"date","geography","geography code","Rural Urban","Household Composition: All categories: Household composition (alternative child and adult defintions); measures: Value","Household Composition: One person household: Total; measures: Value","Household Composition: One person household: One person aged 65 and over; measures: Value","Household Composition: One person household: One person aged under 65; measures: Value","Household Composition: Other households: Total; measures: Value","Household Composition: Other households: No adults or one adult and one or more children; measures: Value","Household Composition: Other households: One adult aged 16 to 64 and one aged 65 and over and no children or two adults aged 65 and over and no children; measures: Value","Household Composition: Other households: Two adults and one or two children; measures: Value","Household Composition: Other households: Two adults aged 16 to 64 and no children; measures: Value","Household Composition: Other households: Two adults and three or more children; measures: Value","Household Composition: Other households: Three or more adults and one or more children; measures: Value","Household Composition: Other households: Three or more adults and no children; measures: Value"
"2011","Darlington 001B","E01012334","Total",962,192,85,107,770,36,129,201,215,41,50,98
"2011","Darlington 001C","E01012335","Total",620,176,98,78,444,15,133,87,116,13,22,58
"2011","Darlington 001D","E01012366","Total",860,199,92,107,661,33,167,89,199,11,38,124
"2011","Darlington 001E","E01033481","Total",554,131,17,114,423,32,28,138,149,13,23,40
"2011","Darlington 001F","E01033482","Total",650,160,36,124,490,31,45,153,146,22,30,63
"2011","Darlington 002C","E01012323","Total",657,177,53,124,480,37,73,110,138,19,37,66
"2011","Darlington 002D","E01012324","Total",627,181,82,99,446,35,106,89,119,11,24,62
"2011","Darlington 002E","E01032545","Total",525,132,51,81,393,35,58,82,100,14,23,81
"2011","Darlington 002F","E01032546","Total",702,131,72,59,571,22,111,117,158,13,45,105
"2011","Darlington 003A","E01012328","Total",768,288,89,199,480,56,84,77,171,19,20,53
"2011","Darlington 003B","E01012329","Total",776,169,93,76,607,16,147,100,202,11,21,110
"2011","Darlington 003C","E01012330","Total",458,89,41,48,369,17,64,74,107,10,26,71
"2011","Darlington 003D","E01012331","Total",505,98,40,58,407,38,67,71,127,15,18,71
"2011","Darlington 004A","E01012349","Total",798,416,140,276,382,85,34,62,116,12,33,40
"2011","Darlington 004B","E01012350","Total",775,328,120,208,447,62,76,94,130,8,16,61
"2011","Darlington 004C","E01012351","Total",556,118,41,77,438,26,56,86,112,16,38,104
"2011","Darlington 004D","E01012352","Total",804,380,120,260,424,76,57,80,132,8,17,54
"2011","Darlington 005A","E01012325","Total",657,201,74,127,456,29,88,58,172,13,20,76
"2011","Darlington 005B","E01012326","Total",502,154,103,51,348,35,72,56,95,10,24,56
"2011","Darlington 005C","E01012332","Total",592,196,93,103,396,42,76,52,111,23,27,65
"2011","Darlington 005D","E01012333","Total",592,150,75,75,442,39,82,76,115,15,35,80
"2011","Darlington 006A","E01012309","Total",760,168,71,97,592,32,80,138,193,22,38,89
"2011","Darlington 006B","E01012310","Total",864,269,139,130,595,41,106,106,176,24,33,109
"2011","Darlington 006C","E01012311","Total",633,168,86,82,465,35,82,86,107,24,40,91
"2011","Darlington 006D","E01012312","Total",625,274,138,136,351,66,39,61,80,29,28,48
"2011","Darlington 006E","E01012313","Total",664,256,136,120,408,53,83,88,101,14,19,50
"2011","Darlington 006F","E01012314","Total",591,191,89,102,400,58,76,75,79,18,33,61
"2011","Darlington 007A","E01012362","Total",703,300,60,240,403,71,49,80,135,12,12,44
"2011","Darlington 007B","E01012363","Total",684,284,61,223,400,64,55,67,143,13,10,48
"2011","Darlington 007C","E01012364","Total",740,301,85,216,439,59,50,85,164,5,13,63
"2011","Darlington 007D","E01012365","Total",540,142,77,65,398,20,79,79,112,8,21,79
"2011","Darlington 008B","E01012353","Total",780,296,43,253,484,77,42,96,175,17,26,51
"2011","Darlington 008C","E01012354","Total",737,351,47,304,386,56,29,52,137,18,51,43
"2011","Darlington 008D","E01012355","Total",710,293,98,195,417,48,57,63,170,13,23,43
"2011","Darlington 008E","E01033483","Total",552,315,82,233,237,33,16,39,90,17,12,30
"2011","Darlington 008F","E01033484","Total",696,421,140,281,275,34,30,40,117,6,11,37
"2011","Darlington 009A","E01012307","Total",878,347,130,217,531,70,81,105,150,17,32,76
"2011","Darlington 009B","E01012327","Total",625,180,68,112,445,88,59,83,92,36,42,45
"2011","Darlington 009C","E01012342","Total",819,294,152,142,525,94,103,65,144,22,28,69
"2011","Darlington 009D","E01012343","Total",887,252,149,103,635,54,148,100,166,17,41,109
"2011","Darlington 010A","E01012315","Total",688,178,112,66,510,21,108,117,132,23,26,83
"2011","Darlington 010B","E01012316","Total",1163,460,142,318,703,29,125,150,232,24,49,94
"2011","Darlington 010C","E01012360","Total",783,272,169,103,511,21,158,94,119,23,31,65
"2011","Darlington 011A","E01012336","Total",725,198,148,50,527,7,156,103,113,15,32,101
"2011","Darlington 011B","E01012337","Total",709,158,98,60,551,9,172,84,130,21,35,100
"2011","Darlington 011C","E01012347","Total",765,214,140,74,551,17,162,100,133,14,30,95
"2011","Darlington 011D","E01012348","Total",915,272,197,75,643,22,278,104,113,16,31,79
"2011","Darlington 011E","E01012361","Total",798,167,115,52,631,20,180,124,168,20,29,90
"2011","Darlington 012A","E01012304","Total",649,349,151,198,300,53,44,37,99,8,31,28
"2011","Darlington 012B","E01012305","Total",622,245,62,183,377,70,36,56,144,8,16,47
"2011","Darlington 012C","E01012306","Total",601,167,63,104,434,36,71,69,133,14,33,78
"2011","Darlington 012D","E01012340","Total",1053,342,127,215,711,86,104,154,211,25,46,85
"2011","Darlington 012E","E01012341","Total",798,302,124,178,496,95,80,79,114,18,41,69
"2011","Darlington 013A","E01012317","Total",624,186,88,98,438,28,127,72,116,12,22,61
"2011","Darlington 013B","E01012318","Total",1015,353,103,250,662,129,72,142,174,24,47,74
"2011","Darlington 013C","E01012319","Total",1119,258,110,148,861,110,125,195,209,42,57,123
"2011","Darlington 014A","E01012356","Total",742,280,88,192,462,49,57,94,158,15,24,65
"2011","Darlington 014B","E01012357","Total",606,180,50,130,426,52,45,69,123,18,45,74
"2011","Darlington 014C","E01012358","Total",708,208,80,128,500,38,81,105,137,27,29,83
"2011","Darlington 014D","E01012359","Total",671,229,70,159,442,115,49,88,84,34,26,46
"2011","Darlington 015A","E01012338","Total",848,251,120,131,597,45,136,100,185,22,41,68
"2011","Darlington 015B","E01012339","Total",756,198,121,77,558,22,170,98,134,11,31,92
"2011","Darlington 015C","E01012344","Total",605,185,71,114,420,34,64,76,148,11,29,58
"2011","Darlington 015D","E01012345","Total",580,149,71,78,431,12,120,74,130,7,20,68
"2011","Darlington 015E","E01012346","Total",699,132,38,94,567,40,66,162,156,19,38,86
"2011","County Durham 002A","E01020613","Total",545,91,50,41,454,10,116,90,109,18,29,82
"2011","County Durham 002B","E01020614","Total",670,228,134,94,442,44,123,84,98,4,26,63
"2011","County Durham 002C","E01020622","Total",677,131,42,89,546,24,70,114,185,14,22,117
"2011","County Durham 002D","E01020623","Total",626,162,34,128,464,25,42,99,161,11,33,93
"2011","County Durham 005A","E01020606","Total",750,312,107,205,438,51,85,65,136,9,28,64
"2011","County Durham 005B","E01020615","Total",755,250,133,117,505,46,80,115,115,11,40,98
"2011","County Durham 005C","E01020616","Total",780,272,90,182,508,81,56,98,165,10,33,65
"2011","County Durham 005D","E01020617","Total",846,260,112,148,586,29,110,103,206,12,17,109
"2011","County Durham 007A","E01020596","Total",758,271,142,129,487,63,89,96,111,19,32,77
"2011","County Durham 007B","E01020597","Total",662,166,89,77,496,23,152,77,132,11,25,76
"2011","County Durham 007C","E01020598","Total",839,289,129,160,550,26,147,116,147,8,31,75
"2011","County Durham 007D","E01020611","Total",582,125,73,52,457,14,138,76,125,5,28,71
"2011","County Durham 007E","E01020612","Total",682,145,108,37,537,13,171,90,127,10,34,92
"2011","County Durham 011A","E01020592","Total",655,223,78,145,432,91,50,95,83,12,35,66
"2011","County Durham 011B","E01020593","Total",638,266,88,178,372,34,69,66,130,5,17,51
"2011","County Durham 011C","E01020599","Total",871,442,198,244,429,38,86,87,99,12,22,85
"2011","County Durham 011D","E01020601","Total",650,181,92,89,469,16,73,116,133,4,43,84
"2011","County Durham 011E","E01020602","Total",890,396,222,174,494,41,128,76,126,19,28,76
"2011","County Durham 011F","E01020618","Total",708,243,104,139,465,49,77,92,122,3,39,83
"2011","County Durham 013A","E01020594","Total",788,269,83,186,519,49,84,89,189,9,22,77
"2011","County Durham 013B","E01020595","Total",773,241,122,119,532,28,135,94,145,14,24,92
"2011","County Durham 013C","E01020600","Total",652,161,99,62,491,11,155,85,109,11,31,89
"2011","County Durham 013D","E01020603","Total",671,94,47,47,577,12,96,146,128,13,56,126
"2011","County Durham 013E","E01020605","Total",771,213,67,146,558,27,79,137,186,11,24,94
"2011","County Durham 015A","E01020590","Total",570,120,61,59,450,38,94,74,141,8,19,76
"2011","County Durham 015B","E01020591","Total",645,208,80,128,437,49,88,65,117,17,30,71
"2011","County Durham 015C","E01020608","Total",749,220,115,105,529,45,86,153,117,13,34,81
"2011","County Durham 015D","E01020609","Total",609,139,74,65,470,37,149,74,103,15,22,70
"2011","County Durham 015E","E01020610","Total",640,151,68,83,489,39,90,98,145,11,27,79
"2011","County Durham 019A","E01020604","Total",632,193,79,114,439,25,84,88,132,5,32,73
"2011","County Durham 019B","E01020607","Total",703,222,95,127,481,30,97,85,136,13,23,97
"2011","County Durham 019C","E01020619","Total",677,187,99,88,490,27,82,104,150,17,24,86
"2011","County Durham 019D","E01020620","Total",658,188,69,119,470,36,81,91,125,24,34,79
"2011","County Durham 019E","E01020621","Total",859,262,93,169,597,62,110,102,191,10,31,91
"2011","County Durham 001A","E01020634","Total",666,171,76,95,495,24,102,102,155,9,21,82
"2011","County Durham 001B","E01020635","Total",615,162,74,88,453,17,88,77,154,11,21,85
"2011","County Durham 001C","E01020636","Total",811,280,141,139,531,51,104,96,170,14,22,74
"2011","County Durham 001D","E01020654","Total",759,199,77,122,560,41,111,109,176,12,24,87
"2011","County Durham 001E","E01020676","Total",699,225,77,148,474,33,83,71,156,11,36,84
"2011","County Durham 003A","E01020627","Total",703,223,90,133,480,23,86,90,157,19,25,80
"2011","County Durham 003B","E01020628","Total",728,194,104,90,534,22,130,107,171,8,27,69
"2011","County Durham 003C","E01020629","Total",623,164,75,89,459,37,87,104,111,16,28,76
"2011","County Durham 003D","E01020655","Total",835,206,80,126,629,27,128,129,214,13,39,79
"2011","County Durham 003E","E01020656","Total",678,244,104,140,434,33,117,57,121,10,19,77
"2011","County Durham 003F","E01020657","Total",611,118,47,71,493,26,94,96,151,7,36,83
"2011","County Durham 004A","E01020661","Total",818,282,103,179,536,66,91,104,161,16,27,71
"2011","County Durham 004B","E01020662","Total",782,242,106,136,540,36,99,114,149,13,40,89
"2011","County Durham 004C","E01020663","Total",842,249,111,138,593,35,132,118,180,11,23,94
"2011","County Durham 004D","E01020674","Total",738,252,119,133,486,44,96,91,151,14,25,65
"2011","County Durham 004E","E01020678","Total",578,140,70,70,438,42,77,68,126,8,30,87
"2011","County Durham 006A","E01020626","Total",758,295,151,144,463,52,107,67,122,16,27,72
"2011","County Durham 006B","E01020638","Total",706,221,101,120,485,41,114,73,123,15,31,88
"2011","County Durham 006C","E01020639","Total",664,233,87,146,431,54,65,82,108,23,28,71
"2011","County Durham 006D","E01020653","Total",692,234,103,131,458,55,94,71,108,16,36,78
"2011","County Durham 006E","E01020677","Total",671,210,110,100,461,32,108,77,113,18,25,88
"2011","County Durham 008A","E01020647","Total",857,200,39,161,657,106,56,165,171,32,44,83
"2011","County Durham 008B","E01020648","Total",778,223,74,149,555,80,81,110,132,26,43,83
"2011","County Durham 008C","E01020649","Total",688,223,82,141,465,57,61,87,145,18,27,70
"2011","County Durham 008D","E01020673","Total",791,324,120,204,467,61,83,59,148,10,33,73
"2011","County Durham 008E","E01020675","Total",799,320,155,165,479,52,93,76,138,10,34,76
"2011","County Durham 009A","E01020624","Total",710,245,75,170,465,52,72,82,131,16,28,84
"2011","County Durham 009B","E01020625","Total",684,203,80,123,481,53,79,83,134,20,34,78
"2011","County Durham 009C","E01020670","Total",753,269,146,123,484,47,121,71,138,12,26,69
"2011","County Durham 009D","E01020671","Total",612,218,66,152,394,66,64,52,105,15,28,64
"2011","County Durham 009E","E01020672","Total",771,254,78,176,517,57,78,69,173,13,38,89
"2011","County Durham 010A","E01020632","Total",812,270,89,181,542,45,84,109,168,12,32,92
"2011","County Durham 010B","E01020640","Total",991,279,80,199,712,54,78,181,211,14,53,121
"2011","County Durham 010C","E01020641","Total",968,342,163,179,626,60,119,122,162,20,45,98
"2011","County Durham 010D","E01020642","Total",626,205,104,101,421,26,93,90,109,6,26,71
"2011","County Durham 010E","E01020643","Total",1051,402,151,251,649,72,90,142,209,15,24,97
"2011","County Durham 010F","E01020667","Total",805,326,156,170,479,40,115,67,175,6,25,51
"2011","County Durham 012A","E01020650","Total",927,238,86,152,689,87,96,149,195,20,39,103
"2011","County Durham 012B","E01020651","Total",801,271,133,138,530,42,157,96,113,9,35,78
"2011","County Durham 012C","E01020652","Total",849,274,157,117,575,53,99,125,143,12,49,94
"2011","County Durham 012D","E01020668","Total",683,232,97,135,451,60,69,65,136,12,26,83
"2011","County Durham 012E","E01020669","Total",636,196,72,124,440,41,69,81,126,9,27,87
"2011","County Durham 014A","E01020630","Total",597,164,70,94,433,51,82,92,96,11,27,74
"2011","County Durham 014B","E01020631","Total",782,310,173,137,472,43,92,84,126,20,28,79
"2011","County Durham 014C","E01020637","Total",730,208,109,99,522,26,130,93,132,15,30,96
"2011","County Durham 014D","E01020644","Total",1054,298,74,224,756,99,69,159,248,26,55,100
"2011","County Durham 014E","E01020645","Total",653,231,105,126,422,68,73,80,96,14,39,52
"2011","County Durham 020A","E01020633","Total",707,204,84,120,503,39,87,87,163,17,21,89
"2011","County Durham 020B","E01020664","Total",679,221,123,98,458,16,124,64,153,10,25,66
"2011","County Durham 020C","E01020665","Total",652,238,114,124,414,42,102,73,105,7,20,65
"2011","County Durham 020D","E01020666","Total",643,154,91,63,489,10,159,86,129,11,28,66
"2011","County Durham 024A","E01020646","Total",688,214,98,116,474,23,78,114,127,14,28,90
"2011","County Durham 024B","E01020658","Total",828,304,145,159,524,79,66,111,168,11,26,63
"2011","County Durham 024C","E01020659","Total",668,170,62,108,498,27,81,118,143,12,27,90
"2011","County Durham 024D","E01020660","Total",694,209,107,102,485,37,102,81,129,10,36,90
"2011","County Durham 022A","E01020709","Total",584,131,36,95,453,17,74,106,137,12,29,78
"2011","County Durham 022B","E01020717","Total",765,230,128,102,535,14,173,68,156,5,26,93
"2011","County Durham 022C","E01020718","Total",619,207,111,96,412,16,109,69,113,10,23,72
"2011","County Durham 022D","E01020719","Total",533,133,41,92,400,21,71,80,131,6,24,67
"2011","County Durham 022E","E01020721","Total",486,105,25,80,381,11,57,71,128,7,22,85
"2011","County Durham 023A","E01020708","Total",535,151,62,89,384,13,102,69,127,8,15,50
"2011","County Durham 023B","E01020710","Total",746,256,75,181,490,30,87,93,173,10,24,73
"2011","County Durham 023C","E01020711","Total",789,282,146,136,507,38,104,83,152,20,31,79
"2011","County Durham 023D","E01020720","Total",699,293,145,148,406,35,89,86,103,15,17,61
"2011","County Durham 026A","E01020679","Total",714,251,108,143,463,50,78,101,124,13,25,72
"2011","County Durham 026B","E01020680","Total",677,149,73,76,528,17,121,118,144,11,21,96
"2011","County Durham 026C","E01020681","Total",693,245,106,139,448,47,86,82,129,9,22,73
"2011","County Durham 026D","E01020714","Total",695,166,65,101,529,23,112,89,186,4,23,92
"2011","County Durham 026E","E01020716","Total",747,240,91,149,507,71,73,87,131,26,43,76
"2011","County Durham 027A","E01020725","Total",657,171,73,98,486,30,91,111,148,12,26,68
"2011","County Durham 027B","E01020726","Total",538,134,52,82,404,25,91,73,134,3,13,65
"2011","County Durham 027C","E01020727","Total",538,238,89,149,300,34,66,48,77,13,18,44
"2011","County Durham 027D","E01020729","Total",943,290,88,202,653,77,94,124,209,22,44,83
"2011","County Durham 027E","E01020730","Total",808,304,164,140,504,48,116,85,130,11,32,82
"2011","County Durham 027F","E01020731","Total",634,161,57,104,473,30,85,95,157,14,22,70
"2011","County Durham 028A","E01020682","Total",834,181,125,56,653,21,229,80,173,10,32,108
"2011","County Durham 028B","E01020683","Total",664,142,47,95,522,21,130,102,133,14,33,89
"2011","County Durham 028C","E01020690","Total",635,197,117,80,438,25,159,51,115,3,18,67
"2011","County Durham 028D","E01020691","Total",617,216,116,100,401,33,67,78,113,6,22,82
"2011","County Durham 028E","E01020692","Total",659,181,90,91,478,8,166,54,147,5,19,79
"2011","County Durham 029A","E01020693","Total",629,225,72,153,404,27,81,53,143,12,15,73
"2011","County Durham 029B","E01020722","Total",882,281,117,164,601,50,91,73,184,24,27,152
"2011","County Durham 029C","E01020723","Total",772,281,94,187,491,26,74,44,159,11,20,157
"2011","County Durham 029D","E01020724","Total",674,214,59,155,460,83,50,81,110,19,42,75
"2011","County Durham 030A","E01020703","Total",695,209,85,124,486,8,34,20,134,1,8,281
"2011","County Durham 030D","E01033164","Total",436,161,61,100,275,2,33,9,104,2,6,119
"2011","County Durham 030E","E01033195","Total",411,127,43,84,284,2,69,27,82,4,3,97
"2011","County Durham 030F","E01033197","Total",401,119,69,50,282,3,44,3,52,3,8,169
"2011","County Durham 030G","E01033221","Total",420,162,75,87,258,4,46,9,71,5,8,115
"2011","County Durham 033A","E01020684","Total",994,291,85,206,703,63,82,154,208,19,50,127
"2011","County Durham 033B","E01020702","Total",825,199,72,127,626,9,115,116,197,24,31,134
"2011","County Durham 033C","E01020704","Total",553,90,37,53,463,3,71,48,87,16,31,207
"2011","County Durham 033D","E01020712","Total",679,180,67,113,499,9,91,94,150,12,32,111
"2011","County Durham 033E","E01020713","Total",794,158,68,90,636,11,110,156,174,26,28,131
"2011","County Durham 031A","E01020705","Total",720,290,143,147,430,43,86,64,127,10,25,75
"2011","County Durham 031B","E01020706","Total",856,276,111,165,580,33,130,99,176,13,27,102
"2011","County Durham 031C","E01020715","Total",1068,335,103,232,733,69,93,141,246,29,28,127
"2011","County Durham 038A","E01020685","Total",714,195,103,92,519,25,107,86,156,12,29,104
"2011","County Durham 038B","E01020686","Total",797,355,131,224,442,52,93,70,131,20,27,49
"2011","County Durham 038C","E01020687","Total",719,284,132,152,435,27,86,78,151,4,20,69
"2011","County Durham 038D","E01020688","Total",681,213,63,150,468,52,59,108,148,12,19,70
"2011","County Durham 038E","E01020689","Total",643,224,85,139,419,57,69,66,106,22,27,72
"2011","County Durham 041A","E01020694","Total",687,251,120,131,436,36,82,73,138,13,23,71
"2011","County Durham 041B","E01020696","Total",609,225,94,131,384,17,76,61,136,9,30,55
"2011","County Durham 041C","E01020697","Total",631,169,56,113,462,32,61,101,133,20,24,91
"2011","County Durham 041D","E01020732","Total",739,197,88,109,542,23,131,109,136,18,34,91
"2011","County Durham 044A","E01020695","Total",807,247,101,146,560,45,105,102,182,15,30,81
"2011","County Durham 044B","E01020698","Total",654,152,45,107,502,16,78,138,145,18,22,85
"2011","County Durham 044C","E01020699","Total",516,160,70,90,356,44,70,60,93,15,24,50
"2011","County Durham 044D","E01020700","Total",712,251,117,134,461,38,94,79,119,13,39,79
"2011","County Durham 044E","E01020701","Total",604,188,107,81,416,24,78,86,119,10,23,76
"2011","County Durham 016A","E01020750","Total",534,126,75,51,408,13,94,58,112,5,30,96
"2011","County Durham 016B","E01020781","Total",492,165,100,65,327,19,75,45,100,4,31,53
"2011","County Durham 016D","E01020786","Total",669,130,65,65,539,13,125,99,147,4,33,118
"2011","County Durham 016E","E01020787","Total",812,281,141,140,531,58,75,86,156,11,54,91
"2011","County Durham 016F","E01033163","Total",820,198,64,134,622,30,65,197,210,23,25,72
"2011","County Durham 016G","E01033202","Total",524,163,75,88,361,43,75,75,82,5,21,60
"2011","County Durham 017A","E01020740","Total",561,131,53,78,430,28,65,94,104,13,26,100
"2011","County Durham 017B","E01020741","Total",534,159,41,118,375,46,41,65,102,9,25,87
"2011","County Durham 017C","E01020742","Total",723,203,74,129,520,67,62,106,151,16,31,87
"2011","County Durham 017D","E01020782","Total",514,163,86,77,351,28,72,44,110,4,23,70
"2011","County Durham 017E","E01020783","Total",593,185,93,92,408,32,81,73,102,8,23,89
"2011","County Durham 017F","E01020784","Total",737,357,170,187,380,40,67,53,100,12,27,81
"2011","County Durham 018A","E01020743","Total",560,149,52,97,411,73,40,100,84,21,30,63
"2011","County Durham 018B","E01020747","Total",492,130,44,86,362,82,40,55,63,19,31,72
"2011","County Durham 018C","E01020748","Total",508,130,44,86,378,42,49,69,82,17,35,84
"2011","County Durham 018D","E01020749","Total",758,320,182,138,438,32,161,54,112,4,14,61
"2011","County Durham 018E","E01020773","Total",658,241,106,135,417,36,79,68,125,6,31,72
"2011","County Durham 018F","E01020775","Total",793,287,135,152,506,78,92,89,124,15,30,78
"2011","County Durham 021C","E01020776","Total",805,233,143,90,572,25,143,94,145,8,40,117
"2011","County Durham 021D","E01033161","Total",616,155,56,99,461,43,59,108,117,7,36,91
"2011","County Durham 021E","E01033198","Total",639,174,58,116,465,57,60,74,143,4,10,117
"2011","County Durham 021F","E01033205","Total",625,160,58,102,465,31,83,101,131,10,30,79
"2011","County Durham 021G","E01033206","Total",652,202,84,118,450,58,60,97,109,15,38,73
"2011","County Durham 025A","E01020751","Total",819,247,75,172,572,67,103,97,149,23,33,100
"2011","County Durham 025B","E01020752","Total",580,207,77,130,373,92,55,47,104,8,12,55
"2011","County Durham 025C","E01020754","Total",633,224,133,91,409,17,105,82,122,4,18,61
"2011","County Durham 025D","E01020756","Total",556,110,42,68,446,26,98,82,126,10,32,72
"2011","County Durham 032A","E01020745","Total",588,198,83,115,390,44,71,63,110,13,26,63
"2011","County Durham 032B","E01020753","Total",864,327,169,158,537,57,88,122,124,11,40,95
"2011","County Durham 032C","E01020757","Total",469,143,62,81,326,44,36,63,92,14,23,54
"2011","County Durham 032D","E01020758","Total",624,198,67,131,426,80,55,86,100,19,23,63
"2011","County Durham 032E","E01020759","Total",462,143,39,104,319,64,43,52,61,14,31,54
"2011","County Durham 032F","E01020765","Total",715,221,72,149,494,68,51,95,125,14,46,95
"2011","County Durham 034A","E01020760","Total",692,198,112,86,494,24,108,94,123,16,38,91
"2011","County Durham 034B","E01020761","Total",548,180,60,120,368,37,52,71,87,15,33,73
"2011","County Durham 034C","E01020762","Total",648,252,116,136,396,68,68,73,85,19,31,52
"2011","County Durham 034D","E01020763","Total",825,284,103,181,541,47,89,103,161,17,34,90
"2011","County Durham 036A","E01020764","Total",686,280,88,192,406,62,79,51,111,13,23,67
"2011","County Durham 036B","E01020766","Total",692,242,144,98,450,25,131,74,126,9,13,72
"2011","County Durham 036C","E01020767","Total",873,336,121,215,537,84,80,87,133,12,47,94
"2011","County Durham 036D","E01020768","Total",662,162,76,86,500,59,98,98,113,16,38,78
"2011","County Durham 035A","E01020733","Total",507,121,57,64,386,51,46,68,104,12,36,69
"2011","County Durham 035B","E01020734","Total",513,131,62,69,382,63,49,76,88,8,23,75
"2011","County Durham 035C","E01020735","Total",626,207,116,91,419,27,81,96,98,10,35,72
"2011","County Durham 035D","E01020770","Total",502,132,58,74,370,38,51,76,85,12,28,80
"2011","County Durham 035E","E01020771","Total",457,148,66,82,309,31,64,52,70,10,31,51
"2011","County Durham 035F","E01020780","Total",510,152,73,79,358,39,74,55,83,14,32,61
"2011","County Durham 037A","E01020746","Total",489,142,72,70,347,18,89,55,82,8,23,72
"2011","County Durham 037B","E01020769","Total",476,92,43,49,384,29,61,73,90,19,40,72
"2011","County Durham 037C","E01020777","Total",673,267,113,154,406,52,68,65,92,14,29,86
"2011","County Durham 037D","E01020778","Total",511,107,40,67,404,18,93,51,132,7,28,75
"2011","County Durham 037E","E01020779","Total",658,103,35,68,555,15,108,96,160,8,38,130
"2011","County Durham 039A","E01020736","Total",521,155,65,90,366,29,70,69,99,16,28,55
"2011","County Durham 039B","E01020737","Total",598,155,86,69,443,30,96,73,131,11,28,74
"2011","County Durham 039C","E01020738","Total",488,166,89,77,322,18,93,47,84,2,13,65
"2011","County Durham 039D","E01020739","Total",686,297,137,160,389,47,88,66,111,14,18,45
"2011","County Durham 039E","E01020744","Total",449,128,68,60,321,25,91,47,71,6,15,66
"2011","County Durham 040A","E01020788","Total",664,206,97,109,458,49,77,68,122,14,38,90
"2011","County Durham 040B","E01020789","Total",634,205,105,100,429,36,88,80,118,13,18,76
"2011","County Durham 040C","E01020790","Total",590,195,72,123,395,50,84,78,81,18,22,62
"2011","County Durham 040D","E01020791","Total",588,196,92,104,392,34,78,65,93,7,31,84
"2011","County Durham 040E","E01020792","Total",608,186,75,111,422,26,65,78,121,19,36,77
"2011","County Durham 043A","E01020772","Total",854,227,98,129,627,27,123,128,181,16,38,114
"2011","County Durham 043B","E01020793","Total",762,254,119,135,508,58,72,83,138,21,35,101
"2011","County Durham 043C","E01020794","Total",738,173,89,84,565,31,88,138,162,11,32,103
"2011","County Durham 043D","E01020795","Total",759,220,74,146,539,60,70,117,158,21,30,83
"2011","County Durham 047A","E01020817","Total",542,127,43,84,415,10,69,78,131,4,17,106
"2011","County Durham 047B","E01020818","Total",667,220,121,99,447,35,105,75,116,14,26,76
"2011","County Durham 047C","E01020819","Total",507,187,111,76,320,41,62,53,79,8,20,57
"2011","County Durham 047D","E01020837","Total",751,154,70,84,597,18,148,119,189,8,28,87
"2011","County Durham 047E","E01020843","Total",728,204,109,95,524,22,107,112,172,10,32,69
"2011","County Durham 048A","E01020809","Total",635,211,95,116,424,51,70,83,90,14,32,84
"2011","County Durham 048B","E01020810","Total",551,152,63,89,399,27,65,70,106,14,33,84
"2011","County Durham 048C","E01020811","Total",559,162,78,84,397,42,72,74,110,16,25,58
"2011","County Durham 048D","E01020812","Total",669,189,100,89,480,33,102,81,128,14,32,90
"2011","County Durham 048E","E01020827","Total",778,222,109,113,556,43,101,102,156,20,33,101
"2011","County Durham 049A","E01020806","Total",622,196,96,100,426,36,90,72,114,14,30,70
"2011","County Durham 049B","E01020807","Total",668,297,55,242,371,59,53,58,107,9,22,63
"2011","County Durham 049C","E01020820","Total",732,292,151,141,440,44,104,84,106,18,44,40
"2011","County Durham 049D","E01020842","Total",907,334,103,231,573,70,85,110,146,27,38,97
"2011","County Durham 050A","E01020797","Total",1198,447,177,270,751,71,186,114,206,18,34,122
"2011","County Durham 050B","E01020798","Total",735,297,170,127,438,37,130,67,101,10,22,71
"2011","County Durham 050C","E01020799","Total",683,246,110,136,437,31,71,90,128,13,28,76
"2011","County Durham 050D","E01020808","Total",648,233,110,123,415,19,114,54,117,8,21,82
"2011","County Durham 052A","E01020821","Total",752,160,63,97,592,36,106,138,152,20,43,97
"2011","County Durham 052B","E01020822","Total",799,192,83,109,607,16,126,107,208,13,33,104
"2011","County Durham 052C","E01020823","Total",853,321,178,143,532,62,95,90,161,14,29,81
"2011","County Durham 052D","E01020835","Total",696,196,65,131,500,45,60,109,148,11,34,93
"2011","County Durham 052E","E01020836","Total",937,351,141,210,586,65,101,116,176,19,33,76
"2011","County Durham 053B","E01020803","Total",830,230,82,148,600,36,102,114,168,13,46,121
"2011","County Durham 053D","E01020805","Total",945,364,190,174,581,75,136,111,138,21,32,68
"2011","County Durham 053E","E01033203","Total",1254,381,120,261,873,88,150,175,242,20,54,144
"2011","County Durham 054A","E01020796","Total",559,160,84,76,399,17,75,77,126,9,22,73
"2011","County Durham 054B","E01020828","Total",667,121,61,60,546,14,155,83,160,14,31,89
"2011","County Durham 054C","E01020829","Total",1039,260,92,168,779,36,161,206,220,23,35,98
"2011","County Durham 054D","E01020830","Total",732,270,179,91,462,24,129,77,128,9,27,68
"2011","County Durham 059A","E01020801","Total",716,231,108,123,485,44,86,84,152,10,22,87
"2011","County Durham 059B","E01020802","Total",939,371,172,199,568,60,93,124,155,21,23,92
"2011","County Durham 059C","E01020838","Total",812,289,114,175,523,46,109,83,149,17,21,98
"2011","County Durham 059D","E01020839","Total",788,305,165,140,483,56,107,72,110,13,23,102
"2011","County Durham 059E","E01020840","Total",721,246,98,148,475,56,102,75,123,14,38,67
"2011","County Durham 059F","E01020841","Total",836,335,129,206,501,91,64,82,140,21,32,71
"2011","County Durham 060A","E01020813","Total",508,89,31,58,419,14,85,85,136,16,23,60
"2011","County Durham 060B","E01020814","Total",610,174,57,117,436,33,41,96,152,13,33,68
"2011","County Durham 060C","E01020815","Total",511,99,34,65,412,30,94,62,124,12,23,67
"2011","County Durham 060D","E01020848","Total",508,154,56,98,354,27,72,63,120,12,17,43
"2011","County Durham 060E","E01020850","Total",699,83,10,73,616,28,62,177,171,19,51,108
"2011","County Durham 060F","E01020851","Total",638,163,66,97,475,22,129,77,140,7,27,73
"2011","County Durham 061A","E01020816","Total",589,161,50,111,428,70,52,94,98,33,36,45
"2011","County Durham 061B","E01020844","Total",679,207,81,126,472,73,84,110,109,22,26,48
"2011","County Durham 061C","E01020847","Total",614,154,44,110,460,82,49,87,111,31,43,57
"2011","County Durham 061D","E01020849","Total",519,169,36,133,350,59,33,54,93,16,30,65
"2011","County Durham 062A","E01020825","Total",717,258,141,117,459,28,101,74,120,11,44,81
"2011","County Durham 062B","E01020831","Total",662,233,129,104,429,57,85,70,112,15,23,67
"2011","County Durham 062C","E01020833","Total",502,124,70,54,378,33,92,64,81,9,26,73
"2011","County Durham 062D","E01020834","Total",611,213,93,120,398,68,78,66,99,14,13,60
"2011","County Durham 063A","E01020824","Total",771,300,165,135,471,45,113,89,129,10,19,66
"2011","County Durham 063B","E01020826","Total",669,213,122,91,456,27,106,65,111,18,30,99
"2011","County Durham 063C","E01020832","Total",640,193,114,79,447,23,132,61,116,10,22,83
"2011","County Durham 063D","E01020845","Total",634,207,108,99,427,52,84,58,124,6,22,81
"2011","County Durham 063E","E01020846","Total",530,120,61,59,410,17,110,58,112,4,29,80
"2011","County Durham 064A","E01020856","Total",733,254,110,144,479,37,111,85,140,13,24,69
"2011","County Durham 064B","E01020858","Total",475,164,85,79,311,21,64,61,89,10,20,46
"2011","County Durham 064C","E01020859","Total",537,147,68,79,390,19,94,58,117,8,30,64
"2011","County Durham 064D","E01020860","Total",476,172,55,117,304,41,40,46,105,6,21,45
"2011","County Durham 064E","E01020861","Total",549,188,94,94,361,19,94,60,98,4,27,59
"2011","County Durham 064F","E01020862","Total",1107,318,164,154,789,34,217,122,251,26,33,106
"2011","County Durham 064G","E01020864","Total",922,263,126,137,659,21,140,111,216,23,29,119
"2011","County Durham 064H","E01020867","Total",956,271,153,118,685,53,150,117,183,36,45,101
"2011","County Durham 065A","E01020857","Total",641,152,78,74,489,35,117,75,138,20,35,69
"2011","County Durham 065B","E01020863","Total",589,124,51,73,465,14,102,88,143,6,22,90
"2011","County Durham 065C","E01020865","Total",642,226,116,110,416,16,124,62,133,9,19,53
"2011","County Durham 065D","E01020866","Total",472,163,69,94,309,13,81,37,92,8,13,65
"2011","County Durham 066A","E01020852","Total",817,382,192,190,435,26,139,61,134,7,22,46
"2011","County Durham 066B","E01020853","Total",649,210,111,99,439,22,108,81,113,12,24,79
"2011","County Durham 066C","E01020854","Total",991,333,130,203,658,37,151,115,199,14,36,106
"2011","County Durham 066D","E01020855","Total",555,163,109,54,392,22,128,50,100,7,27,58
"2011","County Durham 042A","E01020889","Total",705,237,114,123,468,11,121,73,154,12,24,73
"2011","County Durham 042B","E01020890","Total",799,263,128,135,536,33,128,98,147,14,25,91
"2011","County Durham 042C","E01020891","Total",759,245,112,133,514,31,129,67,152,7,29,99
"2011","County Durham 042D","E01020905","Total",717,241,129,112,476,36,122,84,132,11,28,63
"2011","County Durham 042E","E01020906","Total",720,183,84,99,537,19,142,95,155,14,37,75
"2011","County Durham 045A","E01020876","Total",773,250,124,126,523,44,91,126,140,13,24,85
"2011","County Durham 045B","E01020878","Total",734,233,101,132,501,58,83,106,106,27,35,86
"2011","County Durham 045C","E01020887","Total",830,235,105,130,595,40,104,114,178,17,31,111
"2011","County Durham 045D","E01020892","Total",497,173,85,88,324,22,74,53,77,11,23,64
"2011","County Durham 045E","E01020894","Total",518,162,73,89,356,34,60,73,88,25,21,55
"2011","County Durham 045F","E01020898","Total",729,301,132,169,428,71,78,62,107,24,28,58
"2011","County Durham 046A","E01020877","Total",740,261,94,167,479,47,102,71,157,5,23,74
"2011","County Durham 046B","E01020879","Total",983,296,124,172,687,44,149,135,218,21,31,89
"2011","County Durham 046C","E01020893","Total",741,228,85,143,513,43,81,97,166,13,25,88
"2011","County Durham 046D","E01020899","Total",640,231,101,130,409,27,91,61,145,5,14,66
"2011","County Durham 046E","E01020903","Total",512,151,51,100,361,18,62,87,115,9,20,50
"2011","County Durham 046F","E01020904","Total",762,222,84,138,540,38,94,126,156,15,33,78
"2011","County Durham 051A","E01020873","Total",678,240,107,133,438,80,71,64,122,13,25,63
"2011","County Durham 051B","E01020875","Total",570,152,64,88,418,28,69,64,143,10,32,72
"2011","County Durham 051C","E01020900","Total",582,147,63,84,435,24,76,98,116,16,28,77
"2011","County Durham 051D","E01020901","Total",648,275,132,143,373,35,85,62,103,11,21,56
"2011","County Durham 051E","E01020902","Total",657,222,90,132,435,73,79,68,107,14,27,67
"2011","County Durham 055A","E01020868","Total",875,334,151,183,541,36,106,91,196,10,23,79
"2011","County Durham 055B","E01020869","Total",631,232,71,161,399,41,58,77,114,6,27,76
"2011","County Durham 055C","E01020874","Total",643,215,71,144,428,47,78,75,108,10,33,77
"2011","County Durham 055D","E01020880","Total",679,234,81,153,445,60,44,72,140,14,29,86
"2011","County Durham 055E","E01020881","Total",581,165,57,108,416,28,98,81,110,8,22,69
"2011","County Durham 056A","E01020870","Total",605,140,91,49,465,10,182,65,101,6,30,71
"2011","County Durham 056B","E01020871","Total",638,202,69,133,436,57,101,70,99,15,28,66
"2011","County Durham 056C","E01020872","Total",816,305,152,153,511,42,109,94,154,21,19,72
"2011","County Durham 056D","E01020883","Total",692,139,52,87,553,18,102,128,153,8,42,102
"2011","County Durham 056E","E01020886","Total",562,175,62,113,387,43,62,71,119,16,23,53
"2011","County Durham 057A","E01020882","Total",645,193,76,117,452,40,81,65,127,11,30,98
"2011","County Durham 057B","E01020888","Total",844,227,91,136,617,39,92,131,197,15,46,97
"2011","County Durham 057C","E01020895","Total",697,260,91,169,437,66,56,79,136,10,19,71
"2011","County Durham 057D","E01020896","Total",624,198,87,111,426,37,121,60,99,16,27,66
"2011","County Durham 057E","E01020897","Total",1081,306,113,193,775,117,85,162,258,27,42,84
"2011","County Durham 058A","E01020884","Total",642,222,98,124,420,41,92,69,115,9,23,71
"2011","County Durham 058B","E01020885","Total",543,197,92,105,346,29,83,61,90,10,22,51
"2011","County Durham 058C","E01020907","Total",708,229,96,133,479,71,68,78,120,13,45,84
"2011","County Durham 058D","E01020908","Total",601,178,57,121,423,61,55,78,107,11,31,80
"2011","County Durham 058E","E01020909","Total",753,285,97,188,468,126,41,83,104,28,26,60
"2011","Hartlepool 001A","E01011954","Total",948,301,120,181,647,83,102,146,148,17,44,107
"2011","Hartlepool 001B","E01011969","Total",601,138,76,62,463,15,136,70,128,9,21,84
"2011","Hartlepool 001C","E01011970","Total",458,80,33,47,378,19,63,73,112,7,34,70
"2011","Hartlepool 001D","E01011971","Total",526,86,20,66,440,24,43,140,111,25,47,50
"2011","Hartlepool 001F","E01033465","Total",699,141,37,104,558,36,49,130,198,20,39,86
"2011","Hartlepool 001G","E01033467","Total",615,284,188,96,331,45,82,60,82,12,13,37
"2011","Hartlepool 002A","E01011952","Total",690,241,113,128,449,61,74,84,112,17,40,61
"2011","Hartlepool 002B","E01011953","Total",803,268,95,173,535,93,56,98,132,28,49,79
"2011","Hartlepool 002C","E01011991","Total",810,286,130,156,524,32,108,79,127,18,51,109
"2011","Hartlepool 002D","E01011992","Total",712,233,77,156,479,72,57,94,146,14,27,69
"2011","Hartlepool 002E","E01011993","Total",854,372,144,228,482,74,77,84,107,17,38,85
"2011","Hartlepool 002F","E01011994","Total",684,279,107,172,405,68,67,69,98,24,26,53
"2011","Hartlepool 003A","E01011955","Total",601,224,58,166,377,61,49,61,95,17,29,65
"2011","Hartlepool 003C","E01011957","Total",570,174,55,119,396,41,57,77,113,9,41,58
"2011","Hartlepool 003G","E01032540","Total",441,124,51,73,317,28,49,77,99,3,17,44
"2011","Hartlepool 003H","E01032541","Total",985,366,204,162,619,60,134,129,127,14,44,111
"2011","Hartlepool 003I","E01033466","Total",877,312,117,195,565,104,82,89,127,23,42,98
"2011","Hartlepool 005A","E01011973","Total",661,304,67,237,357,85,32,51,104,21,17,47
"2011","Hartlepool 005B","E01011974","Total",933,489,82,407,444,45,40,46,207,15,26,65
"2011","Hartlepool 005C","E01011975","Total",681,301,81,220,380,59,44,79,119,13,10,56
"2011","Hartlepool 005D","E01011976","Total",490,200,59,141,290,38,40,43,92,14,22,41
"2011","Hartlepool 006A","E01011965","Total",635,115,67,48,520,17,121,108,118,16,41,99
"2011","Hartlepool 006B","E01011966","Total",641,231,89,142,410,31,76,70,125,8,27,73
"2011","Hartlepool 006C","E01011983","Total",629,104,59,45,525,9,115,101,126,24,46,104
"2011","Hartlepool 006D","E01012002","Total",607,181,99,82,426,32,84,83,119,6,23,79
"2011","Hartlepool 007A","E01011951","Total",694,296,72,224,398,93,38,68,113,9,28,49
"2011","Hartlepool 007B","E01011964","Total",535,174,66,108,361,22,54,56,76,23,57,73
"2011","Hartlepool 007C","E01011967","Total",548,125,49,76,423,38,46,76,102,19,44,98
"2011","Hartlepool 007D","E01011999","Total",959,413,143,270,546,89,65,83,151,30,48,80
"2011","Hartlepool 007E","E01012000","Total",796,467,133,334,329,61,71,44,96,14,16,27
"2011","Hartlepool 008A","E01011950","Total",771,365,84,281,406,79,46,63,133,5,21,59
"2011","Hartlepool 008B","E01011986","Total",531,122,63,59,409,32,74,65,118,7,34,79
"2011","Hartlepool 008C","E01011987","Total",642,208,68,140,434,55,65,83,129,12,22,68
"2011","Hartlepool 008D","E01012001","Total",913,361,127,234,552,84,66,109,156,16,38,83
"2011","Hartlepool 009A","E01011949","Total",785,203,96,107,582,76,97,104,135,23,50,97
"2011","Hartlepool 009B","E01011980","Total",812,354,177,177,458,53,96,91,93,16,28,81
"2011","Hartlepool 009C","E01011981","Total",709,250,143,107,459,70,78,73,97,17,50,74
"2011","Hartlepool 009D","E01011984","Total",581,190,151,39,391,15,117,55,103,7,21,73
"2011","Hartlepool 010A","E01011985","Total",503,141,63,78,362,17,79,69,111,9,13,64
"2011","Hartlepool 010B","E01011988","Total",862,330,161,169,532,52,85,110,148,18,31,88
"2011","Hartlepool 010C","E01011989","Total",835,302,125,177,533,83,79,83,141,26,45,76
"2011","Hartlepool 010D","E01011990","Total",724,204,107,97,520,44,68,98,152,16,43,99
"2011","Hartlepool 011A","E01011995","Total",581,129,86,43,452,13,130,71,99,17,39,83
"2011","Hartlepool 011B","E01011996","Total",664,227,107,120,437,31,94,66,134,8,28,76
"2011","Hartlepool 011C","E01011997","Total",816,162,78,84,654,47,109,129,183,22,40,124
"2011","Hartlepool 011D","E01011998","Total",637,190,135,55,447,20,103,72,126,14,29,83
"2011","Hartlepool 012A","E01011961","Total",629,179,75,104,450,61,100,80,89,12,35,73
"2011","Hartlepool 012B","E01011962","Total",613,180,92,88,433,55,84,84,87,22,24,77
"2011","Hartlepool 012C","E01011977","Total",748,221,61,160,527,114,51,84,132,13,42,91
"2011","Hartlepool 012D","E01011978","Total",774,385,136,249,389,114,43,54,81,21,26,50
"2011","Hartlepool 012E","E01011979","Total",635,185,60,125,450,83,49,93,97,16,35,77
"2011","Hartlepool 014A","E01011959","Total",830,191,106,85,639,22,129,114,179,22,53,120
"2011","Hartlepool 014B","E01011960","Total",616,147,103,44,469,10,155,63,114,4,37,86
"2011","Hartlepool 014C","E01011963","Total",660,196,115,81,464,22,130,69,128,7,28,80
"2011","Hartlepool 014D","E01011968","Total",952,277,155,122,675,48,156,91,216,13,43,108
"2011","Hartlepool 014E","E01011982","Total",543,112,72,40,431,9,132,79,96,11,30,74
"2011","Hartlepool 014F","E01012003","Total",668,172,82,90,496,18,133,74,122,16,39,94
"2011","Hartlepool 014G","E01012005","Total",717,100,25,75,617,25,51,207,149,12,69,104
"2011","Middlesbrough 001A","E01012068","Total",804,287,33,254,517,58,21,65,161,28,25,159
"2011","Middlesbrough 001D","E01012092","Total",625,246,77,169,379,47,26,57,84,24,45,96
"2011","Middlesbrough 001E","E01012093","Total",711,214,42,172,497,58,14,66,130,63,49,117
"2011","Middlesbrough 001F","E01012094","Total",956,304,64,240,652,63,35,94,184,51,80,145
"2011","Middlesbrough 001G","E01033468","Total",1253,710,174,536,543,50,51,73,151,45,51,122
"2011","Middlesbrough 002A","E01012058","Total",774,292,68,224,482,83,43,71,175,14,30,66
"2011","Middlesbrough 002B","E01012059","Total",724,299,114,185,425,72,61,67,122,12,34,57
"2011","Middlesbrough 002C","E01012060","Total",698,214,87,127,484,119,41,89,100,28,34,73
"2011","Middlesbrough 002D","E01012061","Total",619,211,97,114,408,73,54,61,101,33,28,58
"2011","Middlesbrough 003A","E01012036","Total",608,192,42,150,416,51,30,49,103,14,39,130
"2011","Middlesbrough 003B","E01012037","Total",687,253,74,179,434,82,33,83,110,14,32,80
"2011","Middlesbrough 003C","E01012038","Total",661,234,51,183,427,68,46,74,114,19,31,75
"2011","Middlesbrough 003D","E01012039","Total",625,217,56,161,408,28,22,46,117,18,20,157
"2011","Middlesbrough 003E","E01012040","Total",626,198,41,157,428,66,25,78,126,20,29,84
"2011","Middlesbrough 003F","E01012041","Total",613,367,137,230,246,39,43,24,86,3,15,36
"2011","Middlesbrough 004A","E01012074","Total",634,191,107,84,443,73,50,78,99,20,49,74
"2011","Middlesbrough 004B","E01012075","Total",621,163,72,91,458,110,65,87,65,17,30,84
"2011","Middlesbrough 004C","E01012076","Total",615,154,81,73,461,136,44,70,87,21,39,64
"2011","Middlesbrough 004D","E01012077","Total",604,213,108,105,391,48,75,42,85,13,38,90
"2011","Middlesbrough 004E","E01012088","Total",531,141,77,64,390,78,40,68,59,33,38,74
"2011","Middlesbrough 005A","E01012078","Total",654,242,45,197,412,69,31,60,140,16,27,69
"2011","Middlesbrough 005B","E01012079","Total",503,114,57,57,389,24,62,65,87,28,38,85
"2011","Middlesbrough 005C","E01012080","Total",503,151,62,89,352,20,58,50,83,21,39,81
"2011","Middlesbrough 005D","E01012081","Total",679,229,84,145,450,32,57,69,118,32,56,86
"2011","Middlesbrough 006A","E01012026","Total",618,157,75,82,461,30,64,76,126,26,41,98
"2011","Middlesbrough 006B","E01012027","Total",799,335,110,225,464,75,46,84,135,18,37,69
"2011","Middlesbrough 006E","E01033469","Total",811,236,90,146,575,90,79,107,119,23,51,106
"2011","Middlesbrough 007A","E01012015","Total",710,295,153,142,415,44,79,63,96,13,31,89
"2011","Middlesbrough 007B","E01012016","Total",793,323,112,211,470,92,67,79,117,19,26,70
"2011","Middlesbrough 007C","E01012017","Total",727,224,130,94,503,41,141,56,126,9,31,99
"2011","Middlesbrough 007D","E01012089","Total",602,177,69,108,425,79,47,53,82,26,53,85
"2011","Middlesbrough 007E","E01012090","Total",718,322,72,250,396,62,36,67,104,18,46,63
"2011","Middlesbrough 007F","E01012091","Total",630,152,59,93,478,101,43,77,95,39,60,63
"2011","Middlesbrough 008A","E01012011","Total",770,211,85,126,559,111,88,85,112,13,70,80
"2011","Middlesbrough 008B","E01012012","Total",633,136,67,69,497,36,72,92,87,25,73,112
"2011","Middlesbrough 008C","E01012013","Total",547,157,66,91,390,40,47,78,101,19,27,78
"2011","Middlesbrough 008D","E01012014","Total",617,133,52,81,484,88,50,84,131,19,39,73
"2011","Middlesbrough 009A","E01012053","Total",621,154,74,80,467,13,86,78,99,29,56,106
"2011","Middlesbrough 009B","E01012054","Total",618,130,53,77,488,30,62,90,97,35,61,113
"2011","Middlesbrough 009C","E01012055","Total",734,176,92,84,558,18,109,79,145,20,71,116
"2011","Middlesbrough 009D","E01012056","Total",987,301,62,239,686,85,51,126,230,36,41,117
"2011","Middlesbrough 009E","E01012057","Total",759,190,71,119,569,44,75,110,149,32,56,103
"2011","Middlesbrough 010A","E01012082","Total",629,164,85,79,465,89,54,66,92,20,36,108
"2011","Middlesbrough 010B","E01012083","Total",620,147,70,77,473,98,53,94,101,14,37,76
"2011","Middlesbrough 010C","E01012084","Total",698,230,109,121,468,105,47,72,91,16,50,87
"2011","Middlesbrough 010D","E01012085","Total",584,140,50,90,444,87,64,69,99,14,38,73
"2011","Middlesbrough 011A","E01012018","Total",676,291,78,213,385,50,54,61,120,10,31,59
"2011","Middlesbrough 011B","E01012019","Total",583,209,92,117,374,99,56,65,75,19,26,34
"2011","Middlesbrough 011C","E01012020","Total",623,192,80,112,431,55,59,84,78,28,41,86
"2011","Middlesbrough 011D","E01012021","Total",544,143,62,81,401,76,47,73,82,19,52,52
"2011","Middlesbrough 012A","E01012007","Total",665,214,147,67,451,19,142,58,95,17,34,86
"2011","Middlesbrough 012B","E01012008","Total",535,116,68,48,419,28,71,84,91,16,43,86
"2011","Middlesbrough 012C","E01012009","Total",760,229,94,135,531,22,90,110,170,12,47,80
"2011","Middlesbrough 012D","E01012010","Total",538,116,74,42,422,11,104,58,99,18,35,97
"2011","Middlesbrough 013A","E01012046","Total",815,297,191,106,518,26,164,51,120,15,33,109
"2011","Middlesbrough 013B","E01012047","Total",582,126,85,41,456,25,93,88,68,31,59,92
"2011","Middlesbrough 013C","E01012048","Total",721,184,133,51,537,14,156,68,119,22,48,110
"2011","Middlesbrough 014A","E01012049","Total",637,197,86,111,440,27,79,71,130,10,29,94
"2011","Middlesbrough 014B","E01012050","Total",630,214,122,92,416,75,54,87,79,17,26,78
"2011","Middlesbrough 014C","E01012051","Total",534,133,62,71,401,66,57,62,81,20,43,72
"2011","Middlesbrough 014D","E01012052","Total",542,153,62,91,389,24,72,52,106,13,39,83
"2011","Middlesbrough 015A","E01012022","Total",631,165,69,96,466,27,53,83,143,9,36,115
"2011","Middlesbrough 015B","E01012023","Total",691,228,156,72,463,13,213,26,114,6,20,71
"2011","Middlesbrough 015C","E01012024","Total",643,162,100,62,481,34,129,75,101,7,29,106
"2011","Middlesbrough 015D","E01012025","Total",517,114,64,50,403,10,80,70,97,10,38,98
"2011","Middlesbrough 017A","E01012065","Total",761,204,115,89,557,38,176,99,143,12,20,69
"2011","Middlesbrough 017B","E01012066","Total",715,105,21,84,610,33,50,174,158,25,60,110
"2011","Middlesbrough 017C","E01012067","Total",729,208,142,66,521,13,175,73,132,12,27,89
"2011","Middlesbrough 018A","E01012042","Total",730,341,118,223,389,47,63,66,113,12,27,61
"2011","Middlesbrough 018B","E01012043","Total",625,164,96,68,461,21,127,72,103,10,37,91
"2011","Middlesbrough 018C","E01012044","Total",637,189,38,151,448,96,43,85,100,30,37,57
"2011","Middlesbrough 018D","E01012045","Total",603,185,75,110,418,93,29,79,100,21,34,62
"2011","Middlesbrough 018G","E01032552","Total",631,155,51,104,476,49,36,107,130,23,39,92
"2011","Middlesbrough 018H","E01032553","Total",598,208,115,93,390,9,134,59,120,6,15,47
"2011","Middlesbrough 019A","E01012030","Total",625,193,106,87,432,17,62,92,125,13,38,85
"2011","Middlesbrough 019B","E01012031","Total",771,305,108,197,466,40,88,88,149,13,23,65
"2011","Middlesbrough 019C","E01012032","Total",612,84,18,66,528,24,41,137,145,23,53,105
"2011","Middlesbrough 019D","E01012033","Total",647,326,136,190,321,36,54,43,94,6,22,66
"2011","Middlesbrough 019E","E01012034","Total",548,94,30,64,454,32,45,91,129,19,53,85
"2011","Middlesbrough 019F","E01012035","Total",624,243,128,115,381,35,67,57,99,14,36,73
"2011","Middlesbrough 020A","E01012062","Total",614,140,84,56,474,20,125,72,121,15,36,85
"2011","Middlesbrough 020B","E01012063","Total",638,181,119,62,457,16,110,83,144,11,20,73
"2011","Middlesbrough 020C","E01012064","Total",776,216,85,131,560,40,98,96,162,28,42,94
"2011","Middlesbrough 020D","E01012071","Total",574,84,65,19,490,6,161,69,107,16,43,88
"2011","Middlesbrough 020E","E01012073","Total",597,143,72,71,454,13,130,72,106,15,31,87
"2011","Middlesbrough 020F","E01032593","Total",728,131,87,44,597,13,133,113,130,20,53,135
"2011","Northumberland 004A","E01027356","Total",795,226,123,103,569,9,196,73,169,13,24,85
"2011","Northumberland 004B","E01027357","Total",515,103,68,35,412,5,124,59,114,15,32,63
"2011","Northumberland 004C","E01027366","Total",705,208,105,103,497,16,165,55,164,13,30,54
"2011","Northumberland 004D","E01027367","Total",675,135,67,68,540,32,101,168,131,25,33,50
"2011","Northumberland 005A","E01027358","Total",1012,434,218,216,578,24,128,96,180,10,29,111
"2011","Northumberland 005B","E01027359","Total",925,276,112,164,649,67,94,123,160,46,51,108
"2011","Northumberland 005D","E01033715","Total",577,291,124,167,286,18,81,45,93,3,15,31
"2011","Northumberland 005E","E01033717","Total",636,212,73,139,424,23,80,92,144,10,33,42
"2011","Northumberland 006A","E01027361","Total",974,350,162,188,624,50,115,101,186,13,41,118
"2011","Northumberland 006B","E01027362","Total",584,197,114,83,387,30,82,73,114,12,20,56
"2011","Northumberland 006C","E01027363","Total",508,138,88,50,370,48,79,61,87,17,22,56
"2011","Northumberland 006D","E01027364","Total",908,243,114,129,665,38,172,103,179,13,50,110
"2011","Northumberland 006E","E01027370","Total",787,159,101,58,628,18,155,82,204,14,41,114
"2011","Northumberland 006F","E01027371","Total",762,195,98,97,567,29,115,129,154,31,32,77
"2011","Northumberland 006G","E01027372","Total",985,263,137,126,722,14,238,89,240,13,25,103
"2011","Northumberland 007A","E01027365","Total",972,264,137,127,708,18,206,96,208,23,50,107
"2011","Northumberland 007B","E01027368","Total",789,228,116,112,561,19,129,97,202,17,26,71
"2011","Northumberland 007C","E01027369","Total",742,218,135,83,524,12,203,75,148,15,14,57
"2011","Northumberland 007D","E01027373","Total",904,238,107,131,666,18,181,87,247,27,39,67
"2011","Northumberland 001A","E01027376","Total",742,209,120,89,533,43,104,116,156,19,26,69
"2011","Northumberland 001B","E01027377","Total",908,427,193,234,481,21,133,58,181,12,17,59
"2011","Northumberland 001C","E01027385","Total",491,105,46,59,386,53,61,80,83,17,29,63
"2011","Northumberland 001D","E01027387","Total",863,357,146,211,506,41,120,75,164,14,26,66
"2011","Northumberland 001E","E01027388","Total",633,188,91,97,445,56,64,89,129,8,29,70
"2011","Northumberland 001F","E01027389","Total",692,205,84,121,487,21,93,105,151,16,34,67
"2011","Northumberland 002A","E01027378","Total",454,115,62,53,339,9,110,69,95,10,19,27
"2011","Northumberland 002B","E01027379","Total",624,158,85,73,466,11,155,71,142,9,26,52
"2011","Northumberland 002C","E01027380","Total",656,207,119,88,449,24,115,67,141,12,30,60
"2011","Northumberland 002D","E01027382","Total",796,251,138,113,545,22,170,81,173,10,27,62
"2011","Northumberland 002E","E01027386","Total",593,147,84,63,446,23,118,73,138,11,36,47
"2011","Northumberland 003A","E01027374","Total",976,315,172,143,661,25,190,83,216,19,38,90
"2011","Northumberland 003B","E01027375","Total",812,233,95,138,579,20,146,91,203,9,28,82
"2011","Northumberland 003C","E01027381","Total",852,250,108,142,602,15,175,90,200,16,30,76
"2011","Northumberland 003D","E01027383","Total",674,254,153,101,420,13,144,67,111,10,18,57
"2011","Northumberland 003E","E01027384","Total",725,263,137,126,462,19,165,51,139,11,22,55
"2011","Northumberland 003F","E01027390","Total",974,362,219,143,612,31,199,82,161,10,30,99
"2011","Northumberland 022A","E01027392","Total",781,330,144,186,451,64,83,68,112,28,33,63
"2011","Northumberland 022B","E01027393","Total",621,178,87,91,443,54,61,100,104,34,41,49
"2011","Northumberland 022C","E01027416","Total",759,333,127,206,426,86,55,100,107,17,19,42
"2011","Northumberland 022D","E01027424","Total",823,252,89,163,571,65,89,104,144,27,41,101
"2011","Northumberland 023A","E01027414","Total",649,215,53,162,434,44,71,80,126,12,34,67
"2011","Northumberland 023B","E01027415","Total",790,335,105,230,455,60,66,80,141,13,19,76
"2011","Northumberland 023C","E01027431","Total",897,403,114,289,494,76,75,98,163,9,14,59
"2011","Northumberland 023D","E01027441","Total",926,319,149,170,607,44,103,135,186,16,35,88
"2011","Northumberland 023E","E01027442","Total",805,384,176,208,421,18,54,82,155,7,30,75
"2011","Northumberland 024A","E01027391","Total",592,127,60,67,465,46,74,95,138,18,40,54
"2011","Northumberland 024B","E01027422","Total",845,304,132,172,541,55,102,115,140,30,38,61
"2011","Northumberland 024C","E01027423","Total",645,179,103,76,466,32,103,78,123,21,35,74
"2011","Northumberland 024D","E01027429","Total",886,347,182,165,539,75,93,103,152,15,24,77
"2011","Northumberland 024E","E01027430","Total",712,211,113,98,501,51,113,93,117,16,29,82
"2011","Northumberland 025A","E01027425","Total",922,194,78,116,728,34,127,145,218,26,58,120
"2011","Northumberland 025B","E01027426","Total",533,91,22,69,442,74,45,82,101,37,47,56
"2011","Northumberland 025C","E01027427","Total",827,346,132,214,481,76,106,68,131,15,21,64
"2011","Northumberland 025D","E01027428","Total",632,135,53,82,497,29,79,78,153,16,44,98
"2011","Northumberland 026A","E01027437","Total",760,149,68,81,611,23,128,103,205,9,40,103
"2011","Northumberland 026B","E01027438","Total",621,143,49,94,478,32,88,96,132,10,32,88
"2011","Northumberland 026C","E01027439","Total",759,118,42,76,641,30,96,163,193,17,41,101
"2011","Northumberland 026D","E01027440","Total",596,114,66,48,482,15,105,92,162,7,17,84
"2011","Northumberland 027A","E01027400","Total",488,64,12,52,424,22,28,176,113,4,34,47
"2011","Northumberland 027B","E01027401","Total",540,48,12,36,492,16,66,157,144,13,28,68
"2011","Northumberland 027C","E01027402","Total",491,62,14,48,429,14,56,112,120,9,38,80
"2011","Northumberland 027D","E01027403","Total",484,75,29,46,409,11,70,91,159,5,22,51
"2011","Northumberland 029A","E01027398","Total",894,214,61,153,680,73,67,135,202,52,54,97
"2011","Northumberland 029B","E01027409","Total",741,290,133,157,451,22,142,69,138,7,23,50
"2011","Northumberland 029C","E01027411","Total",624,236,123,113,388,34,100,59,120,11,17,47
"2011","Northumberland 029D","E01027412","Total",634,176,58,118,458,62,60,95,119,28,29,65
"2011","Northumberland 029E","E01027413","Total",821,225,80,145,596,61,105,103,192,18,25,92
"2011","Northumberland 028A","E01027395","Total",681,258,117,141,423,45,55,79,148,17,27,52
"2011","Northumberland 028B","E01027396","Total",568,142,56,86,426,38,66,84,127,21,34,56
"2011","Northumberland 028C","E01027397","Total",637,206,135,71,431,49,94,80,112,9,29,58
"2011","Northumberland 028D","E01027399","Total",595,100,17,83,495,18,39,117,196,12,29,84
"2011","Northumberland 028E","E01027404","Total",610,124,31,93,486,24,52,96,200,9,32,73
"2011","Northumberland 028F","E01027405","Total",641,140,58,82,501,16,111,81,190,3,28,72
"2011","Northumberland 030A","E01027417","Total",696,199,129,70,497,16,175,77,129,8,26,66
"2011","Northumberland 030B","E01027418","Total",788,204,91,113,584,33,84,138,189,12,26,102
"2011","Northumberland 030C","E01027419","Total",775,297,171,126,478,25,139,70,137,6,31,70
"2011","Northumberland 030D","E01027420","Total",611,148,101,47,463,17,115,67,146,10,15,93
"2011","Northumberland 030E","E01027421","Total",728,266,136,130,462,39,126,80,128,7,19,63
"2011","Northumberland 031A","E01027394","Total",536,160,59,101,376,19,86,62,122,2,15,70
"2011","Northumberland 031B","E01027406","Total",617,187,101,86,430,7,137,54,130,4,17,81
"2011","Northumberland 031C","E01027407","Total",618,198,72,126,420,17,93,55,155,3,17,80
"2011","Northumberland 031D","E01027408","Total",649,250,112,138,399,45,105,51,112,7,20,59
"2011","Northumberland 031E","E01027410","Total",665,131,68,63,534,12,138,104,152,16,31,81
"2011","Northumberland 032A","E01027432","Total",780,323,97,226,457,33,90,81,152,17,15,69
"2011","Northumberland 032B","E01027433","Total",773,270,97,173,503,42,84,107,157,13,28,72
"2011","Northumberland 032C","E01027434","Total",633,191,82,109,442,34,111,79,108,12,17,81
"2011","Northumberland 032D","E01027435","Total",671,223,88,135,448,27,97,71,147,14,21,71
"2011","Northumberland 032E","E01027436","Total",679,185,77,108,494,29,115,96,131,12,39,72
"2011","Northumberland 008A","E01027443","Total",675,223,105,118,452,57,87,89,128,15,23,53
"2011","Northumberland 008B","E01027444","Total",576,134,61,73,442,14,98,76,148,16,23,67
"2011","Northumberland 008C","E01027445","Total",682,161,69,92,521,23,119,82,167,15,29,86
"2011","Northumberland 008D","E01027446","Total",583,105,61,44,478,8,122,68,160,8,24,88
"2011","Northumberland 008E","E01027451","Total",814,277,139,138,537,68,84,104,143,24,34,80
"2011","Northumberland 008F","E01027474","Total",851,267,107,160,584,60,94,125,187,21,25,72
"2011","Northumberland 008G","E01027475","Total",641,157,83,74,484,20,136,65,176,9,26,52
"2011","Northumberland 011A","E01027457","Total",554,159,69,90,395,18,82,77,115,16,20,67
"2011","Northumberland 011B","E01027462","Total",883,351,157,194,532,44,94,124,140,21,32,77
"2011","Northumberland 011C","E01027463","Total",703,160,62,98,543,24,84,139,156,15,23,102
"2011","Northumberland 015A","E01027447","Total",768,200,83,117,568,19,118,94,197,24,34,82
"2011","Northumberland 015B","E01027448","Total",770,153,68,85,617,20,147,95,177,35,47,96
"2011","Northumberland 015C","E01027450","Total",696,142,66,76,554,17,143,103,179,13,35,64
"2011","Northumberland 015D","E01027473","Total",756,191,104,87,565,21,138,109,177,18,27,75
"2011","Northumberland 016A","E01027452","Total",651,230,81,149,421,24,96,67,134,10,23,67
"2011","Northumberland 016B","E01027453","Total",849,497,283,214,352,17,107,56,99,14,9,50
"2011","Northumberland 016E","E01027461","Total",614,202,98,104,412,61,95,47,101,14,23,71
"2011","Northumberland 016F","E01033718","Total",1010,403,216,187,607,59,127,104,170,18,33,96
"2011","Northumberland 018A","E01027455","Total",635,136,86,50,499,8,150,105,118,13,23,82
"2011","Northumberland 018B","E01027456","Total",525,73,50,23,452,4,139,71,103,9,34,92
"2011","Northumberland 018C","E01027458","Total",654,146,90,56,508,16,136,78,145,15,39,79
"2011","Northumberland 018D","E01027460","Total",734,196,107,89,538,19,151,112,138,15,25,78
"2011","Northumberland 033A","E01027464","Total",646,240,166,74,406,13,136,55,88,9,28,77
"2011","Northumberland 033B","E01027465","Total",644,188,119,69,456,15,118,79,106,11,38,89
"2011","Northumberland 033C","E01027466","Total",530,185,115,70,345,31,81,60,71,11,25,66
"2011","Northumberland 033F","E01033714","Total",972,215,128,87,757,12,264,115,149,34,62,121
"2011","Northumberland 034A","E01027449","Total",685,184,119,65,501,17,163,82,99,13,30,97
"2011","Northumberland 034B","E01027468","Total",516,87,70,17,429,5,159,50,86,18,25,86
"2011","Northumberland 034C","E01027469","Total",536,71,51,20,465,2,142,85,76,16,53,91
"2011","Northumberland 034D","E01027471","Total",642,94,60,34,548,10,178,93,110,22,34,101
"2011","Northumberland 034E","E01027472","Total",629,135,61,74,494,20,97,105,134,27,37,74
"2011","Northumberland 019A","E01027479","Total",1028,286,161,125,742,30,188,127,215,33,37,112
"2011","Northumberland 019B","E01027480","Total",520,137,50,87,383,10,90,62,106,11,22,82
"2011","Northumberland 019C","E01027503","Total",796,204,95,109,592,13,160,87,211,10,28,83
"2011","Northumberland 019D","E01027511","Total",495,130,67,63,365,8,94,49,126,9,12,67
"2011","Northumberland 037A","E01027484","Total",953,241,120,121,712,23,206,117,190,18,44,114
"2011","Northumberland 037B","E01027485","Total",696,252,122,130,444,29,114,71,115,23,18,74
"2011","Northumberland 037C","E01027486","Total",524,176,92,84,348,27,72,59,96,9,19,66
"2011","Northumberland 037D","E01027487","Total",531,173,91,82,358,18,79,62,114,13,16,56
"2011","Northumberland 037E","E01027512","Total",468,135,50,85,333,11,77,49,106,8,16,66
"2011","Northumberland 036A","E01027483","Total",559,147,58,89,412,12,85,76,139,13,15,72
"2011","Northumberland 036B","E01027496","Total",528,154,86,68,374,21,89,77,90,13,21,63
"2011","Northumberland 036C","E01027508","Total",482,130,61,69,352,12,62,70,127,11,16,54
"2011","Northumberland 036D","E01027513","Total",826,230,128,102,596,25,148,104,174,28,39,78
"2011","Northumberland 035A","E01027476","Total",1161,465,197,268,696,42,163,122,223,17,26,103
"2011","Northumberland 035B","E01027489","Total",650,145,69,76,505,26,108,89,127,18,35,102
"2011","Northumberland 035C","E01027490","Total",812,277,145,132,535,51,112,106,133,21,34,78
"2011","Northumberland 035D","E01027491","Total",642,145,86,59,497,6,157,70,119,21,36,88
"2011","Northumberland 035E","E01027492","Total",764,206,105,101,558,17,138,132,117,29,40,85
"2011","Northumberland 035F","E01027493","Total",677,236,112,124,441,51,96,76,108,13,24,73
"2011","Northumberland 035G","E01027494","Total",1019,355,188,167,664,33,184,109,180,11,35,112
"2011","Northumberland 038A","E01027497","Total",1013,167,57,110,846,58,101,229,233,39,50,136
"2011","Northumberland 038B","E01027498","Total",1167,371,160,211,796,87,147,173,197,32,38,122
"2011","Northumberland 038C","E01027499","Total",629,168,99,69,461,18,124,69,108,19,30,93
"2011","Northumberland 038D","E01027500","Total",763,280,134,146,483,45,93,79,141,21,31,73
"2011","Northumberland 038E","E01027501","Total",475,120,53,67,355,13,72,70,106,10,14,70
"2011","Northumberland 038F","E01027502","Total",486,90,39,51,396,13,59,72,125,9,36,82
"2011","Northumberland 039A","E01027481","Total",796,310,171,139,486,20,143,74,138,17,25,69
"2011","Northumberland 039B","E01027482","Total",685,209,133,76,476,10,134,65,134,11,29,93
"2011","Northumberland 039C","E01027504","Total",802,190,91,99,612,10,209,94,162,15,29,93
"2011","Northumberland 039D","E01027506","Total",468,104,38,66,364,9,83,65,114,16,25,52
"2011","Northumberland 039E","E01027507","Total",542,87,52,35,455,3,121,80,110,18,31,92
"2011","Northumberland 039F","E01027509","Total",612,181,114,67,431,11,124,82,119,11,17,67
"2011","Northumberland 040A","E01027477","Total",520,136,64,72,384,9,92,53,120,11,24,75
"2011","Northumberland 040B","E01027478","Total",502,182,107,75,320,7,91,45,91,12,19,55
"2011","Northumberland 040C","E01027488","Total",943,250,114,136,693,35,152,111,224,20,48,103
"2011","Northumberland 040D","E01027495","Total",459,116,49,67,343,13,106,53,80,16,26,49
"2011","Northumberland 040E","E01027505","Total",553,118,66,52,435,12,92,72,139,17,29,74
"2011","Northumberland 040F","E01027510","Total",510,134,62,72,376,21,82,77,112,9,20,55
"2011","Northumberland 009A","E01027541","Total",830,281,111,170,549,52,127,66,173,15,25,91
"2011","Northumberland 009B","E01027542","Total",843,307,160,147,536,83,122,84,125,23,31,68
"2011","Northumberland 009C","E01027543","Total",548,144,73,71,404,46,58,82,108,28,27,55
"2011","Northumberland 009D","E01027544","Total",632,218,100,118,414,29,112,52,104,11,25,81
"2011","Northumberland 010A","E01027528","Total",611,240,64,176,371,46,52,69,110,7,30,57
"2011","Northumberland 010B","E01027529","Total",482,132,49,83,350,15,50,61,100,13,25,86
"2011","Northumberland 010C","E01027539","Total",773,275,92,183,498,77,82,84,135,16,32,72
"2011","Northumberland 010D","E01027545","Total",927,307,108,199,620,102,82,126,173,20,26,91
"2011","Northumberland 010E","E01027546","Total",828,314,88,226,514,83,71,102,141,19,24,74
"2011","Northumberland 013A","E01027533","Total",902,429,156,273,473,61,109,89,125,18,21,50
"2011","Northumberland 013B","E01027540","Total",831,289,109,180,542,81,58,108,164,15,39,77
"2011","Northumberland 013E","E01027549","Total",586,91,22,69,495,27,43,134,141,16,35,99
"2011","Northumberland 013F","E01033716","Total",1050,323,144,179,727,49,181,120,183,29,49,116
"2011","Northumberland 012A","E01027524","Total",635,183,77,106,452,42,91,78,139,6,27,69
"2011","Northumberland 012B","E01027525","Total",859,395,217,178,464,26,109,85,136,12,34,62
"2011","Northumberland 012C","E01027526","Total",522,96,51,45,426,6,95,72,136,6,30,81
"2011","Northumberland 012D","E01027527","Total",605,215,100,115,390,49,58,76,111,14,19,63
"2011","Northumberland 012E","E01027536","Total",611,144,70,74,467,38,81,67,123,7,30,121
"2011","Northumberland 014A","E01027532","Total",837,211,75,136,626,30,116,121,218,6,29,106
"2011","Northumberland 014B","E01027537","Total",631,214,115,99,417,30,106,62,105,14,29,71
"2011","Northumberland 014C","E01027538","Total",720,140,66,74,580,18,107,134,152,12,42,115
"2011","Northumberland 017A","E01027530","Total",625,180,57,123,445,58,69,92,131,20,23,52
"2011","Northumberland 017B","E01027531","Total",715,202,67,135,513,34,71,114,172,22,34,66
"2011","Northumberland 017C","E01027534","Total",904,316,153,163,588,71,135,101,178,20,31,52
"2011","Northumberland 017D","E01027535","Total",658,149,96,53,509,15,185,69,150,8,26,56
"2011","Northumberland 017E","E01027553","Total",734,223,110,113,511,34,92,82,173,9,27,94
"2011","Northumberland 017F","E01027554","Total",621,164,98,66,457,28,153,65,117,7,18,69
"2011","Northumberland 020A","E01027515","Total",689,260,105,155,429,36,70,74,140,14,24,71
"2011","Northumberland 020B","E01027517","Total",879,307,107,200,572,32,86,124,191,16,23,100
"2011","Northumberland 020C","E01027518","Total",640,218,115,103,422,55,63,78,108,17,31,70
"2011","Northumberland 020D","E01027519","Total",635,220,86,134,415,67,54,94,91,18,30,61
"2011","Northumberland 020E","E01027550","Total",606,197,101,96,409,43,109,70,101,9,19,58
"2011","Northumberland 020F","E01027551","Total",631,207,83,124,424,47,72,75,114,22,31,63
"2011","Northumberland 020G","E01027552","Total",597,225,79,146,372,29,63,60,133,9,22,56
"2011","Northumberland 021A","E01027514","Total",709,188,115,73,521,27,140,85,141,13,24,91
"2011","Northumberland 021B","E01027516","Total",505,152,97,55,353,21,74,61,93,9,25,70
"2011","Northumberland 021C","E01027520","Total",594,116,52,64,478,12,96,95,132,18,39,86
"2011","Northumberland 021D","E01027521","Total",623,91,19,72,532,19,72,163,141,21,45,71
"2011","Northumberland 021E","E01027522","Total",624,233,105,128,391,50,83,65,105,7,19,62
"2011","Northumberland 021F","E01027523","Total",533,188,83,105,345,38,65,59,87,8,18,70
"2011","Redcar and Cleveland 001A","E01012100","Total",883,499,96,403,384,58,44,57,132,5,34,54
"2011","Redcar and Cleveland 001B","E01012101","Total",713,295,136,159,418,38,78,62,133,9,25,73
"2011","Redcar and Cleveland 001C","E01012102","Total",1038,351,83,268,687,129,74,145,216,19,25,79
"2011","Redcar and Cleveland 001D","E01012184","Total",636,197,97,100,439,43,68,94,109,15,27,83
"2011","Redcar and Cleveland 002A","E01012105","Total",567,171,111,60,396,30,63,80,77,13,40,93
"2011","Redcar and Cleveland 002B","E01012142","Total",724,217,131,86,507,28,123,107,106,19,39,85
"2011","Redcar and Cleveland 002C","E01012143","Total",529,184,72,112,345,76,41,61,58,19,34,56
"2011","Redcar and Cleveland 002D","E01012144","Total",612,174,85,89,438,26,94,57,134,8,30,89
"2011","Redcar and Cleveland 003C","E01012106","Total",604,184,106,78,420,28,108,66,97,11,32,78
"2011","Redcar and Cleveland 003D","E01012107","Total",666,280,170,110,386,39,69,71,95,15,30,67
"2011","Redcar and Cleveland 003E","E01032560","Total",457,114,70,44,343,10,107,51,71,9,24,71
"2011","Redcar and Cleveland 003F","E01032561","Total",659,188,60,128,471,103,45,88,123,12,32,68
"2011","Redcar and Cleveland 004A","E01012176","Total",661,200,132,68,461,11,138,80,119,7,21,85
"2011","Redcar and Cleveland 004B","E01012177","Total",615,150,62,88,465,18,73,121,128,10,39,76
"2011","Redcar and Cleveland 004C","E01012178","Total",605,164,84,80,441,30,81,81,121,14,35,79
"2011","Redcar and Cleveland 004D","E01012179","Total",635,178,90,88,457,31,114,90,114,12,33,63
"2011","Redcar and Cleveland 004E","E01012180","Total",613,73,19,54,540,22,53,165,114,11,67,108
"2011","Redcar and Cleveland 004F","E01012185","Total",633,176,97,79,457,52,75,87,124,15,22,82
"2011","Redcar and Cleveland 004G","E01012186","Total",748,239,141,98,509,25,113,90,148,12,31,90
"2011","Redcar and Cleveland 005A","E01012127","Total",517,258,95,163,259,48,34,46,68,14,20,29
"2011","Redcar and Cleveland 005B","E01012128","Total",542,224,121,103,318,45,52,46,95,13,30,37
"2011","Redcar and Cleveland 005C","E01012129","Total",854,172,92,80,682,33,148,130,187,16,60,108
"2011","Redcar and Cleveland 005D","E01012130","Total",588,163,81,82,425,23,104,60,133,6,23,76
"2011","Redcar and Cleveland 005E","E01012131","Total",652,288,164,124,364,62,86,44,59,22,34,57
"2011","Redcar and Cleveland 006A","E01012138","Total",1026,190,85,105,836,50,131,245,195,25,65,125
"2011","Redcar and Cleveland 006B","E01012139","Total",781,131,70,61,650,15,175,106,168,19,41,126
"2011","Redcar and Cleveland 006C","E01012140","Total",617,184,78,106,433,37,112,71,129,13,18,53
"2011","Redcar and Cleveland 006D","E01012141","Total",490,130,86,44,360,17,120,49,74,7,30,63
"2011","Redcar and Cleveland 006E","E01012154","Total",591,175,118,57,416,14,152,53,100,3,24,70
"2011","Redcar and Cleveland 006F","E01012155","Total",768,344,187,157,424,37,116,70,109,8,18,66
"2011","Redcar and Cleveland 006G","E01012156","Total",738,181,117,64,557,17,180,83,110,21,32,114
"2011","Redcar and Cleveland 006H","E01012157","Total",761,278,151,127,483,30,129,78,113,13,30,90
"2011","Redcar and Cleveland 007A","E01012158","Total",647,180,124,56,467,15,169,80,114,6,21,62
"2011","Redcar and Cleveland 007B","E01012159","Total",955,557,172,385,398,42,72,53,166,9,16,40
"2011","Redcar and Cleveland 007C","E01012160","Total",606,192,103,89,414,26,75,77,115,7,31,83
"2011","Redcar and Cleveland 007D","E01012161","Total",657,257,108,149,400,44,81,76,110,17,22,50
"2011","Redcar and Cleveland 009A","E01012113","Total",558,144,59,85,414,83,38,94,83,25,29,62
"2011","Redcar and Cleveland 009B","E01012114","Total",648,237,59,178,411,104,33,82,113,13,24,42
"2011","Redcar and Cleveland 009E","E01012175","Total",636,218,100,118,418,89,53,74,90,12,34,66
"2011","Redcar and Cleveland 009F","E01033471","Total",874,211,64,147,663,156,48,130,139,27,61,102
"2011","Redcar and Cleveland 010A","E01012095","Total",543,89,49,40,454,22,104,92,135,13,21,67
"2011","Redcar and Cleveland 010B","E01012097","Total",512,127,82,45,385,16,126,41,99,13,28,62
"2011","Redcar and Cleveland 010C","E01012098","Total",553,137,43,94,416,24,76,91,121,10,31,63
"2011","Redcar and Cleveland 010D","E01012099","Total",683,237,79,158,446,61,53,89,125,23,31,64
"2011","Redcar and Cleveland 011A","E01012108","Total",618,174,82,92,444,74,76,67,89,12,42,84
"2011","Redcar and Cleveland 011B","E01012109","Total",605,193,66,127,412,39,66,62,135,6,18,86
"2011","Redcar and Cleveland 011C","E01012110","Total",622,198,62,136,424,29,48,84,145,5,19,94
"2011","Redcar and Cleveland 011D","E01012111","Total",642,300,192,108,342,26,65,61,88,3,28,71
"2011","Redcar and Cleveland 011E","E01012171","Total",660,236,141,95,424,44,106,59,92,7,31,85
"2011","Redcar and Cleveland 011F","E01012172","Total",625,179,116,63,446,24,125,70,112,12,21,82
"2011","Redcar and Cleveland 012A","E01012162","Total",624,175,61,114,449,41,66,104,130,21,32,55
"2011","Redcar and Cleveland 012B","E01012163","Total",832,148,66,82,684,22,122,143,179,26,54,138
"2011","Redcar and Cleveland 012C","E01012164","Total",748,227,93,134,521,44,113,77,173,12,18,84
"2011","Redcar and Cleveland 012D","E01012165","Total",985,320,147,173,665,82,112,136,184,30,41,80
"2011","Redcar and Cleveland 013A","E01012096","Total",707,250,87,163,457,59,71,92,107,23,44,61
"2011","Redcar and Cleveland 013D","E01012136","Total",637,217,71,146,420,37,75,67,147,10,32,52
"2011","Redcar and Cleveland 013E","E01033473","Total",910,304,138,166,606,82,104,98,141,29,51,101
"2011","Redcar and Cleveland 015A","E01012112","Total",783,405,129,276,378,68,55,51,109,16,30,49
"2011","Redcar and Cleveland 015B","E01012145","Total",670,227,107,120,443,42,73,81,127,9,32,79
"2011","Redcar and Cleveland 015C","E01012147","Total",670,154,81,73,516,19,132,95,130,10,22,108
"2011","Redcar and Cleveland 015D","E01012149","Total",497,110,65,45,387,11,101,63,90,6,28,88
"2011","Redcar and Cleveland 016A","E01012132","Total",922,294,143,151,628,53,169,87,154,14,44,107
"2011","Redcar and Cleveland 016B","E01012134","Total",697,248,144,104,449,14,114,64,141,14,26,76
"2011","Redcar and Cleveland 016C","E01012137","Total",549,126,57,69,423,17,96,64,106,14,37,89
"2011","Redcar and Cleveland 016D","E01012181","Total",713,213,91,122,500,57,72,112,125,14,39,81
"2011","Redcar and Cleveland 018A","E01012117","Total",782,393,196,197,389,42,96,57,137,3,10,44
"2011","Redcar and Cleveland 018B","E01012118","Total",656,249,120,129,407,43,64,63,133,8,29,67
"2011","Redcar and Cleveland 018C","E01012119","Total",880,241,122,119,639,74,89,138,158,23,43,114
"2011","Redcar and Cleveland 018D","E01012121","Total",615,251,108,143,364,35,62,66,83,16,35,67
"2011","Redcar and Cleveland 019E","E01032548","Total",715,170,125,45,545,11,222,71,133,12,27,69
"2011","Redcar and Cleveland 019F","E01032549","Total",659,138,67,71,521,15,130,87,134,18,31,106
"2011","Redcar and Cleveland 019G","E01033472","Total",1063,278,102,176,785,85,104,165,227,17,55,132
"2011","Redcar and Cleveland 020A","E01012120","Total",631,196,115,81,435,16,163,55,111,5,21,64
"2011","Redcar and Cleveland 020B","E01012124","Total",620,131,76,55,489,12,157,74,139,5,28,74
"2011","Redcar and Cleveland 020C","E01012182","Total",598,145,89,56,453,5,140,60,120,14,24,90
"2011","Redcar and Cleveland 020D","E01012183","Total",620,127,56,71,493,11,69,117,164,12,41,79
"2011","Redcar and Cleveland 021A","E01012148","Total",672,281,79,202,391,58,58,60,104,14,34,63
"2011","Redcar and Cleveland 021B","E01012150","Total",711,256,99,157,455,84,86,64,96,9,31,85
"2011","Redcar and Cleveland 021C","E01012151","Total",650,186,121,65,464,14,154,70,89,6,32,99
"2011","Redcar and Cleveland 021D","E01012152","Total",684,173,102,71,511,23,119,83,146,10,26,104
"2011","Redcar and Cleveland 021E","E01032594","Total",637,211,140,71,426,18,136,66,100,12,24,70
"2011","Redcar and Cleveland 022A","E01012146","Total",516,100,57,43,416,10,129,49,106,14,19,89
"2011","Redcar and Cleveland 022B","E01012167","Total",590,143,61,82,447,42,67,92,93,12,36,105
"2011","Redcar and Cleveland 022C","E01012168","Total",819,242,122,120,577,68,69,118,150,16,50,106
"2011","Redcar and Cleveland 022D","E01012170","Total",568,194,82,112,374,79,39,56,91,21,30,58
"2011","Redcar and Cleveland 022E","E01012173","Total",518,149,97,52,369,18,102,47,87,8,28,79
"2011","Redcar and Cleveland 022F","E01012174","Total",481,122,86,36,359,11,113,50,70,5,30,80
"2011","Redcar and Cleveland 022G","E01033470","Total",809,323,101,222,486,75,65,72,123,10,49,92
"2011","Stockton-on-Tees 001A","E01012242","Total",627,153,87,66,474,14,112,82,111,15,32,108
"2011","Stockton-on-Tees 001B","E01012243","Total",665,176,58,118,489,25,67,111,151,9,37,89
"2011","Stockton-on-Tees 001C","E01012244","Total",620,160,72,88,460,27,81,75,137,10,33,97
"2011","Stockton-on-Tees 001D","E01012246","Total",574,98,25,73,476,18,63,91,160,8,33,103
"2011","Stockton-on-Tees 001E","E01012296","Total",598,205,104,101,393,18,75,73,116,11,26,74
"2011","Stockton-on-Tees 001F","E01012297","Total",978,141,44,97,837,29,106,197,235,28,75,167
"2011","Stockton-on-Tees 002A","E01012197","Total",809,192,78,114,617,92,78,138,145,29,48,87
"2011","Stockton-on-Tees 002B","E01012256","Total",630,187,117,70,443,20,170,44,101,6,13,89
"2011","Stockton-on-Tees 002C","E01012257","Total",632,175,121,54,457,19,135,75,102,12,28,86
"2011","Stockton-on-Tees 002D","E01012275","Total",625,157,87,70,468,58,83,75,96,15,47,94
"2011","Stockton-on-Tees 002E","E01012276","Total",839,382,180,202,457,42,98,68,139,12,21,77
"2011","Stockton-on-Tees 002F","E01012277","Total",704,205,115,90,499,67,79,99,115,18,31,90
"2011","Stockton-on-Tees 003A","E01012196","Total",674,173,97,76,501,50,70,96,115,16,39,115
"2011","Stockton-on-Tees 003B","E01012198","Total",610,183,63,120,427,60,56,71,99,20,45,76
"2011","Stockton-on-Tees 003C","E01012214","Total",643,134,58,76,509,61,99,93,107,22,51,76
"2011","Stockton-on-Tees 003D","E01012215","Total",498,149,58,91,349,56,49,55,66,29,28,66
"2011","Stockton-on-Tees 003E","E01012216","Total",519,130,54,76,389,58,68,72,63,15,35,78
"2011","Stockton-on-Tees 003F","E01012245","Total",729,255,86,169,474,56,105,78,112,21,28,74
"2011","Stockton-on-Tees 004A","E01012278","Total",501,103,43,60,398,47,55,77,104,16,36,63
"2011","Stockton-on-Tees 004B","E01012279","Total",637,113,36,77,524,41,47,119,128,34,43,112
"2011","Stockton-on-Tees 004C","E01012280","Total",649,154,93,61,495,28,124,69,125,26,33,90
"2011","Stockton-on-Tees 004D","E01012281","Total",642,280,156,124,362,58,61,57,90,18,28,50
"2011","Stockton-on-Tees 005A","E01012255","Total",646,165,116,49,481,7,209,49,89,7,32,88
"2011","Stockton-on-Tees 005B","E01012269","Total",668,154,73,81,514,10,126,102,128,15,36,97
"2011","Stockton-on-Tees 005D","E01012294","Total",481,101,50,51,380,7,96,61,109,17,28,62
"2011","Stockton-on-Tees 005E","E01012295","Total",495,116,52,64,379,31,57,85,111,15,19,61
"2011","Stockton-on-Tees 005F","E01033476","Total",597,64,16,48,533,15,60,149,171,17,47,74
"2011","Stockton-on-Tees 005G","E01033480","Total",630,73,28,45,557,12,121,86,160,11,41,126
"2011","Stockton-on-Tees 006A","E01012210","Total",640,115,52,63,525,18,115,77,147,15,31,122
"2011","Stockton-on-Tees 006B","E01012211","Total",750,169,80,89,581,29,94,140,170,18,34,96
"2011","Stockton-on-Tees 006C","E01012212","Total",683,198,88,110,485,13,121,76,169,8,16,82
"2011","Stockton-on-Tees 006D","E01012213","Total",735,311,226,85,424,18,143,42,121,9,19,72
"2011","Stockton-on-Tees 007A","E01012192","Total",748,268,118,150,480,38,112,69,135,15,34,77
"2011","Stockton-on-Tees 007B","E01012193","Total",605,139,64,75,466,63,56,90,120,17,44,76
"2011","Stockton-on-Tees 007C","E01012260","Total",814,314,154,160,500,19,132,71,153,18,24,83
"2011","Stockton-on-Tees 007D","E01012261","Total",703,232,76,156,471,32,77,113,154,13,18,64
"2011","Stockton-on-Tees 008A","E01012247","Total",508,141,77,64,367,43,37,59,96,18,43,71
"2011","Stockton-on-Tees 008B","E01012249","Total",640,193,119,74,447,62,63,69,101,18,39,95
"2011","Stockton-on-Tees 008C","E01012271","Total",575,142,51,91,433,80,34,81,104,32,42,60
"2011","Stockton-on-Tees 008D","E01012272","Total",493,153,78,75,340,6,116,36,85,3,27,67
"2011","Stockton-on-Tees 008E","E01012273","Total",642,180,64,116,462,86,43,84,99,24,42,84
"2011","Stockton-on-Tees 008F","E01012274","Total",500,108,48,60,392,35,55,77,81,17,51,76
"2011","Stockton-on-Tees 009D","E01012248","Total",647,212,104,108,435,41,92,62,115,17,36,72
"2011","Stockton-on-Tees 009E","E01012250","Total",635,236,104,132,399,56,70,62,85,22,32,72
"2011","Stockton-on-Tees 009F","E01032542","Total",446,121,65,56,325,53,23,74,93,21,29,32
"2011","Stockton-on-Tees 009G","E01032543","Total",877,227,100,127,650,111,80,111,140,33,53,122
"2011","Stockton-on-Tees 009H","E01032544","Total",751,153,38,115,598,78,30,163,157,22,50,98
"2011","Stockton-on-Tees 010A","E01012194","Total",647,178,53,125,469,69,62,113,131,15,24,55
"2011","Stockton-on-Tees 010B","E01012195","Total",684,248,91,157,436,97,42,82,98,23,38,56
"2011","Stockton-on-Tees 010C","E01012258","Total",529,219,97,122,310,45,54,45,84,15,28,39
"2011","Stockton-on-Tees 010D","E01012259","Total",776,230,96,134,546,45,86,104,165,17,35,94
"2011","Stockton-on-Tees 010E","E01012268","Total",755,295,80,215,460,81,48,80,135,13,35,68
"2011","Stockton-on-Tees 011A","E01012187","Total",538,86,29,57,452,27,73,84,130,12,35,91
"2011","Stockton-on-Tees 011B","E01012188","Total",491,104,39,65,387,15,58,81,113,9,21,90
"2011","Stockton-on-Tees 011C","E01012189","Total",631,181,118,63,450,16,132,63,117,9,27,86
"2011","Stockton-on-Tees 011D","E01012205","Total",634,185,86,99,449,19,113,81,134,6,22,74
"2011","Stockton-on-Tees 012A","E01012219","Total",693,145,72,73,548,31,88,99,135,15,46,134
"2011","Stockton-on-Tees 012B","E01012251","Total",648,152,49,103,496,77,49,100,115,32,50,73
"2011","Stockton-on-Tees 012C","E01012252","Total",634,199,80,119,435,112,26,89,88,23,36,61
"2011","Stockton-on-Tees 012D","E01012253","Total",484,129,65,64,355,29,60,63,54,13,48,88
"2011","Stockton-on-Tees 012E","E01012254","Total",644,230,41,189,414,105,31,57,111,13,38,59
"2011","Stockton-on-Tees 013A","E01012204","Total",625,170,108,62,455,12,160,44,137,4,18,80
"2011","Stockton-on-Tees 013B","E01012206","Total",716,290,193,97,426,31,109,57,120,8,22,79
"2011","Stockton-on-Tees 013C","E01012207","Total",782,200,125,75,582,16,143,114,137,31,47,94
"2011","Stockton-on-Tees 013D","E01012208","Total",642,138,82,56,504,13,104,93,117,13,49,115
"2011","Stockton-on-Tees 014A","E01012262","Total",810,277,57,220,533,93,45,96,156,25,44,74
"2011","Stockton-on-Tees 014C","E01012264","Total",1036,340,94,246,696,70,67,136,239,32,43,109
"2011","Stockton-on-Tees 014E","E01012266","Total",1149,562,154,408,587,122,68,105,145,34,41,72
"2011","Stockton-on-Tees 014F","E01012267","Total",855,426,166,260,429,58,63,55,135,16,27,75
"2011","Stockton-on-Tees 014G","E01033477","Total",1136,599,111,488,537,50,38,71,166,36,73,103
"2011","Stockton-on-Tees 015A","E01012190","Total",632,141,57,84,491,24,101,91,142,11,25,97
"2011","Stockton-on-Tees 015B","E01012191","Total",713,253,173,80,460,29,127,53,91,19,41,100
"2011","Stockton-on-Tees 015C","E01012224","Total",769,188,122,66,581,18,172,106,146,15,27,97
"2011","Stockton-on-Tees 015D","E01012225","Total",647,163,102,61,484,17,139,65,107,9,39,108
"2011","Stockton-on-Tees 015E","E01012226","Total",600,136,78,58,464,12,146,67,120,4,33,82
"2011","Stockton-on-Tees 016A","E01012209","Total",676,174,94,80,502,13,100,85,123,14,57,110
"2011","Stockton-on-Tees 016B","E01012217","Total",750,336,74,262,414,64,47,86,128,11,30,48
"2011","Stockton-on-Tees 016C","E01012218","Total",615,147,86,61,468,30,96,88,101,17,40,96
"2011","Stockton-on-Tees 016D","E01012223","Total",629,129,80,49,500,19,142,87,122,18,28,84
"2011","Stockton-on-Tees 017A","E01012286","Total",663,230,53,177,433,87,38,77,128,15,17,71
"2011","Stockton-on-Tees 017B","E01012287","Total",945,471,100,371,474,53,31,53,217,6,17,97
"2011","Stockton-on-Tees 017C","E01012288","Total",621,199,82,117,422,82,46,80,95,12,35,72
"2011","Stockton-on-Tees 017D","E01012289","Total",510,163,81,82,347,32,45,53,88,19,34,76
"2011","Stockton-on-Tees 018A","E01012238","Total",641,180,88,92,461,60,62,69,117,19,40,94
"2011","Stockton-on-Tees 018B","E01012239","Total",783,181,71,110,602,103,42,130,172,33,51,71
"2011","Stockton-on-Tees 018C","E01012240","Total",763,191,96,95,572,51,95,90,170,14,47,105
"2011","Stockton-on-Tees 018D","E01012241","Total",611,123,57,66,488,22,88,87,148,8,30,105
"2011","Stockton-on-Tees 019A","E01012290","Total",829,265,170,95,564,27,191,76,140,10,31,89
"2011","Stockton-on-Tees 019B","E01012291","Total",698,167,93,74,531,65,76,102,124,24,42,98
"2011","Stockton-on-Tees 019C","E01012292","Total",1058,391,136,255,667,78,83,134,202,26,58,86
"2011","Stockton-on-Tees 020A","E01012282","Total",539,131,47,84,408,64,65,70,91,9,31,78
"2011","Stockton-on-Tees 020B","E01012283","Total",547,158,60,98,389,70,50,59,95,19,32,64
"2011","Stockton-on-Tees 020C","E01012284","Total",649,179,93,86,470,50,126,70,114,16,32,62
"2011","Stockton-on-Tees 020D","E01012285","Total",620,199,90,109,421,32,93,43,140,11,25,77
"2011","Stockton-on-Tees 021A","E01012199","Total",614,135,63,72,479,16,125,76,129,10,33,90
"2011","Stockton-on-Tees 021B","E01012200","Total",889,231,125,106,658,36,159,108,200,22,29,104
"2011","Stockton-on-Tees 021C","E01012201","Total",737,157,106,51,580,29,179,122,103,19,32,96
"2011","Stockton-on-Tees 021D","E01012202","Total",624,195,80,115,429,28,71,83,130,19,32,66
"2011","Stockton-on-Tees 021E","E01012203","Total",687,129,48,81,558,39,62,153,151,12,40,101
"2011","Stockton-on-Tees 021F","E01012270","Total",586,178,89,89,408,26,75,84,106,10,38,69
"2011","Stockton-on-Tees 022A","E01012228","Total",529,106,32,74,423,21,43,126,109,14,37,73
"2011","Stockton-on-Tees 022B","E01012230","Total",599,109,27,82,490,40,47,114,142,22,43,82
"2011","Stockton-on-Tees 022C","E01012233","Total",564,102,56,46,462,10,97,99,130,15,36,75
"2011","Stockton-on-Tees 022D","E01012236","Total",538,117,37,80,421,22,63,84,128,14,31,79
"2011","Stockton-on-Tees 022E","E01012237","Total",496,63,28,35,433,12,61,79,121,17,45,98
"2011","Stockton-on-Tees 023A","E01012227","Total",590,118,20,98,472,51,19,154,143,24,36,45
"2011","Stockton-on-Tees 023C","E01012231","Total",685,101,15,86,584,43,23,222,133,35,61,67
"2011","Stockton-on-Tees 023D","E01012232","Total",545,99,21,78,446,37,29,121,142,21,34,62
"2011","Stockton-on-Tees 023E","E01012234","Total",580,74,17,57,506,20,37,143,128,25,64,89
"2011","Stockton-on-Tees 023F","E01033474","Total",619,117,7,110,502,45,8,187,179,23,24,36
"2011","Stockton-on-Tees 023G","E01033475","Total",575,53,4,49,522,26,10,217,115,33,68,53
"2011","Stockton-on-Tees 023H","E01033478","Total",582,47,6,41,535,14,27,220,87,35,67,85
"2011","Stockton-on-Tees 023I","E01033479","Total",616,70,15,55,546,32,45,180,130,31,52,76
"2011","Stockton-on-Tees 024A","E01012235","Total",461,82,46,36,379,5,120,47,112,11,26,58
"2011","Stockton-on-Tees 024B","E01012298","Total",544,81,40,41,463,5,117,76,119,12,30,104
"2011","Stockton-on-Tees 024C","E01012299","Total",736,287,75,212,449,46,80,73,157,18,16,59
"2011","Stockton-on-Tees 024D","E01012300","Total",747,284,171,113,463,37,127,77,118,8,27,69
"2011","Stockton-on-Tees 024E","E01012301","Total",564,119,49,70,445,18,79,86,139,9,29,85
"2011","Stockton-on-Tees 024F","E01012302","Total",487,102,39,63,385,20,73,62,124,8,29,69
"2011","Stockton-on-Tees 024G","E01012303","Total",606,162,58,104,444,21,69,78,155,11,22,88
"2011","Gateshead 001A","E01008246","Total",633,199,87,112,434,47,72,100,106,18,33,58
"2011","Gateshead 001B","E01008247","Total",761,293,143,150,468,39,120,80,101,11,37,80
"2011","Gateshead 001C","E01008248","Total",724,148,58,90,576,21,85,134,202,13,31,90
"2011","Gateshead 001D","E01008249","Total",721,191,125,66,530,14,201,71,149,7,11,77
"2011","Gateshead 001E","E01008250","Total",592,133,59,74,459,40,72,93,121,15,37,81
"2011","Gateshead 002A","E01008195","Total",881,253,108,145,628,54,76,134,194,33,37,100
"2011","Gateshead 002B","E01008197","Total",695,219,80,139,476,21,88,93,161,9,15,89
"2011","Gateshead 002C","E01008198","Total",600,182,110,72,418,46,95,65,97,23,25,67
"2011","Gateshead 002D","E01008199","Total",636,229,74,155,407,29,77,77,129,9,14,72
"2011","Gateshead 002E","E01008200","Total",558,120,48,72,438,20,91,90,121,6,20,90
"2011","Gateshead 002F","E01008245","Total",632,167,109,58,465,14,124,86,124,7,27,83
"2011","Gateshead 003A","E01008214","Total",746,253,101,152,493,100,61,85,132,8,37,70
"2011","Gateshead 003B","E01008215","Total",823,399,81,318,424,63,38,59,155,19,23,67
"2011","Gateshead 003C","E01008243","Total",733,238,136,102,495,29,126,77,156,3,23,81
"2011","Gateshead 003D","E01008244","Total",1009,362,93,269,647,76,80,126,234,10,25,96
"2011","Gateshead 004A","E01008178","Total",687,142,29,113,545,72,41,115,194,27,26,70
"2011","Gateshead 004B","E01008180","Total",636,181,84,97,455,76,82,88,83,22,27,77
"2011","Gateshead 004C","E01008182","Total",744,262,112,150,482,54,61,124,143,13,22,65
"2011","Gateshead 004D","E01008277","Total",668,199,124,75,469,18,142,75,95,16,39,84
"2011","Gateshead 004E","E01008280","Total",877,366,155,211,511,52,84,100,125,18,39,93
"2011","Gateshead 005A","E01008177","Total",609,188,77,111,421,33,75,70,132,11,29,71
"2011","Gateshead 005B","E01008179","Total",519,143,48,95,376,24,47,91,122,8,34,50
"2011","Gateshead 005C","E01008181","Total",644,153,83,70,491,34,114,86,149,8,26,74
"2011","Gateshead 005D","E01008276","Total",741,301,167,134,440,35,90,90,141,4,21,59
"2011","Gateshead 005E","E01008279","Total",655,204,109,95,451,4,156,51,103,6,36,95
"2011","Gateshead 007A","E01008209","Total",990,349,116,233,641,71,78,112,248,9,43,80
"2011","Gateshead 007B","E01008210","Total",617,203,77,126,414,50,48,78,134,15,34,55
"2011","Gateshead 007C","E01008258","Total",1154,466,95,371,688,108,36,139,290,12,36,67
"2011","Gateshead 007D","E01008259","Total",1038,555,148,407,483,56,61,85,160,13,33,75
"2011","Gateshead 008A","E01008167","Total",721,255,70,185,466,44,45,80,170,16,33,78
"2011","Gateshead 008B","E01008169","Total",416,101,20,81,315,19,23,44,49,54,75,51
"2011","Gateshead 008C","E01008170","Total",986,426,127,299,560,52,60,96,214,13,36,89
"2011","Gateshead 008D","E01008171","Total",559,249,56,193,310,51,24,53,101,21,15,45
"2011","Gateshead 008E","E01008257","Total",669,270,120,150,399,36,79,56,104,13,28,83
"2011","Gateshead 009A","E01008262","Total",789,276,80,196,513,59,42,104,182,16,34,76
"2011","Gateshead 009B","E01008263","Total",672,199,69,130,473,80,61,98,123,14,29,68
"2011","Gateshead 009C","E01008264","Total",599,139,95,44,460,5,131,109,100,6,32,77
"2011","Gateshead 009D","E01008265","Total",622,165,64,101,457,60,69,90,114,14,36,74
"2011","Gateshead 009E","E01008266","Total",643,217,129,88,426,14,105,73,136,12,23,63
"2011","Gateshead 010A","E01008251","Total",913,421,83,338,492,39,53,87,213,9,20,71
"2011","Gateshead 010B","E01008252","Total",729,284,69,215,445,47,51,58,144,39,47,59
"2011","Gateshead 010C","E01008253","Total",818,328,45,283,490,66,27,79,208,12,28,70
"2011","Gateshead 010D","E01008254","Total",663,279,59,220,384,51,31,83,132,9,14,64
"2011","Gateshead 010E","E01008255","Total",753,228,119,109,525,41,101,95,141,11,38,98
"2011","Gateshead 011A","E01008165","Total",594,183,42,141,411,53,56,55,106,17,35,89
"2011","Gateshead 011B","E01008201","Total",629,189,76,113,440,63,55,77,84,29,56,76
"2011","Gateshead 011C","E01008202","Total",803,215,58,157,588,82,62,136,174,14,32,88
"2011","Gateshead 011D","E01008204","Total",739,278,96,182,461,89,64,71,123,13,28,73
"2011","Gateshead 012A","E01008212","Total",694,282,95,187,412,70,63,73,125,9,12,60
"2011","Gateshead 012B","E01008213","Total",645,190,122,68,455,31,105,71,100,12,39,97
"2011","Gateshead 012C","E01008216","Total",743,314,154,160,429,50,85,63,123,13,22,73
"2011","Gateshead 012D","E01008228","Total",551,195,100,95,356,51,54,56,89,8,25,73
"2011","Gateshead 013A","E01008206","Total",741,217,101,116,524,35,105,119,111,16,34,104
"2011","Gateshead 013B","E01008207","Total",591,112,66,46,479,17,99,82,150,10,32,89
"2011","Gateshead 013C","E01008208","Total",739,256,108,148,483,50,85,84,127,18,37,82
"2011","Gateshead 013D","E01008211","Total",743,196,81,115,547,46,98,80,165,10,42,106
"2011","Gateshead 014A","E01008283","Total",604,168,56,112,436,9,91,64,158,4,21,89
"2011","Gateshead 014B","E01008284","Total",617,153,66,87,464,37,89,81,118,17,24,98
"2011","Gateshead 014C","E01008286","Total",661,193,108,85,468,51,94,81,128,7,34,73
"2011","Gateshead 014D","E01008287","Total",820,198,101,97,622,33,42,185,192,22,55,93
"2011","Gateshead 015A","E01008231","Total",689,185,88,97,504,79,78,96,129,13,22,87
"2011","Gateshead 015B","E01008240","Total",643,164,96,68,479,38,98,97,118,13,33,82
"2011","Gateshead 015C","E01008241","Total",710,193,129,64,517,45,124,90,128,11,38,81
"2011","Gateshead 015D","E01008242","Total",701,213,111,102,488,68,78,108,94,19,38,83
"2011","Gateshead 015E","E01008281","Total",657,206,135,71,451,55,78,83,116,16,30,73
"2011","Gateshead 015F","E01008282","Total",665,229,95,134,436,57,77,78,98,18,33,75
"2011","Gateshead 016A","E01008219","Total",725,232,84,148,493,45,71,117,128,9,34,89
"2011","Gateshead 016B","E01008235","Total",630,142,73,69,488,19,114,85,144,7,29,90
"2011","Gateshead 016C","E01008236","Total",761,321,157,164,440,36,105,74,132,5,22,66
"2011","Gateshead 016D","E01008237","Total",593,97,56,41,496,10,97,123,126,15,41,84
"2011","Gateshead 016E","E01008238","Total",677,207,79,128,470,20,56,108,167,19,31,69
"2011","Gateshead 017A","E01008267","Total",700,244,161,83,456,22,160,69,102,17,22,64
"2011","Gateshead 017B","E01008269","Total",645,154,94,60,491,7,154,95,122,14,22,77
"2011","Gateshead 017C","E01008270","Total",603,152,110,42,451,9,170,71,110,9,14,68
"2011","Gateshead 017D","E01008271","Total",606,144,66,78,462,14,112,88,134,11,14,89
"2011","Gateshead 017E","E01008275","Total",648,138,82,56,510,18,135,85,144,11,25,92
"2011","Gateshead 018A","E01008229","Total",635,195,135,60,440,18,136,62,106,8,14,96
"2011","Gateshead 018B","E01008230","Total",630,242,113,129,388,23,65,90,105,8,35,62
"2011","Gateshead 018C","E01008232","Total",589,167,81,86,422,68,79,83,86,16,25,65
"2011","Gateshead 018D","E01008233","Total",606,168,52,116,438,11,87,74,145,5,24,92
"2011","Gateshead 018E","E01008285","Total",664,239,103,136,425,77,65,60,112,13,29,69
"2011","Gateshead 019A","E01008256","Total",775,217,117,100,558,35,96,113,163,11,32,108
"2011","Gateshead 019B","E01008260","Total",629,136,56,80,493,15,64,125,154,10,31,94
"2011","Gateshead 019C","E01008261","Total",642,220,98,122,422,54,72,81,83,14,27,91
"2011","Gateshead 019D","E01008268","Total",628,162,82,80,466,27,99,96,116,15,21,92
"2011","Gateshead 019E","E01008272","Total",651,198,132,66,453,18,147,86,108,7,13,74
"2011","Gateshead 019F","E01008273","Total",628,177,59,118,451,34,59,104,127,12,27,88
"2011","Gateshead 019G","E01008274","Total",632,186,64,122,446,60,70,85,115,12,30,74
"2011","Gateshead 020A","E01008193","Total",493,122,84,38,371,10,86,72,98,7,26,72
"2011","Gateshead 020B","E01008194","Total",602,159,98,61,443,10,115,79,118,11,27,83
"2011","Gateshead 020C","E01008234","Total",1034,424,217,207,610,20,141,130,175,14,24,106
"2011","Gateshead 020D","E01008239","Total",634,158,68,90,476,14,85,100,146,9,27,95
"2011","Gateshead 021A","E01008218","Total",766,326,180,146,440,42,76,70,114,13,39,86
"2011","Gateshead 021B","E01008220","Total",576,254,82,172,322,76,45,40,54,21,35,51
"2011","Gateshead 021C","E01008221","Total",718,220,92,128,498,55,70,101,111,22,51,88
"2011","Gateshead 021D","E01008225","Total",800,265,114,151,535,37,121,86,163,9,19,100
"2011","Gateshead 021E","E01008227","Total",662,168,30,138,494,114,37,81,110,28,53,71
"2011","Gateshead 022A","E01008184","Total",641,166,90,76,475,8,170,83,125,9,19,61
"2011","Gateshead 022B","E01008185","Total",581,167,102,65,414,37,91,74,87,17,38,70
"2011","Gateshead 022C","E01008188","Total",610,156,101,55,454,29,105,81,118,11,43,67
"2011","Gateshead 022D","E01008278","Total",603,130,82,48,473,8,150,75,107,9,31,93
"2011","Gateshead 023A","E01008189","Total",645,256,98,158,389,26,96,64,90,17,28,68
"2011","Gateshead 023B","E01008190","Total",560,127,85,42,433,15,145,70,98,8,30,67
"2011","Gateshead 023C","E01008191","Total",767,381,132,249,386,41,76,76,82,15,26,70
"2011","Gateshead 023D","E01008192","Total",677,254,102,152,423,29,102,63,109,12,33,75
"2011","Gateshead 023E","E01008217","Total",731,237,121,116,494,52,129,81,123,13,28,68
"2011","Gateshead 024A","E01008183","Total",650,194,82,112,456,56,72,97,128,17,21,65
"2011","Gateshead 024B","E01008186","Total",938,361,98,263,577,70,84,93,182,18,29,101
"2011","Gateshead 024C","E01008187","Total",789,287,175,112,502,35,118,79,138,15,39,78
"2011","Gateshead 024D","E01008196","Total",823,234,104,130,589,37,125,102,162,10,32,121
"2011","Gateshead 025A","E01008222","Total",654,202,71,131,452,49,69,94,113,19,34,74
"2011","Gateshead 025B","E01008223","Total",800,274,131,143,526,86,62,108,140,23,35,72
"2011","Gateshead 025C","E01008224","Total",801,217,121,96,584,29,144,98,166,14,41,92
"2011","Gateshead 025D","E01008226","Total",669,204,95,109,465,34,112,80,124,6,30,79
"2011","Gateshead 026A","E01008172","Total",779,232,156,76,547,35,165,81,135,12,29,90
"2011","Gateshead 026B","E01008173","Total",615,147,68,79,468,64,56,96,104,14,46,88
"2011","Gateshead 026C","E01008174","Total",903,288,159,129,615,50,116,123,146,28,45,107
"2011","Gateshead 026D","E01008175","Total",681,252,72,180,429,44,69,83,138,6,28,61
"2011","Gateshead 026E","E01008176","Total",621,118,65,53,503,23,130,89,128,5,27,101
"2011","Gateshead 027A","E01008162","Total",1191,474,100,374,717,60,48,125,328,3,30,123
"2011","Gateshead 027B","E01008164","Total",638,285,49,236,353,36,22,47,171,13,24,40
"2011","Gateshead 027C","E01008166","Total",1023,641,119,522,382,17,38,33,238,10,5,41
"2011","Gateshead 027D","E01008168","Total",1097,521,120,401,576,37,52,37,341,5,17,87
"2011","Gateshead 028A","E01008163","Total",678,237,81,156,441,40,42,74,118,48,44,75
"2011","Gateshead 028B","E01008203","Total",877,361,86,275,516,59,49,89,198,11,19,91
"2011","Gateshead 028C","E01008205","Total",676,212,129,83,464,13,92,101,137,12,21,88
"2011","Newcastle upon Tyne 001A","E01008294","Total",618,178,52,126,440,21,45,89,139,16,33,97
"2011","Newcastle upon Tyne 001B","E01008306","Total",720,194,113,81,526,28,129,76,161,15,28,89
"2011","Newcastle upon Tyne 001C","E01008307","Total",500,205,100,105,295,47,41,49,91,7,12,48
"2011","Newcastle upon Tyne 001D","E01008308","Total",616,186,83,103,430,39,71,82,129,11,26,72
"2011","Newcastle upon Tyne 001E","E01008311","Total",689,174,47,127,515,11,71,143,140,12,39,99
"2011","Newcastle upon Tyne 001F","E01008312","Total",503,127,30,97,376,22,42,99,101,20,18,74
"2011","Newcastle upon Tyne 001G","E01008313","Total",476,111,28,83,365,15,47,74,107,19,24,79
"2011","Newcastle upon Tyne 002A","E01008309","Total",728,164,115,49,564,16,158,137,110,26,31,86
"2011","Newcastle upon Tyne 002C","E01008352","Total",612,183,82,101,429,32,78,81,102,20,41,75
"2011","Newcastle upon Tyne 002D","E01008357","Total",689,177,105,72,512,12,127,95,135,16,41,86
"2011","Newcastle upon Tyne 002E","E01008358","Total",759,312,117,195,447,36,89,83,176,7,24,32
"2011","Newcastle upon Tyne 002F","E01033550","Total",694,100,44,56,594,16,32,247,144,44,44,67
"2011","Newcastle upon Tyne 002G","E01033551","Total",736,181,105,76,555,8,144,112,143,17,32,99
"2011","Newcastle upon Tyne 003A","E01008336","Total",674,283,112,171,391,49,92,63,95,10,25,57
"2011","Newcastle upon Tyne 003B","E01008337","Total",578,171,78,93,407,58,75,70,80,19,38,67
"2011","Newcastle upon Tyne 003C","E01008338","Total",498,133,49,84,365,33,43,64,100,17,44,64
"2011","Newcastle upon Tyne 003D","E01008339","Total",663,278,128,150,385,46,43,58,107,14,43,74
"2011","Newcastle upon Tyne 003E","E01008340","Total",628,224,48,176,404,87,29,88,79,17,42,62
"2011","Newcastle upon Tyne 003F","E01008341","Total",618,219,90,129,399,45,66,74,101,13,37,63
"2011","Newcastle upon Tyne 003G","E01008342","Total",722,317,168,149,405,14,102,66,125,2,23,73
"2011","Newcastle upon Tyne 004A","E01008293","Total",639,206,67,139,433,35,54,83,130,12,32,87
"2011","Newcastle upon Tyne 004B","E01008456","Total",674,228,130,98,446,69,80,80,96,9,31,81
"2011","Newcastle upon Tyne 004C","E01008457","Total",787,354,134,220,433,68,56,80,133,9,18,69
"2011","Newcastle upon Tyne 004D","E01008458","Total",700,195,102,93,505,16,136,85,128,20,37,83
"2011","Newcastle upon Tyne 004E","E01008459","Total",724,176,68,108,548,129,58,108,107,30,46,70
"2011","Newcastle upon Tyne 004F","E01008460","Total",605,159,72,87,446,62,88,70,80,19,54,73
"2011","Newcastle upon Tyne 005A","E01008351","Total",620,192,93,99,428,23,89,96,113,10,27,70
"2011","Newcastle upon Tyne 005B","E01008354","Total",767,266,98,168,501,32,64,103,180,22,30,70
"2011","Newcastle upon Tyne 005C","E01008418","Total",869,279,109,170,590,8,106,130,203,24,37,82
"2011","Newcastle upon Tyne 005D","E01008420","Total",555,149,64,85,406,14,84,82,124,17,22,63
"2011","Newcastle upon Tyne 005E","E01008422","Total",644,155,69,86,489,11,60,110,156,10,27,115
"2011","Newcastle upon Tyne 005F","E01008424","Total",759,303,96,207,456,20,33,73,218,12,17,83
"2011","Newcastle upon Tyne 006A","E01008353","Total",696,235,108,127,461,48,99,87,124,11,30,62
"2011","Newcastle upon Tyne 006B","E01008355","Total",745,312,169,143,433,19,51,97,166,12,24,64
"2011","Newcastle upon Tyne 006C","E01008356","Total",587,198,60,138,389,22,57,72,105,13,35,85
"2011","Newcastle upon Tyne 006D","E01008378","Total",535,116,84,32,419,8,91,71,85,29,49,86
"2011","Newcastle upon Tyne 006E","E01008419","Total",632,191,55,136,441,12,49,112,156,23,23,66
"2011","Newcastle upon Tyne 006F","E01008421","Total",664,204,77,127,460,14,68,117,164,23,23,51
"2011","Newcastle upon Tyne 006G","E01008423","Total",530,120,68,52,410,8,106,92,87,23,31,63
"2011","Newcastle upon Tyne 007A","E01008317","Total",593,142,78,64,451,10,81,112,114,26,32,76
"2011","Newcastle upon Tyne 007B","E01008319","Total",685,126,37,89,559,19,59,163,130,21,47,120
"2011","Newcastle upon Tyne 007C","E01008320","Total",611,172,82,90,439,18,92,70,122,14,46,77
"2011","Newcastle upon Tyne 007D","E01008321","Total",725,197,78,119,528,17,91,109,185,20,32,74
"2011","Newcastle upon Tyne 007E","E01008322","Total",585,124,66,58,461,12,72,108,115,20,33,101
"2011","Newcastle upon Tyne 007F","E01008323","Total",702,262,88,174,440,26,44,79,185,9,26,71
"2011","Newcastle upon Tyne 008A","E01008295","Total",604,148,51,97,456,90,61,87,83,28,44,63
"2011","Newcastle upon Tyne 008B","E01008374","Total",632,164,87,77,468,27,63,96,126,11,42,103
"2011","Newcastle upon Tyne 008C","E01008375","Total",721,304,106,198,417,50,54,89,119,18,25,62
"2011","Newcastle upon Tyne 008D","E01008376","Total",468,106,54,52,362,8,51,82,105,18,29,69
"2011","Newcastle upon Tyne 008E","E01008377","Total",845,210,52,158,635,81,44,143,189,39,58,81
"2011","Newcastle upon Tyne 008F","E01008379","Total",703,273,134,139,430,40,97,68,111,24,32,58
"2011","Newcastle upon Tyne 008G","E01008380","Total",739,295,77,218,444,94,28,83,94,26,54,65
"2011","Newcastle upon Tyne 011A","E01008296","Total",690,263,100,163,427,38,104,62,117,8,21,77
"2011","Newcastle upon Tyne 011B","E01008297","Total",626,266,120,146,360,37,70,54,84,19,38,58
"2011","Newcastle upon Tyne 011C","E01008298","Total",584,146,87,59,438,33,70,115,86,22,37,75
"2011","Newcastle upon Tyne 011D","E01008299","Total",527,163,84,79,364,42,48,56,80,27,45,66
"2011","Newcastle upon Tyne 012A","E01008314","Total",473,142,58,84,331,16,66,64,90,5,20,70
"2011","Newcastle upon Tyne 012B","E01008315","Total",627,168,79,89,459,26,71,98,111,14,40,99
"2011","Newcastle upon Tyne 012C","E01008316","Total",650,157,67,90,493,22,85,103,127,8,37,111
"2011","Newcastle upon Tyne 012D","E01008318","Total",631,226,135,91,405,32,63,65,113,13,31,88
"2011","Newcastle upon Tyne 012E","E01008363","Total",806,279,131,148,527,21,125,64,213,7,16,81
"2011","Newcastle upon Tyne 012F","E01008365","Total",572,96,43,53,476,6,43,120,107,25,40,135
"2011","Newcastle upon Tyne 013A","E01008366","Total",636,139,40,99,497,2,31,36,120,5,16,287
"2011","Newcastle upon Tyne 013B","E01008369","Total",680,171,32,139,509,3,26,42,164,7,20,247
"2011","Newcastle upon Tyne 013C","E01008371","Total",572,187,100,87,385,5,79,61,92,13,43,92
"2011","Newcastle upon Tyne 013D","E01008372","Total",728,240,60,180,488,3,21,15,163,5,12,269
"2011","Newcastle upon Tyne 013E","E01008373","Total",727,142,26,116,585,7,10,20,168,1,5,374
"2011","Newcastle upon Tyne 014A","E01008400","Total",703,346,161,185,357,48,73,56,101,11,22,46
"2011","Newcastle upon Tyne 014B","E01008401","Total",607,178,101,77,429,41,88,79,87,11,37,86
"2011","Newcastle upon Tyne 014C","E01008402","Total",654,181,71,110,473,47,101,85,125,5,24,86
"2011","Newcastle upon Tyne 014D","E01008403","Total",632,145,78,67,487,27,157,72,114,7,21,89
"2011","Newcastle upon Tyne 014E","E01008404","Total",804,322,72,250,482,48,47,111,177,11,26,62
"2011","Newcastle upon Tyne 014F","E01008405","Total",639,224,103,121,415,60,53,83,106,10,25,78
"2011","Newcastle upon Tyne 014G","E01008443","Total",608,152,84,68,456,16,104,99,115,10,29,83
"2011","Newcastle upon Tyne 015A","E01008324","Total",547,141,86,55,406,56,94,70,87,19,22,58
"2011","Newcastle upon Tyne 015B","E01008325","Total",663,258,142,116,405,58,108,47,74,22,35,61
"2011","Newcastle upon Tyne 015C","E01008326","Total",582,147,82,65,435,23,83,89,94,7,37,102
"2011","Newcastle upon Tyne 015D","E01008327","Total",586,226,101,125,360,76,61,50,68,18,35,52
"2011","Newcastle upon Tyne 015E","E01008328","Total",576,165,129,36,411,9,137,55,100,4,29,77
"2011","Newcastle upon Tyne 015F","E01008329","Total",624,182,77,105,442,39,84,72,103,14,34,96
"2011","Newcastle upon Tyne 015G","E01008330","Total",617,191,90,101,426,81,78,93,98,12,20,44
"2011","Newcastle upon Tyne 016A","E01008300","Total",665,207,84,123,458,72,51,97,104,25,43,66
"2011","Newcastle upon Tyne 016B","E01008450","Total",574,139,74,65,435,76,54,81,92,24,36,72
"2011","Newcastle upon Tyne 016C","E01008451","Total",839,308,88,220,531,61,63,94,186,15,35,77
"2011","Newcastle upon Tyne 016D","E01008452","Total",497,105,74,31,392,9,61,61,96,25,58,82
"2011","Newcastle upon Tyne 017A","E01008367","Total",785,253,41,212,532,2,24,37,227,2,17,223
"2011","Newcastle upon Tyne 017B","E01008368","Total",554,152,29,123,402,0,25,27,100,4,6,240
"2011","Newcastle upon Tyne 017C","E01008370","Total",822,370,102,268,452,9,62,38,184,7,14,138
"2011","Newcastle upon Tyne 017D","E01008409","Total",718,251,83,168,467,14,27,53,184,5,9,175
"2011","Newcastle upon Tyne 017E","E01008411","Total",696,232,64,168,464,12,19,13,182,1,9,228
"2011","Newcastle upon Tyne 018A","E01008303","Total",1060,618,227,391,442,57,75,56,102,9,21,122
"2011","Newcastle upon Tyne 018B","E01008359","Total",577,165,33,132,412,19,15,38,126,5,12,197
"2011","Newcastle upon Tyne 018C","E01008360","Total",768,272,35,237,496,15,29,45,283,4,7,113
"2011","Newcastle upon Tyne 018D","E01008361","Total",686,195,22,173,491,24,18,36,217,10,10,176
"2011","Newcastle upon Tyne 018E","E01008362","Total",730,255,81,174,475,17,22,28,168,5,9,226
"2011","Newcastle upon Tyne 018F","E01008364","Total",715,199,30,169,516,16,20,45,240,6,10,179
"2011","Newcastle upon Tyne 019A","E01008343","Total",606,161,91,70,445,27,82,97,83,18,43,95
"2011","Newcastle upon Tyne 019B","E01008344","Total",701,238,120,118,463,49,83,86,117,21,29,78
"2011","Newcastle upon Tyne 019C","E01008345","Total",849,392,146,246,457,95,71,79,133,9,13,57
"2011","Newcastle upon Tyne 019D","E01008346","Total",520,174,61,113,346,24,30,55,78,10,25,124
"2011","Newcastle upon Tyne 019E","E01008347","Total",552,150,71,79,402,12,64,68,107,22,48,81
"2011","Newcastle upon Tyne 019F","E01008348","Total",406,95,43,52,311,31,36,56,52,29,40,67
"2011","Newcastle upon Tyne 019G","E01008349","Total",482,108,53,55,374,18,33,62,54,47,70,90
"2011","Newcastle upon Tyne 019H","E01008350","Total",571,178,86,92,393,44,57,98,93,10,32,59
"2011","Newcastle upon Tyne 020A","E01008430","Total",614,217,92,125,397,51,57,56,117,8,28,80
"2011","Newcastle upon Tyne 020B","E01008431","Total",616,202,79,123,414,37,69,73,114,8,22,91
"2011","Newcastle upon Tyne 020C","E01008433","Total",634,217,149,68,417,13,111,62,102,5,22,102
"2011","Newcastle upon Tyne 020D","E01008434","Total",603,157,110,47,446,8,90,75,101,5,59,108
"2011","Newcastle upon Tyne 020E","E01008435","Total",629,185,78,107,444,69,69,89,93,14,34,76
"2011","Newcastle upon Tyne 020F","E01008436","Total",781,419,119,300,362,45,47,69,96,12,28,65
"2011","Newcastle upon Tyne 021A","E01008381","Total",651,223,58,165,428,20,65,98,154,6,15,70
"2011","Newcastle upon Tyne 021B","E01008382","Total",504,144,74,70,360,71,43,45,74,17,51,59
"2011","Newcastle upon Tyne 021C","E01008383","Total",646,194,88,106,452,87,63,84,108,16,28,66
"2011","Newcastle upon Tyne 021D","E01008384","Total",597,175,104,71,422,35,97,78,90,11,28,83
"2011","Newcastle upon Tyne 021E","E01008385","Total",656,240,72,168,416,62,46,70,123,12,26,77
"2011","Newcastle upon Tyne 021F","E01008386","Total",570,138,78,60,432,34,93,81,110,10,32,72
"2011","Newcastle upon Tyne 021G","E01008387","Total",624,197,65,132,427,25,89,71,143,11,29,59
"2011","Newcastle upon Tyne 022B","E01008396","Total",683,234,33,201,449,35,18,95,126,43,48,84
"2011","Newcastle upon Tyne 022C","E01008398","Total",868,497,66,431,371,46,23,63,113,27,39,60
"2011","Newcastle upon Tyne 022D","E01008449","Total",575,135,19,116,440,19,6,58,112,26,43,176
"2011","Newcastle upon Tyne 022E","E01008453","Total",569,126,56,70,443,9,61,72,98,29,58,116
"2011","Newcastle upon Tyne 022G","E01008455","Total",500,121,41,80,379,20,25,64,71,40,80,79
"2011","Newcastle upon Tyne 022H","E01033556","Total",950,321,87,234,629,24,30,60,176,22,48,269
"2011","Newcastle upon Tyne 023A","E01008406","Total",766,426,134,292,340,31,46,40,115,11,16,81
"2011","Newcastle upon Tyne 023B","E01008407","Total",758,304,78,226,454,22,27,18,146,4,6,231
"2011","Newcastle upon Tyne 023D","E01008410","Total",708,232,89,143,476,25,50,50,138,8,16,189
"2011","Newcastle upon Tyne 023E","E01008412","Total",637,152,37,115,485,19,29,58,188,5,12,174
"2011","Newcastle upon Tyne 023F","E01008413","Total",614,244,42,202,370,22,14,34,100,6,6,188
"2011","Newcastle upon Tyne 023G","E01033548","Total",677,382,66,316,295,16,33,33,166,0,6,41
"2011","Newcastle upon Tyne 023H","E01033553","Total",675,364,34,330,311,17,8,11,153,1,2,119
"2011","Newcastle upon Tyne 024A","E01008394","Total",439,142,16,126,297,3,5,8,66,2,3,210
"2011","Newcastle upon Tyne 024B","E01008395","Total",765,476,183,293,289,20,55,35,110,5,9,55
"2011","Newcastle upon Tyne 024C","E01008397","Total",531,300,26,274,231,6,9,7,138,1,1,69
"2011","Newcastle upon Tyne 024D","E01008399","Total",800,332,109,223,468,66,50,78,87,38,51,98
"2011","Newcastle upon Tyne 024E","E01008439","Total",805,393,87,306,412,90,34,79,91,18,41,59
"2011","Newcastle upon Tyne 024G","E01033543","Total",751,428,7,421,323,4,6,11,227,1,0,74
"2011","Newcastle upon Tyne 024H","E01033545","Total",760,460,16,444,300,3,9,13,236,1,1,37
"2011","Newcastle upon Tyne 024I","E01033554","Total",736,404,43,361,332,5,19,22,186,6,7,87
"2011","Newcastle upon Tyne 025B","E01008415","Total",516,154,58,96,362,67,46,67,90,11,26,55
"2011","Newcastle upon Tyne 025C","E01008416","Total",728,214,102,112,514,30,83,96,142,11,38,114
"2011","Newcastle upon Tyne 025E","E01033547","Total",949,372,178,194,577,118,78,100,124,22,48,87
"2011","Newcastle upon Tyne 026A","E01008301","Total",913,384,66,318,529,63,40,59,252,10,24,81
"2011","Newcastle upon Tyne 026B","E01008302","Total",780,328,110,218,452,80,62,78,130,11,23,68
"2011","Newcastle upon Tyne 026C","E01008304","Total",1078,652,120,532,426,84,41,53,146,21,31,50
"2011","Newcastle upon Tyne 026D","E01008305","Total",921,355,114,241,566,118,49,80,160,43,46,70
"2011","Newcastle upon Tyne 026E","E01008391","Total",590,150,55,95,440,80,50,74,93,24,42,77
"2011","Newcastle upon Tyne 026F","E01008392","Total",764,318,76,242,446,52,55,74,158,14,22,71
"2011","Newcastle upon Tyne 026G","E01008432","Total",629,235,112,123,394,32,86,63,100,8,26,79
"2011","Newcastle upon Tyne 027A","E01008288","Total",626,234,108,126,392,41,57,61,124,20,13,76
"2011","Newcastle upon Tyne 027B","E01008289","Total",603,184,88,96,419,66,59,63,83,18,40,90
"2011","Newcastle upon Tyne 027C","E01008290","Total",543,193,59,134,350,63,44,49,71,15,38,70
"2011","Newcastle upon Tyne 027D","E01008291","Total",901,344,106,238,557,121,44,87,128,45,56,76
"2011","Newcastle upon Tyne 027E","E01008292","Total",560,141,77,64,419,13,80,79,119,15,27,86
"2011","Newcastle upon Tyne 028A","E01008388","Total",836,312,131,181,524,108,81,99,125,16,35,60
"2011","Newcastle upon Tyne 028B","E01008389","Total",788,280,121,159,508,120,50,90,117,21,33,77
"2011","Newcastle upon Tyne 028C","E01008426","Total",640,168,69,99,472,109,51,90,69,18,38,97
"2011","Newcastle upon Tyne 028D","E01008429","Total",620,228,110,118,392,70,61,64,79,13,29,76
"2011","Newcastle upon Tyne 029A","E01008331","Total",593,151,18,133,442,50,9,95,71,36,88,93
"2011","Newcastle upon Tyne 029B","E01008332","Total",906,344,109,235,562,68,47,130,107,51,63,96
"2011","Newcastle upon Tyne 029C","E01008333","Total",536,158,47,111,378,20,28,60,72,49,72,77
"2011","Newcastle upon Tyne 029D","E01008334","Total",833,279,83,196,554,51,50,124,147,37,50,95
"2011","Newcastle upon Tyne 029E","E01008335","Total",674,163,49,114,511,34,45,88,98,65,91,90
"2011","Newcastle upon Tyne 029F","E01008437","Total",567,294,95,199,273,38,34,49,84,19,12,37
"2011","Newcastle upon Tyne 029G","E01008438","Total",850,453,95,358,397,53,44,52,130,15,38,65
"2011","Newcastle upon Tyne 030A","E01008390","Total",814,302,98,204,512,145,50,92,108,27,25,65
"2011","Newcastle upon Tyne 030B","E01008425","Total",1030,635,161,474,395,47,65,52,139,7,34,51
"2011","Newcastle upon Tyne 030C","E01008427","Total",581,251,66,185,330,58,51,38,93,15,16,59
"2011","Newcastle upon Tyne 030D","E01008428","Total",543,182,65,117,361,55,59,61,86,11,35,54
"2011","Newcastle upon Tyne 031A","E01008441","Total",772,277,170,107,495,48,94,83,137,12,29,92
"2011","Newcastle upon Tyne 031B","E01008442","Total",620,177,115,62,443,16,140,74,109,6,29,69
"2011","Newcastle upon Tyne 031C","E01008444","Total",664,166,99,67,498,28,131,84,120,9,37,89
"2011","Newcastle upon Tyne 031D","E01008445","Total",800,237,122,115,563,43,107,103,123,11,51,125
"2011","Newcastle upon Tyne 031E","E01008446","Total",641,163,118,45,478,12,174,67,114,4,29,78
"2011","Newcastle upon Tyne 031F","E01008447","Total",609,200,149,51,409,10,131,67,86,6,24,85
"2011","Newcastle upon Tyne 031G","E01008448","Total",633,140,67,73,493,9,116,85,135,7,23,118
"2011","North Tyneside 001A","E01008547","Total",601,155,100,55,446,9,174,68,83,20,32,60
"2011","North Tyneside 001B","E01008548","Total",528,89,52,37,439,5,152,63,94,5,24,96
"2011","North Tyneside 001C","E01008549","Total",681,209,139,70,472,17,165,81,98,5,28,78
"2011","North Tyneside 001D","E01008551","Total",661,199,144,55,462,9,152,88,116,9,27,61
"2011","North Tyneside 002A","E01008478","Total",775,319,133,186,456,67,87,79,122,10,26,65
"2011","North Tyneside 002B","E01008480","Total",716,246,102,144,470,51,100,83,143,9,26,58
"2011","North Tyneside 002C","E01008504","Total",646,127,55,72,519,15,116,93,164,11,33,87
"2011","North Tyneside 002D","E01008578","Total",602,160,55,105,442,39,71,82,133,11,34,72
"2011","North Tyneside 002E","E01008583","Total",616,177,71,106,439,47,48,102,126,13,32,71
"2011","North Tyneside 003A","E01008520","Total",573,163,90,73,410,22,76,84,109,19,29,71
"2011","North Tyneside 003B","E01008523","Total",483,80,42,38,403,15,68,99,90,25,37,69
"2011","North Tyneside 003C","E01008546","Total",604,134,93,41,470,14,131,108,104,16,30,67
"2011","North Tyneside 003D","E01008550","Total",634,150,65,85,484,19,70,127,121,22,34,91
"2011","North Tyneside 004A","E01008577","Total",660,250,142,108,410,40,106,73,105,7,25,54
"2011","North Tyneside 004B","E01008579","Total",726,229,162,67,497,21,193,66,125,5,16,71
"2011","North Tyneside 004C","E01008580","Total",607,174,76,98,433,22,84,100,130,9,23,65
"2011","North Tyneside 004D","E01008581","Total",656,217,143,74,439,10,165,55,127,3,21,58
"2011","North Tyneside 004E","E01008582","Total",634,238,108,130,396,35,59,78,121,17,19,67
"2011","North Tyneside 005A","E01008517","Total",598,120,65,55,478,21,94,143,81,21,33,85
"2011","North Tyneside 005B","E01008519","Total",659,261,107,154,398,29,71,77,115,5,39,62
"2011","North Tyneside 005C","E01008521","Total",689,240,118,122,449,26,112,74,132,12,16,77
"2011","North Tyneside 005D","E01008522","Total",658,155,89,66,503,12,113,116,132,17,27,86
"2011","North Tyneside 006A","E01008584","Total",668,275,54,221,393,46,32,72,130,10,26,77
"2011","North Tyneside 006B","E01008585","Total",651,188,54,134,463,41,52,104,145,18,34,69
"2011","North Tyneside 006C","E01008587","Total",638,259,88,171,379,19,45,73,157,8,19,58
"2011","North Tyneside 006D","E01008588","Total",676,231,55,176,445,36,46,97,144,11,32,79
"2011","North Tyneside 006E","E01008589","Total",562,111,52,59,451,11,79,120,107,11,30,93
"2011","North Tyneside 007A","E01008518","Total",783,301,156,145,482,27,114,103,134,7,21,76
"2011","North Tyneside 007B","E01008564","Total",633,173,92,81,460,18,101,85,134,7,23,92
"2011","North Tyneside 007C","E01008565","Total",874,238,76,162,636,73,74,145,210,18,32,84
"2011","North Tyneside 007D","E01008567","Total",587,165,51,114,422,77,48,84,110,17,23,63
"2011","North Tyneside 008A","E01008475","Total",687,153,46,107,534,31,61,154,178,4,29,77
"2011","North Tyneside 008B","E01008476","Total",793,291,123,168,502,92,69,85,124,20,23,89
"2011","North Tyneside 008C","E01008477","Total",659,171,70,101,488,84,70,103,87,20,35,89
"2011","North Tyneside 008D","E01008479","Total",647,218,78,140,429,20,78,79,156,6,23,67
"2011","North Tyneside 009A","E01008552","Total",748,242,124,118,506,26,108,104,157,7,34,70
"2011","North Tyneside 009B","E01008553","Total",831,303,120,183,528,60,93,100,144,15,34,82
"2011","North Tyneside 009C","E01008554","Total",674,159,70,89,515,53,79,96,129,19,47,92
"2011","North Tyneside 009D","E01008555","Total",671,198,122,76,473,54,82,87,99,28,39,84
"2011","North Tyneside 009E","E01008586","Total",674,236,126,110,438,26,65,105,128,22,24,68
"2011","North Tyneside 010A","E01008495","Total",736,197,123,74,539,21,140,111,109,13,27,118
"2011","North Tyneside 010B","E01008496","Total",775,363,163,200,412,23,69,74,151,10,27,58
"2011","North Tyneside 010C","E01008497","Total",651,184,134,50,467,16,133,104,114,4,20,76
"2011","North Tyneside 010D","E01008498","Total",718,229,187,42,489,8,213,68,96,9,24,71
"2011","North Tyneside 011B","E01008568","Total",683,199,120,79,484,32,138,78,131,7,20,78
"2011","North Tyneside 011C","E01008569","Total",647,199,102,97,448,82,81,91,109,11,21,53
"2011","North Tyneside 011D","E01008570","Total",599,172,61,111,427,28,55,107,162,11,24,40
"2011","North Tyneside 011E","E01032647","Total",667,101,5,96,566,25,26,189,229,19,28,50
"2011","North Tyneside 011F","E01032648","Total",657,213,67,146,444,66,39,102,127,30,25,55
"2011","North Tyneside 012A","E01008500","Total",728,250,95,155,478,20,97,106,145,13,27,70
"2011","North Tyneside 012B","E01008505","Total",805,299,102,197,506,30,112,112,148,12,27,65
"2011","North Tyneside 012C","E01008506","Total",613,182,87,95,431,47,67,71,126,7,30,83
"2011","North Tyneside 012D","E01008507","Total",626,143,59,84,483,19,77,107,148,11,29,92
"2011","North Tyneside 013A","E01008493","Total",641,168,110,58,473,23,113,87,124,11,34,81
"2011","North Tyneside 013B","E01008494","Total",734,277,162,115,457,51,106,83,116,9,20,72
"2011","North Tyneside 013C","E01008556","Total",849,266,153,113,583,27,143,113,136,12,56,96
"2011","North Tyneside 013D","E01008557","Total",617,90,54,36,527,9,116,95,124,13,46,124
"2011","North Tyneside 014A","E01008470","Total",643,222,105,117,421,52,76,73,125,5,18,72
"2011","North Tyneside 014B","E01008499","Total",727,213,94,119,514,46,97,121,133,16,34,67
"2011","North Tyneside 014C","E01008502","Total",697,186,92,94,511,53,91,89,141,24,22,91
"2011","North Tyneside 014D","E01008516","Total",649,238,135,103,411,15,136,75,105,5,21,54
"2011","North Tyneside 015A","E01008488","Total",647,225,78,147,422,53,67,79,120,13,31,59
"2011","North Tyneside 015B","E01008489","Total",752,254,121,133,498,88,80,99,93,17,49,72
"2011","North Tyneside 015C","E01008490","Total",768,285,124,161,483,29,139,67,136,8,27,77
"2011","North Tyneside 015D","E01008491","Total",622,145,55,90,477,65,67,94,107,19,43,82
"2011","North Tyneside 016A","E01008558","Total",855,413,150,263,442,31,92,73,180,5,14,47
"2011","North Tyneside 016B","E01008560","Total",857,360,144,216,497,24,85,96,192,15,16,69
"2011","North Tyneside 016C","E01008561","Total",879,423,149,274,456,53,82,63,181,5,21,51
"2011","North Tyneside 016D","E01008562","Total",639,184,88,96,455,22,112,82,116,11,28,84
"2011","North Tyneside 017A","E01008525","Total",724,269,137,132,455,22,111,99,133,9,20,61
"2011","North Tyneside 017B","E01008527","Total",745,297,88,209,448,31,81,71,168,6,18,73
"2011","North Tyneside 017C","E01008559","Total",786,359,106,253,427,31,39,99,179,7,15,57
"2011","North Tyneside 017D","E01008563","Total",594,130,94,36,464,17,126,91,108,16,30,76
"2011","North Tyneside 018A","E01008469","Total",757,322,119,203,435,21,109,69,141,8,16,71
"2011","North Tyneside 018B","E01008472","Total",673,212,137,75,461,17,111,104,118,11,30,70
"2011","North Tyneside 018C","E01008473","Total",527,142,70,72,385,15,77,79,116,14,18,66
"2011","North Tyneside 018D","E01008501","Total",772,135,32,103,637,34,46,211,182,25,45,94
"2011","North Tyneside 018E","E01008503","Total",771,324,117,207,447,50,73,91,126,15,27,65
"2011","North Tyneside 019A","E01008471","Total",660,170,87,83,490,47,77,93,121,19,32,101
"2011","North Tyneside 019B","E01008474","Total",614,196,71,125,418,61,43,73,100,15,41,85
"2011","North Tyneside 019C","E01008513","Total",1137,442,180,262,695,84,85,123,288,11,28,76
"2011","North Tyneside 019D","E01008514","Total",774,228,128,100,546,64,78,96,153,12,56,87
"2011","North Tyneside 019F","E01032649","Total",612,268,89,179,344,36,39,59,180,7,3,20
"2011","North Tyneside 019G","E01032650","Total",594,297,72,225,297,41,43,41,127,2,11,32
"2011","North Tyneside 020A","E01008486","Total",661,226,107,119,435,70,83,85,104,3,15,75
"2011","North Tyneside 020B","E01008487","Total",692,260,105,155,432,48,104,45,114,9,23,89
"2011","North Tyneside 020C","E01008526","Total",617,133,66,67,484,17,102,102,146,9,26,82
"2011","North Tyneside 020D","E01008530","Total",783,291,168,123,492,22,158,70,129,7,25,81
"2011","North Tyneside 021A","E01008461","Total",623,203,75,128,420,54,68,77,112,10,41,58
"2011","North Tyneside 021B","E01008466","Total",559,112,39,73,447,12,74,69,154,4,22,112
"2011","North Tyneside 021C","E01008467","Total",635,196,61,135,439,52,52,95,122,5,20,93
"2011","North Tyneside 021D","E01008468","Total",633,193,58,135,440,57,59,96,123,8,32,65
"2011","North Tyneside 022A","E01008483","Total",757,282,55,227,475,64,48,94,170,4,20,75
"2011","North Tyneside 022B","E01008524","Total",1119,724,212,512,395,38,85,45,167,3,7,50
"2011","North Tyneside 022C","E01008528","Total",634,193,50,143,441,39,72,72,160,11,25,62
"2011","North Tyneside 022D","E01008529","Total",751,281,110,171,470,27,89,77,158,14,26,79
"2011","North Tyneside 023A","E01008481","Total",614,168,86,82,446,72,74,85,82,9,34,90
"2011","North Tyneside 023B","E01008482","Total",824,373,117,256,451,90,64,80,120,13,27,57
"2011","North Tyneside 023C","E01008484","Total",639,242,49,193,397,75,42,64,124,18,19,55
"2011","North Tyneside 023D","E01008485","Total",644,208,57,151,436,131,41,81,74,24,33,52
"2011","North Tyneside 023E","E01008492","Total",750,243,85,158,507,73,70,92,134,8,44,86
"2011","North Tyneside 024A","E01008462","Total",545,191,93,98,354,34,52,72,96,9,26,65
"2011","North Tyneside 024B","E01008463","Total",607,197,101,96,410,36,84,61,118,5,23,83
"2011","North Tyneside 024C","E01008464","Total",655,207,90,117,448,34,106,73,144,11,20,60
"2011","North Tyneside 024D","E01008465","Total",641,193,106,87,448,28,109,85,107,11,24,84
"2011","North Tyneside 025A","E01008531","Total",631,180,55,125,451,17,65,71,147,9,25,117
"2011","North Tyneside 025B","E01008532","Total",701,221,109,112,480,72,78,93,135,15,26,61
"2011","North Tyneside 025C","E01008534","Total",619,183,77,106,436,25,80,63,142,3,28,95
"2011","North Tyneside 025D","E01008538","Total",520,135,33,102,385,22,49,76,98,2,31,107
"2011","North Tyneside 026A","E01008508","Total",617,144,71,73,473,50,67,89,114,17,38,98
"2011","North Tyneside 026B","E01008509","Total",747,282,124,158,465,56,69,85,124,23,24,84
"2011","North Tyneside 026C","E01008510","Total",755,283,99,184,472,53,89,89,139,11,18,73
"2011","North Tyneside 026D","E01008512","Total",763,328,132,196,435,52,66,64,145,10,40,58
"2011","North Tyneside 027A","E01008539","Total",719,271,46,225,448,38,34,102,216,6,13,39
"2011","North Tyneside 027B","E01008540","Total",743,275,66,209,468,98,59,102,97,19,20,73
"2011","North Tyneside 027C","E01008541","Total",792,350,136,214,442,69,58,93,132,10,26,54
"2011","North Tyneside 027D","E01008544","Total",964,575,142,433,389,73,44,75,124,11,13,49
"2011","North Tyneside 027E","E01008545","Total",665,345,85,260,320,56,46,65,91,11,17,34
"2011","North Tyneside 028A","E01008511","Total",780,269,108,161,511,74,69,101,150,18,27,72
"2011","North Tyneside 028B","E01008542","Total",726,253,123,130,473,122,58,90,106,17,23,57
"2011","North Tyneside 028C","E01008543","Total",931,280,45,235,651,113,39,150,211,20,37,81
"2011","North Tyneside 028D","E01008571","Total",875,376,172,204,499,68,71,90,165,11,25,69
"2011","North Tyneside 029A","E01008572","Total",925,486,75,411,439,73,43,75,162,10,20,56
"2011","North Tyneside 029B","E01008573","Total",838,387,65,322,451,81,31,62,174,12,17,74
"2011","North Tyneside 029C","E01008574","Total",692,199,100,99,493,23,94,92,147,17,29,91
"2011","North Tyneside 029D","E01008576","Total",840,208,68,140,632,76,68,141,187,20,56,84
"2011","North Tyneside 030A","E01008533","Total",631,189,102,87,442,56,68,69,109,23,32,85
"2011","North Tyneside 030B","E01008535","Total",652,183,82,101,469,23,96,74,155,7,26,88
"2011","North Tyneside 030C","E01008536","Total",748,362,78,284,386,32,44,74,144,8,24,60
"2011","North Tyneside 030D","E01008537","Total",661,283,112,171,378,24,67,75,121,6,20,65
"2011","North Tyneside 030E","E01008575","Total",693,322,92,230,371,41,44,58,160,10,19,39
"2011","South Tyneside 001A","E01008595","Total",813,352,82,270,461,60,66,73,175,11,19,57
"2011","South Tyneside 001B","E01008596","Total",576,233,86,147,343,65,38,51,50,35,51,53
"2011","South Tyneside 001C","E01008597","Total",1046,354,74,280,692,65,88,138,243,11,44,103
"2011","South Tyneside 001D","E01008598","Total",648,225,58,167,423,42,67,59,124,22,36,73
"2011","South Tyneside 001E","E01008599","Total",729,324,151,173,405,57,89,45,98,15,29,72
"2011","South Tyneside 002A","E01008664","Total",696,343,72,271,353,48,29,66,99,12,26,73
"2011","South Tyneside 002B","E01008665","Total",762,364,65,299,398,62,41,70,130,10,21,64
"2011","South Tyneside 002C","E01008666","Total",803,469,134,335,334,75,38,58,86,12,12,53
"2011","South Tyneside 002D","E01008667","Total",899,464,150,314,435,70,96,50,139,11,7,62
"2011","South Tyneside 002E","E01008668","Total",813,422,123,299,391,58,52,62,108,14,21,76
"2011","South Tyneside 003A","E01008673","Total",524,153,67,86,371,16,73,68,97,9,28,80
"2011","South Tyneside 003B","E01008675","Total",757,343,94,249,414,45,58,82,162,8,13,46
"2011","South Tyneside 003C","E01008676","Total",538,203,52,151,335,25,38,68,109,7,30,58
"2011","South Tyneside 003D","E01008677","Total",590,207,96,111,383,23,91,65,97,1,28,78
"2011","South Tyneside 003E","E01008678","Total",626,274,84,190,352,28,51,52,132,7,20,62
"2011","South Tyneside 004A","E01008647","Total",659,188,128,60,471,13,143,71,112,5,32,95
"2011","South Tyneside 004B","E01008648","Total",668,231,133,98,437,15,144,49,121,9,15,84
"2011","South Tyneside 004C","E01008649","Total",701,245,143,102,456,47,85,74,94,18,48,90
"2011","South Tyneside 004D","E01008651","Total",778,217,71,146,561,156,63,112,95,19,35,81
"2011","South Tyneside 005A","E01008679","Total",625,240,96,144,385,35,77,52,110,9,25,77
"2011","South Tyneside 005B","E01008680","Total",604,143,96,47,461,9,123,76,112,13,25,103
"2011","South Tyneside 005C","E01008682","Total",509,159,75,84,350,60,65,61,55,15,36,58
"2011","South Tyneside 005D","E01008683","Total",729,308,74,234,421,61,47,57,158,8,19,71
"2011","South Tyneside 006A","E01008635","Total",633,210,137,73,423,34,120,59,91,9,28,82
"2011","South Tyneside 006B","E01008650","Total",599,142,86,56,457,24,87,87,127,8,24,100
"2011","South Tyneside 006C","E01008674","Total",512,97,51,46,415,13,96,63,99,13,31,100
"2011","South Tyneside 006D","E01008681","Total",637,196,127,69,441,7,129,65,113,6,35,86
"2011","South Tyneside 007A","E01008600","Total",623,246,55,191,377,60,41,63,108,13,25,67
"2011","South Tyneside 007B","E01008604","Total",769,359,94,265,410,63,54,72,111,15,32,63
"2011","South Tyneside 007C","E01008660","Total",655,234,67,167,421,20,66,75,138,9,25,88
"2011","South Tyneside 007D","E01008661","Total",512,177,71,106,335,31,72,50,92,4,21,65
"2011","South Tyneside 008A","E01008633","Total",603,186,97,89,417,73,58,61,90,18,31,86
"2011","South Tyneside 008B","E01008634","Total",622,266,162,104,356,52,63,66,74,9,30,62
"2011","South Tyneside 008C","E01008636","Total",596,177,107,70,419,34,84,73,78,10,40,100
"2011","South Tyneside 008D","E01008637","Total",629,199,118,81,430,33,79,80,99,10,42,87
"2011","South Tyneside 009A","E01008639","Total",848,240,66,174,608,102,51,127,198,12,39,79
"2011","South Tyneside 009B","E01008652","Total",514,205,69,136,309,31,58,45,87,6,24,58
"2011","South Tyneside 009C","E01008653","Total",526,134,64,70,392,61,47,83,92,10,32,67
"2011","South Tyneside 009D","E01008654","Total",600,251,47,204,349,30,38,76,113,8,13,71
"2011","South Tyneside 009E","E01008655","Total",663,245,122,123,418,50,71,57,110,9,39,82
"2011","South Tyneside 009F","E01008657","Total",578,163,76,87,415,20,85,85,93,9,32,91
"2011","South Tyneside 010A","E01008638","Total",612,191,27,164,421,46,25,126,121,9,39,55
"2011","South Tyneside 010B","E01008640","Total",889,313,109,204,576,50,71,129,176,16,34,100
"2011","South Tyneside 010C","E01008641","Total",818,414,170,244,404,56,69,60,131,12,27,49
"2011","South Tyneside 010D","E01008642","Total",578,134,58,76,444,19,91,65,121,11,31,106
"2011","South Tyneside 011A","E01008590","Total",749,303,121,182,446,64,74,73,128,8,19,80
"2011","South Tyneside 011B","E01008591","Total",763,370,65,305,393,86,50,58,117,3,19,60
"2011","South Tyneside 011C","E01008592","Total",689,286,62,224,403,62,50,71,122,6,21,71
"2011","South Tyneside 011D","E01008594","Total",738,216,101,115,522,77,78,96,121,17,35,98
"2011","South Tyneside 012A","E01008601","Total",635,209,107,102,426,60,66,62,99,25,32,82
"2011","South Tyneside 012B","E01008669","Total",649,261,111,150,388,60,64,45,100,13,34,72
"2011","South Tyneside 012C","E01008671","Total",647,326,71,255,321,55,47,48,89,8,15,59
"2011","South Tyneside 012D","E01008672","Total",588,188,89,99,400,29,76,57,113,8,31,86
"2011","South Tyneside 013A","E01008622","Total",713,185,116,69,528,22,155,60,135,12,24,120
"2011","South Tyneside 013C","E01008625","Total",718,302,141,161,416,69,92,64,91,13,20,67
"2011","South Tyneside 013E","E01033074","Total",887,238,118,120,649,66,116,110,150,13,57,137
"2011","South Tyneside 014A","E01008602","Total",631,188,84,104,443,75,66,77,100,13,26,86
"2011","South Tyneside 014B","E01008603","Total",648,302,96,206,346,44,57,45,90,8,33,69
"2011","South Tyneside 014C","E01008608","Total",544,190,96,94,354,79,82,65,63,2,16,47
"2011","South Tyneside 014D","E01008670","Total",744,304,150,154,440,53,86,76,116,7,29,73
"2011","South Tyneside 015A","E01008643","Total",620,178,90,88,442,24,74,90,125,8,28,93
"2011","South Tyneside 015B","E01008644","Total",753,319,181,138,434,51,98,67,113,9,23,73
"2011","South Tyneside 015C","E01008645","Total",668,229,108,121,439,74,66,77,111,10,30,71
"2011","South Tyneside 015D","E01008646","Total",609,183,123,60,426,31,119,58,94,10,27,87
"2011","South Tyneside 015E","E01008656","Total",604,177,102,75,427,31,103,62,98,13,29,91
"2011","South Tyneside 015F","E01008658","Total",581,142,75,67,439,85,80,64,83,18,34,75
"2011","South Tyneside 016A","E01008593","Total",569,195,51,144,374,70,53,80,90,11,23,47
"2011","South Tyneside 016B","E01008605","Total",508,142,58,84,366,33,57,71,112,4,30,59
"2011","South Tyneside 016C","E01008606","Total",651,243,97,146,408,76,64,68,93,16,29,62
"2011","South Tyneside 016D","E01008607","Total",604,175,65,110,429,120,65,64,78,12,28,62
"2011","South Tyneside 016E","E01008609","Total",648,214,98,116,434,90,67,66,95,18,28,70
"2011","South Tyneside 017A","E01008631","Total",614,172,71,101,442,49,72,67,103,15,38,98
"2011","South Tyneside 017B","E01008632","Total",571,209,102,107,362,40,57,62,95,10,27,71
"2011","South Tyneside 017C","E01008659","Total",634,189,112,77,445,52,92,68,88,12,40,93
"2011","South Tyneside 017D","E01008662","Total",514,144,75,69,370,39,66,64,72,8,41,80
"2011","South Tyneside 017E","E01008663","Total",637,220,128,92,417,53,104,71,83,13,21,72
"2011","South Tyneside 018A","E01008624","Total",590,175,85,90,415,58,50,90,90,19,37,71
"2011","South Tyneside 018B","E01008684","Total",589,229,123,106,360,34,78,51,103,5,27,62
"2011","South Tyneside 018C","E01008685","Total",806,206,118,88,600,56,129,91,165,17,37,105
"2011","South Tyneside 018D","E01008686","Total",726,212,145,67,514,33,122,85,111,13,40,110
"2011","South Tyneside 018E","E01008687","Total",844,338,229,109,506,27,143,86,133,12,25,80
"2011","South Tyneside 019A","E01008688","Total",654,239,109,130,415,57,85,79,94,10,18,72
"2011","South Tyneside 019B","E01008689","Total",769,325,181,144,444,50,110,62,110,11,26,75
"2011","South Tyneside 019C","E01008690","Total",646,235,87,148,411,49,65,81,93,12,38,73
"2011","South Tyneside 019D","E01008691","Total",494,92,40,52,402,14,70,60,106,9,35,108
"2011","South Tyneside 019E","E01008692","Total",615,206,104,102,409,31,80,72,101,9,25,91
"2011","South Tyneside 020A","E01008627","Total",611,193,76,117,418,19,81,74,134,2,22,86
"2011","South Tyneside 020B","E01008628","Total",624,193,98,95,431,80,82,58,78,11,39,83
"2011","South Tyneside 020C","E01008629","Total",595,143,66,77,452,25,82,99,126,6,24,90
"2011","South Tyneside 020D","E01008630","Total",627,196,81,115,431,74,63,87,89,16,37,65
"2011","South Tyneside 021A","E01008610","Total",637,217,119,98,420,95,74,72,84,15,27,53
"2011","South Tyneside 021B","E01008611","Total",602,139,46,93,463,14,50,111,148,6,34,100
"2011","South Tyneside 021C","E01008612","Total",640,174,61,113,466,18,69,87,150,11,28,103
"2011","South Tyneside 021D","E01008613","Total",757,308,89,219,449,69,61,81,120,19,20,79
"2011","South Tyneside 022A","E01008616","Total",643,155,75,80,488,24,90,104,119,12,37,102
"2011","South Tyneside 022B","E01008618","Total",512,98,58,40,414,6,134,75,78,10,32,79
"2011","South Tyneside 022C","E01008619","Total",712,210,152,58,502,11,172,73,106,9,29,102
"2011","South Tyneside 022D","E01008621","Total",604,145,103,42,459,10,111,90,130,8,25,85
"2011","South Tyneside 023A","E01008614","Total",676,175,115,60,501,37,100,82,130,20,44,88
"2011","South Tyneside 023B","E01008615","Total",679,244,130,114,435,47,78,66,143,10,16,75
"2011","South Tyneside 023C","E01008617","Total",621,158,95,63,463,16,105,104,116,10,33,79
"2011","South Tyneside 023D","E01008620","Total",657,215,140,75,442,16,133,85,100,11,28,69
"2011","Sunderland 001A","E01008713","Total",630,127,73,54,503,20,99,103,104,6,49,122
"2011","Sunderland 001B","E01008722","Total",644,174,124,50,470,23,128,86,107,9,24,93
"2011","Sunderland 001C","E01008724","Total",483,93,62,31,390,11,100,70,65,5,37,102
"2011","Sunderland 001D","E01008726","Total",670,203,111,92,467,17,114,96,114,12,27,87
"2011","Sunderland 002A","E01008723","Total",572,154,107,47,418,13,112,81,82,16,31,83
"2011","Sunderland 002B","E01008725","Total",619,163,110,53,456,10,139,86,109,6,30,76
"2011","Sunderland 002C","E01008727","Total",769,295,141,154,474,37,100,74,157,10,20,76
"2011","Sunderland 002D","E01008728","Total",583,133,65,68,450,15,78,89,109,7,41,111
"2011","Sunderland 002E","E01008792","Total",505,128,81,47,377,9,107,61,90,10,21,79
"2011","Sunderland 003A","E01008698","Total",724,306,157,149,418,48,82,77,114,7,27,63
"2011","Sunderland 003B","E01008837","Total",633,260,104,156,373,66,56,67,101,6,21,56
"2011","Sunderland 003C","E01008838","Total",680,202,76,126,478,63,81,106,93,8,38,89
"2011","Sunderland 003D","E01008839","Total",671,298,112,186,373,69,51,59,92,10,26,66
"2011","Sunderland 003E","E01008840","Total",586,169,72,97,417,52,61,82,84,17,49,72
"2011","Sunderland 003F","E01008841","Total",528,183,77,106,345,61,66,52,67,6,36,57
"2011","Sunderland 004A","E01008712","Total",774,301,118,183,473,54,90,74,114,11,42,88
"2011","Sunderland 004B","E01008817","Total",465,139,45,94,326,65,40,53,71,12,28,57
"2011","Sunderland 004C","E01008819","Total",630,188,113,75,442,56,100,78,91,9,30,78
"2011","Sunderland 004D","E01008821","Total",539,147,63,84,392,65,86,57,79,9,37,59
"2011","Sunderland 004E","E01008822","Total",732,242,86,156,490,92,80,79,107,12,38,82
"2011","Sunderland 004F","E01008842","Total",592,144,50,94,448,39,58,80,136,7,36,92
"2011","Sunderland 005A","E01008708","Total",695,251,162,89,444,38,90,76,115,6,27,92
"2011","Sunderland 005B","E01008709","Total",687,291,92,199,396,71,45,58,110,14,25,73
"2011","Sunderland 005D","E01008711","Total",687,285,117,168,402,33,68,77,115,4,33,72
"2011","Sunderland 005F","E01008820","Total",558,201,53,148,357,42,66,53,112,4,23,57
"2011","Sunderland 005G","E01033075","Total",950,369,142,227,581,83,84,97,165,24,44,84
"2011","Sunderland 006A","E01008786","Total",648,202,103,99,446,32,113,88,110,7,23,73
"2011","Sunderland 006B","E01008787","Total",710,233,75,158,477,39,69,67,145,8,29,120
"2011","Sunderland 006C","E01008788","Total",758,290,103,187,468,38,106,83,154,9,15,63
"2011","Sunderland 006D","E01008789","Total",642,242,75,167,400,23,75,78,110,5,20,89
"2011","Sunderland 006E","E01008790","Total",657,214,81,133,443,26,73,71,117,7,46,103
"2011","Sunderland 006F","E01008791","Total",1011,599,186,413,412,24,88,47,133,8,18,94
"2011","Sunderland 007A","E01008855","Total",644,208,23,185,436,25,42,120,141,10,37,61
"2011","Sunderland 007B","E01008856","Total",629,167,92,75,462,17,135,60,128,8,23,91
"2011","Sunderland 007C","E01008876","Total",579,89,46,43,490,19,103,72,151,10,33,102
"2011","Sunderland 007D","E01008877","Total",634,185,75,110,449,16,99,90,134,15,30,65
"2011","Sunderland 008A","E01008693","Total",555,205,89,116,350,31,52,50,95,14,29,79
"2011","Sunderland 008B","E01008694","Total",618,193,100,93,425,51,74,84,91,17,31,77
"2011","Sunderland 008C","E01008695","Total",606,142,68,74,464,61,57,84,122,20,46,74
"2011","Sunderland 008D","E01008696","Total",490,90,38,52,400,21,50,97,98,10,37,87
"2011","Sunderland 008E","E01008697","Total",571,182,125,57,389,34,99,68,83,5,25,75
"2011","Sunderland 008F","E01008699","Total",605,178,90,88,427,57,66,70,105,10,44,75
"2011","Sunderland 009A","E01008853","Total",619,188,63,125,431,69,70,80,117,13,25,57
"2011","Sunderland 009B","E01008854","Total",812,438,87,351,374,43,41,75,132,10,21,52
"2011","Sunderland 009C","E01008857","Total",630,208,114,94,422,51,66,84,114,12,23,72
"2011","Sunderland 009D","E01008858","Total",598,159,67,92,439,107,57,86,91,15,19,64
"2011","Sunderland 009E","E01008859","Total",534,143,35,108,391,68,28,80,96,25,31,63
"2011","Sunderland 009F","E01008860","Total",596,169,75,94,427,71,63,60,100,13,31,89
"2011","Sunderland 009G","E01008878","Total",635,167,86,81,468,46,93,93,78,21,41,96
"2011","Sunderland 010A","E01008873","Total",540,102,49,53,438,18,100,71,142,8,24,75
"2011","Sunderland 010B","E01008874","Total",671,134,63,71,537,55,65,100,132,36,48,101
"2011","Sunderland 010C","E01008875","Total",674,185,75,110,489,58,43,128,160,6,27,67
"2011","Sunderland 010D","E01008879","Total",617,185,86,99,432,29,66,73,114,12,30,108
"2011","Sunderland 010E","E01008880","Total",512,158,57,101,354,26,57,58,115,11,18,69
"2011","Sunderland 011A","E01008701","Total",650,206,53,153,444,71,47,71,115,10,39,91
"2011","Sunderland 011B","E01008704","Total",650,252,100,152,398,45,48,74,102,18,36,75
"2011","Sunderland 011C","E01008706","Total",668,229,100,129,439,51,47,77,102,24,39,99
"2011","Sunderland 011D","E01008707","Total",547,182,50,132,365,35,40,69,105,17,30,69
"2011","Sunderland 012A","E01008756","Total",652,214,116,98,438,60,75,44,93,12,45,109
"2011","Sunderland 012B","E01008762","Total",639,185,87,98,454,74,63,72,101,10,41,93
"2011","Sunderland 012C","E01008812","Total",751,213,73,140,538,102,62,116,130,11,39,78
"2011","Sunderland 012F","E01033076","Total",596,153,66,87,443,58,62,68,84,14,50,107
"2011","Sunderland 013A","E01008700","Total",516,192,70,122,324,42,41,48,98,3,17,75
"2011","Sunderland 013B","E01008703","Total",1089,624,158,466,465,25,70,25,266,3,5,71
"2011","Sunderland 013C","E01008705","Total",485,178,54,124,307,41,32,38,83,4,20,89
"2011","Sunderland 013D","E01008831","Total",1131,601,93,508,530,31,50,63,206,13,31,136
"2011","Sunderland 013E","E01008834","Total",967,514,64,450,453,31,32,54,218,8,28,82
"2011","Sunderland 014A","E01008810","Total",712,215,76,139,497,61,84,100,117,9,32,94
"2011","Sunderland 014B","E01008811","Total",690,189,100,89,501,38,98,98,118,6,41,102
"2011","Sunderland 014C","E01008813","Total",643,195,98,97,448,45,84,68,101,13,46,91
"2011","Sunderland 014D","E01008814","Total",661,168,81,87,493,46,97,79,137,15,28,91
"2011","Sunderland 015A","E01008757","Total",648,209,83,126,439,45,90,69,103,10,31,91
"2011","Sunderland 015B","E01008758","Total",601,145,96,49,456,15,107,84,105,7,38,100
"2011","Sunderland 015C","E01008759","Total",664,210,105,105,454,26,107,75,123,5,19,99
"2011","Sunderland 015D","E01008761","Total",588,166,95,71,422,14,115,67,96,5,43,82
"2011","Sunderland 016A","E01008702","Total",566,266,100,166,300,61,48,39,82,9,19,42
"2011","Sunderland 016B","E01008735","Total",1032,547,196,351,485,50,68,64,174,25,35,69
"2011","Sunderland 016C","E01008736","Total",609,268,67,201,341,75,39,49,88,8,27,55
"2011","Sunderland 016D","E01008737","Total",627,244,50,194,383,53,36,62,114,16,22,80
"2011","Sunderland 016E","E01008738","Total",605,233,48,185,372,55,47,57,99,10,25,79
"2011","Sunderland 016F","E01008836","Total",704,409,98,311,295,28,52,29,85,13,41,47
"2011","Sunderland 017A","E01008845","Total",672,221,69,152,451,19,116,69,145,8,26,68
"2011","Sunderland 017B","E01008846","Total",464,129,47,82,335,50,41,60,72,17,29,66
"2011","Sunderland 017C","E01008847","Total",513,106,41,65,407,62,36,69,105,31,41,63
"2011","Sunderland 017D","E01008850","Total",625,83,38,45,542,20,65,114,144,20,48,131
"2011","Sunderland 017E","E01008851","Total",753,276,101,175,477,34,76,94,157,15,18,83
"2011","Sunderland 018A","E01008760","Total",626,175,79,96,451,26,78,84,120,12,31,100
"2011","Sunderland 018B","E01008830","Total",573,187,40,147,386,23,44,67,84,20,40,108
"2011","Sunderland 018C","E01008832","Total",632,193,68,125,439,35,70,97,99,30,36,72
"2011","Sunderland 018D","E01008833","Total",637,221,102,119,416,17,99,62,94,13,41,90
"2011","Sunderland 019A","E01008843","Total",555,141,56,85,414,17,91,62,125,7,31,81
"2011","Sunderland 019B","E01008844","Total",688,240,130,110,448,22,132,71,111,7,20,85
"2011","Sunderland 019C","E01008848","Total",608,152,92,60,456,15,135,61,134,6,18,87
"2011","Sunderland 019D","E01008849","Total",499,135,39,96,364,70,32,71,79,20,32,60
"2011","Sunderland 019E","E01008852","Total",531,135,59,76,396,17,47,87,136,7,23,79
"2011","Sunderland 020A","E01008867","Total",803,362,35,327,441,64,26,77,158,34,25,57
"2011","Sunderland 020B","E01008868","Total",513,114,39,75,399,17,50,73,139,3,21,96
"2011","Sunderland 020C","E01008869","Total",523,107,55,52,416,21,65,82,121,12,31,84
"2011","Sunderland 020D","E01008870","Total",595,130,45,85,465,17,61,113,146,8,33,87
"2011","Sunderland 020E","E01008871","Total",602,162,57,105,440,41,60,82,123,10,49,75
"2011","Sunderland 020F","E01008872","Total",663,190,73,117,473,18,78,86,162,7,24,98
"2011","Sunderland 021A","E01008729","Total",462,150,58,92,312,50,33,48,90,9,30,52
"2011","Sunderland 021B","E01008730","Total",647,174,74,100,473,65,54,78,94,20,65,97
"2011","Sunderland 021C","E01008731","Total",519,134,80,54,385,59,61,59,80,14,33,79
"2011","Sunderland 021D","E01008732","Total",940,299,147,152,641,77,87,165,166,13,45,88
"2011","Sunderland 021E","E01008733","Total",882,453,163,290,429,58,76,69,106,5,38,77
"2011","Sunderland 021F","E01008734","Total",637,151,101,50,486,15,174,53,105,5,28,106
"2011","Sunderland 022A","E01008740","Total",609,183,120,63,426,25,108,56,109,9,29,90
"2011","Sunderland 022B","E01008781","Total",633,159,93,66,474,13,105,86,119,9,34,108
"2011","Sunderland 022C","E01008782","Total",607,139,102,37,468,11,135,76,101,6,33,106
"2011","Sunderland 022D","E01008783","Total",622,161,97,64,461,7,126,70,135,11,23,89
"2011","Sunderland 022E","E01008784","Total",648,158,103,55,490,18,127,85,97,9,37,117
"2011","Sunderland 022F","E01008785","Total",624,138,85,53,486,12,158,71,122,1,35,87
"2011","Sunderland 022G","E01008835","Total",611,192,47,145,419,17,38,76,134,13,34,107
"2011","Sunderland 023A","E01008823","Total",606,207,81,126,399,40,83,59,74,15,37,91
"2011","Sunderland 023B","E01008824","Total",625,188,51,137,437,75,46,90,98,17,45,66
"2011","Sunderland 023C","E01008825","Total",687,233,114,119,454,39,111,64,83,12,40,105
"2011","Sunderland 023D","E01008826","Total",606,162,74,88,444,42,81,70,106,15,37,93
"2011","Sunderland 023E","E01008827","Total",524,152,52,100,372,62,59,56,79,18,29,69
"2011","Sunderland 023F","E01008828","Total",643,178,77,101,465,87,61,70,89,23,50,85
"2011","Sunderland 023G","E01008829","Total",627,272,94,178,355,59,40,59,92,13,35,57
"2011","Sunderland 024A","E01008739","Total",606,129,50,79,477,56,72,91,95,20,36,107
"2011","Sunderland 024B","E01008741","Total",619,162,73,89,457,34,81,90,124,10,30,88
"2011","Sunderland 024C","E01008779","Total",689,265,148,117,424,44,85,72,108,12,28,75
"2011","Sunderland 024D","E01008780","Total",848,328,113,215,520,49,72,118,118,14,42,107
"2011","Sunderland 025A","E01008799","Total",641,122,42,80,519,16,62,119,156,17,45,104
"2011","Sunderland 025B","E01008861","Total",649,181,73,108,468,37,99,64,123,12,36,97
"2011","Sunderland 025C","E01008862","Total",567,86,39,47,481,11,85,79,151,8,29,118
"2011","Sunderland 025D","E01008863","Total",633,100,44,56,533,17,106,94,149,11,42,114
"2011","Sunderland 025E","E01008864","Total",540,108,37,71,432,5,106,63,136,7,31,84
"2011","Sunderland 025F","E01008865","Total",608,172,106,66,436,32,95,75,117,13,27,77
"2011","Sunderland 025G","E01008866","Total",606,194,70,124,412,37,48,70,127,22,38,70
"2011","Sunderland 026A","E01008773","Total",675,262,92,170,413,77,55,90,104,9,20,58
"2011","Sunderland 026B","E01008776","Total",494,133,70,63,361,45,52,60,86,13,39,66
"2011","Sunderland 026C","E01008777","Total",886,556,292,264,330,24,128,30,100,2,10,36
"2011","Sunderland 026D","E01008778","Total",609,175,98,77,434,61,83,80,102,9,31,68
"2011","Sunderland 026E","E01008809","Total",693,197,93,104,496,37,96,85,150,4,29,95
"2011","Sunderland 027A","E01008803","Total",650,236,129,107,414,44,75,67,107,17,22,82
"2011","Sunderland 027B","E01008804","Total",663,188,105,83,475,42,96,72,107,13,53,92
"2011","Sunderland 027C","E01008805","Total",660,247,92,155,413,52,56,76,103,9,30,87
"2011","Sunderland 027F","E01033077","Total",741,206,105,101,535,48,99,89,108,11,58,122
"2011","Sunderland 028A","E01008763","Total",607,154,73,81,453,61,75,75,98,13,48,83
"2011","Sunderland 028B","E01008764","Total",652,181,86,95,471,36,92,58,134,16,39,96
"2011","Sunderland 028C","E01008766","Total",911,265,136,129,646,64,81,132,153,20,79,117
"2011","Sunderland 028D","E01008768","Total",585,137,58,79,448,25,91,94,116,8,36,78
"2011","Sunderland 028E","E01008769","Total",775,273,114,159,502,56,82,106,132,11,36,79
"2011","Sunderland 029A","E01008772","Total",585,162,102,60,423,2,114,88,96,7,39,77
"2011","Sunderland 029B","E01008774","Total",591,166,106,60,425,31,134,62,94,8,24,72
"2011","Sunderland 029C","E01008775","Total",601,135,86,49,466,9,136,76,114,6,26,99
"2011","Sunderland 029D","E01008802","Total",643,200,130,70,443,13,118,64,114,10,33,91
"2011","Sunderland 029E","E01008808","Total",634,178,34,144,456,29,58,75,150,8,26,110
"2011","Sunderland 030A","E01008793","Total",823,356,163,193,467,86,73,84,106,19,22,77
"2011","Sunderland 030B","E01008795","Total",722,153,72,81,569,42,87,130,145,18,30,117
"2011","Sunderland 030C","E01008797","Total",833,203,124,79,630,30,150,147,149,15,39,100
"2011","Sunderland 030D","E01008800","Total",582,178,62,116,404,60,45,83,78,20,39,79
"2011","Sunderland 030E","E01008801","Total",658,149,66,83,509,21,91,116,144,11,42,84
"2011","Sunderland 031A","E01008765","Total",603,125,51,74,478,24,66,105,121,8,48,106
"2011","Sunderland 031B","E01008767","Total",632,163,100,63,469,33,101,80,114,9,37,95
"2011","Sunderland 031C","E01008770","Total",600,177,66,111,423,17,56,81,119,8,34,108
"2011","Sunderland 031D","E01008771","Total",618,152,61,91,466,29,79,107,108,13,34,96
"2011","Sunderland 032A","E01008720","Total",618,186,75,111,432,37,89,76,118,17,17,78
"2011","Sunderland 032B","E01008721","Total",626,133,50,83,493,19,64,136,135,20,30,89
"2011","Sunderland 032D","E01008796","Total",621,163,62,101,458,24,42,110,136,9,36,101
"2011","Sunderland 032F","E01032483","Total",728,211,84,127,517,37,72,85,154,18,42,109
"2011","Sunderland 032G","E01032484","Total",572,170,67,103,402,21,87,69,115,10,29,71
"2011","Sunderland 033A","E01008750","Total",762,171,91,80,591,40,90,134,166,9,37,115
"2011","Sunderland 033B","E01008751","Total",462,131,61,70,331,27,67,55,93,3,24,62
"2011","Sunderland 033C","E01008752","Total",692,224,91,133,468,63,67,89,105,28,32,84
"2011","Sunderland 033D","E01008753","Total",559,189,83,106,370,34,74,79,93,7,17,66
"2011","Sunderland 033E","E01008755","Total",589,176,72,104,413,36,75,68,121,16,25,72
"2011","Sunderland 034A","E01008714","Total",528,143,58,85,385,68,63,75,75,15,28,61
"2011","Sunderland 034B","E01008715","Total",587,192,91,101,395,40,66,71,118,10,25,65
"2011","Sunderland 034C","E01008716","Total",592,152,97,55,440,13,126,65,103,8,25,100
"2011","Sunderland 034D","E01008717","Total",683,163,86,77,520,53,85,115,142,11,38,76
"2011","Sunderland 034E","E01008749","Total",638,164,95,69,474,12,159,60,115,8,33,87
"2011","Sunderland 034F","E01008754","Total",694,296,169,127,398,37,81,66,118,8,26,62
"2011","Sunderland 035A","E01008718","Total",610,185,97,88,425,17,100,65,105,9,42,87
"2011","Sunderland 035B","E01008719","Total",557,224,111,113,333,30,58,64,87,9,19,66
"2011","Sunderland 035C","E01008742","Total",754,254,123,131,500,51,86,69,133,13,41,107
"2011","Sunderland 035D","E01008747","Total",656,198,98,100,458,22,120,73,133,7,24,79
"2011","Sunderland 035E","E01008748","Total",655,221,139,82,434,13,146,48,115,6,21,85
"2011","Sunderland 036A","E01008743","Total",725,230,106,124,495,78,82,87,107,24,36,81
"2011","Sunderland 036B","E01008744","Total",750,288,104,184,462,68,73,90,117,14,27,73
"2011","Sunderland 036C","E01008745","Total",728,182,109,73,546,24,122,93,175,11,30,91
"2011","Sunderland 036D","E01008746","Total",714,246,101,145,468,69,71,83,103,28,33,81
"2011","Blackburn with Darwen 001A","E01012607","Total",640,202,86,116,438,16,120,71,105,20,39,67
"2011","Blackburn with Darwen 001B","E01012608","Total",731,286,85,201,445,66,58,86,107,31,35,62
"2011","Blackburn with Darwen 001C","E01012633","Total",729,269,124,145,460,42,91,74,121,13,41,78
"2011","Blackburn with Darwen 001D","E01012634","Total",590,183,57,126,407,35,83,78,92,16,39,64
"2011","Blackburn with Darwen 001E","E01012635","Total",589,139,74,65,450,25,70,80,87,39,63,86
"2011","Blackburn with Darwen 001F","E01012636","Total",673,199,134,65,474,24,145,71,106,15,21,92
"2011","Blackburn with Darwen 002A","E01012581","Total",495,113,53,60,382,4,97,73,96,17,37,58
"2011","Blackburn with Darwen 002B","E01012582","Total",525,77,36,41,448,14,73,77,95,24,73,92
"2011","Blackburn with Darwen 002C","E01012583","Total",643,148,87,61,495,14,131,82,111,26,47,84
"2011","Blackburn with Darwen 002D","E01012587","Total",661,163,60,103,498,30,71,81,101,55,81,79
"2011","Blackburn with Darwen 002E","E01012588","Total",617,134,41,93,483,33,40,121,62,81,87,59
"2011","Blackburn with Darwen 003A","E01012574","Total",563,198,96,102,365,28,69,76,59,34,49,50
"2011","Blackburn with Darwen 003B","E01012577","Total",516,98,33,65,418,30,24,67,51,66,114,66
"2011","Blackburn with Darwen 003C","E01012578","Total",528,90,30,60,438,32,18,73,51,56,122,86
"2011","Blackburn with Darwen 003D","E01012605","Total",578,142,66,76,436,29,30,81,60,65,91,80
"2011","Blackburn with Darwen 003E","E01012606","Total",483,94,33,61,389,27,21,80,50,65,72,74
"2011","Blackburn with Darwen 004A","E01012579","Total",542,178,67,111,364,18,29,56,51,48,78,84
"2011","Blackburn with Darwen 004B","E01012580","Total",537,70,15,55,467,13,21,58,60,61,142,112
"2011","Blackburn with Darwen 004C","E01012642","Total",482,124,30,94,358,18,27,59,51,49,90,64
"2011","Blackburn with Darwen 004D","E01012645","Total",582,109,50,59,473,21,48,96,70,67,82,89
"2011","Blackburn with Darwen 005A","E01012585","Total",466,118,64,54,348,6,39,52,67,30,81,73
"2011","Blackburn with Darwen 005B","E01012586","Total",490,159,41,118,331,13,23,46,55,35,89,70
"2011","Blackburn with Darwen 005C","E01012656","Total",627,253,58,195,374,31,37,79,60,47,65,55
"2011","Blackburn with Darwen 005D","E01012657","Total",718,253,57,196,465,45,39,86,74,61,93,67
"2011","Blackburn with Darwen 005E","E01012658","Total",756,251,101,150,505,55,73,97,123,28,48,81
"2011","Blackburn with Darwen 006A","E01012629","Total",479,169,24,145,310,55,24,67,83,14,27,40
"2011","Blackburn with Darwen 006B","E01012631","Total",579,291,97,194,288,25,37,60,68,37,32,29
"2011","Blackburn with Darwen 006C","E01012643","Total",627,288,85,203,339,23,38,54,58,44,68,54
"2011","Blackburn with Darwen 006D","E01012644","Total",661,104,29,75,557,9,30,84,79,63,134,158
"2011","Blackburn with Darwen 006E","E01012655","Total",879,494,167,327,385,72,52,59,111,25,35,31
"2011","Blackburn with Darwen 007A","E01012571","Total",457,113,32,81,344,27,15,58,63,55,66,60
"2011","Blackburn with Darwen 007B","E01012572","Total",522,175,53,122,347,27,33,44,45,60,67,71
"2011","Blackburn with Darwen 007C","E01012573","Total",484,85,25,60,399,18,27,75,30,57,99,93
"2011","Blackburn with Darwen 007D","E01012575","Total",546,259,87,172,287,20,40,49,59,32,40,47
"2011","Blackburn with Darwen 007E","E01012630","Total",601,100,18,82,501,37,28,77,75,73,133,78
"2011","Blackburn with Darwen 008A","E01012576","Total",569,228,104,124,341,24,52,60,55,30,59,61
"2011","Blackburn with Darwen 008B","E01012637","Total",637,191,56,135,446,90,50,82,92,27,49,56
"2011","Blackburn with Darwen 008C","E01012638","Total",703,276,91,185,427,79,35,96,98,25,40,54
"2011","Blackburn with Darwen 008D","E01012639","Total",722,213,54,159,509,101,61,89,101,34,40,83
"2011","Blackburn with Darwen 008E","E01012640","Total",722,220,62,158,502,59,83,92,105,37,39,87
"2011","Blackburn with Darwen 008F","E01012641","Total",550,122,36,86,428,77,31,80,70,49,56,65
"2011","Blackburn with Darwen 009A","E01012595","Total",860,336,128,208,524,79,53,101,158,17,39,77
"2011","Blackburn with Darwen 009B","E01012596","Total",794,283,56,227,511,83,44,103,140,16,38,87
"2011","Blackburn with Darwen 009C","E01012622","Total",780,367,99,268,413,78,41,100,84,26,33,51
"2011","Blackburn with Darwen 009D","E01012623","Total",636,204,68,136,432,52,56,78,115,18,44,69
"2011","Blackburn with Darwen 009E","E01012624","Total",715,277,98,179,438,56,53,93,107,19,39,71
"2011","Blackburn with Darwen 009F","E01012625","Total",774,301,87,214,473,93,58,86,136,16,21,63
"2011","Blackburn with Darwen 010A","E01012584","Total",521,105,44,61,416,14,82,60,103,27,59,71
"2011","Blackburn with Darwen 010B","E01012609","Total",654,136,91,45,518,11,150,82,121,16,35,103
"2011","Blackburn with Darwen 010C","E01012610","Total",506,107,65,42,399,33,76,64,103,16,34,73
"2011","Blackburn with Darwen 010D","E01012611","Total",482,140,74,66,342,15,95,50,99,6,19,58
"2011","Blackburn with Darwen 010E","E01012612","Total",625,162,104,58,463,23,161,74,91,8,24,82
"2011","Blackburn with Darwen 010F","E01012613","Total",558,153,90,63,405,15,94,81,92,5,33,85
"2011","Blackburn with Darwen 011A","E01012600","Total",635,260,117,143,375,52,78,55,82,20,31,57
"2011","Blackburn with Darwen 011B","E01012601","Total",593,158,54,104,435,81,51,67,86,35,37,78
"2011","Blackburn with Darwen 011C","E01012602","Total",651,153,33,120,498,34,34,147,158,15,29,81
"2011","Blackburn with Darwen 011D","E01012603","Total",649,229,46,183,420,93,33,72,90,28,47,57
"2011","Blackburn with Darwen 011E","E01012604","Total",599,122,27,95,477,55,45,112,110,40,44,71
"2011","Blackburn with Darwen 011F","E01012632","Total",808,272,92,180,536,35,63,104,123,35,82,94
"2011","Blackburn with Darwen 012A","E01012594","Total",626,220,76,144,406,69,55,76,81,30,36,59
"2011","Blackburn with Darwen 012B","E01012618","Total",647,187,91,96,460,28,106,70,139,8,31,78
"2011","Blackburn with Darwen 012C","E01012619","Total",554,172,69,103,382,68,51,56,66,25,49,67
"2011","Blackburn with Darwen 012D","E01012620","Total",639,178,92,86,461,25,136,56,124,7,24,89
"2011","Blackburn with Darwen 012E","E01012621","Total",625,186,44,142,439,60,56,85,104,23,34,77
"2011","Blackburn with Darwen 013A","E01012593","Total",742,196,55,141,546,46,77,131,157,20,38,77
"2011","Blackburn with Darwen 013B","E01012597","Total",679,140,54,86,539,28,57,131,150,21,53,99
"2011","Blackburn with Darwen 013C","E01012598","Total",1050,141,18,123,909,52,65,312,243,42,80,115
"2011","Blackburn with Darwen 013D","E01012599","Total",498,142,49,93,356,26,61,64,114,11,25,55
"2011","Blackburn with Darwen 014A","E01012589","Total",653,239,89,150,414,56,57,77,130,16,19,59
"2011","Blackburn with Darwen 014B","E01012590","Total",630,237,111,126,393,62,83,55,96,19,28,50
"2011","Blackburn with Darwen 014C","E01012591","Total",666,255,83,172,411,41,70,73,102,16,34,75
"2011","Blackburn with Darwen 014D","E01012648","Total",531,189,51,138,342,47,41,74,103,13,21,43
"2011","Blackburn with Darwen 014E","E01012652","Total",652,156,92,64,496,14,124,68,133,12,37,108
"2011","Blackburn with Darwen 015A","E01012617","Total",602,180,45,135,422,63,48,73,115,14,25,84
"2011","Blackburn with Darwen 015B","E01012646","Total",744,281,114,167,463,88,54,85,112,22,33,69
"2011","Blackburn with Darwen 015C","E01012647","Total",646,245,77,168,401,52,95,58,104,10,20,62
"2011","Blackburn with Darwen 015D","E01012650","Total",596,205,70,135,391,67,51,57,115,22,40,39
"2011","Blackburn with Darwen 016A","E01012649","Total",633,249,90,159,384,55,53,69,91,19,34,63
"2011","Blackburn with Darwen 016B","E01012651","Total",686,161,60,101,525,63,87,104,136,20,36,79
"2011","Blackburn with Darwen 016C","E01012653","Total",580,197,57,140,383,53,53,73,108,9,30,57
"2011","Blackburn with Darwen 016D","E01012654","Total",762,295,63,232,467,58,43,86,159,29,29,63
"2011","Blackburn with Darwen 017A","E01012614","Total",673,141,60,81,532,26,70,121,138,16,53,108
"2011","Blackburn with Darwen 017B","E01012615","Total",748,323,136,187,425,37,95,73,120,11,20,69
"2011","Blackburn with Darwen 017C","E01012616","Total",761,226,76,150,535,42,76,124,154,15,42,82
"2011","Blackburn with Darwen 017D","E01012659","Total",593,174,58,116,419,24,56,97,122,15,21,84
"2011","Blackburn with Darwen 017E","E01012660","Total",463,91,43,48,372,15,72,66,99,11,26,83
"2011","Blackburn with Darwen 017F","E01012661","Total",687,240,76,164,447,41,60,96,140,12,24,74
"2011","Blackburn with Darwen 018A","E01012592","Total",826,201,83,118,625,24,137,92,202,15,44,111
"2011","Blackburn with Darwen 018D","E01012628","Total",497,123,44,79,374,8,68,70,129,6,26,67
"2011","Blackburn with Darwen 018E","E01032485","Total",719,162,57,105,557,18,100,124,163,20,31,101
"2011","Blackburn with Darwen 018F","E01032486","Total",606,144,75,69,462,18,127,89,119,8,36,65
"2011","Blackpool 001A","E01012663","Total",751,294,150,144,457,38,137,74,81,15,34,78
"2011","Blackpool 001B","E01012664","Total",714,216,106,110,498,53,103,84,131,14,30,83
"2011","Blackpool 001C","E01012665","Total",863,346,240,106,517,33,203,62,125,7,18,69
"2011","Blackpool 001D","E01012716","Total",642,227,119,108,415,25,108,79,80,10,33,80
"2011","Blackpool 001E","E01012719","Total",625,184,115,69,441,30,133,81,95,16,24,62
"2011","Blackpool 002A","E01012662","Total",832,416,252,164,416,23,154,51,112,4,13,59
"2011","Blackpool 002B","E01012703","Total",706,235,142,93,471,38,145,63,117,17,18,73
"2011","Blackpool 002C","E01012704","Total",1078,535,202,333,543,75,89,107,179,15,23,55
"2011","Blackpool 002D","E01012706","Total",709,199,91,108,510,42,86,115,145,11,35,76
"2011","Blackpool 002E","E01012717","Total",715,201,122,79,514,12,159,80,110,12,49,92
"2011","Blackpool 003A","E01012666","Total",667,280,95,185,387,25,104,64,99,10,22,63
"2011","Blackpool 003B","E01012667","Total",642,161,107,54,481,30,117,87,108,11,33,95
"2011","Blackpool 003C","E01012668","Total",728,269,143,126,459,22,128,75,113,15,29,77
"2011","Blackpool 003D","E01012669","Total",875,388,168,220,487,20,128,71,132,15,37,84
"2011","Blackpool 003E","E01012718","Total",771,246,175,71,525,21,207,73,115,3,28,78
"2011","Blackpool 004A","E01012690","Total",740,201,73,128,539,53,101,107,133,15,32,98
"2011","Blackpool 004B","E01012691","Total",790,215,107,108,575,55,121,121,140,19,32,87
"2011","Blackpool 004C","E01012692","Total",827,324,151,173,503,59,105,87,134,13,37,68
"2011","Blackpool 004D","E01012705","Total",727,248,104,144,479,66,94,91,113,17,23,75
"2011","Blackpool 004E","E01012723","Total",654,212,85,127,442,43,99,76,111,7,26,80
"2011","Blackpool 005A","E01012693","Total",725,231,117,114,494,31,138,97,132,8,25,63
"2011","Blackpool 005B","E01012711","Total",602,181,74,107,421,45,74,75,114,9,32,72
"2011","Blackpool 005C","E01012747","Total",611,130,77,53,481,27,135,79,107,9,34,90
"2011","Blackpool 005D","E01012750","Total",735,224,98,126,511,51,111,76,110,19,38,106
"2011","Blackpool 006A","E01012681","Total",762,493,78,415,269,40,31,24,112,4,17,41
"2011","Blackpool 006B","E01012683","Total",715,392,78,314,323,37,39,37,92,18,39,61
"2011","Blackpool 006C","E01012748","Total",715,340,100,240,375,44,61,46,96,17,36,75
"2011","Blackpool 006D","E01012749","Total",715,305,83,222,410,25,82,67,93,15,47,81
"2011","Blackpool 007A","E01012707","Total",640,306,118,188,334,42,50,69,98,6,19,50
"2011","Blackpool 007B","E01012720","Total",649,198,72,126,451,85,70,86,88,33,30,59
"2011","Blackpool 007C","E01012721","Total",835,397,111,286,438,93,58,76,112,15,33,51
"2011","Blackpool 007D","E01012724","Total",621,301,92,209,320,39,54,61,80,16,27,43
"2011","Blackpool 008A","E01012678","Total",738,409,73,336,329,44,29,49,116,17,25,49
"2011","Blackpool 008B","E01012679","Total",637,248,78,170,389,78,40,72,88,15,45,51
"2011","Blackpool 008C","E01012680","Total",684,235,67,168,449,69,51,79,112,28,42,68
"2011","Blackpool 008D","E01012682","Total",745,379,118,261,366,58,53,59,107,18,25,46
"2011","Blackpool 008E","E01012684","Total",689,270,91,179,419,74,57,86,130,18,18,36
"2011","Blackpool 009A","E01012676","Total",611,205,87,118,406,31,74,75,109,13,37,67
"2011","Blackpool 009B","E01012677","Total",614,215,91,124,399,26,77,67,108,11,35,75
"2011","Blackpool 009C","E01012708","Total",607,182,73,109,425,46,77,91,115,10,21,65
"2011","Blackpool 009D","E01012709","Total",744,248,84,164,496,114,57,109,117,21,10,68
"2011","Blackpool 009E","E01012710","Total",480,127,72,55,353,24,76,66,81,11,28,67
"2011","Blackpool 009F","E01012722","Total",514,155,34,121,359,19,56,87,88,5,34,70
"2011","Blackpool 010A","E01012673","Total",712,399,102,297,313,46,26,48,100,17,24,52
"2011","Blackpool 010B","E01012675","Total",697,278,75,203,419,80,39,73,105,24,31,67
"2011","Blackpool 010C","E01012735","Total",700,404,109,295,296,22,70,29,96,6,22,51
"2011","Blackpool 010D","E01012736","Total",468,306,44,262,162,8,35,14,71,1,9,24
"2011","Blackpool 010E","E01012737","Total",805,510,100,410,295,26,34,35,111,15,22,52
"2011","Blackpool 011A","E01012670","Total",574,221,63,158,353,82,37,64,103,15,22,30
"2011","Blackpool 011B","E01012733","Total",471,194,53,141,277,36,38,49,79,12,20,43
"2011","Blackpool 011C","E01012734","Total",631,210,75,135,421,57,65,81,105,12,30,71
"2011","Blackpool 011D","E01012738","Total",563,216,51,165,347,51,52,49,80,21,30,64
"2011","Blackpool 011E","E01012739","Total",578,177,65,112,401,57,63,67,88,18,40,68
"2011","Blackpool 011F","E01012742","Total",541,202,77,125,339,33,63,46,102,8,21,66
"2011","Blackpool 012A","E01012712","Total",695,163,72,91,532,31,95,124,142,11,40,89
"2011","Blackpool 012B","E01012713","Total",826,233,82,151,593,67,101,128,145,20,31,101
"2011","Blackpool 012C","E01012715","Total",698,231,96,135,467,56,78,86,121,10,33,83
"2011","Blackpool 012D","E01012740","Total",685,288,142,146,397,23,78,73,100,8,27,88
"2011","Blackpool 012E","E01012741","Total",608,202,106,96,406,36,85,74,94,13,21,83
"2011","Blackpool 013A","E01012671","Total",586,318,68,250,268,48,32,24,105,6,20,33
"2011","Blackpool 013B","E01012672","Total",540,319,52,267,221,21,28,22,78,7,26,39
"2011","Blackpool 013C","E01012674","Total",720,326,64,262,394,52,36,55,98,21,47,85
"2011","Blackpool 013D","E01012751","Total",735,471,73,398,264,23,45,32,114,6,15,29
"2011","Blackpool 014A","E01012686","Total",636,230,70,160,406,72,53,70,92,22,37,60
"2011","Blackpool 014B","E01012687","Total",632,252,74,178,380,57,46,61,95,22,34,65
"2011","Blackpool 014C","E01012688","Total",658,284,160,124,374,41,117,41,107,6,19,43
"2011","Blackpool 014D","E01012689","Total",630,235,97,138,395,41,100,57,114,12,14,57
"2011","Blackpool 014E","E01012714","Total",796,287,137,150,509,42,118,85,145,6,31,82
"2011","Blackpool 015A","E01012695","Total",616,191,75,116,425,75,63,76,108,14,34,55
"2011","Blackpool 015B","E01012743","Total",742,279,105,174,463,61,65,75,114,27,39,82
"2011","Blackpool 015C","E01012744","Total",746,284,131,153,462,75,61,74,127,21,36,68
"2011","Blackpool 015D","E01012745","Total",755,249,100,149,506,60,117,83,108,15,38,85
"2011","Blackpool 015E","E01012746","Total",796,270,121,149,526,72,95,111,122,19,39,68
"2011","Blackpool 016A","E01012685","Total",638,174,63,111,464,67,60,111,128,13,26,59
"2011","Blackpool 016B","E01012694","Total",645,230,119,111,415,66,85,73,104,11,25,51
"2011","Blackpool 016C","E01012696","Total",667,176,70,106,491,89,69,103,119,9,26,76
"2011","Blackpool 016D","E01012697","Total",680,274,153,121,406,29,116,74,97,6,27,57
"2011","Blackpool 016E","E01012698","Total",637,172,61,111,465,89,63,78,105,18,29,83
"2011","Blackpool 017A","E01012726","Total",757,252,138,114,505,42,135,81,110,17,42,78
"2011","Blackpool 017B","E01012728","Total",736,319,121,198,417,45,90,87,87,15,26,67
"2011","Blackpool 017C","E01012752","Total",583,275,90,185,308,28,64,35,79,9,29,64
"2011","Blackpool 017D","E01012753","Total",469,134,61,73,335,23,63,55,68,12,37,77
"2011","Blackpool 017E","E01012754","Total",522,204,66,138,318,44,38,41,86,14,26,69
"2011","Blackpool 017F","E01012755","Total",608,173,81,92,435,19,82,78,118,16,31,91
"2011","Blackpool 018A","E01012701","Total",619,164,86,78,455,44,100,89,96,14,29,83
"2011","Blackpool 018B","E01012729","Total",749,218,135,83,531,41,178,69,132,11,27,73
"2011","Blackpool 018C","E01012730","Total",685,178,85,93,507,29,97,79,144,11,41,106
"2011","Blackpool 018D","E01012731","Total",728,233,113,120,495,58,107,89,122,10,26,83
"2011","Blackpool 018E","E01012732","Total",829,317,199,118,512,56,135,68,138,13,29,73
"2011","Blackpool 019A","E01012699","Total",759,209,117,92,550,45,120,108,148,14,28,87
"2011","Blackpool 019B","E01012700","Total",758,206,121,85,552,40,119,101,124,17,50,101
"2011","Blackpool 019C","E01012702","Total",766,386,216,170,380,30,124,55,82,11,22,56
"2011","Blackpool 019D","E01012725","Total",595,195,108,87,400,22,88,62,104,9,46,69
"2011","Blackpool 019E","E01012727","Total",653,160,95,65,493,12,118,82,126,14,51,90
"2011","Cheshire East 022A","E01018393","Total",839,178,78,100,661,16,158,110,198,26,36,117
"2011","Cheshire East 022B","E01018411","Total",934,189,118,71,745,14,205,156,166,24,53,127
"2011","Cheshire East 022C","E01018412","Total",660,169,104,65,491,16,163,77,107,16,24,88
"2011","Cheshire East 023A","E01018413","Total",503,94,56,38,409,19,82,115,97,11,25,60
"2011","Cheshire East 023B","E01018414","Total",624,167,86,81,457,4,162,65,116,8,27,75
"2011","Cheshire East 023C","E01018415","Total",774,292,203,89,482,40,127,94,112,10,27,72
"2011","Cheshire East 023D","E01018416","Total",518,92,39,53,426,13,97,93,106,11,26,80
"2011","Cheshire East 024A","E01018424","Total",731,203,69,134,528,34,86,111,164,18,30,85
"2011","Cheshire East 024B","E01018425","Total",748,291,116,175,457,16,106,83,138,10,32,72
"2011","Cheshire East 024C","E01018426","Total",727,223,123,100,504,26,133,82,120,14,24,105
"2011","Cheshire East 024D","E01018427","Total",504,88,42,46,416,22,61,76,116,9,24,108
"2011","Cheshire East 025A","E01018419","Total",535,109,31,78,426,28,36,116,131,6,31,78
"2011","Cheshire East 025B","E01018420","Total",716,149,40,109,567,43,52,173,156,31,46,66
"2011","Cheshire East 025C","E01018421","Total",539,123,38,85,416,24,40,112,131,14,31,64
"2011","Cheshire East 025D","E01018422","Total",542,142,69,73,400,36,74,92,105,12,25,56
"2011","Cheshire East 025E","E01018423","Total",629,200,86,114,429,33,72,86,124,16,35,63
"2011","Cheshire East 026A","E01018395","Total",701,171,74,97,530,28,145,97,134,7,23,96
"2011","Cheshire East 026B","E01018396","Total",609,150,91,59,459,36,115,84,100,18,31,75
"2011","Cheshire East 026C","E01018400","Total",977,401,103,298,576,80,79,121,154,21,42,79
"2011","Cheshire East 026D","E01018401","Total",610,136,47,89,474,37,83,92,116,26,42,78
"2011","Cheshire East 027A","E01018398","Total",735,298,144,154,437,52,99,71,128,7,25,55
"2011","Cheshire East 027B","E01018399","Total",690,260,107,153,430,24,73,97,131,14,19,72
"2011","Cheshire East 027C","E01018402","Total",942,408,97,311,534,48,90,89,194,7,23,83
"2011","Cheshire East 027D","E01018403","Total",825,192,96,96,633,31,152,112,170,17,27,124
"2011","Cheshire East 028A","E01018397","Total",726,187,72,115,539,23,79,162,138,19,36,82
"2011","Cheshire East 028B","E01018408","Total",756,175,96,79,581,22,132,105,175,8,30,109
"2011","Cheshire East 028C","E01018409","Total",870,318,201,117,552,37,157,93,138,13,30,84
"2011","Cheshire East 028D","E01018410","Total",653,147,89,58,506,9,154,89,110,13,30,101
"2011","Cheshire East 029A","E01018404","Total",611,148,92,56,463,5,120,99,112,7,25,95
"2011","Cheshire East 029B","E01018405","Total",600,156,46,110,444,25,71,90,148,14,13,83
"2011","Cheshire East 029C","E01018406","Total",613,153,77,76,460,12,131,97,108,24,16,72
"2011","Cheshire East 029D","E01018407","Total",643,156,89,67,487,13,127,96,144,15,21,71
"2011","Cheshire East 030A","E01018436","Total",611,166,93,73,445,10,128,73,102,6,25,101
"2011","Cheshire East 030B","E01018437","Total",753,280,113,167,473,32,93,98,158,9,26,57
"2011","Cheshire East 030C","E01018438","Total",619,150,104,46,469,18,144,71,113,8,24,91
"2011","Cheshire East 030D","E01018439","Total",557,118,88,30,439,9,147,65,109,13,28,68
"2011","Cheshire East 031A","E01018440","Total",724,210,58,152,514,32,56,152,151,10,37,76
"2011","Cheshire East 031B","E01018441","Total",654,139,33,106,515,39,40,171,139,19,39,68
"2011","Cheshire East 031C","E01018442","Total",753,208,89,119,545,25,103,137,132,22,42,84
"2011","Cheshire East 031D","E01018443","Total",639,162,71,91,477,16,98,100,132,8,30,93
"2011","Cheshire East 032A","E01018432","Total",648,184,103,81,464,20,112,88,113,14,27,90
"2011","Cheshire East 032B","E01018433","Total",586,176,107,69,410,16,139,59,110,4,16,66
"2011","Cheshire East 032C","E01018434","Total",623,205,92,113,418,20,104,69,130,13,17,65
"2011","Cheshire East 032D","E01018435","Total",673,304,160,144,369,30,65,79,105,9,22,59
"2011","Cheshire East 033A","E01018394","Total",815,169,72,97,646,17,146,130,165,19,47,122
"2011","Cheshire East 033B","E01018417","Total",734,200,116,84,534,17,204,71,127,9,24,82
"2011","Cheshire East 033C","E01018418","Total",661,173,83,90,488,22,131,66,146,8,29,86
"2011","Cheshire East 033D","E01018428","Total",625,191,102,89,434,21,86,80,136,8,33,70
"2011","Cheshire East 033E","E01018429","Total",660,171,95,76,489,27,143,77,126,8,32,76
"2011","Cheshire East 033F","E01018430","Total",577,130,48,82,447,20,86,80,123,9,32,97
"2011","Cheshire East 033G","E01018431","Total",512,125,51,74,387,14,72,78,129,4,15,75
"2011","Cheshire East 040A","E01018387","Total",736,164,113,51,572,11,229,71,118,10,42,91
"2011","Cheshire East 040B","E01018388","Total",745,316,107,209,429,53,76,70,119,14,36,61
"2011","Cheshire East 040C","E01018389","Total",729,250,155,95,479,29,117,88,122,11,43,69
"2011","Cheshire East 040D","E01018390","Total",757,228,153,75,529,31,154,72,135,16,35,86
"2011","Cheshire East 042A","E01018386","Total",629,223,135,88,406,20,133,69,97,8,16,63
"2011","Cheshire East 042B","E01018391","Total",812,235,128,107,577,48,88,147,150,22,36,86
"2011","Cheshire East 042C","E01018392","Total",775,174,77,97,601,18,132,118,148,18,40,127
"2011","Cheshire East 034A","E01018472","Total",659,236,65,171,423,28,56,77,158,10,21,73
"2011","Cheshire East 034B","E01018473","Total",657,135,18,117,522,40,43,144,161,17,41,76
"2011","Cheshire East 034C","E01018474","Total",670,113,21,92,557,23,41,137,163,23,61,109
"2011","Cheshire East 034D","E01018475","Total",632,87,13,74,545,19,32,181,129,28,54,102
"2011","Cheshire East 035A","E01018463","Total",627,196,65,131,431,41,49,93,132,16,37,63
"2011","Cheshire East 035B","E01018476","Total",513,136,56,80,377,76,52,62,60,28,38,61
"2011","Cheshire East 035C","E01018477","Total",627,194,113,81,433,37,88,86,106,27,35,54
"2011","Cheshire East 035D","E01018478","Total",527,119,59,60,408,38,52,81,83,22,56,76
"2011","Cheshire East 035E","E01018479","Total",704,207,105,102,497,31,82,97,165,17,32,73
"2011","Cheshire East 036A","E01018459","Total",510,107,46,61,403,62,52,74,81,23,47,64
"2011","Cheshire East 036B","E01018460","Total",622,177,107,70,445,35,128,75,102,12,18,75
"2011","Cheshire East 036C","E01018461","Total",628,197,100,97,431,46,98,67,115,17,25,63
"2011","Cheshire East 036D","E01018466","Total",1126,493,152,341,633,106,78,138,177,20,31,83
"2011","Cheshire East 036E","E01018467","Total",996,376,84,292,620,88,35,141,184,18,41,113
"2011","Cheshire East 037A","E01018482","Total",639,214,93,121,425,40,87,60,115,17,21,85
"2011","Cheshire East 037B","E01018483","Total",631,189,78,111,442,28,121,59,122,8,18,86
"2011","Cheshire East 037C","E01018484","Total",901,241,107,134,660,117,42,178,150,43,48,82
"2011","Cheshire East 037D","E01018485","Total",633,193,49,144,440,62,50,80,114,31,35,68
"2011","Cheshire East 038A","E01018499","Total",711,242,96,146,469,38,85,104,140,9,26,67
"2011","Cheshire East 038B","E01018500","Total",529,114,60,54,415,8,106,67,119,8,23,84
"2011","Cheshire East 038C","E01018501","Total",766,311,180,131,455,23,128,64,117,8,22,93
"2011","Cheshire East 038D","E01018502","Total",543,133,79,54,410,15,153,47,115,7,13,60
"2011","Cheshire East 039A","E01018462","Total",715,304,78,226,411,65,37,93,137,9,12,58
"2011","Cheshire East 039B","E01018464","Total",650,243,81,162,407,34,63,70,128,12,19,81
"2011","Cheshire East 039C","E01018496","Total",681,190,82,108,491,31,62,112,134,20,45,87
"2011","Cheshire East 039D","E01018497","Total",526,198,53,145,328,38,30,67,91,9,26,67
"2011","Cheshire East 039E","E01018498","Total",641,195,32,163,446,76,32,95,127,22,25,69
"2011","Cheshire East 041A","E01018465","Total",1172,262,120,142,910,36,193,170,271,27,71,142
"2011","Cheshire East 041B","E01018468","Total",640,132,67,65,508,28,91,93,126,21,43,106
"2011","Cheshire East 041C","E01018469","Total",646,180,113,67,466,22,98,91,118,15,30,92
"2011","Cheshire East 041D","E01018470","Total",576,102,50,52,474,16,86,97,124,11,42,98
"2011","Cheshire East 041E","E01018471","Total",626,138,55,83,488,21,103,95,142,17,19,91
"2011","Cheshire East 043A","E01018486","Total",702,317,97,220,385,35,46,48,115,10,31,100
"2011","Cheshire East 043B","E01018487","Total",653,197,55,142,456,64,36,91,99,18,39,109
"2011","Cheshire East 043C","E01018488","Total",599,138,63,75,461,22,82,87,111,16,48,95
"2011","Cheshire East 043D","E01018489","Total",534,152,36,116,382,28,38,74,97,15,41,89
"2011","Cheshire East 044A","E01018510","Total",623,133,57,76,490,26,59,122,131,19,34,99
"2011","Cheshire East 044B","E01018511","Total",644,225,119,106,419,28,85,88,101,10,28,79
"2011","Cheshire East 044C","E01018512","Total",713,211,123,88,502,42,115,95,106,18,42,84
"2011","Cheshire East 044D","E01018513","Total",660,154,87,67,506,24,108,108,118,18,39,91
"2011","Cheshire East 045A","E01018445","Total",828,261,72,189,567,94,57,124,156,20,38,78
"2011","Cheshire East 045B","E01018446","Total",502,126,34,92,376,46,33,71,82,13,31,100
"2011","Cheshire East 045C","E01018447","Total",727,220,55,165,507,79,45,86,131,21,44,101
"2011","Cheshire East 045D","E01018448","Total",729,210,88,122,519,38,88,107,137,19,33,97
"2011","Cheshire East 046A","E01018490","Total",637,158,108,50,479,11,174,72,108,12,21,81
"2011","Cheshire East 046B","E01018491","Total",625,175,80,95,450,12,109,91,124,12,24,78
"2011","Cheshire East 046C","E01018492","Total",513,182,116,66,331,13,117,45,69,9,16,62
"2011","Cheshire East 046D","E01018505","Total",436,81,45,36,355,6,96,64,89,12,22,66
"2011","Cheshire East 046E","E01018506","Total",533,69,34,35,464,4,99,93,124,11,38,95
"2011","Cheshire East 046F","E01018507","Total",559,81,53,28,478,8,143,69,124,10,38,86
"2011","Cheshire East 047A","E01018451","Total",758,420,224,196,338,27,88,41,100,8,20,54
"2011","Cheshire East 047B","E01018454","Total",708,266,86,180,442,37,58,62,163,19,37,66
"2011","Cheshire East 047C","E01018455","Total",607,197,116,81,410,19,112,75,120,5,22,57
"2011","Cheshire East 047D","E01018456","Total",587,187,142,45,400,9,162,45,83,5,17,79
"2011","Cheshire East 047E","E01018457","Total",759,342,141,201,417,33,66,71,171,7,17,52
"2011","Cheshire East 049A","E01018444","Total",866,219,97,122,647,25,137,112,177,21,56,119
"2011","Cheshire East 049B","E01018480","Total",821,225,95,130,596,22,117,98,181,26,40,112
"2011","Cheshire East 049C","E01018515","Total",897,169,78,91,728,21,118,164,223,33,56,113
"2011","Cheshire East 049D","E01018516","Total",608,139,76,63,469,20,118,96,110,11,27,87
"2011","Cheshire East 049F","E01033375","Total",444,57,8,49,387,24,25,156,92,16,39,35
"2011","Cheshire East 049G","E01033376","Total",447,101,7,94,346,26,14,131,103,21,21,30
"2011","Cheshire East 049H","E01033378","Total",529,108,55,53,421,12,79,102,95,15,42,76
"2011","Cheshire East 048A","E01018493","Total",622,218,139,79,404,24,134,58,109,2,15,62
"2011","Cheshire East 048B","E01018494","Total",597,174,94,80,423,12,103,71,129,13,22,73
"2011","Cheshire East 048C","E01018495","Total",538,121,65,56,417,24,89,63,140,5,26,70
"2011","Cheshire East 048D","E01018508","Total",493,119,65,54,374,13,100,68,92,11,29,61
"2011","Cheshire East 048E","E01018509","Total",514,166,82,84,348,34,71,63,107,11,11,51
"2011","Cheshire East 050A","E01018452","Total",511,163,87,76,348,30,95,58,74,15,22,54
"2011","Cheshire East 050C","E01018503","Total",689,177,123,54,512,11,176,91,119,14,27,74
"2011","Cheshire East 050D","E01018504","Total",855,348,139,209,507,32,133,83,145,13,32,69
"2011","Cheshire East 050E","E01033372","Total",605,205,63,142,400,30,48,86,169,13,15,39
"2011","Cheshire East 050F","E01033373","Total",631,267,116,151,364,45,61,65,112,16,19,46
"2011","Cheshire East 051A","E01018449","Total",746,180,114,66,566,15,185,87,134,14,28,103
"2011","Cheshire East 051B","E01018450","Total",912,235,125,110,677,31,172,109,185,28,38,114
"2011","Cheshire East 051C","E01018458","Total",869,195,113,82,674,18,152,124,192,23,53,112
"2011","Cheshire East 051D","E01018481","Total",803,170,91,79,633,15,176,92,153,33,49,115
"2011","Cheshire East 051E","E01018514","Total",810,182,97,85,628,17,146,103,187,20,44,111
"2011","Cheshire East 001A","E01018585","Total",617,180,97,83,437,19,112,68,118,11,27,82
"2011","Cheshire East 001B","E01018586","Total",686,226,100,126,460,18,84,86,142,12,27,91
"2011","Cheshire East 001C","E01018587","Total",653,159,71,88,494,11,142,85,148,14,23,71
"2011","Cheshire East 001D","E01018661","Total",516,126,63,63,390,8,108,55,93,12,33,81
"2011","Cheshire East 002A","E01018657","Total",487,171,99,72,316,21,73,69,71,15,23,44
"2011","Cheshire East 002B","E01018662","Total",477,95,44,51,382,17,72,96,104,10,18,65
"2011","Cheshire East 002C","E01018663","Total",660,182,127,55,478,17,159,88,82,18,24,90
"2011","Cheshire East 002D","E01018664","Total",589,110,68,42,479,11,130,78,116,14,32,98
"2011","Cheshire East 002E","E01018665","Total",484,126,71,55,358,17,81,75,95,11,15,64
"2011","Cheshire East 003A","E01018655","Total",748,289,169,120,459,22,154,76,119,7,17,64
"2011","Cheshire East 003B","E01018656","Total",647,183,118,65,464,18,146,85,103,8,30,74
"2011","Cheshire East 003C","E01018658","Total",489,85,44,41,404,13,75,97,86,17,30,86
"2011","Cheshire East 003D","E01018659","Total",521,94,63,31,427,5,143,50,105,16,21,87
"2011","Cheshire East 003E","E01018660","Total",406,87,50,37,319,5,85,69,69,9,21,61
"2011","Cheshire East 004A","E01018582","Total",806,354,61,293,452,15,77,103,117,13,41,86
"2011","Cheshire East 004B","E01018592","Total",731,209,108,101,522,33,122,123,129,18,35,62
"2011","Cheshire East 004C","E01018593","Total",767,259,130,129,508,24,130,94,134,18,23,85
"2011","Cheshire East 004D","E01018594","Total",829,366,156,210,463,41,85,88,137,10,23,79
"2011","Cheshire East 004E","E01018595","Total",729,298,154,144,431,24,83,84,124,13,39,64
"2011","Cheshire East 004F","E01018596","Total",916,392,90,302,524,101,56,89,146,20,44,68
"2011","Cheshire East 005A","E01018583","Total",793,211,66,145,582,41,84,131,206,12,36,72
"2011","Cheshire East 005B","E01018584","Total",716,130,41,89,586,21,94,126,170,28,45,102
"2011","Cheshire East 005C","E01018612","Total",520,136,52,84,384,31,83,84,97,8,24,57
"2011","Cheshire East 005D","E01018613","Total",706,286,124,162,420,41,70,89,105,13,23,79
"2011","Cheshire East 006A","E01018600","Total",639,142,82,60,497,10,147,89,104,18,51,78
"2011","Cheshire East 006B","E01018601","Total",836,339,166,173,497,37,99,89,171,12,24,65
"2011","Cheshire East 006C","E01018602","Total",833,343,171,172,490,16,104,103,157,14,30,66
"2011","Cheshire East 006D","E01018652","Total",603,112,48,64,491,18,97,113,125,20,37,81
"2011","Cheshire East 007A","E01018598","Total",649,152,70,82,497,6,102,122,146,17,24,80
"2011","Cheshire East 007B","E01018599","Total",488,94,43,51,394,6,138,83,94,6,17,50
"2011","Cheshire East 007C","E01018648","Total",929,281,128,153,648,36,161,97,186,27,40,101
"2011","Cheshire East 007D","E01018649","Total",586,164,99,65,422,1,166,59,96,16,25,59
"2011","Cheshire East 007E","E01018650","Total",738,230,88,142,508,24,98,108,162,16,22,78
"2011","Cheshire East 007F","E01018651","Total",501,149,74,75,352,15,86,59,95,16,29,52
"2011","Cheshire East 007G","E01018654","Total",910,242,139,103,668,16,194,124,170,21,31,112
"2011","Cheshire East 008A","E01018588","Total",633,157,67,90,476,25,100,117,106,18,30,80
"2011","Cheshire East 008B","E01018589","Total",622,114,73,41,508,14,130,139,106,19,31,69
"2011","Cheshire East 008C","E01018590","Total",746,178,97,81,568,30,122,154,122,25,29,86
"2011","Cheshire East 008D","E01018653","Total",888,284,165,119,604,19,166,140,144,20,40,75
"2011","Cheshire East 009A","E01018605","Total",494,138,91,47,356,12,117,80,75,18,15,39
"2011","Cheshire East 009B","E01018609","Total",754,239,156,83,515,22,171,77,103,18,26,98
"2011","Cheshire East 009C","E01018610","Total",899,329,121,208,570,54,95,108,185,22,34,72
"2011","Cheshire East 009D","E01018611","Total",749,248,69,179,501,78,68,100,142,13,29,71
"2011","Cheshire East 011A","E01018666","Total",715,129,83,46,586,17,186,104,136,22,40,81
"2011","Cheshire East 011B","E01018667","Total",727,245,150,95,482,16,161,89,103,10,35,68
"2011","Cheshire East 011C","E01018668","Total",651,129,85,44,522,6,158,79,136,18,37,88
"2011","Cheshire East 010A","E01018603","Total",512,111,71,40,401,4,104,85,96,17,26,69
"2011","Cheshire East 010B","E01018604","Total",617,202,103,99,415,24,89,100,121,12,17,52
"2011","Cheshire East 010C","E01018606","Total",818,425,242,183,393,32,78,71,135,13,11,53
"2011","Cheshire East 010D","E01018607","Total",516,97,59,38,419,5,130,82,91,22,21,68
"2011","Cheshire East 010E","E01018608","Total",551,105,54,51,446,17,125,99,95,15,31,64
"2011","Cheshire East 012A","E01018572","Total",746,253,135,118,493,16,129,106,124,19,32,67
"2011","Cheshire East 012B","E01018573","Total",674,198,91,107,476,22,134,76,117,24,31,72
"2011","Cheshire East 012C","E01018574","Total",988,454,196,258,534,46,97,106,159,11,29,86
"2011","Cheshire East 012D","E01018580","Total",658,205,97,108,453,12,132,74,119,19,21,76
"2011","Cheshire East 012E","E01018581","Total",558,192,103,89,366,11,115,73,80,12,22,53
"2011","Cheshire East 013A","E01018575","Total",473,140,62,78,333,25,58,81,91,11,18,49
"2011","Cheshire East 013B","E01018576","Total",872,347,103,244,525,32,90,121,195,8,20,59
"2011","Cheshire East 013C","E01018577","Total",1118,366,161,205,752,39,170,170,224,15,21,113
"2011","Cheshire East 013D","E01018578","Total",486,110,46,64,376,12,74,78,113,9,31,59
"2011","Cheshire East 013E","E01018579","Total",488,161,93,68,327,22,74,60,91,12,16,52
"2011","Cheshire East 014A","E01018641","Total",499,93,55,38,406,10,95,82,94,6,30,89
"2011","Cheshire East 014B","E01018642","Total",535,106,57,49,429,15,78,119,96,14,42,65
"2011","Cheshire East 014C","E01018643","Total",721,126,59,67,595,21,110,155,140,26,45,98
"2011","Cheshire East 014D","E01018644","Total",647,242,124,118,405,10,100,88,111,10,24,62
"2011","Cheshire East 015A","E01018614","Total",829,263,76,187,566,39,92,149,161,22,32,71
"2011","Cheshire East 015B","E01018618","Total",601,177,62,115,424,55,63,86,94,24,43,59
"2011","Cheshire East 015C","E01018619","Total",570,122,48,74,448,21,69,123,125,19,26,65
"2011","Cheshire East 015D","E01018620","Total",580,166,59,107,414,43,71,72,103,16,25,84
"2011","Cheshire East 015E","E01018621","Total",560,157,81,76,403,17,71,78,115,14,29,79
"2011","Cheshire East 016A","E01018626","Total",1064,436,144,292,628,43,101,123,225,20,26,90
"2011","Cheshire East 016B","E01018628","Total",652,154,82,72,498,12,111,99,142,13,34,87
"2011","Cheshire East 016C","E01018629","Total",842,306,141,165,536,74,67,119,152,18,31,75
"2011","Cheshire East 016D","E01018630","Total",629,230,100,130,399,32,96,79,121,5,19,47
"2011","Cheshire East 016E","E01018631","Total",714,344,118,226,370,38,62,62,111,12,25,60
"2011","Cheshire East 017A","E01018615","Total",515,159,41,118,356,18,46,74,130,9,19,60
"2011","Cheshire East 017B","E01018616","Total",508,132,75,57,376,10,76,82,111,11,21,65
"2011","Cheshire East 017C","E01018617","Total",692,274,116,158,418,14,110,66,122,10,23,73
"2011","Cheshire East 017D","E01018632","Total",661,168,70,98,493,18,103,120,128,13,24,87
"2011","Cheshire East 017E","E01018633","Total",616,133,78,55,483,6,149,76,112,9,37,94
"2011","Cheshire East 018A","E01018622","Total",732,351,139,212,381,38,52,81,162,1,16,31
"2011","Cheshire East 018B","E01018623","Total",699,240,83,157,459,33,65,113,154,10,15,69
"2011","Cheshire East 018C","E01018624","Total",996,474,73,401,522,47,39,103,250,11,15,57
"2011","Cheshire East 018D","E01018625","Total",657,236,56,180,421,49,42,95,155,6,15,59
"2011","Cheshire East 018E","E01018627","Total",817,359,81,278,458,32,59,91,187,11,11,67
"2011","Cheshire East 018F","E01018635","Total",589,230,71,159,359,25,57,73,127,5,9,63
"2011","Cheshire East 018G","E01018636","Total",589,160,82,78,429,26,63,96,122,18,25,79
"2011","Cheshire East 019A","E01018634","Total",766,159,82,77,607,22,142,127,154,16,40,106
"2011","Cheshire East 019B","E01018645","Total",887,398,234,164,489,52,100,78,122,18,43,76
"2011","Cheshire East 019C","E01018646","Total",733,191,94,97,542,54,91,106,134,23,44,90
"2011","Cheshire East 019D","E01018647","Total",672,210,102,108,462,30,91,91,108,11,34,97
"2011","Cheshire East 020A","E01018591","Total",1029,256,145,111,773,21,253,107,196,19,35,142
"2011","Cheshire East 020B","E01018597","Total",1026,257,131,126,769,24,244,112,183,22,46,138
"2011","Cheshire East 020C","E01018669","Total",1104,282,150,132,822,21,198,152,236,28,54,133
"2011","Cheshire East 020D","E01018670","Total",1029,288,160,128,741,24,218,127,200,24,38,110
"2011","Cheshire East 021A","E01018637","Total",693,171,53,118,522,85,63,111,115,20,43,85
"2011","Cheshire East 021B","E01018638","Total",674,201,98,103,473,50,96,82,123,17,31,74
"2011","Cheshire East 021C","E01018639","Total",674,236,42,194,438,69,40,84,166,3,19,57
"2011","Cheshire East 021D","E01018640","Total",624,273,98,175,351,46,55,78,87,9,29,47
"2011","Cheshire West and Chester 022A","E01018308","Total",782,216,107,109,566,31,143,96,132,34,39,91
"2011","Cheshire West and Chester 022B","E01018336","Total",525,124,46,78,401,19,80,71,120,13,20,78
"2011","Cheshire West and Chester 022C","E01018337","Total",555,144,64,80,411,18,77,63,146,9,25,73
"2011","Cheshire West and Chester 022D","E01018338","Total",779,248,85,163,531,37,85,133,144,18,33,81
"2011","Cheshire West and Chester 022E","E01018358","Total",475,109,42,67,366,14,77,78,95,10,26,66
"2011","Cheshire West and Chester 022F","E01018359","Total",415,77,39,38,338,6,79,59,81,15,29,69
"2011","Cheshire West and Chester 025A","E01018360","Total",771,137,80,57,634,21,131,164,160,33,42,83
"2011","Cheshire West and Chester 025B","E01018366","Total",647,154,97,57,493,15,121,84,137,14,17,105
"2011","Cheshire West and Chester 025C","E01018367","Total",793,213,126,87,580,35,118,83,148,27,51,118
"2011","Cheshire West and Chester 027A","E01018364","Total",755,304,130,174,451,80,70,95,103,15,29,59
"2011","Cheshire West and Chester 027B","E01018365","Total",857,276,188,88,581,23,174,98,137,12,25,112
"2011","Cheshire West and Chester 027C","E01018378","Total",524,151,87,64,373,40,72,73,85,12,36,55
"2011","Cheshire West and Chester 027D","E01018379","Total",605,181,113,68,424,19,135,71,91,16,30,62
"2011","Cheshire West and Chester 027E","E01018380","Total",513,154,96,58,359,21,114,67,62,5,26,64
"2011","Cheshire West and Chester 028A","E01018362","Total",635,170,88,82,465,20,82,105,128,14,23,93
"2011","Cheshire West and Chester 028B","E01018363","Total",479,153,88,65,326,12,113,57,64,3,23,54
"2011","Cheshire West and Chester 028C","E01018374","Total",785,258,67,191,527,18,97,114,165,23,31,79
"2011","Cheshire West and Chester 028D","E01018375","Total",802,286,56,230,516,18,72,90,225,8,15,88
"2011","Cheshire West and Chester 028E","E01018376","Total",630,166,111,55,464,23,96,113,100,24,33,75
"2011","Cheshire West and Chester 028F","E01018377","Total",659,147,85,62,512,29,96,146,123,15,21,82
"2011","Cheshire West and Chester 029A","E01018309","Total",657,150,61,89,507,46,90,92,122,13,40,104
"2011","Cheshire West and Chester 029B","E01018310","Total",598,159,70,89,439,67,45,68,103,25,48,83
"2011","Cheshire West and Chester 029C","E01018311","Total",649,280,91,189,369,78,31,85,96,10,19,50
"2011","Cheshire West and Chester 029D","E01018312","Total",584,150,55,95,434,60,55,78,89,21,42,89
"2011","Cheshire West and Chester 031A","E01018313","Total",581,141,91,50,440,27,118,68,97,11,21,98
"2011","Cheshire West and Chester 031B","E01018314","Total",699,240,104,136,459,55,73,79,106,26,39,81
"2011","Cheshire West and Chester 031C","E01018315","Total",490,150,77,73,340,15,72,55,86,8,26,78
"2011","Cheshire West and Chester 031D","E01018316","Total",589,167,71,96,422,71,62,90,81,16,28,74
"2011","Cheshire West and Chester 031E","E01018317","Total",744,366,70,296,378,83,47,66,99,11,21,51
"2011","Cheshire West and Chester 030A","E01018349","Total",677,164,93,71,513,19,151,81,118,20,36,88
"2011","Cheshire West and Chester 030B","E01018350","Total",790,171,106,65,619,12,182,125,153,17,35,95
"2011","Cheshire West and Chester 030C","E01018368","Total",602,184,102,82,418,24,90,90,110,9,29,66
"2011","Cheshire West and Chester 030D","E01018370","Total",534,102,66,36,432,15,121,88,89,19,32,68
"2011","Cheshire West and Chester 032A","E01018345","Total",512,113,49,64,399,30,68,89,86,17,32,77
"2011","Cheshire West and Chester 032B","E01018346","Total",542,134,63,71,408,13,91,105,91,12,25,71
"2011","Cheshire West and Chester 032C","E01018347","Total",612,206,100,106,406,35,83,66,103,6,25,88
"2011","Cheshire West and Chester 032D","E01018383","Total",601,145,92,53,456,15,82,114,96,18,40,91
"2011","Cheshire West and Chester 032E","E01018384","Total",621,152,101,51,469,17,125,95,121,7,24,80
"2011","Cheshire West and Chester 033B","E01018327","Total",1176,603,168,435,573,42,89,71,280,2,11,78
"2011","Cheshire West and Chester 033C","E01018343","Total",786,347,110,237,439,36,34,44,209,8,9,99
"2011","Cheshire West and Chester 033D","E01018361","Total",609,189,59,130,420,16,47,88,140,13,24,92
"2011","Cheshire West and Chester 033E","E01032930","Total",1122,621,186,435,501,24,89,38,274,2,11,63
"2011","Cheshire West and Chester 033F","E01032931","Total",581,256,39,217,325,14,35,35,165,2,3,71
"2011","Cheshire West and Chester 034A","E01018326","Total",1175,657,222,435,518,26,109,32,244,5,12,90
"2011","Cheshire West and Chester 034B","E01018328","Total",466,119,16,103,347,12,36,28,68,5,17,181
"2011","Cheshire West and Chester 034C","E01018329","Total",1055,591,120,471,464,26,35,28,202,3,5,165
"2011","Cheshire West and Chester 034D","E01018330","Total",459,109,35,74,350,14,48,47,96,3,9,133
"2011","Cheshire West and Chester 034E","E01018331","Total",714,279,38,241,435,17,36,37,174,5,10,156
"2011","Cheshire West and Chester 036A","E01018319","Total",993,367,124,243,626,60,81,129,217,14,30,95
"2011","Cheshire West and Chester 036B","E01018344","Total",919,305,62,243,614,53,36,134,278,12,20,81
"2011","Cheshire West and Chester 036C","E01018381","Total",517,163,77,86,354,11,64,79,98,11,15,76
"2011","Cheshire West and Chester 036D","E01018382","Total",788,359,208,151,429,30,97,66,130,10,26,70
"2011","Cheshire West and Chester 039A","E01018323","Total",562,175,99,76,387,20,80,61,111,13,33,69
"2011","Cheshire West and Chester 039B","E01018324","Total",532,136,82,54,396,15,92,72,91,18,32,76
"2011","Cheshire West and Chester 039C","E01018325","Total",586,123,67,56,463,12,115,82,120,17,44,73
"2011","Cheshire West and Chester 039D","E01018385","Total",855,222,144,78,633,15,203,96,140,21,52,106
"2011","Cheshire West and Chester 041A","E01018320","Total",616,173,124,49,443,20,119,90,87,13,29,85
"2011","Cheshire West and Chester 041B","E01018321","Total",531,155,70,85,376,14,84,71,111,13,29,54
"2011","Cheshire West and Chester 041C","E01018322","Total",506,156,112,44,350,4,82,77,86,16,20,65
"2011","Cheshire West and Chester 041D","E01018348","Total",894,236,93,143,658,39,107,149,192,23,35,113
"2011","Cheshire West and Chester 043A","E01018332","Total",476,174,77,97,302,8,55,83,87,15,19,35
"2011","Cheshire West and Chester 043B","E01018333","Total",663,181,111,70,482,12,165,76,125,10,22,72
"2011","Cheshire West and Chester 043C","E01018334","Total",651,164,113,51,487,11,159,72,112,16,33,84
"2011","Cheshire West and Chester 043D","E01018340","Total",659,217,113,104,442,25,118,89,108,8,21,73
"2011","Cheshire West and Chester 043E","E01018341","Total",517,149,91,58,368,8,119,67,107,7,13,47
"2011","Cheshire West and Chester 043F","E01018342","Total",866,397,152,245,469,33,87,74,209,9,13,44
"2011","Cheshire West and Chester 044A","E01018351","Total",656,252,74,178,404,57,50,79,109,16,38,55
"2011","Cheshire West and Chester 044B","E01018352","Total",844,299,61,238,545,36,53,145,225,14,26,46
"2011","Cheshire West and Chester 044C","E01018353","Total",628,160,76,84,468,18,86,95,117,20,46,86
"2011","Cheshire West and Chester 044D","E01018354","Total",648,150,50,100,498,75,70,82,135,22,39,75
"2011","Cheshire West and Chester 046A","E01018335","Total",874,216,112,104,658,24,163,117,168,29,50,107
"2011","Cheshire West and Chester 046B","E01018369","Total",606,106,57,49,500,20,124,85,111,25,43,92
"2011","Cheshire West and Chester 046C","E01018371","Total",760,203,109,94,557,34,141,101,125,18,32,106
"2011","Cheshire West and Chester 046D","E01018372","Total",821,209,105,104,612,18,153,111,188,17,29,96
"2011","Cheshire West and Chester 047A","E01018339","Total",893,258,147,111,635,30,167,117,173,20,38,90
"2011","Cheshire West and Chester 047B","E01018355","Total",571,235,134,101,336,18,106,45,84,17,12,54
"2011","Cheshire West and Chester 047C","E01018356","Total",599,145,65,80,454,17,84,94,125,11,40,83
"2011","Cheshire West and Chester 047D","E01018357","Total",539,122,67,55,417,14,112,74,100,4,29,84
"2011","Cheshire West and Chester 047E","E01018373","Total",843,218,99,119,625,22,164,102,165,23,40,109
"2011","Cheshire West and Chester 001A","E01018534","Total",1195,496,206,290,699,77,103,144,184,42,44,105
"2011","Cheshire West and Chester 001B","E01018535","Total",628,162,97,65,466,25,121,63,118,17,36,86
"2011","Cheshire West and Chester 001C","E01018536","Total",743,206,116,90,537,26,140,97,155,10,23,86
"2011","Cheshire West and Chester 001D","E01018537","Total",896,272,178,94,624,12,230,85,152,16,20,109
"2011","Cheshire West and Chester 004A","E01018518","Total",671,164,91,73,507,7,158,72,148,10,28,84
"2011","Cheshire West and Chester 004B","E01018569","Total",545,122,80,42,423,9,137,66,108,15,25,63
"2011","Cheshire West and Chester 004C","E01018570","Total",521,153,75,78,368,8,100,60,100,8,23,69
"2011","Cheshire West and Chester 004D","E01018571","Total",630,222,145,77,408,15,119,70,108,8,19,69
"2011","Cheshire West and Chester 005A","E01018546","Total",646,217,102,115,429,55,67,70,105,10,35,87
"2011","Cheshire West and Chester 005B","E01018547","Total",608,170,79,91,438,22,113,63,123,13,29,75
"2011","Cheshire West and Chester 005C","E01018548","Total",702,221,112,109,481,31,118,79,125,16,30,82
"2011","Cheshire West and Chester 005D","E01018549","Total",656,221,99,122,435,21,128,55,108,10,24,89
"2011","Cheshire West and Chester 006A","E01018532","Total",853,300,189,111,553,37,126,99,141,12,39,99
"2011","Cheshire West and Chester 006B","E01018533","Total",623,126,73,53,497,16,160,67,105,13,32,104
"2011","Cheshire West and Chester 006C","E01018544","Total",645,159,76,83,486,25,115,80,136,7,29,94
"2011","Cheshire West and Chester 006D","E01018545","Total",827,234,128,106,593,21,139,99,141,11,35,147
"2011","Cheshire West and Chester 007A","E01018519","Total",670,252,57,195,418,58,48,96,127,8,22,59
"2011","Cheshire West and Chester 007B","E01018520","Total",492,188,49,139,304,52,33,72,88,8,7,44
"2011","Cheshire West and Chester 007C","E01018525","Total",525,149,63,86,376,78,32,78,90,9,34,55
"2011","Cheshire West and Chester 007D","E01018563","Total",1040,493,175,318,547,77,56,104,190,23,32,65
"2011","Cheshire West and Chester 007E","E01018564","Total",1119,494,141,353,625,73,80,131,193,21,42,85
"2011","Cheshire West and Chester 008A","E01018523","Total",600,212,91,121,388,66,69,77,64,14,26,72
"2011","Cheshire West and Chester 008B","E01018524","Total",604,199,95,104,405,91,43,89,70,14,36,62
"2011","Cheshire West and Chester 008C","E01018541","Total",626,222,104,118,404,31,82,79,118,8,20,66
"2011","Cheshire West and Chester 008D","E01018542","Total",494,113,47,66,381,79,41,74,70,21,43,53
"2011","Cheshire West and Chester 008E","E01018543","Total",604,212,104,108,392,56,73,69,101,13,22,58
"2011","Cheshire West and Chester 009A","E01018528","Total",496,135,74,61,361,9,65,78,99,6,20,84
"2011","Cheshire West and Chester 009B","E01018529","Total",648,148,91,57,500,15,142,71,131,9,32,100
"2011","Cheshire West and Chester 009C","E01018530","Total",563,93,25,68,470,17,56,133,125,20,38,81
"2011","Cheshire West and Chester 009D","E01018531","Total",667,181,88,93,486,21,109,90,127,17,26,96
"2011","Cheshire West and Chester 009E","E01018560","Total",471,97,45,52,374,8,71,74,107,10,26,78
"2011","Cheshire West and Chester 009F","E01018561","Total",475,86,32,54,389,11,60,88,108,13,30,79
"2011","Cheshire West and Chester 009G","E01018562","Total",524,81,16,65,443,21,31,145,120,15,36,75
"2011","Cheshire West and Chester 010A","E01018522","Total",591,187,81,106,404,50,73,67,97,13,29,75
"2011","Cheshire West and Chester 010B","E01018538","Total",451,100,57,43,351,44,61,47,74,15,38,72
"2011","Cheshire West and Chester 010C","E01018539","Total",482,165,44,121,317,48,62,54,65,9,18,61
"2011","Cheshire West and Chester 010D","E01018540","Total",611,163,82,81,448,29,106,87,103,14,29,80
"2011","Cheshire West and Chester 011A","E01018521","Total",501,156,96,60,345,43,50,68,68,10,30,76
"2011","Cheshire West and Chester 011B","E01018550","Total",481,190,37,153,291,55,26,63,57,13,23,54
"2011","Cheshire West and Chester 011C","E01018551","Total",694,279,69,210,415,56,59,80,104,16,32,68
"2011","Cheshire West and Chester 011D","E01018552","Total",641,182,79,103,459,45,71,90,114,19,34,86
"2011","Cheshire West and Chester 011E","E01018553","Total",686,236,128,108,450,57,115,61,98,15,35,69
"2011","Cheshire West and Chester 013A","E01018556","Total",635,165,105,60,470,26,151,73,116,10,28,66
"2011","Cheshire West and Chester 013B","E01018557","Total",662,248,154,94,414,32,87,76,90,12,36,81
"2011","Cheshire West and Chester 013C","E01018558","Total",500,84,20,64,416,23,32,106,140,8,29,78
"2011","Cheshire West and Chester 013D","E01018559","Total",468,89,43,46,379,16,83,68,95,7,28,82
"2011","Cheshire West and Chester 014A","E01018565","Total",618,142,99,43,476,19,111,92,114,15,31,94
"2011","Cheshire West and Chester 014B","E01018566","Total",592,160,108,52,432,14,138,55,101,7,27,90
"2011","Cheshire West and Chester 014C","E01018567","Total",590,138,90,48,452,16,104,68,122,7,29,106
"2011","Cheshire West and Chester 014D","E01018568","Total",575,105,15,90,470,28,28,157,128,19,42,68
"2011","Cheshire West and Chester 016A","E01018526","Total",666,150,92,58,516,24,122,83,126,12,44,105
"2011","Cheshire West and Chester 016B","E01018527","Total",654,137,61,76,517,18,95,102,124,17,43,118
"2011","Cheshire West and Chester 016C","E01018554","Total",993,247,115,132,746,28,164,142,203,14,44,151
"2011","Cheshire West and Chester 016D","E01018555","Total",479,118,39,79,361,14,66,75,96,11,27,72
"2011","Cheshire West and Chester 002A","E01018685","Total",601,262,141,121,339,32,70,63,88,11,22,53
"2011","Cheshire West and Chester 002B","E01018686","Total",603,164,51,113,439,44,56,103,145,16,22,53
"2011","Cheshire West and Chester 002C","E01018687","Total",585,139,89,50,446,15,142,67,107,12,27,76
"2011","Cheshire West and Chester 002D","E01018688","Total",692,196,86,110,496,21,139,91,128,18,26,73
"2011","Cheshire West and Chester 002E","E01018689","Total",676,276,166,110,400,27,98,65,101,13,26,70
"2011","Cheshire West and Chester 002F","E01018690","Total",868,201,114,87,667,20,194,120,168,18,31,116
"2011","Cheshire West and Chester 003A","E01018675","Total",871,183,97,86,688,12,186,123,184,19,42,122
"2011","Cheshire West and Chester 003B","E01018708","Total",889,210,111,99,679,11,187,100,191,26,47,117
"2011","Cheshire West and Chester 003C","E01018721","Total",921,208,104,104,713,22,173,106,197,18,52,145
"2011","Cheshire West and Chester 012A","E01018671","Total",513,105,57,48,408,11,96,69,113,14,27,78
"2011","Cheshire West and Chester 012B","E01018672","Total",667,197,96,101,470,43,81,75,120,22,39,90
"2011","Cheshire West and Chester 012C","E01018673","Total",522,146,61,85,376,26,81,63,110,14,20,62
"2011","Cheshire West and Chester 012D","E01018674","Total",691,240,104,136,451,33,50,100,142,13,30,83
"2011","Cheshire West and Chester 015A","E01018684","Total",927,199,104,95,728,12,176,130,224,23,48,115
"2011","Cheshire West and Chester 015B","E01018695","Total",738,203,78,125,535,34,98,125,160,7,31,80
"2011","Cheshire West and Chester 015C","E01018696","Total",626,165,101,64,461,7,145,83,94,8,38,86
"2011","Cheshire West and Chester 015D","E01018697","Total",779,255,155,100,524,34,107,106,144,17,40,76
"2011","Cheshire West and Chester 015E","E01018698","Total",814,168,114,54,646,14,186,99,165,20,40,122
"2011","Cheshire West and Chester 017A","E01018704","Total",541,184,93,91,357,27,92,56,78,7,21,76
"2011","Cheshire West and Chester 017B","E01018705","Total",620,138,62,76,482,22,81,101,128,17,30,103
"2011","Cheshire West and Chester 017C","E01018706","Total",526,133,48,85,393,29,60,72,117,19,26,70
"2011","Cheshire West and Chester 017D","E01018718","Total",671,150,47,103,521,24,83,95,172,15,35,97
"2011","Cheshire West and Chester 017E","E01018722","Total",941,214,120,94,727,19,212,115,202,23,45,111
"2011","Cheshire West and Chester 018A","E01018713","Total",1144,305,124,181,839,66,118,197,241,21,60,136
"2011","Cheshire West and Chester 018B","E01018714","Total",890,406,127,279,484,62,64,108,165,11,25,49
"2011","Cheshire West and Chester 018C","E01018715","Total",766,224,47,177,542,61,64,133,164,12,21,87
"2011","Cheshire West and Chester 019A","E01018726","Total",613,166,89,77,447,31,78,70,130,30,29,79
"2011","Cheshire West and Chester 019B","E01018727","Total",749,201,118,83,548,20,167,69,162,10,24,96
"2011","Cheshire West and Chester 019C","E01018728","Total",636,175,93,82,461,28,84,99,105,21,36,88
"2011","Cheshire West and Chester 019D","E01018729","Total",757,278,151,127,479,29,98,91,122,26,34,79
"2011","Cheshire West and Chester 020A","E01018709","Total",669,217,41,176,452,51,40,99,154,9,23,76
"2011","Cheshire West and Chester 020B","E01018710","Total",579,162,58,104,417,44,49,66,111,20,46,81
"2011","Cheshire West and Chester 020C","E01018711","Total",730,290,65,225,440,34,73,83,140,12,23,75
"2011","Cheshire West and Chester 020D","E01018712","Total",752,275,86,189,477,30,79,91,173,11,21,72
"2011","Cheshire West and Chester 021A","E01018699","Total",653,162,73,89,491,39,71,116,127,23,31,84
"2011","Cheshire West and Chester 021B","E01018701","Total",622,199,117,82,423,50,74,71,88,10,50,80
"2011","Cheshire West and Chester 021C","E01018716","Total",641,200,89,111,441,32,80,67,111,27,44,80
"2011","Cheshire West and Chester 021D","E01018717","Total",766,234,65,169,532,56,67,118,155,15,34,87
"2011","Cheshire West and Chester 021E","E01018719","Total",639,176,78,98,463,27,78,113,114,10,36,85
"2011","Cheshire West and Chester 021F","E01018720","Total",668,194,116,78,474,54,87,87,107,13,34,92
"2011","Cheshire West and Chester 023A","E01018691","Total",700,214,122,92,486,34,130,93,103,18,27,81
"2011","Cheshire West and Chester 023B","E01018693","Total",626,120,68,52,506,16,109,108,127,15,29,102
"2011","Cheshire West and Chester 023C","E01018694","Total",635,121,61,60,514,12,150,97,115,21,41,78
"2011","Cheshire West and Chester 023D","E01018700","Total",761,169,25,144,592,32,51,196,148,37,53,75
"2011","Cheshire West and Chester 023E","E01018702","Total",481,85,23,62,396,29,41,116,113,20,32,45
"2011","Cheshire West and Chester 023F","E01018703","Total",828,267,51,216,561,34,98,116,192,18,30,73
"2011","Cheshire West and Chester 024A","E01018676","Total",642,161,101,60,481,10,171,68,117,15,22,78
"2011","Cheshire West and Chester 024B","E01018677","Total",648,153,77,76,495,6,164,63,166,12,22,62
"2011","Cheshire West and Chester 024C","E01018678","Total",510,115,75,40,395,6,127,67,94,6,34,61
"2011","Cheshire West and Chester 024D","E01018679","Total",725,203,91,112,522,46,105,106,126,23,24,92
"2011","Cheshire West and Chester 024E","E01018692","Total",793,172,80,92,621,11,160,120,152,26,46,106
"2011","Cheshire West and Chester 026A","E01018680","Total",647,125,56,69,522,13,109,106,152,18,33,91
"2011","Cheshire West and Chester 026B","E01018681","Total",627,154,77,77,473,27,109,102,138,15,16,66
"2011","Cheshire West and Chester 026C","E01018682","Total",491,162,87,75,329,28,84,64,73,7,20,53
"2011","Cheshire West and Chester 026D","E01018683","Total",643,182,100,82,461,21,101,93,143,8,23,72
"2011","Cheshire West and Chester 035A","E01018733","Total",611,152,90,62,459,22,130,69,118,8,25,87
"2011","Cheshire West and Chester 035B","E01018734","Total",530,154,82,72,376,32,77,57,97,7,28,78
"2011","Cheshire West and Chester 035C","E01018748","Total",507,117,42,75,390,83,43,81,52,32,38,61
"2011","Cheshire West and Chester 035D","E01018749","Total",951,198,31,167,753,58,45,230,231,45,61,83
"2011","Cheshire West and Chester 037A","E01018736","Total",657,149,57,92,508,30,75,120,147,12,44,80
"2011","Cheshire West and Chester 037B","E01018737","Total",534,95,35,60,439,19,68,105,122,10,28,87
"2011","Cheshire West and Chester 037C","E01018743","Total",625,164,65,99,461,28,88,87,126,13,20,99
"2011","Cheshire West and Chester 037D","E01018744","Total",680,162,63,99,518,60,70,104,128,23,47,86
"2011","Cheshire West and Chester 038A","E01018732","Total",554,149,65,84,405,35,55,73,125,8,33,76
"2011","Cheshire West and Chester 038B","E01018745","Total",708,271,110,161,437,58,61,86,103,17,34,78
"2011","Cheshire West and Chester 038C","E01018746","Total",708,211,96,115,497,37,84,76,143,12,40,105
"2011","Cheshire West and Chester 038D","E01018747","Total",657,191,79,112,466,44,71,81,132,12,35,91
"2011","Cheshire West and Chester 040A","E01018730","Total",635,201,109,92,434,28,109,64,97,12,48,76
"2011","Cheshire West and Chester 040B","E01018738","Total",560,166,90,76,394,87,44,89,56,31,38,49
"2011","Cheshire West and Chester 040C","E01018739","Total",575,145,46,99,430,82,47,78,111,18,40,54
"2011","Cheshire West and Chester 040D","E01018741","Total",527,150,65,85,377,7,107,57,77,14,31,84
"2011","Cheshire West and Chester 042A","E01018731","Total",676,186,69,117,490,60,69,99,129,25,29,79
"2011","Cheshire West and Chester 042B","E01018735","Total",540,117,39,78,423,25,70,92,135,9,24,68
"2011","Cheshire West and Chester 042C","E01018740","Total",608,165,73,92,443,60,54,85,106,26,46,66
"2011","Cheshire West and Chester 042D","E01018742","Total",630,150,66,84,480,17,93,71,150,8,40,101
"2011","Cheshire West and Chester 045A","E01018707","Total",736,176,97,79,560,16,168,91,129,15,31,110
"2011","Cheshire West and Chester 045B","E01018723","Total",510,171,98,73,339,20,86,58,86,13,26,50
"2011","Cheshire West and Chester 045C","E01018724","Total",666,196,113,83,470,17,131,64,136,19,29,74
"2011","Cheshire West and Chester 045D","E01018725","Total",543,123,60,63,420,19,122,60,103,21,23,72
"2011","Halton 001A","E01012392","Total",910,192,52,140,718,45,71,170,205,32,61,134
"2011","Halton 001B","E01012393","Total",865,227,108,119,638,28,160,121,165,12,37,115
"2011","Halton 001C","E01012395","Total",620,157,92,65,463,16,143,62,107,13,28,94
"2011","Halton 001D","E01012411","Total",591,178,94,84,413,23,108,65,104,5,23,85
"2011","Halton 002A","E01012374","Total",1075,244,83,161,831,46,100,202,244,30,78,131
"2011","Halton 002B","E01012375","Total",559,69,41,28,490,10,95,91,97,18,49,130
"2011","Halton 002C","E01012376","Total",922,142,20,122,780,47,32,249,212,28,82,130
"2011","Halton 002D","E01012421","Total",536,98,39,59,438,16,78,80,118,4,31,111
"2011","Halton 002E","E01012423","Total",640,222,74,148,418,26,71,72,130,11,21,87
"2011","Halton 003A","E01012368","Total",849,298,160,138,551,70,96,95,132,29,30,99
"2011","Halton 003B","E01012410","Total",533,135,52,83,398,16,60,75,118,6,27,96
"2011","Halton 003C","E01012412","Total",684,295,101,194,389,57,46,83,101,11,27,64
"2011","Halton 003D","E01012413","Total",663,253,123,130,410,58,66,73,98,14,36,65
"2011","Halton 003E","E01012414","Total",504,96,49,47,408,23,86,69,114,4,27,85
"2011","Halton 004A","E01012377","Total",745,216,90,126,529,50,81,79,132,17,42,128
"2011","Halton 004B","E01012390","Total",678,220,129,91,458,43,84,87,118,11,25,90
"2011","Halton 004C","E01012419","Total",486,154,43,111,332,60,41,61,64,11,34,61
"2011","Halton 004D","E01012420","Total",746,328,144,184,418,70,78,68,101,12,26,63
"2011","Halton 004E","E01012422","Total",632,213,73,140,419,89,53,80,78,22,34,63
"2011","Halton 005A","E01012369","Total",619,188,93,95,431,25,59,79,104,14,46,104
"2011","Halton 005B","E01012394","Total",675,261,144,117,414,32,87,73,94,13,28,87
"2011","Halton 005C","E01012425","Total",692,205,104,101,487,54,83,82,120,14,31,103
"2011","Halton 005D","E01012426","Total",572,155,89,66,417,20,91,72,100,5,42,87
"2011","Halton 005E","E01012427","Total",649,141,59,82,508,39,47,121,122,19,60,100
"2011","Halton 006A","E01012378","Total",640,169,107,62,471,22,110,76,113,6,32,112
"2011","Halton 006B","E01012379","Total",634,196,77,119,438,44,62,74,116,14,31,97
"2011","Halton 006C","E01012380","Total",571,197,78,119,374,56,47,68,81,16,26,80
"2011","Halton 006D","E01012388","Total",730,190,81,109,540,93,73,94,110,22,35,113
"2011","Halton 006E","E01012442","Total",618,164,69,95,454,74,46,94,95,30,42,73
"2011","Halton 007A","E01012367","Total",776,322,131,191,454,78,71,59,129,18,27,72
"2011","Halton 007B","E01012370","Total",811,293,73,220,518,81,57,96,160,9,22,93
"2011","Halton 007C","E01012424","Total",761,252,83,169,509,74,55,74,107,31,57,111
"2011","Halton 007D","E01012441","Total",1078,420,108,312,658,131,88,118,164,23,37,97
"2011","Halton 008A","E01012389","Total",745,173,107,66,572,15,173,78,129,17,37,123
"2011","Halton 008B","E01012391","Total",975,327,106,221,648,69,105,121,184,19,34,116
"2011","Halton 008C","E01012401","Total",787,188,113,75,599,20,167,80,155,13,40,124
"2011","Halton 008D","E01012443","Total",601,137,31,106,464,38,43,97,122,17,34,113
"2011","Halton 009A","E01012385","Total",575,108,37,71,467,19,59,109,167,17,24,72
"2011","Halton 009B","E01012386","Total",661,71,15,56,590,20,23,194,167,23,60,103
"2011","Halton 009C","E01012387","Total",507,145,90,55,362,15,92,66,113,7,24,45
"2011","Halton 009D","E01012434","Total",601,99,30,69,502,27,58,119,166,13,28,91
"2011","Halton 009E","E01012435","Total",759,98,28,70,661,29,58,149,206,27,67,125
"2011","Halton 010A","E01012381","Total",656,305,69,236,351,54,38,62,107,20,20,50
"2011","Halton 010B","E01012382","Total",709,272,67,205,437,92,72,62,110,16,28,57
"2011","Halton 010C","E01012384","Total",748,298,118,180,450,21,107,57,121,10,47,87
"2011","Halton 010D","E01012444","Total",427,97,39,58,330,61,32,58,69,15,31,64
"2011","Halton 010E","E01012445","Total",553,194,61,133,359,66,41,53,83,7,27,82
"2011","Halton 011A","E01012398","Total",513,158,89,69,355,22,66,68,80,18,32,69
"2011","Halton 011B","E01012400","Total",507,127,61,66,380,35,59,69,101,17,30,69
"2011","Halton 011C","E01012402","Total",656,218,76,142,438,71,62,69,86,13,46,91
"2011","Halton 011D","E01012404","Total",577,145,65,80,432,37,72,91,117,18,27,70
"2011","Halton 011E","E01012405","Total",836,243,121,122,593,55,89,98,148,17,50,136
"2011","Halton 012A","E01012416","Total",774,234,138,96,540,32,118,104,140,16,48,82
"2011","Halton 012B","E01012417","Total",577,166,64,102,411,58,50,76,141,7,22,57
"2011","Halton 012C","E01012428","Total",1024,375,110,265,649,72,60,129,231,14,38,105
"2011","Halton 012D","E01012429","Total",627,201,103,98,426,56,87,79,107,13,23,61
"2011","Halton 012E","E01012430","Total",884,382,105,277,502,99,54,79,169,11,20,70
"2011","Halton 012F","E01012431","Total",1011,400,77,323,611,87,61,125,220,10,21,87
"2011","Halton 013A","E01012383","Total",756,270,104,166,486,43,76,78,129,18,39,103
"2011","Halton 013B","E01012396","Total",600,176,82,94,424,71,77,75,68,20,33,80
"2011","Halton 013C","E01012397","Total",679,269,98,171,410,89,48,86,84,14,35,54
"2011","Halton 013D","E01012399","Total",639,244,106,138,395,60,62,70,83,15,38,67
"2011","Halton 013E","E01012403","Total",647,177,64,113,470,92,60,87,88,23,45,75
"2011","Halton 013F","E01012408","Total",739,169,45,124,570,105,66,101,108,39,63,88
"2011","Halton 014A","E01012432","Total",666,214,55,159,452,68,55,72,169,9,25,54
"2011","Halton 014B","E01012433","Total",690,199,62,137,491,99,60,77,130,25,31,69
"2011","Halton 014C","E01012436","Total",504,105,21,84,399,119,26,69,79,24,26,56
"2011","Halton 014D","E01012438","Total",535,207,95,112,328,71,44,41,74,16,27,55
"2011","Halton 014E","E01012440","Total",524,79,24,55,445,32,49,88,144,12,29,91
"2011","Halton 015A","E01012406","Total",673,188,73,115,485,58,75,74,134,23,41,80
"2011","Halton 015B","E01012407","Total",758,323,97,226,435,72,51,68,115,16,30,83
"2011","Halton 015C","E01012409","Total",633,222,77,145,411,62,75,50,100,13,37,74
"2011","Halton 015D","E01012437","Total",539,137,39,98,402,67,40,64,108,20,36,67
"2011","Halton 015E","E01012439","Total",642,194,81,113,448,76,48,71,116,21,22,94
"2011","Halton 016A","E01012371","Total",526,130,34,96,396,19,53,80,128,5,21,90
"2011","Halton 016B","E01012372","Total",507,125,48,77,382,12,89,57,125,3,15,81
"2011","Halton 016C","E01012373","Total",538,101,52,49,437,9,101,68,142,9,16,92
"2011","Halton 016D","E01012415","Total",545,89,37,52,456,16,94,67,133,25,28,93
"2011","Halton 016E","E01012418","Total",618,164,115,49,454,12,149,59,116,8,23,87
"2011","Warrington 001A","E01012471","Total",507,120,73,47,387,19,113,74,77,12,30,62
"2011","Warrington 001B","E01012472","Total",740,159,91,68,581,24,154,108,148,22,38,87
"2011","Warrington 001C","E01012476","Total",668,187,84,103,481,23,112,74,125,11,32,104
"2011","Warrington 001D","E01012477","Total",610,137,78,59,473,13,112,115,96,16,36,85
"2011","Warrington 002A","E01012473","Total",678,178,139,39,500,18,168,102,105,20,18,69
"2011","Warrington 002B","E01012474","Total",611,205,115,90,406,29,90,74,100,14,33,66
"2011","Warrington 002C","E01012475","Total",643,191,88,103,452,33,93,97,110,13,34,72
"2011","Warrington 002D","E01012554","Total",840,211,90,121,629,22,145,124,188,13,46,91
"2011","Warrington 003A","E01012467","Total",522,120,82,38,402,7,141,44,93,7,32,78
"2011","Warrington 003B","E01012468","Total",914,207,104,103,707,24,125,209,179,24,59,87
"2011","Warrington 003C","E01012469","Total",624,157,62,95,467,27,91,98,140,10,31,70
"2011","Warrington 003D","E01012470","Total",497,146,82,64,351,35,84,54,75,10,23,70
"2011","Warrington 004A","E01012460","Total",629,199,57,142,430,55,54,79,134,14,26,68
"2011","Warrington 004B","E01012462","Total",633,258,94,164,375,30,53,77,127,10,22,56
"2011","Warrington 004C","E01012463","Total",506,109,55,54,397,9,128,46,119,5,15,75
"2011","Warrington 004D","E01012464","Total",599,168,63,105,431,32,68,78,129,13,28,83
"2011","Warrington 005A","E01012459","Total",622,235,60,175,387,43,45,74,119,10,25,71
"2011","Warrington 005B","E01012461","Total",535,127,43,84,408,12,62,88,125,12,34,75
"2011","Warrington 005C","E01012465","Total",608,233,55,178,375,20,49,92,124,9,24,57
"2011","Warrington 005D","E01012466","Total",707,301,67,234,406,72,23,80,120,22,29,60
"2011","Warrington 006A","E01012526","Total",654,177,41,136,477,97,38,99,94,31,49,69
"2011","Warrington 006B","E01012534","Total",655,224,73,151,431,73,47,80,102,19,36,74
"2011","Warrington 006C","E01012535","Total",701,216,87,129,485,87,45,107,126,19,36,65
"2011","Warrington 006D","E01012537","Total",702,272,121,151,430,80,71,78,94,16,27,64
"2011","Warrington 006E","E01012539","Total",697,243,99,144,454,56,75,92,111,19,32,69
"2011","Warrington 007A","E01012538","Total",619,155,43,112,464,19,72,91,161,5,28,88
"2011","Warrington 007B","E01012540","Total",587,158,73,85,429,14,82,102,124,12,23,72
"2011","Warrington 007C","E01012541","Total",516,126,42,84,390,24,40,87,101,14,20,104
"2011","Warrington 007D","E01012542","Total",633,210,101,109,423,29,99,52,130,11,25,77
"2011","Warrington 007E","E01012543","Total",595,149,77,72,446,24,116,72,126,7,13,88
"2011","Warrington 007F","E01012544","Total",588,125,63,62,463,37,93,60,136,6,38,93
"2011","Warrington 008A","E01012521","Total",654,166,70,96,488,44,110,69,121,18,35,91
"2011","Warrington 008B","E01012522","Total",613,216,110,106,397,43,60,73,104,12,27,78
"2011","Warrington 008C","E01012533","Total",554,120,39,81,434,97,66,77,86,25,29,54
"2011","Warrington 008D","E01012536","Total",631,224,81,143,407,61,53,68,104,24,26,71
"2011","Warrington 008E","E01012545","Total",703,230,81,149,473,101,54,83,116,23,24,72
"2011","Warrington 008F","E01012546","Total",682,257,68,189,425,90,23,97,101,34,32,48
"2011","Warrington 009A","E01012561","Total",678,219,81,138,459,24,41,130,149,14,28,73
"2011","Warrington 009B","E01012562","Total",610,79,18,61,531,22,43,138,148,20,59,101
"2011","Warrington 009C","E01012567","Total",641,75,10,65,566,25,22,160,162,20,70,107
"2011","Warrington 009D","E01012568","Total",963,205,29,176,758,47,35,263,240,23,55,95
"2011","Warrington 010A","E01012563","Total",635,79,28,51,556,19,98,124,138,9,51,117
"2011","Warrington 010B","E01012564","Total",526,123,25,98,403,18,45,80,125,13,30,92
"2011","Warrington 010C","E01012565","Total",932,194,48,146,738,47,60,216,216,41,62,96
"2011","Warrington 010D","E01012566","Total",729,117,28,89,612,32,36,191,150,39,77,87
"2011","Warrington 010E","E01012569","Total",703,116,23,93,587,20,66,165,156,23,53,104
"2011","Warrington 010F","E01012570","Total",604,258,96,162,346,31,69,57,96,10,22,61
"2011","Warrington 011A","E01012481","Total",714,220,70,150,494,64,53,118,162,15,15,67
"2011","Warrington 011B","E01012482","Total",869,434,230,204,435,65,89,88,106,7,17,63
"2011","Warrington 011C","E01012520","Total",638,225,85,140,413,59,63,61,94,32,31,73
"2011","Warrington 011D","E01012523","Total",621,184,56,128,437,36,72,85,126,19,32,67
"2011","Warrington 011E","E01012524","Total",627,144,84,60,483,17,98,95,123,5,41,104
"2011","Warrington 011F","E01012525","Total",635,183,71,112,452,54,64,100,108,14,36,76
"2011","Warrington 012A","E01012478","Total",617,191,99,92,426,35,67,81,114,17,31,81
"2011","Warrington 012B","E01012547","Total",682,156,80,76,526,29,110,93,115,26,39,114
"2011","Warrington 012C","E01012548","Total",703,136,61,75,567,19,96,127,150,12,47,116
"2011","Warrington 012D","E01012549","Total",639,189,137,52,450,19,156,74,98,5,19,79
"2011","Warrington 012E","E01012550","Total",702,189,111,78,513,20,143,97,121,8,28,96
"2011","Warrington 013A","E01012453","Total",654,181,67,114,473,76,40,86,102,39,46,84
"2011","Warrington 013B","E01012454","Total",859,263,57,206,596,62,62,142,189,24,48,69
"2011","Warrington 013C","E01012455","Total",876,344,100,244,532,110,46,128,108,32,32,76
"2011","Warrington 013D","E01012457","Total",777,307,75,232,470,61,49,96,156,12,35,61
"2011","Warrington 014A","E01012551","Total",598,103,42,61,495,19,81,102,139,18,37,99
"2011","Warrington 014B","E01012552","Total",619,205,130,75,414,28,86,73,122,6,25,74
"2011","Warrington 014C","E01012553","Total",499,65,25,40,434,10,54,96,120,11,37,106
"2011","Warrington 014D","E01012555","Total",525,98,47,51,427,20,80,79,117,15,31,85
"2011","Warrington 014E","E01012556","Total",621,145,90,55,476,12,114,79,123,8,35,105
"2011","Warrington 015A","E01012491","Total",621,189,108,81,432,26,118,84,82,11,34,77
"2011","Warrington 015B","E01012492","Total",609,131,85,46,478,15,128,91,130,10,33,71
"2011","Warrington 015C","E01012493","Total",669,134,52,82,535,22,104,134,128,21,40,86
"2011","Warrington 015D","E01012494","Total",649,131,26,105,518,31,58,133,145,15,46,90
"2011","Warrington 015E","E01012500","Total",593,149,77,72,444,17,126,60,125,13,22,81
"2011","Warrington 016A","E01012495","Total",643,132,32,100,511,26,40,134,147,22,47,95
"2011","Warrington 016B","E01012496","Total",585,135,69,66,450,24,100,79,129,9,27,82
"2011","Warrington 016C","E01012497","Total",516,129,44,85,387,38,71,62,99,10,32,75
"2011","Warrington 016D","E01012498","Total",656,225,100,125,431,35,62,67,120,32,36,79
"2011","Warrington 016E","E01012499","Total",739,132,35,97,607,50,64,166,175,22,42,88
"2011","Warrington 016F","E01012501","Total",603,151,61,90,452,30,82,91,137,11,23,78
"2011","Warrington 017A","E01012479","Total",793,340,101,239,453,67,55,89,136,14,22,70
"2011","Warrington 017B","E01012480","Total",921,413,71,342,508,44,39,97,237,10,18,63
"2011","Warrington 017D","E01012510","Total",868,386,100,286,482,37,62,89,162,10,35,87
"2011","Warrington 017E","E01012511","Total",786,257,67,190,529,70,62,86,194,12,30,75
"2011","Warrington 017F","E01033299","Total",971,368,29,339,603,93,22,149,236,12,24,67
"2011","Warrington 017G","E01033303","Total",591,238,61,177,353,57,35,78,115,5,11,52
"2011","Warrington 018B","E01012458","Total",1011,293,90,203,718,82,62,188,241,25,37,83
"2011","Warrington 018C","E01012483","Total",883,458,176,282,425,69,57,72,136,12,23,56
"2011","Warrington 018D","E01012509","Total",882,298,134,164,584,39,178,76,169,10,19,93
"2011","Warrington 018E","E01012512","Total",739,233,128,105,506,14,179,68,115,8,24,98
"2011","Warrington 018F","E01033300","Total",613,339,62,277,274,9,18,29,164,6,12,36
"2011","Warrington 018G","E01033302","Total",740,291,53,238,449,43,35,98,171,16,16,70
"2011","Warrington 019A","E01012527","Total",622,150,73,77,472,19,104,87,127,15,37,83
"2011","Warrington 019B","E01012528","Total",500,107,72,35,393,10,124,57,82,8,30,82
"2011","Warrington 019C","E01012529","Total",599,143,65,78,456,21,128,77,114,10,33,73
"2011","Warrington 019D","E01012530","Total",529,101,55,46,428,10,84,103,99,9,40,83
"2011","Warrington 019E","E01012531","Total",675,185,105,80,490,28,169,93,103,17,18,62
"2011","Warrington 019F","E01012532","Total",601,157,106,51,444,14,160,57,96,15,23,79
"2011","Warrington 020A","E01012504","Total",753,217,64,153,536,72,58,108,166,18,43,71
"2011","Warrington 020B","E01012505","Total",652,261,91,170,391,49,46,72,109,12,30,73
"2011","Warrington 020C","E01012506","Total",668,233,72,161,435,52,55,87,112,23,36,70
"2011","Warrington 020D","E01012507","Total",943,420,127,293,523,64,60,102,192,16,21,68
"2011","Warrington 020E","E01012508","Total",715,291,93,198,424,60,72,71,98,16,33,74
"2011","Warrington 021A","E01012513","Total",805,211,94,117,594,26,118,148,163,31,42,66
"2011","Warrington 021B","E01012514","Total",737,195,81,114,542,20,99,160,124,24,40,75
"2011","Warrington 021C","E01012515","Total",659,205,86,119,454,26,106,98,119,16,25,64
"2011","Warrington 021D","E01012516","Total",589,188,87,101,401,10,108,81,113,13,25,51
"2011","Warrington 021E","E01012517","Total",900,217,76,141,683,40,116,184,186,31,47,79
"2011","Warrington 021F","E01012518","Total",846,228,96,132,618,55,105,139,173,23,44,79
"2011","Warrington 021G","E01012519","Total",635,167,96,71,468,16,124,107,112,12,23,74
"2011","Warrington 022A","E01012485","Total",660,163,58,105,497,46,105,122,116,9,37,62
"2011","Warrington 022B","E01012486","Total",631,170,103,67,461,28,95,101,120,17,18,82
"2011","Warrington 022C","E01012487","Total",652,178,97,81,474,24,91,109,131,15,38,66
"2011","Warrington 022D","E01012489","Total",681,129,76,53,552,16,121,144,111,30,47,83
"2011","Warrington 022E","E01012490","Total",629,160,109,51,469,19,133,96,104,14,17,86
"2011","Warrington 023A","E01012450","Total",633,224,159,65,409,7,108,74,94,20,25,81
"2011","Warrington 023B","E01012451","Total",648,209,134,75,439,39,78,94,98,17,32,81
"2011","Warrington 023C","E01012557","Total",755,283,93,190,472,33,71,103,170,16,15,64
"2011","Warrington 023D","E01012558","Total",749,206,94,112,543,27,87,148,148,19,36,78
"2011","Warrington 023E","E01012559","Total",593,123,68,55,470,7,97,131,122,13,29,71
"2011","Warrington 023F","E01012560","Total",631,198,117,81,433,13,91,105,103,15,32,74
"2011","Warrington 024A","E01012448","Total",498,95,34,61,403,12,65,93,111,11,27,84
"2011","Warrington 024B","E01012488","Total",716,156,93,63,560,10,160,117,141,19,24,89
"2011","Warrington 024C","E01012502","Total",629,134,66,68,495,15,95,117,116,22,47,83
"2011","Warrington 024D","E01012503","Total",559,109,37,72,450,15,65,116,124,19,39,72
"2011","Warrington 025A","E01012446","Total",527,67,39,28,460,9,83,89,118,12,37,112
"2011","Warrington 025B","E01012447","Total",494,34,10,24,460,6,65,132,104,26,53,74
"2011","Warrington 025C","E01012449","Total",641,162,121,41,479,8,167,70,132,7,18,77
"2011","Warrington 025D","E01012452","Total",732,163,100,63,569,18,168,94,140,29,40,80
"2011","Allerdale 001A","E01019126","Total",755,286,153,133,469,27,111,78,128,17,37,71
"2011","Allerdale 001B","E01019127","Total",707,209,125,84,498,5,193,64,117,10,29,80
"2011","Allerdale 001C","E01019132","Total",728,169,88,81,559,8,120,79,161,25,41,125
"2011","Allerdale 001D","E01019134","Total",670,190,109,81,480,18,148,76,109,13,33,83
"2011","Allerdale 001E","E01019135","Total",676,216,107,109,460,39,75,82,109,23,36,96
"2011","Allerdale 001F","E01019136","Total",648,167,79,88,481,17,90,127,117,14,39,77
"2011","Allerdale 001G","E01019137","Total",521,233,104,129,288,24,68,43,85,9,24,35
"2011","Allerdale 002A","E01019083","Total",784,215,106,109,569,10,168,91,168,17,24,91
"2011","Allerdale 002B","E01019107","Total",683,180,90,90,503,10,129,77,145,19,37,86
"2011","Allerdale 002C","E01019130","Total",697,170,89,81,527,13,134,89,137,20,37,97
"2011","Allerdale 002D","E01019131","Total",781,180,93,87,601,15,152,88,165,22,44,115
"2011","Allerdale 003A","E01019081","Total",825,246,125,121,579,50,120,110,164,18,35,82
"2011","Allerdale 003B","E01019082","Total",677,207,115,92,470,22,96,77,163,8,29,75
"2011","Allerdale 003C","E01019102","Total",734,210,103,107,524,29,120,72,144,23,40,96
"2011","Allerdale 003D","E01019128","Total",681,167,84,83,514,14,126,77,155,22,41,79
"2011","Allerdale 003E","E01019133","Total",663,179,75,104,484,15,106,82,149,15,37,80
"2011","Allerdale 004A","E01019093","Total",646,148,63,85,498,26,113,101,130,16,30,82
"2011","Allerdale 004B","E01019094","Total",721,197,102,95,524,23,133,107,117,12,38,94
"2011","Allerdale 004C","E01019096","Total",979,245,143,102,734,31,188,121,200,19,46,129
"2011","Allerdale 004D","E01019114","Total",625,178,78,100,447,24,92,81,128,10,29,83
"2011","Allerdale 004E","E01019115","Total",784,352,130,222,432,23,92,67,142,10,40,58
"2011","Allerdale 005A","E01019095","Total",680,259,93,166,421,54,59,79,106,12,41,70
"2011","Allerdale 005B","E01019097","Total",758,243,116,127,515,66,94,84,103,40,39,89
"2011","Allerdale 005C","E01019098","Total",711,210,101,109,501,43,97,86,137,15,48,75
"2011","Allerdale 005D","E01019099","Total",749,232,109,123,517,34,95,96,144,14,35,99
"2011","Allerdale 006A","E01019084","Total",653,180,79,101,473,44,84,114,135,18,22,56
"2011","Allerdale 006B","E01019085","Total",616,118,57,61,498,11,96,118,144,11,40,78
"2011","Allerdale 006C","E01019086","Total",460,101,60,41,359,4,113,62,83,11,25,61
"2011","Allerdale 006D","E01019088","Total",949,515,232,283,434,28,89,77,166,11,16,47
"2011","Allerdale 006E","E01019091","Total",776,183,85,98,593,17,133,120,175,20,29,99
"2011","Allerdale 007A","E01019078","Total",659,178,99,79,481,11,141,96,104,22,26,81
"2011","Allerdale 007B","E01019079","Total",645,173,109,64,472,21,115,83,142,11,28,72
"2011","Allerdale 007C","E01019080","Total",835,291,136,155,544,65,97,98,149,9,38,88
"2011","Allerdale 007D","E01019087","Total",699,202,103,99,497,16,114,86,159,13,31,78
"2011","Allerdale 007E","E01019090","Total",675,161,83,78,514,7,157,64,159,18,27,82
"2011","Allerdale 008A","E01019116","Total",611,278,96,182,333,30,54,49,98,8,26,68
"2011","Allerdale 008B","E01019118","Total",661,256,83,173,405,47,52,79,132,6,29,60
"2011","Allerdale 008C","E01019122","Total",668,277,115,162,391,56,67,78,77,14,30,69
"2011","Allerdale 008D","E01019123","Total",667,172,94,78,495,40,117,98,111,14,32,83
"2011","Allerdale 008E","E01019124","Total",840,182,105,77,658,16,122,149,182,17,55,117
"2011","Allerdale 008F","E01019125","Total",694,219,120,99,475,25,111,91,129,12,31,76
"2011","Allerdale 009A","E01019111","Total",687,211,82,129,476,75,81,89,113,10,30,78
"2011","Allerdale 009B","E01019112","Total",760,267,114,153,493,69,72,79,116,23,33,101
"2011","Allerdale 009C","E01019113","Total",837,356,138,218,481,97,62,93,129,21,20,59
"2011","Allerdale 009D","E01019120","Total",812,269,96,173,543,38,80,107,180,9,41,88
"2011","Allerdale 009E","E01019121","Total",1036,492,172,320,544,57,89,89,181,12,44,72
"2011","Allerdale 010A","E01019108","Total",629,164,78,86,465,71,81,76,106,13,31,87
"2011","Allerdale 010B","E01019109","Total",752,203,93,110,549,62,98,102,138,20,38,91
"2011","Allerdale 010C","E01019110","Total",865,381,170,211,484,85,98,79,120,10,20,72
"2011","Allerdale 010D","E01019117","Total",579,168,59,109,411,12,85,77,132,6,23,76
"2011","Allerdale 010E","E01019119","Total",636,166,105,61,470,5,150,75,110,4,37,89
"2011","Allerdale 011A","E01019089","Total",710,211,91,120,499,23,111,85,166,16,34,64
"2011","Allerdale 011B","E01019100","Total",718,218,87,131,500,20,120,94,136,10,41,79
"2011","Allerdale 011C","E01019101","Total",619,134,65,69,485,8,139,95,142,10,17,74
"2011","Allerdale 011D","E01019129","Total",702,163,78,85,539,13,116,107,174,13,25,91
"2011","Allerdale 012A","E01019092","Total",642,163,94,69,479,3,159,83,120,10,32,72
"2011","Allerdale 012B","E01019103","Total",516,137,72,65,379,28,77,65,97,16,27,69
"2011","Allerdale 012C","E01019104","Total",699,313,171,142,386,28,135,43,120,7,14,39
"2011","Allerdale 012D","E01019105","Total",525,227,97,130,298,14,55,40,110,5,18,56
"2011","Allerdale 012E","E01019106","Total",630,152,88,64,478,14,176,60,109,13,32,74
"2011","Barrow-in-Furness 001A","E01019144","Total",590,140,81,59,450,27,112,68,109,14,40,80
"2011","Barrow-in-Furness 001B","E01019145","Total",837,240,112,128,597,36,108,132,144,23,43,111
"2011","Barrow-in-Furness 001C","E01019146","Total",583,160,81,79,423,11,94,95,119,14,21,69
"2011","Barrow-in-Furness 001D","E01019147","Total",670,184,87,97,486,45,60,109,144,12,33,83
"2011","Barrow-in-Furness 002A","E01019148","Total",603,151,63,88,452,18,117,74,129,9,29,76
"2011","Barrow-in-Furness 002B","E01019149","Total",653,192,72,120,461,32,78,86,129,16,34,86
"2011","Barrow-in-Furness 002C","E01019150","Total",739,294,120,174,445,39,85,95,119,12,25,70
"2011","Barrow-in-Furness 002D","E01019151","Total",623,173,102,71,450,29,125,75,108,21,30,62
"2011","Barrow-in-Furness 003A","E01019152","Total",461,121,77,44,340,4,81,68,82,7,29,69
"2011","Barrow-in-Furness 003B","E01019153","Total",460,109,79,30,351,11,95,73,89,2,21,60
"2011","Barrow-in-Furness 003C","E01019154","Total",615,200,154,46,415,1,166,49,115,3,18,63
"2011","Barrow-in-Furness 003D","E01019155","Total",680,225,172,53,455,6,220,49,106,2,8,64
"2011","Barrow-in-Furness 003E","E01019162","Total",630,157,98,59,473,17,116,104,124,10,24,78
"2011","Barrow-in-Furness 003F","E01019163","Total",504,96,54,42,408,2,107,84,96,12,34,73
"2011","Barrow-in-Furness 004A","E01019156","Total",766,415,168,247,351,53,56,55,99,9,33,46
"2011","Barrow-in-Furness 004B","E01019159","Total",505,187,62,125,318,37,45,62,104,9,15,46
"2011","Barrow-in-Furness 004C","E01019164","Total",609,210,44,166,399,74,41,89,77,26,37,55
"2011","Barrow-in-Furness 004D","E01019165","Total",659,223,81,142,436,33,76,81,138,9,26,73
"2011","Barrow-in-Furness 004E","E01019166","Total",650,239,88,151,411,38,86,76,111,9,24,67
"2011","Barrow-in-Furness 005A","E01019167","Total",723,276,84,192,447,53,72,87,139,11,23,62
"2011","Barrow-in-Furness 005B","E01019168","Total",613,208,115,93,405,15,78,76,105,12,37,82
"2011","Barrow-in-Furness 005C","E01019169","Total",515,138,75,63,377,15,65,75,92,21,36,73
"2011","Barrow-in-Furness 005D","E01019170","Total",506,121,48,73,385,36,53,84,81,7,47,77
"2011","Barrow-in-Furness 005E","E01019171","Total",633,241,70,171,392,46,40,83,143,11,21,48
"2011","Barrow-in-Furness 006A","E01019161","Total",694,190,101,89,504,40,80,111,125,18,47,83
"2011","Barrow-in-Furness 006B","E01019176","Total",708,157,106,51,551,7,146,98,141,19,35,105
"2011","Barrow-in-Furness 006C","E01019177","Total",598,192,68,124,406,61,62,75,88,13,37,70
"2011","Barrow-in-Furness 006D","E01019178","Total",704,204,92,112,500,24,122,99,162,4,20,69
"2011","Barrow-in-Furness 006E","E01019179","Total",520,115,50,65,405,13,101,71,115,7,32,66
"2011","Barrow-in-Furness 007A","E01019140","Total",483,189,63,126,294,67,33,54,72,9,18,41
"2011","Barrow-in-Furness 007B","E01019160","Total",617,238,88,150,379,42,55,63,89,21,44,65
"2011","Barrow-in-Furness 007C","E01019172","Total",641,226,67,159,415,41,54,76,137,16,11,80
"2011","Barrow-in-Furness 007D","E01019173","Total",619,255,90,165,364,49,63,75,93,14,23,47
"2011","Barrow-in-Furness 007E","E01019174","Total",472,148,63,85,324,41,32,45,82,14,39,71
"2011","Barrow-in-Furness 007F","E01019175","Total",594,168,76,92,426,39,69,70,105,19,35,89
"2011","Barrow-in-Furness 008A","E01019141","Total",692,393,123,270,299,59,43,49,82,8,22,36
"2011","Barrow-in-Furness 008B","E01019142","Total",701,306,73,233,395,87,56,65,104,15,24,44
"2011","Barrow-in-Furness 008C","E01019143","Total",718,335,88,247,383,62,45,53,104,16,35,68
"2011","Barrow-in-Furness 008D","E01019157","Total",743,356,105,251,387,71,49,60,118,11,28,50
"2011","Barrow-in-Furness 008E","E01019158","Total",568,232,63,169,336,63,38,66,85,17,18,49
"2011","Barrow-in-Furness 009A","E01019180","Total",942,347,219,128,595,21,231,83,159,4,29,68
"2011","Barrow-in-Furness 009C","E01019182","Total",625,197,95,102,428,27,90,87,133,8,19,64
"2011","Barrow-in-Furness 009E","E01019184","Total",633,231,97,134,402,33,72,84,117,11,22,63
"2011","Barrow-in-Furness 009F","E01033160","Total",888,303,146,157,585,48,100,108,136,35,62,96
"2011","Barrow-in-Furness 010A","E01019138","Total",609,223,101,122,386,33,86,64,116,11,20,56
"2011","Barrow-in-Furness 010B","E01019139","Total",856,564,101,463,292,56,34,48,98,3,14,39
"2011","Barrow-in-Furness 010C","E01019185","Total",614,161,92,69,453,18,113,88,122,10,29,73
"2011","Barrow-in-Furness 010D","E01019186","Total",601,200,91,109,401,38,73,79,129,12,16,54
"2011","Barrow-in-Furness 010E","E01019187","Total",557,161,86,75,396,18,85,69,114,10,30,70
"2011","Carlisle 001A","E01019226","Total",481,106,50,56,375,17,93,47,107,9,27,75
"2011","Carlisle 001B","E01019227","Total",674,281,107,174,393,25,92,57,114,15,25,65
"2011","Carlisle 001C","E01019228","Total",658,201,94,107,457,26,95,68,117,12,26,113
"2011","Carlisle 001D","E01019229","Total",816,201,105,96,615,15,169,90,167,21,30,123
"2011","Carlisle 002A","E01019200","Total",727,246,123,123,481,18,151,83,123,15,25,66
"2011","Carlisle 002B","E01019201","Total",668,273,132,141,395,37,99,57,101,13,33,55
"2011","Carlisle 002C","E01019202","Total",710,224,94,130,486,40,93,99,126,23,31,74
"2011","Carlisle 002D","E01019225","Total",843,220,84,136,623,15,147,113,187,21,43,97
"2011","Carlisle 003A","E01019188","Total",651,216,99,117,435,38,82,88,105,15,29,78
"2011","Carlisle 003B","E01019189","Total",666,220,71,149,446,47,43,103,114,21,30,88
"2011","Carlisle 003C","E01019190","Total",693,191,125,66,502,11,158,75,116,11,33,98
"2011","Carlisle 003D","E01019191","Total",689,193,114,79,496,21,125,74,150,18,30,78
"2011","Carlisle 003E","E01019244","Total",636,184,121,63,452,19,120,97,103,10,21,82
"2011","Carlisle 004A","E01019196","Total",837,280,88,192,557,40,106,122,185,13,27,64
"2011","Carlisle 004B","E01019238","Total",595,172,94,78,423,13,120,88,122,8,24,48
"2011","Carlisle 004C","E01019240","Total",715,176,71,105,539,23,120,114,136,20,37,89
"2011","Carlisle 004D","E01019241","Total",679,161,91,70,518,15,137,105,144,17,29,71
"2011","Carlisle 004E","E01019243","Total",637,190,110,80,447,20,100,101,136,8,28,54
"2011","Carlisle 004F","E01019251","Total",754,216,114,102,538,12,127,109,165,18,21,86
"2011","Carlisle 005A","E01019192","Total",621,160,89,71,461,18,123,91,111,11,34,73
"2011","Carlisle 005B","E01019195","Total",551,117,49,68,434,22,83,95,128,9,23,74
"2011","Carlisle 005C","E01019203","Total",871,184,98,86,687,19,159,106,202,24,43,134
"2011","Carlisle 005D","E01019254","Total",601,165,88,77,436,10,92,78,152,8,25,71
"2011","Carlisle 005E","E01019255","Total",553,107,51,56,446,13,89,74,137,15,33,85
"2011","Carlisle 006A","E01019204","Total",618,314,58,256,304,18,23,43,135,5,8,72
"2011","Carlisle 006B","E01019206","Total",785,453,69,384,332,19,40,37,137,8,21,70
"2011","Carlisle 006C","E01019234","Total",899,508,181,327,391,32,47,49,154,2,14,93
"2011","Carlisle 006D","E01019235","Total",674,223,97,126,451,26,76,82,144,9,30,84
"2011","Carlisle 006E","E01019237","Total",610,210,60,150,400,22,64,68,122,9,37,78
"2011","Carlisle 006F","E01019242","Total",615,262,144,118,353,18,70,63,91,12,24,75
"2011","Carlisle 007A","E01019219","Total",940,253,120,133,687,19,186,126,184,18,34,120
"2011","Carlisle 007B","E01019224","Total",897,252,141,111,645,23,153,116,175,21,36,121
"2011","Carlisle 007C","E01019239","Total",623,140,59,81,483,19,99,93,119,21,34,98
"2011","Carlisle 007D","E01019249","Total",672,203,128,75,469,12,141,59,150,9,25,73
"2011","Carlisle 007E","E01019250","Total",588,149,76,73,439,16,89,70,152,10,20,82
"2011","Carlisle 008A","E01019205","Total",834,369,100,269,465,62,60,102,165,11,26,39
"2011","Carlisle 008B","E01019207","Total",689,283,82,201,406,68,45,79,129,11,21,53
"2011","Carlisle 008C","E01019215","Total",742,310,105,205,432,42,61,67,157,17,24,64
"2011","Carlisle 008D","E01019218","Total",617,169,58,111,448,52,57,75,124,16,44,80
"2011","Carlisle 008E","E01019233","Total",637,243,156,87,394,19,126,63,94,4,20,68
"2011","Carlisle 009A","E01019193","Total",662,229,65,164,433,82,55,72,112,26,32,54
"2011","Carlisle 009B","E01019194","Total",864,245,74,171,619,78,59,150,193,27,39,73
"2011","Carlisle 009C","E01019230","Total",799,350,160,190,449,54,116,69,109,12,15,74
"2011","Carlisle 009D","E01019231","Total",826,453,197,256,373,30,110,61,92,13,25,42
"2011","Carlisle 009E","E01019232","Total",651,207,107,100,444,19,96,73,119,9,44,84
"2011","Carlisle 009F","E01019252","Total",673,247,138,109,426,25,106,67,124,9,22,73
"2011","Carlisle 010A","E01019209","Total",683,298,107,191,385,22,42,98,115,14,27,67
"2011","Carlisle 010B","E01019211","Total",850,326,58,268,524,40,48,118,206,11,26,75
"2011","Carlisle 010C","E01019216","Total",848,414,124,290,434,37,56,79,167,8,20,67
"2011","Carlisle 010D","E01019217","Total",915,407,81,326,508,70,43,83,207,9,29,67
"2011","Carlisle 010E","E01019220","Total",708,265,74,191,443,23,66,103,153,7,29,62
"2011","Carlisle 010F","E01019236","Total",752,286,69,217,466,41,33,83,185,13,28,83
"2011","Carlisle 011A","E01019197","Total",887,350,124,226,537,89,67,120,122,31,42,66
"2011","Carlisle 011B","E01019198","Total",637,250,86,164,387,61,59,85,106,11,21,44
"2011","Carlisle 011C","E01019199","Total",494,173,62,111,321,51,48,66,89,15,15,37
"2011","Carlisle 011D","E01019221","Total",862,280,95,185,582,63,77,134,173,25,41,69
"2011","Carlisle 011E","E01019222","Total",734,258,125,133,476,56,74,95,128,26,39,58
"2011","Carlisle 011F","E01019245","Total",666,237,84,153,429,70,60,70,97,26,45,61
"2011","Carlisle 012A","E01019208","Total",624,157,70,87,467,68,66,106,108,15,28,76
"2011","Carlisle 012B","E01019210","Total",588,150,52,98,438,73,73,87,87,16,34,68
"2011","Carlisle 012C","E01019246","Total",621,272,150,122,349,32,89,68,80,10,23,47
"2011","Carlisle 012D","E01019247","Total",656,210,87,123,446,30,103,80,114,17,25,77
"2011","Carlisle 012E","E01019248","Total",518,195,71,124,323,70,38,70,69,17,21,38
"2011","Carlisle 013A","E01019212","Total",640,193,108,85,447,12,132,73,112,19,24,75
"2011","Carlisle 013B","E01019213","Total",1155,308,121,187,847,27,170,188,263,21,60,118
"2011","Carlisle 013C","E01019214","Total",826,265,159,106,561,30,160,77,160,14,30,90
"2011","Carlisle 013D","E01019223","Total",669,170,93,77,499,16,140,72,141,12,34,84
"2011","Carlisle 013E","E01019253","Total",768,203,99,104,565,25,127,124,165,6,37,81
"2011","Copeland 001A","E01019268","Total",489,132,58,74,357,14,104,52,101,7,21,58
"2011","Copeland 001B","E01019269","Total",680,214,85,129,466,57,80,76,114,17,32,90
"2011","Copeland 001C","E01019270","Total",594,168,65,103,426,45,64,77,127,13,22,78
"2011","Copeland 001D","E01019297","Total",546,97,45,52,449,16,80,88,133,13,41,78
"2011","Copeland 002A","E01019260","Total",635,172,67,105,463,28,61,87,148,16,35,88
"2011","Copeland 002B","E01019280","Total",1030,697,250,447,333,22,92,29,138,4,12,36
"2011","Copeland 002C","E01019281","Total",569,192,110,82,377,16,112,53,99,11,20,66
"2011","Copeland 002D","E01019282","Total",501,120,46,74,381,8,64,73,94,14,38,90
"2011","Copeland 003A","E01019261","Total",686,143,62,81,543,4,107,128,140,18,33,113
"2011","Copeland 003B","E01019262","Total",726,172,48,124,554,19,88,127,195,15,32,78
"2011","Copeland 003C","E01019284","Total",582,218,109,109,364,32,84,75,83,16,25,49
"2011","Copeland 003D","E01019285","Total",645,184,56,128,461,63,54,95,123,24,29,73
"2011","Copeland 003E","E01019286","Total",630,230,111,119,400,14,106,73,122,5,30,50
"2011","Copeland 003F","E01019287","Total",510,116,53,63,394,11,101,85,107,9,28,53
"2011","Copeland 003G","E01019288","Total",546,90,45,45,456,10,80,119,103,15,41,88
"2011","Copeland 004A","E01019256","Total",660,185,66,119,475,16,96,84,151,11,28,89
"2011","Copeland 004B","E01019263","Total",491,149,55,94,342,26,66,56,92,13,25,64
"2011","Copeland 004C","E01019264","Total",701,193,80,113,508,20,87,123,138,15,49,76
"2011","Copeland 004D","E01019265","Total",612,238,75,163,374,29,77,59,115,5,23,66
"2011","Copeland 004E","E01019266","Total",642,193,65,128,449,28,78,78,131,12,32,90
"2011","Copeland 004F","E01019267","Total",603,225,119,106,378,54,71,66,79,8,35,65
"2011","Copeland 004G","E01019276","Total",447,98,37,61,349,11,83,52,133,7,20,43
"2011","Copeland 004H","E01019277","Total",552,204,87,117,348,38,78,56,74,18,27,57
"2011","Copeland 004I","E01019278","Total",570,147,50,97,423,11,79,79,128,9,38,79
"2011","Copeland 005A","E01019291","Total",599,210,110,100,389,32,61,77,112,13,23,71
"2011","Copeland 005B","E01019292","Total",504,143,64,79,361,18,93,50,105,5,30,60
"2011","Copeland 005C","E01019294","Total",619,152,84,68,467,38,99,75,137,7,29,82
"2011","Copeland 005D","E01019295","Total",609,156,60,96,453,82,47,90,97,32,35,70
"2011","Copeland 005E","E01019296","Total",595,185,106,79,410,35,69,70,107,10,39,80
"2011","Copeland 005F","E01019301","Total",634,213,55,158,421,95,50,76,83,19,23,75
"2011","Copeland 005G","E01019302","Total",423,106,41,65,317,23,51,47,83,7,27,79
"2011","Copeland 006A","E01019271","Total",582,179,75,104,403,51,63,76,104,21,23,65
"2011","Copeland 006B","E01019272","Total",609,144,64,80,465,58,90,86,107,20,34,70
"2011","Copeland 006C","E01019273","Total",687,185,62,123,502,18,108,79,156,16,54,71
"2011","Copeland 006D","E01019274","Total",790,331,135,196,459,44,109,80,135,8,18,65
"2011","Copeland 006E","E01019275","Total",937,289,123,166,648,29,139,113,158,22,57,130
"2011","Copeland 007A","E01019257","Total",643,164,82,82,479,25,127,78,130,17,29,73
"2011","Copeland 007B","E01019258","Total",666,165,70,95,501,12,124,70,166,13,30,86
"2011","Copeland 007C","E01019279","Total",644,199,95,104,445,5,160,71,120,7,21,61
"2011","Copeland 007D","E01019300","Total",737,200,76,124,537,14,117,123,153,19,28,83
"2011","Copeland 007E","E01019303","Total",654,187,95,92,467,14,130,81,117,19,34,72
"2011","Copeland 007F","E01019304","Total",582,175,104,71,407,2,115,55,123,17,21,74
"2011","Copeland 008A","E01019259","Total",584,181,80,101,403,6,121,51,122,13,28,62
"2011","Copeland 008B","E01019283","Total",574,158,100,58,416,10,112,61,111,9,35,78
"2011","Copeland 008C","E01019289","Total",598,167,90,77,431,28,110,82,102,13,28,68
"2011","Copeland 008D","E01019290","Total",463,139,51,88,324,22,62,52,86,13,32,57
"2011","Copeland 008E","E01019293","Total",571,141,84,57,430,4,122,53,128,13,29,81
"2011","Copeland 008F","E01019298","Total",682,204,110,94,478,25,140,80,116,12,35,70
"2011","Copeland 008G","E01019299","Total",903,358,163,195,545,54,102,98,127,24,35,105
"2011","Eden 001A","E01019305","Total",996,380,165,215,616,37,142,103,185,12,35,102
"2011","Eden 001B","E01019314","Total",531,126,58,68,405,14,103,58,114,16,26,74
"2011","Eden 001C","E01019320","Total",600,140,52,88,460,11,106,81,132,22,36,72
"2011","Eden 001D","E01019321","Total",644,155,86,69,489,7,112,85,144,20,40,81
"2011","Eden 002A","E01019315","Total",732,186,89,97,546,20,140,93,164,21,32,76
"2011","Eden 002B","E01019316","Total",528,125,53,72,403,12,84,85,107,17,24,74
"2011","Eden 002C","E01019322","Total",625,186,109,77,439,14,106,81,141,8,32,57
"2011","Eden 002D","E01019338","Total",608,129,72,57,479,12,113,86,134,12,34,88
"2011","Eden 003A","E01019327","Total",667,267,131,136,400,50,84,79,113,3,20,51
"2011","Eden 003B","E01019332","Total",663,274,143,131,389,25,99,82,110,10,12,51
"2011","Eden 003C","E01019333","Total",536,227,93,134,309,36,53,60,93,3,15,49
"2011","Eden 003D","E01019335","Total",656,217,65,152,439,28,55,103,131,16,36,70
"2011","Eden 003E","E01019336","Total",832,340,82,258,492,44,57,94,176,16,18,87
"2011","Eden 004A","E01019312","Total",635,171,89,82,464,6,156,75,128,11,25,63
"2011","Eden 004B","E01019326","Total",696,184,104,80,512,29,141,93,150,6,29,64
"2011","Eden 004C","E01019328","Total",533,147,76,71,386,12,88,81,89,14,24,78
"2011","Eden 004D","E01019329","Total",501,155,86,69,346,8,97,47,98,18,23,55
"2011","Eden 004E","E01019330","Total",656,234,97,137,422,22,75,82,143,12,22,66
"2011","Eden 004F","E01019331","Total",666,178,88,90,488,30,132,74,119,20,24,89
"2011","Eden 004G","E01019334","Total",624,206,131,75,418,14,133,79,95,14,28,55
"2011","Eden 005A","E01019308","Total",620,166,77,89,454,22,117,67,140,19,26,63
"2011","Eden 005B","E01019311","Total",637,171,104,67,466,8,139,86,131,10,27,65
"2011","Eden 005C","E01019313","Total",639,200,114,86,439,15,140,61,130,13,18,62
"2011","Eden 005D","E01019339","Total",595,168,88,80,427,14,140,67,114,9,18,65
"2011","Eden 006A","E01019306","Total",651,267,143,124,384,13,135,66,106,10,18,36
"2011","Eden 006B","E01019307","Total",764,230,95,135,534,28,142,105,142,13,40,64
"2011","Eden 006C","E01019310","Total",574,151,73,78,423,14,103,67,130,17,25,67
"2011","Eden 006D","E01019319","Total",640,162,72,90,478,27,96,85,141,21,35,73
"2011","Eden 006E","E01019323","Total",538,149,78,71,389,16,107,61,114,18,14,59
"2011","Eden 006F","E01019324","Total",532,123,55,68,409,17,104,73,98,17,18,82
"2011","Eden 006G","E01019337","Total",620,209,102,107,411,14,97,80,106,13,25,76
"2011","Eden 007A","E01019309","Total",982,256,114,142,726,19,189,131,205,26,39,117
"2011","Eden 007B","E01019317","Total",549,147,73,74,402,5,127,66,100,18,18,68
"2011","Eden 007C","E01019318","Total",621,233,125,108,388,40,94,63,124,12,11,44
"2011","Eden 007D","E01019325","Total",589,161,66,95,428,20,90,83,126,13,20,76
"2011","Eden 007E","E01019340","Total",563,138,74,64,425,10,119,67,113,17,24,75
"2011","South Lakeland 001A","E01019374","Total",708,278,127,151,430,31,90,75,125,13,23,73
"2011","South Lakeland 001B","E01019375","Total",690,290,186,104,400,9,160,37,123,6,17,48
"2011","South Lakeland 001C","E01019376","Total",576,179,92,87,397,9,127,52,125,8,18,58
"2011","South Lakeland 001D","E01019395","Total",950,406,261,145,544,21,189,71,161,7,23,72
"2011","South Lakeland 002A","E01019387","Total",960,314,176,138,646,23,184,118,186,11,44,80
"2011","South Lakeland 002B","E01019396","Total",937,323,189,134,614,30,183,99,154,16,33,99
"2011","South Lakeland 002C","E01019397","Total",899,322,127,195,577,40,163,93,189,15,24,53
"2011","South Lakeland 002D","E01019398","Total",481,126,56,70,355,30,56,77,102,14,26,50
"2011","South Lakeland 002E","E01019399","Total",461,149,82,67,312,15,68,63,73,9,25,59
"2011","South Lakeland 003A","E01019346","Total",849,232,116,116,617,29,172,87,182,20,33,94
"2011","South Lakeland 003B","E01019359","Total",953,341,151,190,612,55,118,117,185,18,33,86
"2011","South Lakeland 003C","E01019365","Total",1006,346,126,220,660,28,121,106,208,15,55,127
"2011","South Lakeland 003D","E01019370","Total",1057,402,154,248,655,32,120,157,229,21,27,69
"2011","South Lakeland 004A","E01019360","Total",1059,470,154,316,589,27,103,91,260,10,27,71
"2011","South Lakeland 004B","E01019363","Total",949,445,154,291,504,37,85,99,161,16,31,75
"2011","South Lakeland 004C","E01019364","Total",841,312,123,189,529,51,65,123,140,28,39,83
"2011","South Lakeland 004D","E01019371","Total",934,281,101,180,653,62,104,141,181,24,40,101
"2011","South Lakeland 005A","E01019358","Total",790,196,118,78,594,29,151,111,177,13,31,82
"2011","South Lakeland 005B","E01019362","Total",900,281,164,117,619,17,172,131,164,15,31,89
"2011","South Lakeland 005C","E01019366","Total",781,225,145,80,556,19,134,110,153,19,26,95
"2011","South Lakeland 005D","E01019394","Total",926,188,76,112,738,12,168,110,235,38,57,118
"2011","South Lakeland 006A","E01019361","Total",797,222,112,110,575,19,145,113,162,15,40,81
"2011","South Lakeland 006B","E01019367","Total",1091,362,141,221,729,38,134,176,211,28,35,107
"2011","South Lakeland 006C","E01019368","Total",840,190,92,98,650,24,117,157,166,21,55,110
"2011","South Lakeland 006D","E01019369","Total",869,292,176,116,577,15,178,95,152,11,28,98
"2011","South Lakeland 007A","E01019356","Total",684,241,123,118,443,9,140,55,147,10,23,59
"2011","South Lakeland 007B","E01019381","Total",923,239,101,138,684,21,197,104,210,23,31,98
"2011","South Lakeland 007C","E01019386","Total",797,248,128,120,549,21,170,66,171,14,23,84
"2011","South Lakeland 008A","E01019344","Total",468,129,69,60,339,14,83,58,107,5,13,59
"2011","South Lakeland 008B","E01019345","Total",530,154,87,67,376,4,107,56,113,15,21,60
"2011","South Lakeland 008C","E01019350","Total",735,218,118,100,517,17,162,62,156,6,24,90
"2011","South Lakeland 008D","E01019351","Total",760,184,89,95,576,18,148,71,189,12,47,91
"2011","South Lakeland 009A","E01019372","Total",557,275,141,134,282,13,91,46,84,5,14,29
"2011","South Lakeland 009B","E01019373","Total",543,145,68,77,398,13,120,67,118,8,16,56
"2011","South Lakeland 009C","E01019384","Total",973,266,148,118,707,14,226,99,221,18,42,87
"2011","South Lakeland 009D","E01019385","Total",588,261,124,137,327,16,84,64,102,10,11,40
"2011","South Lakeland 010A","E01019348","Total",518,114,74,40,404,7,122,83,104,12,29,47
"2011","South Lakeland 010B","E01019352","Total",902,178,81,97,724,20,176,112,212,23,51,130
"2011","South Lakeland 010C","E01019377","Total",805,234,122,112,571,15,218,79,148,18,21,72
"2011","South Lakeland 010D","E01019383","Total",882,237,144,93,645,7,236,89,169,18,37,89
"2011","South Lakeland 011A","E01019341","Total",752,201,131,70,551,4,259,57,158,4,17,52
"2011","South Lakeland 011B","E01019342","Total",508,205,147,58,303,11,124,36,63,11,18,40
"2011","South Lakeland 011C","E01019343","Total",668,191,116,75,477,8,180,56,134,11,23,65
"2011","South Lakeland 011D","E01019347","Total",781,229,101,128,552,29,118,110,173,17,32,73
"2011","South Lakeland 011E","E01019382","Total",947,319,149,170,628,46,154,122,158,21,40,87
"2011","South Lakeland 012A","E01019388","Total",774,237,120,117,537,37,133,89,126,13,36,103
"2011","South Lakeland 012B","E01019389","Total",1005,294,81,213,711,74,117,153,217,18,37,95
"2011","South Lakeland 012C","E01019390","Total",960,367,161,206,593,28,143,122,178,16,29,77
"2011","South Lakeland 012D","E01019392","Total",1006,527,230,297,479,38,82,81,165,14,20,79
"2011","South Lakeland 013A","E01019349","Total",822,242,141,101,580,15,194,88,156,9,24,94
"2011","South Lakeland 013B","E01019353","Total",695,222,142,80,473,21,161,68,107,15,26,75
"2011","South Lakeland 013C","E01019354","Total",737,377,246,131,360,2,161,33,100,8,16,40
"2011","South Lakeland 013D","E01019355","Total",659,220,162,58,439,5,258,27,102,3,15,29
"2011","South Lakeland 013E","E01019357","Total",831,246,139,107,585,24,161,95,165,10,37,93
"2011","South Lakeland 014A","E01019378","Total",688,182,96,86,506,19,113,102,148,6,39,79
"2011","South Lakeland 014B","E01019379","Total",633,186,106,80,447,10,152,64,115,10,25,71
"2011","South Lakeland 014C","E01019380","Total",474,110,51,59,364,11,103,61,115,8,15,51
"2011","South Lakeland 014D","E01019391","Total",739,190,105,85,549,20,148,105,144,19,24,89
"2011","South Lakeland 014E","E01019393","Total",904,251,160,91,653,7,239,88,187,13,25,94
"2011","Bolton 001A","E01004768","Total",605,100,48,52,505,15,102,129,122,10,32,95
"2011","Bolton 001B","E01004803","Total",709,180,68,112,529,22,128,107,159,12,38,63
"2011","Bolton 001C","E01004804","Total",602,119,59,60,483,11,119,106,123,5,28,91
"2011","Bolton 001D","E01004807","Total",543,93,17,76,450,27,55,106,123,15,43,81
"2011","Bolton 001E","E01004808","Total",687,174,73,101,513,23,104,104,140,13,29,100
"2011","Bolton 002A","E01004788","Total",609,155,104,51,454,12,138,85,114,12,20,73
"2011","Bolton 002B","E01004790","Total",644,189,105,84,455,37,112,70,121,13,24,78
"2011","Bolton 002C","E01004805","Total",676,151,90,61,525,21,133,98,129,13,37,94
"2011","Bolton 002D","E01004806","Total",650,181,122,59,469,16,154,89,86,10,41,73
"2011","Bolton 002E","E01004810","Total",626,117,50,67,509,23,89,122,132,15,41,87
"2011","Bolton 003A","E01004769","Total",685,223,92,131,462,21,90,94,135,12,35,75
"2011","Bolton 003B","E01004770","Total",616,147,103,44,469,14,143,93,104,15,29,71
"2011","Bolton 003C","E01004771","Total",636,113,67,46,523,16,133,108,128,24,36,78
"2011","Bolton 003D","E01004773","Total",852,312,94,218,540,44,63,105,165,25,42,96
"2011","Bolton 003E","E01004809","Total",893,375,146,229,518,55,103,93,170,9,25,63
"2011","Bolton 004A","E01004777","Total",705,241,87,154,464,52,77,97,145,12,32,49
"2011","Bolton 004B","E01004881","Total",748,367,197,170,381,43,87,75,114,7,13,42
"2011","Bolton 004C","E01004888","Total",554,152,47,105,402,21,57,99,106,12,27,80
"2011","Bolton 004D","E01004889","Total",608,183,88,95,425,40,80,89,96,18,35,67
"2011","Bolton 004E","E01004890","Total",673,244,82,162,429,32,89,70,141,8,28,61
"2011","Bolton 005A","E01004766","Total",795,350,160,190,445,46,90,76,122,9,37,65
"2011","Bolton 005B","E01004767","Total",768,286,111,175,482,29,97,82,143,14,40,77
"2011","Bolton 005C","E01004772","Total",731,263,87,176,468,69,44,100,104,27,49,75
"2011","Bolton 005D","E01004774","Total",706,232,79,153,474,51,55,89,126,17,48,88
"2011","Bolton 005E","E01004824","Total",496,107,29,78,389,18,21,64,52,50,99,85
"2011","Bolton 006A","E01004784","Total",508,98,63,35,410,8,108,81,97,11,23,82
"2011","Bolton 006B","E01004785","Total",641,190,97,93,451,35,113,74,122,14,20,73
"2011","Bolton 006C","E01004786","Total",648,193,119,74,455,29,117,93,112,5,21,78
"2011","Bolton 006D","E01004789","Total",591,135,88,47,456,9,129,84,108,12,29,85
"2011","Bolton 006E","E01004791","Total",607,247,150,97,360,15,101,71,82,8,20,63
"2011","Bolton 006F","E01004792","Total",642,146,92,54,496,11,173,80,122,13,21,76
"2011","Bolton 007A","E01004779","Total",588,119,39,80,469,33,43,107,136,26,46,78
"2011","Bolton 007B","E01004781","Total",792,211,62,149,581,38,69,155,197,9,30,83
"2011","Bolton 007C","E01004882","Total",594,180,102,78,414,24,59,88,122,12,31,78
"2011","Bolton 007D","E01004883","Total",627,176,70,106,451,26,60,90,161,13,33,68
"2011","Bolton 007E","E01004884","Total",685,188,96,92,497,6,163,77,156,10,19,66
"2011","Bolton 008A","E01004864","Total",697,235,96,139,462,34,72,86,137,14,37,82
"2011","Bolton 008B","E01004867","Total",632,204,56,148,428,49,52,100,98,27,34,68
"2011","Bolton 008C","E01004921","Total",737,260,119,141,477,31,106,93,140,10,19,78
"2011","Bolton 008D","E01004924","Total",604,122,67,55,482,14,99,92,130,15,47,85
"2011","Bolton 008E","E01004925","Total",646,193,104,89,453,18,91,85,121,14,41,83
"2011","Bolton 009A","E01004778","Total",517,146,75,71,371,19,113,51,88,5,27,68
"2011","Bolton 009B","E01004780","Total",871,245,90,155,626,39,104,139,208,12,34,90
"2011","Bolton 009C","E01004782","Total",494,150,86,64,344,18,73,64,106,12,21,50
"2011","Bolton 009D","E01004783","Total",636,165,84,81,471,19,107,79,134,7,39,86
"2011","Bolton 010A","E01004802","Total",750,262,98,164,488,78,54,111,91,26,50,78
"2011","Bolton 010B","E01004926","Total",510,157,63,94,353,56,33,64,66,18,52,64
"2011","Bolton 010C","E01004927","Total",1008,438,128,310,570,89,58,112,179,18,40,74
"2011","Bolton 010D","E01004929","Total",867,307,118,189,560,53,68,108,158,34,43,96
"2011","Bolton 011A","E01004820","Total",645,266,81,185,379,56,38,69,72,27,67,50
"2011","Bolton 011B","E01004825","Total",631,262,61,201,369,33,26,72,66,52,55,65
"2011","Bolton 011C","E01004826","Total",634,213,52,161,421,71,42,85,87,33,47,56
"2011","Bolton 011D","E01004865","Total",653,298,126,172,355,35,53,72,104,15,30,46
"2011","Bolton 011E","E01004866","Total",780,353,140,213,427,71,49,75,98,32,49,53
"2011","Bolton 012A","E01004840","Total",715,199,95,104,516,43,108,82,147,18,34,84
"2011","Bolton 012B","E01004841","Total",669,222,76,146,447,66,42,106,78,41,48,66
"2011","Bolton 012C","E01004842","Total",732,224,153,71,508,16,123,95,120,27,37,90
"2011","Bolton 012D","E01004919","Total",656,188,95,93,468,28,116,89,107,14,28,86
"2011","Bolton 012E","E01004920","Total",658,189,102,87,469,38,104,69,121,27,36,74
"2011","Bolton 013A","E01004787","Total",778,346,92,254,432,97,46,82,106,23,27,51
"2011","Bolton 013B","E01004793","Total",658,224,86,138,434,54,74,71,105,26,39,65
"2011","Bolton 013C","E01004794","Total",678,164,61,103,514,88,63,106,110,39,47,61
"2011","Bolton 013D","E01004795","Total",700,304,91,213,396,40,85,72,105,15,18,61
"2011","Bolton 013E","E01004797","Total",507,126,61,65,381,60,36,71,81,28,37,68
"2011","Bolton 014A","E01004775","Total",614,152,71,81,462,19,113,77,140,12,33,68
"2011","Bolton 014B","E01004885","Total",530,97,59,38,433,11,94,95,103,12,36,82
"2011","Bolton 014C","E01004886","Total",610,219,101,118,391,45,56,80,94,12,43,61
"2011","Bolton 014D","E01004887","Total",618,198,78,120,420,29,81,68,109,17,38,78
"2011","Bolton 015A","E01004868","Total",692,241,60,181,451,45,38,90,136,22,49,71
"2011","Bolton 015B","E01004869","Total",848,401,135,266,447,76,51,100,123,15,29,53
"2011","Bolton 015C","E01004870","Total",794,391,102,289,403,30,57,47,94,26,68,81
"2011","Bolton 015D","E01004871","Total",545,162,40,122,383,38,36,63,76,34,69,67
"2011","Bolton 015E","E01004922","Total",775,280,98,182,495,77,57,95,133,16,43,74
"2011","Bolton 016B","E01004822","Total",625,252,86,166,373,36,45,57,46,43,72,74
"2011","Bolton 016C","E01004823","Total",838,409,136,273,429,66,67,60,99,25,39,73
"2011","Bolton 016D","E01004848","Total",714,381,148,233,333,42,58,58,89,21,19,46
"2011","Bolton 016E","E01033217","Total",658,400,114,286,258,29,37,33,124,5,6,24
"2011","Bolton 016F","E01033220","Total",745,467,82,385,278,38,22,47,98,16,16,41
"2011","Bolton 017A","E01004818","Total",713,345,76,269,368,31,46,62,102,18,38,71
"2011","Bolton 017B","E01004819","Total",596,220,76,144,376,30,85,51,99,12,28,71
"2011","Bolton 017C","E01004928","Total",684,274,98,176,410,67,56,78,123,8,22,56
"2011","Bolton 017D","E01004930","Total",646,168,89,79,478,25,123,85,102,7,39,97
"2011","Bolton 017E","E01004931","Total",767,314,160,154,453,44,99,97,112,12,28,61
"2011","Bolton 017F","E01004932","Total",717,243,64,179,474,53,53,99,165,9,27,68
"2011","Bolton 018A","E01004834","Total",579,190,62,128,389,34,37,73,102,27,54,62
"2011","Bolton 018B","E01004838","Total",642,206,66,140,436,63,45,86,93,30,46,73
"2011","Bolton 018C","E01004843","Total",621,173,91,82,448,18,95,103,105,12,33,82
"2011","Bolton 018D","E01004845","Total",692,175,68,107,517,31,93,91,149,16,53,84
"2011","Bolton 018E","E01004923","Total",663,207,44,163,456,45,50,75,138,19,47,82
"2011","Bolton 019A","E01004796","Total",643,183,61,122,460,25,85,90,125,18,33,84
"2011","Bolton 019B","E01004798","Total",689,202,87,115,487,66,71,94,112,15,42,87
"2011","Bolton 019C","E01004799","Total",598,160,93,67,438,16,121,65,131,7,23,75
"2011","Bolton 019D","E01004800","Total",529,101,40,61,428,21,56,73,143,12,32,91
"2011","Bolton 019E","E01004801","Total",690,208,53,155,482,114,47,82,109,23,33,74
"2011","Bolton 019F","E01004917","Total",869,236,68,168,633,71,80,150,182,20,32,98
"2011","Bolton 020A","E01004835","Total",577,135,61,74,442,14,122,61,82,18,49,96
"2011","Bolton 020B","E01004836","Total",588,155,92,63,433,8,138,71,81,12,40,83
"2011","Bolton 020C","E01004837","Total",599,103,63,40,496,8,118,82,101,24,55,108
"2011","Bolton 020D","E01004844","Total",612,100,58,42,512,6,137,86,123,15,45,100
"2011","Bolton 020E","E01004897","Total",474,124,48,76,350,18,83,77,97,6,16,53
"2011","Bolton 021A","E01004827","Total",684,281,95,186,403,62,50,82,73,35,43,58
"2011","Bolton 021B","E01004849","Total",548,155,39,116,393,19,37,58,62,43,90,84
"2011","Bolton 021C","E01004850","Total",762,345,59,286,417,53,40,73,100,32,53,66
"2011","Bolton 021D","E01004851","Total",674,316,137,179,358,27,60,39,71,35,54,72
"2011","Bolton 021E","E01004853","Total",517,145,49,96,372,45,24,77,49,51,60,66
"2011","Bolton 022A","E01004811","Total",633,251,72,179,382,53,30,70,100,34,52,43
"2011","Bolton 022B","E01004812","Total",624,177,31,146,447,35,30,75,101,45,81,80
"2011","Bolton 022C","E01004813","Total",530,171,46,125,359,42,54,56,69,17,40,81
"2011","Bolton 022D","E01004815","Total",589,181,77,104,408,38,61,75,80,33,50,71
"2011","Bolton 022E","E01004817","Total",754,345,101,244,409,30,66,70,135,15,29,64
"2011","Bolton 023A","E01004828","Total",652,202,65,137,450,62,48,85,88,48,60,59
"2011","Bolton 023B","E01004829","Total",498,167,51,116,331,35,22,53,79,28,54,60
"2011","Bolton 023C","E01004832","Total",650,187,64,123,463,54,59,125,111,12,27,75
"2011","Bolton 023D","E01004854","Total",460,101,30,71,359,21,27,76,50,36,70,79
"2011","Bolton 023E","E01004878","Total",541,140,52,88,401,25,72,62,75,35,52,80
"2011","Bolton 024A","E01004911","Total",745,307,104,203,438,42,78,87,108,15,34,74
"2011","Bolton 024B","E01004912","Total",642,138,76,62,504,31,135,66,158,6,24,84
"2011","Bolton 024C","E01004913","Total",768,206,66,140,562,55,60,143,134,30,52,88
"2011","Bolton 024D","E01004914","Total",519,112,79,33,407,18,137,56,93,12,22,69
"2011","Bolton 024E","E01004915","Total",536,103,56,47,433,20,90,65,119,6,31,102
"2011","Bolton 024F","E01004916","Total",666,237,122,115,429,54,73,71,113,18,28,72
"2011","Bolton 024G","E01004918","Total",520,117,61,56,403,20,80,62,102,11,42,86
"2011","Bolton 025A","E01004846","Total",512,176,72,104,336,40,38,69,79,29,32,49
"2011","Bolton 025B","E01004847","Total",638,142,30,112,496,59,36,120,87,50,80,64
"2011","Bolton 025C","E01004852","Total",484,95,37,58,389,24,38,54,63,53,78,79
"2011","Bolton 025D","E01004877","Total",689,259,118,141,430,57,56,82,52,47,71,65
"2011","Bolton 025E","E01004879","Total",520,148,49,99,372,38,45,91,66,36,47,49
"2011","Bolton 026A","E01004830","Total",741,320,133,187,421,55,67,88,95,18,23,75
"2011","Bolton 026B","E01004831","Total",654,175,86,89,479,28,78,108,115,18,44,88
"2011","Bolton 026C","E01004833","Total",636,158,89,69,478,26,107,95,121,10,40,79
"2011","Bolton 026D","E01004839","Total",944,441,185,256,503,71,87,93,113,27,48,64
"2011","Bolton 027A","E01004814","Total",582,202,45,157,380,46,42,74,89,22,49,58
"2011","Bolton 027B","E01004855","Total",613,174,55,119,439,61,56,71,114,18,44,75
"2011","Bolton 027C","E01004856","Total",637,246,89,157,391,55,44,84,107,18,33,50
"2011","Bolton 027D","E01004857","Total",636,236,54,182,400,51,45,69,107,24,41,63
"2011","Bolton 028A","E01004891","Total",756,289,162,127,467,19,114,73,129,12,36,84
"2011","Bolton 028B","E01004893","Total",592,99,49,50,493,12,94,95,130,16,33,113
"2011","Bolton 028C","E01004894","Total",797,244,111,133,553,44,79,105,169,24,34,98
"2011","Bolton 028E","E01004901","Total",739,153,53,100,586,20,90,117,181,13,44,121
"2011","Bolton 028F","E01033218","Total",648,151,16,135,497,31,40,168,170,17,24,47
"2011","Bolton 028G","E01033219","Total",593,108,55,53,485,30,98,93,127,15,38,84
"2011","Bolton 029A","E01004816","Total",513,112,67,45,401,23,68,39,57,46,76,92
"2011","Bolton 029B","E01004872","Total",619,174,61,113,445,48,58,76,104,22,54,83
"2011","Bolton 029C","E01004873","Total",626,154,69,85,472,53,41,73,102,43,69,91
"2011","Bolton 029D","E01004875","Total",653,165,94,71,488,33,109,94,107,18,33,94
"2011","Bolton 029E","E01004880","Total",508,106,62,44,402,18,75,72,111,11,49,66
"2011","Bolton 030A","E01004892","Total",693,201,141,60,492,20,168,76,104,14,28,82
"2011","Bolton 030B","E01004896","Total",556,107,72,35,449,7,171,57,97,12,33,72
"2011","Bolton 030C","E01004899","Total",622,162,58,104,460,21,86,112,109,17,35,80
"2011","Bolton 030D","E01004900","Total",624,152,30,122,472,38,39,135,143,16,44,57
"2011","Bolton 031A","E01004776","Total",794,244,89,155,550,48,73,124,173,14,29,89
"2011","Bolton 031B","E01004895","Total",588,194,92,102,394,28,58,77,113,16,30,72
"2011","Bolton 031C","E01004936","Total",950,310,88,222,640,44,89,138,245,14,29,81
"2011","Bolton 031D","E01004938","Total",632,221,116,105,411,57,54,77,86,19,40,78
"2011","Bolton 031E","E01004939","Total",686,227,59,168,459,43,81,87,132,10,33,73
"2011","Bolton 032A","E01004858","Total",755,319,123,196,436,38,61,87,126,17,38,69
"2011","Bolton 032B","E01004859","Total",704,365,152,213,339,44,59,63,90,14,24,45
"2011","Bolton 032C","E01004860","Total",691,233,97,136,458,60,85,71,126,8,27,81
"2011","Bolton 032D","E01004902","Total",802,308,100,208,494,43,101,87,154,20,29,60
"2011","Bolton 032E","E01004906","Total",810,357,147,210,453,52,71,83,116,22,28,81
"2011","Bolton 033A","E01004861","Total",623,157,42,115,466,77,40,100,88,28,51,82
"2011","Bolton 033B","E01004862","Total",610,250,100,150,360,64,35,74,85,21,32,49
"2011","Bolton 033C","E01004863","Total",646,223,69,154,423,54,44,82,102,13,55,73
"2011","Bolton 033D","E01004874","Total",683,158,71,87,525,73,81,95,103,28,55,90
"2011","Bolton 033E","E01004876","Total",792,252,79,173,540,64,93,111,129,19,51,73
"2011","Bolton 034A","E01004903","Total",575,120,44,76,455,35,55,121,118,16,34,76
"2011","Bolton 034B","E01004904","Total",696,200,63,137,496,54,63,141,135,9,33,61
"2011","Bolton 034C","E01004905","Total",679,207,75,132,472,49,59,81,133,23,32,95
"2011","Bolton 034D","E01004907","Total",541,158,57,101,383,54,43,80,93,11,46,56
"2011","Bolton 034E","E01004908","Total",570,151,93,58,419,26,123,84,82,10,32,62
"2011","Bolton 034F","E01004909","Total",632,226,112,114,406,47,84,83,85,14,33,60
"2011","Bolton 034G","E01004910","Total",970,341,63,278,629,60,70,124,218,17,38,102
"2011","Bolton 035A","E01004933","Total",569,170,31,139,399,30,40,91,122,14,17,85
"2011","Bolton 035B","E01004934","Total",560,105,18,87,455,50,38,108,115,22,40,82
"2011","Bolton 035C","E01004935","Total",705,157,55,102,548,37,69,144,155,17,49,77
"2011","Bolton 035D","E01004937","Total",558,87,21,66,471,20,63,112,107,8,61,100
"2011","Bolton 035E","E01004940","Total",616,147,76,71,469,26,82,85,152,19,27,78
"2011","Bury 001A","E01005014","Total",746,290,100,190,456,43,97,63,165,7,20,61
"2011","Bury 001B","E01005015","Total",688,229,103,126,459,44,65,80,156,19,27,68
"2011","Bury 001C","E01005016","Total",718,253,81,172,465,27,67,94,172,15,20,70
"2011","Bury 001D","E01005017","Total",707,190,71,119,517,31,76,146,129,21,44,70
"2011","Bury 001E","E01005018","Total",713,261,81,180,452,41,69,112,144,10,28,48
"2011","Bury 001F","E01005021","Total",410,90,48,42,320,7,79,62,84,11,19,58
"2011","Bury 002A","E01005019","Total",620,148,86,62,472,33,107,89,117,17,30,79
"2011","Bury 002B","E01005023","Total",554,170,108,62,384,17,92,60,92,17,32,74
"2011","Bury 002C","E01005046","Total",643,175,118,57,468,12,173,79,98,13,29,64
"2011","Bury 002D","E01005048","Total",666,115,62,53,551,9,155,89,133,19,30,116
"2011","Bury 003A","E01005020","Total",507,56,16,40,451,19,38,123,111,17,39,104
"2011","Bury 003B","E01005022","Total",644,141,43,98,503,33,74,111,146,13,43,83
"2011","Bury 003C","E01005047","Total",568,114,69,45,454,16,110,76,129,15,29,79
"2011","Bury 003D","E01005049","Total",738,197,85,112,541,36,108,108,160,15,29,85
"2011","Bury 003E","E01005051","Total",658,199,93,106,459,35,67,113,135,14,29,66
"2011","Bury 004A","E01004976","Total",638,197,83,114,441,42,90,59,91,23,41,95
"2011","Bury 004B","E01004977","Total",767,290,149,141,477,34,99,80,140,15,27,82
"2011","Bury 004C","E01004978","Total",654,183,71,112,471,32,64,87,128,29,48,83
"2011","Bury 004D","E01004981","Total",632,197,104,93,435,17,115,81,116,17,29,60
"2011","Bury 004E","E01004982","Total",635,166,76,90,469,13,138,82,125,14,25,72
"2011","Bury 005A","E01004961","Total",647,174,74,100,473,65,70,81,120,20,36,81
"2011","Bury 005B","E01004965","Total",486,94,47,47,392,8,98,67,96,14,33,76
"2011","Bury 005C","E01004966","Total",719,185,61,124,534,82,85,111,110,22,41,83
"2011","Bury 005D","E01004967","Total",472,72,37,35,400,9,85,71,96,14,41,84
"2011","Bury 006A","E01004963","Total",673,206,98,108,467,30,116,84,122,8,22,85
"2011","Bury 006B","E01004968","Total",627,122,63,59,505,22,112,109,136,16,40,70
"2011","Bury 006C","E01005050","Total",819,200,85,115,619,57,69,175,154,29,41,94
"2011","Bury 006D","E01005052","Total",582,113,51,62,469,22,98,93,113,7,42,94
"2011","Bury 006E","E01005053","Total",640,172,63,109,468,46,74,102,136,12,23,75
"2011","Bury 007A","E01004954","Total",658,224,112,112,434,22,112,67,120,20,15,78
"2011","Bury 007B","E01004955","Total",550,164,51,113,386,47,49,72,102,19,33,64
"2011","Bury 007C","E01004956","Total",696,270,105,165,426,44,71,93,112,16,32,58
"2011","Bury 007D","E01004957","Total",813,317,98,219,496,98,52,88,132,15,33,78
"2011","Bury 007E","E01004960","Total",632,226,53,173,406,104,22,89,86,28,31,46
"2011","Bury 008A","E01004958","Total",661,276,81,195,385,46,44,65,124,16,23,67
"2011","Bury 008B","E01004959","Total",728,255,65,190,473,64,59,88,125,23,38,76
"2011","Bury 008C","E01004979","Total",630,241,60,181,389,49,31,73,102,34,39,61
"2011","Bury 008D","E01004980","Total",596,249,65,184,347,41,19,70,122,14,18,63
"2011","Bury 008E","E01005024","Total",511,170,61,109,341,47,27,67,68,32,53,47
"2011","Bury 008F","E01005026","Total",545,134,42,92,411,31,35,82,94,43,58,68
"2011","Bury 009A","E01004947","Total",653,255,59,196,398,48,45,90,112,7,31,65
"2011","Bury 009B","E01004948","Total",836,377,125,252,459,55,74,98,112,18,29,73
"2011","Bury 009C","E01004962","Total",708,203,61,142,505,46,58,124,168,13,26,70
"2011","Bury 009D","E01004964","Total",832,298,75,223,534,61,58,111,187,16,31,70
"2011","Bury 010A","E01004949","Total",596,117,70,47,479,15,142,108,101,12,30,71
"2011","Bury 010B","E01004950","Total",612,122,77,45,490,14,142,93,109,15,33,84
"2011","Bury 010C","E01004951","Total",653,152,100,52,501,15,147,83,126,11,34,85
"2011","Bury 010D","E01004952","Total",619,143,98,45,476,6,198,49,105,7,22,89
"2011","Bury 010E","E01004953","Total",628,175,114,61,453,21,83,90,121,15,40,83
"2011","Bury 011A","E01005025","Total",685,248,98,150,437,22,65,78,139,15,23,95
"2011","Bury 011B","E01005027","Total",732,285,82,203,447,32,40,70,139,23,68,75
"2011","Bury 011C","E01005028","Total",803,310,107,203,493,59,55,107,135,32,47,58
"2011","Bury 011D","E01005029","Total",660,176,74,102,484,35,66,82,115,37,75,74
"2011","Bury 012A","E01005000","Total",574,108,42,66,466,34,59,113,110,12,41,97
"2011","Bury 012B","E01005001","Total",493,60,11,49,433,24,36,104,133,11,37,88
"2011","Bury 012C","E01005005","Total",632,203,105,98,429,23,107,86,116,11,17,69
"2011","Bury 012D","E01005006","Total",647,174,96,78,473,35,101,71,127,15,27,97
"2011","Bury 013A","E01005030","Total",733,307,94,213,426,43,74,70,117,19,41,62
"2011","Bury 013B","E01005054","Total",641,176,63,113,465,22,91,96,116,11,27,102
"2011","Bury 013C","E01005059","Total",733,256,90,166,477,32,70,93,147,21,40,74
"2011","Bury 013D","E01005060","Total",734,225,92,133,509,38,115,100,133,16,36,71
"2011","Bury 014A","E01004997","Total",594,148,58,90,446,43,68,92,111,13,40,79
"2011","Bury 014B","E01004998","Total",641,180,108,72,461,28,125,67,129,16,24,72
"2011","Bury 014C","E01004999","Total",596,142,54,88,454,31,61,103,137,13,45,64
"2011","Bury 014D","E01005002","Total",635,142,73,69,493,32,87,91,135,15,43,90
"2011","Bury 014E","E01005003","Total",654,232,86,146,422,42,62,99,116,19,27,57
"2011","Bury 015A","E01004991","Total",588,149,45,104,439,57,81,89,104,9,46,53
"2011","Bury 015B","E01004992","Total",637,207,58,149,430,42,52,91,128,22,29,66
"2011","Bury 015C","E01004993","Total",551,154,66,88,397,32,52,91,87,20,44,71
"2011","Bury 015D","E01004994","Total",614,249,63,186,365,59,27,81,119,15,19,45
"2011","Bury 016A","E01004990","Total",634,204,92,112,430,38,55,76,112,26,40,83
"2011","Bury 016B","E01004996","Total",731,324,75,249,407,63,68,81,117,11,18,49
"2011","Bury 016C","E01005004","Total",849,502,194,308,347,38,75,66,90,12,18,48
"2011","Bury 016D","E01005008","Total",875,343,86,257,532,92,46,112,171,18,33,60
"2011","Bury 016E","E01005009","Total",742,335,62,273,407,57,42,70,145,16,32,45
"2011","Bury 017A","E01004945","Total",658,164,110,54,494,17,154,88,97,17,33,88
"2011","Bury 017B","E01005055","Total",584,122,82,40,462,10,109,82,104,27,28,102
"2011","Bury 017C","E01005056","Total",604,221,111,110,383,15,122,49,95,11,15,76
"2011","Bury 017D","E01005057","Total",630,168,68,100,462,50,63,130,99,12,30,78
"2011","Bury 017E","E01005058","Total",505,104,73,31,401,6,109,80,60,15,33,98
"2011","Bury 018A","E01004995","Total",640,134,75,59,506,21,127,75,150,13,39,81
"2011","Bury 018B","E01005010","Total",660,153,48,105,507,42,58,125,155,16,29,82
"2011","Bury 018C","E01005012","Total",755,267,71,196,488,70,58,93,132,17,52,66
"2011","Bury 018D","E01005013","Total",956,283,73,210,673,102,49,168,160,39,57,98
"2011","Bury 019A","E01004984","Total",573,177,108,69,396,6,111,85,72,20,35,67
"2011","Bury 019B","E01004985","Total",577,114,70,44,463,10,127,84,104,12,33,93
"2011","Bury 019C","E01004989","Total",567,140,62,78,427,17,83,81,106,18,42,80
"2011","Bury 019D","E01005007","Total",710,274,139,135,436,24,116,74,124,4,25,69
"2011","Bury 019E","E01005011","Total",589,172,80,92,417,32,74,90,104,14,22,81
"2011","Bury 020A","E01004983","Total",545,149,40,109,396,25,45,81,125,10,33,77
"2011","Bury 020B","E01004986","Total",806,318,138,180,488,60,84,85,159,13,26,61
"2011","Bury 020C","E01004987","Total",649,346,172,174,303,29,74,59,69,9,17,46
"2011","Bury 020D","E01004988","Total",637,187,77,110,450,40,84,72,142,17,31,64
"2011","Bury 021A","E01004941","Total",726,222,95,127,504,56,69,111,98,19,58,93
"2011","Bury 021B","E01004942","Total",639,232,73,159,407,77,51,87,79,28,39,46
"2011","Bury 021C","E01004943","Total",650,169,53,116,481,56,57,97,124,31,40,76
"2011","Bury 021D","E01004944","Total",630,130,54,76,500,27,86,126,122,12,35,92
"2011","Bury 021E","E01004946","Total",798,365,163,202,433,74,82,84,81,14,27,71
"2011","Bury 022A","E01004969","Total",705,327,108,219,378,21,74,62,109,12,31,69
"2011","Bury 022B","E01004970","Total",605,130,76,54,475,19,102,82,100,18,52,102
"2011","Bury 022C","E01004971","Total",598,125,63,62,473,16,112,79,104,21,42,99
"2011","Bury 022D","E01005034","Total",640,226,97,129,414,22,76,95,115,10,20,76
"2011","Bury 023A","E01004972","Total",573,159,58,101,414,45,46,81,87,26,41,88
"2011","Bury 023B","E01004973","Total",658,198,77,121,460,28,71,76,134,16,35,100
"2011","Bury 023C","E01004975","Total",757,318,124,194,439,47,47,93,164,8,17,63
"2011","Bury 023D","E01005039","Total",699,274,124,150,425,55,65,57,142,19,32,55
"2011","Bury 023E","E01005045","Total",682,210,87,123,472,41,62,98,138,17,40,76
"2011","Bury 024A","E01004974","Total",603,183,83,100,420,23,65,68,124,16,32,92
"2011","Bury 024B","E01005033","Total",614,182,57,125,432,20,87,75,100,35,41,74
"2011","Bury 024C","E01005036","Total",1030,565,193,372,465,33,88,77,174,9,24,60
"2011","Bury 024D","E01005037","Total",628,205,82,123,423,27,80,78,114,12,31,81
"2011","Bury 025A","E01005031","Total",627,198,71,127,429,46,60,86,119,16,29,73
"2011","Bury 025B","E01005032","Total",523,222,67,155,301,47,56,48,79,11,15,45
"2011","Bury 025C","E01005035","Total",626,203,72,131,423,26,64,101,135,10,25,62
"2011","Bury 025D","E01005038","Total",531,113,47,66,418,17,64,99,113,20,30,75
"2011","Bury 026A","E01005040","Total",696,195,67,128,501,21,66,114,123,30,51,96
"2011","Bury 026B","E01005041","Total",519,99,56,43,420,14,66,75,67,45,65,88
"2011","Bury 026C","E01005042","Total",608,138,65,73,470,21,80,90,74,66,52,87
"2011","Bury 026D","E01005043","Total",496,70,43,27,426,4,63,56,60,112,65,66
"2011","Bury 026E","E01005044","Total",471,106,34,72,365,9,28,51,43,130,44,60
"2011","Manchester 001A","E01005098","Total",777,372,128,244,405,72,69,52,104,16,34,58
"2011","Manchester 001B","E01005099","Total",726,194,67,127,532,144,59,96,85,19,45,84
"2011","Manchester 001C","E01005100","Total",658,198,84,114,460,62,73,65,110,28,33,89
"2011","Manchester 001D","E01005102","Total",626,210,72,138,416,49,70,78,113,9,19,78
"2011","Manchester 001E","E01005103","Total",835,380,197,183,455,82,78,74,110,11,28,72
"2011","Manchester 002A","E01005101","Total",723,235,94,141,488,73,58,95,110,18,45,89
"2011","Manchester 002B","E01005135","Total",624,158,51,107,466,80,57,77,83,21,52,96
"2011","Manchester 002C","E01005136","Total",637,222,84,138,415,35,65,55,100,17,31,112
"2011","Manchester 002D","E01005138","Total",787,314,101,213,473,124,50,80,74,32,31,82
"2011","Manchester 002E","E01005140","Total",1185,409,99,310,776,120,78,144,189,42,60,143
"2011","Manchester 003B","E01005139","Total",714,209,83,126,505,62,65,104,122,21,42,89
"2011","Manchester 003C","E01005141","Total",805,358,111,247,447,72,57,79,85,22,38,94
"2011","Manchester 003D","E01005251","Total",633,172,63,109,461,82,49,91,91,17,50,81
"2011","Manchester 003E","E01005252","Total",763,233,122,111,530,60,89,88,119,24,48,102
"2011","Manchester 003F","E01033685","Total",652,224,61,163,428,62,33,112,100,16,39,66
"2011","Manchester 003G","E01033687","Total",802,443,132,311,359,49,45,68,116,7,28,46
"2011","Manchester 004A","E01005104","Total",842,356,75,281,486,105,39,87,143,27,31,54
"2011","Manchester 004B","E01005160","Total",721,256,103,153,465,27,74,92,109,32,49,82
"2011","Manchester 004C","E01005161","Total",657,196,53,143,461,55,73,103,122,22,36,50
"2011","Manchester 004D","E01005162","Total",679,274,127,147,405,22,70,63,77,27,58,88
"2011","Manchester 004E","E01005163","Total",661,221,90,131,440,27,75,80,91,35,45,87
"2011","Manchester 005A","E01005247","Total",627,211,91,120,416,26,71,73,101,9,33,103
"2011","Manchester 005B","E01005248","Total",573,144,59,85,429,15,101,57,107,9,27,113
"2011","Manchester 005C","E01005249","Total",777,280,74,206,497,45,53,98,154,13,43,91
"2011","Manchester 005D","E01005250","Total",750,215,90,125,535,100,81,88,117,20,34,95
"2011","Manchester 005E","E01005253","Total",639,165,87,78,474,78,69,83,105,20,37,82
"2011","Manchester 005F","E01005254","Total",683,195,71,124,488,32,69,98,144,7,49,89
"2011","Manchester 006A","E01005164","Total",694,313,58,255,381,48,30,80,93,22,42,66
"2011","Manchester 006B","E01005205","Total",937,396,158,238,541,103,54,104,143,19,39,79
"2011","Manchester 006C","E01005206","Total",747,279,68,211,468,71,53,90,134,14,35,71
"2011","Manchester 006D","E01005207","Total",817,255,70,185,562,79,49,89,149,26,33,137
"2011","Manchester 007A","E01005223","Total",549,198,48,150,351,42,58,55,86,11,37,62
"2011","Manchester 007B","E01005224","Total",715,204,50,154,511,99,30,105,117,30,57,73
"2011","Manchester 007C","E01005225","Total",837,304,123,181,533,77,96,90,113,22,36,99
"2011","Manchester 007D","E01005226","Total",683,218,63,155,465,72,51,99,122,13,32,76
"2011","Manchester 007E","E01005229","Total",609,136,80,56,473,32,86,84,104,8,31,128
"2011","Manchester 008A","E01005145","Total",801,166,31,135,635,39,44,129,94,88,117,124
"2011","Manchester 008B","E01005146","Total",852,254,74,180,598,45,63,127,140,55,78,90
"2011","Manchester 008C","E01005149","Total",474,72,22,50,402,26,41,59,44,42,99,91
"2011","Manchester 008D","E01005165","Total",976,511,149,362,465,59,31,102,132,27,52,62
"2011","Manchester 008E","E01005166","Total",716,292,97,195,424,35,40,67,87,45,71,79
"2011","Manchester 008F","E01005167","Total",565,119,26,93,446,38,23,75,73,52,109,76
"2011","Manchester 009A","E01005202","Total",783,292,60,232,491,133,49,85,95,19,34,76
"2011","Manchester 009B","E01005203","Total",927,454,109,345,473,111,39,81,106,19,46,71
"2011","Manchester 009D","E01005227","Total",698,235,80,155,463,90,37,86,100,21,42,87
"2011","Manchester 009E","E01005228","Total",755,313,97,216,442,93,45,98,84,22,44,56
"2011","Manchester 009F","E01033678","Total",688,291,52,239,397,80,38,71,83,25,47,53
"2011","Manchester 009G","E01033679","Total",643,319,87,232,324,73,22,47,63,22,36,61
"2011","Manchester 011A","E01005256","Total",854,279,80,199,575,112,63,102,151,21,43,83
"2011","Manchester 011B","E01005257","Total",820,324,86,238,496,120,48,71,115,26,32,84
"2011","Manchester 011C","E01005258","Total",781,323,113,210,458,70,63,71,116,21,25,92
"2011","Manchester 011D","E01005259","Total",782,327,85,242,455,106,56,67,120,21,20,65
"2011","Manchester 011E","E01005260","Total",592,175,61,114,417,23,64,76,103,15,45,91
"2011","Manchester 012A","E01005093","Total",678,199,79,120,479,95,66,85,85,33,37,78
"2011","Manchester 012B","E01005094","Total",660,253,101,152,407,74,48,74,106,18,40,47
"2011","Manchester 012C","E01005097","Total",650,180,59,121,470,100,56,60,89,37,51,77
"2011","Manchester 012D","E01005255","Total",824,419,116,303,405,87,62,76,73,15,37,55
"2011","Manchester 012E","E01005261","Total",651,200,75,125,451,112,41,70,75,25,47,81
"2011","Manchester 013B","E01005129","Total",709,340,71,269,369,83,30,50,104,22,35,45
"2011","Manchester 013C","E01005132","Total",661,244,69,175,417,88,39,86,98,22,35,49
"2011","Manchester 013D","E01005133","Total",596,248,91,157,348,43,40,31,125,6,22,81
"2011","Manchester 013E","E01033663","Total",712,349,22,327,363,12,10,25,265,0,7,44
"2011","Manchester 013F","E01033684","Total",649,166,0,166,483,4,1,17,413,0,1,47
"2011","Manchester 013G","E01033688","Total",691,302,89,213,389,64,46,63,97,15,39,65
"2011","Manchester 015A","E01005092","Total",720,280,108,172,440,91,39,92,89,24,32,73
"2011","Manchester 015C","E01005105","Total",809,246,42,204,563,94,32,93,162,29,49,104
"2011","Manchester 015D","E01005106","Total",825,331,92,239,494,93,55,89,104,22,48,83
"2011","Manchester 015E","E01005107","Total",740,264,68,196,476,106,37,88,97,33,53,62
"2011","Manchester 015F","E01033668","Total",598,245,21,224,353,38,11,61,199,3,12,29
"2011","Manchester 015G","E01033669","Total",677,301,72,229,376,63,38,66,106,15,33,55
"2011","Manchester 017A","E01005108","Total",1053,331,104,227,722,182,69,97,137,50,70,117
"2011","Manchester 017D","E01005189","Total",826,390,147,243,436,93,65,71,94,16,28,69
"2011","Manchester 017E","E01005190","Total",881,314,103,211,567,110,63,111,124,27,45,87
"2011","Manchester 017F","E01033666","Total",1103,413,151,262,690,83,94,113,144,41,69,146
"2011","Manchester 018A","E01005061","Total",743,352,77,275,391,77,30,79,75,28,49,53
"2011","Manchester 018B","E01005062","Total",772,268,66,202,504,51,33,93,131,34,36,126
"2011","Manchester 018C","E01005063","Total",614,224,49,175,390,73,42,71,83,17,46,58
"2011","Manchester 018D","E01005065","Total",916,349,81,268,567,87,37,136,126,40,39,102
"2011","Manchester 018E","E01005066","Total",501,280,26,254,221,26,7,29,73,13,29,44
"2011","Manchester 019A","E01005208","Total",1110,371,40,331,739,73,20,115,372,22,28,109
"2011","Manchester 019B","E01005209","Total",868,382,55,327,486,48,28,70,204,15,33,88
"2011","Manchester 019C","E01005210","Total",638,322,48,274,316,25,20,38,133,14,19,67
"2011","Manchester 019D","E01005214","Total",1013,315,14,301,698,52,12,100,325,23,20,166
"2011","Manchester 020A","E01005067","Total",587,240,77,163,347,70,41,54,67,19,46,50
"2011","Manchester 020B","E01005186","Total",945,316,75,241,629,91,46,123,169,47,53,100
"2011","Manchester 020C","E01005232","Total",713,248,83,165,465,35,36,107,103,45,53,86
"2011","Manchester 020D","E01005235","Total",719,268,68,200,451,59,55,98,79,34,55,71
"2011","Manchester 020E","E01005239","Total",660,247,61,186,413,88,24,85,59,46,53,58
"2011","Manchester 021A","E01005187","Total",787,261,58,203,526,108,36,94,122,37,42,87
"2011","Manchester 021B","E01005188","Total",703,210,82,128,493,63,69,87,113,19,48,94
"2011","Manchester 021C","E01005191","Total",800,334,97,237,466,108,54,97,99,16,24,68
"2011","Manchester 021D","E01005192","Total",679,237,71,166,442,48,52,79,108,17,50,88
"2011","Manchester 021E","E01005193","Total",818,301,90,211,517,81,47,101,155,18,38,77
"2011","Manchester 022B","E01005230","Total",819,363,49,314,456,21,19,51,154,20,55,136
"2011","Manchester 022C","E01005231","Total",633,175,27,148,458,6,10,33,128,9,24,248
"2011","Manchester 022D","E01005236","Total",702,205,43,162,497,38,22,79,93,31,46,188
"2011","Manchester 022E","E01005237","Total",533,116,30,86,417,16,17,54,66,40,125,99
"2011","Manchester 022F","E01033652","Total",411,143,26,117,268,19,10,33,101,10,28,67
"2011","Manchester 022G","E01033657","Total",435,193,39,154,242,22,17,29,66,9,17,82
"2011","Manchester 023A","E01005195","Total",735,193,76,117,542,96,52,97,97,33,78,89
"2011","Manchester 023B","E01005196","Total",894,271,72,199,623,134,51,152,88,46,82,70
"2011","Manchester 023C","E01005197","Total",697,294,107,187,403,66,48,67,90,23,35,74
"2011","Manchester 023D","E01005198","Total",649,266,91,175,383,70,29,66,74,31,41,72
"2011","Manchester 023E","E01005201","Total",816,252,51,201,564,130,33,124,137,36,48,56
"2011","Manchester 024A","E01005240","Total",1003,308,59,249,695,139,45,126,148,61,78,98
"2011","Manchester 024B","E01005243","Total",1084,459,125,334,625,123,51,104,161,54,55,77
"2011","Manchester 024C","E01005245","Total",871,302,131,171,569,122,52,93,69,55,82,96
"2011","Manchester 024D","E01005246","Total",738,223,61,162,515,119,35,87,68,64,71,71
"2011","Manchester 025A","E01005241","Total",1009,299,64,235,710,86,46,145,207,32,27,167
"2011","Manchester 025B","E01005242","Total",1008,292,69,223,716,156,29,144,149,45,35,158
"2011","Manchester 025C","E01005244","Total",926,303,67,236,623,51,40,73,135,25,43,256
"2011","Manchester 025D","E01005285","Total",476,167,39,128,309,19,26,44,69,27,37,87
"2011","Manchester 025E","E01005288","Total",640,184,39,145,456,29,21,44,102,26,26,208
"2011","Manchester 026A","E01005280","Total",528,100,41,59,428,33,36,35,51,49,114,110
"2011","Manchester 026B","E01005281","Total",542,291,81,210,251,3,23,15,134,2,6,68
"2011","Manchester 026C","E01005284","Total",834,384,32,352,450,6,10,56,162,9,16,191
"2011","Manchester 026D","E01005286","Total",738,207,37,170,531,8,21,57,184,11,30,220
"2011","Manchester 026E","E01005287","Total",652,187,50,137,465,30,45,53,66,55,91,125
"2011","Manchester 027A","E01005194","Total",940,293,61,232,647,73,46,133,128,63,85,119
"2011","Manchester 027B","E01005199","Total",895,269,59,210,626,85,34,130,166,57,46,108
"2011","Manchester 027C","E01005200","Total",764,271,77,194,493,63,34,99,136,30,48,83
"2011","Manchester 027D","E01005233","Total",770,186,32,154,584,76,33,122,98,64,94,97
"2011","Manchester 027E","E01005234","Total",633,176,51,125,457,47,20,69,60,54,95,112
"2011","Manchester 027F","E01005238","Total",564,96,23,73,468,30,20,75,66,62,105,110
"2011","Manchester 028A","E01005297","Total",916,337,47,290,579,59,33,116,145,34,83,109
"2011","Manchester 028B","E01005298","Total",641,158,33,125,483,34,32,80,132,44,63,98
"2011","Manchester 028C","E01005302","Total",930,444,60,384,486,39,25,79,222,15,26,80
"2011","Manchester 028E","E01033680","Total",646,312,31,281,334,24,7,43,190,7,8,55
"2011","Manchester 028F","E01033686","Total",608,295,50,245,313,23,28,71,112,11,15,53
"2011","Manchester 029A","E01005150","Total",930,443,57,386,487,18,21,42,253,12,16,125
"2011","Manchester 029B","E01005151","Total",717,335,100,235,382,11,40,71,166,16,19,59
"2011","Manchester 029C","E01005152","Total",600,157,51,106,443,16,32,115,165,13,23,79
"2011","Manchester 029D","E01005159","Total",621,135,22,113,486,12,49,95,164,16,32,118
"2011","Manchester 029E","E01005296","Total",614,156,62,94,458,9,47,62,131,42,49,118
"2011","Manchester 029F","E01005299","Total",533,110,44,66,423,15,46,66,97,22,71,106
"2011","Manchester 030A","E01005178","Total",742,195,58,137,547,41,55,74,150,30,62,135
"2011","Manchester 030B","E01005179","Total",953,416,52,364,537,38,28,82,199,25,64,101
"2011","Manchester 030C","E01005180","Total",782,272,95,177,510,89,66,85,108,12,50,100
"2011","Manchester 030D","E01005181","Total",683,182,37,145,501,32,46,95,107,35,79,107
"2011","Manchester 030E","E01005182","Total",469,95,38,57,374,41,39,60,52,34,77,71
"2011","Manchester 030F","E01005183","Total",670,205,80,125,465,46,66,69,99,27,63,95
"2011","Manchester 031A","E01005219","Total",916,431,45,386,485,43,21,82,156,19,66,98
"2011","Manchester 031B","E01005220","Total",728,226,44,182,502,48,39,106,138,37,51,83
"2011","Manchester 031C","E01005221","Total",779,203,37,166,576,43,33,100,134,60,72,134
"2011","Manchester 031D","E01005222","Total",897,330,80,250,567,87,39,123,148,37,43,90
"2011","Manchester 032A","E01005184","Total",779,237,63,174,542,15,33,66,148,13,23,244
"2011","Manchester 032B","E01005185","Total",534,106,22,84,428,4,9,17,103,2,7,286
"2011","Manchester 032C","E01005271","Total",694,231,44,187,463,13,17,40,141,1,8,243
"2011","Manchester 032D","E01005282","Total",550,86,29,57,464,33,42,52,86,35,74,142
"2011","Manchester 032E","E01005283","Total",408,44,14,30,364,10,8,10,63,2,9,262
"2011","Manchester 033A","E01005154","Total",669,204,34,170,465,10,18,84,190,15,31,117
"2011","Manchester 033B","E01005156","Total",635,164,35,129,471,20,45,94,194,18,16,84
"2011","Manchester 033C","E01005158","Total",711,264,94,170,447,41,41,90,170,9,18,78
"2011","Manchester 033D","E01005300","Total",490,110,60,50,380,10,51,49,57,26,80,107
"2011","Manchester 033E","E01005301","Total",612,197,41,156,415,10,42,77,115,25,59,87
"2011","Manchester 034A","E01005118","Total",497,95,59,36,402,11,65,73,70,27,60,96
"2011","Manchester 034B","E01005120","Total",661,170,81,89,491,47,72,78,97,48,66,83
"2011","Manchester 034C","E01005215","Total",756,225,61,164,531,51,61,108,108,44,61,98
"2011","Manchester 034D","E01005216","Total",611,185,50,135,426,25,46,85,126,25,44,75
"2011","Manchester 034E","E01005217","Total",678,161,81,80,517,29,72,85,123,32,64,112
"2011","Manchester 034F","E01005218","Total",632,219,104,115,413,8,62,42,86,20,50,145
"2011","Manchester 035A","E01005270","Total",675,171,53,118,504,64,55,86,108,19,46,126
"2011","Manchester 035B","E01005272","Total",755,263,132,131,492,106,45,81,98,25,44,93
"2011","Manchester 035C","E01005273","Total",553,167,43,124,386,25,18,28,117,2,9,187
"2011","Manchester 035D","E01005278","Total",541,95,42,53,446,15,50,40,35,25,43,238
"2011","Manchester 035E","E01005279","Total",817,220,69,151,597,65,62,123,168,27,46,106
"2011","Manchester 036A","E01005305","Total",592,125,50,75,467,16,43,55,91,22,44,196
"2011","Manchester 036B","E01005309","Total",963,388,82,306,575,5,17,17,285,1,11,239
"2011","Manchester 036C","E01005310","Total",579,125,45,80,454,48,21,33,57,7,19,269
"2011","Manchester 036D","E01005311","Total",615,133,40,93,482,19,37,41,140,16,24,205
"2011","Manchester 036E","E01005312","Total",618,218,69,149,400,13,35,14,111,0,10,217
"2011","Manchester 037A","E01005082","Total",659,212,80,132,447,53,50,84,134,13,42,71
"2011","Manchester 037B","E01005153","Total",820,307,90,217,513,38,40,96,246,11,16,66
"2011","Manchester 037C","E01005155","Total",683,234,70,164,449,18,35,99,221,9,14,53
"2011","Manchester 037D","E01005157","Total",614,140,64,76,474,20,51,124,141,23,35,80
"2011","Manchester 038A","E01005274","Total",682,175,61,114,507,44,43,53,144,15,29,179
"2011","Manchester 038B","E01005275","Total",818,364,41,323,454,13,14,49,250,5,11,112
"2011","Manchester 038C","E01005276","Total",643,199,32,167,444,30,15,50,211,6,10,122
"2011","Manchester 038D","E01005277","Total",778,242,34,208,536,12,48,88,246,13,25,104
"2011","Manchester 039A","E01005076","Total",782,360,39,321,422,16,10,51,272,4,7,62
"2011","Manchester 039C","E01005081","Total",784,320,76,244,464,91,37,94,103,16,52,71
"2011","Manchester 039D","E01005083","Total",888,440,21,419,448,9,14,67,238,10,15,95
"2011","Manchester 039E","E01033670","Total",655,249,7,242,406,13,4,52,272,8,6,51
"2011","Manchester 039F","E01033671","Total",793,284,29,255,509,13,24,61,270,5,12,124
"2011","Manchester 040A","E01005125","Total",635,187,59,128,448,54,50,71,111,23,58,81
"2011","Manchester 040B","E01005304","Total",657,198,57,141,459,12,25,46,163,11,14,188
"2011","Manchester 040C","E01005306","Total",687,236,92,144,451,10,69,89,154,15,29,85
"2011","Manchester 040D","E01005307","Total",721,170,76,94,551,7,55,62,164,16,28,219
"2011","Manchester 040E","E01005308","Total",625,131,53,78,494,51,56,72,114,22,46,133
"2011","Manchester 041A","E01005119","Total",629,202,81,121,427,64,57,81,85,19,45,76
"2011","Manchester 041B","E01005121","Total",599,169,57,112,430,81,38,64,79,31,47,90
"2011","Manchester 041C","E01005122","Total",641,168,59,109,473,66,69,79,98,23,52,86
"2011","Manchester 041D","E01005123","Total",622,147,57,90,475,80,41,72,101,29,54,98
"2011","Manchester 041E","E01005124","Total",686,167,52,115,519,87,50,97,128,9,61,87
"2011","Manchester 042A","E01005077","Total",630,187,49,138,443,103,39,80,93,23,42,63
"2011","Manchester 042B","E01005078","Total",824,432,97,335,392,9,22,55,252,3,8,43
"2011","Manchester 042C","E01005079","Total",628,187,80,107,441,37,52,85,129,20,41,77
"2011","Manchester 042D","E01005084","Total",867,270,91,179,597,58,63,106,194,22,37,117
"2011","Manchester 043A","E01005172","Total",803,352,115,237,451,8,57,64,217,20,26,59
"2011","Manchester 043B","E01005173","Total",703,247,92,155,456,10,63,80,190,18,19,76
"2011","Manchester 043C","E01005174","Total",624,183,60,123,441,10,62,102,112,23,35,97
"2011","Manchester 043D","E01005175","Total",693,206,77,129,487,17,65,118,157,16,25,89
"2011","Manchester 043E","E01005176","Total",936,332,66,266,604,19,30,82,374,9,6,84
"2011","Manchester 043F","E01005177","Total",643,230,103,127,413,16,65,89,159,6,12,66
"2011","Manchester 044A","E01005115","Total",785,196,62,134,589,73,99,132,151,13,37,84
"2011","Manchester 044B","E01005262","Total",861,332,68,264,529,75,44,132,165,17,27,69
"2011","Manchester 044C","E01005264","Total",617,196,79,117,421,59,49,74,104,22,39,74
"2011","Manchester 044D","E01005265","Total",682,190,65,125,492,71,53,93,130,20,44,81
"2011","Manchester 044E","E01005266","Total",835,264,117,147,571,89,71,115,149,25,38,84
"2011","Manchester 045A","E01005126","Total",819,236,96,140,583,33,82,94,175,24,48,127
"2011","Manchester 045B","E01005168","Total",522,129,60,69,393,18,50,96,90,20,44,75
"2011","Manchester 045C","E01005169","Total",487,135,55,80,352,5,61,66,93,13,34,80
"2011","Manchester 045D","E01005170","Total",584,138,69,69,446,24,75,89,111,31,36,80
"2011","Manchester 045E","E01005171","Total",711,217,77,140,494,18,64,72,169,14,46,111
"2011","Manchester 046A","E01005263","Total",825,402,128,274,423,36,50,80,144,11,24,78
"2011","Manchester 046B","E01005267","Total",664,193,95,98,471,26,82,87,130,12,29,105
"2011","Manchester 046C","E01005268","Total",994,362,148,214,632,24,85,117,267,6,17,116
"2011","Manchester 046D","E01005269","Total",617,188,93,95,429,15,82,76,101,19,37,99
"2011","Manchester 047A","E01005069","Total",641,190,51,139,451,18,68,94,159,9,33,70
"2011","Manchester 047B","E01005111","Total",622,205,90,115,417,55,82,85,86,10,26,73
"2011","Manchester 047C","E01005113","Total",830,437,114,323,393,62,45,81,107,15,29,54
"2011","Manchester 047D","E01005114","Total",810,279,143,136,531,14,154,89,131,15,38,90
"2011","Manchester 047E","E01005116","Total",973,386,118,268,587,55,66,123,221,8,35,79
"2011","Manchester 048A","E01005071","Total",684,247,104,143,437,58,42,102,105,18,33,79
"2011","Manchester 048B","E01005072","Total",811,356,99,257,455,69,42,110,126,17,29,62
"2011","Manchester 048C","E01005073","Total",615,178,68,110,437,21,84,90,103,14,37,88
"2011","Manchester 048D","E01005112","Total",676,187,69,118,489,66,77,93,108,23,44,78
"2011","Manchester 048E","E01005117","Total",938,389,82,307,549,103,54,131,120,31,40,70
"2011","Manchester 049A","E01005085","Total",599,155,39,116,444,79,34,85,105,31,40,70
"2011","Manchester 049B","E01005086","Total",715,197,59,138,518,90,52,107,108,32,48,81
"2011","Manchester 049C","E01005089","Total",699,200,75,125,499,89,43,107,88,36,46,90
"2011","Manchester 049D","E01005289","Total",641,240,80,160,401,75,42,73,88,20,26,77
"2011","Manchester 049E","E01005295","Total",1124,424,46,378,700,69,40,165,277,18,38,93
"2011","Manchester 050A","E01005087","Total",792,171,38,133,621,136,50,134,125,28,51,97
"2011","Manchester 050B","E01005088","Total",687,198,63,135,489,110,47,92,92,35,33,80
"2011","Manchester 050C","E01005090","Total",745,322,124,198,423,89,53,66,84,23,27,81
"2011","Manchester 050D","E01005091","Total",867,255,65,190,612,126,49,130,126,29,52,100
"2011","Manchester 050E","E01005291","Total",714,341,151,190,373,59,37,70,82,18,27,80
"2011","Manchester 051A","E01005068","Total",704,273,112,161,431,86,41,86,93,11,34,80
"2011","Manchester 051B","E01005070","Total",740,276,76,200,464,74,59,108,110,15,35,63
"2011","Manchester 051C","E01005074","Total",644,227,70,157,417,44,46,92,88,28,38,81
"2011","Manchester 051D","E01005075","Total",612,229,90,139,383,45,47,95,83,17,29,67
"2011","Manchester 051E","E01005319","Total",880,260,75,185,620,100,85,121,136,22,43,113
"2011","Manchester 052A","E01005290","Total",675,225,72,153,450,79,53,72,122,16,38,70
"2011","Manchester 052B","E01005292","Total",696,267,92,175,429,80,48,71,124,10,33,63
"2011","Manchester 052C","E01005293","Total",521,128,35,93,393,44,51,76,124,13,22,63
"2011","Manchester 052D","E01005294","Total",645,204,87,117,441,26,92,63,111,14,34,101
"2011","Manchester 052E","E01005317","Total",774,316,92,224,458,58,69,77,129,15,36,74
"2011","Manchester 053A","E01005313","Total",618,195,72,123,423,65,53,57,95,19,36,98
"2011","Manchester 053B","E01005314","Total",635,194,76,118,441,56,59,69,93,20,43,101
"2011","Manchester 053C","E01005315","Total",715,304,99,205,411,62,54,84,106,12,33,60
"2011","Manchester 053D","E01005316","Total",702,236,44,192,466,47,51,96,126,15,25,106
"2011","Manchester 053E","E01005318","Total",782,249,86,163,533,87,53,116,141,13,35,88
"2011","Manchester 054A","E01005130","Total",767,396,54,342,371,75,37,63,108,8,24,56
"2011","Manchester 054B","E01033651","Total",630,211,6,205,419,5,6,26,329,1,5,47
"2011","Manchester 054C","E01033658","Total",711,392,7,385,319,7,11,21,253,0,2,25
"2011","Manchester 054D","E01033664","Total",607,228,1,227,379,5,3,16,325,0,1,29
"2011","Manchester 054E","E01033667","Total",653,364,25,339,289,4,5,13,240,0,1,26
"2011","Manchester 055A","E01005128","Total",766,302,5,297,464,7,1,18,396,0,0,42
"2011","Manchester 055B","E01033653","Total",1036,506,115,391,530,2,38,23,409,0,1,57
"2011","Manchester 055C","E01033654","Total",617,241,8,233,376,1,3,8,314,1,0,49
"2011","Manchester 055D","E01033659","Total",760,263,3,260,497,6,2,20,422,0,2,45
"2011","Manchester 055E","E01033661","Total",706,340,87,253,366,2,13,10,278,0,2,61
"2011","Manchester 056A","E01005143","Total",792,201,50,151,591,44,36,113,81,84,100,133
"2011","Manchester 056B","E01033655","Total",694,255,1,254,439,2,0,23,388,0,4,22
"2011","Manchester 056C","E01033665","Total",723,337,34,303,386,7,19,20,298,6,6,30
"2011","Manchester 056D","E01033676","Total",730,332,92,240,398,70,38,59,80,33,54,64
"2011","Manchester 057A","E01005212","Total",696,344,52,292,352,46,6,54,172,7,9,58
"2011","Manchester 057B","E01033656","Total",761,328,1,327,433,5,0,6,313,0,4,105
"2011","Manchester 057C","E01033662","Total",842,415,8,407,427,3,1,12,368,0,0,43
"2011","Manchester 058A","E01005142","Total",729,292,48,244,437,57,34,96,57,56,63,74
"2011","Manchester 058B","E01005147","Total",914,278,56,222,636,97,40,143,112,74,83,87
"2011","Manchester 058C","E01033674","Total",647,214,11,203,433,37,12,46,237,15,31,55
"2011","Manchester 058D","E01033675","Total",757,159,34,125,598,117,35,133,133,37,61,82
"2011","Manchester 059A","E01005213","Total",1178,597,89,508,581,81,23,76,272,19,30,80
"2011","Manchester 059B","E01033660","Total",698,258,0,258,440,1,0,14,410,0,0,15
"2011","Manchester 059C","E01033672","Total",725,377,53,324,348,60,19,45,174,13,9,28
"2011","Manchester 059D","E01033673","Total",673,278,2,276,395,1,1,10,363,0,0,20
"2011","Manchester 060A","E01033677","Total",699,301,10,291,398,3,3,20,328,0,0,44
"2011","Manchester 060B","E01033681","Total",844,363,7,356,481,6,7,20,431,0,2,15
"2011","Manchester 060C","E01033682","Total",797,378,22,356,419,1,8,16,371,0,0,23
"2011","Manchester 060D","E01033683","Total",747,319,2,317,428,2,2,27,362,0,2,33
"2011","Oldham 001A","E01005357","Total",616,160,92,68,456,15,120,70,109,9,31,102
"2011","Oldham 001B","E01005358","Total",735,254,118,136,481,53,71,103,121,16,29,88
"2011","Oldham 001C","E01005359","Total",757,232,122,110,525,19,183,73,140,10,29,71
"2011","Oldham 001D","E01005360","Total",648,223,138,85,425,29,132,49,98,17,30,70
"2011","Oldham 002A","E01005441","Total",792,327,127,200,465,56,95,82,122,9,27,74
"2011","Oldham 002B","E01005442","Total",588,118,62,56,470,26,76,88,156,7,26,91
"2011","Oldham 002C","E01005444","Total",672,202,80,122,470,47,63,119,137,12,20,72
"2011","Oldham 002D","E01005445","Total",672,238,98,140,434,52,44,100,113,18,31,76
"2011","Oldham 003A","E01005361","Total",728,175,104,71,553,12,169,95,136,12,40,89
"2011","Oldham 003B","E01005443","Total",552,98,33,65,454,15,99,90,128,12,23,87
"2011","Oldham 003C","E01005446","Total",605,159,63,96,446,45,72,87,140,12,26,64
"2011","Oldham 003D","E01005447","Total",701,289,124,165,412,62,63,85,103,19,30,50
"2011","Oldham 004A","E01005390","Total",604,125,53,72,479,33,94,93,127,23,27,82
"2011","Oldham 004B","E01005394","Total",654,162,99,63,492,23,112,89,123,11,31,103
"2011","Oldham 004C","E01005395","Total",610,165,77,88,445,36,89,80,106,12,32,90
"2011","Oldham 004D","E01005396","Total",589,131,61,70,458,23,111,60,112,17,45,90
"2011","Oldham 005A","E01005355","Total",630,167,68,99,463,44,64,100,123,15,33,84
"2011","Oldham 005B","E01005356","Total",503,81,28,53,422,22,50,99,111,13,35,92
"2011","Oldham 005C","E01005399","Total",698,196,86,110,502,17,112,85,140,9,33,106
"2011","Oldham 005D","E01005403","Total",644,130,50,80,514,45,57,134,132,17,43,86
"2011","Oldham 006A","E01005410","Total",599,108,41,67,491,14,100,107,124,14,39,93
"2011","Oldham 006B","E01005411","Total",721,265,165,100,456,17,105,86,133,8,33,74
"2011","Oldham 006C","E01005414","Total",525,104,46,58,421,12,83,87,122,14,27,76
"2011","Oldham 006D","E01005415","Total",508,159,98,61,349,14,95,74,76,10,26,54
"2011","Oldham 007C","E01005452","Total",543,115,40,75,428,15,65,89,116,12,40,91
"2011","Oldham 007D","E01005453","Total",537,124,54,70,413,21,87,80,99,19,36,71
"2011","Oldham 007E","E01032558","Total",641,231,63,168,410,100,45,78,83,21,24,59
"2011","Oldham 007F","E01032559","Total",1005,222,60,162,783,70,50,271,165,36,75,116
"2011","Oldham 008A","E01005391","Total",651,176,83,93,475,22,82,93,117,21,36,104
"2011","Oldham 008B","E01005392","Total",767,369,188,181,398,44,75,62,105,9,31,72
"2011","Oldham 008C","E01005393","Total",524,132,74,58,392,19,107,51,96,11,26,82
"2011","Oldham 008D","E01005401","Total",689,181,100,81,508,27,122,105,111,14,46,83
"2011","Oldham 009A","E01005397","Total",637,197,95,102,440,31,88,81,111,15,28,86
"2011","Oldham 009B","E01005398","Total",656,204,98,106,452,31,88,93,117,14,31,78
"2011","Oldham 009C","E01005400","Total",753,317,157,160,436,51,95,54,125,16,24,71
"2011","Oldham 009D","E01005402","Total",622,187,85,102,435,32,62,107,108,15,35,76
"2011","Oldham 010A","E01005335","Total",540,124,64,60,416,16,99,66,110,8,26,91
"2011","Oldham 010B","E01005337","Total",655,157,54,103,498,37,56,87,110,77,75,56
"2011","Oldham 010C","E01005339","Total",589,129,97,32,460,10,128,87,99,11,39,86
"2011","Oldham 010D","E01005340","Total",606,227,101,126,379,54,59,67,74,20,40,65
"2011","Oldham 011A","E01005421","Total",735,247,67,180,488,100,47,105,123,22,21,70
"2011","Oldham 011B","E01005422","Total",533,105,32,73,428,115,30,83,62,29,49,60
"2011","Oldham 011E","E01032920","Total",880,340,121,219,540,80,84,89,155,19,41,72
"2011","Oldham 012A","E01005448","Total",781,407,148,259,374,93,39,66,97,17,23,39
"2011","Oldham 012B","E01005449","Total",578,242,125,117,336,49,55,52,81,11,26,62
"2011","Oldham 012C","E01005454","Total",569,130,52,78,439,36,56,85,115,13,38,96
"2011","Oldham 012D","E01005455","Total",619,144,40,104,475,39,50,123,117,13,47,86
"2011","Oldham 012E","E01005456","Total",785,345,94,251,440,74,56,84,128,17,29,52
"2011","Oldham 013A","E01005407","Total",724,160,67,93,564,17,124,121,178,9,29,86
"2011","Oldham 013B","E01005412","Total",784,234,110,124,550,27,111,103,194,12,29,74
"2011","Oldham 013C","E01005416","Total",599,165,61,104,434,20,70,101,156,9,18,60
"2011","Oldham 013D","E01005417","Total",635,152,73,79,483,29,115,75,148,1,21,94
"2011","Oldham 014A","E01005348","Total",625,225,96,129,400,43,46,77,76,47,53,58
"2011","Oldham 014B","E01005350","Total",989,591,208,383,398,40,58,41,98,40,55,66
"2011","Oldham 014C","E01005432","Total",648,252,99,153,396,77,53,61,92,24,38,51
"2011","Oldham 014D","E01005433","Total",666,271,63,208,395,89,35,58,99,25,40,49
"2011","Oldham 015A","E01005329","Total",616,142,42,100,474,23,62,100,140,8,37,104
"2011","Oldham 015B","E01005330","Total",626,135,71,64,491,19,76,97,141,11,33,114
"2011","Oldham 015C","E01005333","Total",499,111,52,59,388,8,69,60,100,9,29,113
"2011","Oldham 015D","E01005336","Total",630,147,103,44,483,13,116,94,94,15,48,103
"2011","Oldham 016A","E01005349","Total",538,66,21,45,472,32,11,59,33,113,161,63
"2011","Oldham 016B","E01005351","Total",467,78,35,43,389,19,14,54,46,90,115,51
"2011","Oldham 016C","E01005352","Total",461,144,29,115,317,23,36,38,61,50,62,47
"2011","Oldham 016D","E01005353","Total",657,281,52,229,376,23,34,51,63,37,116,52
"2011","Oldham 016E","E01005354","Total",541,113,36,77,428,34,29,82,96,37,88,62
"2011","Oldham 017A","E01005327","Total",757,226,100,126,531,43,100,118,120,25,38,87
"2011","Oldham 017B","E01005328","Total",696,364,170,194,332,29,59,56,80,19,28,61
"2011","Oldham 017C","E01005331","Total",635,178,84,94,457,43,79,80,114,23,41,77
"2011","Oldham 017D","E01005334","Total",541,82,28,54,459,15,52,144,105,16,47,80
"2011","Oldham 017E","E01005338","Total",752,282,166,116,470,54,92,67,112,57,40,48
"2011","Oldham 018A","E01005387","Total",631,188,70,118,443,29,68,102,130,7,29,78
"2011","Oldham 018B","E01005388","Total",596,193,99,94,403,39,80,69,106,8,27,74
"2011","Oldham 018C","E01005389","Total",727,268,93,175,459,85,53,80,117,16,42,66
"2011","Oldham 018D","E01005418","Total",585,124,72,52,461,22,80,84,115,15,50,95
"2011","Oldham 019A","E01005428","Total",532,130,33,97,402,38,23,92,53,50,87,59
"2011","Oldham 019B","E01005431","Total",717,244,95,149,473,55,54,115,122,27,29,71
"2011","Oldham 019C","E01005450","Total",627,185,74,111,442,57,40,88,97,49,55,56
"2011","Oldham 019D","E01005451","Total",482,109,40,69,373,21,43,67,108,28,51,55
"2011","Oldham 020C","E01005408","Total",794,233,116,117,561,29,116,108,179,23,27,79
"2011","Oldham 020D","E01005409","Total",664,136,71,65,528,20,102,121,145,18,38,84
"2011","Oldham 020E","E01032922","Total",1071,323,211,112,748,27,182,134,182,25,49,149
"2011","Oldham 021A","E01005406","Total",594,145,79,66,449,9,111,95,122,6,33,73
"2011","Oldham 021B","E01005413","Total",654,131,69,62,523,18,108,128,118,26,24,101
"2011","Oldham 021C","E01005419","Total",638,181,73,108,457,28,67,95,140,12,35,80
"2011","Oldham 021D","E01005420","Total",716,232,130,102,484,26,102,104,112,16,41,83
"2011","Oldham 022A","E01005321","Total",596,219,54,165,377,36,37,61,74,49,54,66
"2011","Oldham 022B","E01005326","Total",554,58,27,31,496,17,23,47,26,70,221,92
"2011","Oldham 022C","E01005427","Total",497,91,30,61,406,30,10,74,34,65,116,77
"2011","Oldham 022D","E01005429","Total",479,84,29,55,395,31,11,75,46,68,97,67
"2011","Oldham 022E","E01005430","Total",714,177,65,112,537,51,36,93,77,81,119,80
"2011","Oldham 024A","E01005320","Total",631,164,61,103,467,60,32,93,70,52,64,96
"2011","Oldham 024B","E01005434","Total",657,340,96,244,317,38,31,61,80,26,32,49
"2011","Oldham 024C","E01005437","Total",529,72,33,39,457,32,32,67,79,68,89,90
"2011","Oldham 024D","E01005459","Total",407,129,83,46,278,22,26,51,21,30,81,47
"2011","Oldham 026A","E01005383","Total",718,192,71,121,526,69,63,111,104,39,64,76
"2011","Oldham 026D","E01005386","Total",626,222,73,149,404,76,63,64,107,15,29,50
"2011","Oldham 026E","E01032556","Total",662,220,84,136,442,36,79,92,132,12,21,70
"2011","Oldham 026F","E01032557","Total",745,283,107,176,462,124,52,83,99,23,29,52
"2011","Oldham 027A","E01005342","Total",662,298,156,142,364,51,64,59,99,13,29,49
"2011","Oldham 027B","E01005343","Total",547,128,65,63,419,52,68,90,96,17,28,68
"2011","Oldham 027C","E01005344","Total",656,229,81,148,427,76,36,88,104,26,23,74
"2011","Oldham 027D","E01005381","Total",642,259,137,122,383,55,52,61,81,29,50,55
"2011","Oldham 028A","E01005332","Total",979,311,126,185,668,80,110,111,177,34,55,101
"2011","Oldham 028B","E01005341","Total",602,162,59,103,440,41,55,91,127,14,38,74
"2011","Oldham 028C","E01005345","Total",620,167,84,83,453,20,90,78,111,10,47,97
"2011","Oldham 028D","E01005346","Total",610,178,100,78,432,13,98,79,100,7,27,108
"2011","Oldham 028E","E01005347","Total",540,128,47,81,412,37,59,89,107,16,33,71
"2011","Oldham 029A","E01005322","Total",523,155,45,110,368,83,35,58,77,23,29,63
"2011","Oldham 029B","E01005323","Total",621,215,81,134,406,67,55,77,99,19,26,63
"2011","Oldham 029C","E01005324","Total",612,177,67,110,435,107,52,62,94,15,30,75
"2011","Oldham 029D","E01005325","Total",419,144,56,88,275,66,32,41,52,23,24,37
"2011","Oldham 029E","E01005438","Total",966,310,94,216,656,76,86,136,166,44,53,95
"2011","Oldham 030A","E01005377","Total",498,115,26,89,383,65,44,58,71,28,50,67
"2011","Oldham 030B","E01005379","Total",507,138,52,86,369,119,29,65,59,22,24,51
"2011","Oldham 030C","E01005380","Total",533,101,46,55,432,102,22,79,66,31,43,89
"2011","Oldham 030D","E01005382","Total",598,192,85,107,406,48,51,65,109,20,39,74
"2011","Oldham 030E","E01005439","Total",654,191,119,72,463,34,99,67,119,17,40,87
"2011","Oldham 031A","E01005362","Total",612,156,80,76,456,41,86,75,114,5,39,96
"2011","Oldham 031B","E01005364","Total",709,190,111,79,519,21,109,117,122,9,38,103
"2011","Oldham 031C","E01005368","Total",729,268,99,169,461,91,39,90,132,17,18,74
"2011","Oldham 031D","E01005376","Total",558,190,78,112,368,66,39,69,90,21,26,57
"2011","Oldham 031E","E01005378","Total",663,213,83,130,450,56,67,86,122,10,27,82
"2011","Oldham 032A","E01005363","Total",699,233,96,137,466,61,60,81,144,15,25,80
"2011","Oldham 032B","E01005369","Total",655,223,59,164,432,75,51,86,128,10,27,55
"2011","Oldham 032C","E01005370","Total",714,316,179,137,398,44,83,72,110,12,21,56
"2011","Oldham 032D","E01005371","Total",554,149,36,113,405,54,39,93,124,10,28,57
"2011","Oldham 033A","E01005365","Total",624,168,79,89,456,24,90,85,125,11,35,86
"2011","Oldham 033B","E01005366","Total",699,290,140,150,409,45,87,63,86,14,29,85
"2011","Oldham 033C","E01005367","Total",572,116,70,46,456,22,103,101,88,12,45,85
"2011","Oldham 033D","E01005440","Total",625,231,109,122,394,19,68,69,132,3,24,79
"2011","Oldham 034A","E01005372","Total",518,162,70,92,356,48,62,67,76,15,21,67
"2011","Oldham 034B","E01005373","Total",507,142,91,51,365,16,98,62,73,11,29,76
"2011","Oldham 034C","E01005374","Total",621,181,99,82,440,53,88,84,93,13,27,82
"2011","Oldham 034D","E01005375","Total",652,183,125,58,469,29,145,68,99,6,33,89
"2011","Oldham 035A","E01005435","Total",490,69,21,48,421,29,18,67,38,67,106,96
"2011","Oldham 035B","E01005436","Total",520,117,54,63,403,30,48,67,71,37,75,75
"2011","Oldham 035C","E01005460","Total",753,174,58,116,579,64,49,112,111,64,99,80
"2011","Oldham 035D","E01005461","Total",536,91,36,55,445,21,27,53,30,66,163,85
"2011","Oldham 035E","E01005462","Total",552,132,52,80,420,24,47,63,65,49,95,77
"2011","Oldham 035F","E01005463","Total",406,152,34,118,254,32,21,40,44,35,47,35
"2011","Oldham 035G","E01032921","Total",771,254,52,202,517,41,28,96,57,70,125,100
"2011","Rochdale 001A","E01005518","Total",591,157,60,97,434,29,92,71,109,19,30,84
"2011","Rochdale 001B","E01005520","Total",811,279,116,163,532,54,96,111,158,14,34,65
"2011","Rochdale 001C","E01005522","Total",658,261,107,154,397,53,54,79,131,10,21,49
"2011","Rochdale 001D","E01005523","Total",800,212,74,138,588,38,103,131,167,20,45,84
"2011","Rochdale 002A","E01005519","Total",615,140,60,80,475,42,56,113,126,23,33,82
"2011","Rochdale 002B","E01005594","Total",582,129,53,76,453,25,84,88,119,15,38,84
"2011","Rochdale 002C","E01005597","Total",672,166,68,98,506,44,86,109,143,19,28,77
"2011","Rochdale 002D","E01005598","Total",675,174,75,99,501,24,112,77,153,14,39,82
"2011","Rochdale 003A","E01005516","Total",552,117,45,72,435,26,69,94,128,14,36,68
"2011","Rochdale 003B","E01005517","Total",651,172,90,82,479,19,127,74,139,9,24,87
"2011","Rochdale 003C","E01005521","Total",627,200,93,107,427,16,75,94,150,8,26,58
"2011","Rochdale 003D","E01005596","Total",753,176,59,117,577,42,76,125,166,24,50,94
"2011","Rochdale 004A","E01005578","Total",489,147,71,76,342,32,33,58,71,32,65,51
"2011","Rochdale 004B","E01005579","Total",538,124,36,88,414,44,32,81,70,72,66,49
"2011","Rochdale 004C","E01005586","Total",664,273,120,153,391,74,63,47,74,34,41,58
"2011","Rochdale 004D","E01005593","Total",569,129,37,92,440,64,46,82,95,28,58,67
"2011","Rochdale 004E","E01005595","Total",792,463,177,286,329,48,72,52,83,8,31,35
"2011","Rochdale 005A","E01005489","Total",503,113,58,55,390,31,90,67,110,15,18,59
"2011","Rochdale 005B","E01005490","Total",410,100,43,57,310,40,43,54,48,20,41,64
"2011","Rochdale 005C","E01005491","Total",697,272,117,155,425,35,81,82,119,16,27,65
"2011","Rochdale 005D","E01005493","Total",669,154,71,83,515,27,95,90,166,8,46,83
"2011","Rochdale 005E","E01005494","Total",704,200,77,123,504,46,78,104,113,25,50,88
"2011","Rochdale 005F","E01005495","Total",684,225,104,121,459,38,92,61,126,23,49,70
"2011","Rochdale 006A","E01005488","Total",581,98,22,76,483,41,64,136,108,28,38,68
"2011","Rochdale 006B","E01005492","Total",614,104,52,52,510,18,115,90,143,22,38,84
"2011","Rochdale 006C","E01005499","Total",649,190,71,119,459,27,79,92,136,10,25,90
"2011","Rochdale 006D","E01005571","Total",653,172,58,114,481,19,80,100,145,16,33,88
"2011","Rochdale 007A","E01005570","Total",572,171,75,96,401,17,110,60,124,11,24,55
"2011","Rochdale 007B","E01005572","Total",638,133,60,73,505,20,92,118,118,19,35,103
"2011","Rochdale 007C","E01005573","Total",561,113,69,44,448,11,91,94,103,16,52,81
"2011","Rochdale 007D","E01005574","Total",680,167,67,100,513,24,120,81,130,16,48,94
"2011","Rochdale 007E","E01005587","Total",508,75,30,45,433,22,47,98,99,20,55,92
"2011","Rochdale 007F","E01005588","Total",688,297,177,120,391,33,108,69,83,8,23,67
"2011","Rochdale 008A","E01005580","Total",585,158,56,102,427,52,48,86,88,31,39,83
"2011","Rochdale 008B","E01005581","Total",599,214,89,125,385,43,56,66,69,56,41,54
"2011","Rochdale 008D","E01005583","Total",464,138,59,79,326,16,28,39,32,23,118,70
"2011","Rochdale 008F","E01005585","Total",463,104,20,84,359,25,34,76,72,34,66,52
"2011","Rochdale 008G","E01033258","Total",795,156,36,120,639,52,34,84,84,86,177,122
"2011","Rochdale 009A","E01005496","Total",537,144,50,94,393,78,38,79,62,14,38,84
"2011","Rochdale 009B","E01005589","Total",653,219,68,151,434,44,54,81,116,13,49,77
"2011","Rochdale 009C","E01005590","Total",527,135,51,84,392,33,38,70,68,39,73,71
"2011","Rochdale 009D","E01005591","Total",626,216,109,107,410,30,86,77,108,11,28,70
"2011","Rochdale 009E","E01005592","Total",615,200,93,107,415,53,56,76,87,25,51,67
"2011","Rochdale 010A","E01005472","Total",663,240,109,131,423,72,48,76,109,24,46,48
"2011","Rochdale 010B","E01005473","Total",492,117,52,65,375,29,43,65,65,36,59,78
"2011","Rochdale 010C","E01005482","Total",1173,801,130,671,372,50,36,54,120,29,38,45
"2011","Rochdale 010D","E01005483","Total",812,395,109,286,417,29,37,67,130,35,70,49
"2011","Rochdale 010E","E01005484","Total",907,444,110,334,463,65,44,77,86,42,72,77
"2011","Rochdale 010F","E01005486","Total",566,146,38,108,420,70,31,88,88,46,50,47
"2011","Rochdale 010G","E01005487","Total",568,156,67,89,412,45,52,60,64,39,86,66
"2011","Rochdale 011A","E01005474","Total",480,112,57,55,368,21,92,57,77,22,23,76
"2011","Rochdale 011B","E01005575","Total",722,216,109,107,506,21,141,90,128,18,38,70
"2011","Rochdale 011C","E01005576","Total",557,102,54,48,455,7,136,66,87,21,52,86
"2011","Rochdale 011D","E01005577","Total",637,194,107,87,443,15,111,71,107,12,46,81
"2011","Rochdale 012A","E01005469","Total",716,192,69,123,524,42,85,96,118,28,54,101
"2011","Rochdale 012B","E01005563","Total",631,164,46,118,467,60,55,71,92,36,82,71
"2011","Rochdale 012C","E01005565","Total",558,126,36,90,432,38,45,87,94,34,58,76
"2011","Rochdale 012D","E01005566","Total",810,216,79,137,594,73,42,132,164,52,70,61
"2011","Rochdale 012E","E01005568","Total",632,247,62,185,385,68,24,66,72,47,53,55
"2011","Rochdale 012F","E01005569","Total",641,204,52,152,437,40,78,73,90,40,52,64
"2011","Rochdale 013A","E01005556","Total",669,194,58,136,475,40,71,109,139,8,27,81
"2011","Rochdale 013B","E01005559","Total",691,266,115,151,425,58,63,78,104,27,35,60
"2011","Rochdale 013C","E01005560","Total",695,207,105,102,488,45,119,72,130,8,27,87
"2011","Rochdale 013D","E01005567","Total",647,214,59,155,433,54,51,99,123,11,32,63
"2011","Rochdale 014A","E01005555","Total",525,107,35,72,418,29,74,71,89,20,46,89
"2011","Rochdale 014B","E01005557","Total",499,105,58,47,394,18,99,65,103,10,27,72
"2011","Rochdale 014C","E01005558","Total",711,202,87,115,509,32,80,113,167,14,32,71
"2011","Rochdale 014D","E01005561","Total",598,179,62,117,419,30,75,79,144,10,21,60
"2011","Rochdale 014E","E01005562","Total",691,239,98,141,452,39,67,89,133,20,34,70
"2011","Rochdale 015A","E01005470","Total",474,94,32,62,380,32,19,75,38,48,85,83
"2011","Rochdale 015B","E01005471","Total",562,146,58,88,416,36,44,98,78,35,60,65
"2011","Rochdale 015C","E01005475","Total",597,198,66,132,399,45,44,63,68,29,69,81
"2011","Rochdale 015D","E01005485","Total",622,194,50,144,428,23,45,48,44,39,136,93
"2011","Rochdale 015E","E01005564","Total",641,180,67,113,461,65,34,78,68,47,91,78
"2011","Rochdale 016A","E01005464","Total",643,170,61,109,473,83,37,85,83,42,61,82
"2011","Rochdale 016B","E01005465","Total",761,277,131,146,484,47,65,100,126,16,42,88
"2011","Rochdale 016C","E01005466","Total",1072,456,129,327,616,122,67,118,148,35,56,70
"2011","Rochdale 016D","E01005467","Total",800,335,119,216,465,75,69,110,92,27,34,58
"2011","Rochdale 016E","E01005468","Total",602,121,48,73,481,23,99,85,129,19,32,94
"2011","Rochdale 017A","E01005476","Total",708,232,84,148,476,42,63,110,133,20,30,78
"2011","Rochdale 017B","E01005477","Total",815,358,131,227,457,67,62,74,131,25,30,68
"2011","Rochdale 017C","E01005478","Total",682,186,77,109,496,52,106,72,126,18,38,84
"2011","Rochdale 017D","E01005479","Total",711,193,90,103,518,33,92,94,133,21,45,100
"2011","Rochdale 017E","E01005480","Total",739,264,150,114,475,40,119,59,129,16,34,78
"2011","Rochdale 017F","E01005481","Total",602,150,62,88,452,40,66,79,115,25,51,76
"2011","Rochdale 018A","E01005497","Total",682,232,92,140,450,79,49,99,101,18,42,62
"2011","Rochdale 018B","E01005501","Total",892,508,226,282,384,41,89,75,109,13,18,39
"2011","Rochdale 018C","E01005502","Total",715,294,113,181,421,42,62,81,108,17,32,79
"2011","Rochdale 018D","E01005504","Total",638,199,83,116,439,54,62,80,104,23,24,92
"2011","Rochdale 018E","E01005505","Total",780,261,97,164,519,81,73,93,149,8,36,79
"2011","Rochdale 018F","E01005509","Total",964,494,138,356,470,77,59,63,154,16,25,76
"2011","Rochdale 019A","E01005510","Total",440,67,17,50,373,16,62,72,117,16,28,62
"2011","Rochdale 019B","E01005511","Total",503,122,37,85,381,20,57,70,121,11,32,70
"2011","Rochdale 019C","E01005512","Total",685,240,89,151,445,35,79,76,129,13,32,81
"2011","Rochdale 019D","E01005513","Total",599,222,80,142,377,66,45,79,87,12,31,57
"2011","Rochdale 019E","E01005514","Total",658,209,77,132,449,57,69,69,120,22,36,76
"2011","Rochdale 019F","E01005515","Total",706,218,99,119,488,95,60,91,91,27,38,86
"2011","Rochdale 020A","E01005498","Total",587,155,58,97,432,56,55,89,94,22,27,89
"2011","Rochdale 020B","E01005500","Total",647,177,88,89,470,40,61,91,146,12,41,79
"2011","Rochdale 020C","E01005503","Total",522,109,58,51,413,18,76,68,110,7,42,92
"2011","Rochdale 020D","E01005506","Total",671,235,96,139,436,44,80,76,110,17,43,66
"2011","Rochdale 020E","E01005507","Total",711,233,67,166,478,71,55,85,138,16,34,79
"2011","Rochdale 020F","E01005508","Total",729,167,77,90,562,24,94,100,153,20,54,117
"2011","Rochdale 021A","E01005524","Total",638,190,60,130,448,37,68,82,127,13,31,90
"2011","Rochdale 021B","E01005525","Total",818,426,149,277,392,42,56,75,103,24,29,63
"2011","Rochdale 021C","E01005526","Total",678,225,60,165,453,55,51,86,118,17,44,82
"2011","Rochdale 021D","E01005528","Total",674,237,99,138,437,51,75,78,112,20,29,72
"2011","Rochdale 021E","E01005536","Total",653,175,54,121,478,59,49,95,135,19,38,83
"2011","Rochdale 021F","E01005543","Total",523,144,77,67,379,20,56,64,118,8,38,75
"2011","Rochdale 022A","E01005527","Total",636,235,77,158,401,60,55,60,95,20,41,70
"2011","Rochdale 022B","E01005529","Total",795,355,147,208,440,74,60,59,129,18,39,61
"2011","Rochdale 022C","E01005551","Total",797,315,120,195,482,101,55,71,131,29,35,60
"2011","Rochdale 022D","E01005552","Total",882,352,112,240,530,107,54,97,117,30,49,76
"2011","Rochdale 022E","E01005553","Total",759,213,95,118,546,68,94,82,118,15,51,118
"2011","Rochdale 022F","E01005554","Total",583,177,57,120,406,30,58,67,139,22,28,62
"2011","Rochdale 023A","E01005534","Total",642,229,102,127,413,36,41,75,109,16,48,88
"2011","Rochdale 023B","E01005535","Total",690,226,45,181,464,43,68,78,134,12,42,87
"2011","Rochdale 023C","E01005537","Total",566,125,41,84,441,34,58,72,146,7,37,87
"2011","Rochdale 023D","E01005538","Total",581,150,52,98,431,62,48,116,81,13,45,66
"2011","Rochdale 023E","E01005540","Total",581,163,50,113,418,36,57,81,129,9,25,81
"2011","Rochdale 023F","E01005541","Total",704,213,49,164,491,62,49,117,143,12,35,73
"2011","Rochdale 023G","E01005542","Total",623,253,110,143,370,43,63,80,98,11,26,49
"2011","Rochdale 024A","E01005533","Total",836,367,132,235,469,37,71,104,168,3,23,63
"2011","Rochdale 024B","E01005539","Total",694,339,96,243,355,49,50,62,118,12,8,56
"2011","Rochdale 024C","E01005546","Total",618,265,114,151,353,23,70,67,104,8,22,59
"2011","Rochdale 024D","E01005547","Total",630,195,69,126,435,45,51,107,126,11,23,72
"2011","Rochdale 024E","E01005548","Total",655,324,91,233,331,40,47,52,106,8,24,54
"2011","Rochdale 025A","E01005530","Total",645,200,133,67,445,18,142,69,97,11,27,81
"2011","Rochdale 025B","E01005531","Total",509,169,68,101,340,44,40,60,92,7,30,67
"2011","Rochdale 025C","E01005532","Total",669,283,94,189,386,67,48,76,89,17,32,57
"2011","Rochdale 025D","E01005544","Total",609,167,115,52,442,12,103,82,84,14,33,114
"2011","Rochdale 025E","E01005545","Total",481,101,69,32,380,11,93,74,85,11,34,72
"2011","Rochdale 025F","E01005549","Total",588,118,78,40,470,9,106,88,98,22,54,93
"2011","Rochdale 025G","E01005550","Total",630,184,125,59,446,21,144,75,88,12,26,80
"2011","Salford 001A","E01005659","Total",631,211,85,126,420,64,67,74,102,14,25,74
"2011","Salford 001B","E01005660","Total",675,278,120,158,397,81,62,69,87,22,34,42
"2011","Salford 001C","E01005663","Total",618,197,67,130,421,72,69,75,110,12,27,56
"2011","Salford 001D","E01005664","Total",630,193,76,117,437,98,54,80,97,24,26,58
"2011","Salford 001E","E01005665","Total",629,230,98,132,399,96,52,59,61,27,41,63
"2011","Salford 002A","E01005703","Total",704,278,84,194,426,79,49,79,103,20,37,59
"2011","Salford 002B","E01005704","Total",591,151,48,103,440,63,75,69,115,11,40,67
"2011","Salford 002C","E01005706","Total",655,224,98,126,431,87,64,80,95,13,28,64
"2011","Salford 002D","E01005708","Total",750,341,154,187,409,58,71,74,108,11,26,61
"2011","Salford 003A","E01005702","Total",927,288,110,178,639,68,98,111,184,22,50,106
"2011","Salford 003B","E01005705","Total",869,321,120,201,548,64,75,124,168,18,32,67
"2011","Salford 003C","E01005707","Total",783,291,78,213,492,88,67,100,130,17,36,54
"2011","Salford 004A","E01005661","Total",725,198,64,134,527,98,55,115,127,21,45,66
"2011","Salford 004B","E01005662","Total",617,189,71,118,428,80,54,90,88,32,39,45
"2011","Salford 004C","E01005709","Total",605,190,75,115,415,85,63,69,93,14,32,59
"2011","Salford 004D","E01005710","Total",608,137,70,67,471,29,104,76,109,17,39,97
"2011","Salford 005A","E01005670","Total",822,349,173,176,473,83,56,77,135,13,26,83
"2011","Salford 005B","E01005672","Total",608,177,52,125,431,51,44,86,145,10,20,75
"2011","Salford 005C","E01005676","Total",554,138,69,69,416,16,123,51,101,6,28,91
"2011","Salford 005D","E01005677","Total",696,224,106,118,472,46,89,87,129,13,32,76
"2011","Salford 006A","E01005686","Total",621,186,57,129,435,61,72,65,116,12,33,76
"2011","Salford 006B","E01005688","Total",657,158,72,86,499,69,104,92,110,10,47,67
"2011","Salford 006C","E01005691","Total",697,226,116,110,471,34,150,53,119,7,29,79
"2011","Salford 006D","E01005692","Total",734,400,125,275,334,42,54,66,113,6,15,38
"2011","Salford 007A","E01005711","Total",659,181,64,117,478,31,100,90,136,9,37,75
"2011","Salford 007B","E01005712","Total",728,267,81,186,461,50,62,83,135,9,33,89
"2011","Salford 007C","E01005713","Total",632,169,97,72,463,19,132,80,117,8,23,84
"2011","Salford 007D","E01005714","Total",617,185,84,101,432,51,82,71,100,16,34,78
"2011","Salford 007E","E01005715","Total",724,216,102,114,508,19,117,108,134,12,34,84
"2011","Salford 007F","E01005718","Total",822,321,160,161,501,35,96,75,160,12,34,89
"2011","Salford 008A","E01005673","Total",642,217,59,158,425,49,50,86,130,15,26,69
"2011","Salford 008B","E01005675","Total",712,196,42,154,516,66,39,133,140,17,41,80
"2011","Salford 008C","E01005678","Total",653,205,75,130,448,79,44,79,106,15,36,89
"2011","Salford 008D","E01005679","Total",670,200,63,137,470,111,68,91,90,23,29,58
"2011","Salford 009A","E01005687","Total",800,275,102,173,525,71,70,117,147,10,27,83
"2011","Salford 009B","E01005689","Total",575,178,65,113,397,81,44,77,71,32,35,57
"2011","Salford 009C","E01005690","Total",678,208,87,121,470,33,96,87,122,16,28,88
"2011","Salford 009D","E01005693","Total",611,165,78,87,446,43,96,77,108,10,30,82
"2011","Salford 010A","E01005646","Total",527,181,106,75,346,12,53,50,79,54,65,33
"2011","Salford 010B","E01005649","Total",682,268,130,138,414,15,85,66,101,60,49,38
"2011","Salford 010C","E01005650","Total",597,312,132,180,285,20,26,41,60,39,60,39
"2011","Salford 010D","E01005651","Total",537,102,35,67,435,56,42,65,54,92,78,48
"2011","Salford 011A","E01005647","Total",675,329,129,200,346,14,68,47,91,43,35,48
"2011","Salford 011B","E01005648","Total",861,350,88,262,511,32,75,106,175,15,28,80
"2011","Salford 011C","E01005652","Total",548,132,47,85,416,59,53,67,97,26,39,75
"2011","Salford 011D","E01005653","Total",626,173,67,106,453,99,48,77,98,9,36,86
"2011","Salford 012A","E01005671","Total",745,332,161,171,413,56,58,87,108,16,25,63
"2011","Salford 012B","E01005674","Total",574,164,71,93,410,42,62,65,109,5,41,86
"2011","Salford 012C","E01005694","Total",686,157,70,87,529,51,75,138,123,12,42,88
"2011","Salford 012D","E01005696","Total",626,154,69,85,472,36,76,96,131,13,36,84
"2011","Salford 012E","E01005698","Total",801,346,148,198,455,84,79,75,103,16,38,60
"2011","Salford 012F","E01005700","Total",661,205,71,134,456,49,68,95,122,13,28,81
"2011","Salford 013A","E01005716","Total",668,115,43,72,553,20,89,139,130,13,49,113
"2011","Salford 013B","E01005717","Total",543,80,16,64,463,13,40,172,103,15,48,72
"2011","Salford 013C","E01005734","Total",618,213,85,128,405,36,77,79,123,6,23,61
"2011","Salford 013D","E01005735","Total",579,140,71,69,439,22,86,96,112,12,22,89
"2011","Salford 013E","E01005736","Total",626,168,65,103,458,25,94,89,136,8,26,80
"2011","Salford 013F","E01005737","Total",604,127,75,52,477,17,109,107,118,14,30,82
"2011","Salford 013G","E01005739","Total",614,125,45,80,489,33,75,132,133,15,29,72
"2011","Salford 014A","E01005695","Total",620,130,72,58,490,12,116,123,114,16,39,70
"2011","Salford 014B","E01005697","Total",676,197,108,89,479,27,100,113,118,16,22,83
"2011","Salford 014C","E01005738","Total",768,213,105,108,555,26,141,102,162,17,25,82
"2011","Salford 014D","E01005740","Total",708,230,118,112,478,12,120,108,132,12,27,67
"2011","Salford 014E","E01005741","Total",685,172,103,69,513,11,124,117,115,14,25,107
"2011","Salford 014F","E01005742","Total",673,199,93,106,474,39,101,90,105,19,35,85
"2011","Salford 015A","E01005625","Total",601,204,104,100,397,32,78,75,106,6,30,70
"2011","Salford 015B","E01005627","Total",477,126,77,49,351,15,64,61,81,16,34,80
"2011","Salford 015C","E01005699","Total",639,184,90,94,455,35,91,76,113,13,34,93
"2011","Salford 015D","E01005701","Total",619,124,67,57,495,37,111,85,117,10,39,96
"2011","Salford 016A","E01005609","Total",852,360,66,294,492,74,32,74,195,14,28,75
"2011","Salford 016B","E01005611","Total",898,400,108,292,498,79,45,73,133,11,34,123
"2011","Salford 016C","E01005612","Total",1031,608,216,392,423,65,60,57,111,56,30,44
"2011","Salford 016D","E01005613","Total",984,465,59,406,519,88,48,97,105,49,56,76
"2011","Salford 016E","E01005614","Total",529,144,46,98,385,33,37,51,49,112,56,47
"2011","Salford 016F","E01005615","Total",695,253,72,181,442,52,38,63,100,33,32,124
"2011","Salford 017A","E01005624","Total",677,208,75,133,469,80,68,73,89,33,41,85
"2011","Salford 017B","E01005680","Total",723,379,82,297,344,64,45,64,87,11,19,54
"2011","Salford 017C","E01005683","Total",777,327,104,223,450,98,62,83,110,16,28,53
"2011","Salford 017F","E01032919","Total",976,317,111,206,659,125,58,97,189,15,36,139
"2011","Salford 018A","E01005622","Total",665,248,100,148,417,50,47,92,129,11,21,67
"2011","Salford 018B","E01005623","Total",498,115,48,67,383,16,69,62,91,7,37,101
"2011","Salford 018C","E01005626","Total",507,117,58,59,390,15,72,79,104,9,25,86
"2011","Salford 018D","E01005628","Total",692,258,71,187,434,28,63,65,139,11,22,106
"2011","Salford 019A","E01005725","Total",559,179,66,113,380,64,48,66,78,26,39,59
"2011","Salford 019B","E01005726","Total",615,190,67,123,425,52,53,76,105,17,44,78
"2011","Salford 019C","E01005727","Total",653,259,41,218,394,45,47,73,140,8,22,59
"2011","Salford 019D","E01005728","Total",584,165,99,66,419,26,93,78,110,14,25,73
"2011","Salford 019E","E01005733","Total",503,124,55,69,379,57,60,44,60,29,33,96
"2011","Salford 020A","E01005631","Total",1021,736,298,438,285,13,53,46,123,5,11,34
"2011","Salford 020B","E01005632","Total",916,369,92,277,547,48,38,107,194,28,56,76
"2011","Salford 020C","E01005633","Total",597,207,115,92,390,36,65,54,86,16,47,86
"2011","Salford 020D","E01005634","Total",601,133,50,83,468,21,75,103,139,10,34,86
"2011","Salford 020E","E01005635","Total",704,303,79,224,401,9,69,75,120,7,29,92
"2011","Salford 020F","E01005636","Total",680,237,101,136,443,19,80,79,123,9,34,99
"2011","Salford 020G","E01005637","Total",628,249,80,169,379,36,57,76,105,6,22,77
"2011","Salford 021A","E01005629","Total",618,256,125,131,362,15,79,58,97,12,33,68
"2011","Salford 021B","E01005630","Total",648,209,90,119,439,60,61,84,120,13,26,75
"2011","Salford 021C","E01005719","Total",915,454,181,273,461,33,63,60,169,14,17,105
"2011","Salford 021D","E01005720","Total",1121,416,94,322,705,124,65,93,268,19,38,98
"2011","Salford 021E","E01005722","Total",709,221,84,137,488,74,52,79,118,25,53,87
"2011","Salford 021F","E01005723","Total",639,225,86,139,414,79,45,65,89,16,35,85
"2011","Salford 021G","E01005724","Total",643,227,126,101,416,10,92,60,103,14,29,108
"2011","Salford 022D","E01005610","Total",472,183,75,108,289,64,45,38,64,13,27,38
"2011","Salford 022E","E01032684","Total",631,207,23,184,424,26,15,38,222,7,9,107
"2011","Salford 022F","E01032687","Total",716,265,13,252,451,6,6,17,346,0,4,72
"2011","Salford 022G","E01032906","Total",712,366,28,338,346,23,14,18,212,2,7,70
"2011","Salford 022H","E01032907","Total",659,300,29,271,359,32,17,26,218,3,13,50
"2011","Salford 022I","E01032909","Total",837,404,3,401,433,3,0,21,388,0,1,20
"2011","Salford 022J","E01032911","Total",731,388,9,379,343,15,0,19,283,6,3,17
"2011","Salford 022K","E01033330","Total",875,566,118,448,309,44,28,39,141,5,17,35
"2011","Salford 023A","E01005654","Total",754,283,62,221,471,74,30,47,254,8,8,50
"2011","Salford 023B","E01005656","Total",645,192,61,131,453,95,58,69,112,11,29,79
"2011","Salford 023C","E01005657","Total",709,321,124,197,388,47,67,60,100,12,19,83
"2011","Salford 023D","E01005721","Total",766,376,155,221,390,38,85,44,121,4,14,84
"2011","Salford 024A","E01005655","Total",716,374,43,331,342,44,15,56,156,15,19,37
"2011","Salford 024B","E01005658","Total",662,276,92,184,386,93,49,65,84,8,32,55
"2011","Salford 024C","E01005681","Total",568,336,122,214,232,19,46,20,84,3,5,55
"2011","Salford 024D","E01005682","Total",1035,723,145,578,312,56,54,25,130,4,16,27
"2011","Salford 025A","E01005729","Total",743,427,122,305,316,72,28,58,101,9,19,29
"2011","Salford 025B","E01005730","Total",711,232,62,170,479,59,59,78,144,21,37,81
"2011","Salford 025C","E01005731","Total",594,150,61,89,444,76,49,77,94,28,50,70
"2011","Salford 025D","E01005732","Total",558,222,84,138,336,42,62,45,95,9,20,63
"2011","Salford 026A","E01005599","Total",809,391,95,296,418,35,57,76,139,24,23,64
"2011","Salford 026B","E01005600","Total",612,181,46,135,431,77,52,70,111,19,36,66
"2011","Salford 026C","E01005601","Total",662,228,69,159,434,80,52,76,122,14,34,56
"2011","Salford 026D","E01005602","Total",775,416,101,315,359,68,39,71,127,5,20,29
"2011","Salford 027A","E01005603","Total",653,176,50,126,477,84,36,104,133,10,45,65
"2011","Salford 027B","E01005604","Total",702,226,85,141,476,76,76,82,130,8,23,81
"2011","Salford 027C","E01005605","Total",668,253,76,177,415,51,65,72,138,14,18,57
"2011","Salford 027D","E01005638","Total",759,299,64,235,460,90,51,94,151,10,21,43
"2011","Salford 028B","E01005667","Total",879,372,103,269,507,84,52,90,158,14,33,76
"2011","Salford 028E","E01032685","Total",945,493,16,477,452,10,11,36,359,1,1,34
"2011","Salford 028F","E01032686","Total",880,439,9,430,441,3,8,23,363,0,2,42
"2011","Salford 028G","E01032912","Total",779,372,98,274,407,67,47,61,135,14,24,59
"2011","Salford 028H","E01032914","Total",943,453,10,443,490,28,7,55,337,0,10,53
"2011","Salford 028I","E01032915","Total",693,256,83,173,437,98,27,54,141,10,31,76
"2011","Salford 028J","E01032917","Total",591,258,26,232,333,24,18,24,215,4,5,43
"2011","Salford 029A","E01005639","Total",605,173,58,115,432,109,48,88,71,35,31,50
"2011","Salford 029B","E01005640","Total",546,125,53,72,421,80,54,76,76,24,36,75
"2011","Salford 029C","E01005641","Total",640,225,135,90,415,45,77,74,106,14,25,74
"2011","Salford 029D","E01005642","Total",512,137,48,89,375,39,62,79,89,12,25,69
"2011","Salford 029E","E01005643","Total",671,227,150,77,444,32,152,57,114,7,24,58
"2011","Salford 029F","E01005644","Total",631,144,30,114,487,38,62,110,142,24,40,71
"2011","Salford 029G","E01005645","Total",603,154,96,58,449,17,123,73,93,14,31,98
"2011","Salford 030A","E01005616","Total",620,202,86,116,418,40,90,65,83,18,39,83
"2011","Salford 030B","E01005617","Total",611,126,60,66,485,43,85,90,128,17,39,83
"2011","Salford 030C","E01005618","Total",666,227,99,128,439,79,74,94,92,22,25,53
"2011","Salford 030D","E01005619","Total",528,127,51,76,401,52,65,49,103,15,36,81
"2011","Salford 030E","E01005620","Total",1060,318,86,232,742,82,80,193,198,27,59,103
"2011","Salford 030F","E01005621","Total",768,294,102,192,474,60,65,92,143,15,36,63
"2011","Stockport 001A","E01005886","Total",656,213,46,167,443,82,36,92,109,14,32,78
"2011","Stockport 001B","E01005888","Total",592,164,63,101,428,45,59,89,77,21,51,86
"2011","Stockport 001C","E01005889","Total",686,245,133,112,441,52,91,71,116,13,30,68
"2011","Stockport 001D","E01005891","Total",569,156,59,97,413,23,91,52,118,9,28,92
"2011","Stockport 001E","E01005894","Total",573,143,56,87,430,46,77,90,91,15,35,76
"2011","Stockport 002A","E01005887","Total",595,157,48,109,438,83,40,96,96,23,33,67
"2011","Stockport 002B","E01005890","Total",579,159,47,112,420,48,62,95,82,28,40,65
"2011","Stockport 002C","E01005893","Total",837,336,96,240,501,76,62,76,175,14,25,73
"2011","Stockport 002D","E01005896","Total",776,268,69,199,508,78,50,111,162,10,24,73
"2011","Stockport 002E","E01005919","Total",716,272,81,191,444,107,56,72,104,15,36,54
"2011","Stockport 003A","E01005862","Total",604,144,65,79,460,19,67,107,107,16,48,96
"2011","Stockport 003B","E01005892","Total",560,156,68,88,404,43,75,74,109,12,27,64
"2011","Stockport 003C","E01005895","Total",491,157,83,74,334,31,55,73,71,14,23,67
"2011","Stockport 003D","E01005920","Total",636,159,82,77,477,16,84,94,128,16,38,101
"2011","Stockport 003E","E01005921","Total",690,269,105,164,421,65,50,66,151,10,22,57
"2011","Stockport 003F","E01005922","Total",635,195,84,111,440,36,85,94,125,6,18,76
"2011","Stockport 004A","E01005753","Total",672,197,86,111,475,105,56,79,104,19,48,64
"2011","Stockport 004B","E01005754","Total",945,513,100,413,432,83,45,74,115,23,30,62
"2011","Stockport 004C","E01005755","Total",672,227,72,155,445,94,34,92,82,29,46,68
"2011","Stockport 004D","E01005756","Total",764,369,44,325,395,115,41,73,69,20,31,46
"2011","Stockport 005A","E01005745","Total",595,166,55,111,429,36,58,84,116,9,40,86
"2011","Stockport 005B","E01005746","Total",777,423,215,208,354,20,90,52,105,6,31,50
"2011","Stockport 005C","E01005747","Total",587,131,55,76,456,25,83,93,118,8,40,89
"2011","Stockport 005D","E01005748","Total",659,167,106,61,492,15,160,76,109,6,38,88
"2011","Stockport 006A","E01005863","Total",776,305,128,177,471,17,71,87,140,19,41,96
"2011","Stockport 006B","E01005864","Total",624,219,57,162,405,14,55,100,141,17,23,55
"2011","Stockport 006C","E01005866","Total",821,366,94,272,455,30,51,90,169,12,36,67
"2011","Stockport 006D","E01005869","Total",610,169,85,84,441,18,88,92,100,16,29,98
"2011","Stockport 007A","E01005914","Total",675,254,100,154,421,31,77,92,121,10,24,66
"2011","Stockport 007B","E01005915","Total",722,280,98,182,442,60,57,93,140,5,24,63
"2011","Stockport 007C","E01005916","Total",708,247,79,168,461,64,66,76,148,8,28,71
"2011","Stockport 007D","E01005917","Total",847,388,94,294,459,92,41,66,156,16,20,68
"2011","Stockport 008A","E01005859","Total",625,260,77,183,365,15,48,74,110,22,35,61
"2011","Stockport 008B","E01005865","Total",632,197,84,113,435,16,122,71,94,14,46,72
"2011","Stockport 008C","E01005867","Total",660,264,122,142,396,15,87,74,111,13,34,62
"2011","Stockport 008D","E01005868","Total",576,151,75,76,425,22,81,95,85,25,44,73
"2011","Stockport 009A","E01005743","Total",583,142,62,80,441,28,129,76,97,7,36,68
"2011","Stockport 009B","E01005744","Total",605,218,96,122,387,33,73,62,102,10,36,71
"2011","Stockport 009C","E01005749","Total",731,223,99,124,508,39,73,111,159,11,35,80
"2011","Stockport 009D","E01005750","Total",703,187,70,117,516,47,64,121,153,16,35,80
"2011","Stockport 009E","E01005751","Total",586,160,54,106,426,57,55,88,142,10,18,56
"2011","Stockport 010A","E01005897","Total",599,168,89,79,431,50,58,96,90,15,43,79
"2011","Stockport 010B","E01005898","Total",723,240,126,114,483,28,124,84,122,17,36,72
"2011","Stockport 010C","E01005900","Total",770,315,142,173,455,33,112,86,122,11,23,68
"2011","Stockport 010D","E01005903","Total",623,159,105,54,464,7,156,74,111,12,29,75
"2011","Stockport 010E","E01005904","Total",624,181,109,72,443,21,100,97,102,18,30,75
"2011","Stockport 011A","E01005853","Total",655,196,78,118,459,57,54,94,119,22,36,77
"2011","Stockport 011B","E01005856","Total",661,188,76,112,473,31,75,86,132,20,42,87
"2011","Stockport 011C","E01005860","Total",580,130,74,56,450,21,79,122,101,17,27,83
"2011","Stockport 011D","E01005861","Total",714,263,120,143,451,23,91,95,124,11,31,76
"2011","Stockport 012A","E01005752","Total",626,184,92,92,442,71,69,99,87,15,30,71
"2011","Stockport 012B","E01005899","Total",744,267,169,98,477,39,138,75,112,17,24,72
"2011","Stockport 012C","E01005901","Total",621,167,93,74,454,14,147,60,103,15,25,90
"2011","Stockport 012D","E01005902","Total",736,269,135,134,467,76,77,87,101,18,39,69
"2011","Stockport 012E","E01005905","Total",614,217,67,150,397,72,53,74,97,22,29,50
"2011","Stockport 013A","E01005852","Total",695,256,90,166,439,21,73,73,145,17,33,77
"2011","Stockport 013B","E01005854","Total",739,256,91,165,483,25,87,105,144,14,25,83
"2011","Stockport 013C","E01005855","Total",594,178,80,98,416,13,63,89,102,20,44,85
"2011","Stockport 013D","E01005857","Total",595,175,60,115,420,17,55,85,106,28,47,82
"2011","Stockport 013E","E01005858","Total",790,321,105,216,469,29,76,93,187,6,21,57
"2011","Stockport 014A","E01005757","Total",709,245,51,194,464,62,57,103,130,24,30,58
"2011","Stockport 014B","E01005758","Total",1148,735,195,540,413,64,63,54,171,4,18,39
"2011","Stockport 014C","E01005766","Total",695,308,99,209,387,51,38,54,131,6,35,72
"2011","Stockport 014D","E01005918","Total",894,558,112,446,336,80,40,48,111,9,16,32
"2011","Stockport 015A","E01005870","Total",600,162,58,104,438,58,50,114,144,9,14,49
"2011","Stockport 015B","E01005871","Total",597,192,51,141,405,59,52,81,113,8,19,73
"2011","Stockport 015C","E01005873","Total",578,135,70,65,443,27,82,105,83,13,43,90
"2011","Stockport 015D","E01005875","Total",656,163,62,101,493,41,77,100,142,13,26,94
"2011","Stockport 016A","E01005764","Total",777,259,90,169,518,94,53,110,190,8,19,44
"2011","Stockport 016B","E01005816","Total",699,200,60,140,499,90,33,109,170,10,30,57
"2011","Stockport 016C","E01005817","Total",636,235,64,171,401,43,37,79,152,12,25,53
"2011","Stockport 016D","E01005822","Total",886,500,109,391,386,74,38,64,144,8,8,50
"2011","Stockport 017A","E01005880","Total",643,184,100,84,459,24,108,92,109,14,22,90
"2011","Stockport 017B","E01005881","Total",506,88,54,34,418,10,114,76,100,13,26,79
"2011","Stockport 017C","E01005883","Total",663,164,87,77,499,8,164,95,121,16,28,67
"2011","Stockport 017D","E01005908","Total",575,102,60,42,473,7,121,91,123,23,28,80
"2011","Stockport 018A","E01005765","Total",578,152,65,87,426,34,47,100,134,6,34,71
"2011","Stockport 018B","E01005818","Total",557,158,38,120,399,51,32,96,106,24,33,57
"2011","Stockport 018C","E01005819","Total",651,170,69,101,481,22,81,96,146,11,32,93
"2011","Stockport 018D","E01005820","Total",642,226,84,142,416,43,47,76,149,19,17,65
"2011","Stockport 018E","E01005821","Total",679,229,84,145,450,46,59,98,144,11,30,62
"2011","Stockport 018F","E01005823","Total",696,214,60,154,482,44,48,120,149,14,41,66
"2011","Stockport 019A","E01005825","Total",692,256,85,171,436,20,54,100,138,10,27,87
"2011","Stockport 019B","E01005872","Total",802,296,82,214,506,89,59,115,141,16,27,59
"2011","Stockport 019C","E01005874","Total",924,493,134,359,431,69,59,74,132,11,22,64
"2011","Stockport 019D","E01005876","Total",610,149,64,85,461,46,70,90,111,8,32,104
"2011","Stockport 019E","E01005877","Total",617,196,93,103,421,44,61,103,112,11,33,57
"2011","Stockport 020A","E01005878","Total",637,234,157,77,403,52,76,80,86,14,27,68
"2011","Stockport 020B","E01005879","Total",592,203,110,93,389,27,86,74,100,15,25,62
"2011","Stockport 020C","E01005882","Total",489,80,53,27,409,12,107,79,84,8,32,87
"2011","Stockport 020D","E01005884","Total",585,105,74,31,480,16,136,94,96,7,39,92
"2011","Stockport 020E","E01005885","Total",637,277,151,126,360,26,83,60,96,13,29,53
"2011","Stockport 021A","E01005832","Total",623,194,97,97,429,22,80,82,96,11,39,99
"2011","Stockport 021B","E01005833","Total",464,171,111,60,293,15,59,59,71,9,27,53
"2011","Stockport 021C","E01005835","Total",564,132,61,71,432,17,94,74,108,12,33,94
"2011","Stockport 021D","E01005837","Total",672,183,65,118,489,37,72,104,146,13,36,81
"2011","Stockport 021E","E01005843","Total",619,131,62,69,488,17,95,91,145,11,30,99
"2011","Stockport 022A","E01005769","Total",663,255,84,171,408,28,34,77,185,7,21,56
"2011","Stockport 022B","E01005778","Total",641,196,96,100,445,29,68,99,124,7,28,90
"2011","Stockport 022C","E01005779","Total",580,163,80,83,417,25,62,90,106,18,34,82
"2011","Stockport 022D","E01005780","Total",557,125,45,80,432,29,42,118,111,15,39,78
"2011","Stockport 022E","E01005781","Total",820,402,157,245,418,80,80,69,105,9,22,53
"2011","Stockport 023A","E01005759","Total",690,181,54,127,509,46,64,109,148,23,32,87
"2011","Stockport 023B","E01005760","Total",848,314,80,234,534,95,38,120,155,23,39,64
"2011","Stockport 023C","E01005797","Total",670,265,72,193,405,53,34,87,156,5,17,53
"2011","Stockport 023D","E01005800","Total",693,202,94,108,491,32,91,98,140,20,23,87
"2011","Stockport 023E","E01005804","Total",481,171,61,110,310,33,39,72,91,9,27,39
"2011","Stockport 024A","E01005824","Total",610,175,95,80,435,18,76,94,104,17,30,96
"2011","Stockport 024B","E01005826","Total",597,195,92,103,402,62,92,55,72,27,42,52
"2011","Stockport 024C","E01005827","Total",598,168,98,70,430,8,123,68,92,13,27,99
"2011","Stockport 024D","E01005828","Total",586,219,72,147,367,93,48,65,75,14,27,45
"2011","Stockport 024E","E01005829","Total",498,128,55,73,370,58,52,74,69,15,30,72
"2011","Stockport 025A","E01005768","Total",615,146,86,60,469,12,119,82,91,22,48,95
"2011","Stockport 025B","E01005770","Total",629,229,134,95,400,9,96,92,83,19,37,64
"2011","Stockport 025C","E01005771","Total",545,137,66,71,408,20,56,105,115,21,31,60
"2011","Stockport 025D","E01005775","Total",624,179,103,76,445,11,95,125,103,13,43,55
"2011","Stockport 026A","E01005761","Total",550,152,64,88,398,38,44,92,95,24,39,66
"2011","Stockport 026B","E01005762","Total",664,229,116,113,435,102,56,54,84,23,46,70
"2011","Stockport 026C","E01005763","Total",648,170,55,115,478,69,46,90,122,33,46,72
"2011","Stockport 026D","E01005799","Total",701,191,33,158,510,112,31,122,115,25,45,60
"2011","Stockport 027A","E01005798","Total",787,401,182,219,386,25,91,60,103,18,33,56
"2011","Stockport 027B","E01005801","Total",634,195,82,113,439,47,58,108,128,8,25,65
"2011","Stockport 027C","E01005802","Total",597,135,60,75,462,23,67,113,114,16,37,92
"2011","Stockport 027D","E01005803","Total",602,158,101,57,444,13,88,103,97,15,34,94
"2011","Stockport 027E","E01005830","Total",707,270,124,146,437,41,90,88,114,6,23,75
"2011","Stockport 027F","E01005831","Total",664,194,72,122,470,37,60,103,151,18,28,73
"2011","Stockport 028A","E01005767","Total",591,151,103,48,440,5,158,50,70,15,43,99
"2011","Stockport 028B","E01005772","Total",573,170,103,67,403,9,108,68,67,25,50,76
"2011","Stockport 028C","E01005773","Total",635,197,107,90,438,20,95,108,93,16,37,69
"2011","Stockport 028D","E01005774","Total",684,322,168,154,362,28,80,78,86,9,29,52
"2011","Stockport 028E","E01005776","Total",598,165,106,59,433,10,87,85,82,22,44,103
"2011","Stockport 029A","E01005909","Total",645,153,94,59,492,18,137,92,103,14,28,100
"2011","Stockport 029B","E01005910","Total",707,268,134,134,439,38,81,80,125,13,34,68
"2011","Stockport 029C","E01005911","Total",540,135,86,49,405,14,116,70,89,13,24,79
"2011","Stockport 029D","E01005912","Total",610,163,80,83,447,21,119,74,126,12,23,72
"2011","Stockport 030A","E01005782","Total",552,173,85,88,379,10,91,70,104,9,15,80
"2011","Stockport 030B","E01005783","Total",654,168,90,78,486,25,124,91,114,18,24,90
"2011","Stockport 030C","E01005784","Total",529,110,67,43,419,11,116,86,74,14,40,78
"2011","Stockport 030D","E01005785","Total",641,191,94,97,450,14,93,102,98,19,34,90
"2011","Stockport 030E","E01005786","Total",610,142,85,57,468,15,100,99,85,21,47,101
"2011","Stockport 031A","E01005834","Total",631,207,90,117,424,36,52,101,103,11,35,86
"2011","Stockport 031B","E01005836","Total",851,297,138,159,554,32,155,93,149,21,34,70
"2011","Stockport 031C","E01005838","Total",852,352,118,234,500,66,70,110,156,17,10,71
"2011","Stockport 031D","E01005840","Total",732,298,128,170,434,42,75,79,126,14,27,71
"2011","Stockport 032A","E01005927","Total",491,70,42,28,421,15,75,99,94,17,34,87
"2011","Stockport 032B","E01005928","Total",674,190,94,96,484,70,98,79,114,20,27,76
"2011","Stockport 032C","E01005929","Total",610,202,107,95,408,8,127,79,87,14,25,68
"2011","Stockport 032D","E01005930","Total",600,105,67,38,495,6,146,83,111,22,50,77
"2011","Stockport 033A","E01005806","Total",495,107,71,36,388,11,100,91,82,10,24,70
"2011","Stockport 033B","E01005813","Total",612,173,80,93,439,17,94,78,112,17,30,91
"2011","Stockport 033C","E01005814","Total",547,131,93,38,416,12,133,65,69,10,39,88
"2011","Stockport 033D","E01005815","Total",586,120,82,38,466,28,114,107,105,15,31,66
"2011","Stockport 034A","E01005777","Total",682,235,111,124,447,33,118,89,105,9,26,67
"2011","Stockport 034B","E01005787","Total",474,76,52,24,398,5,94,64,73,19,43,100
"2011","Stockport 034C","E01005788","Total",603,147,68,79,456,25,95,114,90,18,28,86
"2011","Stockport 034D","E01005790","Total",511,174,83,91,337,30,30,72,87,12,34,72
"2011","Stockport 035A","E01005805","Total",591,134,97,37,457,12,85,122,95,15,30,98
"2011","Stockport 035B","E01005807","Total",623,132,100,32,491,10,139,91,96,15,37,103
"2011","Stockport 035C","E01005839","Total",522,92,54,38,430,10,128,68,95,14,35,80
"2011","Stockport 035D","E01005841","Total",625,153,83,70,472,31,128,93,96,15,38,71
"2011","Stockport 036A","E01005844","Total",553,149,97,52,404,17,120,48,69,15,55,80
"2011","Stockport 036B","E01005845","Total",604,141,97,44,463,13,102,68,92,19,53,116
"2011","Stockport 036C","E01005849","Total",607,133,87,46,474,14,119,69,93,25,41,113
"2011","Stockport 036D","E01005851","Total",611,161,96,65,450,11,132,67,81,16,50,93
"2011","Stockport 037A","E01005808","Total",526,98,70,28,428,22,100,92,83,16,31,84
"2011","Stockport 037B","E01005809","Total",498,109,53,56,389,25,92,82,66,15,25,84
"2011","Stockport 037C","E01005810","Total",658,201,115,86,457,24,127,89,108,11,28,70
"2011","Stockport 037D","E01005811","Total",636,221,84,137,415,14,76,83,118,14,24,86
"2011","Stockport 037E","E01005812","Total",479,75,52,23,404,7,98,78,88,24,32,77
"2011","Stockport 038A","E01005842","Total",673,163,100,63,510,18,140,101,115,19,26,91
"2011","Stockport 038B","E01005906","Total",646,173,131,42,473,3,182,62,116,13,30,67
"2011","Stockport 038C","E01005907","Total",609,188,121,67,421,16,176,59,87,9,13,61
"2011","Stockport 038D","E01005913","Total",649,198,124,74,451,15,134,81,112,14,25,70
"2011","Stockport 039A","E01005789","Total",655,205,89,116,450,10,91,118,102,18,36,75
"2011","Stockport 039B","E01005791","Total",647,183,102,81,464,24,99,103,104,16,29,89
"2011","Stockport 039C","E01005793","Total",621,182,89,93,439,25,100,82,120,8,27,77
"2011","Stockport 039D","E01005795","Total",527,129,71,58,398,19,100,74,85,16,27,77
"2011","Stockport 039E","E01005796","Total",497,109,64,45,388,16,74,106,82,9,20,81
"2011","Stockport 040A","E01005846","Total",614,143,75,68,471,11,101,90,100,26,59,84
"2011","Stockport 040B","E01005847","Total",619,163,72,91,456,21,90,88,99,15,41,102
"2011","Stockport 040C","E01005848","Total",730,185,114,71,545,30,122,95,128,17,36,117
"2011","Stockport 040D","E01005850","Total",759,244,120,124,515,42,91,92,132,14,53,91
"2011","Stockport 041A","E01005792","Total",603,143,96,47,460,14,133,80,100,19,29,85
"2011","Stockport 041B","E01005794","Total",504,130,84,46,374,10,83,73,84,5,36,83
"2011","Stockport 041C","E01005923","Total",626,128,90,38,498,10,174,102,91,16,36,69
"2011","Stockport 041D","E01005931","Total",643,199,140,59,444,20,140,77,102,14,33,58
"2011","Stockport 042A","E01005924","Total",528,134,86,48,394,14,104,87,72,17,32,68
"2011","Stockport 042B","E01005925","Total",612,203,158,45,409,11,116,88,88,11,32,63
"2011","Stockport 042C","E01005926","Total",485,94,58,36,391,13,96,66,96,18,34,68
"2011","Stockport 042D","E01005932","Total",535,78,56,22,457,10,123,87,106,15,33,83
"2011","Tameside 001A","E01006053","Total",818,236,59,177,582,28,78,138,204,16,26,92
"2011","Tameside 001B","E01006054","Total",759,316,141,175,443,42,90,69,120,22,31,69
"2011","Tameside 001C","E01006055","Total",639,203,43,160,436,25,55,100,166,11,15,64
"2011","Tameside 001D","E01006057","Total",644,172,58,114,472,43,56,99,163,11,24,76
"2011","Tameside 001E","E01006058","Total",945,397,110,287,548,49,63,111,214,11,35,65
"2011","Tameside 001F","E01006059","Total",612,171,49,122,441,28,80,102,132,12,26,61
"2011","Tameside 002A","E01005938","Total",670,191,81,110,479,36,90,89,109,26,39,90
"2011","Tameside 002B","E01005939","Total",494,95,56,39,399,15,110,48,74,6,50,96
"2011","Tameside 002C","E01005940","Total",596,155,92,63,441,17,105,72,85,16,36,110
"2011","Tameside 002D","E01005955","Total",632,111,56,55,521,25,80,102,132,22,54,106
"2011","Tameside 003A","E01006056","Total",507,165,56,109,342,62,41,69,78,18,32,42
"2011","Tameside 003B","E01006061","Total",962,261,85,176,701,89,75,158,168,32,68,111
"2011","Tameside 003C","E01006062","Total",813,145,60,85,668,27,99,165,184,29,41,123
"2011","Tameside 003D","E01006063","Total",564,111,41,70,453,23,60,92,123,8,48,99
"2011","Tameside 004A","E01005936","Total",637,159,65,94,478,25,105,78,136,9,35,90
"2011","Tameside 004B","E01005937","Total",692,214,96,118,478,86,97,91,103,11,23,67
"2011","Tameside 004C","E01005945","Total",743,226,66,160,517,88,56,100,101,39,57,76
"2011","Tameside 004D","E01005946","Total",676,204,64,140,472,48,45,113,126,13,34,93
"2011","Tameside 004E","E01005947","Total",756,311,105,206,445,67,42,107,127,14,32,56
"2011","Tameside 005A","E01005954","Total",777,387,201,186,390,23,94,54,111,8,31,69
"2011","Tameside 005B","E01005956","Total",578,146,83,63,432,20,74,67,125,6,43,97
"2011","Tameside 005C","E01005957","Total",589,164,72,92,425,30,68,97,107,18,29,76
"2011","Tameside 005D","E01005958","Total",659,230,88,142,429,62,65,85,101,17,27,72
"2011","Tameside 005E","E01005959","Total",655,166,71,95,489,68,64,96,88,19,50,104
"2011","Tameside 006A","E01005933","Total",548,136,43,93,412,62,39,78,78,26,51,78
"2011","Tameside 006B","E01005934","Total",614,144,64,80,470,48,81,84,133,12,36,76
"2011","Tameside 006C","E01005935","Total",656,251,124,127,405,65,50,66,109,21,33,61
"2011","Tameside 006D","E01005949","Total",715,271,121,150,444,35,58,75,157,13,34,72
"2011","Tameside 006E","E01005960","Total",723,282,93,189,441,71,43,92,115,15,32,73
"2011","Tameside 007A","E01005941","Total",731,288,71,217,443,55,61,91,117,19,45,55
"2011","Tameside 007B","E01005942","Total",701,184,81,103,517,36,90,106,155,10,45,75
"2011","Tameside 007C","E01005943","Total",828,287,83,204,541,50,79,101,190,13,39,69
"2011","Tameside 007D","E01005944","Total",554,125,50,75,429,15,69,87,117,19,34,88
"2011","Tameside 008A","E01006060","Total",687,299,73,226,388,64,42,74,115,11,26,56
"2011","Tameside 008B","E01006064","Total",724,287,151,136,437,67,91,62,102,15,33,67
"2011","Tameside 008C","E01006065","Total",500,105,40,65,395,73,31,79,80,24,43,65
"2011","Tameside 008D","E01006066","Total",598,200,67,133,398,44,47,96,118,6,26,61
"2011","Tameside 009A","E01006067","Total",727,169,57,112,558,24,59,132,167,21,49,106
"2011","Tameside 009B","E01006068","Total",834,403,148,255,431,36,56,98,170,9,14,48
"2011","Tameside 009C","E01006069","Total",650,175,62,113,475,77,52,82,102,21,51,90
"2011","Tameside 009D","E01006073","Total",721,236,58,178,485,83,40,105,128,27,34,68
"2011","Tameside 010A","E01005993","Total",615,195,94,101,420,24,87,72,105,10,35,87
"2011","Tameside 010B","E01005995","Total",508,77,32,45,431,16,50,88,101,8,53,115
"2011","Tameside 010C","E01005996","Total",804,218,72,146,586,73,72,128,161,18,41,93
"2011","Tameside 010D","E01005997","Total",673,257,115,142,416,47,70,65,96,13,36,89
"2011","Tameside 010E","E01006000","Total",822,425,230,195,397,39,93,50,97,6,26,86
"2011","Tameside 011A","E01005994","Total",605,158,66,92,447,55,54,100,116,9,30,83
"2011","Tameside 011B","E01005999","Total",840,304,119,185,536,78,70,110,135,18,40,85
"2011","Tameside 011C","E01006002","Total",560,164,98,66,396,34,75,63,69,20,42,93
"2011","Tameside 011D","E01006004","Total",603,129,72,57,474,22,98,79,95,15,53,112
"2011","Tameside 011E","E01006005","Total",634,251,92,159,383,71,61,69,101,9,24,48
"2011","Tameside 011F","E01006007","Total",655,194,71,123,461,60,64,92,123,8,42,72
"2011","Tameside 012A","E01005998","Total",729,209,61,148,520,53,76,101,152,17,36,85
"2011","Tameside 012B","E01006001","Total",647,175,88,87,472,50,76,77,123,11,54,81
"2011","Tameside 012C","E01006003","Total",617,181,78,103,436,37,76,75,113,15,35,85
"2011","Tameside 012D","E01006006","Total",604,142,77,65,462,27,80,84,124,10,36,101
"2011","Tameside 013A","E01005948","Total",959,557,65,492,402,47,40,71,141,22,31,50
"2011","Tameside 013B","E01005950","Total",584,109,26,83,475,46,40,92,79,50,94,74
"2011","Tameside 013C","E01005951","Total",731,280,86,194,451,67,52,101,123,19,21,68
"2011","Tameside 013D","E01005952","Total",1181,713,101,612,468,66,48,73,139,32,38,72
"2011","Tameside 013E","E01005953","Total",797,273,120,153,524,65,61,108,88,47,58,97
"2011","Tameside 014A","E01005961","Total",562,127,61,66,435,25,75,77,130,9,34,85
"2011","Tameside 014B","E01005962","Total",597,169,108,61,428,20,78,85,95,16,38,96
"2011","Tameside 014C","E01005968","Total",628,179,74,105,449,20,91,80,117,11,31,99
"2011","Tameside 014D","E01005969","Total",573,149,93,56,424,27,80,67,109,10,37,94
"2011","Tameside 015A","E01006022","Total",790,318,118,200,472,20,84,82,168,12,26,80
"2011","Tameside 015B","E01006023","Total",790,355,100,255,435,50,67,86,136,9,20,67
"2011","Tameside 015C","E01006070","Total",628,178,55,123,450,36,78,86,136,14,24,76
"2011","Tameside 015D","E01006071","Total",650,118,75,43,532,9,161,65,140,18,25,114
"2011","Tameside 015E","E01006072","Total",671,121,56,65,550,24,102,98,155,11,39,121
"2011","Tameside 016A","E01006009","Total",569,156,61,95,413,27,71,80,106,6,32,91
"2011","Tameside 016B","E01006017","Total",536,80,33,47,456,15,92,114,103,9,36,87
"2011","Tameside 016C","E01006018","Total",560,117,74,43,443,10,112,65,111,18,31,96
"2011","Tameside 016D","E01006021","Total",610,187,92,95,423,32,87,82,111,14,20,77
"2011","Tameside 017A","E01006008","Total",615,158,32,126,457,56,41,122,144,10,27,57
"2011","Tameside 017B","E01006010","Total",671,277,137,140,394,68,53,69,117,12,27,48
"2011","Tameside 017C","E01006012","Total",777,224,75,149,553,56,87,110,171,13,36,80
"2011","Tameside 017D","E01006015","Total",531,97,31,66,434,19,55,103,109,14,48,86
"2011","Tameside 017E","E01006016","Total",979,542,137,405,437,65,47,80,160,13,25,47
"2011","Tameside 018A","E01006011","Total",682,224,94,130,458,55,74,68,107,21,56,77
"2011","Tameside 018B","E01006013","Total",548,153,79,74,395,22,91,68,102,9,31,72
"2011","Tameside 018C","E01006014","Total",478,91,28,63,387,54,40,65,102,18,44,64
"2011","Tameside 018D","E01006019","Total",803,415,143,272,388,39,79,76,103,11,17,63
"2011","Tameside 018E","E01006020","Total",607,166,98,68,441,47,77,91,80,17,40,89
"2011","Tameside 019A","E01005963","Total",509,137,56,81,372,29,57,70,101,11,34,70
"2011","Tameside 019B","E01005964","Total",660,190,67,123,470,38,75,98,127,13,23,96
"2011","Tameside 019C","E01005965","Total",662,258,86,172,404,57,70,68,111,10,31,57
"2011","Tameside 019D","E01005966","Total",539,140,40,100,399,46,37,79,100,16,52,69
"2011","Tameside 019E","E01005967","Total",694,329,129,200,365,51,47,64,98,12,31,62
"2011","Tameside 020A","E01006031","Total",661,261,99,162,400,52,50,71,101,25,37,64
"2011","Tameside 020B","E01006032","Total",547,179,54,125,368,40,48,68,90,26,36,60
"2011","Tameside 020C","E01006033","Total",635,246,57,189,389,48,49,73,113,15,26,65
"2011","Tameside 020D","E01006034","Total",931,303,104,199,628,83,65,153,183,31,37,76
"2011","Tameside 020E","E01006035","Total",954,404,138,266,550,53,71,106,184,17,33,86
"2011","Tameside 020F","E01006036","Total",819,271,75,196,548,67,55,114,163,36,43,70
"2011","Tameside 021A","E01005970","Total",652,205,97,108,447,9,110,64,118,13,27,106
"2011","Tameside 021B","E01005972","Total",737,214,54,160,523,82,65,110,147,9,35,75
"2011","Tameside 021C","E01005974","Total",742,292,107,185,450,56,66,95,125,8,42,58
"2011","Tameside 021D","E01005975","Total",680,219,75,144,461,52,67,87,122,14,34,85
"2011","Tameside 022A","E01006024","Total",675,115,52,63,560,26,86,120,136,16,53,123
"2011","Tameside 022B","E01006026","Total",744,272,104,168,472,43,76,103,146,14,24,66
"2011","Tameside 022C","E01006037","Total",605,117,52,65,488,18,93,111,133,11,23,99
"2011","Tameside 022D","E01006038","Total",655,155,65,90,500,35,103,96,120,15,34,97
"2011","Tameside 023A","E01006047","Total",572,166,57,109,406,40,79,63,107,17,38,62
"2011","Tameside 023B","E01006048","Total",729,295,154,141,434,19,105,74,127,11,19,79
"2011","Tameside 023C","E01006049","Total",714,246,100,146,468,31,107,80,138,10,29,73
"2011","Tameside 023D","E01006051","Total",735,240,88,152,495,32,87,92,165,18,28,73
"2011","Tameside 024A","E01005985","Total",709,248,164,84,461,25,149,82,85,11,24,85
"2011","Tameside 024B","E01005987","Total",711,243,158,85,468,26,117,69,124,10,29,93
"2011","Tameside 024C","E01005988","Total",636,150,81,69,486,24,100,93,107,20,46,96
"2011","Tameside 024D","E01005990","Total",620,226,130,96,394,27,96,62,87,10,31,81
"2011","Tameside 024E","E01005991","Total",617,191,98,93,426,32,73,91,95,12,29,94
"2011","Tameside 025A","E01005971","Total",632,205,74,131,427,55,79,68,107,14,27,77
"2011","Tameside 025B","E01005986","Total",531,176,64,112,355,39,49,71,74,18,29,75
"2011","Tameside 025C","E01005989","Total",512,124,66,58,388,9,97,60,98,7,39,78
"2011","Tameside 025D","E01005992","Total",592,220,86,134,372,48,52,80,100,13,19,60
"2011","Tameside 026A","E01005973","Total",597,142,63,79,455,26,100,72,118,12,34,93
"2011","Tameside 026B","E01005976","Total",624,224,98,126,400,33,59,77,73,19,58,81
"2011","Tameside 026C","E01005977","Total",658,191,85,106,467,31,95,86,137,8,35,75
"2011","Tameside 026D","E01005978","Total",605,175,79,96,430,58,65,70,128,11,33,65
"2011","Tameside 027A","E01006025","Total",593,187,81,106,406,61,63,73,94,24,36,55
"2011","Tameside 027B","E01006027","Total",621,231,85,146,390,68,64,57,90,20,42,49
"2011","Tameside 027C","E01006050","Total",797,306,127,179,491,110,76,80,104,17,24,80
"2011","Tameside 027D","E01006052","Total",661,238,103,135,423,39,72,83,90,22,39,78
"2011","Tameside 028A","E01006028","Total",883,420,221,199,463,77,79,78,122,12,30,65
"2011","Tameside 028B","E01006029","Total",718,224,56,168,494,55,40,120,125,35,56,63
"2011","Tameside 028C","E01006030","Total",748,236,68,168,512,61,53,99,145,19,41,94
"2011","Tameside 028D","E01006039","Total",440,100,27,73,340,25,56,46,60,30,69,54
"2011","Tameside 028E","E01006040","Total",564,168,33,135,396,35,34,66,101,35,72,53
"2011","Tameside 028F","E01006041","Total",662,217,68,149,445,49,48,108,121,25,36,58
"2011","Tameside 029A","E01005979","Total",777,296,150,146,481,25,148,59,120,21,29,79
"2011","Tameside 029B","E01005980","Total",641,213,79,134,428,73,76,80,104,14,29,52
"2011","Tameside 029C","E01005981","Total",791,378,238,140,413,55,103,51,100,12,35,57
"2011","Tameside 029D","E01005982","Total",583,173,71,102,410,38,104,69,89,14,27,69
"2011","Tameside 029E","E01005983","Total",707,199,101,98,508,28,125,99,127,9,35,85
"2011","Tameside 029F","E01005984","Total",773,359,112,247,414,70,70,73,106,16,20,59
"2011","Tameside 030A","E01006042","Total",770,262,103,159,508,48,89,102,166,9,29,65
"2011","Tameside 030B","E01006043","Total",606,182,101,81,424,47,74,87,86,12,33,85
"2011","Tameside 030C","E01006044","Total",612,209,104,105,403,22,107,70,96,10,30,68
"2011","Tameside 030D","E01006045","Total",542,127,77,50,415,15,108,75,104,5,22,86
"2011","Tameside 030E","E01006046","Total",618,153,76,77,465,18,116,109,117,10,23,72
"2011","Trafford 001A","E01006109","Total",781,470,60,410,311,56,23,71,92,19,20,30
"2011","Trafford 001B","E01006110","Total",671,171,61,110,500,68,53,81,128,31,59,80
"2011","Trafford 001C","E01006111","Total",568,149,38,111,419,71,19,74,65,39,76,75
"2011","Trafford 001D","E01006112","Total",561,148,69,79,413,37,31,61,83,30,82,89
"2011","Trafford 001E","E01006185","Total",1015,513,81,432,502,65,35,64,210,15,49,64
"2011","Trafford 001F","E01006188","Total",566,163,32,131,403,41,30,84,89,31,59,69
"2011","Trafford 002A","E01006116","Total",536,111,53,58,425,37,74,101,99,14,30,70
"2011","Trafford 002B","E01006117","Total",637,117,68,49,520,17,113,116,100,18,45,111
"2011","Trafford 002C","E01006118","Total",608,199,111,88,409,29,76,94,76,10,42,82
"2011","Trafford 002D","E01006119","Total",636,134,76,58,502,13,99,107,125,12,37,109
"2011","Trafford 002E","E01006121","Total",614,123,52,71,491,52,77,91,126,12,41,92
"2011","Trafford 003A","E01006141","Total",585,133,56,77,452,35,56,90,103,32,55,81
"2011","Trafford 003B","E01006186","Total",792,238,84,154,554,66,44,103,189,25,43,84
"2011","Trafford 003C","E01006187","Total",1156,406,87,319,750,109,54,160,248,16,44,119
"2011","Trafford 003D","E01006189","Total",918,259,72,187,659,84,85,127,175,29,57,102
"2011","Trafford 004A","E01006113","Total",468,89,46,43,379,16,50,62,48,23,76,104
"2011","Trafford 004B","E01006114","Total",574,158,69,89,416,28,63,42,72,31,77,103
"2011","Trafford 004C","E01006115","Total",632,226,81,145,406,34,47,56,102,17,64,86
"2011","Trafford 004D","E01006145","Total",677,221,109,112,456,53,60,69,87,32,72,83
"2011","Trafford 004E","E01006146","Total",658,139,78,61,519,40,70,87,108,29,80,105
"2011","Trafford 005A","E01006122","Total",672,187,125,62,485,15,156,75,98,16,39,86
"2011","Trafford 005B","E01006123","Total",659,142,85,57,517,32,121,95,108,23,45,93
"2011","Trafford 005C","E01006124","Total",596,141,96,45,455,13,98,87,110,13,32,102
"2011","Trafford 005D","E01006128","Total",720,199,105,94,521,24,76,146,137,13,38,87
"2011","Trafford 005E","E01006131","Total",646,187,84,103,459,23,95,100,100,20,40,81
"2011","Trafford 006A","E01006155","Total",676,169,69,100,507,34,74,122,150,16,32,79
"2011","Trafford 006B","E01006157","Total",609,151,52,99,458,34,53,105,105,17,36,108
"2011","Trafford 006C","E01006159","Total",715,206,87,119,509,94,49,104,110,29,46,77
"2011","Trafford 006D","E01006182","Total",598,124,74,50,474,34,82,78,111,19,29,121
"2011","Trafford 006E","E01006183","Total",632,145,69,76,487,17,94,101,99,17,51,108
"2011","Trafford 007A","E01006125","Total",602,148,71,77,454,23,114,87,88,8,36,98
"2011","Trafford 007B","E01006126","Total",711,231,109,122,480,47,83,90,115,21,43,81
"2011","Trafford 007C","E01006127","Total",631,128,53,75,503,36,77,97,137,17,44,95
"2011","Trafford 007D","E01006130","Total",752,211,105,106,541,26,103,117,151,10,53,81
"2011","Trafford 007E","E01006132","Total",673,217,111,106,456,25,76,109,107,18,28,93
"2011","Trafford 008A","E01006156","Total",676,208,73,135,468,49,80,86,114,20,42,77
"2011","Trafford 008B","E01006158","Total",772,301,91,210,471,67,72,85,129,19,32,67
"2011","Trafford 008C","E01006179","Total",854,404,132,272,450,46,69,58,136,20,33,88
"2011","Trafford 008D","E01006184","Total",731,256,115,141,475,48,84,85,112,20,42,84
"2011","Trafford 009A","E01006198","Total",667,261,93,168,406,32,47,91,114,11,34,77
"2011","Trafford 009B","E01006199","Total",742,262,93,169,480,65,62,84,165,11,29,64
"2011","Trafford 009C","E01006200","Total",671,295,172,123,376,22,96,60,94,16,22,66
"2011","Trafford 009D","E01006201","Total",657,241,91,150,416,31,48,112,118,12,30,65
"2011","Trafford 009E","E01006202","Total",626,245,63,182,381,17,63,89,110,8,30,64
"2011","Trafford 010A","E01006120","Total",560,118,74,44,442,13,105,86,98,14,40,86
"2011","Trafford 010B","E01006129","Total",632,226,123,103,406,41,106,77,100,7,19,56
"2011","Trafford 010C","E01006133","Total",664,203,108,95,461,13,133,71,125,7,23,89
"2011","Trafford 010D","E01006197","Total",600,154,94,60,446,31,71,110,100,16,43,75
"2011","Trafford 010E","E01006203","Total",516,97,57,40,419,12,61,94,105,16,35,96
"2011","Trafford 011A","E01006142","Total",751,311,151,160,440,47,68,85,97,19,40,84
"2011","Trafford 011B","E01006143","Total",709,243,112,131,466,25,74,79,132,21,37,98
"2011","Trafford 011C","E01006144","Total",718,318,136,182,400,72,48,73,116,14,15,62
"2011","Trafford 011D","E01006180","Total",794,248,46,202,546,63,47,106,191,13,37,89
"2011","Trafford 011E","E01006181","Total",656,194,100,94,462,33,68,86,113,20,49,93
"2011","Trafford 012A","E01006147","Total",542,114,71,43,428,15,85,103,91,22,34,78
"2011","Trafford 012B","E01006149","Total",659,221,126,95,438,20,84,130,117,13,27,47
"2011","Trafford 012C","E01006150","Total",709,271,112,159,438,18,79,89,135,27,24,66
"2011","Trafford 012D","E01006154","Total",634,182,55,127,452,19,35,130,161,19,25,63
"2011","Trafford 012E","E01006165","Total",874,272,73,199,602,49,53,132,250,9,38,71
"2011","Trafford 013A","E01006166","Total",705,227,81,146,478,54,69,90,128,10,29,98
"2011","Trafford 013B","E01006169","Total",683,176,87,89,507,24,110,109,121,15,42,86
"2011","Trafford 013C","E01006170","Total",687,224,135,89,463,23,79,117,131,13,29,71
"2011","Trafford 013D","E01006171","Total",799,299,106,193,500,85,64,97,115,17,42,80
"2011","Trafford 014A","E01006098","Total",515,112,60,52,403,10,104,91,103,15,27,53
"2011","Trafford 014B","E01006099","Total",558,149,63,86,409,23,65,101,106,14,29,71
"2011","Trafford 014C","E01006164","Total",727,215,130,85,512,18,122,103,134,15,28,92
"2011","Trafford 014D","E01006174","Total",815,297,101,196,518,20,112,110,163,19,29,65
"2011","Trafford 014E","E01006178","Total",781,224,103,121,557,24,102,120,170,15,34,92
"2011","Trafford 015A","E01006097","Total",852,340,151,189,512,25,130,91,163,21,24,58
"2011","Trafford 015B","E01006160","Total",963,485,214,271,478,21,71,93,204,10,21,58
"2011","Trafford 015C","E01006161","Total",900,347,101,246,553,22,85,142,191,18,29,66
"2011","Trafford 015D","E01006162","Total",701,246,85,161,455,10,52,122,146,12,36,77
"2011","Trafford 015E","E01006163","Total",826,266,50,216,560,40,50,132,232,17,28,61
"2011","Trafford 016A","E01006148","Total",690,211,94,117,479,22,112,81,126,18,33,87
"2011","Trafford 016B","E01006151","Total",562,117,68,49,445,7,102,91,86,20,38,101
"2011","Trafford 016C","E01006152","Total",621,113,74,39,508,8,144,80,104,28,51,93
"2011","Trafford 016D","E01006153","Total",637,161,110,51,476,7,132,92,92,14,35,104
"2011","Trafford 016E","E01006172","Total",678,214,131,83,464,10,147,73,94,15,32,93
"2011","Trafford 017A","E01006104","Total",747,237,98,139,510,50,113,72,141,18,38,78
"2011","Trafford 017B","E01006105","Total",777,219,60,159,558,166,61,94,99,39,24,75
"2011","Trafford 017C","E01006106","Total",617,170,75,95,447,71,66,64,109,17,36,84
"2011","Trafford 017D","E01006107","Total",723,250,130,120,473,57,88,70,132,20,36,70
"2011","Trafford 017E","E01006108","Total",680,216,46,170,464,137,31,87,89,25,33,62
"2011","Trafford 018A","E01006102","Total",574,167,111,56,407,26,78,105,90,15,31,62
"2011","Trafford 018B","E01006173","Total",606,143,77,66,463,8,99,105,107,18,34,92
"2011","Trafford 018C","E01006175","Total",749,277,170,107,472,82,77,71,123,15,35,69
"2011","Trafford 018D","E01006176","Total",757,215,104,111,542,43,105,99,138,17,37,103
"2011","Trafford 018E","E01006177","Total",613,139,55,84,474,63,47,108,99,25,60,72
"2011","Trafford 019A","E01006091","Total",980,257,43,214,723,54,36,227,277,16,37,76
"2011","Trafford 019B","E01006092","Total",515,129,41,88,386,64,30,85,81,22,29,75
"2011","Trafford 019C","E01006095","Total",682,182,61,121,500,26,78,117,143,12,36,88
"2011","Trafford 019D","E01006167","Total",772,321,93,228,451,84,76,78,91,13,36,73
"2011","Trafford 019E","E01006168","Total",837,302,73,229,535,132,39,118,116,23,40,67
"2011","Trafford 020A","E01006090","Total",906,296,62,234,610,33,94,139,216,12,24,92
"2011","Trafford 020B","E01006094","Total",593,147,109,38,446,5,80,115,99,19,27,101
"2011","Trafford 020C","E01006096","Total",559,101,48,53,458,16,71,130,98,25,35,83
"2011","Trafford 020D","E01006100","Total",611,168,90,78,443,13,67,99,121,21,36,86
"2011","Trafford 020E","E01006103","Total",602,103,61,42,499,18,74,139,122,14,37,95
"2011","Trafford 021A","E01006101","Total",557,81,47,34,476,9,97,132,106,17,31,84
"2011","Trafford 021B","E01006190","Total",647,129,70,59,518,6,101,125,127,20,36,103
"2011","Trafford 021C","E01006195","Total",658,107,64,43,551,17,106,129,115,21,50,113
"2011","Trafford 021D","E01006196","Total",692,145,68,77,547,20,82,148,133,14,40,110
"2011","Trafford 021E","E01006210","Total",675,183,82,101,492,21,93,122,111,26,30,89
"2011","Trafford 022A","E01006204","Total",692,224,141,83,468,17,101,93,111,15,40,91
"2011","Trafford 022B","E01006206","Total",776,233,105,128,543,64,86,104,136,27,42,84
"2011","Trafford 022C","E01006207","Total",795,367,109,258,428,53,58,101,105,10,31,70
"2011","Trafford 022D","E01006208","Total",653,165,74,91,488,56,93,75,122,33,30,79
"2011","Trafford 022E","E01006211","Total",642,191,107,84,451,32,88,87,105,26,42,71
"2011","Trafford 023A","E01006093","Total",608,130,56,74,478,24,74,127,117,14,44,78
"2011","Trafford 023B","E01006191","Total",645,134,78,56,511,18,111,115,97,19,39,112
"2011","Trafford 023C","E01006192","Total",632,173,113,60,459,18,106,95,101,20,41,78
"2011","Trafford 023D","E01006205","Total",563,137,84,53,426,9,118,93,88,24,31,63
"2011","Trafford 023E","E01006209","Total",630,143,101,42,487,15,132,96,102,24,35,83
"2011","Trafford 024A","E01006078","Total",856,268,95,173,588,33,57,142,243,8,10,95
"2011","Trafford 024B","E01006080","Total",788,251,93,158,537,20,74,140,165,14,31,93
"2011","Trafford 024C","E01006089","Total",632,160,63,97,472,20,61,115,167,11,35,63
"2011","Trafford 024D","E01006193","Total",624,152,73,79,472,23,93,115,128,17,28,68
"2011","Trafford 024E","E01006194","Total",983,284,76,208,699,57,46,228,229,23,31,85
"2011","Trafford 025A","E01006074","Total",619,190,112,78,429,27,74,94,102,18,46,68
"2011","Trafford 025B","E01006075","Total",887,340,151,189,547,18,111,121,174,29,31,63
"2011","Trafford 025C","E01006076","Total",779,318,155,163,461,25,160,65,111,18,25,57
"2011","Trafford 025D","E01006079","Total",879,273,65,208,606,31,100,135,200,17,41,82
"2011","Trafford 025E","E01006087","Total",584,120,54,66,464,12,125,70,96,21,52,88
"2011","Trafford 026A","E01006083","Total",488,77,51,26,411,7,74,101,72,36,41,80
"2011","Trafford 026B","E01006084","Total",641,148,66,82,493,3,92,131,99,32,54,82
"2011","Trafford 026C","E01006088","Total",654,186,63,123,468,22,54,154,131,24,16,67
"2011","Trafford 026D","E01006139","Total",709,193,94,99,516,28,74,134,157,33,31,59
"2011","Trafford 026E","E01006140","Total",639,137,63,74,502,30,82,144,106,33,36,71
"2011","Trafford 027A","E01006077","Total",776,314,129,185,462,23,65,93,175,17,25,64
"2011","Trafford 027B","E01006081","Total",503,76,41,35,427,3,114,86,77,19,44,84
"2011","Trafford 027C","E01006082","Total",675,187,71,116,488,13,132,86,127,25,33,72
"2011","Trafford 027D","E01006085","Total",622,175,88,87,447,21,87,106,118,28,27,60
"2011","Trafford 027E","E01006086","Total",675,190,92,98,485,29,116,97,105,20,40,78
"2011","Trafford 028A","E01006134","Total",528,79,51,28,449,14,81,89,87,20,54,104
"2011","Trafford 028B","E01006135","Total",619,136,86,50,483,13,149,91,89,25,40,76
"2011","Trafford 028C","E01006136","Total",614,153,105,48,461,12,128,85,87,28,42,79
"2011","Trafford 028D","E01006137","Total",492,85,65,20,407,8,103,69,51,19,65,92
"2011","Trafford 028E","E01006138","Total",794,285,190,95,509,26,149,91,112,18,37,76
"2011","Wigan 001A","E01006315","Total",518,128,71,57,390,11,90,86,101,7,27,68
"2011","Wigan 001B","E01006316","Total",618,127,57,70,491,10,100,94,158,10,26,93
"2011","Wigan 001C","E01006317","Total",662,185,102,83,477,40,112,82,115,8,28,92
"2011","Wigan 001D","E01006319","Total",523,95,46,49,428,38,33,132,96,25,45,59
"2011","Wigan 002A","E01006229","Total",669,181,86,95,488,23,143,73,128,9,28,84
"2011","Wigan 002B","E01006230","Total",584,137,75,62,447,14,85,88,117,6,41,96
"2011","Wigan 002C","E01006233","Total",555,84,51,33,471,12,103,100,108,13,38,97
"2011","Wigan 002D","E01006237","Total",603,117,53,64,486,27,80,131,114,18,44,72
"2011","Wigan 002E","E01006238","Total",762,325,164,161,437,64,69,85,118,15,18,68
"2011","Wigan 003A","E01006259","Total",542,120,51,69,422,22,78,84,117,14,25,82
"2011","Wigan 003B","E01006312","Total",618,145,73,72,473,19,129,74,106,13,29,103
"2011","Wigan 003C","E01006313","Total",458,142,65,77,316,30,63,52,74,9,27,61
"2011","Wigan 003D","E01006314","Total",740,207,116,91,533,18,145,99,134,7,30,100
"2011","Wigan 003E","E01006318","Total",627,149,87,62,478,21,139,71,117,9,31,90
"2011","Wigan 003F","E01006320","Total",560,122,52,70,438,16,100,78,116,8,29,91
"2011","Wigan 003G","E01006321","Total",703,166,62,104,537,28,80,112,173,16,35,93
"2011","Wigan 004A","E01006231","Total",620,142,67,75,478,23,104,87,129,12,29,94
"2011","Wigan 004B","E01006232","Total",761,194,57,137,567,14,105,124,166,14,46,98
"2011","Wigan 004C","E01006234","Total",536,138,68,70,398,19,114,61,94,11,20,79
"2011","Wigan 004D","E01006235","Total",698,241,128,113,457,60,93,94,110,15,27,58
"2011","Wigan 005A","E01006253","Total",666,176,95,81,490,44,126,81,106,17,34,82
"2011","Wigan 005B","E01006254","Total",634,155,61,94,479,94,64,103,83,27,43,65
"2011","Wigan 005C","E01006255","Total",655,170,75,95,485,22,118,85,128,11,24,97
"2011","Wigan 005D","E01006256","Total",606,160,62,98,446,32,70,111,116,11,25,81
"2011","Wigan 005E","E01006260","Total",638,176,97,79,462,48,80,96,105,20,30,83
"2011","Wigan 006A","E01006370","Total",834,413,92,321,421,29,55,76,140,12,23,86
"2011","Wigan 006B","E01006372","Total",660,142,67,75,518,10,133,94,119,12,36,114
"2011","Wigan 006C","E01006373","Total",642,172,84,88,470,22,87,82,139,14,29,97
"2011","Wigan 006D","E01006374","Total",693,219,120,99,474,14,107,116,117,13,26,81
"2011","Wigan 006E","E01006390","Total",699,220,120,100,479,36,128,72,105,10,27,101
"2011","Wigan 007A","E01006236","Total",660,164,73,91,496,17,131,79,153,9,20,87
"2011","Wigan 007B","E01006388","Total",744,244,99,145,500,41,96,101,127,16,27,92
"2011","Wigan 007C","E01006389","Total",512,77,17,60,435,41,33,96,121,14,39,91
"2011","Wigan 007D","E01006391","Total",667,158,90,68,509,16,133,78,133,14,35,100
"2011","Wigan 008A","E01006257","Total",532,141,62,79,391,27,61,86,95,11,35,76
"2011","Wigan 008B","E01006258","Total",715,215,101,114,500,49,94,104,121,12,34,86
"2011","Wigan 008C","E01006369","Total",910,444,113,331,466,59,59,76,170,9,21,72
"2011","Wigan 008D","E01006371","Total",661,194,65,129,467,27,75,81,139,17,33,95
"2011","Wigan 008E","E01006375","Total",674,203,78,125,471,21,75,104,129,22,35,85
"2011","Wigan 009A","E01006306","Total",861,460,148,312,401,37,72,67,131,9,22,63
"2011","Wigan 009B","E01006307","Total",635,227,90,137,408,46,56,80,97,14,34,81
"2011","Wigan 009C","E01006386","Total",984,621,211,410,363,31,96,50,126,4,13,43
"2011","Wigan 009D","E01006387","Total",539,161,77,84,378,40,62,72,86,14,28,76
"2011","Wigan 009E","E01006392","Total",622,217,63,154,405,57,44,92,86,29,38,59
"2011","Wigan 010A","E01006350","Total",742,214,89,125,528,86,61,93,124,28,52,84
"2011","Wigan 010B","E01006351","Total",930,319,110,209,611,144,45,138,145,25,36,78
"2011","Wigan 010C","E01006357","Total",654,194,87,107,460,68,48,89,87,32,49,87
"2011","Wigan 010D","E01006360","Total",729,254,74,180,475,97,51,94,89,22,35,87
"2011","Wigan 010E","E01006361","Total",690,252,53,199,438,76,48,97,99,21,35,62
"2011","Wigan 011A","E01006356","Total",608,191,66,125,417,47,56,77,85,19,47,86
"2011","Wigan 011B","E01006396","Total",566,117,39,78,449,26,63,86,121,11,38,104
"2011","Wigan 011C","E01006397","Total",576,258,138,120,318,26,67,64,92,9,7,53
"2011","Wigan 011D","E01006398","Total",507,179,57,122,328,30,50,71,99,4,19,55
"2011","Wigan 011E","E01006399","Total",701,228,106,122,473,41,90,83,136,13,35,75
"2011","Wigan 012A","E01006305","Total",707,213,78,135,494,64,56,93,105,30,51,95
"2011","Wigan 012B","E01006308","Total",684,217,77,140,467,55,59,96,120,20,37,80
"2011","Wigan 012C","E01006309","Total",633,169,40,129,464,62,41,100,110,22,32,97
"2011","Wigan 012D","E01006310","Total",698,277,126,151,421,61,52,91,108,15,43,51
"2011","Wigan 012E","E01006311","Total",650,168,55,113,482,68,60,91,127,22,41,73
"2011","Wigan 013A","E01006269","Total",735,264,112,152,471,38,100,95,105,14,39,80
"2011","Wigan 013B","E01006271","Total",742,205,68,137,537,38,105,89,134,11,52,108
"2011","Wigan 013C","E01006272","Total",701,228,86,142,473,40,55,117,151,10,42,58
"2011","Wigan 013D","E01006273","Total",662,174,69,105,488,54,89,79,146,14,23,83
"2011","Wigan 013E","E01006276","Total",868,167,59,108,701,54,79,194,186,25,59,104
"2011","Wigan 014A","E01006353","Total",656,157,82,75,499,40,102,75,137,6,43,96
"2011","Wigan 014B","E01006354","Total",648,205,103,102,443,45,68,98,106,10,33,83
"2011","Wigan 014C","E01006355","Total",694,194,72,122,500,39,104,100,154,6,24,73
"2011","Wigan 014D","E01006358","Total",805,288,122,166,517,58,86,82,157,14,28,92
"2011","Wigan 014E","E01006359","Total",610,164,76,88,446,48,57,87,105,18,44,87
"2011","Wigan 015A","E01006349","Total",886,356,111,245,530,49,59,91,214,11,24,82
"2011","Wigan 015B","E01006352","Total",754,265,79,186,489,44,67,93,166,16,26,77
"2011","Wigan 015C","E01006404","Total",703,240,99,141,463,43,57,102,135,21,46,59
"2011","Wigan 015D","E01006405","Total",646,237,89,148,409,46,75,66,114,12,22,74
"2011","Wigan 015E","E01006411","Total",834,427,108,319,407,77,57,82,94,21,26,50
"2011","Wigan 016A","E01006270","Total",664,240,110,130,424,27,104,64,90,18,37,84
"2011","Wigan 016B","E01006274","Total",663,240,114,126,423,54,73,78,90,21,33,74
"2011","Wigan 016C","E01006275","Total",654,217,114,103,437,74,66,81,76,19,30,91
"2011","Wigan 016D","E01006277","Total",628,84,15,69,544,28,33,182,130,14,54,103
"2011","Wigan 016E","E01006286","Total",642,163,73,90,479,16,144,60,123,6,31,99
"2011","Wigan 017A","E01006239","Total",1008,482,162,320,526,61,75,99,162,17,35,77
"2011","Wigan 017B","E01006240","Total",629,161,38,123,468,82,49,88,107,31,35,76
"2011","Wigan 017C","E01006241","Total",762,172,53,119,590,81,71,117,146,32,48,95
"2011","Wigan 017D","E01006287","Total",478,77,40,37,401,13,63,73,120,11,23,98
"2011","Wigan 017E","E01006289","Total",863,383,112,271,480,89,69,80,126,14,35,67
"2011","Wigan 018A","E01006362","Total",748,180,92,88,568,20,144,114,135,18,34,103
"2011","Wigan 018B","E01006363","Total",725,241,178,63,484,21,167,64,102,11,30,89
"2011","Wigan 018C","E01006364","Total",814,277,137,140,537,55,93,107,136,17,40,89
"2011","Wigan 018D","E01006365","Total",820,139,56,83,681,42,81,210,162,17,55,114
"2011","Wigan 018E","E01006366","Total",798,281,121,160,517,31,142,83,124,12,25,100
"2011","Wigan 018F","E01006367","Total",699,178,98,80,521,18,136,101,148,7,28,83
"2011","Wigan 018G","E01006368","Total",716,188,95,93,528,43,136,103,120,11,29,86
"2011","Wigan 019A","E01006278","Total",697,185,89,96,512,41,135,76,133,10,31,86
"2011","Wigan 019B","E01006279","Total",613,108,44,64,505,24,76,113,140,13,43,96
"2011","Wigan 019C","E01006280","Total",627,198,119,79,429,43,85,77,101,10,24,89
"2011","Wigan 019D","E01006281","Total",725,149,62,87,576,37,98,127,170,10,36,98
"2011","Wigan 019E","E01006285","Total",714,125,61,64,589,18,116,111,159,13,44,128
"2011","Wigan 020A","E01006406","Total",626,158,77,81,468,19,120,62,123,14,34,96
"2011","Wigan 020B","E01006407","Total",591,119,33,86,472,18,55,104,135,10,39,111
"2011","Wigan 020C","E01006408","Total",644,163,75,88,481,46,80,88,129,21,37,80
"2011","Wigan 020D","E01006409","Total",590,141,81,60,449,15,120,76,108,5,31,94
"2011","Wigan 020E","E01006410","Total",538,88,39,49,450,16,84,75,121,9,48,97
"2011","Wigan 021A","E01006393","Total",605,135,46,89,470,23,75,73,149,20,38,92
"2011","Wigan 021B","E01006394","Total",648,140,69,71,508,16,133,80,128,7,34,110
"2011","Wigan 021C","E01006395","Total",859,94,20,74,765,34,56,258,183,33,65,136
"2011","Wigan 021D","E01006400","Total",504,81,21,60,423,26,39,106,129,11,37,75
"2011","Wigan 021E","E01006401","Total",565,95,45,50,470,15,93,97,131,12,38,84
"2011","Wigan 021F","E01006402","Total",471,89,43,46,382,13,71,77,99,6,22,94
"2011","Wigan 021G","E01006403","Total",682,123,56,67,559,24,143,92,136,20,36,108
"2011","Wigan 022A","E01006290","Total",619,174,79,95,445,20,117,65,124,8,25,86
"2011","Wigan 022B","E01006291","Total",676,241,94,147,435,40,76,87,129,15,27,61
"2011","Wigan 022C","E01006292","Total",648,153,65,88,495,35,110,81,121,14,28,106
"2011","Wigan 022D","E01006293","Total",729,272,89,183,457,42,81,95,136,17,19,67
"2011","Wigan 023A","E01006242","Total",760,249,106,143,511,26,106,106,162,9,23,79
"2011","Wigan 023B","E01006243","Total",876,224,79,145,652,35,109,148,210,17,42,91
"2011","Wigan 023C","E01006244","Total",848,412,178,234,436,56,93,78,123,8,12,66
"2011","Wigan 023D","E01006245","Total",1081,319,96,223,762,90,91,187,232,12,35,115
"2011","Wigan 024A","E01006213","Total",710,243,81,162,467,79,57,97,113,12,43,66
"2011","Wigan 024B","E01006215","Total",735,261,86,175,474,71,79,72,120,20,31,81
"2011","Wigan 024C","E01006217","Total",934,229,103,126,705,68,81,183,185,26,55,107
"2011","Wigan 024D","E01006218","Total",864,240,53,187,624,76,70,150,188,21,41,78
"2011","Wigan 024E","E01006219","Total",523,107,39,68,416,42,50,54,133,15,23,99
"2011","Wigan 025A","E01006288","Total",736,199,76,123,537,82,76,105,127,22,37,88
"2011","Wigan 025B","E01006294","Total",909,315,75,240,594,95,41,154,188,9,32,75
"2011","Wigan 025C","E01006295","Total",803,351,109,242,452,51,52,105,141,11,25,67
"2011","Wigan 025D","E01006377","Total",667,173,69,104,494,28,86,94,133,9,37,107
"2011","Wigan 025E","E01006378","Total",591,138,75,63,453,16,135,71,124,5,20,82
"2011","Wigan 026A","E01006212","Total",570,124,63,61,446,21,97,88,120,10,28,82
"2011","Wigan 026B","E01006214","Total",596,176,60,116,420,62,45,88,122,18,20,65
"2011","Wigan 026C","E01006216","Total",883,187,53,134,696,64,68,180,221,22,40,101
"2011","Wigan 026D","E01006322","Total",677,225,74,151,452,49,62,93,126,17,33,72
"2011","Wigan 026E","E01006329","Total",476,141,45,96,335,26,53,61,101,12,21,61
"2011","Wigan 027A","E01006282","Total",686,183,73,110,503,36,85,114,125,20,26,97
"2011","Wigan 027B","E01006283","Total",682,221,67,154,461,82,59,94,117,20,25,64
"2011","Wigan 027C","E01006284","Total",649,208,70,138,441,41,56,75,130,24,31,84
"2011","Wigan 027D","E01006336","Total",734,284,81,203,450,95,59,83,95,24,20,74
"2011","Wigan 027E","E01006337","Total",658,195,77,118,463,37,90,94,118,10,25,89
"2011","Wigan 028A","E01006376","Total",694,196,74,122,498,74,76,97,115,20,32,84
"2011","Wigan 028B","E01006381","Total",709,130,27,103,579,38,47,143,162,27,55,107
"2011","Wigan 028C","E01006382","Total",517,60,27,33,457,19,83,101,100,8,39,107
"2011","Wigan 028D","E01006383","Total",636,120,38,82,516,20,57,117,161,20,45,96
"2011","Wigan 028E","E01006384","Total",601,173,44,129,428,23,61,90,121,5,37,91
"2011","Wigan 029A","E01006250","Total",676,182,65,117,494,20,116,101,142,11,19,85
"2011","Wigan 029B","E01006251","Total",604,137,61,76,467,22,79,102,131,8,21,104
"2011","Wigan 029C","E01006379","Total",689,181,79,102,508,37,124,99,150,10,21,67
"2011","Wigan 029D","E01006380","Total",746,269,132,137,477,61,83,89,110,19,29,86
"2011","Wigan 029E","E01006385","Total",611,125,58,67,486,19,106,91,125,10,24,111
"2011","Wigan 030A","E01006328","Total",680,285,79,206,395,44,49,68,120,18,31,65
"2011","Wigan 030B","E01006333","Total",843,329,72,257,514,57,57,114,164,25,24,73
"2011","Wigan 030C","E01006334","Total",837,334,75,259,503,69,57,121,161,14,21,60
"2011","Wigan 030D","E01006338","Total",735,249,85,164,486,55,75,108,140,13,24,71
"2011","Wigan 031A","E01006248","Total",796,395,101,294,401,55,64,77,87,20,28,70
"2011","Wigan 031B","E01006249","Total",642,167,59,108,475,57,74,84,109,20,38,93
"2011","Wigan 031C","E01006330","Total",668,149,74,75,519,15,118,102,134,11,29,110
"2011","Wigan 031D","E01006331","Total",640,132,50,82,508,20,92,119,131,15,29,102
"2011","Wigan 031E","E01006332","Total",856,317,70,247,539,43,71,148,161,10,42,64
"2011","Wigan 032A","E01006262","Total",623,159,68,91,464,47,64,104,109,19,31,90
"2011","Wigan 032B","E01006263","Total",641,117,67,50,524,11,165,69,127,16,38,98
"2011","Wigan 032C","E01006266","Total",626,165,105,60,461,19,137,58,128,9,31,79
"2011","Wigan 032D","E01006267","Total",790,335,172,163,455,69,85,67,101,15,32,86
"2011","Wigan 032E","E01006268","Total",717,184,82,102,533,45,75,112,137,19,40,105
"2011","Wigan 033A","E01006323","Total",638,188,61,127,450,61,74,97,96,19,29,74
"2011","Wigan 033B","E01006324","Total",614,234,100,134,380,52,62,46,98,17,29,76
"2011","Wigan 033C","E01006325","Total",628,132,52,80,496,43,66,92,135,18,43,99
"2011","Wigan 033D","E01006326","Total",659,240,76,164,419,46,53,88,116,15,28,73
"2011","Wigan 033E","E01006327","Total",620,221,115,106,399,52,65,74,80,26,39,63
"2011","Wigan 034A","E01006246","Total",732,238,71,167,494,44,124,89,125,12,25,75
"2011","Wigan 034B","E01006247","Total",555,146,79,67,409,14,100,74,88,11,41,81
"2011","Wigan 034C","E01006252","Total",639,173,86,87,466,19,114,101,122,6,28,76
"2011","Wigan 034D","E01006297","Total",772,292,100,192,480,83,64,97,133,16,31,56
"2011","Wigan 034E","E01006335","Total",777,277,66,211,500,77,53,105,143,11,26,85
"2011","Wigan 035A","E01006220","Total",768,238,118,120,530,56,103,104,109,21,38,99
"2011","Wigan 035B","E01006221","Total",695,179,79,100,516,43,103,105,125,15,33,92
"2011","Wigan 035C","E01006222","Total",644,153,80,73,491,19,97,117,123,20,36,79
"2011","Wigan 035D","E01006224","Total",518,60,10,50,458,33,23,140,98,32,53,79
"2011","Wigan 035E","E01006226","Total",750,186,82,104,564,40,107,111,166,23,22,95
"2011","Wigan 036A","E01006223","Total",717,235,71,164,482,52,72,107,139,13,22,77
"2011","Wigan 036B","E01006225","Total",645,169,103,66,476,31,111,70,130,16,25,93
"2011","Wigan 036C","E01006261","Total",655,191,111,80,464,37,107,98,95,5,39,83
"2011","Wigan 036D","E01006264","Total",523,68,30,38,455,13,93,80,127,8,29,105
"2011","Wigan 036E","E01006265","Total",619,161,77,84,458,41,87,75,122,11,27,95
"2011","Wigan 037A","E01006296","Total",710,252,79,173,458,93,47,96,124,15,24,59
"2011","Wigan 037B","E01006298","Total",677,286,107,179,391,62,56,72,98,12,32,59
"2011","Wigan 037C","E01006299","Total",827,232,73,159,595,40,113,146,163,13,35,85
"2011","Wigan 037D","E01006300","Total",610,158,115,43,452,8,159,66,116,11,26,66
"2011","Wigan 037E","E01006301","Total",532,88,50,38,444,18,103,78,114,12,32,87
"2011","Wigan 038A","E01006227","Total",621,140,51,89,481,20,86,101,134,24,34,82
"2011","Wigan 038B","E01006228","Total",730,207,48,159,523,70,65,102,144,25,35,82
"2011","Wigan 038C","E01006342","Total",686,220,99,121,466,41,93,75,128,23,29,77
"2011","Wigan 038D","E01006344","Total",596,172,102,70,424,66,69,60,88,20,40,81
"2011","Wigan 038E","E01006346","Total",974,320,116,204,654,61,106,125,215,25,38,84
"2011","Wigan 039A","E01006339","Total",595,143,64,79,452,12,109,56,154,10,27,84
"2011","Wigan 039B","E01006340","Total",645,222,92,130,423,49,55,89,115,15,40,60
"2011","Wigan 039C","E01006343","Total",649,112,25,87,537,29,55,162,144,25,46,76
"2011","Wigan 039D","E01006345","Total",672,152,82,70,520,31,130,111,142,12,19,75
"2011","Wigan 039E","E01006348","Total",680,167,82,85,513,15,144,93,134,12,31,84
"2011","Wigan 040A","E01006302","Total",658,162,42,120,496,35,69,111,138,11,36,96
"2011","Wigan 040B","E01006303","Total",601,142,66,76,459,30,105,78,121,16,21,88
"2011","Wigan 040C","E01006304","Total",632,161,68,93,471,40,113,76,116,16,34,76
"2011","Wigan 040D","E01006341","Total",755,267,112,155,488,49,87,111,130,8,35,68
"2011","Wigan 040E","E01006347","Total",642,146,99,47,496,16,126,95,111,17,35,96
"2011","Burnley 001A","E01024859","Total",689,212,46,166,477,57,50,92,182,9,20,67
"2011","Burnley 001B","E01024861","Total",530,105,47,58,425,18,92,79,108,10,27,91
"2011","Burnley 001C","E01024862","Total",661,160,74,86,501,27,86,128,134,8,24,94
"2011","Burnley 001D","E01024891","Total",645,170,90,80,475,51,128,60,86,23,36,91
"2011","Burnley 001E","E01024892","Total",628,211,126,85,417,27,107,42,94,19,48,80
"2011","Burnley 001F","E01024894","Total",528,122,53,69,406,25,63,81,94,15,39,89
"2011","Burnley 002A","E01024893","Total",654,255,113,142,399,36,69,74,106,31,35,48
"2011","Burnley 002B","E01024896","Total",583,173,89,84,410,21,72,61,126,17,27,86
"2011","Burnley 002C","E01024897","Total",537,168,96,72,369,23,101,54,72,16,38,65
"2011","Burnley 002D","E01024898","Total",708,257,63,194,451,75,44,85,134,17,28,68
"2011","Burnley 003A","E01024856","Total",604,199,53,146,405,51,46,74,87,44,59,44
"2011","Burnley 003B","E01024875","Total",412,108,11,97,304,19,24,51,41,60,64,45
"2011","Burnley 003C","E01024876","Total",451,159,36,123,292,19,27,47,43,40,60,56
"2011","Burnley 003D","E01024877","Total",538,192,49,143,346,33,29,50,56,51,82,45
"2011","Burnley 003E","E01024878","Total",427,74,16,58,353,22,31,51,34,73,96,46
"2011","Burnley 003F","E01024895","Total",587,237,46,191,350,56,34,61,77,35,33,54
"2011","Burnley 004A","E01024883","Total",655,215,109,106,440,45,77,86,106,13,35,78
"2011","Burnley 004B","E01024884","Total",695,204,110,94,491,48,117,83,131,6,29,77
"2011","Burnley 004C","E01024885","Total",866,414,88,326,452,72,44,82,155,22,23,54
"2011","Burnley 004D","E01024886","Total",633,218,65,153,415,60,54,78,128,15,26,54
"2011","Burnley 004E","E01024889","Total",626,259,116,143,367,28,73,59,126,9,17,55
"2011","Burnley 004F","E01024890","Total",639,220,92,128,419,64,56,104,96,14,27,58
"2011","Burnley 005A","E01024879","Total",571,181,80,101,390,50,47,76,106,12,24,75
"2011","Burnley 005B","E01024880","Total",632,204,115,89,428,41,101,61,103,11,28,83
"2011","Burnley 005C","E01024912","Total",584,137,76,61,447,14,103,76,134,9,26,85
"2011","Burnley 005D","E01024913","Total",504,84,31,53,420,25,36,117,109,11,43,79
"2011","Burnley 005E","E01024914","Total",615,133,52,81,482,19,107,81,121,9,28,117
"2011","Burnley 006A","E01024881","Total",621,205,78,127,416,49,56,64,115,19,38,75
"2011","Burnley 006B","E01024882","Total",720,301,79,222,419,69,55,69,125,15,26,60
"2011","Burnley 006C","E01024902","Total",701,255,79,176,446,57,58,103,141,12,27,48
"2011","Burnley 006D","E01024911","Total",803,277,126,151,526,48,85,95,146,25,28,99
"2011","Burnley 007A","E01024855","Total",779,400,171,229,379,49,90,56,97,10,11,66
"2011","Burnley 007B","E01024857","Total",631,255,133,122,376,34,54,60,99,26,41,62
"2011","Burnley 007C","E01024858","Total",640,326,76,250,314,53,27,48,92,24,37,33
"2011","Burnley 007D","E01024864","Total",740,267,103,164,473,50,72,85,133,13,26,94
"2011","Burnley 008A","E01024863","Total",617,177,71,106,440,58,73,85,109,21,34,60
"2011","Burnley 008B","E01024865","Total",771,382,159,223,389,41,91,62,102,9,24,60
"2011","Burnley 008C","E01024866","Total",858,345,169,176,513,46,109,83,139,10,33,93
"2011","Burnley 008D","E01024867","Total",598,112,70,42,486,14,151,69,123,14,23,92
"2011","Burnley 009A","E01024860","Total",529,136,68,68,393,18,72,64,117,7,33,82
"2011","Burnley 009B","E01024868","Total",520,137,67,70,383,21,78,74,116,12,21,61
"2011","Burnley 009C","E01024869","Total",646,175,109,66,471,7,157,58,128,10,19,92
"2011","Burnley 009D","E01024870","Total",516,147,63,84,369,11,90,60,125,6,15,62
"2011","Burnley 010A","E01024872","Total",660,272,80,192,388,73,66,62,95,18,17,57
"2011","Burnley 010B","E01024899","Total",677,195,72,123,482,67,86,82,105,27,41,74
"2011","Burnley 010C","E01024900","Total",685,244,87,157,441,77,50,82,96,31,36,69
"2011","Burnley 010D","E01024907","Total",579,236,69,167,343,37,57,61,89,13,25,61
"2011","Burnley 010E","E01024908","Total",557,286,77,209,271,46,30,41,97,5,14,38
"2011","Burnley 010F","E01024909","Total",706,312,67,245,394,44,50,71,129,10,32,58
"2011","Burnley 011A","E01024874","Total",436,103,38,65,333,8,63,53,106,8,28,67
"2011","Burnley 011B","E01024887","Total",598,134,42,92,464,43,61,93,130,21,32,84
"2011","Burnley 011C","E01024888","Total",723,195,63,132,528,36,133,91,152,7,33,76
"2011","Burnley 011D","E01024901","Total",767,190,52,138,577,35,70,139,183,8,34,108
"2011","Burnley 014D","E01024871","Total",520,130,64,66,390,17,96,58,90,7,29,93
"2011","Burnley 014E","E01024873","Total",610,181,100,81,429,25,99,81,112,13,25,74
"2011","Burnley 014F","E01024903","Total",482,116,49,67,366,48,44,71,75,18,33,77
"2011","Burnley 014A","E01024904","Total",720,218,76,142,502,43,96,88,121,16,45,93
"2011","Burnley 014G","E01024905","Total",502,119,60,59,383,8,79,93,88,6,26,83
"2011","Burnley 014B","E01024906","Total",800,393,114,279,407,66,55,59,124,12,33,58
"2011","Burnley 014C","E01024910","Total",636,214,76,138,422,50,59,93,104,8,32,76
"2011","Chorley 001A","E01024951","Total",472,124,29,95,348,53,32,54,91,17,40,61
"2011","Chorley 001B","E01024952","Total",604,292,66,226,312,28,40,57,112,9,13,53
"2011","Chorley 001C","E01024953","Total",646,258,87,171,388,60,48,61,116,15,25,63
"2011","Chorley 001D","E01024954","Total",638,204,71,133,434,26,91,65,140,13,28,71
"2011","Chorley 002A","E01024921","Total",857,179,83,96,678,25,158,113,193,9,41,139
"2011","Chorley 002B","E01024978","Total",573,144,58,86,429,39,60,94,146,23,18,49
"2011","Chorley 002C","E01024979","Total",591,140,55,85,451,23,89,90,148,7,41,53
"2011","Chorley 002D","E01024980","Total",581,138,72,66,443,24,105,74,120,20,30,70
"2011","Chorley 003A","E01024946","Total",526,132,68,64,394,21,89,87,107,10,22,58
"2011","Chorley 003B","E01024947","Total",499,89,23,66,410,15,42,106,116,29,32,70
"2011","Chorley 003C","E01024955","Total",656,208,66,142,448,24,76,83,142,7,22,94
"2011","Chorley 003D","E01024956","Total",619,137,53,84,482,23,103,82,154,7,20,93
"2011","Chorley 003E","E01024957","Total",592,144,90,54,448,4,126,86,115,14,38,65
"2011","Chorley 003F","E01024958","Total",565,162,49,113,403,37,52,89,112,19,31,63
"2011","Chorley 004A","E01024948","Total",642,184,78,106,458,26,103,88,129,15,27,70
"2011","Chorley 004B","E01024949","Total",996,308,65,243,688,49,51,185,265,29,30,79
"2011","Chorley 004C","E01024950","Total",536,103,40,63,433,11,72,113,136,16,22,63
"2011","Chorley 004D","E01024977","Total",899,186,80,106,713,21,120,187,209,17,42,117
"2011","Chorley 005A","E01024967","Total",532,102,53,49,430,10,111,77,114,9,28,81
"2011","Chorley 005B","E01024968","Total",738,158,65,93,580,35,86,187,151,29,36,56
"2011","Chorley 005C","E01024969","Total",598,190,114,76,408,26,93,80,96,6,28,79
"2011","Chorley 005D","E01024970","Total",575,131,64,67,444,24,86,93,127,10,24,80
"2011","Chorley 005E","E01024971","Total",528,116,63,53,412,23,101,74,114,8,22,70
"2011","Chorley 005F","E01024972","Total",535,122,66,56,413,9,85,73,125,9,25,87
"2011","Chorley 006A","E01024929","Total",545,180,55,125,365,59,39,77,79,19,30,62
"2011","Chorley 006B","E01024930","Total",633,182,62,120,451,48,70,94,141,12,22,64
"2011","Chorley 006C","E01024931","Total",666,220,62,158,446,57,67,93,132,14,26,57
"2011","Chorley 006D","E01024932","Total",417,81,43,38,336,11,78,51,102,10,21,63
"2011","Chorley 006E","E01024933","Total",629,213,98,115,416,35,103,48,119,13,28,70
"2011","Chorley 006F","E01024937","Total",638,177,98,79,461,14,120,94,102,8,24,99
"2011","Chorley 007A","E01024964","Total",620,155,86,69,465,13,114,85,126,12,38,77
"2011","Chorley 007B","E01024974","Total",642,148,76,72,494,31,108,104,126,13,27,85
"2011","Chorley 007C","E01024975","Total",535,138,58,80,397,16,65,94,129,12,25,56
"2011","Chorley 007D","E01024976","Total",659,205,97,108,454,33,71,89,127,19,32,83
"2011","Chorley 008A","E01024919","Total",1113,360,82,278,753,81,62,182,264,27,44,93
"2011","Chorley 008B","E01024920","Total",920,281,153,128,639,22,185,88,200,14,17,113
"2011","Chorley 008C","E01024934","Total",621,169,105,64,452,18,128,80,102,11,28,85
"2011","Chorley 008D","E01024935","Total",627,164,119,45,463,11,155,65,119,15,28,70
"2011","Chorley 009A","E01024925","Total",761,309,150,159,452,63,46,104,108,30,41,60
"2011","Chorley 009B","E01024926","Total",854,311,106,205,543,73,62,102,150,23,48,85
"2011","Chorley 009C","E01024927","Total",732,217,88,129,515,41,97,119,148,15,24,71
"2011","Chorley 009D","E01024928","Total",656,200,69,131,456,31,80,87,126,20,22,90
"2011","Chorley 010A","E01024936","Total",754,311,129,182,443,32,63,81,161,12,22,72
"2011","Chorley 010B","E01024938","Total",699,182,91,91,517,22,120,96,145,17,39,78
"2011","Chorley 010C","E01024939","Total",701,137,80,57,564,19,149,99,136,21,42,98
"2011","Chorley 010D","E01024940","Total",851,392,98,294,459,44,62,107,141,8,25,72
"2011","Chorley 010E","E01024941","Total",742,300,135,165,442,43,62,83,136,23,25,70
"2011","Chorley 011A","E01024923","Total",523,126,68,58,397,11,106,55,105,11,32,77
"2011","Chorley 011B","E01024924","Total",600,135,71,64,465,11,123,67,136,11,31,86
"2011","Chorley 011C","E01024963","Total",673,193,112,81,480,30,116,85,123,12,22,92
"2011","Chorley 011D","E01024965","Total",570,122,68,54,448,13,115,70,113,11,40,86
"2011","Chorley 011E","E01024966","Total",657,164,77,87,493,24,110,112,123,16,36,72
"2011","Chorley 012A","E01024942","Total",779,320,131,189,459,62,73,101,119,14,25,65
"2011","Chorley 012B","E01024943","Total",946,245,55,190,701,119,48,184,197,27,33,93
"2011","Chorley 012C","E01024944","Total",636,104,26,78,532,27,40,163,143,23,52,84
"2011","Chorley 012D","E01024945","Total",1162,326,89,237,836,84,84,232,242,42,55,97
"2011","Chorley 013A","E01024922","Total",587,127,65,62,460,31,91,104,120,14,30,70
"2011","Chorley 013B","E01024959","Total",753,278,100,178,475,51,54,100,122,22,39,87
"2011","Chorley 013C","E01024960","Total",639,158,83,75,481,41,68,105,119,22,41,85
"2011","Chorley 013D","E01024961","Total",662,162,72,90,500,28,93,90,150,13,30,96
"2011","Chorley 013E","E01024962","Total",623,125,67,58,498,13,137,63,133,18,27,107
"2011","Chorley 014A","E01024915","Total",961,317,158,159,644,55,123,158,162,15,44,87
"2011","Chorley 014B","E01024916","Total",725,179,99,80,546,22,142,107,154,6,29,86
"2011","Chorley 014C","E01024917","Total",773,260,78,182,513,39,75,128,161,10,35,65
"2011","Chorley 014D","E01024918","Total",760,197,100,97,563,19,138,115,154,14,25,98
"2011","Chorley 014E","E01024973","Total",877,203,103,100,674,26,177,127,178,15,49,102
"2011","Fylde 001A","E01024993","Total",626,150,71,79,476,22,109,87,128,16,22,92
"2011","Fylde 001B","E01025026","Total",554,147,76,71,407,11,123,47,107,17,30,72
"2011","Fylde 001C","E01025027","Total",708,180,68,112,528,44,69,129,146,30,38,72
"2011","Fylde 001D","E01025028","Total",545,112,44,68,433,28,101,68,100,10,37,89
"2011","Fylde 001E","E01025031","Total",535,130,77,53,405,5,168,55,94,9,23,51
"2011","Fylde 002A","E01025007","Total",501,104,35,69,397,23,68,73,122,12,29,70
"2011","Fylde 002B","E01025008","Total",498,118,72,46,380,23,96,63,97,11,12,78
"2011","Fylde 002C","E01025009","Total",728,289,127,162,439,27,118,66,135,8,21,64
"2011","Fylde 002D","E01025011","Total",675,269,117,152,406,47,59,73,129,14,28,56
"2011","Fylde 002E","E01025012","Total",795,180,77,103,615,29,113,137,168,13,54,101
"2011","Fylde 002F","E01025013","Total",716,225,61,164,491,71,65,105,133,15,32,70
"2011","Fylde 002G","E01025019","Total",620,159,90,69,461,13,156,69,117,8,30,68
"2011","Fylde 003A","E01024998","Total",721,183,93,90,538,66,107,100,116,20,33,96
"2011","Fylde 003B","E01025010","Total",524,116,63,53,408,12,107,83,105,11,35,55
"2011","Fylde 003C","E01025014","Total",685,153,62,91,532,33,100,87,144,20,38,110
"2011","Fylde 003D","E01025015","Total",634,136,71,65,498,26,108,92,140,13,35,84
"2011","Fylde 004A","E01025004","Total",600,200,101,99,400,34,99,74,90,12,26,65
"2011","Fylde 004B","E01025006","Total",667,316,111,205,351,53,52,42,114,23,17,50
"2011","Fylde 004C","E01025023","Total",604,156,82,74,448,28,127,82,131,7,17,56
"2011","Fylde 004D","E01025024","Total",699,308,165,143,391,30,145,36,120,2,11,47
"2011","Fylde 004E","E01025025","Total",695,245,79,166,450,56,59,90,131,14,22,78
"2011","Fylde 005A","E01025001","Total",793,332,213,119,461,31,174,57,108,11,24,56
"2011","Fylde 005B","E01025002","Total",664,221,83,138,443,51,72,107,117,11,26,59
"2011","Fylde 005C","E01025005","Total",736,262,163,99,474,26,195,51,123,4,13,62
"2011","Fylde 005D","E01025016","Total",1024,257,138,119,767,20,236,156,199,18,42,96
"2011","Fylde 005E","E01025018","Total",565,168,111,57,397,20,150,63,79,4,19,62
"2011","Fylde 006A","E01024984","Total",670,222,124,98,448,15,156,61,112,9,25,70
"2011","Fylde 006B","E01024985","Total",627,207,124,83,420,20,107,70,113,15,23,72
"2011","Fylde 006C","E01024986","Total",916,581,241,340,335,17,109,37,110,11,14,37
"2011","Fylde 006D","E01024987","Total",753,444,74,370,309,63,32,42,107,4,15,46
"2011","Fylde 006E","E01024988","Total",844,475,201,274,369,36,120,48,96,6,19,44
"2011","Fylde 006F","E01024989","Total",656,231,92,139,425,38,88,77,111,12,35,64
"2011","Fylde 006G","E01024996","Total",639,358,122,236,281,15,70,43,76,11,24,42
"2011","Fylde 007A","E01024997","Total",671,240,121,119,431,17,116,59,136,11,28,64
"2011","Fylde 007B","E01024999","Total",691,222,135,87,469,28,113,69,134,13,27,85
"2011","Fylde 007C","E01025000","Total",596,185,95,90,411,19,116,44,128,12,21,71
"2011","Fylde 007D","E01025029","Total",924,297,164,133,627,29,214,96,150,9,28,101
"2011","Fylde 007E","E01025030","Total",683,176,54,122,507,86,59,104,132,15,32,79
"2011","Fylde 008A","E01024981","Total",685,260,154,106,425,10,168,47,117,6,11,66
"2011","Fylde 008B","E01024982","Total",622,298,165,133,324,14,109,54,78,9,22,38
"2011","Fylde 008C","E01024983","Total",625,200,89,111,425,30,66,99,115,15,40,60
"2011","Fylde 008D","E01024994","Total",722,217,120,97,505,15,166,88,136,12,20,68
"2011","Fylde 008E","E01024995","Total",664,260,132,128,404,11,132,68,90,7,28,68
"2011","Fylde 008F","E01025003","Total",792,286,180,106,506,25,176,88,109,11,20,77
"2011","Fylde 008G","E01025017","Total",813,423,303,120,390,31,139,45,96,6,20,53
"2011","Fylde 009A","E01024990","Total",815,364,152,212,451,24,131,82,144,14,19,37
"2011","Fylde 009B","E01024991","Total",517,251,129,122,266,14,100,27,81,7,13,24
"2011","Fylde 009C","E01024992","Total",734,294,197,97,440,25,216,40,94,4,6,55
"2011","Fylde 009D","E01025020","Total",559,164,61,103,395,55,66,71,105,16,22,60
"2011","Fylde 009E","E01025021","Total",681,251,116,135,430,18,118,80,110,13,28,63
"2011","Fylde 009F","E01025022","Total",874,306,98,208,568,69,89,128,180,14,30,58
"2011","Hyndburn 001A","E01025060","Total",602,185,53,132,417,62,42,82,115,26,30,60
"2011","Hyndburn 001B","E01025061","Total",682,244,160,84,438,13,159,50,102,11,39,64
"2011","Hyndburn 001C","E01025062","Total",715,312,94,218,403,63,49,84,96,23,40,48
"2011","Hyndburn 001D","E01025063","Total",694,271,109,162,423,24,100,57,95,22,39,86
"2011","Hyndburn 001E","E01025064","Total",689,178,98,80,511,14,154,86,120,9,25,103
"2011","Hyndburn 001F","E01025065","Total",764,280,88,192,484,64,74,88,147,14,29,68
"2011","Hyndburn 001G","E01025066","Total",642,153,47,106,489,38,70,114,138,22,28,79
"2011","Hyndburn 002A","E01025032","Total",617,203,71,132,414,47,75,69,112,20,33,58
"2011","Hyndburn 002B","E01025033","Total",807,123,21,102,684,46,43,210,179,34,71,101
"2011","Hyndburn 002C","E01025034","Total",719,197,53,144,522,43,104,87,152,27,21,88
"2011","Hyndburn 002D","E01025048","Total",689,202,113,89,487,25,100,74,141,23,32,92
"2011","Hyndburn 002E","E01025049","Total",780,306,99,207,474,70,80,84,147,14,22,57
"2011","Hyndburn 002F","E01025050","Total",638,179,49,130,459,36,73,94,141,12,32,71
"2011","Hyndburn 002G","E01025053","Total",641,165,56,109,476,42,80,111,126,14,29,74
"2011","Hyndburn 003A","E01025070","Total",493,142,55,87,351,55,46,64,97,15,28,46
"2011","Hyndburn 003B","E01025071","Total",616,223,86,137,393,34,58,65,102,11,37,86
"2011","Hyndburn 003C","E01025072","Total",641,244,84,160,397,57,65,77,99,21,28,50
"2011","Hyndburn 003D","E01025073","Total",591,190,64,126,401,31,88,63,123,14,22,60
"2011","Hyndburn 003E","E01025074","Total",571,120,70,50,451,8,142,81,88,9,41,82
"2011","Hyndburn 004A","E01025051","Total",602,232,59,173,370,36,56,65,98,19,28,68
"2011","Hyndburn 004B","E01025052","Total",638,152,70,82,486,24,96,93,158,9,30,76
"2011","Hyndburn 004C","E01025057","Total",692,223,118,105,469,31,99,86,116,16,39,82
"2011","Hyndburn 004D","E01025058","Total",655,252,131,121,403,42,114,67,98,10,20,52
"2011","Hyndburn 004E","E01025059","Total",672,249,111,138,423,50,100,75,97,17,16,68
"2011","Hyndburn 004F","E01025067","Total",709,291,79,212,418,73,47,72,117,26,27,56
"2011","Hyndburn 004G","E01025068","Total",738,325,112,213,413,67,46,76,131,22,31,40
"2011","Hyndburn 004H","E01025069","Total",632,198,62,136,434,67,42,101,114,21,29,60
"2011","Hyndburn 005A","E01025044","Total",500,144,57,87,356,40,56,70,81,19,30,60
"2011","Hyndburn 005B","E01025045","Total",514,173,77,96,341,59,50,61,58,29,27,57
"2011","Hyndburn 005C","E01025046","Total",628,293,126,167,335,47,46,58,116,12,18,38
"2011","Hyndburn 005D","E01025081","Total",662,142,56,86,520,28,85,99,144,15,53,96
"2011","Hyndburn 006A","E01025041","Total",660,275,124,151,385,53,51,52,59,42,66,62
"2011","Hyndburn 006B","E01025042","Total",619,153,42,111,466,45,41,64,63,74,108,71
"2011","Hyndburn 006E","E01025082","Total",664,194,79,115,470,97,52,69,86,31,51,84
"2011","Hyndburn 006F","E01025083","Total",811,268,87,181,543,94,67,111,133,26,51,61
"2011","Hyndburn 006G","E01025084","Total",551,150,43,107,401,55,38,54,78,54,57,65
"2011","Hyndburn 006H","E01033231","Total",880,233,70,163,647,64,61,110,88,84,142,98
"2011","Hyndburn 007A","E01025055","Total",708,275,108,167,433,68,68,92,116,13,26,50
"2011","Hyndburn 007B","E01025075","Total",779,281,69,212,498,54,58,118,160,12,35,61
"2011","Hyndburn 007C","E01025076","Total",637,266,139,127,371,42,64,85,80,14,31,55
"2011","Hyndburn 007D","E01025077","Total",632,221,111,110,411,43,102,51,122,6,29,58
"2011","Hyndburn 007E","E01025078","Total",631,141,50,91,490,24,101,101,132,15,30,87
"2011","Hyndburn 008A","E01025035","Total",647,212,95,117,435,22,88,70,110,13,40,92
"2011","Hyndburn 008B","E01025036","Total",783,389,77,312,394,50,43,66,143,20,24,48
"2011","Hyndburn 008C","E01025037","Total",624,190,63,127,434,58,85,95,100,6,23,67
"2011","Hyndburn 008D","E01025038","Total",600,159,93,66,441,26,126,74,113,8,30,64
"2011","Hyndburn 008E","E01025039","Total",492,112,56,56,380,12,66,82,104,7,28,81
"2011","Hyndburn 008F","E01025040","Total",624,161,47,114,463,21,89,94,132,12,33,82
"2011","Hyndburn 009A","E01025054","Total",769,267,102,165,502,26,97,80,147,15,52,85
"2011","Hyndburn 009B","E01025056","Total",606,156,90,66,450,15,134,69,131,8,25,68
"2011","Hyndburn 009C","E01025079","Total",723,184,100,84,539,32,141,78,138,9,34,107
"2011","Hyndburn 009D","E01025080","Total",668,183,70,113,485,31,78,83,144,10,37,102
"2011","Lancaster 001A","E01025088","Total",455,118,52,66,337,12,65,77,82,12,27,62
"2011","Lancaster 001B","E01025096","Total",675,180,60,120,495,27,80,123,146,20,21,78
"2011","Lancaster 001C","E01025097","Total",646,208,119,89,438,50,90,77,103,16,39,63
"2011","Lancaster 001D","E01025098","Total",596,174,82,92,422,22,102,74,144,7,15,58
"2011","Lancaster 001E","E01025148","Total",941,265,162,103,676,12,251,97,198,12,28,78
"2011","Lancaster 001F","E01025168","Total",523,175,78,97,348,31,80,63,110,8,12,44
"2011","Lancaster 001G","E01025169","Total",543,132,84,48,411,17,128,77,105,12,13,59
"2011","Lancaster 002A","E01025130","Total",956,269,144,125,687,21,209,117,189,19,31,101
"2011","Lancaster 002B","E01025132","Total",590,139,60,79,451,12,109,61,134,20,28,87
"2011","Lancaster 002C","E01025166","Total",541,161,90,71,380,17,140,53,94,7,17,52
"2011","Lancaster 002D","E01025167","Total",478,109,53,56,369,6,96,59,104,20,29,55
"2011","Lancaster 003A","E01025089","Total",627,199,111,88,428,19,112,65,116,14,26,76
"2011","Lancaster 003B","E01025090","Total",751,184,102,82,567,22,176,97,146,13,38,75
"2011","Lancaster 003C","E01025158","Total",620,178,125,53,442,13,170,68,95,12,22,62
"2011","Lancaster 003D","E01025159","Total",612,163,93,70,449,15,139,63,119,9,25,79
"2011","Lancaster 003E","E01025160","Total",554,129,92,37,425,11,152,65,103,9,25,60
"2011","Lancaster 004A","E01025085","Total",604,203,100,103,401,28,121,64,89,12,32,55
"2011","Lancaster 004B","E01025086","Total",656,223,152,71,433,13,181,52,104,11,21,51
"2011","Lancaster 004C","E01025087","Total",683,381,219,162,302,14,114,42,65,10,19,38
"2011","Lancaster 004D","E01025161","Total",627,269,193,76,358,14,188,28,75,2,10,41
"2011","Lancaster 005A","E01025108","Total",533,158,76,82,375,20,95,72,99,17,14,58
"2011","Lancaster 005B","E01025109","Total",447,122,76,46,325,11,82,65,85,12,28,42
"2011","Lancaster 005C","E01025131","Total",654,185,97,88,469,22,102,75,130,17,32,91
"2011","Lancaster 005D","E01025133","Total",676,225,141,84,451,22,147,81,118,8,20,55
"2011","Lancaster 006A","E01025112","Total",779,338,119,219,441,62,92,56,109,12,36,74
"2011","Lancaster 006B","E01025136","Total",715,286,126,160,429,95,53,84,91,17,41,48
"2011","Lancaster 006C","E01025138","Total",585,162,71,91,423,53,47,108,94,16,35,70
"2011","Lancaster 006D","E01025139","Total",853,434,112,322,419,64,60,54,125,19,35,62
"2011","Lancaster 006E","E01025140","Total",644,294,113,181,350,20,74,54,97,9,29,67
"2011","Lancaster 008A","E01025111","Total",728,199,83,116,529,64,79,113,127,16,38,92
"2011","Lancaster 008B","E01025113","Total",639,177,78,99,462,23,83,89,120,14,35,98
"2011","Lancaster 008C","E01025118","Total",478,172,58,114,306,43,56,53,62,14,24,54
"2011","Lancaster 008D","E01025119","Total",577,174,86,88,403,39,78,79,104,7,25,71
"2011","Lancaster 009A","E01025110","Total",697,358,61,297,339,55,25,71,101,11,23,53
"2011","Lancaster 009B","E01025116","Total",660,284,118,166,376,36,82,46,109,9,30,64
"2011","Lancaster 009C","E01025117","Total",646,290,43,247,356,60,20,58,102,18,40,58
"2011","Lancaster 009D","E01025120","Total",633,260,72,188,373,50,49,77,89,25,25,58
"2011","Lancaster 010A","E01025170","Total",834,297,163,134,537,47,181,89,128,16,16,60
"2011","Lancaster 010B","E01025171","Total",794,292,142,150,502,89,129,69,111,20,20,64
"2011","Lancaster 010C","E01025172","Total",656,166,62,104,490,52,95,94,142,14,25,68
"2011","Lancaster 010D","E01025173","Total",775,275,137,138,500,61,138,71,109,19,28,74
"2011","Lancaster 011A","E01025149","Total",970,329,95,234,641,70,63,148,220,20,31,89
"2011","Lancaster 011B","E01025150","Total",609,150,72,78,459,45,68,84,126,17,28,91
"2011","Lancaster 011C","E01025151","Total",777,331,94,237,446,65,48,74,161,5,20,73
"2011","Lancaster 011D","E01025152","Total",616,167,58,109,449,59,55,89,114,16,37,79
"2011","Lancaster 011E","E01025154","Total",633,267,147,120,366,76,70,43,76,20,29,52
"2011","Lancaster 013A","E01025091","Total",645,231,110,121,414,36,85,73,98,25,32,65
"2011","Lancaster 013B","E01025092","Total",513,170,79,91,343,49,52,76,74,16,22,54
"2011","Lancaster 013C","E01025095","Total",500,140,33,107,360,31,33,79,139,7,14,57
"2011","Lancaster 013D","E01025126","Total",763,177,52,125,586,20,75,137,182,18,29,125
"2011","Lancaster 014A","E01025093","Total",713,259,51,208,454,34,36,45,174,3,20,142
"2011","Lancaster 014B","E01025094","Total",616,284,100,184,332,36,27,60,126,7,10,66
"2011","Lancaster 014C","E01025099","Total",781,370,66,304,411,36,42,58,183,4,15,73
"2011","Lancaster 014E","E01033071","Total",572,294,38,256,278,13,16,25,146,7,8,63
"2011","Lancaster 014F","E01033073","Total",695,319,121,198,376,11,36,59,153,16,17,84
"2011","Lancaster 015A","E01025125","Total",379,86,27,59,293,22,22,23,92,2,11,121
"2011","Lancaster 015B","E01025128","Total",646,268,64,204,378,35,21,42,173,5,7,95
"2011","Lancaster 015C","E01025129","Total",473,135,30,105,338,16,14,46,109,11,16,126
"2011","Lancaster 015D","E01025147","Total",607,188,68,120,419,25,61,91,113,15,15,99
"2011","Lancaster 016A","E01025114","Total",681,216,128,88,465,17,144,79,106,13,29,77
"2011","Lancaster 016B","E01025115","Total",660,192,98,94,468,59,103,92,93,19,37,65
"2011","Lancaster 016C","E01025121","Total",739,177,64,113,562,52,117,108,165,11,40,69
"2011","Lancaster 016D","E01025122","Total",781,244,137,107,537,24,161,102,136,19,27,68
"2011","Lancaster 016E","E01025123","Total",905,183,67,116,722,51,110,183,196,26,52,104
"2011","Lancaster 016F","E01025124","Total",676,227,93,134,449,74,74,77,121,16,35,52
"2011","Lancaster 016I","E01033072","Total",1070,335,177,158,735,40,214,109,190,29,48,105
"2011","Lancaster 017A","E01025100","Total",668,222,75,147,446,43,50,95,159,17,16,66
"2011","Lancaster 017B","E01025101","Total",631,230,80,150,401,53,51,73,125,21,27,51
"2011","Lancaster 017C","E01025102","Total",533,166,69,97,367,16,45,64,87,15,35,105
"2011","Lancaster 017D","E01025103","Total",520,106,51,55,414,12,71,88,118,16,32,77
"2011","Lancaster 017E","E01025144","Total",797,300,100,200,497,33,66,90,183,12,20,93
"2011","Lancaster 017F","E01025146","Total",784,164,89,75,620,19,135,125,161,25,48,107
"2011","Lancaster 018A","E01025127","Total",600,154,91,63,446,7,123,89,118,5,30,74
"2011","Lancaster 018B","E01025141","Total",606,193,99,94,413,11,80,90,94,19,24,95
"2011","Lancaster 018C","E01025143","Total",639,225,125,100,414,41,81,74,98,9,28,83
"2011","Lancaster 018D","E01025145","Total",614,171,62,109,443,52,41,90,144,17,21,78
"2011","Lancaster 019A","E01025105","Total",517,98,43,55,419,9,92,77,109,21,32,79
"2011","Lancaster 019B","E01025106","Total",754,225,96,129,529,42,89,116,176,17,31,58
"2011","Lancaster 019C","E01025107","Total",679,163,64,99,516,11,120,78,156,25,31,95
"2011","Lancaster 019D","E01025142","Total",621,154,89,65,467,15,131,45,132,11,39,94
"2011","Lancaster 020A","E01025137","Total",604,161,90,71,443,31,86,96,104,15,34,77
"2011","Lancaster 020F","E01025153","Total",499,103,46,57,396,24,71,73,118,14,30,66
"2011","Lancaster 020G","E01025155","Total",510,118,62,56,392,18,76,70,110,17,25,76
"2011","Lancaster 020H","E01025156","Total",444,112,26,86,332,96,29,48,56,18,38,47
"2011","Lancaster 020I","E01025157","Total",572,245,134,111,327,34,68,62,84,9,22,48
"2011","Lancaster 020B","E01025162","Total",682,260,191,69,422,10,158,63,110,7,19,55
"2011","Lancaster 020C","E01025163","Total",628,180,115,65,448,13,152,74,97,7,22,83
"2011","Lancaster 020D","E01025164","Total",632,218,122,96,414,27,101,77,109,6,22,72
"2011","Lancaster 020E","E01025165","Total",587,124,32,92,463,31,61,127,122,18,38,66
"2011","Pendle 001A","E01025191","Total",530,139,70,69,391,18,79,84,103,10,28,69
"2011","Pendle 001B","E01025192","Total",604,197,63,134,407,45,57,95,106,19,23,62
"2011","Pendle 001C","E01025193","Total",609,172,110,62,437,30,112,83,116,7,22,67
"2011","Pendle 001D","E01025194","Total",623,217,101,116,406,43,49,81,126,14,28,65
"2011","Pendle 002A","E01025195","Total",518,133,50,83,385,16,71,78,124,10,20,66
"2011","Pendle 002B","E01025196","Total",810,370,84,286,440,35,73,74,165,14,30,49
"2011","Pendle 002C","E01025197","Total",569,150,78,72,419,5,113,67,101,14,33,86
"2011","Pendle 002D","E01025198","Total",602,216,108,108,386,24,76,68,96,22,36,64
"2011","Pendle 003A","E01025199","Total",733,195,75,120,538,29,123,93,168,16,31,78
"2011","Pendle 003B","E01025200","Total",661,206,88,118,455,24,82,85,144,21,31,68
"2011","Pendle 003C","E01025201","Total",689,203,101,102,486,37,91,80,145,22,37,74
"2011","Pendle 003D","E01025202","Total",595,138,59,79,457,29,104,74,146,12,30,62
"2011","Pendle 004A","E01025205","Total",606,198,58,140,408,60,36,93,115,13,32,59
"2011","Pendle 004B","E01025206","Total",511,125,79,46,386,19,110,53,105,8,26,65
"2011","Pendle 004C","E01025207","Total",681,318,104,214,363,39,51,57,143,5,17,51
"2011","Pendle 004D","E01025208","Total",664,366,175,191,298,31,63,42,74,7,22,59
"2011","Pendle 005A","E01025220","Total",655,189,69,120,466,102,57,95,100,26,32,54
"2011","Pendle 005B","E01025221","Total",521,120,46,74,401,48,53,89,95,20,36,60
"2011","Pendle 005C","E01025222","Total",616,158,66,92,458,24,94,80,134,16,34,76
"2011","Pendle 005D","E01025223","Total",621,245,92,153,376,39,58,66,102,20,24,67
"2011","Pendle 006A","E01025178","Total",793,229,113,116,564,28,114,110,169,10,33,100
"2011","Pendle 006B","E01025179","Total",701,196,78,118,505,35,91,104,160,7,23,85
"2011","Pendle 006C","E01025180","Total",774,171,72,99,603,28,110,132,175,16,37,105
"2011","Pendle 006D","E01025203","Total",748,194,89,105,554,10,133,89,192,15,32,83
"2011","Pendle 007A","E01025226","Total",784,364,98,266,420,59,56,68,134,20,26,57
"2011","Pendle 007B","E01025227","Total",977,442,104,338,535,73,82,86,145,30,30,89
"2011","Pendle 007C","E01025228","Total",648,162,64,98,486,37,71,102,149,16,37,74
"2011","Pendle 008A","E01025174","Total",613,156,77,79,457,16,120,68,130,17,27,79
"2011","Pendle 008B","E01025175","Total",661,175,80,95,486,22,111,94,131,14,30,84
"2011","Pendle 008C","E01025176","Total",1015,434,178,256,581,59,73,119,225,15,26,64
"2011","Pendle 008D","E01025177","Total",784,192,92,100,592,20,162,97,184,10,32,87
"2011","Pendle 008E","E01025204","Total",723,178,74,104,545,16,135,88,177,16,22,91
"2011","Pendle 008F","E01025211","Total",663,191,113,78,472,19,142,88,124,12,17,70
"2011","Pendle 009A","E01025181","Total",618,205,100,105,413,56,81,78,66,42,46,44
"2011","Pendle 009B","E01025182","Total",611,248,79,169,363,23,44,57,70,42,62,65
"2011","Pendle 009C","E01025183","Total",700,292,93,199,408,40,51,73,95,31,50,68
"2011","Pendle 009D","E01025184","Total",522,149,44,105,373,35,24,71,55,46,81,61
"2011","Pendle 010A","E01025188","Total",886,395,170,225,491,65,84,77,95,43,52,75
"2011","Pendle 010B","E01025189","Total",687,236,52,184,451,58,47,81,116,35,47,67
"2011","Pendle 010C","E01025210","Total",803,272,97,175,531,83,75,99,136,16,35,87
"2011","Pendle 010D","E01025217","Total",635,240,76,164,395,42,49,73,103,33,34,61
"2011","Pendle 010E","E01025218","Total",510,245,71,174,265,25,29,47,49,34,51,30
"2011","Pendle 010F","E01025219","Total",537,243,43,200,294,42,37,57,72,27,24,35
"2011","Pendle 011A","E01025224","Total",768,244,95,149,524,50,73,89,84,65,84,79
"2011","Pendle 011B","E01025225","Total",653,204,89,115,449,32,94,85,72,32,49,85
"2011","Pendle 011C","E01025229","Total",659,165,58,107,494,31,38,67,85,68,106,99
"2011","Pendle 011D","E01025230","Total",547,197,72,125,350,14,23,53,73,49,82,56
"2011","Pendle 012A","E01025187","Total",575,165,79,86,410,16,114,53,97,22,43,65
"2011","Pendle 012B","E01025190","Total",647,155,65,90,492,29,99,70,125,26,46,97
"2011","Pendle 012C","E01025209","Total",693,181,96,85,512,58,118,74,101,24,44,93
"2011","Pendle 012D","E01025216","Total",714,158,78,80,556,39,70,99,118,46,76,108
"2011","Pendle 013A","E01025185","Total",721,248,105,143,473,32,86,74,93,30,75,83
"2011","Pendle 013B","E01025186","Total",596,223,55,168,373,33,50,60,76,41,51,62
"2011","Pendle 013C","E01025212","Total",527,109,70,39,418,13,123,40,91,22,42,87
"2011","Pendle 013D","E01025213","Total",405,102,66,36,303,18,50,52,72,24,34,53
"2011","Pendle 013E","E01025214","Total",533,97,38,59,436,14,97,69,118,12,38,88
"2011","Pendle 013F","E01025215","Total",499,176,63,113,323,33,41,41,59,29,66,54
"2011","Preston 001A","E01025278","Total",1003,230,106,124,773,26,171,184,186,32,53,121
"2011","Preston 001B","E01025279","Total",722,140,58,82,582,7,131,92,135,23,68,126
"2011","Preston 001C","E01025282","Total",568,150,93,57,418,11,91,77,114,20,23,82
"2011","Preston 002A","E01025257","Total",505,69,40,29,436,9,97,74,97,12,37,110
"2011","Preston 002B","E01025277","Total",737,199,149,50,538,7,165,95,115,17,32,107
"2011","Preston 002C","E01025280","Total",703,148,55,93,555,25,105,90,148,18,51,118
"2011","Preston 002D","E01025281","Total",583,109,57,52,474,14,128,93,92,11,47,89
"2011","Preston 003A","E01025256","Total",636,207,144,63,429,10,119,75,84,20,40,81
"2011","Preston 003B","E01025258","Total",635,170,119,51,465,13,153,75,95,10,40,79
"2011","Preston 003C","E01025259","Total",874,237,134,103,637,24,156,132,145,16,49,115
"2011","Preston 003D","E01025299","Total",624,180,99,81,444,11,115,86,118,15,33,66
"2011","Preston 003E","E01025301","Total",469,146,26,120,323,27,32,72,85,19,21,67
"2011","Preston 003F","E01025302","Total",504,120,52,68,384,12,85,77,104,11,16,79
"2011","Preston 004A","E01025253","Total",692,157,20,137,535,27,17,166,192,19,42,72
"2011","Preston 004B","E01025254","Total",470,129,60,69,341,10,59,87,86,10,25,64
"2011","Preston 004C","E01025255","Total",588,107,12,95,481,34,50,131,132,19,56,59
"2011","Preston 004D","E01025300","Total",557,287,124,163,270,4,87,36,63,5,12,63
"2011","Preston 004E","E01025303","Total",608,215,68,147,393,23,59,72,123,9,31,76
"2011","Preston 005A","E01025260","Total",765,377,117,260,388,74,59,66,118,19,23,29
"2011","Preston 005B","E01025262","Total",719,287,127,160,432,42,89,65,107,16,26,87
"2011","Preston 005C","E01025263","Total",640,217,63,154,423,78,65,73,100,23,26,58
"2011","Preston 005D","E01025264","Total",652,223,51,172,429,69,57,62,115,16,30,80
"2011","Preston 006A","E01025239","Total",663,251,153,98,412,12,116,66,105,18,23,72
"2011","Preston 006B","E01025241","Total",666,214,113,101,452,13,103,81,107,14,44,90
"2011","Preston 006C","E01025242","Total",625,142,97,45,483,8,144,84,108,20,45,74
"2011","Preston 006D","E01025243","Total",786,281,100,181,505,20,73,96,142,30,57,87
"2011","Preston 006E","E01025251","Total",559,155,94,61,404,24,77,66,73,23,66,75
"2011","Preston 007A","E01025234","Total",563,156,50,106,407,32,55,89,99,15,39,78
"2011","Preston 007B","E01025235","Total",675,174,85,89,501,25,129,80,105,22,40,100
"2011","Preston 007C","E01025237","Total",653,213,105,108,440,60,69,67,109,13,39,83
"2011","Preston 007D","E01025238","Total",649,216,83,133,433,85,48,92,75,24,37,72
"2011","Preston 007E","E01025245","Total",928,243,92,151,685,97,65,116,118,62,116,111
"2011","Preston 007F","E01025252","Total",631,253,135,118,378,28,83,67,99,9,30,62
"2011","Preston 008A","E01025233","Total",523,120,58,62,403,14,71,89,80,18,46,85
"2011","Preston 008B","E01025240","Total",652,174,110,64,478,21,110,73,123,10,42,99
"2011","Preston 008C","E01025261","Total",651,224,111,113,427,13,116,62,123,13,26,74
"2011","Preston 008D","E01025266","Total",520,127,82,45,393,23,98,58,89,11,39,75
"2011","Preston 008E","E01025309","Total",514,164,84,80,350,33,72,54,94,13,24,60
"2011","Preston 009A","E01025236","Total",573,177,63,114,396,79,37,79,69,29,41,62
"2011","Preston 009B","E01025283","Total",627,166,59,107,461,129,40,78,72,34,50,58
"2011","Preston 009C","E01025284","Total",665,176,76,100,489,43,62,86,121,29,48,100
"2011","Preston 009D","E01025285","Total",513,131,52,79,382,38,67,47,68,26,53,83
"2011","Preston 009E","E01025286","Total",685,212,57,155,473,86,38,91,108,31,54,65
"2011","Preston 009F","E01025287","Total",991,482,130,352,509,84,61,83,146,33,37,65
"2011","Preston 010A","E01025270","Total",666,178,62,116,488,25,87,98,137,9,40,92
"2011","Preston 010B","E01025272","Total",616,145,46,99,471,17,50,108,142,21,47,86
"2011","Preston 010C","E01025273","Total",501,82,19,63,419,13,35,133,101,13,42,82
"2011","Preston 010D","E01025288","Total",899,462,65,397,437,48,40,73,217,8,7,44
"2011","Preston 011A","E01025246","Total",531,111,33,78,420,17,42,88,52,52,84,85
"2011","Preston 011B","E01025274","Total",818,306,50,256,512,50,27,77,164,13,17,164
"2011","Preston 011C","E01025275","Total",772,358,97,261,414,57,49,72,120,9,25,82
"2011","Preston 011D","E01025294","Total",667,203,42,161,464,36,26,104,106,34,49,109
"2011","Preston 012A","E01025276","Total",652,182,55,127,470,40,66,79,100,24,43,118
"2011","Preston 012B","E01025308","Total",741,237,42,195,504,73,27,89,159,21,21,114
"2011","Preston 012C","E01025310","Total",709,263,73,190,446,50,42,81,157,11,22,83
"2011","Preston 012D","E01025311","Total",666,269,88,181,397,54,40,83,146,12,13,49
"2011","Preston 012E","E01025312","Total",762,263,50,213,499,66,37,94,178,11,26,87
"2011","Preston 012F","E01025313","Total",652,337,82,255,315,36,33,41,113,7,11,74
"2011","Preston 012G","E01025314","Total",823,360,59,301,463,40,40,69,189,3,14,108
"2011","Preston 013A","E01025231","Total",591,197,90,107,394,12,87,77,95,15,45,63
"2011","Preston 013B","E01025232","Total",760,311,53,258,449,51,28,92,158,10,19,91
"2011","Preston 013C","E01025265","Total",648,193,57,136,455,38,59,86,146,18,28,80
"2011","Preston 013D","E01025267","Total",627,214,100,114,413,34,82,82,89,16,36,74
"2011","Preston 013E","E01025268","Total",811,364,137,227,447,67,63,93,114,9,28,73
"2011","Preston 013F","E01025269","Total",649,182,75,107,467,61,63,102,107,22,42,70
"2011","Preston 013G","E01025271","Total",620,162,94,68,458,42,93,65,92,19,50,97
"2011","Preston 014A","E01025295","Total",1090,613,181,432,477,65,56,74,171,28,31,52
"2011","Preston 014B","E01025296","Total",762,250,59,191,512,102,33,99,90,39,57,92
"2011","Preston 014C","E01025297","Total",829,283,67,216,546,103,40,109,121,41,48,84
"2011","Preston 014D","E01025298","Total",614,173,46,127,441,63,37,97,94,30,55,65
"2011","Preston 015A","E01025244","Total",511,96,24,72,415,30,30,81,69,39,88,78
"2011","Preston 015B","E01025292","Total",753,398,52,346,355,35,25,34,170,14,12,65
"2011","Preston 015C","E01025293","Total",924,438,128,310,486,54,63,62,114,26,66,101
"2011","Preston 016A","E01025247","Total",667,225,55,170,442,54,35,92,108,35,61,57
"2011","Preston 016B","E01025248","Total",509,134,48,86,375,86,37,77,72,24,31,48
"2011","Preston 016C","E01025249","Total",436,155,88,67,281,14,63,55,56,12,21,60
"2011","Preston 016D","E01025250","Total",642,205,38,167,437,75,38,73,75,39,57,80
"2011","Preston 016E","E01025304","Total",611,139,67,72,472,21,74,79,83,50,76,89
"2011","Preston 016F","E01025305","Total",664,247,73,174,417,52,49,52,93,24,61,86
"2011","Preston 017A","E01025289","Total",739,262,40,222,477,46,30,61,170,11,22,137
"2011","Preston 017B","E01025290","Total",785,391,43,348,394,33,20,47,122,14,27,131
"2011","Preston 017C","E01025291","Total",657,295,88,207,362,36,43,67,105,11,19,81
"2011","Preston 017D","E01025306","Total",854,448,52,396,406,17,24,42,169,18,43,93
"2011","Preston 017F","E01033223","Total",606,452,65,387,154,1,11,15,95,1,2,29
"2011","Preston 017G","E01033224","Total",600,370,85,285,230,30,15,34,104,11,7,29
"2011","Preston 017H","E01033226","Total",567,327,59,268,240,13,25,40,87,12,29,34
"2011","Ribble Valley 001A","E01025315","Total",544,134,60,74,410,13,98,68,88,23,37,83
"2011","Ribble Valley 001B","E01025320","Total",536,128,64,64,408,10,85,64,116,21,33,79
"2011","Ribble Valley 001C","E01025331","Total",563,137,68,69,426,14,92,81,116,19,35,69
"2011","Ribble Valley 001D","E01025348","Total",728,235,143,92,493,13,171,52,150,12,20,75
"2011","Ribble Valley 001E","E01025349","Total",573,133,64,69,440,7,105,96,117,18,21,76
"2011","Ribble Valley 002A","E01025334","Total",681,203,97,106,478,31,125,85,126,13,33,65
"2011","Ribble Valley 002B","E01025344","Total",624,230,123,107,394,32,89,88,91,12,32,50
"2011","Ribble Valley 002C","E01025345","Total",626,176,109,67,450,19,121,91,114,16,27,62
"2011","Ribble Valley 002D","E01025346","Total",652,191,62,129,461,37,62,115,134,18,23,72
"2011","Ribble Valley 002E","E01025347","Total",683,196,72,124,487,31,88,115,125,23,33,72
"2011","Ribble Valley 003A","E01025329","Total",614,191,118,73,423,20,109,78,93,15,32,76
"2011","Ribble Valley 003B","E01025330","Total",603,224,90,134,379,26,88,80,99,12,19,55
"2011","Ribble Valley 003C","E01025335","Total",706,339,173,166,367,40,93,61,87,18,18,50
"2011","Ribble Valley 003D","E01025338","Total",723,275,74,201,448,35,57,99,142,15,28,72
"2011","Ribble Valley 003E","E01025339","Total",649,209,96,113,440,28,92,86,104,12,26,92
"2011","Ribble Valley 004A","E01025322","Total",544,115,58,57,429,21,100,66,117,13,31,81
"2011","Ribble Valley 004B","E01025326","Total",629,187,101,86,442,26,94,67,127,14,28,86
"2011","Ribble Valley 004C","E01025327","Total",541,141,71,70,400,19,80,86,104,16,28,67
"2011","Ribble Valley 004D","E01025342","Total",667,183,81,102,484,30,113,86,120,18,31,86
"2011","Ribble Valley 005A","E01025321","Total",565,175,79,96,390,17,89,79,102,8,28,67
"2011","Ribble Valley 005B","E01025340","Total",609,177,74,103,432,32,92,80,112,12,31,73
"2011","Ribble Valley 005C","E01025341","Total",482,107,66,41,375,14,101,65,84,15,25,71
"2011","Ribble Valley 005D","E01025343","Total",614,179,86,93,435,27,89,91,120,19,23,66
"2011","Ribble Valley 005E","E01025354","Total",572,153,73,80,419,23,109,85,103,13,21,65
"2011","Ribble Valley 006A","E01025316","Total",567,110,48,62,457,19,90,81,115,14,44,94
"2011","Ribble Valley 006B","E01025317","Total",484,140,56,84,344,48,61,73,89,10,22,41
"2011","Ribble Valley 006C","E01025325","Total",737,313,156,157,424,36,67,77,131,13,35,65
"2011","Ribble Valley 006D","E01025328","Total",503,129,62,67,374,27,109,64,90,16,23,45
"2011","Ribble Valley 007A","E01025318","Total",454,136,77,59,318,23,61,61,86,20,17,50
"2011","Ribble Valley 007B","E01025319","Total",801,179,61,118,622,19,109,176,145,26,64,83
"2011","Ribble Valley 007C","E01025333","Total",536,161,73,88,375,9,94,73,105,7,28,59
"2011","Ribble Valley 007D","E01025350","Total",562,195,117,78,367,13,95,64,84,13,37,61
"2011","Ribble Valley 007E","E01025351","Total",979,246,124,122,733,42,155,186,158,36,57,99
"2011","Ribble Valley 008A","E01025323","Total",478,120,74,46,358,17,111,52,81,9,33,55
"2011","Ribble Valley 008B","E01025324","Total",593,150,71,79,443,33,113,95,109,13,23,57
"2011","Ribble Valley 008C","E01025332","Total",430,83,56,27,347,11,118,53,76,10,26,53
"2011","Ribble Valley 008D","E01025336","Total",489,124,66,58,365,18,98,62,102,11,18,56
"2011","Ribble Valley 008E","E01025337","Total",695,211,125,86,484,13,139,91,126,18,21,76
"2011","Ribble Valley 008F","E01025352","Total",554,112,77,35,442,14,110,91,83,16,38,90
"2011","Ribble Valley 008G","E01025353","Total",455,121,51,70,334,21,87,66,79,12,17,52
"2011","Rossendale 001A","E01025355","Total",837,146,54,92,691,33,90,155,195,28,51,139
"2011","Rossendale 001B","E01025361","Total",892,261,92,169,631,46,68,142,227,20,33,95
"2011","Rossendale 001C","E01025362","Total",822,206,86,120,616,18,109,154,187,22,39,87
"2011","Rossendale 001D","E01025393","Total",611,181,64,117,430,20,64,60,156,13,39,78
"2011","Rossendale 002A","E01025363","Total",551,186,105,81,365,25,75,74,82,11,35,63
"2011","Rossendale 002B","E01025364","Total",537,126,56,70,411,6,95,70,114,7,39,80
"2011","Rossendale 002C","E01025366","Total",594,188,42,146,406,53,47,70,89,32,58,57
"2011","Rossendale 002D","E01025395","Total",712,231,85,146,481,26,102,89,149,17,29,69
"2011","Rossendale 002E","E01025396","Total",660,321,102,219,339,39,58,49,84,19,45,45
"2011","Rossendale 002F","E01025397","Total",652,204,44,160,448,55,46,92,111,33,47,64
"2011","Rossendale 002G","E01025398","Total",557,165,50,115,392,56,42,88,93,28,36,49
"2011","Rossendale 003A","E01025367","Total",682,144,42,102,538,24,68,124,153,23,43,103
"2011","Rossendale 003B","E01025368","Total",701,223,76,147,478,42,84,100,132,19,26,75
"2011","Rossendale 003C","E01025369","Total",554,216,80,136,338,44,41,59,100,12,27,55
"2011","Rossendale 003D","E01025381","Total",618,187,59,128,431,57,66,94,104,22,18,70
"2011","Rossendale 003E","E01025382","Total",798,303,96,207,495,69,82,88,133,22,31,70
"2011","Rossendale 003F","E01025383","Total",928,211,70,141,717,40,99,166,207,34,50,121
"2011","Rossendale 004A","E01025356","Total",625,198,76,122,427,53,75,75,117,15,41,51
"2011","Rossendale 004C","E01025373","Total",678,214,101,113,464,21,95,86,130,14,42,76
"2011","Rossendale 004D","E01025385","Total",588,228,81,147,360,61,61,60,95,10,25,48
"2011","Rossendale 004F","E01025387","Total",501,112,45,67,389,19,74,64,91,21,47,73
"2011","Rossendale 004G","E01033281","Total",1111,376,136,240,735,58,119,126,218,26,70,118
"2011","Rossendale 007A","E01025377","Total",554,109,41,68,445,15,62,102,135,14,30,87
"2011","Rossendale 007B","E01025378","Total",647,180,49,131,467,18,73,110,153,14,27,72
"2011","Rossendale 007C","E01025379","Total",621,248,125,123,373,46,90,57,91,13,22,54
"2011","Rossendale 007D","E01025380","Total",583,109,64,45,474,15,120,87,106,18,34,94
"2011","Rossendale 008A","E01025357","Total",608,214,75,139,394,47,56,75,121,11,23,61
"2011","Rossendale 008B","E01025358","Total",943,254,98,156,689,25,120,136,232,22,40,114
"2011","Rossendale 008C","E01025365","Total",656,186,90,96,470,17,92,92,148,11,32,78
"2011","Rossendale 008D","E01025384","Total",533,157,76,81,376,14,86,69,121,11,25,50
"2011","Rossendale 009A","E01025359","Total",708,187,78,109,521,24,116,85,156,13,37,90
"2011","Rossendale 009B","E01025360","Total",919,337,141,196,582,34,124,97,175,23,38,91
"2011","Rossendale 009C","E01025375","Total",682,139,40,99,543,34,93,92,177,12,35,100
"2011","Rossendale 009D","E01025376","Total",983,358,147,211,625,99,84,143,127,27,48,97
"2011","Rossendale 010F","E01025370","Total",513,151,52,99,362,19,68,51,109,8,31,76
"2011","Rossendale 010A","E01025371","Total",648,237,96,141,411,36,79,82,116,19,29,50
"2011","Rossendale 010B","E01025374","Total",629,211,97,114,418,21,90,78,111,19,30,69
"2011","Rossendale 010G","E01025388","Total",657,238,75,163,419,39,79,72,109,26,26,68
"2011","Rossendale 010H","E01025389","Total",548,193,69,124,355,47,49,79,78,22,15,65
"2011","Rossendale 010I","E01025390","Total",517,204,93,111,313,37,67,43,82,15,21,48
"2011","Rossendale 010C","E01025391","Total",660,220,69,151,440,68,70,82,101,17,32,70
"2011","Rossendale 010D","E01025392","Total",573,206,79,127,367,29,73,65,119,9,10,62
"2011","Rossendale 010E","E01025394","Total",667,223,79,144,444,42,63,79,131,26,32,71
"2011","South Ribble 001A","E01025424","Total",505,100,49,51,405,14,89,86,107,13,28,68
"2011","South Ribble 001B","E01025425","Total",532,125,67,58,407,22,71,95,97,11,29,82
"2011","South Ribble 001C","E01025426","Total",502,118,77,41,384,11,87,70,94,10,32,80
"2011","South Ribble 001D","E01025466","Total",619,155,101,54,464,28,99,92,119,20,29,77
"2011","South Ribble 002A","E01025413","Total",770,206,130,76,564,33,138,93,148,20,31,101
"2011","South Ribble 002B","E01025414","Total",680,164,96,68,516,9,155,73,133,11,26,109
"2011","South Ribble 002C","E01025456","Total",472,101,50,51,371,12,87,53,109,14,34,62
"2011","South Ribble 002D","E01025458","Total",674,221,88,133,453,40,69,94,134,10,29,77
"2011","South Ribble 003A","E01025408","Total",651,190,109,81,461,17,113,62,138,7,32,92
"2011","South Ribble 003B","E01025409","Total",578,166,60,106,412,19,73,71,125,14,28,82
"2011","South Ribble 003C","E01025410","Total",512,96,51,45,416,8,58,103,97,16,39,95
"2011","South Ribble 003D","E01025467","Total",874,237,160,77,637,20,192,96,148,13,41,127
"2011","South Ribble 004A","E01025403","Total",786,158,39,119,628,33,63,188,192,27,40,85
"2011","South Ribble 004B","E01025457","Total",627,199,78,121,428,23,77,74,140,13,29,72
"2011","South Ribble 004C","E01025463","Total",574,156,58,98,418,24,65,94,126,11,27,71
"2011","South Ribble 004D","E01025464","Total",502,87,49,38,415,5,90,85,106,11,40,78
"2011","South Ribble 004E","E01025465","Total",503,156,73,83,347,19,68,71,113,5,19,52
"2011","South Ribble 005A","E01025411","Total",878,214,84,130,664,46,125,140,202,18,35,98
"2011","South Ribble 005B","E01025448","Total",700,200,75,125,500,24,99,92,159,10,39,77
"2011","South Ribble 005C","E01025449","Total",425,136,98,38,289,8,57,50,70,7,33,64
"2011","South Ribble 005D","E01025450","Total",415,112,41,71,303,33,50,75,63,6,32,44
"2011","South Ribble 006A","E01025412","Total",676,226,110,116,450,30,107,83,126,17,25,62
"2011","South Ribble 006B","E01025427","Total",741,349,102,247,392,36,84,69,107,11,27,58
"2011","South Ribble 006C","E01025428","Total",630,187,71,116,443,35,73,95,109,13,41,77
"2011","South Ribble 006D","E01025429","Total",617,214,62,152,403,83,35,74,123,19,20,49
"2011","South Ribble 007A","E01025404","Total",551,165,124,41,386,9,135,44,76,11,19,92
"2011","South Ribble 007B","E01025405","Total",560,221,116,105,339,31,72,47,107,9,21,52
"2011","South Ribble 007C","E01025406","Total",548,163,104,59,385,20,109,62,95,3,29,67
"2011","South Ribble 007D","E01025407","Total",862,281,96,185,581,85,67,109,172,16,41,91
"2011","South Ribble 008A","E01025399","Total",618,143,57,86,475,74,55,104,106,25,38,73
"2011","South Ribble 008B","E01025400","Total",715,140,63,77,575,44,119,123,138,14,42,95
"2011","South Ribble 008C","E01025401","Total",651,182,72,110,469,19,112,78,131,15,21,93
"2011","South Ribble 008D","E01025402","Total",605,154,45,109,451,40,65,130,124,14,24,54
"2011","South Ribble 009A","E01025442","Total",520,195,61,134,325,40,36,72,119,8,12,38
"2011","South Ribble 009B","E01025443","Total",603,166,74,92,437,22,103,69,141,9,23,70
"2011","South Ribble 009C","E01025444","Total",559,143,49,94,416,25,66,90,128,14,21,72
"2011","South Ribble 009D","E01025461","Total",737,144,68,76,593,19,92,155,142,22,51,112
"2011","South Ribble 009E","E01025462","Total",706,175,73,102,531,25,109,114,141,17,40,85
"2011","South Ribble 010A","E01025439","Total",579,144,94,50,435,14,134,80,100,16,17,74
"2011","South Ribble 010B","E01025453","Total",670,150,81,69,520,24,142,88,109,15,35,107
"2011","South Ribble 010C","E01025454","Total",506,99,66,33,407,13,114,70,84,15,37,74
"2011","South Ribble 010D","E01025455","Total",642,168,105,63,474,12,155,73,111,14,27,82
"2011","South Ribble 011A","E01025436","Total",912,200,101,99,712,24,156,141,183,18,53,137
"2011","South Ribble 011B","E01025437","Total",781,227,107,120,554,33,118,118,142,15,28,100
"2011","South Ribble 011C","E01025438","Total",523,101,54,47,422,12,98,77,126,12,25,72
"2011","South Ribble 011D","E01025440","Total",603,153,107,46,450,11,139,72,103,17,28,80
"2011","South Ribble 011E","E01025441","Total",662,221,154,67,441,18,133,77,108,9,22,74
"2011","South Ribble 012A","E01025417","Total",622,157,83,74,465,18,113,75,136,8,25,90
"2011","South Ribble 012B","E01025418","Total",611,163,77,86,448,38,82,87,121,14,26,80
"2011","South Ribble 012C","E01025419","Total",665,202,96,106,463,38,64,99,111,19,41,91
"2011","South Ribble 012D","E01025420","Total",1057,195,88,107,862,31,158,185,216,29,72,171
"2011","South Ribble 013A","E01025421","Total",912,199,35,164,713,70,65,174,217,48,42,97
"2011","South Ribble 013B","E01025422","Total",639,233,140,93,406,41,70,67,130,7,24,67
"2011","South Ribble 013C","E01025431","Total",772,249,55,194,523,62,38,124,178,18,29,74
"2011","South Ribble 013D","E01025433","Total",753,184,80,104,569,44,97,109,161,12,34,112
"2011","South Ribble 014A","E01025416","Total",610,129,55,74,481,17,98,89,143,17,33,84
"2011","South Ribble 014B","E01025451","Total",733,121,38,83,612,24,75,164,166,20,50,113
"2011","South Ribble 014C","E01025452","Total",738,226,68,158,512,76,60,88,155,16,37,80
"2011","South Ribble 015A","E01025415","Total",846,223,94,129,623,42,108,116,172,17,52,116
"2011","South Ribble 015B","E01025423","Total",604,209,84,125,395,75,64,78,91,14,27,46
"2011","South Ribble 015C","E01025435","Total",674,222,111,111,452,28,102,90,121,13,22,76
"2011","South Ribble 015D","E01025446","Total",663,193,108,85,470,28,116,84,120,7,29,86
"2011","South Ribble 016A","E01025430","Total",796,173,100,73,623,54,110,116,153,21,43,126
"2011","South Ribble 016C","E01025434","Total",827,161,118,43,666,10,233,86,152,15,46,124
"2011","South Ribble 016D","E01032928","Total",826,215,27,188,611,61,27,178,257,20,19,49
"2011","South Ribble 016E","E01032929","Total",497,148,88,60,349,24,88,48,108,9,18,54
"2011","South Ribble 017A","E01025445","Total",536,118,37,81,418,81,51,92,79,22,37,56
"2011","South Ribble 017B","E01025447","Total",533,218,121,97,315,58,41,59,65,19,30,43
"2011","South Ribble 017C","E01025459","Total",710,179,76,103,531,33,119,87,159,13,33,87
"2011","South Ribble 017D","E01025460","Total",922,328,94,234,594,52,96,116,169,26,39,96
"2011","West Lancashire 001A","E01025496","Total",481,112,60,52,369,24,71,65,90,14,31,74
"2011","West Lancashire 001B","E01025497","Total",563,85,33,52,478,20,81,112,111,18,46,90
"2011","West Lancashire 001C","E01025498","Total",520,117,57,60,403,14,97,64,105,14,29,80
"2011","West Lancashire 001D","E01025530","Total",620,140,65,75,480,16,137,81,119,9,25,93
"2011","West Lancashire 001E","E01025532","Total",600,110,62,48,490,19,136,97,113,12,44,69
"2011","West Lancashire 001F","E01025533","Total",709,222,132,90,487,21,120,99,132,8,28,79
"2011","West Lancashire 002A","E01025507","Total",678,179,66,113,499,31,128,82,150,10,29,69
"2011","West Lancashire 002B","E01025508","Total",616,194,97,97,422,26,98,58,113,17,26,84
"2011","West Lancashire 002C","E01025509","Total",553,186,101,85,367,29,83,54,94,11,17,79
"2011","West Lancashire 002D","E01025513","Total",822,207,115,92,615,20,143,110,151,25,51,115
"2011","West Lancashire 002E","E01025531","Total",488,121,66,55,367,8,112,47,106,6,20,68
"2011","West Lancashire 003A","E01025474","Total",458,93,47,46,365,15,91,57,88,9,28,77
"2011","West Lancashire 003B","E01025495","Total",867,231,118,113,636,14,175,104,161,23,36,123
"2011","West Lancashire 003C","E01025514","Total",966,242,136,106,724,19,159,126,220,21,46,133
"2011","West Lancashire 003D","E01025515","Total",680,193,111,82,487,7,143,59,130,11,40,97
"2011","West Lancashire 004A","E01025483","Total",958,300,131,169,658,53,143,122,168,30,43,99
"2011","West Lancashire 004B","E01025484","Total",791,180,91,89,611,31,140,119,148,22,37,114
"2011","West Lancashire 004C","E01025485","Total",702,187,74,113,515,29,98,112,125,16,45,90
"2011","West Lancashire 004D","E01025486","Total",654,136,52,84,518,28,100,121,120,19,34,96
"2011","West Lancashire 004E","E01025487","Total",624,131,74,57,493,33,97,111,113,13,30,96
"2011","West Lancashire 005A","E01025510","Total",514,93,60,33,421,10,138,69,75,6,30,93
"2011","West Lancashire 005B","E01025511","Total",469,96,53,43,373,10,114,73,90,11,21,54
"2011","West Lancashire 005C","E01025512","Total",563,180,92,88,383,23,77,86,92,9,23,73
"2011","West Lancashire 005D","E01025538","Total",660,179,99,80,481,9,129,89,127,10,35,82
"2011","West Lancashire 005E","E01025539","Total",560,136,67,69,424,19,91,88,122,12,27,65
"2011","West Lancashire 006A","E01025499","Total",596,192,86,106,404,20,83,67,110,8,29,87
"2011","West Lancashire 006B","E01025501","Total",493,138,103,35,355,9,128,51,75,5,19,68
"2011","West Lancashire 006C","E01025502","Total",639,144,104,40,495,17,134,95,92,20,35,102
"2011","West Lancashire 006D","E01025516","Total",631,157,82,75,474,26,111,88,121,8,32,88
"2011","West Lancashire 006E","E01025517","Total",595,137,54,83,458,35,77,85,118,18,36,89
"2011","West Lancashire 006F","E01025519","Total",505,130,79,51,375,14,110,49,79,10,20,93
"2011","West Lancashire 007A","E01025488","Total",743,248,131,117,495,23,73,63,117,6,21,192
"2011","West Lancashire 007B","E01025489","Total",505,120,70,50,385,14,78,68,86,14,27,98
"2011","West Lancashire 007C","E01025490","Total",495,140,78,62,355,22,69,48,79,20,19,98
"2011","West Lancashire 007D","E01025500","Total",664,253,139,114,411,26,93,58,113,7,20,94
"2011","West Lancashire 007E","E01025518","Total",629,248,130,118,381,24,60,51,88,11,10,137
"2011","West Lancashire 008A","E01025479","Total",837,204,104,100,633,23,173,78,164,18,44,133
"2011","West Lancashire 008B","E01025491","Total",575,145,90,55,430,10,144,63,92,12,24,85
"2011","West Lancashire 008C","E01025506","Total",842,217,126,91,625,14,172,108,157,13,36,125
"2011","West Lancashire 009A","E01025468","Total",595,84,27,57,511,25,39,119,130,23,64,111
"2011","West Lancashire 009B","E01025469","Total",761,324,142,182,437,38,74,81,114,6,38,86
"2011","West Lancashire 009C","E01025470","Total",542,86,25,61,456,20,50,109,114,9,49,105
"2011","West Lancashire 009D","E01025522","Total",507,147,107,40,360,23,93,44,91,8,24,77
"2011","West Lancashire 010A","E01025471","Total",574,123,31,92,451,72,46,94,97,22,36,84
"2011","West Lancashire 010B","E01025480","Total",503,108,23,85,395,58,31,92,88,18,46,62
"2011","West Lancashire 010C","E01025481","Total",640,214,58,156,426,66,57,74,106,13,29,81
"2011","West Lancashire 010D","E01025482","Total",578,176,46,130,402,72,35,76,83,34,38,64
"2011","West Lancashire 010E","E01025520","Total",522,184,80,104,338,43,67,61,58,16,22,71
"2011","West Lancashire 010F","E01025521","Total",659,162,54,108,497,81,65,91,104,29,38,89
"2011","West Lancashire 011A","E01025523","Total",685,213,75,138,472,56,65,99,117,15,39,81
"2011","West Lancashire 011B","E01025524","Total",746,340,109,231,406,44,60,72,122,13,29,66
"2011","West Lancashire 011C","E01025525","Total",629,140,68,72,489,36,90,87,99,31,40,106
"2011","West Lancashire 011D","E01025526","Total",774,254,117,137,520,44,106,90,142,16,32,90
"2011","West Lancashire 012A","E01025472","Total",543,92,69,23,451,9,129,84,102,19,33,75
"2011","West Lancashire 012B","E01025473","Total",607,198,101,97,409,23,111,62,92,17,14,90
"2011","West Lancashire 012C","E01025475","Total",606,127,100,27,479,13,141,71,108,11,37,98
"2011","West Lancashire 012D","E01025476","Total",547,154,100,54,393,13,108,68,95,8,26,75
"2011","West Lancashire 012E","E01025477","Total",478,116,69,47,362,8,81,61,77,12,36,87
"2011","West Lancashire 012F","E01025478","Total",478,95,64,31,383,6,131,61,70,10,35,70
"2011","West Lancashire 013A","E01025492","Total",503,98,38,60,405,37,69,77,105,8,38,71
"2011","West Lancashire 013B","E01025527","Total",621,246,114,132,375,68,54,48,71,17,43,74
"2011","West Lancashire 013C","E01025528","Total",685,162,39,123,523,127,51,116,100,21,40,68
"2011","West Lancashire 013D","E01025529","Total",709,169,55,114,540,101,60,121,112,19,40,87
"2011","West Lancashire 014A","E01025493","Total",660,181,38,143,479,143,31,80,90,24,34,77
"2011","West Lancashire 014B","E01025494","Total",676,259,100,159,417,81,44,52,96,21,49,74
"2011","West Lancashire 014C","E01025503","Total",499,98,28,70,401,75,35,94,75,18,36,68
"2011","West Lancashire 014D","E01025504","Total",472,157,51,106,315,80,37,44,67,11,26,50
"2011","West Lancashire 014E","E01025505","Total",632,188,73,115,444,62,81,60,126,10,38,67
"2011","West Lancashire 015A","E01025534","Total",686,144,84,60,542,18,128,126,122,23,35,90
"2011","West Lancashire 015B","E01025535","Total",582,145,59,86,437,18,88,70,115,6,45,95
"2011","West Lancashire 015C","E01025536","Total",646,202,105,97,444,46,69,100,97,13,40,79
"2011","West Lancashire 015D","E01025537","Total",683,201,98,103,482,22,134,80,141,8,29,68
"2011","West Lancashire 015E","E01025540","Total",488,116,61,55,372,10,86,46,110,16,23,81
"2011","Wyre 001A","E01025573","Total",590,155,90,65,435,26,98,70,100,14,37,90
"2011","Wyre 001B","E01025574","Total",741,294,160,134,447,64,86,92,117,12,23,53
"2011","Wyre 001C","E01025581","Total",587,179,86,93,408,35,73,69,94,8,34,95
"2011","Wyre 001D","E01025582","Total",581,203,65,138,378,54,44,68,125,15,14,58
"2011","Wyre 001E","E01025583","Total",602,224,87,137,378,49,59,79,101,16,21,53
"2011","Wyre 001F","E01025584","Total",851,474,145,329,377,30,93,50,133,3,22,46
"2011","Wyre 002A","E01025605","Total",565,142,88,54,423,16,107,75,104,14,35,72
"2011","Wyre 002B","E01025606","Total",516,147,60,87,369,59,59,60,87,18,26,60
"2011","Wyre 002C","E01025607","Total",630,160,94,66,470,4,121,77,103,21,43,101
"2011","Wyre 002D","E01025608","Total",658,162,88,74,496,29,120,80,103,20,41,103
"2011","Wyre 003A","E01025590","Total",622,193,96,97,429,87,68,60,70,22,40,82
"2011","Wyre 003B","E01025591","Total",748,217,153,64,531,11,213,65,137,2,22,81
"2011","Wyre 003C","E01025592","Total",638,196,88,108,442,98,69,62,94,24,31,64
"2011","Wyre 003D","E01025593","Total",654,155,106,49,499,10,217,42,106,8,30,86
"2011","Wyre 004A","E01025563","Total",455,121,63,58,334,10,117,36,86,9,20,56
"2011","Wyre 004B","E01025564","Total",719,208,127,81,511,27,143,70,134,17,30,90
"2011","Wyre 004C","E01025565","Total",642,164,102,62,478,9,159,61,117,14,35,83
"2011","Wyre 004D","E01025586","Total",715,190,131,59,525,17,203,73,121,12,31,68
"2011","Wyre 004E","E01025587","Total",694,206,117,89,488,18,193,59,103,18,23,74
"2011","Wyre 004F","E01025588","Total",704,279,187,92,425,8,203,38,104,2,19,51
"2011","Wyre 004G","E01025589","Total",489,121,48,73,368,16,67,68,96,11,32,78
"2011","Wyre 005A","E01025557","Total",683,178,90,88,505,32,122,99,142,9,34,67
"2011","Wyre 005B","E01025575","Total",551,269,119,150,282,49,53,41,66,15,13,45
"2011","Wyre 005C","E01025578","Total",629,162,88,74,467,53,94,69,95,17,37,102
"2011","Wyre 005D","E01025579","Total",513,101,52,49,412,62,54,75,91,32,25,73
"2011","Wyre 005E","E01025580","Total",497,103,60,43,394,11,115,36,85,22,31,94
"2011","Wyre 006A","E01025547","Total",669,174,89,85,495,13,118,79,130,17,45,93
"2011","Wyre 006B","E01025549","Total",842,193,88,105,649,25,130,135,195,30,37,97
"2011","Wyre 006C","E01025609","Total",826,212,108,104,614,29,142,82,169,29,51,112
"2011","Wyre 007A","E01025548","Total",747,244,170,74,503,11,231,53,113,12,17,66
"2011","Wyre 007B","E01025553","Total",1031,215,98,117,816,25,158,178,220,33,60,142
"2011","Wyre 007C","E01025558","Total",822,278,194,84,544,9,229,70,119,12,28,77
"2011","Wyre 007D","E01025559","Total",776,218,113,105,558,25,126,97,151,17,47,95
"2011","Wyre 007E","E01025560","Total",647,204,152,52,443,5,178,43,134,13,14,56
"2011","Wyre 008A","E01025554","Total",764,272,172,100,492,14,213,66,107,8,18,66
"2011","Wyre 008B","E01025556","Total",638,185,107,78,453,27,121,81,90,17,37,80
"2011","Wyre 008C","E01025570","Total",678,362,179,183,316,26,121,35,76,4,11,43
"2011","Wyre 008D","E01025571","Total",586,158,64,94,428,49,112,58,90,15,37,67
"2011","Wyre 008E","E01025572","Total",642,203,135,68,439,10,198,47,92,3,27,62
"2011","Wyre 008F","E01025604","Total",653,195,115,80,458,29,112,83,100,5,41,88
"2011","Wyre 009A","E01025561","Total",591,125,62,63,466,11,118,95,102,18,35,87
"2011","Wyre 009B","E01025562","Total",871,227,139,88,644,21,162,97,161,21,60,122
"2011","Wyre 009C","E01025585","Total",890,166,90,76,724,20,194,107,177,30,59,137
"2011","Wyre 010A","E01025542","Total",684,148,84,64,536,21,122,97,148,12,38,98
"2011","Wyre 010B","E01025555","Total",685,246,181,65,439,15,172,62,105,6,15,64
"2011","Wyre 010C","E01025601","Total",621,151,102,49,470,6,182,66,101,8,23,84
"2011","Wyre 010D","E01025602","Total",691,233,76,157,458,36,76,103,119,11,30,83
"2011","Wyre 010E","E01025603","Total",710,206,141,65,504,24,190,61,127,6,23,73
"2011","Wyre 011A","E01025541","Total",693,175,73,102,518,41,93,108,131,19,40,86
"2011","Wyre 011B","E01025543","Total",747,200,86,114,547,57,82,133,156,14,38,67
"2011","Wyre 011C","E01025544","Total",755,280,163,117,475,46,141,63,124,10,30,61
"2011","Wyre 011D","E01025576","Total",1069,359,207,152,710,45,194,133,179,10,42,107
"2011","Wyre 011E","E01025577","Total",646,224,119,105,422,27,92,102,99,13,27,62
"2011","Wyre 012A","E01025550","Total",671,191,114,77,480,7,162,86,115,14,27,69
"2011","Wyre 012B","E01025552","Total",497,91,44,47,406,10,79,81,97,15,26,98
"2011","Wyre 012C","E01025594","Total",744,257,176,81,487,23,177,59,121,4,16,87
"2011","Wyre 012D","E01025595","Total",628,135,90,45,493,11,176,82,114,5,25,80
"2011","Wyre 012E","E01025596","Total",820,189,82,107,631,36,119,160,142,28,49,97
"2011","Wyre 012F","E01025597","Total",480,125,76,49,355,26,109,59,85,15,22,39
"2011","Wyre 013A","E01025545","Total",789,253,141,112,536,17,150,74,138,17,30,110
"2011","Wyre 013B","E01025546","Total",716,289,131,158,427,46,65,71,143,18,20,64
"2011","Wyre 013C","E01025551","Total",552,151,63,88,401,12,83,73,109,8,22,94
"2011","Wyre 013D","E01025567","Total",756,282,139,143,474,41,138,55,131,10,22,77
"2011","Wyre 013E","E01025598","Total",765,328,181,147,437,27,133,68,132,5,17,55
"2011","Wyre 014A","E01025566","Total",847,200,139,61,647,12,225,106,141,18,48,97
"2011","Wyre 014B","E01025568","Total",792,244,139,105,548,32,170,76,137,17,32,84
"2011","Wyre 014C","E01025569","Total",877,290,192,98,587,19,202,85,148,11,31,91
"2011","Wyre 014D","E01025599","Total",432,112,64,48,320,10,88,54,87,4,21,56
"2011","Wyre 014E","E01025600","Total",667,179,94,85,488,21,121,97,123,15,20,91
"2011","Knowsley 001A","E01006448","Total",720,243,106,137,477,109,62,71,95,16,41,83
"2011","Knowsley 001B","E01006492","Total",515,93,26,67,422,50,40,54,109,10,43,116
"2011","Knowsley 001C","E01006493","Total",433,115,50,65,318,70,29,39,61,17,37,65
"2011","Knowsley 001D","E01006494","Total",526,121,42,79,405,92,26,61,71,22,41,92
"2011","Knowsley 001E","E01006495","Total",689,136,25,111,553,104,42,125,121,28,49,84
"2011","Knowsley 002A","E01006454","Total",512,144,84,60,368,15,76,51,78,6,37,105
"2011","Knowsley 002B","E01006456","Total",670,226,108,118,444,29,73,67,89,11,62,113
"2011","Knowsley 002C","E01006457","Total",522,142,98,44,380,9,133,30,70,7,27,104
"2011","Knowsley 002D","E01006458","Total",593,175,72,103,418,57,78,55,86,7,36,99
"2011","Knowsley 002E","E01006490","Total",1032,200,26,174,832,116,31,225,247,38,65,110
"2011","Knowsley 002F","E01006491","Total",761,174,22,152,587,61,41,160,162,22,49,92
"2011","Knowsley 003A","E01006415","Total",825,226,85,141,599,87,63,118,125,23,63,120
"2011","Knowsley 003B","E01006417","Total",711,385,95,290,326,68,42,34,90,8,24,60
"2011","Knowsley 003C","E01006436","Total",636,243,63,180,393,53,53,54,85,15,40,93
"2011","Knowsley 003D","E01006437","Total",618,228,78,150,390,55,49,61,96,7,32,90
"2011","Knowsley 003E","E01006447","Total",632,288,68,220,344,60,38,36,89,14,28,79
"2011","Knowsley 004A","E01006455","Total",701,197,67,130,504,109,69,67,103,17,40,99
"2011","Knowsley 004B","E01006506","Total",550,150,32,118,400,61,29,61,117,17,32,83
"2011","Knowsley 004C","E01006507","Total",636,232,86,146,404,86,49,63,74,8,34,90
"2011","Knowsley 004D","E01006508","Total",576,180,47,133,396,46,43,86,95,16,32,78
"2011","Knowsley 004E","E01006509","Total",695,215,102,113,480,102,55,75,93,8,52,95
"2011","Knowsley 004F","E01006510","Total",493,119,50,69,374,29,70,56,93,7,30,89
"2011","Knowsley 005A","E01006416","Total",665,242,83,159,423,85,54,55,108,8,26,87
"2011","Knowsley 005B","E01006418","Total",549,177,77,100,372,49,50,63,74,15,33,88
"2011","Knowsley 005C","E01006434","Total",631,193,63,130,438,99,38,67,96,8,38,92
"2011","Knowsley 005D","E01006435","Total",653,199,87,112,454,74,59,45,105,11,53,107
"2011","Knowsley 005E","E01006438","Total",510,149,81,68,361,16,111,37,61,14,37,85
"2011","Knowsley 005F","E01006439","Total",686,221,108,113,465,48,93,62,96,17,48,101
"2011","Knowsley 005G","E01006446","Total",566,160,66,94,406,58,63,69,87,8,41,80
"2011","Knowsley 006A","E01006412","Total",591,145,64,81,446,78,86,42,82,11,51,96
"2011","Knowsley 006B","E01006413","Total",866,537,151,386,329,79,54,39,94,3,24,36
"2011","Knowsley 006C","E01006414","Total",610,213,100,113,397,73,89,37,68,8,39,83
"2011","Knowsley 006D","E01006441","Total",993,321,130,191,672,75,90,135,165,33,66,108
"2011","Knowsley 007A","E01006460","Total",661,206,77,129,455,96,57,55,97,21,35,94
"2011","Knowsley 007B","E01006461","Total",619,157,67,90,462,70,75,77,81,22,41,96
"2011","Knowsley 007C","E01006463","Total",971,469,125,344,502,79,63,100,164,12,21,63
"2011","Knowsley 007D","E01006464","Total",727,272,167,105,455,30,127,58,88,13,29,110
"2011","Knowsley 007E","E01006466","Total",776,335,174,161,441,47,67,82,136,8,27,74
"2011","Knowsley 008A","E01006453","Total",515,136,51,85,379,95,56,53,73,14,22,66
"2011","Knowsley 008B","E01006467","Total",558,184,69,115,374,101,44,41,73,9,29,77
"2011","Knowsley 008E","E01006470","Total",585,200,82,118,385,50,63,43,83,17,43,86
"2011","Knowsley 008F","E01033228","Total",810,270,106,164,540,123,68,76,91,24,47,111
"2011","Knowsley 009A","E01006459","Total",614,144,48,96,470,38,68,79,108,15,48,114
"2011","Knowsley 009B","E01006462","Total",639,192,109,83,447,32,101,91,89,20,38,76
"2011","Knowsley 009C","E01006496","Total",606,224,110,114,382,30,74,63,74,16,30,95
"2011","Knowsley 009D","E01006498","Total",548,101,45,56,447,18,50,127,88,19,45,100
"2011","Knowsley 009E","E01006499","Total",681,203,79,124,478,39,89,102,109,13,35,91
"2011","Knowsley 010A","E01006440","Total",622,196,78,118,426,88,53,67,84,14,37,83
"2011","Knowsley 010B","E01006442","Total",614,273,71,202,341,76,40,44,73,14,34,60
"2011","Knowsley 010C","E01006443","Total",667,290,121,169,377,71,77,50,81,8,25,65
"2011","Knowsley 010D","E01006444","Total",521,140,50,90,381,76,52,58,61,17,41,76
"2011","Knowsley 010E","E01006445","Total",539,159,58,101,380,81,45,60,58,15,35,86
"2011","Knowsley 011A","E01006465","Total",635,143,69,74,492,15,67,109,111,21,46,123
"2011","Knowsley 011B","E01006482","Total",587,144,66,78,443,70,62,59,84,17,56,95
"2011","Knowsley 011C","E01006483","Total",614,226,98,128,388,65,77,55,79,10,33,69
"2011","Knowsley 011D","E01006484","Total",567,175,73,102,392,46,56,73,77,13,37,90
"2011","Knowsley 012A","E01006449","Total",623,188,106,82,435,40,99,65,83,14,43,91
"2011","Knowsley 012B","E01006450","Total",619,203,91,112,416,88,63,62,80,17,35,71
"2011","Knowsley 012C","E01006451","Total",606,156,81,75,450,59,84,61,96,15,39,96
"2011","Knowsley 012D","E01006452","Total",618,166,70,96,452,54,64,82,100,15,47,90
"2011","Knowsley 013A","E01006497","Total",472,141,63,78,331,17,68,53,83,6,23,81
"2011","Knowsley 013B","E01006500","Total",464,135,86,49,329,29,63,42,68,13,35,79
"2011","Knowsley 013C","E01006501","Total",562,123,38,85,439,65,65,109,105,21,31,43
"2011","Knowsley 013D","E01006504","Total",573,202,46,156,371,43,46,76,80,25,31,70
"2011","Knowsley 013E","E01006505","Total",700,212,109,103,488,69,59,87,95,24,60,94
"2011","Knowsley 014A","E01006472","Total",638,158,95,63,480,16,114,66,111,14,50,109
"2011","Knowsley 014B","E01006485","Total",615,159,85,74,456,37,90,82,91,24,45,87
"2011","Knowsley 014C","E01006486","Total",491,128,69,59,363,13,80,61,89,8,26,86
"2011","Knowsley 014D","E01006487","Total",630,159,84,75,471,31,110,75,91,11,40,113
"2011","Knowsley 014E","E01006488","Total",686,165,96,69,521,21,98,94,122,12,52,122
"2011","Knowsley 014F","E01006489","Total",581,159,95,64,422,30,81,63,87,14,38,109
"2011","Knowsley 015A","E01006477","Total",575,166,62,104,409,61,65,64,82,10,30,97
"2011","Knowsley 015B","E01006478","Total",613,242,92,150,371,52,54,64,75,9,33,84
"2011","Knowsley 015C","E01006479","Total",590,181,85,96,409,59,67,54,85,13,39,92
"2011","Knowsley 015D","E01006480","Total",613,237,118,119,376,56,65,45,76,10,44,80
"2011","Knowsley 015E","E01006481","Total",642,299,143,156,343,46,67,49,65,9,33,74
"2011","Knowsley 016A","E01006471","Total",624,174,105,69,450,23,104,73,89,9,44,108
"2011","Knowsley 016B","E01006473","Total",490,115,69,46,375,18,81,56,73,13,33,101
"2011","Knowsley 016C","E01006474","Total",637,202,127,75,435,11,121,65,88,17,37,96
"2011","Knowsley 016D","E01006475","Total",555,134,65,69,421,15,100,66,75,9,39,117
"2011","Knowsley 016E","E01006476","Total",568,139,94,45,429,6,83,75,104,9,46,106
"2011","Knowsley 017A","E01006420","Total",764,155,61,94,609,41,61,155,146,27,56,123
"2011","Knowsley 017B","E01006424","Total",803,189,72,117,614,24,64,126,172,18,63,147
"2011","Knowsley 017C","E01006502","Total",767,214,114,100,553,36,139,79,139,11,24,125
"2011","Knowsley 017D","E01006503","Total",544,158,116,42,386,11,111,42,87,13,24,98
"2011","Knowsley 018A","E01006421","Total",428,62,9,53,366,22,35,97,91,11,33,77
"2011","Knowsley 018B","E01006425","Total",559,173,69,104,386,27,51,68,93,14,40,93
"2011","Knowsley 018C","E01006430","Total",611,293,141,152,318,52,62,42,68,8,27,59
"2011","Knowsley 018D","E01006433","Total",633,231,93,138,402,41,64,84,90,8,24,91
"2011","Knowsley 019A","E01006419","Total",628,172,48,124,456,43,47,118,130,9,29,80
"2011","Knowsley 019B","E01006422","Total",528,135,84,51,393,20,106,58,75,7,33,94
"2011","Knowsley 019C","E01006423","Total",528,88,21,67,440,22,50,103,119,11,30,105
"2011","Knowsley 019D","E01006427","Total",618,172,105,67,446,20,120,62,98,12,42,92
"2011","Knowsley 020A","E01006426","Total",556,198,71,127,358,61,52,50,90,4,31,70
"2011","Knowsley 020B","E01006428","Total",630,192,66,126,438,58,48,99,102,15,38,78
"2011","Knowsley 020C","E01006429","Total",463,133,60,73,330,61,39,50,66,13,28,73
"2011","Knowsley 020D","E01006431","Total",765,270,92,178,495,67,91,74,125,15,24,99
"2011","Knowsley 020E","E01006432","Total",671,235,101,134,436,64,70,71,100,13,33,85
"2011","Liverpool 001A","E01006651","Total",592,103,27,76,489,37,33,141,118,13,62,85
"2011","Liverpool 001B","E01006653","Total",656,203,74,129,453,55,82,86,107,13,37,73
"2011","Liverpool 001C","E01006655","Total",706,194,88,106,512,41,82,103,116,18,45,107
"2011","Liverpool 001D","E01006658","Total",634,254,84,170,380,73,73,51,87,8,21,67
"2011","Liverpool 001E","E01006660","Total",616,226,97,129,390,44,59,83,68,12,41,83
"2011","Liverpool 002A","E01006652","Total",633,193,67,126,440,49,64,86,97,13,37,94
"2011","Liverpool 002B","E01006656","Total",669,222,69,153,447,64,68,67,112,13,26,97
"2011","Liverpool 002C","E01006657","Total",582,236,71,165,346,55,55,64,88,13,14,57
"2011","Liverpool 002D","E01006780","Total",619,191,80,111,428,48,69,76,100,8,37,90
"2011","Liverpool 002E","E01006783","Total",645,199,73,126,446,56,54,89,98,20,33,96
"2011","Liverpool 003A","E01006781","Total",600,163,60,103,437,29,58,95,102,8,36,109
"2011","Liverpool 003B","E01006782","Total",691,271,79,192,420,53,44,84,103,9,29,98
"2011","Liverpool 003C","E01006784","Total",586,209,57,152,377,36,40,84,96,11,30,80
"2011","Liverpool 003D","E01006785","Total",781,275,87,188,506,65,75,86,111,15,42,112
"2011","Liverpool 003E","E01006786","Total",764,237,67,170,527,34,80,115,135,21,41,101
"2011","Liverpool 004A","E01006661","Total",749,269,123,146,480,74,97,62,97,15,33,102
"2011","Liverpool 004B","E01006662","Total",785,333,162,171,452,70,77,99,96,14,33,63
"2011","Liverpool 004C","E01006663","Total",510,175,64,111,335,53,35,73,87,11,22,54
"2011","Liverpool 004D","E01006664","Total",822,327,128,199,495,90,62,74,122,19,46,82
"2011","Liverpool 004E","E01006669","Total",551,123,28,95,428,35,32,101,108,18,52,82
"2011","Liverpool 005A","E01006654","Total",627,217,98,119,410,43,42,76,101,14,39,95
"2011","Liverpool 005B","E01006659","Total",548,264,77,187,284,51,44,43,64,11,18,53
"2011","Liverpool 005C","E01006734","Total",625,187,79,108,438,135,57,47,85,13,21,80
"2011","Liverpool 005D","E01006735","Total",571,207,71,136,364,71,48,57,67,11,32,78
"2011","Liverpool 005E","E01006736","Total",582,158,57,101,424,59,55,71,80,7,42,110
"2011","Liverpool 005F","E01006737","Total",562,142,62,80,420,55,64,71,71,8,50,101
"2011","Liverpool 006A","E01006787","Total",691,312,43,269,379,57,39,60,87,12,43,81
"2011","Liverpool 006B","E01006788","Total",681,137,62,75,544,70,74,109,102,22,44,123
"2011","Liverpool 006C","E01006790","Total",801,350,108,242,451,116,47,71,110,8,23,76
"2011","Liverpool 006D","E01006791","Total",873,418,127,291,455,65,79,67,124,9,27,84
"2011","Liverpool 007A","E01006665","Total",630,180,49,131,450,46,37,103,121,15,39,89
"2011","Liverpool 007B","E01006666","Total",514,84,30,54,430,29,29,99,86,19,70,98
"2011","Liverpool 007C","E01006667","Total",618,188,78,110,430,49,68,66,120,8,32,87
"2011","Liverpool 007D","E01006668","Total",590,119,32,87,471,49,43,125,127,15,43,69
"2011","Liverpool 007E","E01006670","Total",607,133,38,95,474,52,70,100,110,14,36,92
"2011","Liverpool 008A","E01006607","Total",641,196,80,116,445,73,81,61,73,11,34,112
"2011","Liverpool 008B","E01006612","Total",740,346,124,222,394,70,79,54,72,12,32,75
"2011","Liverpool 008C","E01006729","Total",539,121,74,47,418,97,49,56,79,24,37,76
"2011","Liverpool 008F","E01032510","Total",776,262,69,193,514,56,73,94,109,23,49,110
"2011","Liverpool 008G","E01032511","Total",616,199,61,138,417,58,62,57,117,9,21,93
"2011","Liverpool 009A","E01006608","Total",563,221,74,147,342,45,49,55,87,5,34,67
"2011","Liverpool 009B","E01006609","Total",576,209,62,147,367,49,56,65,82,9,26,80
"2011","Liverpool 009C","E01006610","Total",669,283,134,149,386,79,48,53,90,7,30,79
"2011","Liverpool 009D","E01006613","Total",611,240,114,126,371,35,74,46,67,9,41,99
"2011","Liverpool 009E","E01006705","Total",689,299,57,242,390,76,45,53,103,11,25,77
"2011","Liverpool 010A","E01006598","Total",604,223,106,117,381,76,60,54,73,23,29,66
"2011","Liverpool 010B","E01006599","Total",482,158,45,113,324,96,29,59,57,8,23,52
"2011","Liverpool 010E","E01006672","Total",798,238,80,158,560,108,64,110,104,25,55,94
"2011","Liverpool 010F","E01033759","Total",480,142,65,77,338,53,41,68,79,9,25,63
"2011","Liverpool 011A","E01006600","Total",592,180,92,88,412,44,80,49,76,10,44,109
"2011","Liverpool 011B","E01006603","Total",594,182,78,104,412,50,91,47,81,11,39,93
"2011","Liverpool 011C","E01006730","Total",542,165,90,75,377,56,54,51,70,16,40,90
"2011","Liverpool 011D","E01006731","Total",486,142,61,81,344,51,53,53,64,14,34,75
"2011","Liverpool 011E","E01006732","Total",644,170,69,101,474,117,72,62,70,26,45,82
"2011","Liverpool 012A","E01006611","Total",742,411,82,329,331,88,41,60,80,10,4,48
"2011","Liverpool 012B","E01006614","Total",667,292,67,225,375,68,68,62,94,6,19,58
"2011","Liverpool 012C","E01006615","Total",663,279,72,207,384,99,44,51,98,1,22,69
"2011","Liverpool 012D","E01006698","Total",725,244,70,174,481,86,57,77,97,23,32,109
"2011","Liverpool 012E","E01006700","Total",653,265,61,204,388,56,58,61,84,12,36,81
"2011","Liverpool 013A","E01006623","Total",527,69,32,37,458,14,95,76,95,14,41,123
"2011","Liverpool 013B","E01006624","Total",702,268,90,178,434,51,69,67,107,11,34,95
"2011","Liverpool 013C","E01006627","Total",600,195,88,107,405,25,69,88,95,4,37,87
"2011","Liverpool 013D","E01006671","Total",499,115,52,63,384,33,57,51,78,11,57,97
"2011","Liverpool 014A","E01006699","Total",777,322,78,244,455,94,66,72,115,13,22,73
"2011","Liverpool 014B","E01006701","Total",671,290,80,210,381,50,55,51,100,5,27,93
"2011","Liverpool 014C","E01006702","Total",740,263,84,179,477,97,69,71,120,15,24,81
"2011","Liverpool 014D","E01006703","Total",818,447,114,333,371,51,56,48,101,13,26,76
"2011","Liverpool 014E","E01006778","Total",1124,496,132,364,628,108,70,78,211,8,39,114
"2011","Liverpool 015A","E01006541","Total",803,362,139,223,441,60,89,62,101,4,32,93
"2011","Liverpool 015B","E01006543","Total",509,148,73,75,361,24,64,56,66,8,31,112
"2011","Liverpool 015C","E01006544","Total",738,264,85,179,474,88,75,68,103,15,46,79
"2011","Liverpool 015D","E01006616","Total",613,207,88,119,406,42,71,45,93,13,43,99
"2011","Liverpool 015E","E01006762","Total",725,226,80,146,499,76,80,64,113,17,46,103
"2011","Liverpool 016A","E01006604","Total",571,175,78,97,396,40,69,51,83,10,42,101
"2011","Liverpool 016B","E01006605","Total",696,289,123,166,407,46,74,58,79,12,52,86
"2011","Liverpool 016C","E01006618","Total",692,212,132,80,480,34,108,62,94,6,50,126
"2011","Liverpool 016D","E01006625","Total",609,185,114,71,424,30,94,76,90,9,38,87
"2011","Liverpool 016E","E01006626","Total",593,173,101,72,420,15,79,65,85,6,42,128
"2011","Liverpool 017A","E01006637","Total",670,208,66,142,462,114,38,90,104,19,34,63
"2011","Liverpool 017B","E01006638","Total",518,161,60,101,357,77,49,53,63,14,27,74
"2011","Liverpool 017C","E01006639","Total",640,199,71,128,441,64,56,92,96,17,36,80
"2011","Liverpool 017D","E01006644","Total",963,404,114,290,559,85,69,101,137,18,49,100
"2011","Liverpool 017E","E01006645","Total",690,299,138,161,391,83,77,49,68,8,26,80
"2011","Liverpool 018A","E01006542","Total",583,241,50,191,342,46,43,55,71,12,39,76
"2011","Liverpool 018B","E01006558","Total",739,380,93,287,359,77,39,45,106,9,23,60
"2011","Liverpool 018E","E01006562","Total",714,294,77,217,420,100,39,64,90,13,30,84
"2011","Liverpool 018F","E01033747","Total",496,233,78,155,263,52,36,34,51,14,29,47
"2011","Liverpool 019A","E01006545","Total",646,201,72,129,445,92,62,64,88,13,41,85
"2011","Liverpool 019B","E01006546","Total",583,227,57,170,356,76,34,51,78,11,35,71
"2011","Liverpool 019C","E01006547","Total",718,334,69,265,384,67,52,54,79,13,34,85
"2011","Liverpool 019D","E01006548","Total",759,334,86,248,425,109,53,74,77,11,30,71
"2011","Liverpool 019E","E01006766","Total",574,232,49,183,342,79,33,60,63,16,23,68
"2011","Liverpool 019F","E01006767","Total",779,294,64,230,485,79,46,105,107,20,25,103
"2011","Liverpool 020A","E01006606","Total",723,272,82,190,451,68,82,62,116,11,23,89
"2011","Liverpool 020B","E01006761","Total",793,383,98,285,410,71,64,59,89,10,34,83
"2011","Liverpool 020C","E01006763","Total",652,217,72,145,435,80,65,62,116,11,37,64
"2011","Liverpool 020D","E01006764","Total",667,259,47,212,408,63,54,47,95,16,51,82
"2011","Liverpool 020E","E01006765","Total",659,243,85,158,416,56,60,71,104,10,36,79
"2011","Liverpool 020F","E01006768","Total",587,234,37,197,353,23,51,43,79,11,38,108
"2011","Liverpool 021A","E01006617","Total",650,211,69,142,439,34,82,75,134,10,17,87
"2011","Liverpool 021B","E01006619","Total",734,256,89,167,478,35,108,96,120,12,24,83
"2011","Liverpool 021C","E01006620","Total",625,229,145,84,396,27,94,52,81,11,40,91
"2011","Liverpool 021D","E01006621","Total",584,163,88,75,421,12,93,71,77,10,40,118
"2011","Liverpool 021E","E01006622","Total",586,129,76,53,457,18,103,90,83,17,33,113
"2011","Liverpool 021F","E01006640","Total",760,217,91,126,543,42,92,116,120,20,44,109
"2011","Liverpool 022B","E01006776","Total",844,386,154,232,458,61,73,63,151,2,36,72
"2011","Liverpool 022D","E01006779","Total",902,334,160,174,568,118,86,67,135,12,41,109
"2011","Liverpool 022E","E01033764","Total",1172,607,197,410,565,107,95,61,142,9,29,122
"2011","Liverpool 023A","E01006560","Total",996,536,177,359,460,86,87,51,96,9,36,95
"2011","Liverpool 023B","E01006564","Total",800,300,121,179,500,49,115,48,121,10,47,110
"2011","Liverpool 023C","E01006646","Total",1006,503,94,409,503,66,57,64,183,7,40,86
"2011","Liverpool 023D","E01006648","Total",1075,428,125,303,647,65,58,67,270,8,33,146
"2011","Liverpool 024A","E01006540","Total",771,415,100,315,356,99,29,53,67,3,32,73
"2011","Liverpool 024B","E01006563","Total",908,477,208,269,431,96,88,54,56,15,32,90
"2011","Liverpool 024C","E01006647","Total",636,242,92,150,394,94,60,50,65,24,37,64
"2011","Liverpool 024D","E01006693","Total",838,463,182,281,375,33,102,50,73,3,29,85
"2011","Liverpool 025A","E01006572","Total",501,133,67,66,368,78,54,52,84,14,23,63
"2011","Liverpool 025B","E01006574","Total",612,231,118,113,381,51,65,75,59,17,28,86
"2011","Liverpool 025C","E01006641","Total",633,154,17,137,479,62,17,160,132,24,39,45
"2011","Liverpool 025D","E01006642","Total",590,219,81,138,371,79,46,53,85,16,25,67
"2011","Liverpool 025E","E01006643","Total",740,198,57,141,542,101,63,107,117,25,49,80
"2011","Liverpool 026A","E01006567","Total",892,500,185,315,392,47,83,52,78,13,27,92
"2011","Liverpool 026B","E01006568","Total",629,191,70,121,438,58,50,83,114,11,35,87
"2011","Liverpool 026C","E01006570","Total",595,165,78,87,430,38,72,72,90,14,36,108
"2011","Liverpool 026D","E01006571","Total",612,204,84,120,408,38,72,61,85,13,42,97
"2011","Liverpool 027A","E01006711","Total",685,277,83,194,408,62,55,77,89,12,44,69
"2011","Liverpool 027D","E01006717","Total",576,168,67,101,408,38,56,57,83,11,53,110
"2011","Liverpool 027E","E01006718","Total",678,245,86,159,433,35,63,79,98,16,39,103
"2011","Liverpool 027F","E01006719","Total",638,193,69,124,445,63,61,80,97,15,43,86
"2011","Liverpool 027G","E01032508","Total",847,399,102,297,448,73,51,62,117,13,50,82
"2011","Liverpool 027H","E01032509","Total",665,247,67,180,418,85,56,85,95,6,28,63
"2011","Liverpool 028A","E01006690","Total",801,436,57,379,365,63,36,46,116,2,22,80
"2011","Liverpool 028B","E01006692","Total",989,400,94,306,589,80,78,101,158,20,54,98
"2011","Liverpool 028C","E01006695","Total",1029,637,58,579,392,78,30,48,113,8,40,75
"2011","Liverpool 028D","E01006759","Total",460,180,41,139,280,40,31,45,59,9,26,70
"2011","Liverpool 028E","E01006760","Total",826,498,70,428,328,38,20,47,96,8,22,97
"2011","Liverpool 029A","E01006565","Total",638,197,105,92,441,33,88,69,84,12,46,109
"2011","Liverpool 029B","E01006569","Total",613,236,106,130,377,25,86,45,76,14,42,89
"2011","Liverpool 029C","E01006573","Total",778,368,149,219,410,84,69,62,96,12,24,63
"2011","Liverpool 029D","E01006712","Total",569,194,68,126,375,47,47,82,101,22,20,56
"2011","Liverpool 029E","E01006713","Total",604,196,95,101,408,45,54,84,108,13,25,79
"2011","Liverpool 030A","E01006691","Total",647,247,59,188,400,75,42,67,76,20,22,98
"2011","Liverpool 030B","E01006694","Total",891,375,65,310,516,111,59,76,119,19,37,95
"2011","Liverpool 030C","E01006696","Total",768,290,78,212,478,75,50,75,118,23,36,101
"2011","Liverpool 030D","E01006697","Total",828,319,68,251,509,91,57,78,124,21,34,104
"2011","Liverpool 030E","E01006746","Total",655,216,88,128,439,47,89,36,82,11,28,146
"2011","Liverpool 031A","E01006512","Total",799,431,28,403,368,30,2,55,206,12,13,50
"2011","Liverpool 031B","E01006747","Total",857,460,69,391,397,21,28,55,147,1,16,129
"2011","Liverpool 031C","E01006748","Total",756,239,75,164,517,40,39,37,99,7,20,275
"2011","Liverpool 031F","E01006751","Total",831,301,118,183,530,73,62,80,115,11,48,141
"2011","Liverpool 031G","E01033763","Total",820,507,140,367,313,28,34,32,80,6,15,118
"2011","Liverpool 032A","E01006566","Total",577,184,92,92,393,24,49,82,86,11,47,94
"2011","Liverpool 032B","E01006585","Total",641,268,102,166,373,41,72,47,85,12,32,84
"2011","Liverpool 032C","E01006586","Total",921,414,126,288,507,59,76,85,144,4,44,95
"2011","Liverpool 032D","E01006587","Total",717,259,57,202,458,32,60,73,129,21,39,104
"2011","Liverpool 032E","E01006716","Total",701,285,71,214,416,91,42,71,116,13,28,55
"2011","Liverpool 034A","E01006575","Total",578,205,97,108,373,32,82,58,78,8,33,82
"2011","Liverpool 034B","E01006576","Total",713,191,98,93,522,27,83,117,151,6,38,100
"2011","Liverpool 034C","E01006577","Total",597,145,76,69,452,17,78,94,101,13,39,110
"2011","Liverpool 034D","E01006579","Total",618,131,94,37,487,17,95,109,89,19,46,112
"2011","Liverpool 034E","E01006584","Total",611,205,77,128,406,28,78,70,100,13,38,79
"2011","Liverpool 035A","E01006720","Total",905,361,73,288,544,89,22,80,141,38,35,139
"2011","Liverpool 035B","E01006725","Total",739,308,84,224,431,62,54,71,121,9,21,93
"2011","Liverpool 035C","E01006726","Total",659,226,50,176,433,56,38,43,116,14,18,148
"2011","Liverpool 035D","E01006727","Total",665,238,63,175,427,56,48,57,136,12,27,91
"2011","Liverpool 035E","E01006728","Total",855,399,103,296,456,104,40,65,161,14,16,56
"2011","Liverpool 035F","E01006752","Total",489,232,54,178,257,40,30,35,71,5,25,51
"2011","Liverpool 036A","E01006578","Total",554,139,65,74,415,25,65,85,105,18,37,80
"2011","Liverpool 036B","E01006580","Total",515,113,56,57,402,11,80,75,85,12,39,100
"2011","Liverpool 036C","E01006581","Total",607,138,72,66,469,11,92,112,95,16,37,106
"2011","Liverpool 036D","E01006773","Total",554,114,48,66,440,24,81,98,109,7,27,94
"2011","Liverpool 036E","E01006774","Total",552,124,62,62,428,17,59,95,97,10,50,100
"2011","Liverpool 037A","E01006514","Total",1115,747,72,675,368,24,10,38,206,3,9,78
"2011","Liverpool 037B","E01006515","Total",641,313,91,222,328,44,45,36,123,8,16,56
"2011","Liverpool 037D","E01006673","Total",954,482,125,357,472,91,29,70,148,24,47,63
"2011","Liverpool 037E","E01033757","Total",715,548,15,533,167,20,5,8,91,2,7,34
"2011","Liverpool 037F","E01033768","Total",835,599,50,549,236,30,8,30,117,2,8,41
"2011","Liverpool 038A","E01006550","Total",483,118,27,91,365,9,23,33,81,3,11,205
"2011","Liverpool 038B","E01006557","Total",635,138,41,97,497,21,19,24,101,13,20,299
"2011","Liverpool 038C","E01006721","Total",912,453,136,317,459,115,33,53,173,6,16,63
"2011","Liverpool 038D","E01006722","Total",608,155,56,99,453,33,18,33,81,14,23,251
"2011","Liverpool 038E","E01006723","Total",749,264,63,201,485,31,41,39,112,9,27,226
"2011","Liverpool 038F","E01006724","Total",554,113,36,77,441,13,37,25,78,8,24,256
"2011","Liverpool 039A","E01006552","Total",869,346,48,298,523,129,30,86,137,37,42,62
"2011","Liverpool 039B","E01006556","Total",1016,538,92,446,478,113,37,67,114,22,38,87
"2011","Liverpool 039C","E01006674","Total",826,400,113,287,426,76,50,85,79,37,48,51
"2011","Liverpool 039D","E01006679","Total",920,392,91,301,528,105,55,88,102,61,60,57
"2011","Liverpool 040A","E01006709","Total",685,293,118,175,392,44,67,58,93,7,33,90
"2011","Liverpool 040B","E01006769","Total",712,401,199,202,311,55,73,42,69,11,20,41
"2011","Liverpool 040C","E01006770","Total",445,160,77,83,285,40,59,45,56,7,29,49
"2011","Liverpool 040D","E01006771","Total",694,296,141,155,398,61,71,55,90,11,26,84
"2011","Liverpool 040E","E01006772","Total",480,168,81,87,312,29,58,41,74,6,30,74
"2011","Liverpool 040F","E01006775","Total",556,165,82,83,391,38,86,42,81,13,37,94
"2011","Liverpool 041A","E01006582","Total",585,110,53,57,475,17,83,98,91,14,67,105
"2011","Liverpool 041B","E01006589","Total",599,152,78,74,447,21,73,104,96,14,35,104
"2011","Liverpool 041C","E01006591","Total",671,192,65,127,479,24,60,87,137,15,37,119
"2011","Liverpool 041D","E01006592","Total",624,189,123,66,435,10,93,66,92,18,38,118
"2011","Liverpool 041E","E01006597","Total",683,193,92,101,490,19,89,87,130,17,36,112
"2011","Liverpool 042A","E01006553","Total",642,167,29,138,475,19,26,47,125,13,17,228
"2011","Liverpool 042C","E01006588","Total",702,272,72,200,430,12,60,60,152,9,25,112
"2011","Liverpool 042D","E01006590","Total",701,231,65,166,470,23,49,67,147,7,18,159
"2011","Liverpool 042E","E01006593","Total",662,232,52,180,430,31,41,71,133,11,19,124
"2011","Liverpool 042F","E01033749","Total",1039,973,5,968,66,5,4,12,30,4,1,10
"2011","Liverpool 042G","E01033766","Total",424,104,28,76,320,24,28,30,97,2,19,120
"2011","Liverpool 043A","E01006520","Total",1182,805,140,665,377,16,20,39,270,2,8,22
"2011","Liverpool 043B","E01006549","Total",949,636,48,588,313,25,12,32,157,4,13,70
"2011","Liverpool 043C","E01006675","Total",1132,766,71,695,366,31,11,38,222,5,12,47
"2011","Liverpool 043D","E01006677","Total",477,210,58,152,267,85,21,49,49,11,16,36
"2011","Liverpool 044A","E01006518","Total",835,389,139,250,446,61,70,54,137,15,27,82
"2011","Liverpool 044B","E01006630","Total",555,166,45,121,389,69,48,69,89,11,42,61
"2011","Liverpool 044C","E01006632","Total",884,344,83,261,540,103,91,83,146,16,28,73
"2011","Liverpool 044D","E01006676","Total",761,290,83,207,471,109,46,89,97,27,39,64
"2011","Liverpool 044E","E01006678","Total",1059,513,115,398,546,82,83,69,123,20,48,121
"2011","Liverpool 045A","E01006706","Total",582,186,77,109,396,65,79,50,69,9,39,85
"2011","Liverpool 045B","E01006707","Total",553,163,89,74,390,51,84,46,84,16,31,78
"2011","Liverpool 045C","E01006708","Total",754,249,96,153,505,52,76,99,126,17,50,85
"2011","Liverpool 045D","E01006710","Total",592,136,67,69,456,73,68,59,95,12,43,106
"2011","Liverpool 046A","E01006792","Total",557,138,100,38,419,13,121,74,70,6,38,97
"2011","Liverpool 046B","E01006794","Total",711,224,85,139,487,31,120,90,112,11,29,94
"2011","Liverpool 046C","E01006800","Total",679,257,137,120,422,12,167,49,78,12,21,83
"2011","Liverpool 046D","E01006801","Total",609,171,106,65,438,13,133,56,114,8,19,95
"2011","Liverpool 047A","E01006532","Total",617,149,97,52,468,9,120,82,96,22,41,98
"2011","Liverpool 047B","E01006539","Total",601,176,79,97,425,9,100,66,109,10,34,97
"2011","Liverpool 047C","E01006583","Total",467,85,61,24,382,4,87,79,67,13,36,96
"2011","Liverpool 047D","E01006594","Total",579,172,96,76,407,4,89,69,98,15,39,93
"2011","Liverpool 047E","E01006796","Total",581,105,71,34,476,6,110,77,84,29,39,131
"2011","Liverpool 048A","E01006522","Total",1094,675,58,617,419,50,9,41,271,0,5,43
"2011","Liverpool 048B","E01006524","Total",583,273,72,201,310,18,61,48,125,4,15,39
"2011","Liverpool 048C","E01006526","Total",654,287,81,206,367,23,64,72,118,7,23,60
"2011","Liverpool 048D","E01006529","Total",559,180,58,122,379,15,51,94,106,13,18,82
"2011","Liverpool 048E","E01006551","Total",751,511,209,302,240,22,72,21,83,1,5,36
"2011","Liverpool 048F","E01006554","Total",649,280,34,246,369,13,24,40,107,11,26,148
"2011","Liverpool 049A","E01006525","Total",486,109,61,48,377,7,82,63,82,5,34,104
"2011","Liverpool 049B","E01006595","Total",812,280,128,152,532,40,82,98,174,10,16,112
"2011","Liverpool 049C","E01006596","Total",597,162,78,84,435,13,76,68,124,15,36,103
"2011","Liverpool 049D","E01006689","Total",717,228,98,130,489,21,91,103,133,16,34,91
"2011","Liverpool 050B","E01006633","Total",699,317,145,172,382,69,59,57,91,11,35,60
"2011","Liverpool 050F","E01032505","Total",563,182,68,114,381,34,61,60,87,14,34,91
"2011","Liverpool 050G","E01032506","Total",656,260,72,188,396,45,54,66,122,4,18,87
"2011","Liverpool 050H","E01032507","Total",666,195,43,152,471,27,47,62,172,9,29,125
"2011","Liverpool 050I","E01033748","Total",772,369,15,354,403,28,13,30,302,2,4,24
"2011","Liverpool 050J","E01033767","Total",562,261,65,196,301,87,32,36,77,2,8,59
"2011","Liverpool 051A","E01006793","Total",759,337,134,203,422,46,101,56,119,16,23,61
"2011","Liverpool 051B","E01006795","Total",628,215,89,126,413,15,79,76,114,17,25,87
"2011","Liverpool 051C","E01006797","Total",707,297,101,196,410,42,75,70,95,10,30,88
"2011","Liverpool 051D","E01006798","Total",609,183,74,109,426,17,96,65,111,5,31,101
"2011","Liverpool 051E","E01006799","Total",1145,719,351,368,426,37,124,54,129,5,12,65
"2011","Liverpool 052A","E01006521","Total",928,485,173,312,443,37,90,48,183,9,8,68
"2011","Liverpool 052B","E01006523","Total",830,448,78,370,382,29,31,53,179,7,9,74
"2011","Liverpool 052C","E01006528","Total",613,214,45,169,399,27,42,71,117,8,32,102
"2011","Liverpool 052D","E01006628","Total",651,200,77,123,451,29,54,73,148,12,34,101
"2011","Liverpool 052E","E01006629","Total",573,203,79,124,370,23,62,51,110,8,18,98
"2011","Liverpool 053A","E01006527","Total",638,245,112,133,393,28,81,74,92,8,22,88
"2011","Liverpool 053B","E01006680","Total",605,140,89,51,465,15,92,89,86,11,43,129
"2011","Liverpool 053C","E01006682","Total",498,96,58,38,402,16,87,76,77,15,33,98
"2011","Liverpool 053D","E01006683","Total",594,136,80,56,458,12,97,89,96,13,44,107
"2011","Liverpool 053E","E01006686","Total",531,122,77,45,409,14,84,52,78,18,45,118
"2011","Liverpool 054A","E01006534","Total",649,224,89,135,425,34,61,70,91,14,53,102
"2011","Liverpool 054B","E01006535","Total",656,205,105,100,451,29,71,70,113,10,39,119
"2011","Liverpool 054C","E01006536","Total",815,272,103,169,543,48,106,75,138,12,54,110
"2011","Liverpool 054D","E01006681","Total",719,276,107,169,443,34,87,73,101,10,32,106
"2011","Liverpool 055A","E01006530","Total",616,172,109,63,444,16,129,79,86,4,31,99
"2011","Liverpool 055B","E01006531","Total",674,227,171,56,447,12,164,55,84,10,25,97
"2011","Liverpool 055C","E01006533","Total",614,240,116,124,374,20,85,56,81,12,29,91
"2011","Liverpool 055D","E01006537","Total",964,278,58,220,686,84,97,109,195,16,48,137
"2011","Liverpool 055E","E01006538","Total",527,130,71,59,397,25,76,66,81,10,39,100
"2011","Liverpool 056A","E01006519","Total",514,128,66,62,386,12,74,77,86,15,32,90
"2011","Liverpool 056B","E01006684","Total",999,361,106,255,638,40,104,126,222,20,34,92
"2011","Liverpool 056C","E01006685","Total",604,181,88,93,423,17,85,67,96,18,21,119
"2011","Liverpool 056D","E01006687","Total",933,391,149,242,542,32,92,116,166,14,22,100
"2011","Liverpool 056E","E01006688","Total",712,282,84,198,430,30,83,78,113,12,22,92
"2011","Liverpool 057A","E01006740","Total",604,273,83,190,331,58,41,46,78,27,22,59
"2011","Liverpool 057B","E01006742","Total",591,195,75,120,396,29,68,73,88,14,30,94
"2011","Liverpool 057C","E01006744","Total",739,321,81,240,418,72,58,65,117,14,25,67
"2011","Liverpool 057D","E01006745","Total",907,407,65,342,500,105,54,83,126,9,33,90
"2011","Liverpool 058A","E01006738","Total",662,220,97,123,442,77,65,64,101,15,36,84
"2011","Liverpool 058B","E01006739","Total",707,225,91,134,482,84,56,87,92,24,57,82
"2011","Liverpool 058C","E01006741","Total",778,251,105,146,527,73,88,87,115,7,44,113
"2011","Liverpool 058D","E01006743","Total",1008,385,99,286,623,99,58,129,181,17,42,97
"2011","Liverpool 059A","E01006753","Total",666,211,75,136,455,97,65,63,97,18,39,76
"2011","Liverpool 059B","E01006754","Total",781,322,110,212,459,88,65,65,112,8,44,77
"2011","Liverpool 059C","E01006755","Total",690,257,76,181,433,112,43,65,93,13,37,70
"2011","Liverpool 059D","E01006756","Total",757,220,66,154,537,135,63,94,97,14,43,91
"2011","Liverpool 059E","E01006757","Total",621,203,73,130,418,85,42,79,83,23,34,72
"2011","Liverpool 059F","E01006758","Total",639,199,71,128,440,97,50,65,88,14,37,89
"2011","Liverpool 060A","E01006513","Total",909,467,30,437,442,16,13,17,267,0,6,123
"2011","Liverpool 060B","E01033758","Total",475,312,15,297,163,13,7,13,110,1,5,14
"2011","Liverpool 060C","E01033760","Total",529,330,5,325,199,4,2,4,136,0,1,52
"2011","Liverpool 060D","E01033761","Total",832,415,3,412,417,7,1,8,347,0,1,53
"2011","Liverpool 060E","E01033762","Total",456,282,38,244,174,4,6,8,121,0,3,32
"2011","Liverpool 061A","E01033750","Total",905,504,17,487,401,12,15,37,269,1,5,62
"2011","Liverpool 061B","E01033754","Total",838,396,50,346,442,20,38,24,284,4,9,63
"2011","Liverpool 061C","E01033756","Total",733,414,10,404,319,4,10,20,250,0,2,33
"2011","Liverpool 061D","E01033765","Total",659,282,68,214,377,71,44,50,113,12,22,65
"2011","Liverpool 062A","E01033751","Total",603,313,47,266,290,26,10,23,179,2,11,39
"2011","Liverpool 062B","E01033752","Total",790,448,4,444,342,4,1,24,283,0,1,29
"2011","Liverpool 062C","E01033753","Total",714,423,6,417,291,3,3,19,248,0,1,17
"2011","Liverpool 062D","E01033755","Total",675,341,6,335,334,2,3,24,266,1,0,38
"2011","Sefton 001A","E01006946","Total",680,228,145,83,452,21,175,64,96,9,19,68
"2011","Sefton 001B","E01007028","Total",593,167,90,77,426,39,93,73,112,11,20,78
"2011","Sefton 001C","E01007029","Total",612,195,148,47,417,9,200,46,83,6,16,57
"2011","Sefton 001D","E01007030","Total",636,183,90,93,453,43,82,102,100,23,39,64
"2011","Sefton 001E","E01007036","Total",538,133,85,48,405,22,107,57,118,5,20,76
"2011","Sefton 002A","E01006947","Total",609,160,107,53,449,19,133,67,98,10,33,89
"2011","Sefton 002B","E01007031","Total",586,129,83,46,457,23,105,77,114,24,30,84
"2011","Sefton 002C","E01007032","Total",550,131,83,48,419,19,104,79,100,11,29,77
"2011","Sefton 002D","E01007033","Total",646,177,122,55,469,34,130,83,101,15,25,81
"2011","Sefton 002E","E01007035","Total",620,194,108,86,426,21,124,72,99,20,22,68
"2011","Sefton 003A","E01006944","Total",902,477,301,176,425,27,194,33,129,5,7,30
"2011","Sefton 003B","E01006948","Total",655,301,189,112,354,36,85,45,87,11,16,74
"2011","Sefton 003C","E01006949","Total",730,318,215,103,412,10,164,54,81,11,22,70
"2011","Sefton 003D","E01006951","Total",773,367,194,173,406,27,155,48,96,5,18,57
"2011","Sefton 003E","E01007034","Total",579,175,121,54,404,14,115,64,94,10,34,73
"2011","Sefton 004A","E01006945","Total",802,404,173,231,398,18,106,58,135,5,18,58
"2011","Sefton 004B","E01006950","Total",800,444,144,300,356,22,66,48,159,3,10,48
"2011","Sefton 004C","E01006968","Total",1052,654,214,440,398,43,76,76,143,1,15,44
"2011","Sefton 004D","E01006969","Total",667,266,81,185,401,48,55,75,107,21,21,74
"2011","Sefton 004F","E01033094","Total",565,316,73,243,249,25,53,41,100,0,6,24
"2011","Sefton 004G","E01033097","Total",600,326,110,216,274,25,61,48,89,5,12,34
"2011","Sefton 005A","E01007055","Total",580,138,53,85,442,57,70,84,100,25,35,71
"2011","Sefton 005B","E01007056","Total",672,166,68,98,506,52,72,127,136,13,32,74
"2011","Sefton 005C","E01007057","Total",656,159,76,83,497,74,92,78,132,11,20,90
"2011","Sefton 005D","E01007062","Total",597,170,72,98,427,25,78,94,105,16,31,78
"2011","Sefton 005E","E01007063","Total",635,178,100,78,457,46,62,94,106,20,43,86
"2011","Sefton 006A","E01007058","Total",630,218,70,148,412,44,53,76,119,14,31,75
"2011","Sefton 006B","E01007059","Total",608,149,75,74,459,42,70,97,112,19,34,85
"2011","Sefton 006C","E01007060","Total",590,179,75,104,411,40,55,85,108,27,15,81
"2011","Sefton 006D","E01007061","Total",567,114,40,74,453,48,48,93,115,24,41,84
"2011","Sefton 006E","E01007064","Total",473,108,46,62,365,20,49,70,103,14,41,68
"2011","Sefton 007A","E01006934","Total",648,202,95,107,446,39,67,86,115,15,36,88
"2011","Sefton 007B","E01006970","Total",770,327,100,227,443,43,76,71,136,20,25,72
"2011","Sefton 007C","E01006994","Total",649,191,56,135,458,61,43,93,123,29,31,78
"2011","Sefton 007D","E01006996","Total",645,214,75,139,431,32,62,83,111,23,44,76
"2011","Sefton 007E","E01006998","Total",699,199,76,123,500,72,63,101,128,14,44,78
"2011","Sefton 008A","E01006995","Total",488,121,53,68,367,17,55,60,79,22,44,90
"2011","Sefton 008B","E01006997","Total",613,175,51,124,438,38,58,86,109,22,41,84
"2011","Sefton 008C","E01006999","Total",685,182,112,70,503,42,124,85,111,12,39,90
"2011","Sefton 008D","E01007000","Total",517,141,54,87,376,29,56,77,94,16,40,64
"2011","Sefton 008E","E01007001","Total",670,206,83,123,464,64,55,95,116,23,37,74
"2011","Sefton 008F","E01007002","Total",585,154,90,64,431,25,118,60,119,11,25,73
"2011","Sefton 009A","E01006928","Total",583,143,85,58,440,19,93,79,84,23,40,102
"2011","Sefton 009B","E01006935","Total",688,211,96,115,477,19,91,88,116,29,52,82
"2011","Sefton 009C","E01006971","Total",807,354,193,161,453,13,198,36,119,8,20,59
"2011","Sefton 009D","E01006972","Total",907,478,341,137,429,14,206,43,90,7,18,51
"2011","Sefton 009E","E01006973","Total",643,217,140,77,426,21,160,42,90,11,32,70
"2011","Sefton 009F","E01006974","Total",681,198,116,82,483,16,138,59,133,15,39,83
"2011","Sefton 010A","E01006929","Total",616,159,58,101,457,29,83,89,96,19,41,100
"2011","Sefton 010B","E01006930","Total",620,163,89,74,457,44,83,99,123,13,22,73
"2011","Sefton 010C","E01006931","Total",642,170,96,74,472,26,121,103,85,12,29,96
"2011","Sefton 010D","E01006932","Total",592,115,61,54,477,15,111,90,114,13,34,100
"2011","Sefton 010E","E01006933","Total",595,151,75,76,444,40,82,92,104,27,25,74
"2011","Sefton 011A","E01006920","Total",699,215,136,79,484,40,126,90,89,15,39,85
"2011","Sefton 011B","E01006924","Total",681,259,155,104,422,48,102,78,93,20,25,56
"2011","Sefton 011C","E01006925","Total",598,153,86,67,445,42,75,64,102,25,37,100
"2011","Sefton 011D","E01006927","Total",755,252,170,82,503,37,135,84,121,13,33,80
"2011","Sefton 012A","E01006921","Total",596,159,121,38,437,6,189,53,86,8,23,72
"2011","Sefton 012B","E01006922","Total",605,125,77,48,480,8,183,55,105,6,31,92
"2011","Sefton 012C","E01006923","Total",682,182,147,35,500,9,200,59,129,8,23,72
"2011","Sefton 012D","E01006926","Total",717,178,131,47,539,8,205,62,125,13,27,99
"2011","Sefton 013A","E01006985","Total",599,141,86,55,458,15,143,75,86,19,34,86
"2011","Sefton 013B","E01006986","Total",515,113,82,31,402,9,154,40,88,9,27,75
"2011","Sefton 013C","E01006987","Total",540,143,99,44,397,13,144,48,79,12,29,72
"2011","Sefton 013D","E01006989","Total",557,125,91,34,432,5,173,52,91,15,26,70
"2011","Sefton 013E","E01006990","Total",477,77,51,26,400,13,116,63,76,15,24,93
"2011","Sefton 014A","E01006988","Total",625,226,152,74,399,20,126,58,88,11,25,71
"2011","Sefton 014B","E01007079","Total",650,167,119,48,483,21,144,80,81,27,36,94
"2011","Sefton 014C","E01007080","Total",612,179,89,90,433,23,114,82,99,12,30,73
"2011","Sefton 014D","E01007081","Total",722,293,207,86,429,11,139,72,83,10,24,90
"2011","Sefton 015A","E01006991","Total",603,107,77,30,496,10,181,72,90,18,35,90
"2011","Sefton 015B","E01006992","Total",444,129,92,37,315,5,76,70,65,6,26,67
"2011","Sefton 015C","E01006993","Total",586,117,84,33,469,15,140,59,80,25,40,110
"2011","Sefton 015D","E01007078","Total",646,162,103,59,484,6,158,90,98,14,32,86
"2011","Sefton 016A","E01007075","Total",615,190,116,74,425,30,138,58,89,11,28,71
"2011","Sefton 016B","E01007076","Total",575,148,96,52,427,20,112,67,92,10,42,84
"2011","Sefton 016C","E01007077","Total",593,143,84,59,450,22,100,91,86,23,41,87
"2011","Sefton 016D","E01007082","Total",614,166,103,63,448,25,124,92,94,12,22,79
"2011","Sefton 017A","E01007067","Total",591,170,76,94,421,12,107,61,103,16,32,90
"2011","Sefton 017B","E01007068","Total",481,85,42,43,396,13,80,68,86,10,36,103
"2011","Sefton 017C","E01007069","Total",660,239,128,111,421,36,113,54,91,9,34,84
"2011","Sefton 017D","E01007070","Total",602,128,91,37,474,14,142,58,100,10,38,112
"2011","Sefton 017E","E01007101","Total",608,152,109,43,456,10,144,63,85,6,35,113
"2011","Sefton 018C","E01007095","Total",706,232,163,69,474,14,149,79,84,9,44,95
"2011","Sefton 018D","E01007096","Total",567,154,102,52,413,14,129,44,75,10,33,108
"2011","Sefton 018E","E01007100","Total",593,179,112,67,414,18,94,85,83,10,24,100
"2011","Sefton 018F","E01033096","Total",989,240,148,92,749,34,176,129,169,17,48,176
"2011","Sefton 019A","E01007074","Total",622,168,110,58,454,36,87,89,94,15,38,95
"2011","Sefton 019B","E01007097","Total",654,175,107,68,479,22,144,85,92,7,27,102
"2011","Sefton 019C","E01007098","Total",624,174,97,77,450,13,145,52,102,15,29,94
"2011","Sefton 019D","E01007099","Total",655,241,182,59,414,8,137,51,80,9,32,97
"2011","Sefton 020A","E01007065","Total",501,84,53,31,417,26,64,75,99,14,39,100
"2011","Sefton 020B","E01007066","Total",601,122,70,52,479,25,79,105,111,9,41,109
"2011","Sefton 020C","E01007071","Total",503,121,78,43,382,5,94,69,73,11,32,98
"2011","Sefton 020D","E01007072","Total",685,261,199,62,424,7,160,45,78,5,31,98
"2011","Sefton 020E","E01007073","Total",499,87,48,39,412,6,101,72,74,14,41,104
"2011","Sefton 021A","E01007020","Total",580,178,94,84,402,40,65,61,80,15,41,100
"2011","Sefton 021B","E01007022","Total",597,191,98,93,406,17,85,61,95,22,27,99
"2011","Sefton 021C","E01007023","Total",529,123,70,53,406,9,95,57,88,13,29,115
"2011","Sefton 021D","E01007027","Total",892,216,129,87,676,17,156,85,214,12,40,152
"2011","Sefton 021E","E01007037","Total",656,198,123,75,458,14,123,65,96,13,30,117
"2011","Sefton 021F","E01007038","Total",611,175,92,83,436,26,95,59,86,13,44,113
"2011","Sefton 022A","E01006936","Total",765,341,197,144,424,10,133,43,130,10,24,74
"2011","Sefton 022B","E01006937","Total",482,96,56,40,386,11,69,77,83,22,33,91
"2011","Sefton 022C","E01006938","Total",535,152,93,59,383,7,137,39,91,9,29,71
"2011","Sefton 022D","E01006939","Total",663,225,100,125,438,38,65,78,133,17,32,75
"2011","Sefton 022E","E01006940","Total",599,207,97,110,392,16,92,54,84,19,32,95
"2011","Sefton 022F","E01006943","Total",479,103,72,31,376,7,87,64,80,8,34,96
"2011","Sefton 023A","E01007083","Total",476,123,67,56,353,30,68,50,67,10,27,101
"2011","Sefton 023B","E01007085","Total",580,186,78,108,394,64,71,56,80,13,37,73
"2011","Sefton 023C","E01007086","Total",501,164,82,82,337,48,55,51,80,10,19,74
"2011","Sefton 023D","E01007091","Total",607,235,116,119,372,26,100,50,87,10,37,62
"2011","Sefton 023E","E01007092","Total",459,149,78,71,310,28,69,35,59,10,42,67
"2011","Sefton 024A","E01006979","Total",619,213,87,126,406,70,51,75,86,21,34,69
"2011","Sefton 024B","E01006980","Total",656,224,85,139,432,109,48,65,83,16,37,74
"2011","Sefton 024C","E01007024","Total",478,151,60,91,327,51,53,40,89,7,22,65
"2011","Sefton 024D","E01007026","Total",515,188,105,83,327,34,66,46,74,6,30,71
"2011","Sefton 024E","E01007089","Total",603,220,85,135,383,66,63,51,79,12,34,78
"2011","Sefton 025A","E01007021","Total",541,145,103,42,396,8,101,46,76,9,28,128
"2011","Sefton 025B","E01007025","Total",534,126,85,41,408,11,101,58,83,12,43,100
"2011","Sefton 025C","E01007105","Total",709,240,134,106,469,47,80,101,101,15,34,91
"2011","Sefton 025D","E01007106","Total",630,190,105,85,440,33,84,94,98,9,28,94
"2011","Sefton 025E","E01007107","Total",485,102,63,39,383,12,59,88,68,15,37,104
"2011","Sefton 025F","E01007108","Total",599,116,55,61,483,24,81,104,110,17,41,106
"2011","Sefton 026A","E01007039","Total",512,122,56,66,390,34,63,88,92,6,29,78
"2011","Sefton 026B","E01007040","Total",747,166,65,101,581,39,84,122,158,19,45,114
"2011","Sefton 026C","E01007042","Total",546,171,108,63,375,23,87,60,70,10,25,100
"2011","Sefton 026D","E01007044","Total",621,200,152,48,421,14,158,42,74,9,32,92
"2011","Sefton 026E","E01007045","Total",486,100,57,43,386,17,99,56,70,10,32,102
"2011","Sefton 027A","E01007041","Total",570,155,83,72,415,24,83,75,83,9,41,100
"2011","Sefton 027B","E01007043","Total",611,180,114,66,431,10,141,49,81,9,32,109
"2011","Sefton 027C","E01007046","Total",637,151,72,79,486,32,77,93,121,8,49,106
"2011","Sefton 027D","E01007053","Total",556,141,74,67,415,31,72,84,80,10,42,96
"2011","Sefton 027E","E01007084","Total",539,116,35,81,423,19,54,76,119,17,38,100
"2011","Sefton 028A","E01006941","Total",696,236,124,112,460,32,82,67,117,17,43,102
"2011","Sefton 028B","E01006942","Total",640,194,79,115,446,41,57,92,133,12,23,88
"2011","Sefton 028C","E01006954","Total",680,278,112,166,402,30,54,62,112,7,37,100
"2011","Sefton 028D","E01007104","Total",563,162,72,90,401,12,66,95,97,14,31,86
"2011","Sefton 028E","E01007109","Total",675,214,92,122,461,56,80,73,119,24,32,77
"2011","Sefton 029A","E01007048","Total",635,174,47,127,461,82,35,98,91,20,59,76
"2011","Sefton 029B","E01007054","Total",613,198,85,113,415,41,95,50,92,11,34,92
"2011","Sefton 029C","E01007087","Total",614,242,85,157,372,51,63,38,88,13,34,85
"2011","Sefton 029D","E01007088","Total",575,198,102,96,377,49,57,63,87,7,27,87
"2011","Sefton 029E","E01007090","Total",543,226,82,144,317,57,56,44,57,11,26,66
"2011","Sefton 030A","E01006955","Total",621,117,44,73,504,45,57,94,123,20,43,122
"2011","Sefton 030B","E01006956","Total",679,234,54,180,445,43,45,78,146,17,38,78
"2011","Sefton 030C","E01006958","Total",718,310,96,214,408,44,59,73,129,9,18,76
"2011","Sefton 030D","E01007102","Total",579,146,55,91,433,27,46,95,114,19,46,86
"2011","Sefton 030E","E01007103","Total",614,166,86,80,448,12,102,85,113,12,32,92
"2011","Sefton 031A","E01006978","Total",569,135,64,71,434,22,83,63,115,12,51,88
"2011","Sefton 031B","E01006981","Total",618,203,70,133,415,62,62,56,85,19,39,92
"2011","Sefton 031C","E01006982","Total",557,140,78,62,417,34,83,61,98,17,35,89
"2011","Sefton 031D","E01006983","Total",686,186,70,116,500,53,74,103,132,12,37,89
"2011","Sefton 031E","E01006984","Total",498,103,46,57,395,100,38,61,72,26,34,64
"2011","Sefton 032A","E01006952","Total",627,276,55,221,351,42,46,60,88,15,28,72
"2011","Sefton 032B","E01006953","Total",666,265,65,200,401,59,63,69,99,11,28,72
"2011","Sefton 032C","E01006957","Total",857,505,117,388,352,41,59,40,124,4,20,64
"2011","Sefton 032D","E01006959","Total",666,243,91,152,423,37,68,66,115,11,39,87
"2011","Sefton 032E","E01006977","Total",880,456,279,177,424,50,98,63,109,10,35,59
"2011","Sefton 033A","E01006976","Total",594,156,70,86,438,47,55,88,114,10,31,93
"2011","Sefton 033B","E01007014","Total",650,169,115,54,481,28,96,85,109,14,44,105
"2011","Sefton 033E","E01007047","Total",655,253,112,141,402,35,79,69,95,15,41,68
"2011","Sefton 033F","E01033095","Total",747,191,111,80,556,40,134,87,91,18,46,140
"2011","Sefton 034A","E01007004","Total",654,265,75,190,389,69,43,72,86,13,28,78
"2011","Sefton 034B","E01007005","Total",602,228,36,192,374,102,39,36,81,25,33,58
"2011","Sefton 034C","E01007011","Total",666,288,104,184,378,69,44,44,81,9,37,94
"2011","Sefton 034D","E01007016","Total",738,205,56,149,533,81,63,92,125,20,42,110
"2011","Sefton 034E","E01007017","Total",746,324,73,251,422,89,42,74,100,13,26,78
"2011","Sefton 035A","E01007019","Total",530,130,54,76,400,81,36,61,82,17,48,75
"2011","Sefton 035B","E01007049","Total",652,218,132,86,434,37,66,80,101,9,39,102
"2011","Sefton 035C","E01007050","Total",488,103,60,43,385,22,71,66,69,16,45,96
"2011","Sefton 035D","E01007051","Total",509,158,75,83,351,49,52,49,86,13,32,70
"2011","Sefton 035E","E01007052","Total",548,148,53,95,400,61,52,73,72,22,37,83
"2011","Sefton 036A","E01006964","Total",645,218,64,154,427,61,51,72,113,17,33,80
"2011","Sefton 036B","E01007003","Total",568,225,42,183,343,89,39,53,84,8,26,44
"2011","Sefton 036C","E01007006","Total",605,213,89,124,392,75,52,62,73,18,39,73
"2011","Sefton 036D","E01007012","Total",600,211,51,160,389,60,44,72,111,10,27,65
"2011","Sefton 036E","E01007013","Total",684,301,83,218,383,73,34,71,95,21,15,74
"2011","Sefton 037A","E01006967","Total",753,389,158,231,364,51,63,55,88,6,25,76
"2011","Sefton 037B","E01007007","Total",635,327,95,232,308,48,35,38,96,13,23,55
"2011","Sefton 037C","E01007008","Total",644,289,74,215,355,82,40,54,93,3,16,67
"2011","Sefton 037D","E01007009","Total",654,391,93,298,263,31,33,28,88,9,18,56
"2011","Sefton 037E","E01007010","Total",519,220,66,154,299,76,35,34,68,10,29,47
"2011","Sefton 038A","E01006960","Total",445,91,48,43,354,18,83,41,67,11,38,96
"2011","Sefton 038B","E01006961","Total",632,213,76,137,419,62,45,65,108,15,40,84
"2011","Sefton 038C","E01006962","Total",647,261,138,123,386,38,74,53,85,11,36,89
"2011","Sefton 038D","E01006963","Total",633,218,46,172,415,90,48,70,87,15,32,73
"2011","Sefton 038E","E01006965","Total",580,162,87,75,418,60,62,73,69,14,44,96
"2011","Sefton 038F","E01006966","Total",640,213,88,125,427,50,39,88,105,8,35,102
"2011","St. Helens 001A","E01006882","Total",499,110,73,37,389,5,133,72,73,7,27,72
"2011","St. Helens 001B","E01006883","Total",607,190,121,69,417,15,131,66,101,7,22,75
"2011","St. Helens 001C","E01006884","Total",623,195,122,73,428,13,118,68,111,14,20,84
"2011","St. Helens 001D","E01006885","Total",546,119,84,35,427,11,133,58,118,7,33,67
"2011","St. Helens 001E","E01006886","Total",578,146,93,53,432,10,135,75,104,8,21,79
"2011","St. Helens 001F","E01006887","Total",592,181,78,103,411,42,97,59,102,10,29,72
"2011","St. Helens 002A","E01006802","Total",747,234,118,116,513,26,108,81,140,16,27,115
"2011","St. Helens 002B","E01006804","Total",660,157,92,65,503,24,123,84,118,22,26,106
"2011","St. Helens 002C","E01006806","Total",623,123,73,50,500,10,158,77,110,18,34,93
"2011","St. Helens 002D","E01006807","Total",587,140,85,55,447,8,144,73,109,12,20,81
"2011","St. Helens 003A","E01006803","Total",601,134,69,65,467,21,115,72,121,8,32,98
"2011","St. Helens 003B","E01006805","Total",620,153,64,89,467,35,82,96,113,19,40,82
"2011","St. Helens 003C","E01006808","Total",539,122,42,80,417,11,56,74,135,8,29,104
"2011","St. Helens 003D","E01006809","Total",608,125,77,48,483,16,132,72,119,9,34,101
"2011","St. Helens 004A","E01006849","Total",648,243,116,127,405,64,60,73,88,14,41,65
"2011","St. Helens 004B","E01006850","Total",738,333,146,187,405,53,70,68,94,16,24,80
"2011","St. Helens 004C","E01006851","Total",559,155,78,77,404,26,98,61,102,5,21,91
"2011","St. Helens 004D","E01006852","Total",525,93,46,47,432,15,85,87,118,3,32,92
"2011","St. Helens 004E","E01006853","Total",577,155,57,98,422,20,79,81,109,4,28,101
"2011","St. Helens 004F","E01006854","Total",640,199,77,122,441,38,64,92,117,12,26,92
"2011","St. Helens 004G","E01006855","Total",638,174,84,90,464,53,94,67,125,15,29,81
"2011","St. Helens 005A","E01006836","Total",600,158,78,80,442,32,103,67,102,16,33,89
"2011","St. Helens 005B","E01006839","Total",572,155,76,79,417,16,85,61,115,9,29,102
"2011","St. Helens 005C","E01006840","Total",669,190,84,106,479,29,100,67,147,15,24,97
"2011","St. Helens 005D","E01006842","Total",657,199,85,114,458,74,56,85,111,25,32,75
"2011","St. Helens 006A","E01006837","Total",614,132,62,70,482,39,85,109,116,16,28,89
"2011","St. Helens 006B","E01006838","Total",718,303,161,142,415,32,90,73,125,14,22,59
"2011","St. Helens 006C","E01006841","Total",645,122,71,51,523,21,85,132,129,18,43,95
"2011","St. Helens 006D","E01006843","Total",543,151,80,71,392,40,116,58,83,8,23,64
"2011","St. Helens 007A","E01006914","Total",527,124,78,46,403,10,134,67,93,9,32,58
"2011","St. Helens 007B","E01006915","Total",671,208,115,93,463,29,76,84,117,12,35,110
"2011","St. Helens 007C","E01006916","Total",660,210,94,116,450,37,64,86,122,10,35,96
"2011","St. Helens 007D","E01006917","Total",674,164,108,56,510,22,119,113,105,14,40,97
"2011","St. Helens 007E","E01006918","Total",511,134,50,84,377,25,56,80,101,7,42,66
"2011","St. Helens 007F","E01006919","Total",643,174,69,105,469,89,57,92,102,22,36,71
"2011","St. Helens 008A","E01006810","Total",493,71,28,43,422,12,91,65,106,11,39,98
"2011","St. Helens 008B","E01006811","Total",613,189,90,99,424,34,112,47,109,13,26,83
"2011","St. Helens 008C","E01006812","Total",593,155,69,86,438,84,56,89,98,15,29,67
"2011","St. Helens 008D","E01006813","Total",697,262,112,150,435,43,85,77,107,11,30,82
"2011","St. Helens 008E","E01006814","Total",602,93,43,50,509,17,88,108,140,6,40,110
"2011","St. Helens 008F","E01006815","Total",557,160,87,73,397,39,87,59,101,11,26,74
"2011","St. Helens 008G","E01006818","Total",530,101,43,58,429,21,72,72,139,6,20,99
"2011","St. Helens 009A","E01006822","Total",559,117,71,46,442,22,105,90,104,16,24,81
"2011","St. Helens 009B","E01006823","Total",570,165,129,36,405,6,173,65,59,1,31,70
"2011","St. Helens 009C","E01006824","Total",517,144,99,45,373,14,87,80,88,16,19,69
"2011","St. Helens 009D","E01006825","Total",607,131,76,55,476,13,140,72,112,11,29,99
"2011","St. Helens 010A","E01006866","Total",642,177,87,90,465,67,68,77,123,28,38,64
"2011","St. Helens 010B","E01006867","Total",784,160,48,112,624,33,65,181,178,23,49,95
"2011","St. Helens 010C","E01006868","Total",656,233,97,136,423,43,65,90,115,17,35,58
"2011","St. Helens 010D","E01006869","Total",655,224,72,152,431,44,72,80,114,15,29,77
"2011","St. Helens 011A","E01006819","Total",608,145,55,90,463,43,53,83,129,16,42,97
"2011","St. Helens 011B","E01006820","Total",611,182,69,113,429,74,41,74,113,19,37,71
"2011","St. Helens 011C","E01006821","Total",652,241,109,132,411,82,64,61,90,17,30,67
"2011","St. Helens 011D","E01006871","Total",669,243,71,172,426,66,55,67,108,25,35,70
"2011","St. Helens 012A","E01006832","Total",781,314,39,275,467,46,28,134,170,18,24,47
"2011","St. Helens 012B","E01006834","Total",610,260,72,188,350,60,46,52,129,5,11,47
"2011","St. Helens 012C","E01006877","Total",734,376,158,218,358,44,78,37,113,3,20,63
"2011","St. Helens 012D","E01006880","Total",763,355,112,243,408,77,60,67,125,5,19,55
"2011","St. Helens 012E","E01006881","Total",735,342,103,239,393,51,59,68,112,9,22,72
"2011","St. Helens 013A","E01006863","Total",829,377,126,251,452,68,65,88,129,9,26,67
"2011","St. Helens 013B","E01006864","Total",818,233,63,170,585,37,66,130,210,12,29,101
"2011","St. Helens 013C","E01006865","Total",840,320,181,139,520,87,101,88,127,15,23,79
"2011","St. Helens 014A","E01006845","Total",685,236,83,153,449,47,71,87,125,15,24,80
"2011","St. Helens 014B","E01006870","Total",648,252,85,167,396,44,64,77,110,10,23,68
"2011","St. Helens 014C","E01006872","Total",777,405,129,276,372,53,62,51,136,6,22,42
"2011","St. Helens 014D","E01006873","Total",495,166,76,90,329,76,49,51,57,17,28,51
"2011","St. Helens 014E","E01006874","Total",583,237,73,164,346,76,40,57,96,14,20,43
"2011","St. Helens 015A","E01006856","Total",614,199,60,139,415,23,54,98,143,9,26,62
"2011","St. Helens 015B","E01006857","Total",606,166,83,83,440,17,108,88,109,8,18,92
"2011","St. Helens 015C","E01006858","Total",597,155,57,98,442,67,52,85,113,20,36,69
"2011","St. Helens 015D","E01006859","Total",694,178,84,94,516,11,112,113,145,10,46,79
"2011","St. Helens 015E","E01006860","Total",625,179,59,120,446,37,78,78,150,13,24,66
"2011","St. Helens 015F","E01006861","Total",631,176,71,105,455,88,49,97,103,14,36,68
"2011","St. Helens 015G","E01006862","Total",581,196,91,105,385,36,60,76,101,13,24,75
"2011","St. Helens 016A","E01006831","Total",662,220,75,145,442,44,64,101,123,10,22,78
"2011","St. Helens 016B","E01006833","Total",754,264,103,161,490,54,72,93,153,7,28,83
"2011","St. Helens 016C","E01006835","Total",647,238,93,145,409,29,82,65,121,13,25,74
"2011","St. Helens 016D","E01006876","Total",679,225,77,148,454,51,84,73,124,8,27,87
"2011","St. Helens 016E","E01006878","Total",648,225,95,130,423,44,72,69,147,5,22,64
"2011","St. Helens 016F","E01006879","Total",598,149,75,74,449,50,61,87,105,21,46,79
"2011","St. Helens 016G","E01006904","Total",670,153,76,77,517,59,85,86,120,14,42,111
"2011","St. Helens 017A","E01006816","Total",706,233,76,157,473,77,38,88,123,26,40,81
"2011","St. Helens 017B","E01006817","Total",623,260,91,169,363,62,49,50,87,16,33,66
"2011","St. Helens 017C","E01006875","Total",509,117,61,56,392,65,52,58,81,13,33,90
"2011","St. Helens 017D","E01006899","Total",813,210,76,134,603,71,79,135,148,33,44,93
"2011","St. Helens 018A","E01006826","Total",648,249,101,148,399,23,112,52,107,11,28,66
"2011","St. Helens 018B","E01006827","Total",614,132,52,80,482,27,73,129,108,16,48,81
"2011","St. Helens 018C","E01006828","Total",877,227,143,84,650,19,150,107,155,18,51,150
"2011","St. Helens 018D","E01006829","Total",518,137,70,67,381,12,97,64,104,10,24,70
"2011","St. Helens 019A","E01006830","Total",538,160,85,75,378,65,43,53,82,23,39,73
"2011","St. Helens 019C","E01006903","Total",752,331,151,180,421,44,81,71,119,18,27,61
"2011","St. Helens 019D","E01006905","Total",584,178,55,123,406,61,63,52,103,12,24,91
"2011","St. Helens 019E","E01006906","Total",661,214,78,136,447,54,64,92,127,6,25,79
"2011","St. Helens 019F","E01006907","Total",668,197,70,127,471,49,88,96,118,8,31,81
"2011","St. Helens 019G","E01006912","Total",613,179,46,133,434,80,44,88,106,22,28,66
"2011","St. Helens 019H","E01006913","Total",525,122,63,59,403,49,72,60,96,20,32,74
"2011","St. Helens 019I","E01032904","Total",688,122,60,62,566,24,104,163,110,24,55,86
"2011","St. Helens 019J","E01032905","Total",671,231,149,82,440,19,70,106,116,25,40,64
"2011","St. Helens 020A","E01006844","Total",771,309,104,205,462,77,72,81,124,12,36,60
"2011","St. Helens 020B","E01006846","Total",616,163,100,63,453,20,124,79,118,8,24,80
"2011","St. Helens 020C","E01006847","Total",685,183,58,125,502,76,49,121,104,18,44,90
"2011","St. Helens 020D","E01006848","Total",629,205,80,125,424,20,74,80,124,7,24,95
"2011","St. Helens 020E","E01006896","Total",660,155,79,76,505,15,125,81,138,7,25,114
"2011","St. Helens 020F","E01006897","Total",629,174,79,95,455,21,88,69,125,6,26,120
"2011","St. Helens 020G","E01006901","Total",533,116,47,69,417,35,62,71,116,8,32,93
"2011","St. Helens 021A","E01006890","Total",616,168,79,89,448,41,100,70,106,11,34,86
"2011","St. Helens 021B","E01006892","Total",482,121,73,48,361,10,83,65,80,7,29,87
"2011","St. Helens 021C","E01006893","Total",617,206,92,114,411,40,88,71,82,8,29,93
"2011","St. Helens 021D","E01006894","Total",584,146,101,45,438,14,157,71,73,7,28,88
"2011","St. Helens 022A","E01006898","Total",744,249,129,120,495,50,132,72,112,11,32,86
"2011","St. Helens 022B","E01006900","Total",1066,236,41,195,830,64,67,239,242,31,64,123
"2011","St. Helens 022C","E01006908","Total",604,215,56,159,389,67,42,75,101,14,23,67
"2011","St. Helens 022D","E01006909","Total",497,121,40,81,376,90,46,58,72,28,34,48
"2011","St. Helens 022E","E01006910","Total",749,232,77,155,517,70,71,95,133,12,35,101
"2011","St. Helens 022F","E01006911","Total",616,118,64,54,498,12,137,68,115,12,36,118
"2011","St. Helens 023A","E01006888","Total",499,120,80,40,379,6,134,65,66,8,19,81
"2011","St. Helens 023B","E01006889","Total",570,125,64,61,445,19,103,83,80,15,35,110
"2011","St. Helens 023C","E01006891","Total",538,131,84,47,407,16,107,75,69,10,37,93
"2011","St. Helens 023D","E01006895","Total",645,208,133,75,437,8,188,45,83,5,22,86
"2011","Wirral 001A","E01007229","Total",699,210,63,147,489,72,61,84,129,16,45,82
"2011","Wirral 001B","E01007230","Total",566,188,78,110,378,36,78,47,118,11,29,59
"2011","Wirral 001C","E01007231","Total",728,287,86,201,441,33,82,80,124,8,34,80
"2011","Wirral 001D","E01007237","Total",866,485,243,242,381,42,112,53,102,8,16,48
"2011","Wirral 001E","E01007238","Total",873,473,160,313,400,61,64,45,141,11,21,57
"2011","Wirral 002A","E01007218","Total",654,235,65,170,419,70,35,80,118,17,28,71
"2011","Wirral 002B","E01007232","Total",619,226,74,152,393,39,60,69,112,10,31,72
"2011","Wirral 002C","E01007233","Total",765,269,121,148,496,57,62,83,127,36,42,89
"2011","Wirral 002D","E01007234","Total",715,255,64,191,460,56,81,70,130,7,46,70
"2011","Wirral 002E","E01007236","Total",593,198,99,99,395,50,55,77,104,9,29,71
"2011","Wirral 003A","E01007307","Total",700,185,66,119,515,27,98,69,123,12,61,125
"2011","Wirral 003B","E01007308","Total",731,312,151,161,419,20,115,54,108,10,33,79
"2011","Wirral 003C","E01007312","Total",662,221,141,80,441,27,103,73,98,13,32,95
"2011","Wirral 003D","E01007313","Total",761,318,165,153,443,45,94,55,109,8,35,97
"2011","Wirral 003E","E01007315","Total",611,148,90,58,463,36,78,100,102,8,39,100
"2011","Wirral 004A","E01007211","Total",502,139,74,65,363,16,81,62,83,8,32,81
"2011","Wirral 004B","E01007235","Total",607,155,78,77,452,40,87,84,97,14,40,90
"2011","Wirral 004C","E01007310","Total",528,122,69,53,406,18,72,75,77,14,35,115
"2011","Wirral 004D","E01007311","Total",616,163,107,56,453,10,98,69,118,8,36,114
"2011","Wirral 004E","E01007314","Total",605,158,60,98,447,42,66,78,107,13,37,104
"2011","Wirral 004F","E01007316","Total",598,133,75,58,465,28,96,74,91,11,38,127
"2011","Wirral 005A","E01007215","Total",784,395,160,235,389,67,67,64,91,16,35,49
"2011","Wirral 005B","E01007216","Total",661,207,67,140,454,77,66,79,97,21,29,85
"2011","Wirral 005C","E01007219","Total",628,215,61,154,413,40,60,63,81,26,46,97
"2011","Wirral 005D","E01007220","Total",548,215,40,175,333,82,34,52,70,15,26,54
"2011","Wirral 005E","E01007275","Total",680,244,64,180,436,80,40,79,114,13,32,78
"2011","Wirral 006A","E01007203","Total",860,240,71,169,620,40,83,112,201,19,51,114
"2011","Wirral 006B","E01007205","Total",619,188,86,102,431,36,77,77,85,26,47,83
"2011","Wirral 006C","E01007210","Total",869,286,97,189,583,95,99,80,153,25,35,96
"2011","Wirral 006D","E01007309","Total",621,148,90,58,473,15,128,91,85,14,34,106
"2011","Wirral 007A","E01007212","Total",618,168,89,79,450,20,105,72,116,17,37,83
"2011","Wirral 007B","E01007213","Total",648,177,94,83,471,34,101,68,115,12,34,107
"2011","Wirral 007C","E01007214","Total",691,291,121,170,400,53,84,62,87,9,36,69
"2011","Wirral 007D","E01007217","Total",790,333,116,217,457,82,64,72,123,11,29,76
"2011","Wirral 007E","E01007276","Total",605,147,59,88,458,57,74,89,91,17,46,84
"2011","Wirral 008A","E01007272","Total",605,194,56,138,411,74,64,66,77,22,33,75
"2011","Wirral 008B","E01007273","Total",667,296,93,203,371,103,33,68,95,9,18,45
"2011","Wirral 008C","E01007274","Total",670,315,116,199,355,113,31,57,71,14,20,49
"2011","Wirral 008D","E01007277","Total",648,243,70,173,405,84,60,58,80,13,33,77
"2011","Wirral 008E","E01007278","Total",658,253,87,166,405,84,46,69,95,22,24,65
"2011","Wirral 009A","E01007204","Total",677,217,76,141,460,135,37,66,84,34,44,60
"2011","Wirral 009B","E01007206","Total",730,158,57,101,572,55,75,130,147,15,49,101
"2011","Wirral 009C","E01007207","Total",685,314,135,179,371,67,78,39,91,16,22,58
"2011","Wirral 009D","E01007209","Total",685,360,199,161,325,37,91,43,57,13,20,64
"2011","Wirral 010C","E01007269","Total",815,281,75,206,534,121,55,73,148,17,43,77
"2011","Wirral 010D","E01007270","Total",778,290,80,210,488,96,46,90,116,16,27,97
"2011","Wirral 010E","E01007271","Total",745,261,83,178,484,96,63,91,112,17,26,79
"2011","Wirral 010F","E01032903","Total",1081,364,110,254,717,146,103,126,149,25,40,128
"2011","Wirral 011A","E01007120","Total",543,144,57,87,399,84,44,70,91,21,35,54
"2011","Wirral 011B","E01007121","Total",686,275,78,197,411,90,41,70,111,20,21,58
"2011","Wirral 011C","E01007122","Total",720,349,96,253,371,116,45,38,89,19,14,50
"2011","Wirral 011D","E01007123","Total",733,207,46,161,526,163,32,112,120,18,24,57
"2011","Wirral 011E","E01007124","Total",614,200,73,127,414,107,37,57,75,24,35,79
"2011","Wirral 012A","E01007208","Total",734,214,97,117,520,51,98,77,127,24,38,105
"2011","Wirral 012B","E01007221","Total",651,188,86,102,463,40,102,68,122,7,35,89
"2011","Wirral 012C","E01007225","Total",771,194,123,71,577,19,169,80,136,22,40,111
"2011","Wirral 012D","E01007227","Total",645,243,130,113,402,46,65,61,97,19,34,80
"2011","Wirral 012E","E01007228","Total",706,318,163,155,388,38,86,69,97,10,19,69
"2011","Wirral 013A","E01007195","Total",647,135,85,50,512,29,124,89,103,14,40,113
"2011","Wirral 013B","E01007199","Total",602,122,78,44,480,8,131,89,87,20,41,104
"2011","Wirral 013C","E01007222","Total",707,199,83,116,508,54,82,98,143,12,26,93
"2011","Wirral 013D","E01007223","Total",556,146,15,131,410,30,38,116,137,10,36,43
"2011","Wirral 014A","E01007193","Total",740,257,146,111,483,21,135,64,131,17,34,81
"2011","Wirral 014B","E01007194","Total",668,269,115,154,399,28,67,81,115,13,22,73
"2011","Wirral 014C","E01007200","Total",655,158,97,61,497,9,93,118,109,18,41,109
"2011","Wirral 014D","E01007201","Total",640,208,107,101,432,27,77,80,119,23,28,78
"2011","Wirral 014E","E01007202","Total",623,216,96,120,407,40,79,69,110,12,19,78
"2011","Wirral 015A","E01007125","Total",784,280,90,190,504,97,61,93,135,13,32,73
"2011","Wirral 015B","E01007156","Total",660,240,70,170,420,26,85,54,111,15,24,105
"2011","Wirral 015C","E01007157","Total",601,149,69,80,452,40,67,107,87,10,40,101
"2011","Wirral 015D","E01007158","Total",684,235,110,125,449,26,99,62,119,11,41,91
"2011","Wirral 015E","E01007159","Total",721,182,82,100,539,31,134,109,126,17,50,72
"2011","Wirral 016A","E01007126","Total",1170,744,117,627,426,98,51,58,167,8,12,32
"2011","Wirral 016B","E01007127","Total",670,240,53,187,430,118,34,70,86,22,28,72
"2011","Wirral 016C","E01007128","Total",926,562,204,358,364,63,47,57,94,24,23,56
"2011","Wirral 016D","E01007129","Total",761,378,80,298,383,82,49,58,105,10,29,50
"2011","Wirral 016E","E01007133","Total",679,443,138,305,236,50,33,29,69,6,14,35
"2011","Wirral 017A","E01007224","Total",610,152,79,73,458,20,93,85,120,10,33,97
"2011","Wirral 017B","E01007226","Total",746,236,146,90,510,30,129,78,149,7,22,95
"2011","Wirral 017C","E01007265","Total",531,124,55,69,407,20,70,102,87,15,32,81
"2011","Wirral 017D","E01007299","Total",589,181,91,90,408,33,68,74,108,14,21,90
"2011","Wirral 017E","E01007306","Total",726,232,88,144,494,38,86,92,152,10,28,88
"2011","Wirral 018A","E01007297","Total",618,214,147,67,404,47,90,70,82,14,34,67
"2011","Wirral 018B","E01007298","Total",598,143,103,40,455,13,124,54,94,19,42,109
"2011","Wirral 018C","E01007301","Total",707,203,108,95,504,38,109,93,112,12,36,104
"2011","Wirral 018D","E01007302","Total",711,298,112,186,413,35,90,80,105,9,22,72
"2011","Wirral 018E","E01007305","Total",734,223,103,120,511,32,116,83,143,9,36,92
"2011","Wirral 019A","E01007119","Total",614,176,83,93,438,79,79,41,114,13,38,74
"2011","Wirral 019B","E01007161","Total",646,183,92,91,463,22,123,72,105,20,35,86
"2011","Wirral 019C","E01007162","Total",556,131,63,68,425,77,56,52,77,22,59,82
"2011","Wirral 019D","E01007300","Total",794,260,96,164,534,87,76,94,120,22,52,83
"2011","Wirral 020A","E01007155","Total",919,520,147,373,399,39,64,54,125,8,24,85
"2011","Wirral 020B","E01007160","Total",822,352,87,265,470,41,81,90,137,15,29,77
"2011","Wirral 020C","E01007240","Total",861,498,110,388,363,36,54,52,147,6,19,49
"2011","Wirral 020D","E01007241","Total",703,304,170,134,399,11,120,62,107,9,16,74
"2011","Wirral 020E","E01007242","Total",864,388,196,192,476,23,120,74,156,6,29,68
"2011","Wirral 021A","E01007130","Total",716,235,63,172,481,87,41,85,108,29,54,77
"2011","Wirral 021B","E01007131","Total",724,278,84,194,446,113,33,86,109,15,27,63
"2011","Wirral 021C","E01007179","Total",612,257,64,193,355,76,36,57,96,8,29,53
"2011","Wirral 021D","E01007291","Total",917,456,94,362,461,116,44,77,144,3,18,59
"2011","Wirral 021E","E01007292","Total",679,275,76,199,404,105,45,63,93,17,32,49
"2011","Wirral 021F","E01007294","Total",673,223,64,159,450,119,43,94,112,19,21,42
"2011","Wirral 022A","E01007180","Total",685,278,106,172,407,33,66,51,104,12,41,100
"2011","Wirral 022B","E01007181","Total",640,218,67,151,422,58,49,77,116,15,29,78
"2011","Wirral 022C","E01007239","Total",781,294,76,218,487,84,47,87,150,22,27,70
"2011","Wirral 022D","E01007243","Total",824,368,158,210,456,28,118,76,123,10,23,78
"2011","Wirral 022E","E01007244","Total",913,318,63,255,595,115,45,130,147,27,33,98
"2011","Wirral 023A","E01007259","Total",496,117,79,38,379,10,86,65,85,12,31,90
"2011","Wirral 023B","E01007261","Total",615,171,117,54,444,14,168,53,93,12,23,81
"2011","Wirral 023C","E01007264","Total",656,207,110,97,449,19,138,74,107,9,16,86
"2011","Wirral 023D","E01007266","Total",617,140,103,37,477,15,122,85,100,22,32,101
"2011","Wirral 023E","E01007267","Total",622,168,92,76,454,27,96,75,119,13,25,99
"2011","Wirral 023F","E01007268","Total",581,194,105,89,387,21,108,55,103,8,22,70
"2011","Wirral 024A","E01007163","Total",907,199,83,116,708,53,114,146,161,35,59,140
"2011","Wirral 024B","E01007245","Total",639,164,101,63,475,20,105,77,108,15,29,121
"2011","Wirral 024C","E01007246","Total",592,97,47,50,495,24,100,91,105,14,38,123
"2011","Wirral 024D","E01007247","Total",658,116,45,71,542,24,93,129,119,20,43,114
"2011","Wirral 024E","E01007252","Total",655,181,85,96,474,20,93,90,128,17,34,92
"2011","Wirral 025A","E01007249","Total",592,217,92,125,375,57,50,72,83,18,26,69
"2011","Wirral 025B","E01007251","Total",542,193,83,110,349,15,82,63,87,5,14,83
"2011","Wirral 025C","E01007257","Total",626,275,100,175,351,53,51,69,82,15,31,50
"2011","Wirral 025D","E01007303","Total",700,317,158,159,383,60,58,56,87,14,31,77
"2011","Wirral 025E","E01007304","Total",641,198,81,117,443,92,58,74,96,12,38,73
"2011","Wirral 026A","E01007196","Total",749,325,211,114,424,24,113,79,92,19,27,70
"2011","Wirral 026B","E01007197","Total",662,161,85,76,501,22,116,98,112,34,40,79
"2011","Wirral 026C","E01007198","Total",836,365,202,163,471,34,98,89,144,22,28,56
"2011","Wirral 026D","E01007263","Total",627,206,119,87,421,32,100,70,98,11,35,75
"2011","Wirral 026E","E01007282","Total",665,266,145,121,399,32,69,90,108,19,15,66
"2011","Wirral 027A","E01007175","Total",844,365,102,263,479,77,55,71,121,22,42,91
"2011","Wirral 027B","E01007290","Total",835,411,124,287,424,97,43,60,104,21,34,65
"2011","Wirral 027C","E01007293","Total",713,326,129,197,387,126,41,47,79,15,35,44
"2011","Wirral 027D","E01007295","Total",522,183,31,152,339,75,21,48,96,15,24,60
"2011","Wirral 027E","E01007296","Total",813,323,91,232,490,124,55,86,112,20,29,64
"2011","Wirral 028A","E01007258","Total",624,165,89,76,459,21,114,84,117,14,20,89
"2011","Wirral 028B","E01007260","Total",643,154,104,50,489,20,117,93,115,20,34,90
"2011","Wirral 028C","E01007262","Total",637,152,103,49,485,12,150,82,118,14,35,74
"2011","Wirral 028D","E01007281","Total",594,192,124,68,402,4,132,78,90,16,25,57
"2011","Wirral 028E","E01007283","Total",492,92,66,26,400,15,134,45,84,16,31,75
"2011","Wirral 029A","E01007173","Total",590,145,77,68,445,28,78,64,91,19,39,126
"2011","Wirral 029B","E01007174","Total",646,179,84,95,467,49,70,93,102,14,39,100
"2011","Wirral 029C","E01007176","Total",739,309,78,231,430,53,51,93,113,14,24,82
"2011","Wirral 029D","E01007177","Total",684,235,127,108,449,52,108,65,104,11,32,77
"2011","Wirral 029E","E01007178","Total",711,278,95,183,433,40,85,68,106,11,38,85
"2011","Wirral 030A","E01007248","Total",577,156,60,96,421,12,95,66,73,23,46,106
"2011","Wirral 030B","E01007250","Total",559,131,81,50,428,14,94,76,85,15,38,106
"2011","Wirral 030C","E01007253","Total",727,293,143,150,434,45,93,75,92,14,25,90
"2011","Wirral 030D","E01007254","Total",607,125,72,53,482,12,134,75,111,10,39,101
"2011","Wirral 031A","E01007115","Total",673,207,97,110,466,29,84,89,118,27,37,82
"2011","Wirral 031B","E01007138","Total",782,331,102,229,451,77,59,70,129,22,26,68
"2011","Wirral 031C","E01007139","Total",683,250,65,185,433,53,43,91,118,17,32,79
"2011","Wirral 031D","E01007141","Total",861,396,170,226,465,52,114,74,141,7,9,68
"2011","Wirral 031E","E01007289","Total",664,218,42,176,446,122,32,83,96,22,32,59
"2011","Wirral 032A","E01007111","Total",593,103,61,42,490,16,93,109,98,13,38,123
"2011","Wirral 032B","E01007112","Total",655,208,88,120,447,39,93,86,95,17,26,91
"2011","Wirral 032C","E01007113","Total",586,180,101,79,406,12,80,88,97,12,30,87
"2011","Wirral 032D","E01007114","Total",591,125,46,79,466,70,58,110,91,28,26,83
"2011","Wirral 032E","E01007116","Total",683,219,118,101,464,30,118,83,99,18,27,89
"2011","Wirral 033A","E01007280","Total",741,231,137,94,510,27,105,96,109,19,42,112
"2011","Wirral 033B","E01007284","Total",691,166,97,69,525,6,144,80,142,12,34,107
"2011","Wirral 033C","E01007285","Total",638,161,99,62,477,27,151,65,92,13,41,88
"2011","Wirral 033D","E01007287","Total",871,290,207,83,581,18,184,76,144,10,32,117
"2011","Wirral 034A","E01007183","Total",527,118,59,59,409,8,103,86,101,18,19,74
"2011","Wirral 034B","E01007255","Total",655,210,109,101,445,18,108,80,106,13,35,85
"2011","Wirral 034C","E01007256","Total",746,248,178,70,498,18,182,62,113,8,33,82
"2011","Wirral 034D","E01007279","Total",667,149,83,66,518,37,113,92,121,17,42,96
"2011","Wirral 034E","E01007286","Total",639,198,95,103,441,34,90,71,130,12,31,73
"2011","Wirral 035A","E01007110","Total",706,209,115,94,497,26,124,90,128,13,30,86
"2011","Wirral 035B","E01007117","Total",640,127,71,56,513,39,88,127,98,21,36,104
"2011","Wirral 035C","E01007118","Total",656,238,107,131,418,42,76,78,87,19,33,83
"2011","Wirral 035D","E01007151","Total",636,162,114,48,474,30,104,102,95,15,38,90
"2011","Wirral 035E","E01007154","Total",621,130,78,52,491,17,123,106,104,14,27,100
"2011","Wirral 036A","E01007140","Total",787,285,91,194,502,53,62,128,155,16,22,66
"2011","Wirral 036B","E01007142","Total",761,188,74,114,573,22,145,92,187,6,29,92
"2011","Wirral 036C","E01007143","Total",703,200,59,141,503,66,66,116,128,20,18,89
"2011","Wirral 036D","E01007152","Total",771,292,192,100,479,34,109,89,125,19,30,73
"2011","Wirral 036E","E01007153","Total",643,243,159,84,400,25,94,77,84,14,26,80
"2011","Wirral 037A","E01007182","Total",736,283,187,96,453,13,147,64,119,18,20,72
"2011","Wirral 037B","E01007184","Total",642,199,130,69,443,21,108,105,98,14,20,77
"2011","Wirral 037C","E01007185","Total",699,226,105,121,473,42,83,104,134,21,29,60
"2011","Wirral 037D","E01007192","Total",611,233,164,69,378,10,132,58,77,14,26,61
"2011","Wirral 037E","E01007288","Total",746,264,171,93,482,42,151,64,100,12,33,80
"2011","Wirral 038A","E01007144","Total",545,156,82,74,389,9,116,65,95,7,27,70
"2011","Wirral 038B","E01007145","Total",537,99,56,43,438,7,149,65,88,6,20,103
"2011","Wirral 038C","E01007146","Total",714,226,120,106,488,21,124,73,132,11,32,95
"2011","Wirral 038D","E01007147","Total",606,154,81,73,452,20,137,73,107,15,23,77
"2011","Wirral 038E","E01007148","Total",664,132,88,44,532,3,180,81,114,15,36,103
"2011","Wirral 039A","E01007135","Total",635,163,94,69,472,24,131,75,111,20,28,83
"2011","Wirral 039B","E01007136","Total",699,193,89,104,506,72,67,93,123,29,33,89
"2011","Wirral 039C","E01007137","Total",779,325,137,188,454,44,77,82,125,18,30,78
"2011","Wirral 039D","E01007170","Total",634,160,100,60,474,11,135,91,95,17,39,86
"2011","Wirral 040A","E01007186","Total",660,161,101,60,499,19,143,103,91,20,29,94
"2011","Wirral 040B","E01007187","Total",653,162,95,67,491,5,190,60,124,13,19,80
"2011","Wirral 040C","E01007188","Total",616,142,105,37,474,14,135,92,108,15,32,78
"2011","Wirral 040D","E01007189","Total",717,199,139,60,518,5,201,74,109,20,29,80
"2011","Wirral 040E","E01007190","Total",641,159,109,50,482,10,179,66,102,25,33,67
"2011","Wirral 040F","E01007191","Total",534,97,77,20,437,3,158,65,75,19,40,77
"2011","Wirral 041A","E01007149","Total",621,146,86,60,475,12,153,78,96,9,25,102
"2011","Wirral 041B","E01007150","Total",593,129,62,67,464,15,120,84,100,19,36,90
"2011","Wirral 041C","E01007165","Total",570,142,94,48,428,13,134,65,94,12,28,82
"2011","Wirral 041D","E01007171","Total",617,150,91,59,467,12,101,95,101,25,32,101
"2011","Wirral 041E","E01007172","Total",608,159,96,63,449,11,122,71,113,18,32,82
"2011","Wirral 042A","E01007164","Total",737,234,103,131,503,31,78,116,128,21,38,91
"2011","Wirral 042B","E01007166","Total",636,167,109,58,469,20,137,71,110,10,21,100
"2011","Wirral 042C","E01007167","Total",615,179,87,92,436,44,79,66,108,25,37,77
"2011","Wirral 042D","E01007168","Total",777,293,149,144,484,45,109,80,130,18,24,78
"2011","Wirral 042E","E01007169","Total",761,231,121,110,530,43,112,92,138,15,36,94
"2011","East Riding of Yorkshire 001A","E01012933","Total",476,125,76,49,351,8,134,39,95,4,19,52
"2011","East Riding of Yorkshire 001B","E01012934","Total",711,215,124,91,496,29,166,63,135,12,21,70
"2011","East Riding of Yorkshire 001C","E01012938","Total",1095,328,174,154,767,39,281,112,219,21,34,61
"2011","East Riding of Yorkshire 001D","E01012939","Total",802,173,108,65,629,25,244,87,151,22,20,80
"2011","East Riding of Yorkshire 001E","E01012940","Total",837,270,169,101,567,20,244,66,149,4,19,65
"2011","East Riding of Yorkshire 001F","E01012941","Total",707,217,163,54,490,11,237,43,138,4,13,44
"2011","East Riding of Yorkshire 002A","E01012929","Total",794,180,77,103,614,71,84,124,172,23,50,90
"2011","East Riding of Yorkshire 002B","E01012930","Total",637,166,93,73,471,29,161,58,115,12,32,64
"2011","East Riding of Yorkshire 002C","E01012935","Total",610,168,133,35,442,5,208,48,96,4,18,63
"2011","East Riding of Yorkshire 002D","E01012937","Total",1045,326,189,137,719,20,290,62,200,12,36,99
"2011","East Riding of Yorkshire 002E","E01012942","Total",653,222,166,56,431,9,237,27,106,4,15,33
"2011","East Riding of Yorkshire 003A","E01012928","Total",719,234,125,109,485,73,92,93,92,30,35,70
"2011","East Riding of Yorkshire 003B","E01012931","Total",810,355,230,125,455,53,123,63,127,12,17,60
"2011","East Riding of Yorkshire 003C","E01012932","Total",713,225,102,123,488,68,108,83,113,24,28,64
"2011","East Riding of Yorkshire 003D","E01012946","Total",696,231,126,105,465,80,94,84,91,21,30,65
"2011","East Riding of Yorkshire 003E","E01012949","Total",633,225,127,98,408,29,104,61,117,14,24,59
"2011","East Riding of Yorkshire 004A","E01012936","Total",688,309,166,143,379,10,163,31,107,2,15,51
"2011","East Riding of Yorkshire 004B","E01012943","Total",701,245,105,140,456,42,85,83,120,18,29,79
"2011","East Riding of Yorkshire 004C","E01012945","Total",717,276,85,191,441,54,88,72,111,17,38,61
"2011","East Riding of Yorkshire 004D","E01012952","Total",653,265,85,180,388,38,100,56,98,10,26,60
"2011","East Riding of Yorkshire 005A","E01012944","Total",719,368,67,301,351,40,51,50,95,18,35,62
"2011","East Riding of Yorkshire 005B","E01012947","Total",578,116,62,54,462,33,121,59,113,15,31,90
"2011","East Riding of Yorkshire 005C","E01012948","Total",652,305,88,217,347,27,58,58,116,11,24,53
"2011","East Riding of Yorkshire 005D","E01012951","Total",574,239,102,137,335,19,100,38,88,13,30,47
"2011","East Riding of Yorkshire 006A","E01012950","Total",592,138,89,49,454,18,169,67,94,13,22,71
"2011","East Riding of Yorkshire 006B","E01012990","Total",600,164,85,79,436,15,115,75,124,9,29,69
"2011","East Riding of Yorkshire 006C","E01012991","Total",663,148,69,79,515,20,140,77,142,17,30,89
"2011","East Riding of Yorkshire 006D","E01012992","Total",656,184,83,101,472,25,121,56,138,13,33,86
"2011","East Riding of Yorkshire 008A","E01012978","Total",649,179,133,46,470,9,171,78,115,7,24,66
"2011","East Riding of Yorkshire 008B","E01012981","Total",611,149,68,81,462,9,116,70,148,11,27,81
"2011","East Riding of Yorkshire 008C","E01012983","Total",740,166,85,81,574,17,128,123,170,15,41,80
"2011","East Riding of Yorkshire 008D","E01012989","Total",751,177,92,85,574,19,198,87,134,14,35,87
"2011","East Riding of Yorkshire 008E","E01013125","Total",734,184,84,100,550,13,123,95,179,22,35,83
"2011","East Riding of Yorkshire 009A","E01013057","Total",614,106,44,62,508,17,121,110,145,11,30,74
"2011","East Riding of Yorkshire 009B","E01013059","Total",679,148,80,68,531,16,134,110,141,20,19,91
"2011","East Riding of Yorkshire 009C","E01013060","Total",795,180,105,75,615,23,173,121,162,18,32,86
"2011","East Riding of Yorkshire 009D","E01013061","Total",697,184,106,78,513,25,123,103,139,9,27,87
"2011","East Riding of Yorkshire 009E","E01013126","Total",599,114,44,70,485,14,88,109,139,19,40,76
"2011","East Riding of Yorkshire 010A","E01012986","Total",738,212,115,97,526,11,203,58,149,13,30,62
"2011","East Riding of Yorkshire 010B","E01012987","Total",704,160,84,76,544,12,133,106,147,16,38,92
"2011","East Riding of Yorkshire 010C","E01012988","Total",646,174,85,89,472,28,104,93,131,18,36,62
"2011","East Riding of Yorkshire 010D","E01013048","Total",866,182,91,91,684,23,167,121,212,19,43,99
"2011","East Riding of Yorkshire 011A","E01013052","Total",637,146,83,63,491,16,95,93,154,10,44,79
"2011","East Riding of Yorkshire 011B","E01013053","Total",654,191,130,61,463,6,185,53,125,10,18,66
"2011","East Riding of Yorkshire 011C","E01013054","Total",801,217,85,132,584,34,95,174,156,25,37,63
"2011","East Riding of Yorkshire 011D","E01013055","Total",671,180,97,83,491,30,123,80,137,13,30,78
"2011","East Riding of Yorkshire 011E","E01013056","Total",747,281,112,169,466,41,92,91,131,20,17,74
"2011","East Riding of Yorkshire 011F","E01013058","Total",599,167,92,75,432,18,96,75,148,12,24,59
"2011","East Riding of Yorkshire 011G","E01013119","Total",628,169,68,101,459,12,105,78,134,22,33,75
"2011","East Riding of Yorkshire 012A","E01013046","Total",767,224,143,81,543,21,196,48,146,13,25,94
"2011","East Riding of Yorkshire 012B","E01013047","Total",701,223,121,102,478,22,151,58,115,16,31,85
"2011","East Riding of Yorkshire 012C","E01013049","Total",754,294,172,122,460,32,129,54,134,10,33,68
"2011","East Riding of Yorkshire 012D","E01013050","Total",734,197,100,97,537,24,178,81,139,13,24,78
"2011","East Riding of Yorkshire 012E","E01013051","Total",670,173,88,85,497,54,137,85,104,18,30,69
"2011","East Riding of Yorkshire 013A","E01012922","Total",642,142,65,77,500,17,122,77,164,17,24,79
"2011","East Riding of Yorkshire 013B","E01012923","Total",603,131,60,71,472,26,85,107,130,21,37,66
"2011","East Riding of Yorkshire 013C","E01012925","Total",534,114,57,57,420,10,93,102,113,8,29,65
"2011","East Riding of Yorkshire 013D","E01012927","Total",648,114,73,41,534,12,164,77,127,19,26,109
"2011","East Riding of Yorkshire 014A","E01012924","Total",703,141,71,70,562,15,122,114,159,13,33,106
"2011","East Riding of Yorkshire 014B","E01012926","Total",1059,240,138,102,819,28,251,143,226,14,43,114
"2011","East Riding of Yorkshire 014C","E01013027","Total",736,197,118,79,539,19,166,73,152,4,30,95
"2011","East Riding of Yorkshire 014D","E01013034","Total",734,149,67,82,585,17,129,122,194,19,37,67
"2011","East Riding of Yorkshire 015A","E01013120","Total",834,196,92,104,638,19,164,104,201,22,31,97
"2011","East Riding of Yorkshire 015B","E01013121","Total",769,132,52,80,637,32,90,140,192,32,48,103
"2011","East Riding of Yorkshire 015C","E01013123","Total",663,167,68,99,496,32,110,95,150,10,30,69
"2011","East Riding of Yorkshire 015D","E01013124","Total",987,341,201,140,646,67,173,109,188,13,29,67
"2011","East Riding of Yorkshire 016A","E01013064","Total",526,84,13,71,442,21,60,124,107,17,41,72
"2011","East Riding of Yorkshire 016B","E01013065","Total",742,203,121,82,539,15,162,90,141,6,30,95
"2011","East Riding of Yorkshire 016C","E01013066","Total",691,164,94,70,527,24,133,107,128,12,28,95
"2011","East Riding of Yorkshire 016D","E01013067","Total",701,153,50,103,548,17,96,122,165,22,34,92
"2011","East Riding of Yorkshire 016E","E01013068","Total",630,157,100,57,473,9,180,67,107,6,22,82
"2011","East Riding of Yorkshire 016F","E01013070","Total",687,224,127,97,463,13,129,82,133,14,24,68
"2011","East Riding of Yorkshire 017A","E01013038","Total",612,166,65,101,446,67,69,87,79,31,35,78
"2011","East Riding of Yorkshire 017B","E01013045","Total",642,172,92,80,470,77,69,97,96,30,32,69
"2011","East Riding of Yorkshire 017C","E01013069","Total",702,189,78,111,513,36,113,90,148,11,17,98
"2011","East Riding of Yorkshire 017D","E01013071","Total",802,373,180,193,429,55,88,56,126,17,24,63
"2011","East Riding of Yorkshire 018A","E01013022","Total",754,142,53,89,612,9,111,112,210,20,43,107
"2011","East Riding of Yorkshire 018B","E01013023","Total",754,149,70,79,605,11,150,99,194,16,41,94
"2011","East Riding of Yorkshire 018C","E01013024","Total",751,168,94,74,583,33,118,106,171,22,46,87
"2011","East Riding of Yorkshire 018D","E01013122","Total",589,114,47,67,475,13,104,83,139,17,40,79
"2011","East Riding of Yorkshire 018E","E01013127","Total",608,115,52,63,493,15,110,102,147,15,33,71
"2011","East Riding of Yorkshire 019A","E01013036","Total",791,326,124,202,465,60,76,85,155,5,14,70
"2011","East Riding of Yorkshire 019B","E01013037","Total",656,185,41,144,471,25,65,111,164,13,20,73
"2011","East Riding of Yorkshire 019C","E01013040","Total",881,260,52,208,621,53,70,136,237,22,24,79
"2011","East Riding of Yorkshire 019D","E01013041","Total",883,439,239,200,444,31,159,58,133,6,11,46
"2011","East Riding of Yorkshire 019E","E01013062","Total",903,414,178,236,489,35,110,71,180,13,18,62
"2011","East Riding of Yorkshire 019F","E01013063","Total",684,206,106,100,478,21,121,84,141,20,22,69
"2011","East Riding of Yorkshire 020A","E01012919","Total",531,155,73,82,376,19,75,94,103,13,21,51
"2011","East Riding of Yorkshire 020B","E01012921","Total",486,135,77,58,351,13,67,80,104,15,22,50
"2011","East Riding of Yorkshire 020C","E01013039","Total",784,217,98,119,567,21,143,72,188,11,37,95
"2011","East Riding of Yorkshire 020D","E01013042","Total",655,117,52,65,538,23,110,147,124,17,35,82
"2011","East Riding of Yorkshire 020E","E01013043","Total",548,114,40,74,434,33,70,103,103,15,41,69
"2011","East Riding of Yorkshire 020F","E01013044","Total",659,139,50,89,520,16,102,122,156,16,34,74
"2011","East Riding of Yorkshire 021A","E01013029","Total",632,156,88,68,476,26,118,59,145,17,31,80
"2011","East Riding of Yorkshire 021B","E01013030","Total",654,169,85,84,485,10,128,74,149,11,28,85
"2011","East Riding of Yorkshire 021C","E01013031","Total",630,136,83,53,494,9,138,59,150,5,45,88
"2011","East Riding of Yorkshire 021D","E01013032","Total",622,157,90,67,465,13,117,71,129,12,23,100
"2011","East Riding of Yorkshire 021E","E01013035","Total",551,97,43,54,454,9,104,73,147,10,23,88
"2011","East Riding of Yorkshire 022A","E01012954","Total",543,135,74,61,408,15,128,52,111,10,27,65
"2011","East Riding of Yorkshire 022B","E01012956","Total",477,82,59,23,395,11,99,66,91,16,40,72
"2011","East Riding of Yorkshire 022C","E01012958","Total",486,122,82,40,364,9,127,43,107,3,17,58
"2011","East Riding of Yorkshire 022D","E01012961","Total",683,203,141,62,480,24,187,80,102,5,24,58
"2011","East Riding of Yorkshire 022E","E01012966","Total",576,150,94,56,426,7,123,53,143,5,24,71
"2011","East Riding of Yorkshire 023A","E01012953","Total",485,140,58,82,345,7,89,58,103,7,23,58
"2011","East Riding of Yorkshire 023B","E01012955","Total",666,194,94,100,472,19,132,88,112,10,26,85
"2011","East Riding of Yorkshire 023C","E01012959","Total",642,178,86,92,464,19,95,98,138,13,24,77
"2011","East Riding of Yorkshire 023D","E01012962","Total",471,129,72,57,342,5,82,66,103,6,20,60
"2011","East Riding of Yorkshire 023E","E01012964","Total",746,222,137,85,524,55,120,94,125,13,29,88
"2011","East Riding of Yorkshire 024A","E01012920","Total",622,154,51,103,468,13,108,100,137,20,22,68
"2011","East Riding of Yorkshire 024B","E01012965","Total",422,97,51,46,325,8,81,50,97,7,21,61
"2011","East Riding of Yorkshire 024C","E01012967","Total",660,157,101,56,503,18,139,92,135,13,27,79
"2011","East Riding of Yorkshire 024D","E01012968","Total",701,137,59,78,564,11,143,120,160,17,37,76
"2011","East Riding of Yorkshire 024E","E01012969","Total",476,116,64,52,360,17,83,73,90,12,20,65
"2011","East Riding of Yorkshire 025A","E01012957","Total",780,380,201,179,400,31,97,63,133,9,19,48
"2011","East Riding of Yorkshire 025B","E01012960","Total",703,199,127,72,504,22,135,73,148,15,35,76
"2011","East Riding of Yorkshire 025C","E01012963","Total",756,343,180,163,413,57,123,47,99,18,14,55
"2011","East Riding of Yorkshire 025D","E01013112","Total",647,166,128,38,481,10,195,60,112,10,28,66
"2011","East Riding of Yorkshire 026A","E01013018","Total",769,186,102,84,583,34,118,130,164,21,40,76
"2011","East Riding of Yorkshire 026B","E01013019","Total",496,116,52,64,380,18,76,63,121,4,24,74
"2011","East Riding of Yorkshire 026C","E01013021","Total",655,163,91,72,492,10,131,72,158,13,26,82
"2011","East Riding of Yorkshire 026D","E01013025","Total",589,176,98,78,413,12,112,81,103,11,23,71
"2011","East Riding of Yorkshire 026E","E01013026","Total",694,170,78,92,524,17,116,95,144,19,34,99
"2011","East Riding of Yorkshire 027A","E01013105","Total",611,150,94,56,461,52,109,74,99,13,32,82
"2011","East Riding of Yorkshire 027B","E01013110","Total",660,214,136,78,446,22,84,114,101,18,32,75
"2011","East Riding of Yorkshire 027C","E01013111","Total",606,148,84,64,458,20,109,94,113,11,33,78
"2011","East Riding of Yorkshire 027D","E01013115","Total",639,152,81,71,487,33,98,103,119,11,28,95
"2011","East Riding of Yorkshire 027E","E01013117","Total",590,108,68,40,482,14,135,90,94,10,40,99
"2011","East Riding of Yorkshire 028A","E01013108","Total",627,149,74,75,478,7,138,77,117,12,27,100
"2011","East Riding of Yorkshire 028B","E01013113","Total",663,204,123,81,459,20,128,77,117,12,23,82
"2011","East Riding of Yorkshire 028C","E01013114","Total",633,129,85,44,504,10,161,74,132,12,25,90
"2011","East Riding of Yorkshire 028D","E01013116","Total",611,125,71,54,486,7,144,101,104,11,30,89
"2011","East Riding of Yorkshire 028E","E01013118","Total",638,150,111,39,488,11,162,73,118,17,24,83
"2011","East Riding of Yorkshire 029A","E01013094","Total",566,112,66,46,454,9,119,79,116,14,29,88
"2011","East Riding of Yorkshire 029B","E01013095","Total",669,209,94,115,460,26,107,64,144,11,27,81
"2011","East Riding of Yorkshire 029C","E01013096","Total",700,183,82,101,517,33,102,113,145,9,35,80
"2011","East Riding of Yorkshire 029D","E01013097","Total",662,197,83,114,465,46,103,70,134,5,22,85
"2011","East Riding of Yorkshire 029E","E01013102","Total",660,183,88,95,477,15,126,85,156,5,15,75
"2011","East Riding of Yorkshire 031A","E01013028","Total",650,142,62,80,508,15,118,84,157,18,35,81
"2011","East Riding of Yorkshire 031B","E01013078","Total",594,135,64,71,459,14,127,64,134,9,42,69
"2011","East Riding of Yorkshire 031C","E01013081","Total",651,159,70,89,492,14,120,76,167,6,30,79
"2011","East Riding of Yorkshire 031D","E01013082","Total",665,167,91,76,498,25,153,81,116,12,26,85
"2011","East Riding of Yorkshire 031E","E01013085","Total",704,170,89,81,534,30,138,84,136,15,35,96
"2011","East Riding of Yorkshire 032A","E01012970","Total",634,160,61,99,474,7,124,96,130,7,24,86
"2011","East Riding of Yorkshire 032C","E01012972","Total",601,93,64,29,508,18,134,114,126,18,35,63
"2011","East Riding of Yorkshire 032D","E01012973","Total",1135,263,52,211,872,45,95,264,294,23,48,103
"2011","East Riding of Yorkshire 032E","E01012974","Total",661,194,101,93,467,25,104,110,110,10,27,81
"2011","East Riding of Yorkshire 032F","E01013092","Total",844,217,119,98,627,19,134,163,174,27,35,75
"2011","East Riding of Yorkshire 032G","E01033495","Total",580,147,2,145,433,36,24,153,155,9,22,34
"2011","East Riding of Yorkshire 032H","E01033496","Total",651,117,49,68,534,20,88,161,135,20,37,73
"2011","East Riding of Yorkshire 033A","E01013033","Total",643,124,59,65,519,19,76,104,176,20,41,83
"2011","East Riding of Yorkshire 033B","E01013098","Total",920,221,82,139,699,44,130,163,205,18,49,90
"2011","East Riding of Yorkshire 033C","E01013099","Total",638,222,122,100,416,40,115,60,110,6,29,56
"2011","East Riding of Yorkshire 033D","E01013100","Total",686,147,72,75,539,16,152,87,129,15,45,95
"2011","East Riding of Yorkshire 033E","E01013101","Total",717,179,80,99,538,20,125,101,167,20,38,67
"2011","East Riding of Yorkshire 034A","E01013008","Total",650,189,55,134,461,45,57,102,156,8,27,66
"2011","East Riding of Yorkshire 034B","E01013009","Total",753,312,154,158,441,39,99,83,118,13,21,68
"2011","East Riding of Yorkshire 034C","E01013013","Total",672,183,61,122,489,44,98,103,137,9,27,71
"2011","East Riding of Yorkshire 034D","E01013014","Total",608,154,85,69,454,35,96,89,91,19,46,78
"2011","East Riding of Yorkshire 034E","E01013107","Total",777,342,225,117,435,45,95,87,114,10,23,61
"2011","East Riding of Yorkshire 035A","E01013088","Total",688,138,91,47,550,11,192,104,123,22,33,65
"2011","East Riding of Yorkshire 035B","E01013089","Total",707,182,74,108,525,24,137,112,145,9,31,67
"2011","East Riding of Yorkshire 035C","E01013090","Total",587,127,86,41,460,11,118,91,123,7,39,71
"2011","East Riding of Yorkshire 035D","E01013091","Total",671,170,93,77,501,21,126,115,109,19,27,84
"2011","East Riding of Yorkshire 035E","E01013093","Total",630,135,68,67,495,16,162,78,121,20,27,71
"2011","East Riding of Yorkshire 036A","E01013005","Total",528,148,69,79,380,9,109,58,90,15,26,73
"2011","East Riding of Yorkshire 036B","E01013007","Total",663,192,98,94,471,24,95,110,130,9,31,72
"2011","East Riding of Yorkshire 036C","E01013011","Total",652,207,108,99,445,21,79,110,114,11,32,78
"2011","East Riding of Yorkshire 036D","E01013012","Total",520,74,29,45,446,6,88,105,123,8,29,87
"2011","East Riding of Yorkshire 037A","E01012996","Total",638,143,72,71,495,18,126,85,139,19,27,81
"2011","East Riding of Yorkshire 037B","E01012998","Total",884,186,96,90,698,32,135,155,193,17,43,123
"2011","East Riding of Yorkshire 037C","E01013015","Total",674,199,62,137,475,21,71,87,166,19,31,80
"2011","East Riding of Yorkshire 037D","E01013016","Total",704,137,71,66,567,9,139,104,186,9,25,95
"2011","East Riding of Yorkshire 038A","E01013003","Total",658,221,144,77,437,18,117,77,125,15,17,68
"2011","East Riding of Yorkshire 038B","E01013017","Total",731,239,125,114,492,29,111,95,141,13,32,71
"2011","East Riding of Yorkshire 038C","E01013020","Total",720,142,63,79,578,22,88,120,185,18,34,111
"2011","East Riding of Yorkshire 038D","E01013076","Total",630,165,70,95,465,19,112,92,135,16,33,58
"2011","East Riding of Yorkshire 039A","E01013079","Total",686,182,94,88,504,9,158,59,161,11,34,72
"2011","East Riding of Yorkshire 039B","E01013080","Total",580,162,81,81,418,65,89,69,95,18,30,52
"2011","East Riding of Yorkshire 039C","E01013083","Total",616,211,90,121,405,42,81,43,112,20,45,62
"2011","East Riding of Yorkshire 039D","E01013084","Total",678,259,159,100,419,61,115,54,96,15,24,54
"2011","East Riding of Yorkshire 039E","E01013086","Total",634,198,127,71,436,27,105,70,114,19,32,69
"2011","East Riding of Yorkshire 039F","E01013087","Total",572,141,70,71,431,21,98,67,132,13,32,68
"2011","East Riding of Yorkshire 040A","E01012993","Total",596,165,102,63,431,9,126,61,121,13,27,74
"2011","East Riding of Yorkshire 040B","E01012997","Total",850,313,105,208,537,53,83,115,141,15,36,94
"2011","East Riding of Yorkshire 040C","E01012999","Total",681,175,53,122,506,59,33,112,134,19,48,101
"2011","East Riding of Yorkshire 040D","E01013001","Total",756,194,97,97,562,35,135,111,154,22,32,73
"2011","East Riding of Yorkshire 040E","E01013074","Total",676,146,55,91,530,21,137,85,155,13,29,90
"2011","East Riding of Yorkshire 041A","E01012994","Total",781,239,139,100,542,30,118,110,144,23,26,91
"2011","East Riding of Yorkshire 041B","E01012995","Total",771,200,85,115,571,80,80,115,110,24,61,101
"2011","East Riding of Yorkshire 041C","E01013000","Total",915,425,94,331,490,70,50,83,166,13,37,71
"2011","East Riding of Yorkshire 041D","E01013002","Total",686,176,73,103,510,71,63,97,147,20,33,79
"2011","East Riding of Yorkshire 041E","E01013004","Total",658,156,73,83,502,65,65,97,132,19,41,83
"2011","East Riding of Yorkshire 042A","E01013072","Total",701,175,87,88,526,21,111,126,151,22,28,67
"2011","East Riding of Yorkshire 042B","E01013073","Total",673,167,59,108,506,21,115,95,140,11,36,88
"2011","East Riding of Yorkshire 042C","E01013075","Total",547,107,43,64,440,15,95,76,138,13,24,79
"2011","East Riding of Yorkshire 042D","E01013077","Total",819,199,103,96,620,25,120,140,177,15,39,104
"2011","East Riding of Yorkshire 043A","E01013006","Total",629,165,52,113,464,45,57,96,128,14,39,85
"2011","East Riding of Yorkshire 043B","E01013010","Total",631,160,78,82,471,24,107,91,120,11,30,88
"2011","East Riding of Yorkshire 043C","E01013103","Total",611,140,76,64,471,14,134,74,135,13,27,74
"2011","East Riding of Yorkshire 043D","E01013104","Total",567,151,78,73,416,20,123,69,123,4,19,58
"2011","East Riding of Yorkshire 043E","E01013106","Total",480,122,70,52,358,33,63,64,79,20,31,68
"2011","East Riding of Yorkshire 043F","E01032596","Total",599,164,84,80,435,26,82,84,112,11,34,86
"2011","East Riding of Yorkshire 044A","E01012975","Total",650,161,84,77,489,16,136,77,127,6,25,102
"2011","East Riding of Yorkshire 044B","E01012977","Total",1019,237,90,147,782,36,130,203,192,29,58,134
"2011","East Riding of Yorkshire 044C","E01012984","Total",706,161,78,83,545,12,136,115,145,15,27,95
"2011","East Riding of Yorkshire 044D","E01012985","Total",739,209,121,88,530,24,149,103,134,17,34,69
"2011","East Riding of Yorkshire 045A","E01012976","Total",613,157,83,74,456,36,91,66,125,20,32,86
"2011","East Riding of Yorkshire 045B","E01012979","Total",731,261,120,141,470,23,134,79,133,11,20,70
"2011","East Riding of Yorkshire 045C","E01012980","Total",837,326,156,170,511,50,92,96,158,18,20,77
"2011","East Riding of Yorkshire 045D","E01012982","Total",775,249,131,118,526,33,130,85,162,17,27,72
"2011","Kingston upon Hull 001A","E01012779","Total",487,123,18,105,364,67,22,76,77,31,35,56
"2011","Kingston upon Hull 001B","E01012780","Total",593,149,28,121,444,94,35,91,83,29,37,75
"2011","Kingston upon Hull 001C","E01012781","Total",471,142,53,89,329,59,33,64,66,29,26,52
"2011","Kingston upon Hull 001E","E01012832","Total",548,143,19,124,405,33,26,119,127,11,29,60
"2011","Kingston upon Hull 001F","E01033105","Total",556,97,3,94,459,21,21,119,180,19,28,71
"2011","Kingston upon Hull 001G","E01033106","Total",495,150,5,145,345,17,2,100,144,11,19,52
"2011","Kingston upon Hull 001H","E01033107","Total",492,73,6,67,419,20,11,114,164,13,29,68
"2011","Kingston upon Hull 001I","E01033108","Total",554,111,8,103,443,34,17,126,155,17,37,57
"2011","Kingston upon Hull 002A","E01012782","Total",576,206,95,111,370,65,42,66,68,24,53,52
"2011","Kingston upon Hull 002B","E01012785","Total",549,175,60,115,374,91,47,55,79,22,32,48
"2011","Kingston upon Hull 002C","E01012786","Total",507,138,72,66,369,29,74,58,83,11,32,82
"2011","Kingston upon Hull 002D","E01012787","Total",681,245,75,170,436,92,55,64,102,18,37,68
"2011","Kingston upon Hull 002E","E01012788","Total",578,146,53,93,432,72,68,67,75,23,42,85
"2011","Kingston upon Hull 002F","E01012789","Total",540,125,40,85,415,71,69,66,91,17,33,68
"2011","Kingston upon Hull 003A","E01012875","Total",645,256,81,175,389,84,36,65,82,31,41,50
"2011","Kingston upon Hull 003B","E01012876","Total",680,201,80,121,479,98,83,63,86,35,41,73
"2011","Kingston upon Hull 003C","E01012877","Total",499,91,39,52,408,73,40,67,79,39,43,67
"2011","Kingston upon Hull 003D","E01012878","Total",650,179,62,117,471,80,75,83,108,18,36,71
"2011","Kingston upon Hull 003E","E01012879","Total",649,265,70,195,384,100,36,66,77,24,23,58
"2011","Kingston upon Hull 004A","E01012778","Total",536,108,33,75,428,78,37,71,82,32,47,81
"2011","Kingston upon Hull 004B","E01012783","Total",529,195,49,146,334,70,43,54,76,21,36,34
"2011","Kingston upon Hull 004C","E01012784","Total",791,161,37,124,630,87,45,155,170,31,62,80
"2011","Kingston upon Hull 004D","E01012790","Total",569,195,100,95,374,42,83,48,90,11,33,67
"2011","Kingston upon Hull 004E","E01012906","Total",679,217,74,143,462,97,56,70,100,19,39,81
"2011","Kingston upon Hull 004F","E01012908","Total",490,158,59,99,332,53,53,68,86,6,17,49
"2011","Kingston upon Hull 005A","E01012764","Total",552,177,74,103,375,13,115,59,121,6,11,50
"2011","Kingston upon Hull 005B","E01012765","Total",628,169,57,112,459,26,85,91,124,19,35,79
"2011","Kingston upon Hull 005C","E01012768","Total",698,258,93,165,440,26,109,62,166,2,12,63
"2011","Kingston upon Hull 005D","E01012769","Total",684,239,125,114,445,17,202,55,98,5,12,56
"2011","Kingston upon Hull 006A","E01012829","Total",692,190,81,109,502,19,93,90,161,13,33,93
"2011","Kingston upon Hull 006B","E01012830","Total",612,126,56,70,486,25,89,87,154,9,33,89
"2011","Kingston upon Hull 006C","E01012905","Total",580,175,68,107,405,66,74,52,91,13,35,74
"2011","Kingston upon Hull 006D","E01012910","Total",466,69,19,50,397,28,38,87,104,13,37,90
"2011","Kingston upon Hull 006E","E01012912","Total",756,165,87,78,591,32,138,111,147,12,44,107
"2011","Kingston upon Hull 007A","E01012822","Total",651,211,122,89,440,24,106,100,92,10,24,84
"2011","Kingston upon Hull 007B","E01012904","Total",655,240,101,139,415,28,76,51,143,7,38,72
"2011","Kingston upon Hull 007C","E01012907","Total",595,168,56,112,427,45,66,82,114,8,25,87
"2011","Kingston upon Hull 007D","E01012909","Total",591,170,37,133,421,20,53,93,170,6,20,59
"2011","Kingston upon Hull 007E","E01012911","Total",500,113,27,86,387,24,53,72,122,4,28,84
"2011","Kingston upon Hull 008A","E01012873","Total",643,187,66,121,456,116,57,79,73,21,34,76
"2011","Kingston upon Hull 008B","E01012874","Total",645,210,86,124,435,77,61,72,89,34,43,59
"2011","Kingston upon Hull 008C","E01012880","Total",704,199,78,121,505,114,52,92,104,27,39,77
"2011","Kingston upon Hull 008D","E01012881","Total",639,217,78,139,422,80,56,80,76,14,43,73
"2011","Kingston upon Hull 008E","E01012915","Total",640,200,106,94,440,65,71,77,102,18,36,71
"2011","Kingston upon Hull 008F","E01012917","Total",785,339,170,169,446,49,94,82,106,24,31,60
"2011","Kingston upon Hull 008G","E01012918","Total",609,142,43,99,467,66,55,85,117,21,48,75
"2011","Kingston upon Hull 009A","E01012833","Total",645,197,105,92,448,73,66,89,104,16,31,69
"2011","Kingston upon Hull 009B","E01012835","Total",525,142,89,53,383,12,116,36,117,9,25,68
"2011","Kingston upon Hull 009C","E01012836","Total",785,389,143,246,396,40,80,68,111,12,27,58
"2011","Kingston upon Hull 009D","E01012839","Total",551,163,96,67,388,36,80,70,88,12,26,76
"2011","Kingston upon Hull 009E","E01012840","Total",648,212,80,132,436,67,69,82,97,16,31,74
"2011","Kingston upon Hull 010A","E01012824","Total",682,185,78,107,497,30,77,103,147,11,35,94
"2011","Kingston upon Hull 010B","E01012825","Total",679,232,121,111,447,21,106,67,111,14,35,93
"2011","Kingston upon Hull 010C","E01012834","Total",664,187,81,106,477,97,72,89,106,24,34,55
"2011","Kingston upon Hull 010D","E01012837","Total",741,290,149,141,451,55,91,75,109,8,39,74
"2011","Kingston upon Hull 010E","E01012838","Total",607,162,71,91,445,87,53,91,102,21,39,52
"2011","Kingston upon Hull 011A","E01012821","Total",609,280,189,91,329,19,68,51,100,10,27,54
"2011","Kingston upon Hull 011B","E01012823","Total",602,193,102,91,409,68,81,58,85,23,37,57
"2011","Kingston upon Hull 011C","E01012826","Total",710,270,164,106,440,42,101,88,112,15,28,54
"2011","Kingston upon Hull 011D","E01012827","Total",755,355,195,160,400,16,101,58,123,1,25,76
"2011","Kingston upon Hull 011E","E01012828","Total",679,211,107,104,468,34,109,89,110,11,33,82
"2011","Kingston upon Hull 012A","E01012766","Total",562,110,31,79,452,16,52,85,147,11,41,100
"2011","Kingston upon Hull 012B","E01012767","Total",583,155,31,124,428,10,46,53,115,14,27,163
"2011","Kingston upon Hull 012C","E01012914","Total",627,231,26,205,396,12,18,20,71,1,23,251
"2011","Kingston upon Hull 012D","E01012916","Total",685,244,91,153,441,24,84,90,116,13,18,96
"2011","Kingston upon Hull 013A","E01012812","Total",521,86,48,38,435,13,75,106,78,12,46,105
"2011","Kingston upon Hull 013B","E01012813","Total",681,127,58,69,554,25,70,116,152,15,48,128
"2011","Kingston upon Hull 013C","E01012814","Total",623,135,82,53,488,19,105,108,114,10,31,101
"2011","Kingston upon Hull 013D","E01012815","Total",675,172,46,126,503,32,64,126,166,11,30,74
"2011","Kingston upon Hull 013E","E01012818","Total",507,123,58,65,384,19,78,73,84,8,33,89
"2011","Kingston upon Hull 014A","E01012791","Total",662,137,63,74,525,17,105,95,142,18,35,113
"2011","Kingston upon Hull 014B","E01012792","Total",644,150,78,72,494,25,93,112,136,18,30,80
"2011","Kingston upon Hull 014C","E01012793","Total",620,196,128,68,424,12,99,48,126,17,28,94
"2011","Kingston upon Hull 014D","E01012794","Total",637,149,51,98,488,21,60,119,139,8,37,104
"2011","Kingston upon Hull 014E","E01012913","Total",821,220,62,158,601,78,70,123,176,24,41,89
"2011","Kingston upon Hull 015A","E01012761","Total",863,469,124,345,394,27,50,43,143,12,30,89
"2011","Kingston upon Hull 015B","E01012868","Total",695,273,89,184,422,14,25,39,107,6,21,210
"2011","Kingston upon Hull 015C","E01012869","Total",675,231,68,163,444,28,25,35,122,8,25,201
"2011","Kingston upon Hull 015D","E01012871","Total",742,228,26,202,514,49,31,74,157,15,41,147
"2011","Kingston upon Hull 015E","E01012872","Total",678,265,53,212,413,19,14,40,87,10,16,227
"2011","Kingston upon Hull 016A","E01012804","Total",683,221,54,167,462,22,73,94,168,11,17,77
"2011","Kingston upon Hull 016B","E01012806","Total",743,334,73,261,409,58,36,97,139,8,22,49
"2011","Kingston upon Hull 016C","E01012807","Total",599,189,80,109,410,19,89,84,112,9,26,71
"2011","Kingston upon Hull 016D","E01012817","Total",648,219,40,179,429,42,51,99,148,5,17,67
"2011","Kingston upon Hull 016E","E01012819","Total",622,161,57,104,461,40,65,80,162,14,22,78
"2011","Kingston upon Hull 017A","E01012841","Total",655,197,78,119,458,104,48,95,94,25,41,51
"2011","Kingston upon Hull 017B","E01012844","Total",609,228,84,144,381,77,50,65,89,17,26,57
"2011","Kingston upon Hull 017C","E01012849","Total",712,270,125,145,442,62,84,67,117,13,31,68
"2011","Kingston upon Hull 017D","E01012895","Total",588,175,68,107,413,82,54,65,66,35,42,69
"2011","Kingston upon Hull 017E","E01012897","Total",695,262,104,158,433,108,57,78,83,27,34,46
"2011","Kingston upon Hull 017F","E01012898","Total",669,292,206,86,377,35,106,53,71,18,27,67
"2011","Kingston upon Hull 018A","E01012758","Total",700,243,49,194,457,18,54,101,166,14,22,82
"2011","Kingston upon Hull 018B","E01012762","Total",632,181,33,148,451,30,41,81,149,6,36,108
"2011","Kingston upon Hull 018C","E01012763","Total",996,546,41,505,450,29,32,64,160,23,39,103
"2011","Kingston upon Hull 018D","E01012866","Total",701,231,52,179,470,52,28,65,162,10,20,133
"2011","Kingston upon Hull 018E","E01012870","Total",670,200,31,169,470,30,17,59,141,8,18,197
"2011","Kingston upon Hull 019A","E01012774","Total",667,215,80,135,452,37,67,94,120,16,36,82
"2011","Kingston upon Hull 019B","E01012795","Total",880,315,165,150,565,57,119,98,129,21,51,90
"2011","Kingston upon Hull 019C","E01012797","Total",643,231,127,104,412,31,85,102,108,12,22,52
"2011","Kingston upon Hull 019D","E01012798","Total",834,399,246,153,435,45,121,61,118,13,24,53
"2011","Kingston upon Hull 019E","E01012801","Total",664,202,85,117,462,42,85,82,150,15,25,63
"2011","Kingston upon Hull 020A","E01012816","Total",573,166,82,84,407,20,64,73,121,11,33,85
"2011","Kingston upon Hull 020B","E01012848","Total",631,302,40,262,329,20,37,69,133,3,15,52
"2011","Kingston upon Hull 020C","E01012894","Total",629,160,60,100,469,46,75,73,104,18,45,108
"2011","Kingston upon Hull 020D","E01012896","Total",802,177,45,132,625,43,60,156,165,19,70,112
"2011","Kingston upon Hull 020E","E01012901","Total",611,192,82,110,419,22,65,97,117,15,27,76
"2011","Kingston upon Hull 021A","E01012842","Total",602,160,60,100,442,69,59,84,84,33,34,79
"2011","Kingston upon Hull 021B","E01012843","Total",633,240,75,165,393,72,54,83,84,28,32,40
"2011","Kingston upon Hull 021C","E01012845","Total",623,183,86,97,440,89,54,74,83,23,53,64
"2011","Kingston upon Hull 021D","E01012846","Total",624,212,96,116,412,61,71,73,93,14,32,68
"2011","Kingston upon Hull 021E","E01012847","Total",521,146,60,86,375,79,50,60,70,24,33,59
"2011","Kingston upon Hull 022A","E01012820","Total",561,166,36,130,395,29,48,83,91,24,37,83
"2011","Kingston upon Hull 022B","E01012899","Total",669,203,52,151,466,42,60,99,160,11,35,59
"2011","Kingston upon Hull 022C","E01012900","Total",756,293,49,244,463,69,49,94,164,12,29,46
"2011","Kingston upon Hull 022D","E01012902","Total",616,137,68,69,479,26,69,86,128,20,40,110
"2011","Kingston upon Hull 022E","E01012903","Total",829,323,68,255,506,58,61,101,182,14,20,70
"2011","Kingston upon Hull 023A","E01012796","Total",576,163,81,82,413,18,96,93,104,10,20,72
"2011","Kingston upon Hull 023B","E01012799","Total",606,204,50,154,402,43,48,111,152,5,9,34
"2011","Kingston upon Hull 023C","E01012800","Total",755,309,110,199,446,41,60,87,163,8,25,62
"2011","Kingston upon Hull 023D","E01012802","Total",650,204,71,133,446,35,70,98,160,6,20,57
"2011","Kingston upon Hull 023E","E01012803","Total",664,216,57,159,448,52,85,96,130,9,20,56
"2011","Kingston upon Hull 024A","E01012850","Total",984,546,63,483,438,50,31,78,143,29,33,74
"2011","Kingston upon Hull 024B","E01012852","Total",799,359,75,284,440,53,62,57,127,9,51,81
"2011","Kingston upon Hull 024C","E01012856","Total",819,412,122,290,407,55,79,71,97,20,30,55
"2011","Kingston upon Hull 024D","E01012857","Total",769,362,105,257,407,52,49,65,115,20,37,69
"2011","Kingston upon Hull 024E","E01012867","Total",734,331,77,254,403,52,30,87,117,26,28,63
"2011","Kingston upon Hull 025A","E01012756","Total",714,266,62,204,448,31,53,80,167,12,25,80
"2011","Kingston upon Hull 025B","E01012757","Total",687,264,38,226,423,35,34,77,149,14,21,93
"2011","Kingston upon Hull 025C","E01012759","Total",801,312,79,233,489,52,57,84,180,13,28,75
"2011","Kingston upon Hull 025D","E01012760","Total",724,272,57,215,452,54,38,86,181,13,23,57
"2011","Kingston upon Hull 025E","E01012862","Total",597,245,90,155,352,35,62,51,88,17,33,66
"2011","Kingston upon Hull 026A","E01012805","Total",671,299,64,235,372,43,42,77,113,11,22,64
"2011","Kingston upon Hull 026B","E01012808","Total",874,440,148,292,434,58,64,64,132,10,30,76
"2011","Kingston upon Hull 026C","E01012809","Total",924,429,74,355,495,69,38,95,182,10,33,68
"2011","Kingston upon Hull 026D","E01012810","Total",949,409,128,281,540,34,86,156,186,13,17,48
"2011","Kingston upon Hull 026E","E01012811","Total",855,392,52,340,463,40,48,117,187,14,16,41
"2011","Kingston upon Hull 027A","E01012773","Total",753,223,78,145,530,43,71,136,164,16,24,76
"2011","Kingston upon Hull 027B","E01012776","Total",657,194,67,127,463,43,64,106,145,6,22,77
"2011","Kingston upon Hull 027C","E01012863","Total",602,171,53,118,431,54,52,89,125,9,27,75
"2011","Kingston upon Hull 027D","E01012864","Total",732,297,40,257,435,49,27,87,123,25,41,83
"2011","Kingston upon Hull 027E","E01012865","Total",605,222,51,171,383,34,53,82,112,23,20,59
"2011","Kingston upon Hull 028A","E01012770","Total",591,103,52,51,488,25,95,108,128,12,26,94
"2011","Kingston upon Hull 028B","E01012771","Total",636,160,89,71,476,25,99,93,120,14,34,91
"2011","Kingston upon Hull 028C","E01012772","Total",613,170,53,117,443,13,78,105,122,13,38,74
"2011","Kingston upon Hull 028D","E01012775","Total",658,225,99,126,433,45,86,82,110,12,32,66
"2011","Kingston upon Hull 028E","E01012777","Total",729,360,256,104,369,26,97,60,88,7,18,73
"2011","Kingston upon Hull 029A","E01012851","Total",1383,832,151,681,551,50,59,74,273,10,16,69
"2011","Kingston upon Hull 029C","E01012854","Total",1243,786,111,675,457,58,58,97,174,13,22,35
"2011","Kingston upon Hull 029D","E01012855","Total",945,527,128,399,418,45,59,84,127,17,39,47
"2011","Kingston upon Hull 029E","E01033104","Total",911,669,106,563,242,4,18,22,172,3,2,21
"2011","Kingston upon Hull 029F","E01033109","Total",834,547,73,474,287,30,16,31,170,5,7,28
"2011","Kingston upon Hull 030A","E01012859","Total",651,261,47,214,390,65,20,74,104,21,42,64
"2011","Kingston upon Hull 030B","E01012889","Total",648,282,101,181,366,47,65,65,94,21,24,50
"2011","Kingston upon Hull 030C","E01012891","Total",1078,563,49,514,515,57,24,106,181,21,44,82
"2011","Kingston upon Hull 030D","E01012892","Total",827,320,46,274,507,64,38,107,141,28,46,83
"2011","Kingston upon Hull 030E","E01012893","Total",701,303,74,229,398,67,54,62,96,17,28,74
"2011","Kingston upon Hull 031A","E01012858","Total",729,203,85,118,526,64,79,102,125,13,45,98
"2011","Kingston upon Hull 031B","E01012860","Total",641,151,52,99,490,48,56,93,119,23,32,119
"2011","Kingston upon Hull 031D","E01012886","Total",691,219,86,133,472,52,78,83,127,12,36,84
"2011","Kingston upon Hull 031E","E01012888","Total",725,288,56,232,437,65,29,92,150,6,13,82
"2011","Kingston upon Hull 031G","E01033110","Total",728,308,120,188,420,53,74,56,117,22,29,69
"2011","Kingston upon Hull 033A","E01012882","Total",685,195,70,125,490,30,76,100,156,13,26,89
"2011","Kingston upon Hull 033B","E01012883","Total",809,365,245,120,444,15,150,54,157,7,15,46
"2011","Kingston upon Hull 033C","E01012884","Total",822,305,165,140,517,69,107,88,114,16,38,85
"2011","Kingston upon Hull 033D","E01012887","Total",703,307,86,221,396,70,78,48,82,18,28,72
"2011","Kingston upon Hull 033E","E01032595","Total",772,245,114,131,527,58,114,81,106,22,43,103
"2011","North East Lincolnshire 001A","E01013174","Total",532,102,13,89,430,100,22,99,90,35,29,55
"2011","North East Lincolnshire 001B","E01013175","Total",601,162,83,79,439,14,91,69,147,10,38,70
"2011","North East Lincolnshire 001C","E01013176","Total",600,160,65,95,440,32,89,73,135,17,31,63
"2011","North East Lincolnshire 001D","E01013177","Total",804,381,135,246,423,66,76,79,103,17,26,56
"2011","North East Lincolnshire 001E","E01013178","Total",637,156,93,63,481,25,137,79,127,11,31,71
"2011","North East Lincolnshire 001F","E01013179","Total",632,181,89,92,451,35,105,65,112,20,36,78
"2011","North East Lincolnshire 001G","E01013180","Total",621,168,96,72,453,23,90,62,145,10,40,83
"2011","North East Lincolnshire 002A","E01013136","Total",885,521,151,370,364,66,51,43,141,9,15,39
"2011","North East Lincolnshire 002B","E01013137","Total",989,665,212,453,324,52,60,34,133,7,7,31
"2011","North East Lincolnshire 002C","E01013139","Total",656,358,123,235,298,65,40,43,74,19,22,35
"2011","North East Lincolnshire 002D","E01013142","Total",767,290,69,221,477,96,41,95,124,25,36,60
"2011","North East Lincolnshire 003A","E01013218","Total",624,206,49,157,418,72,39,88,118,16,21,64
"2011","North East Lincolnshire 003B","E01013219","Total",641,211,79,132,430,80,58,69,114,14,29,66
"2011","North East Lincolnshire 003C","E01013220","Total",761,280,78,202,481,92,49,97,133,22,17,71
"2011","North East Lincolnshire 003D","E01013221","Total",953,488,132,356,465,77,59,73,159,17,23,57
"2011","North East Lincolnshire 003E","E01013222","Total",702,239,63,176,463,72,48,76,141,20,32,74
"2011","North East Lincolnshire 004A","E01013144","Total",792,417,150,267,375,69,68,59,102,16,15,46
"2011","North East Lincolnshire 004B","E01013145","Total",503,82,37,45,421,13,86,62,129,12,30,89
"2011","North East Lincolnshire 004C","E01013146","Total",708,163,53,110,545,53,86,113,154,26,33,80
"2011","North East Lincolnshire 004D","E01013148","Total",575,112,37,75,463,18,78,63,149,9,47,99
"2011","North East Lincolnshire 005A","E01013195","Total",616,202,79,123,414,68,49,86,91,25,31,64
"2011","North East Lincolnshire 005B","E01013196","Total",565,145,47,98,420,75,39,78,101,20,35,72
"2011","North East Lincolnshire 005C","E01013201","Total",673,225,42,183,448,83,41,75,126,21,30,72
"2011","North East Lincolnshire 005D","E01013202","Total",621,171,43,128,450,67,56,96,101,29,31,70
"2011","North East Lincolnshire 005E","E01013203","Total",728,274,53,221,454,72,36,85,128,22,37,74
"2011","North East Lincolnshire 006A","E01013138","Total",619,221,42,179,398,86,32,69,116,19,26,50
"2011","North East Lincolnshire 006B","E01013140","Total",652,192,44,148,460,77,38,80,135,24,34,72
"2011","North East Lincolnshire 006C","E01013141","Total",647,166,51,115,481,74,56,95,112,23,43,78
"2011","North East Lincolnshire 006D","E01013143","Total",579,164,55,109,415,74,42,80,108,25,22,64
"2011","North East Lincolnshire 007A","E01013173","Total",534,128,72,56,406,20,91,66,144,7,22,56
"2011","North East Lincolnshire 007B","E01013223","Total",1149,222,116,106,927,33,186,209,245,40,74,140
"2011","North East Lincolnshire 007C","E01013224","Total",778,195,97,98,583,36,126,116,157,18,45,85
"2011","North East Lincolnshire 007D","E01013226","Total",632,129,79,50,503,21,117,93,143,14,34,81
"2011","North East Lincolnshire 008A","E01013187","Total",792,474,224,250,318,21,79,35,114,8,18,43
"2011","North East Lincolnshire 008B","E01013188","Total",684,181,77,104,503,13,98,90,162,4,29,107
"2011","North East Lincolnshire 008C","E01013231","Total",708,198,81,117,510,72,72,95,150,18,28,75
"2011","North East Lincolnshire 008D","E01013233","Total",618,168,42,126,450,41,60,87,138,18,26,80
"2011","North East Lincolnshire 009A","E01013147","Total",607,182,88,94,425,55,83,66,104,16,32,69
"2011","North East Lincolnshire 009D","E01013234","Total",656,243,126,117,413,40,71,85,134,11,26,46
"2011","North East Lincolnshire 009E","E01033414","Total",970,230,86,144,740,52,155,117,230,23,37,126
"2011","North East Lincolnshire 010A","E01013128","Total",616,194,62,132,422,53,49,78,132,12,32,66
"2011","North East Lincolnshire 010B","E01013198","Total",613,166,64,102,447,45,64,64,150,19,30,75
"2011","North East Lincolnshire 010C","E01013199","Total",541,214,30,184,327,71,30,45,120,5,18,38
"2011","North East Lincolnshire 010D","E01013200","Total",511,111,52,59,400,24,69,78,107,10,34,78
"2011","North East Lincolnshire 011A","E01013159","Total",613,165,39,126,448,74,41,85,121,27,24,76
"2011","North East Lincolnshire 011B","E01013161","Total",566,160,33,127,406,71,30,79,107,28,38,53
"2011","North East Lincolnshire 011C","E01013162","Total",670,245,36,209,425,47,47,79,94,30,44,84
"2011","North East Lincolnshire 011D","E01013165","Total",602,220,47,173,382,58,30,63,116,23,27,65
"2011","North East Lincolnshire 012A","E01013158","Total",599,170,76,94,429,41,65,74,99,18,39,93
"2011","North East Lincolnshire 012B","E01013160","Total",655,180,76,104,475,31,91,80,158,11,27,77
"2011","North East Lincolnshire 012C","E01013163","Total",605,172,93,79,433,13,137,54,121,9,22,77
"2011","North East Lincolnshire 012D","E01013164","Total",715,200,70,130,515,66,68,110,127,24,34,86
"2011","North East Lincolnshire 012E","E01013197","Total",524,127,61,66,397,35,68,76,99,13,26,80
"2011","North East Lincolnshire 013A","E01013149","Total",485,96,41,55,389,13,97,65,118,6,29,61
"2011","North East Lincolnshire 013B","E01013150","Total",522,95,35,60,427,15,78,64,134,11,42,83
"2011","North East Lincolnshire 013C","E01013227","Total",751,240,125,115,511,36,134,86,130,11,25,89
"2011","North East Lincolnshire 013D","E01013228","Total",691,198,31,167,493,29,63,114,167,13,21,86
"2011","North East Lincolnshire 013E","E01013229","Total",575,136,52,84,439,70,46,82,98,20,39,84
"2011","North East Lincolnshire 014A","E01013131","Total",778,345,149,196,433,70,63,58,150,19,18,55
"2011","North East Lincolnshire 014B","E01013132","Total",635,191,108,83,444,23,89,85,116,15,29,87
"2011","North East Lincolnshire 014C","E01013133","Total",772,322,108,214,450,58,69,60,161,11,28,63
"2011","North East Lincolnshire 014D","E01013134","Total",691,238,163,75,453,36,132,60,122,10,32,61
"2011","North East Lincolnshire 015A","E01013206","Total",593,195,72,123,398,51,67,64,92,15,29,80
"2011","North East Lincolnshire 015B","E01013207","Total",604,174,85,89,430,26,114,56,124,8,27,75
"2011","North East Lincolnshire 015C","E01013211","Total",642,164,84,80,478,35,94,80,142,22,30,75
"2011","North East Lincolnshire 015D","E01013212","Total",599,240,78,162,359,92,33,65,72,20,30,47
"2011","North East Lincolnshire 016A","E01013181","Total",616,166,34,132,450,76,34,87,121,29,30,73
"2011","North East Lincolnshire 016B","E01013182","Total",636,174,104,70,462,10,144,69,140,8,18,73
"2011","North East Lincolnshire 016C","E01013183","Total",639,150,69,81,489,33,94,92,130,19,29,92
"2011","North East Lincolnshire 016D","E01013184","Total",643,223,66,157,420,32,66,63,142,19,29,69
"2011","North East Lincolnshire 016E","E01013185","Total",657,170,78,92,487,27,75,100,139,23,26,97
"2011","North East Lincolnshire 016F","E01013186","Total",502,99,53,46,403,15,64,87,115,14,34,74
"2011","North East Lincolnshire 017A","E01013129","Total",728,326,68,258,402,47,47,73,136,16,34,49
"2011","North East Lincolnshire 017B","E01013151","Total",520,107,78,29,413,8,113,77,105,5,29,76
"2011","North East Lincolnshire 017C","E01013152","Total",620,169,115,54,451,9,122,96,110,11,27,76
"2011","North East Lincolnshire 017D","E01013155","Total",626,181,96,85,445,17,128,75,124,14,22,65
"2011","North East Lincolnshire 018A","E01013130","Total",627,237,134,103,390,25,81,51,99,16,34,84
"2011","North East Lincolnshire 018B","E01013135","Total",758,319,201,118,439,20,163,48,115,13,19,61
"2011","North East Lincolnshire 018C","E01013154","Total",619,134,78,56,485,14,171,70,128,6,23,73
"2011","North East Lincolnshire 018D","E01013156","Total",661,266,207,59,395,13,165,45,106,6,14,46
"2011","North East Lincolnshire 019A","E01013204","Total",586,171,104,67,415,47,69,60,109,19,33,78
"2011","North East Lincolnshire 019B","E01013205","Total",519,133,44,89,386,95,31,54,85,28,29,64
"2011","North East Lincolnshire 019C","E01013208","Total",520,113,41,72,407,105,35,65,81,32,38,51
"2011","North East Lincolnshire 019D","E01013209","Total",676,262,92,170,414,80,60,67,102,26,20,59
"2011","North East Lincolnshire 019E","E01013210","Total",536,118,44,74,418,105,40,72,76,34,32,59
"2011","North East Lincolnshire 020A","E01013153","Total",643,184,120,64,459,17,180,50,124,6,14,68
"2011","North East Lincolnshire 020B","E01013157","Total",735,151,69,82,584,35,107,142,157,15,41,87
"2011","North East Lincolnshire 020C","E01013166","Total",692,197,129,68,495,15,159,71,115,12,39,84
"2011","North East Lincolnshire 020D","E01013167","Total",808,247,128,119,561,7,186,97,153,7,42,69
"2011","North East Lincolnshire 020E","E01013169","Total",528,192,140,52,336,11,132,40,85,8,16,44
"2011","North East Lincolnshire 021A","E01013189","Total",641,191,127,64,450,17,122,82,119,10,34,66
"2011","North East Lincolnshire 021B","E01013190","Total",1075,214,85,129,861,58,122,198,227,41,75,140
"2011","North East Lincolnshire 021C","E01013191","Total",642,144,93,51,498,19,142,87,114,16,29,91
"2011","North East Lincolnshire 021D","E01013192","Total",744,358,175,183,386,37,87,72,83,18,31,58
"2011","North East Lincolnshire 021E","E01013194","Total",677,205,138,67,472,20,162,74,118,15,18,65
"2011","North East Lincolnshire 022A","E01013168","Total",709,170,105,65,539,5,174,94,134,12,26,94
"2011","North East Lincolnshire 022B","E01013170","Total",665,178,118,60,487,30,133,87,124,7,31,75
"2011","North East Lincolnshire 022C","E01013171","Total",625,89,37,52,536,14,83,143,115,29,54,98
"2011","North East Lincolnshire 022D","E01013172","Total",682,219,131,88,463,19,154,65,107,10,22,86
"2011","North East Lincolnshire 022E","E01013193","Total",728,216,147,69,512,8,160,72,148,14,23,87
"2011","North East Lincolnshire 023A","E01013213","Total",625,280,193,87,345,31,107,48,97,8,13,41
"2011","North East Lincolnshire 023B","E01013214","Total",637,151,92,59,486,12,162,52,135,15,31,79
"2011","North East Lincolnshire 023C","E01013215","Total",620,134,71,63,486,9,148,80,109,24,31,85
"2011","North East Lincolnshire 023D","E01013216","Total",511,82,36,46,429,22,77,97,125,10,31,67
"2011","North East Lincolnshire 023E","E01013217","Total",623,170,88,82,453,11,112,72,124,14,29,91
"2011","North East Lincolnshire 023F","E01013225","Total",429,93,41,52,336,9,91,39,103,13,12,69
"2011","North Lincolnshire 001A","E01013254","Total",814,305,134,171,509,61,109,88,137,14,22,78
"2011","North Lincolnshire 001B","E01013255","Total",832,333,132,201,499,40,120,73,157,7,24,78
"2011","North Lincolnshire 001C","E01013256","Total",1029,260,96,164,769,63,120,187,204,24,45,126
"2011","North Lincolnshire 001D","E01013257","Total",746,138,67,71,608,24,152,88,191,21,34,98
"2011","North Lincolnshire 001E","E01013258","Total",712,209,107,102,503,51,83,96,130,26,39,78
"2011","North Lincolnshire 001F","E01013259","Total",683,159,60,99,524,51,107,106,129,32,32,67
"2011","North Lincolnshire 002A","E01013303","Total",579,175,77,98,404,20,86,64,127,12,29,66
"2011","North Lincolnshire 002B","E01013304","Total",659,134,62,72,525,19,110,101,153,21,28,93
"2011","North Lincolnshire 002C","E01013305","Total",651,132,51,81,519,18,92,102,175,18,30,84
"2011","North Lincolnshire 002D","E01013307","Total",747,200,96,104,547,31,119,93,180,18,33,73
"2011","North Lincolnshire 003A","E01013288","Total",647,136,77,59,511,22,107,104,141,19,30,88
"2011","North Lincolnshire 003B","E01013291","Total",604,147,84,63,457,54,61,94,97,38,38,75
"2011","North Lincolnshire 003C","E01013292","Total",750,193,96,97,557,38,129,77,176,11,44,82
"2011","North Lincolnshire 003D","E01013294","Total",666,155,78,77,511,29,119,76,163,8,37,79
"2011","North Lincolnshire 004A","E01013270","Total",829,229,98,131,600,38,115,128,169,17,41,92
"2011","North Lincolnshire 004B","E01013306","Total",658,167,86,81,491,21,100,98,154,19,34,65
"2011","North Lincolnshire 004C","E01013308","Total",746,187,79,108,559,30,117,92,178,18,42,82
"2011","North Lincolnshire 004D","E01013309","Total",702,185,79,106,517,14,126,99,154,10,30,84
"2011","North Lincolnshire 005A","E01013286","Total",1159,437,193,244,722,47,236,107,210,16,36,70
"2011","North Lincolnshire 005B","E01013287","Total",698,217,84,133,481,13,130,83,166,10,10,69
"2011","North Lincolnshire 005C","E01013289","Total",704,206,77,129,498,20,83,106,156,15,48,70
"2011","North Lincolnshire 005D","E01013290","Total",728,183,99,84,545,20,161,79,159,8,29,89
"2011","North Lincolnshire 005E","E01013293","Total",667,165,101,64,502,13,147,89,129,16,29,79
"2011","North Lincolnshire 006A","E01013245","Total",609,161,75,86,448,44,67,84,123,29,33,68
"2011","North Lincolnshire 006B","E01013246","Total",638,142,66,76,496,18,96,82,179,13,34,74
"2011","North Lincolnshire 006C","E01013247","Total",711,164,82,82,547,24,95,113,158,17,36,104
"2011","North Lincolnshire 006D","E01013248","Total",760,195,86,109,565,26,132,94,170,10,38,95
"2011","North Lincolnshire 006E","E01013249","Total",747,219,97,122,528,40,94,115,137,21,44,77
"2011","North Lincolnshire 007A","E01013297","Total",876,239,106,133,637,25,71,146,204,15,57,119
"2011","North Lincolnshire 007B","E01013300","Total",629,183,70,113,446,47,33,59,119,26,62,100
"2011","North Lincolnshire 007C","E01013302","Total",557,112,43,69,445,21,86,76,119,12,34,97
"2011","North Lincolnshire 007D","E01013331","Total",845,374,141,233,471,36,80,85,159,13,28,70
"2011","North Lincolnshire 008A","E01013296","Total",648,196,36,160,452,57,31,93,127,29,43,72
"2011","North Lincolnshire 008B","E01013298","Total",534,102,39,63,432,56,23,92,82,51,44,84
"2011","North Lincolnshire 008C","E01013299","Total",657,213,84,129,444,62,62,75,91,47,44,63
"2011","North Lincolnshire 008D","E01013330","Total",778,327,84,243,451,44,43,72,160,23,40,69
"2011","North Lincolnshire 008E","E01013332","Total",660,151,58,93,509,31,45,78,145,38,78,94
"2011","North Lincolnshire 009A","E01013295","Total",596,140,72,68,456,22,143,74,105,7,26,79
"2011","North Lincolnshire 009B","E01013301","Total",654,160,69,91,494,30,91,105,127,14,44,83
"2011","North Lincolnshire 009C","E01013333","Total",620,170,74,96,450,19,60,89,106,37,48,91
"2011","North Lincolnshire 009D","E01013334","Total",648,177,83,94,471,27,78,92,130,16,40,88
"2011","North Lincolnshire 010A","E01013310","Total",614,168,66,102,446,44,69,82,119,20,37,75
"2011","North Lincolnshire 010B","E01013312","Total",800,271,63,208,529,92,38,112,152,14,29,92
"2011","North Lincolnshire 010C","E01013313","Total",670,194,102,92,476,38,64,101,150,11,31,81
"2011","North Lincolnshire 010D","E01013314","Total",631,193,71,122,438,31,60,81,112,21,39,94
"2011","North Lincolnshire 011A","E01013267","Total",507,106,57,49,401,14,99,78,113,13,22,62
"2011","North Lincolnshire 011B","E01013268","Total",567,162,87,75,405,33,96,56,132,15,18,55
"2011","North Lincolnshire 011C","E01013269","Total",720,154,86,68,566,13,126,102,173,18,29,105
"2011","North Lincolnshire 011D","E01013271","Total",768,203,83,120,565,53,86,107,137,37,42,103
"2011","North Lincolnshire 011E","E01013272","Total",832,376,186,190,456,29,89,74,156,13,27,68
"2011","North Lincolnshire 011F","E01013273","Total",757,201,118,83,556,15,165,81,163,13,29,90
"2011","North Lincolnshire 012A","E01013279","Total",716,306,108,198,410,75,55,59,127,17,14,63
"2011","North Lincolnshire 012B","E01013285","Total",524,118,50,68,406,15,91,58,116,14,27,85
"2011","North Lincolnshire 012C","E01013316","Total",588,121,68,53,467,17,110,78,120,16,35,91
"2011","North Lincolnshire 012D","E01013321","Total",665,144,67,77,521,19,100,99,145,21,38,99
"2011","North Lincolnshire 013A","E01013274","Total",818,193,70,123,625,32,105,129,210,15,37,97
"2011","North Lincolnshire 013B","E01013275","Total",650,144,93,51,506,27,110,94,141,17,41,76
"2011","North Lincolnshire 013C","E01013276","Total",730,235,140,95,495,39,117,94,119,15,29,82
"2011","North Lincolnshire 013D","E01013277","Total",636,150,77,73,486,20,97,94,151,12,25,87
"2011","North Lincolnshire 014A","E01013315","Total",776,360,246,114,416,27,112,55,121,20,20,61
"2011","North Lincolnshire 014B","E01013317","Total",558,157,91,66,401,22,76,60,106,19,29,89
"2011","North Lincolnshire 014C","E01013318","Total",625,189,97,92,436,21,68,83,98,27,43,96
"2011","North Lincolnshire 014D","E01013319","Total",920,276,70,206,644,90,66,146,157,40,56,89
"2011","North Lincolnshire 015A","E01013238","Total",769,287,124,163,482,32,69,105,149,18,32,77
"2011","North Lincolnshire 015B","E01013240","Total",987,294,106,188,693,73,82,159,206,16,58,99
"2011","North Lincolnshire 015C","E01013311","Total",772,265,110,155,507,86,65,93,128,29,48,58
"2011","North Lincolnshire 015D","E01013320","Total",636,184,77,107,452,23,86,102,119,19,32,71
"2011","North Lincolnshire 016A","E01013278","Total",641,223,69,154,418,73,54,72,102,25,36,56
"2011","North Lincolnshire 016B","E01013280","Total",601,130,54,76,471,22,114,86,118,17,29,85
"2011","North Lincolnshire 016C","E01013281","Total",517,110,45,65,407,51,61,75,85,28,40,67
"2011","North Lincolnshire 016D","E01013283","Total",530,97,49,48,433,58,65,77,86,26,44,77
"2011","North Lincolnshire 017A","E01013236","Total",728,263,152,111,465,25,121,91,111,11,27,79
"2011","North Lincolnshire 017B","E01013239","Total",714,234,96,138,480,29,99,72,152,10,38,80
"2011","North Lincolnshire 017C","E01013282","Total",624,137,75,62,487,48,86,80,122,27,41,83
"2011","North Lincolnshire 017D","E01013284","Total",645,182,82,100,463,49,75,76,102,26,43,92
"2011","North Lincolnshire 018B","E01013237","Total",647,151,94,57,496,72,63,86,96,38,57,84
"2011","North Lincolnshire 018C","E01013261","Total",640,156,104,52,484,13,162,84,119,14,20,72
"2011","North Lincolnshire 018D","E01013262","Total",598,138,85,53,460,12,138,69,129,16,19,77
"2011","North Lincolnshire 018E","E01013263","Total",666,212,127,85,454,14,117,67,137,8,26,85
"2011","North Lincolnshire 018F","E01033296","Total",601,138,70,68,463,25,104,92,119,15,27,81
"2011","North Lincolnshire 018G","E01033297","Total",652,147,4,143,505,55,14,190,142,16,31,57
"2011","North Lincolnshire 019A","E01013260","Total",660,166,107,59,494,15,151,73,133,8,29,85
"2011","North Lincolnshire 019B","E01013264","Total",746,185,94,91,561,41,98,107,188,14,28,85
"2011","North Lincolnshire 019C","E01013265","Total",726,181,118,63,545,15,156,82,153,13,32,94
"2011","North Lincolnshire 019D","E01013266","Total",835,220,87,133,615,32,113,125,193,23,28,101
"2011","North Lincolnshire 020A","E01013241","Total",725,239,133,106,486,16,152,77,140,10,21,70
"2011","North Lincolnshire 020B","E01013242","Total",709,138,58,80,571,17,115,98,159,21,42,119
"2011","North Lincolnshire 020C","E01013243","Total",871,190,84,106,681,46,112,132,209,22,51,109
"2011","North Lincolnshire 020D","E01013244","Total",790,246,116,130,544,40,104,128,148,17,34,73
"2011","North Lincolnshire 021A","E01013324","Total",627,137,67,70,490,4,115,96,123,10,38,104
"2011","North Lincolnshire 021B","E01013326","Total",696,170,105,65,526,19,163,83,141,9,27,84
"2011","North Lincolnshire 021C","E01013327","Total",697,225,141,84,472,15,179,69,136,10,12,51
"2011","North Lincolnshire 021D","E01013328","Total",519,90,48,42,429,24,99,93,106,11,27,69
"2011","North Lincolnshire 022A","E01013322","Total",806,201,83,118,605,41,124,117,169,23,50,81
"2011","North Lincolnshire 022B","E01013323","Total",670,140,73,67,530,35,115,95,162,16,29,78
"2011","North Lincolnshire 022C","E01013325","Total",650,148,80,68,502,12,141,70,136,14,38,91
"2011","North Lincolnshire 022D","E01013329","Total",773,208,93,115,565,24,132,103,166,25,47,68
"2011","North Lincolnshire 023A","E01013250","Total",703,189,109,80,514,19,124,80,166,17,35,73
"2011","North Lincolnshire 023B","E01013251","Total",768,170,82,88,598,8,164,90,172,15,40,109
"2011","North Lincolnshire 023C","E01013252","Total",695,137,78,59,558,22,131,121,150,21,37,76
"2011","North Lincolnshire 023D","E01013253","Total",801,194,93,101,607,27,123,131,166,23,46,91
"2011","York 001A","E01013436","Total",626,100,44,56,526,16,88,153,138,30,36,65
"2011","York 001B","E01013438","Total",733,186,108,78,547,40,101,122,142,22,33,87
"2011","York 001C","E01013439","Total",527,80,35,45,447,7,65,143,119,18,43,52
"2011","York 001D","E01013440","Total",787,195,98,97,592,24,117,108,177,23,38,105
"2011","York 002A","E01013370","Total",756,301,195,106,455,27,130,61,140,14,26,57
"2011","York 002B","E01013373","Total",635,199,127,72,436,20,106,90,116,14,28,62
"2011","York 002C","E01013375","Total",598,156,98,58,442,13,134,72,130,7,17,69
"2011","York 002D","E01013376","Total",635,131,82,49,504,14,136,80,156,13,23,82
"2011","York 003A","E01013371","Total",588,112,71,41,476,14,100,96,135,14,25,92
"2011","York 003B","E01013372","Total",805,319,220,99,486,19,164,66,141,14,20,62
"2011","York 003C","E01013374","Total",594,88,54,34,506,18,109,113,136,14,31,85
"2011","York 003D","E01013377","Total",659,129,67,62,530,15,113,107,150,17,25,103
"2011","York 004A","E01013404","Total",647,205,85,120,442,29,89,71,143,12,29,69
"2011","York 004B","E01013407","Total",672,234,170,64,438,17,141,58,124,16,16,66
"2011","York 004C","E01013408","Total",626,174,129,45,452,11,185,44,114,7,20,71
"2011","York 004D","E01013410","Total",620,230,126,104,390,50,63,58,89,13,42,75
"2011","York 005A","E01013405","Total",611,157,89,68,454,18,121,69,120,14,23,89
"2011","York 005B","E01013406","Total",835,207,51,156,628,46,90,128,225,13,44,82
"2011","York 005C","E01013409","Total",705,211,141,70,494,20,143,82,129,12,28,80
"2011","York 005D","E01013411","Total",713,221,159,62,492,14,185,82,100,8,28,75
"2011","York 006A","E01013428","Total",701,189,69,120,512,38,56,118,180,12,30,78
"2011","York 006B","E01013429","Total",808,174,29,145,634,49,46,176,207,33,41,82
"2011","York 006C","E01013430","Total",656,140,67,73,516,22,122,94,154,11,39,74
"2011","York 006D","E01013431","Total",656,173,34,139,483,44,43,146,161,14,26,49
"2011","York 006E","E01013435","Total",630,167,84,83,463,20,89,101,145,10,32,66
"2011","York 007A","E01013344","Total",677,258,75,183,419,14,60,68,173,15,17,72
"2011","York 007B","E01013346","Total",810,311,161,150,499,20,118,78,185,12,18,68
"2011","York 007C","E01013432","Total",865,233,101,132,632,39,106,163,187,23,35,79
"2011","York 007D","E01013433","Total",651,177,113,64,474,14,132,91,121,9,27,80
"2011","York 007E","E01013434","Total",616,157,78,79,459,15,120,95,136,7,23,63
"2011","York 008A","E01013379","Total",614,166,97,69,448,16,90,100,116,16,26,84
"2011","York 008B","E01013380","Total",716,232,88,144,484,18,76,71,158,12,33,116
"2011","York 008C","E01013385","Total",635,205,83,122,430,49,66,75,119,14,26,81
"2011","York 008D","E01013387","Total",679,198,141,57,481,10,157,91,132,13,19,59
"2011","York 008E","E01013388","Total",503,164,105,59,339,7,123,39,93,5,14,58
"2011","York 008F","E01013389","Total",505,131,85,46,374,12,106,60,95,8,26,67
"2011","York 008G","E01013437","Total",525,138,65,73,387,16,103,61,111,5,20,71
"2011","York 009A","E01013343","Total",839,275,98,177,564,30,50,81,236,17,16,134
"2011","York 009B","E01013345","Total",786,245,117,128,541,29,59,80,220,10,18,125
"2011","York 009C","E01013347","Total",667,212,72,140,455,54,52,88,115,22,37,87
"2011","York 009D","E01013349","Total",523,143,35,108,380,57,37,73,74,27,46,66
"2011","York 009E","E01013350","Total",678,233,69,164,445,41,64,69,123,18,49,81
"2011","York 010A","E01013348","Total",672,201,43,158,471,42,35,80,173,5,11,125
"2011","York 010B","E01013368","Total",937,277,65,212,660,41,45,97,224,8,19,226
"2011","York 010C","E01013382","Total",760,278,105,173,482,52,63,86,156,8,38,79
"2011","York 010D","E01013383","Total",1031,356,88,268,675,73,60,88,245,19,24,166
"2011","York 010E","E01013386","Total",761,257,99,158,504,57,43,89,168,27,37,83
"2011","York 011A","E01013421","Total",524,122,62,60,402,14,105,72,116,12,25,58
"2011","York 011B","E01013422","Total",644,114,57,57,530,23,95,134,149,21,43,65
"2011","York 011C","E01013426","Total",718,178,131,47,540,11,182,90,136,18,28,75
"2011","York 011D","E01013427","Total",605,142,111,31,463,9,171,81,84,20,28,70
"2011","York 012A","E01013335","Total",639,172,80,92,467,57,80,83,104,17,43,83
"2011","York 012B","E01013336","Total",638,194,90,104,444,22,111,69,106,19,25,92
"2011","York 012C","E01013337","Total",697,203,93,110,494,15,85,97,141,25,33,98
"2011","York 012D","E01013338","Total",902,197,83,114,705,58,131,153,175,22,45,121
"2011","York 012E","E01013339","Total",644,156,104,52,488,8,102,108,123,25,37,85
"2011","York 012F","E01013392","Total",632,169,74,95,463,20,60,99,142,24,32,86
"2011","York 013A","E01013366","Total",975,517,130,387,458,30,59,54,216,6,7,86
"2011","York 013C","E01013369","Total",982,500,164,336,482,24,78,56,218,3,14,89
"2011","York 013E","E01013416","Total",791,359,123,236,432,68,33,58,174,10,19,70
"2011","York 013F","E01033067","Total",733,355,78,277,378,38,36,53,180,4,6,61
"2011","York 013G","E01033068","Total",683,321,53,268,362,24,38,27,230,1,2,40
"2011","York 013H","E01033069","Total",645,323,74,249,322,20,40,40,169,4,11,38
"2011","York 013I","E01033070","Total",702,396,71,325,306,10,29,26,191,1,5,44
"2011","York 014A","E01013381","Total",615,157,82,75,458,22,74,103,114,6,31,108
"2011","York 014B","E01013402","Total",641,144,99,45,497,8,138,63,99,8,35,146
"2011","York 014C","E01013419","Total",652,186,126,60,466,19,149,70,109,12,28,79
"2011","York 014D","E01013420","Total",854,243,136,107,611,26,147,126,137,15,33,127
"2011","York 015A","E01013384","Total",653,192,87,105,461,35,39,78,89,18,31,171
"2011","York 015B","E01013398","Total",556,132,50,82,424,30,50,66,75,18,31,154
"2011","York 015C","E01013399","Total",682,189,81,108,493,89,43,102,90,34,34,101
"2011","York 015D","E01013400","Total",862,283,34,249,579,43,26,50,285,3,13,159
"2011","York 015E","E01013401","Total",593,113,51,62,480,30,38,55,134,15,33,175
"2011","York 015F","E01013403","Total",650,146,68,78,504,16,77,45,106,4,38,218
"2011","York 016A","E01013393","Total",730,227,54,173,503,52,62,96,190,16,21,66
"2011","York 016B","E01013394","Total",663,267,87,180,396,57,80,77,115,9,17,41
"2011","York 016C","E01013395","Total",650,197,63,134,453,20,62,104,160,13,26,68
"2011","York 016D","E01013396","Total",767,289,155,134,478,32,127,97,121,17,18,66
"2011","York 016E","E01013441","Total",697,212,78,134,485,35,81,92,163,10,19,85
"2011","York 016F","E01013445","Total",769,328,160,168,441,53,64,87,149,10,26,52
"2011","York 017A","E01013390","Total",796,269,47,222,527,52,27,90,289,7,14,48
"2011","York 017B","E01013391","Total",1049,341,70,271,708,54,48,112,367,21,12,94
"2011","York 017C","E01013397","Total",643,175,80,95,468,28,85,89,141,20,22,83
"2011","York 017D","E01013413","Total",727,232,82,150,495,21,51,112,179,22,17,93
"2011","York 017E","E01013417","Total",838,304,75,229,534,22,82,108,191,32,26,73
"2011","York 018A","E01013442","Total",615,165,94,71,450,39,96,75,143,8,23,66
"2011","York 018B","E01013443","Total",709,297,116,181,412,72,54,67,121,20,18,60
"2011","York 018C","E01013444","Total",585,158,62,96,427,76,54,91,98,18,22,68
"2011","York 018D","E01013446","Total",700,203,87,116,497,49,69,104,133,18,36,88
"2011","York 018E","E01013447","Total",617,180,76,104,437,62,55,80,113,15,32,80
"2011","York 018F","E01013448","Total",604,210,59,151,394,58,37,82,117,21,24,55
"2011","York 019A","E01013360","Total",648,106,55,51,542,25,65,157,123,27,39,106
"2011","York 019B","E01013361","Total",799,210,55,155,589,58,53,91,210,8,17,152
"2011","York 019C","E01013362","Total",772,278,144,134,494,28,110,79,142,14,26,95
"2011","York 019D","E01013363","Total",861,321,101,220,540,33,36,68,225,3,13,162
"2011","York 019E","E01013364","Total",865,317,71,246,548,38,37,52,198,7,26,190
"2011","York 019F","E01013418","Total",798,333,96,237,465,45,62,80,188,5,14,71
"2011","York 020A","E01013351","Total",761,167,101,66,594,19,188,117,129,16,44,81
"2011","York 020B","E01013352","Total",758,220,154,66,538,17,187,103,113,23,21,74
"2011","York 020C","E01013451","Total",468,78,33,45,390,19,63,88,121,26,26,47
"2011","York 020D","E01013452","Total",640,123,80,43,517,18,122,118,132,28,41,58
"2011","York 021A","E01013357","Total",808,162,88,74,646,23,196,145,147,29,40,66
"2011","York 021B","E01013358","Total",671,176,58,118,495,20,100,112,150,16,20,77
"2011","York 021C","E01013412","Total",881,309,81,228,572,55,35,98,278,11,12,83
"2011","York 021D","E01013414","Total",770,231,78,153,539,49,76,92,212,12,16,82
"2011","York 022A","E01013353","Total",727,264,132,132,463,29,83,89,142,12,36,72
"2011","York 022B","E01013354","Total",613,136,53,83,477,16,84,89,178,3,29,78
"2011","York 022C","E01013355","Total",710,209,115,94,501,12,170,63,163,4,19,70
"2011","York 022D","E01013356","Total",654,178,95,83,476,29,116,78,148,4,28,73
"2011","York 022E","E01013359","Total",660,198,93,105,462,38,77,99,119,19,31,79
"2011","York 022F","E01013449","Total",708,179,81,98,529,48,92,90,153,25,30,91
"2011","York 023A","E01013365","Total",1181,375,214,161,806,40,206,134,207,26,51,142
"2011","York 023B","E01013378","Total",480,150,65,85,330,18,59,52,93,10,24,74
"2011","York 023C","E01013450","Total",512,107,49,58,405,16,105,73,110,18,21,62
"2011","York 024A","E01013340","Total",521,113,62,51,408,15,105,96,96,13,19,64
"2011","York 024B","E01013341","Total",616,229,157,72,387,19,133,72,92,14,10,47
"2011","York 024C","E01013342","Total",599,128,56,72,471,14,160,80,124,6,21,66
"2011","York 024D","E01013423","Total",533,100,66,34,433,10,109,87,129,16,16,66
"2011","York 024E","E01013424","Total",506,69,23,46,437,19,86,81,117,17,32,85
"2011","York 024F","E01013425","Total",688,176,95,81,512,37,119,105,155,12,30,54
"2011","Craven 001A","E01027558","Total",845,247,129,118,598,16,163,99,178,16,24,102
"2011","Craven 001B","E01027559","Total",781,243,112,131,538,45,124,89,147,15,21,97
"2011","Craven 001C","E01027569","Total",589,144,88,56,445,14,139,68,132,10,27,55
"2011","Craven 001D","E01027570","Total",1099,326,172,154,773,30,211,122,224,20,43,123
"2011","Craven 002A","E01027562","Total",669,175,87,88,494,11,132,60,147,18,44,82
"2011","Craven 002B","E01027567","Total",789,309,193,116,480,19,165,72,127,16,25,56
"2011","Craven 002C","E01027585","Total",832,238,161,77,594,14,246,74,143,19,24,74
"2011","Craven 003A","E01027568","Total",942,234,117,117,708,24,188,120,220,29,36,91
"2011","Craven 003B","E01027571","Total",782,218,124,94,564,23,171,89,160,17,26,78
"2011","Craven 003C","E01027572","Total",998,405,183,222,593,31,145,95,187,15,36,84
"2011","Craven 003D","E01027573","Total",699,226,145,81,473,16,165,67,110,16,27,72
"2011","Craven 004A","E01027557","Total",655,156,68,88,499,11,135,88,137,20,40,68
"2011","Craven 004B","E01027561","Total",831,228,126,102,603,25,160,100,175,25,39,79
"2011","Craven 004C","E01027576","Total",668,164,111,53,504,9,155,72,134,17,45,72
"2011","Craven 005A","E01027574","Total",646,169,93,76,477,12,138,77,135,14,27,74
"2011","Craven 005B","E01027575","Total",879,278,183,95,601,29,142,112,183,9,25,101
"2011","Craven 005C","E01027577","Total",929,348,180,168,581,39,119,108,198,13,31,73
"2011","Craven 005D","E01027579","Total",533,204,98,106,329,54,50,63,90,6,21,45
"2011","Craven 006A","E01027578","Total",737,269,105,164,468,59,58,79,180,18,17,57
"2011","Craven 006B","E01027580","Total",486,185,92,93,301,44,37,44,66,16,30,64
"2011","Craven 006C","E01027581","Total",1141,481,174,307,660,62,105,111,209,29,60,84
"2011","Craven 006D","E01027582","Total",678,224,91,133,454,30,88,69,138,21,38,70
"2011","Craven 007A","E01027556","Total",703,177,74,103,526,15,113,112,149,17,36,84
"2011","Craven 007B","E01027560","Total",977,244,80,164,733,53,100,183,227,25,44,101
"2011","Craven 007C","E01027563","Total",681,255,152,103,426,18,133,61,125,9,24,56
"2011","Craven 007D","E01027586","Total",854,261,113,148,593,23,148,115,185,18,31,73
"2011","Craven 008A","E01027555","Total",826,220,108,112,606,26,166,113,170,12,38,81
"2011","Craven 008B","E01027564","Total",569,261,146,115,308,27,63,55,90,8,18,47
"2011","Craven 008C","E01027565","Total",657,160,90,70,497,31,127,101,131,14,36,57
"2011","Craven 008D","E01027566","Total",535,138,72,66,397,23,82,73,115,11,19,74
"2011","Craven 008E","E01027583","Total",845,227,130,97,618,44,129,126,153,22,50,94
"2011","Craven 008F","E01027584","Total",728,237,134,103,491,28,106,98,150,7,21,81
"2011","Hambleton 001A","E01027591","Total",730,188,86,102,542,17,157,75,148,17,29,99
"2011","Hambleton 001B","E01027597","Total",687,191,99,92,496,16,144,92,120,15,29,80
"2011","Hambleton 001C","E01027599","Total",801,318,151,167,483,36,115,92,126,15,30,69
"2011","Hambleton 001D","E01027623","Total",584,181,125,56,403,15,119,76,93,13,22,65
"2011","Hambleton 001E","E01027625","Total",772,297,162,135,475,49,117,80,116,18,29,66
"2011","Hambleton 002A","E01027598","Total",855,271,173,98,584,15,241,78,147,9,19,75
"2011","Hambleton 002B","E01027618","Total",1042,248,144,104,794,24,244,119,207,22,51,127
"2011","Hambleton 002C","E01027624","Total",527,115,76,39,412,17,110,73,97,11,31,73
"2011","Hambleton 002D","E01027626","Total",584,145,85,60,439,15,145,63,116,10,23,67
"2011","Hambleton 002E","E01027627","Total",803,225,111,114,578,9,169,96,153,12,44,95
"2011","Hambleton 003A","E01027590","Total",982,355,132,223,627,29,130,118,208,12,35,95
"2011","Hambleton 003B","E01027592","Total",758,171,72,99,587,13,167,77,175,11,37,107
"2011","Hambleton 003C","E01027613","Total",767,217,107,110,550,15,147,93,138,18,40,99
"2011","Hambleton 003D","E01027617","Total",451,108,54,54,343,7,74,49,101,14,24,74
"2011","Hambleton 004A","E01027605","Total",728,263,75,188,465,34,57,99,181,14,19,61
"2011","Hambleton 004B","E01027606","Total",692,216,135,81,476,13,139,100,124,11,15,74
"2011","Hambleton 004C","E01027608","Total",731,261,78,183,470,49,65,76,126,27,32,95
"2011","Hambleton 004D","E01027609","Total",548,133,34,99,415,60,29,106,124,9,32,55
"2011","Hambleton 004E","E01027610","Total",733,228,86,142,505,42,83,97,150,18,31,84
"2011","Hambleton 004F","E01027611","Total",925,317,208,109,608,19,204,86,170,14,29,86
"2011","Hambleton 004G","E01027612","Total",757,262,148,114,495,60,96,92,112,21,32,82
"2011","Hambleton 004H","E01027616","Total",661,230,123,107,431,34,90,87,121,15,29,55
"2011","Hambleton 005A","E01027603","Total",789,178,100,78,611,18,155,113,161,11,42,111
"2011","Hambleton 005B","E01027604","Total",762,183,96,87,579,18,157,100,174,20,27,83
"2011","Hambleton 005C","E01027607","Total",550,131,92,39,419,9,140,51,109,4,26,80
"2011","Hambleton 005D","E01027614","Total",565,156,103,53,409,9,125,66,111,4,22,72
"2011","Hambleton 005E","E01027615","Total",504,89,66,23,415,10,94,94,106,9,23,79
"2011","Hambleton 006A","E01027587","Total",623,218,157,61,405,19,132,69,86,5,28,66
"2011","Hambleton 006B","E01027588","Total",677,233,104,129,444,30,85,90,118,14,37,70
"2011","Hambleton 006C","E01027589","Total",714,182,98,84,532,22,112,92,151,12,30,113
"2011","Hambleton 006D","E01027593","Total",751,201,101,100,550,9,146,104,157,12,40,82
"2011","Hambleton 007B","E01027628","Total",766,167,89,78,599,20,124,118,189,28,28,92
"2011","Hambleton 007C","E01027633","Total",788,171,79,92,617,16,183,106,176,27,28,81
"2011","Hambleton 007D","E01033065","Total",473,84,46,38,389,16,65,113,103,13,18,61
"2011","Hambleton 007E","E01033066","Total",548,64,29,35,484,11,39,187,102,66,33,46
"2011","Hambleton 008A","E01027620","Total",808,222,105,117,586,41,113,147,149,13,41,82
"2011","Hambleton 008B","E01027630","Total",869,344,143,201,525,36,107,86,184,14,17,81
"2011","Hambleton 008C","E01027631","Total",677,250,142,108,427,18,118,69,127,13,27,55
"2011","Hambleton 008D","E01027632","Total",595,135,65,70,460,18,96,97,114,17,39,79
"2011","Hambleton 008E","E01027637","Total",823,204,99,105,619,18,172,98,185,15,34,97
"2011","Hambleton 009A","E01027621","Total",1000,282,175,107,718,30,193,108,211,19,52,105
"2011","Hambleton 009B","E01027629","Total",615,204,110,94,411,42,96,85,98,17,24,49
"2011","Hambleton 009C","E01027635","Total",925,172,85,87,753,26,135,188,230,36,36,102
"2011","Hambleton 009D","E01027636","Total",870,202,122,80,668,15,181,106,187,27,37,115
"2011","Hambleton 010A","E01027594","Total",737,312,184,128,425,30,119,82,100,11,23,60
"2011","Hambleton 010B","E01027595","Total",740,235,124,111,505,30,131,91,125,16,27,85
"2011","Hambleton 010C","E01027596","Total",731,263,168,95,468,13,165,58,121,19,24,68
"2011","Hambleton 010D","E01027601","Total",791,190,108,82,601,25,133,124,161,20,48,90
"2011","Hambleton 010E","E01027622","Total",798,179,93,86,619,16,180,105,154,24,45,95
"2011","Hambleton 011A","E01027600","Total",773,157,76,81,616,18,122,145,179,17,40,95
"2011","Hambleton 011B","E01027619","Total",952,184,82,102,768,31,129,205,211,39,52,101
"2011","Hambleton 011C","E01027634","Total",785,147,76,71,638,26,108,149,174,24,54,103
"2011","Harrogate 001A","E01027666","Total",720,161,96,65,559,24,149,95,158,25,29,79
"2011","Harrogate 001B","E01027667","Total",563,128,54,74,435,11,101,100,113,14,31,65
"2011","Harrogate 001C","E01027685","Total",592,217,125,92,375,20,107,49,121,9,23,46
"2011","Harrogate 001D","E01027686","Total",461,89,32,57,372,19,90,65,106,12,19,61
"2011","Harrogate 002A","E01027712","Total",505,98,51,47,407,18,77,103,95,15,29,70
"2011","Harrogate 002B","E01027713","Total",754,265,125,140,489,35,106,85,142,18,29,74
"2011","Harrogate 002C","E01027714","Total",740,255,132,123,485,28,119,84,141,26,28,59
"2011","Harrogate 002D","E01027715","Total",411,77,48,29,334,8,40,127,83,20,23,33
"2011","Harrogate 003A","E01027643","Total",631,157,78,79,474,13,150,78,126,20,29,58
"2011","Harrogate 003B","E01027688","Total",681,165,91,74,516,16,158,92,145,13,20,72
"2011","Harrogate 003C","E01027736","Total",658,142,73,69,516,20,112,100,174,22,25,63
"2011","Harrogate 003D","E01027737","Total",606,89,46,43,517,19,73,173,149,22,24,57
"2011","Harrogate 004A","E01027705","Total",706,197,61,136,509,36,78,110,154,17,35,79
"2011","Harrogate 004B","E01027706","Total",976,423,211,212,553,67,110,95,153,20,33,75
"2011","Harrogate 004C","E01027707","Total",792,232,91,141,560,50,138,95,163,15,27,72
"2011","Harrogate 004D","E01027708","Total",604,156,92,64,448,18,122,97,116,12,19,64
"2011","Harrogate 004E","E01027709","Total",507,114,73,41,393,3,119,61,101,15,27,67
"2011","Harrogate 004F","E01027710","Total",465,149,83,66,316,42,80,53,67,12,24,38
"2011","Harrogate 004G","E01027711","Total",499,101,53,48,398,30,49,87,110,17,33,72
"2011","Harrogate 005A","E01027644","Total",664,200,113,87,464,21,114,115,125,13,21,55
"2011","Harrogate 005B","E01027645","Total",677,192,65,127,485,32,117,74,140,9,31,82
"2011","Harrogate 005C","E01027647","Total",677,153,80,73,524,9,145,101,146,14,33,76
"2011","Harrogate 005D","E01027687","Total",617,142,75,67,475,11,109,89,133,15,36,82
"2011","Harrogate 006A","E01027681","Total",668,160,62,98,508,25,113,83,151,25,35,76
"2011","Harrogate 006B","E01027693","Total",745,168,88,80,577,16,142,104,158,16,37,104
"2011","Harrogate 006C","E01027701","Total",681,183,85,98,498,17,123,77,157,19,25,80
"2011","Harrogate 006D","E01027702","Total",551,216,127,89,335,19,81,54,109,8,22,42
"2011","Harrogate 007A","E01027642","Total",596,137,72,65,459,17,156,86,109,17,26,48
"2011","Harrogate 007B","E01027646","Total",669,169,86,83,500,22,142,90,138,18,33,57
"2011","Harrogate 007C","E01027674","Total",546,128,87,41,418,12,87,96,110,16,34,63
"2011","Harrogate 007D","E01027675","Total",938,193,113,80,745,30,140,189,190,32,48,116
"2011","Harrogate 008A","E01027641","Total",470,64,22,42,406,8,55,99,108,12,38,86
"2011","Harrogate 008B","E01027664","Total",895,242,167,75,653,33,166,136,161,42,40,75
"2011","Harrogate 008C","E01027665","Total",453,110,65,45,343,12,100,64,84,14,18,51
"2011","Harrogate 008D","E01027722","Total",539,100,27,73,439,35,28,128,131,23,35,59
"2011","Harrogate 009A","E01027668","Total",672,187,112,75,485,43,103,133,117,10,25,54
"2011","Harrogate 009B","E01027669","Total",934,382,235,147,552,36,174,82,136,13,24,87
"2011","Harrogate 009C","E01027673","Total",881,352,143,209,529,52,120,82,162,11,29,73
"2011","Harrogate 009D","E01027676","Total",686,162,72,90,524,42,67,137,122,19,45,92
"2011","Harrogate 010A","E01027638","Total",598,141,71,70,457,16,133,81,138,11,17,61
"2011","Harrogate 010B","E01027639","Total",546,146,78,68,400,22,89,84,104,15,26,60
"2011","Harrogate 010C","E01027640","Total",657,189,103,86,468,33,107,108,117,12,29,62
"2011","Harrogate 010D","E01027690","Total",632,166,92,74,466,20,111,89,138,9,20,79
"2011","Harrogate 010E","E01027738","Total",579,147,63,84,432,44,54,85,147,12,19,71
"2011","Harrogate 010F","E01027739","Total",458,108,42,66,350,18,43,77,125,8,25,54
"2011","Harrogate 010G","E01027741","Total",622,184,117,67,438,32,100,74,121,17,15,79
"2011","Harrogate 011A","E01027689","Total",635,194,61,133,441,40,70,81,157,12,21,60
"2011","Harrogate 011B","E01027691","Total",665,196,64,132,469,38,63,108,162,11,28,59
"2011","Harrogate 011C","E01027720","Total",653,206,64,142,447,36,64,103,142,17,23,62
"2011","Harrogate 011D","E01027721","Total",643,164,61,103,479,22,74,108,157,16,34,68
"2011","Harrogate 011E","E01027723","Total",740,312,108,204,428,53,51,91,143,8,26,56
"2011","Harrogate 012A","E01027670","Total",662,144,70,74,518,37,92,114,144,15,32,84
"2011","Harrogate 012B","E01027671","Total",621,116,79,37,505,12,135,115,110,14,36,83
"2011","Harrogate 012C","E01027672","Total",698,135,96,39,563,17,175,105,129,5,32,100
"2011","Harrogate 012D","E01027704","Total",500,127,78,49,373,6,110,73,102,11,22,49
"2011","Harrogate 013A","E01027649","Total",696,177,79,98,519,50,66,103,170,14,27,89
"2011","Harrogate 013B","E01027651","Total",600,184,87,97,416,46,54,93,77,25,39,82
"2011","Harrogate 013C","E01027657","Total",580,194,37,157,386,38,20,78,163,8,17,62
"2011","Harrogate 013D","E01027658","Total",740,238,71,167,502,69,52,84,205,14,22,56
"2011","Harrogate 013E","E01027692","Total",545,201,73,128,344,30,49,68,109,12,15,61
"2011","Harrogate 013F","E01027740","Total",940,556,300,256,384,32,118,50,111,9,13,51
"2011","Harrogate 014A","E01027648","Total",679,227,109,118,452,43,73,107,101,21,35,72
"2011","Harrogate 014B","E01027650","Total",625,155,85,70,470,29,87,93,118,16,38,89
"2011","Harrogate 014C","E01027726","Total",674,189,82,107,485,48,60,102,148,15,24,88
"2011","Harrogate 014D","E01027727","Total",673,190,113,77,483,29,77,92,149,9,31,96
"2011","Harrogate 014E","E01027728","Total",612,187,116,71,425,24,122,83,95,7,21,73
"2011","Harrogate 014F","E01027729","Total",682,196,63,133,486,72,35,109,165,15,29,61
"2011","Harrogate 015A","E01027652","Total",691,245,80,165,446,43,81,92,138,20,25,47
"2011","Harrogate 015B","E01027655","Total",535,191,89,102,344,8,96,55,94,15,34,42
"2011","Harrogate 015C","E01027659","Total",939,427,82,345,512,49,40,90,229,15,18,71
"2011","Harrogate 015D","E01027677","Total",685,277,75,202,408,14,69,62,175,7,17,64
"2011","Harrogate 015E","E01027678","Total",920,459,94,365,461,30,42,78,210,6,14,81
"2011","Harrogate 015F","E01027680","Total",727,383,116,267,344,32,49,63,138,9,11,42
"2011","Harrogate 016A","E01027683","Total",585,128,72,56,457,18,81,110,131,17,25,75
"2011","Harrogate 016B","E01027684","Total",588,126,67,59,462,17,90,93,138,18,26,80
"2011","Harrogate 016C","E01027695","Total",690,151,84,67,539,28,109,111,167,20,29,75
"2011","Harrogate 016D","E01027696","Total",549,103,51,52,446,15,88,91,126,16,32,78
"2011","Harrogate 016E","E01027703","Total",773,192,89,103,581,25,128,105,197,10,30,86
"2011","Harrogate 017A","E01027660","Total",640,178,126,52,462,13,137,73,108,21,32,78
"2011","Harrogate 017B","E01027661","Total",620,178,97,81,442,29,104,91,96,6,25,91
"2011","Harrogate 017C","E01027662","Total",447,79,53,26,368,6,64,93,83,18,25,79
"2011","Harrogate 017D","E01027663","Total",616,192,101,91,424,12,99,89,121,8,24,71
"2011","Harrogate 017E","E01027697","Total",588,149,82,67,439,26,88,119,95,17,32,62
"2011","Harrogate 017F","E01027733","Total",518,111,72,39,407,15,97,102,84,18,21,70
"2011","Harrogate 018A","E01027682","Total",674,144,79,65,530,18,140,95,141,31,20,85
"2011","Harrogate 018B","E01027694","Total",478,84,46,38,394,14,107,68,104,22,25,54
"2011","Harrogate 018C","E01027734","Total",647,147,72,75,500,9,129,88,153,24,31,66
"2011","Harrogate 018D","E01027735","Total",667,156,82,74,511,17,136,99,123,23,37,76
"2011","Harrogate 019A","E01027656","Total",872,382,177,205,490,27,136,74,169,10,14,60
"2011","Harrogate 019B","E01027679","Total",820,381,191,190,439,28,113,78,145,10,18,47
"2011","Harrogate 019C","E01027730","Total",688,229,91,138,459,32,83,91,144,21,25,63
"2011","Harrogate 019D","E01027731","Total",624,195,81,114,429,38,62,85,135,30,25,54
"2011","Harrogate 019E","E01027732","Total",544,146,71,75,398,14,107,69,117,24,27,40
"2011","Harrogate 020A","E01027653","Total",658,274,153,121,384,34,100,70,89,16,27,48
"2011","Harrogate 020B","E01027654","Total",487,116,52,64,371,16,80,81,99,23,19,53
"2011","Harrogate 020C","E01027698","Total",629,133,85,48,496,25,138,92,112,16,42,71
"2011","Harrogate 020D","E01027716","Total",603,135,98,37,468,11,158,85,93,21,24,76
"2011","Harrogate 020E","E01027717","Total",618,154,88,66,464,15,90,148,107,13,32,59
"2011","Harrogate 020F","E01027718","Total",746,161,87,74,585,48,113,148,142,28,36,70
"2011","Harrogate 020G","E01027719","Total",621,198,128,70,423,27,123,74,103,13,30,53
"2011","Harrogate 021A","E01027699","Total",515,88,63,25,427,6,134,82,93,15,38,59
"2011","Harrogate 021B","E01027700","Total",494,113,63,50,381,12,106,81,84,13,18,67
"2011","Harrogate 021C","E01027724","Total",655,144,76,68,511,16,147,106,123,27,30,62
"2011","Harrogate 021D","E01027725","Total",633,167,75,92,466,14,114,99,127,14,25,73
"2011","Richmondshire 001A","E01027743","Total",536,125,62,63,411,11,127,64,117,13,19,60
"2011","Richmondshire 001B","E01027751","Total",530,118,57,61,412,18,101,75,107,11,22,78
"2011","Richmondshire 001C","E01027752","Total",548,176,95,81,372,7,89,61,129,12,24,50
"2011","Richmondshire 001D","E01027759","Total",615,161,77,84,454,16,107,88,138,10,30,65
"2011","Richmondshire 001E","E01027761","Total",525,151,78,73,374,14,140,58,101,10,19,32
"2011","Richmondshire 001F","E01027762","Total",571,147,61,86,424,13,90,68,144,12,27,70
"2011","Richmondshire 002A","E01027765","Total",670,158,85,73,512,39,104,86,155,13,31,84
"2011","Richmondshire 002B","E01027766","Total",581,241,121,120,340,24,77,51,98,9,27,54
"2011","Richmondshire 002C","E01027767","Total",625,135,78,57,490,28,131,77,125,22,28,79
"2011","Richmondshire 002D","E01027768","Total",496,120,71,49,376,22,102,71,84,12,24,61
"2011","Richmondshire 002E","E01027769","Total",567,156,64,92,411,48,94,53,111,11,30,64
"2011","Richmondshire 002F","E01027770","Total",836,362,152,210,474,62,108,72,155,12,16,49
"2011","Richmondshire 003A","E01027745","Total",624,133,51,82,491,30,89,114,128,25,42,63
"2011","Richmondshire 003B","E01027746","Total",648,190,89,101,458,26,95,78,152,9,21,77
"2011","Richmondshire 003C","E01027747","Total",580,140,44,96,440,27,61,118,145,13,24,52
"2011","Richmondshire 003D","E01027748","Total",530,158,98,60,372,19,116,69,93,10,18,47
"2011","Richmondshire 004A","E01027749","Total",786,218,82,136,568,100,63,108,124,28,41,104
"2011","Richmondshire 004B","E01027750","Total",998,225,75,150,773,82,63,161,237,27,75,128
"2011","Richmondshire 004C","E01027754","Total",454,74,31,43,380,18,40,121,95,44,29,33
"2011","Richmondshire 004E","E01027771","Total",484,14,7,7,470,22,11,233,103,47,36,18
"2011","Richmondshire 004F","E01027772","Total",544,126,48,78,418,25,65,70,154,8,32,64
"2011","Richmondshire 004G","E01033183","Total",421,2,0,2,419,15,0,222,54,72,40,16
"2011","Richmondshire 004H","E01033184","Total",496,35,6,29,461,43,5,179,131,30,31,42
"2011","Richmondshire 005A","E01027742","Total",631,204,111,93,427,7,134,54,136,9,26,61
"2011","Richmondshire 005B","E01027753","Total",606,178,77,101,428,13,101,72,147,7,27,61
"2011","Richmondshire 005C","E01027763","Total",550,165,81,84,385,5,131,50,133,7,15,44
"2011","Richmondshire 005D","E01027764","Total",542,144,73,71,398,7,109,61,127,12,27,55
"2011","Richmondshire 005E","E01027773","Total",493,134,67,67,359,6,111,42,125,9,14,52
"2011","Richmondshire 006A","E01027744","Total",590,159,81,78,431,14,158,63,124,11,16,45
"2011","Richmondshire 006B","E01027756","Total",716,153,65,88,563,41,74,137,182,19,33,77
"2011","Richmondshire 006D","E01027758","Total",591,134,66,68,457,11,132,73,133,15,20,73
"2011","Richmondshire 006E","E01027760","Total",587,179,83,96,408,12,121,44,126,18,15,72
"2011","Richmondshire 006F","E01033185","Total",611,223,132,91,388,22,126,54,100,9,12,65
"2011","Richmondshire 006G","E01033186","Total",625,201,137,64,424,14,157,48,121,9,18,57
"2011","Ryedale 001A","E01027776","Total",651,163,97,66,488,14,148,57,134,24,31,80
"2011","Ryedale 001B","E01027777","Total",606,148,66,82,458,13,137,56,128,15,29,80
"2011","Ryedale 001C","E01027783","Total",817,244,140,104,573,18,204,83,146,13,24,85
"2011","Ryedale 001D","E01027784","Total",772,262,159,103,510,35,135,87,132,23,32,66
"2011","Ryedale 002A","E01027792","Total",875,319,190,129,556,21,196,80,156,9,28,66
"2011","Ryedale 002B","E01027793","Total",658,237,140,97,421,24,106,69,108,13,29,72
"2011","Ryedale 002C","E01027794","Total",876,207,140,67,669,37,214,100,173,26,31,88
"2011","Ryedale 002D","E01027795","Total",719,252,135,117,467,33,101,75,130,23,22,83
"2011","Ryedale 002E","E01027801","Total",755,247,169,78,508,16,167,68,136,15,25,81
"2011","Ryedale 002F","E01027802","Total",710,178,96,82,532,16,142,77,177,13,36,71
"2011","Ryedale 003A","E01027775","Total",635,175,97,78,460,12,137,72,108,14,37,80
"2011","Ryedale 003B","E01027780","Total",788,217,112,105,571,19,151,89,160,18,31,103
"2011","Ryedale 003C","E01027781","Total",637,240,155,85,397,22,153,54,100,4,18,46
"2011","Ryedale 003D","E01027800","Total",728,174,109,65,554,17,156,77,166,21,32,85
"2011","Ryedale 004A","E01027779","Total",475,108,62,46,367,18,97,52,106,14,29,51
"2011","Ryedale 004B","E01027796","Total",772,221,137,84,551,15,143,105,156,19,27,86
"2011","Ryedale 004C","E01027798","Total",831,202,109,93,629,45,125,118,169,17,40,115
"2011","Ryedale 004D","E01027803","Total",714,140,57,83,574,17,113,109,183,34,38,80
"2011","Ryedale 007A","E01027774","Total",832,198,99,99,634,29,153,124,163,30,39,96
"2011","Ryedale 007B","E01027778","Total",1000,269,137,132,731,28,179,125,229,19,48,103
"2011","Ryedale 007C","E01027782","Total",766,214,129,85,552,22,161,74,180,8,27,80
"2011","Ryedale 007D","E01027797","Total",716,163,79,84,553,14,137,77,182,16,43,84
"2011","Ryedale 007E","E01027799","Total",762,195,112,83,567,20,148,83,174,23,30,89
"2011","Ryedale 008A","E01027785","Total",811,398,150,248,413,37,76,84,134,14,18,50
"2011","Ryedale 008B","E01027786","Total",688,188,107,81,500,11,172,65,124,13,29,86
"2011","Ryedale 008C","E01027787","Total",744,229,118,111,515,32,129,80,117,27,35,95
"2011","Ryedale 008D","E01027788","Total",658,216,140,76,442,14,128,70,119,7,22,82
"2011","Ryedale 008E","E01027789","Total",1063,339,149,190,724,62,102,167,212,32,42,107
"2011","Ryedale 008F","E01027790","Total",819,246,77,169,573,34,86,115,187,17,49,85
"2011","Ryedale 008G","E01027791","Total",646,157,90,67,489,11,99,103,149,17,29,81
"2011","Scarborough 001A","E01027837","Total",672,261,171,90,411,45,114,58,100,17,20,57
"2011","Scarborough 001B","E01027839","Total",707,194,119,75,513,27,116,108,128,26,31,77
"2011","Scarborough 001C","E01027869","Total",623,369,110,259,254,20,72,25,103,2,6,26
"2011","Scarborough 001D","E01027870","Total",685,291,145,146,394,49,100,43,141,4,14,43
"2011","Scarborough 001E","E01027871","Total",695,256,157,99,439,27,124,70,112,9,23,74
"2011","Scarborough 002A","E01027813","Total",837,214,118,96,623,15,172,78,174,15,51,118
"2011","Scarborough 002B","E01027822","Total",610,172,87,85,438,11,101,63,138,16,38,71
"2011","Scarborough 002C","E01027840","Total",977,356,182,174,621,38,148,90,177,20,35,113
"2011","Scarborough 002D","E01027841","Total",583,161,92,69,422,10,112,60,133,9,25,73
"2011","Scarborough 003A","E01027838","Total",681,178,93,85,503,13,155,66,140,15,31,83
"2011","Scarborough 003B","E01027864","Total",588,149,56,93,439,39,75,86,104,20,34,81
"2011","Scarborough 003C","E01027865","Total",785,309,97,212,476,55,84,69,149,9,26,84
"2011","Scarborough 003D","E01027866","Total",661,209,91,118,452,30,96,74,123,14,28,87
"2011","Scarborough 004A","E01027821","Total",651,184,108,76,467,12,177,50,124,5,27,72
"2011","Scarborough 004B","E01027823","Total",662,197,133,64,465,19,166,71,114,14,20,61
"2011","Scarborough 004C","E01027831","Total",463,120,64,56,343,12,107,51,90,11,15,57
"2011","Scarborough 004D","E01027832","Total",448,159,89,70,289,8,80,27,98,9,14,53
"2011","Scarborough 004E","E01027836","Total",1018,290,181,109,728,31,229,115,209,14,25,105
"2011","Scarborough 004F","E01027857","Total",560,144,89,55,416,13,130,59,106,13,30,65
"2011","Scarborough 005A","E01027842","Total",709,200,118,82,509,32,142,79,122,14,28,92
"2011","Scarborough 005B","E01027843","Total",622,197,118,79,425,35,103,86,104,14,27,56
"2011","Scarborough 005C","E01027844","Total",656,142,84,58,514,15,132,85,150,10,34,88
"2011","Scarborough 005D","E01027845","Total",725,185,113,72,540,28,126,89,133,18,38,108
"2011","Scarborough 005E","E01027855","Total",628,130,83,47,498,6,176,63,120,11,46,76
"2011","Scarborough 005F","E01027856","Total",610,246,197,49,364,3,186,38,70,8,14,45
"2011","Scarborough 006A","E01027805","Total",778,358,145,213,420,52,90,51,136,13,19,59
"2011","Scarborough 006B","E01027806","Total",928,511,146,365,417,50,44,72,144,11,26,70
"2011","Scarborough 006C","E01027846","Total",766,254,64,190,512,52,80,107,125,22,42,84
"2011","Scarborough 006D","E01027847","Total",996,544,121,423,452,54,57,70,171,16,26,58
"2011","Scarborough 006E","E01027848","Total",456,129,66,63,327,12,92,65,73,12,23,50
"2011","Scarborough 007A","E01027849","Total",518,183,105,78,335,12,117,38,76,13,22,57
"2011","Scarborough 007B","E01027850","Total",622,273,141,132,349,34,71,65,80,17,34,48
"2011","Scarborough 007C","E01027872","Total",604,182,89,93,422,44,81,65,98,19,36,79
"2011","Scarborough 007D","E01027874","Total",620,159,68,91,461,87,49,85,102,32,44,62
"2011","Scarborough 008A","E01027810","Total",649,162,48,114,487,63,40,112,121,23,43,85
"2011","Scarborough 008B","E01027811","Total",687,177,55,122,510,82,55,117,130,20,29,77
"2011","Scarborough 008C","E01027812","Total",753,224,83,141,529,93,56,123,119,20,29,89
"2011","Scarborough 008D","E01027851","Total",626,162,54,108,464,28,69,102,127,14,35,89
"2011","Scarborough 008E","E01027862","Total",753,297,90,207,456,53,70,83,143,15,25,67
"2011","Scarborough 009A","E01027824","Total",717,310,214,96,407,16,127,46,105,11,29,73
"2011","Scarborough 009B","E01027825","Total",759,222,62,160,537,64,45,134,164,27,36,67
"2011","Scarborough 009C","E01027826","Total",655,214,83,131,441,52,59,102,123,11,24,70
"2011","Scarborough 009D","E01027861","Total",646,274,120,154,372,45,70,58,108,14,19,58
"2011","Scarborough 009E","E01027863","Total",661,216,146,70,445,11,165,50,120,8,28,63
"2011","Scarborough 009F","E01027873","Total",723,292,161,131,431,21,113,72,116,12,23,74
"2011","Scarborough 010A","E01027804","Total",847,465,87,378,382,57,48,36,162,5,10,64
"2011","Scarborough 010B","E01027852","Total",899,493,111,382,406,30,78,42,171,2,10,73
"2011","Scarborough 010C","E01027853","Total",657,311,123,188,346,26,102,42,118,4,11,43
"2011","Scarborough 010D","E01027854","Total",857,481,155,326,376,26,74,28,201,4,10,33
"2011","Scarborough 010E","E01027868","Total",1173,605,322,283,568,17,222,60,193,8,10,58
"2011","Scarborough 011A","E01027807","Total",646,167,102,65,479,20,150,77,118,13,27,74
"2011","Scarborough 011B","E01027808","Total",654,156,96,60,498,20,190,60,122,11,21,74
"2011","Scarborough 011C","E01027809","Total",644,223,142,81,421,14,173,49,123,7,11,44
"2011","Scarborough 011D","E01027818","Total",611,158,82,76,453,40,85,100,150,8,21,49
"2011","Scarborough 011E","E01027867","Total",627,176,121,55,451,9,170,66,116,11,20,59
"2011","Scarborough 012A","E01027817","Total",592,195,77,118,397,62,56,65,89,16,43,66
"2011","Scarborough 012B","E01027819","Total",581,189,78,111,392,63,57,80,64,25,39,64
"2011","Scarborough 012C","E01027820","Total",510,107,44,63,403,59,52,92,77,32,39,52
"2011","Scarborough 012D","E01027858","Total",606,144,87,57,462,11,148,71,126,11,24,71
"2011","Scarborough 012E","E01027860","Total",637,151,86,65,486,29,116,96,116,19,29,81
"2011","Scarborough 013A","E01027814","Total",677,176,103,73,501,19,155,73,131,17,32,74
"2011","Scarborough 013B","E01027815","Total",594,151,83,68,443,16,120,62,153,12,24,56
"2011","Scarborough 013C","E01027816","Total",697,193,124,69,504,20,158,84,130,14,23,75
"2011","Scarborough 013D","E01027859","Total",719,159,90,69,560,18,131,110,168,12,41,80
"2011","Scarborough 014A","E01027827","Total",892,442,240,202,450,19,134,50,155,9,27,56
"2011","Scarborough 014B","E01027828","Total",798,250,196,54,548,17,254,57,113,9,22,76
"2011","Scarborough 014C","E01027829","Total",771,274,175,99,497,15,238,44,121,7,11,61
"2011","Scarborough 014D","E01027830","Total",736,186,97,89,550,41,121,109,123,29,41,86
"2011","Scarborough 014E","E01027833","Total",747,232,136,96,515,20,174,53,147,9,31,81
"2011","Scarborough 014F","E01027834","Total",738,227,154,73,511,29,181,62,128,12,22,77
"2011","Scarborough 014G","E01027835","Total",752,199,96,103,553,22,162,64,157,15,47,86
"2011","Selby 001A","E01027918","Total",648,215,97,118,433,16,70,96,127,27,28,69
"2011","Selby 001B","E01027919","Total",509,176,64,112,333,10,61,67,94,10,28,63
"2011","Selby 001C","E01027920","Total",500,116,58,58,384,14,69,71,113,4,23,90
"2011","Selby 001D","E01027921","Total",859,339,199,140,520,20,155,91,139,7,18,90
"2011","Selby 001E","E01027922","Total",668,132,81,51,536,11,129,104,128,26,29,109
"2011","Selby 002A","E01027875","Total",712,114,63,51,598,10,146,113,147,35,48,99
"2011","Selby 002B","E01027886","Total",559,137,56,81,422,14,87,110,124,6,25,56
"2011","Selby 002C","E01027887","Total",663,157,48,109,506,15,92,98,182,16,28,75
"2011","Selby 002D","E01027888","Total",702,144,41,103,558,12,95,161,168,14,30,78
"2011","Selby 002E","E01027904","Total",890,173,69,104,717,23,110,171,208,41,46,118
"2011","Selby 003A","E01027876","Total",653,125,54,71,528,25,96,112,155,20,34,86
"2011","Selby 003B","E01027877","Total",511,120,52,68,391,13,75,72,124,17,16,74
"2011","Selby 003C","E01027900","Total",757,133,69,64,624,37,83,148,206,20,35,95
"2011","Selby 003D","E01027901","Total",636,124,56,68,512,13,110,101,167,20,19,82
"2011","Selby 003E","E01027902","Total",587,122,64,58,465,28,103,81,131,18,36,68
"2011","Selby 003F","E01027903","Total",416,89,50,39,327,6,82,77,76,15,20,51
"2011","Selby 004A","E01027898","Total",1003,255,134,121,748,30,116,172,246,22,40,122
"2011","Selby 004B","E01027914","Total",669,132,63,69,537,16,107,86,158,16,42,112
"2011","Selby 004C","E01027915","Total",710,227,115,112,483,19,94,87,148,23,30,82
"2011","Selby 004D","E01027916","Total",653,198,86,112,455,37,69,77,136,17,34,85
"2011","Selby 004E","E01027917","Total",699,121,41,80,578,32,64,155,160,17,32,118
"2011","Selby 005A","E01027878","Total",548,158,56,102,390,43,40,100,107,7,24,69
"2011","Selby 005B","E01027905","Total",868,319,92,227,549,45,72,100,190,15,20,107
"2011","Selby 005C","E01027907","Total",563,168,70,98,395,58,61,70,82,21,33,70
"2011","Selby 005D","E01027908","Total",779,333,139,194,446,44,59,82,151,13,27,70
"2011","Selby 005E","E01027909","Total",952,346,116,230,606,61,63,121,222,12,36,91
"2011","Selby 005F","E01027910","Total",1099,273,114,159,826,93,77,193,246,38,62,117
"2011","Selby 006A","E01027881","Total",593,188,126,62,405,19,115,64,109,15,19,64
"2011","Selby 006B","E01027906","Total",575,152,59,93,423,34,56,89,121,14,38,71
"2011","Selby 006C","E01027911","Total",619,194,112,82,425,11,127,60,122,14,25,66
"2011","Selby 006D","E01027912","Total",428,101,67,34,327,4,74,61,90,8,26,64
"2011","Selby 006E","E01027913","Total",490,105,71,34,385,12,110,73,81,11,24,74
"2011","Selby 007A","E01027879","Total",566,137,60,77,429,14,85,86,125,10,29,80
"2011","Selby 007B","E01027880","Total",626,99,61,38,527,13,148,96,128,10,36,96
"2011","Selby 007C","E01027882","Total",699,105,48,57,594,17,93,134,191,18,50,91
"2011","Selby 007D","E01027894","Total",773,163,72,91,610,23,125,111,186,23,45,97
"2011","Selby 007E","E01027895","Total",675,148,82,66,527,16,153,74,158,15,24,87
"2011","Selby 008A","E01027883","Total",446,93,49,44,353,17,71,51,101,9,32,72
"2011","Selby 008B","E01027884","Total",627,138,58,80,489,29,74,105,134,18,37,92
"2011","Selby 008C","E01027885","Total",655,164,83,81,491,20,111,103,128,15,27,87
"2011","Selby 008D","E01027896","Total",802,178,87,91,624,33,98,145,187,13,44,104
"2011","Selby 008E","E01027897","Total",840,156,79,77,684,13,139,141,212,21,47,111
"2011","Selby 009A","E01027891","Total",746,207,89,118,539,24,119,66,182,20,27,101
"2011","Selby 009B","E01027892","Total",836,273,93,180,563,39,109,104,171,17,32,91
"2011","Selby 009C","E01027893","Total",764,155,75,80,609,14,134,124,199,22,30,86
"2011","Selby 009D","E01027899","Total",683,130,66,64,553,35,109,137,143,24,28,77
"2011","Selby 010A","E01027889","Total",718,171,78,93,547,43,96,110,156,18,30,94
"2011","Selby 010B","E01027890","Total",807,161,79,82,646,17,137,123,197,19,44,109
"2011","Selby 010C","E01027923","Total",944,226,116,110,718,28,162,139,190,21,43,135
"2011","Selby 010D","E01027924","Total",834,143,56,87,691,27,104,140,241,25,50,104
"2011","Barnsley 001A","E01007434","Total",837,270,99,171,567,53,79,136,155,20,33,91
"2011","Barnsley 001B","E01007435","Total",723,278,138,140,445,30,82,71,122,32,31,77
"2011","Barnsley 001C","E01007438","Total",629,160,94,66,469,33,102,98,101,5,33,97
"2011","Barnsley 001D","E01007439","Total",507,106,53,53,401,15,84,69,109,9,23,92
"2011","Barnsley 002A","E01007433","Total",678,176,77,99,502,53,99,96,108,11,35,100
"2011","Barnsley 002B","E01007436","Total",568,161,79,82,407,30,99,57,113,21,19,68
"2011","Barnsley 002C","E01007437","Total",626,176,59,117,450,41,59,88,129,12,35,86
"2011","Barnsley 002D","E01007440","Total",665,216,83,133,449,50,61,86,132,21,27,72
"2011","Barnsley 003A","E01007329","Total",637,161,74,87,476,35,82,110,119,26,33,71
"2011","Barnsley 003B","E01007331","Total",823,223,90,133,600,41,130,105,191,15,30,88
"2011","Barnsley 003C","E01007342","Total",563,104,44,60,459,46,103,63,121,8,36,82
"2011","Barnsley 003D","E01007343","Total",650,247,152,95,403,32,86,64,113,8,28,72
"2011","Barnsley 004A","E01007356","Total",602,146,79,67,456,22,124,71,123,9,31,76
"2011","Barnsley 004B","E01007357","Total",598,177,84,93,421,38,72,84,126,10,29,62
"2011","Barnsley 004C","E01007361","Total",698,195,57,138,503,44,60,123,167,8,20,81
"2011","Barnsley 004D","E01007362","Total",691,166,76,90,525,14,110,114,156,12,33,86
"2011","Barnsley 004E","E01007363","Total",769,288,145,143,481,43,116,79,135,9,23,76
"2011","Barnsley 005A","E01007355","Total",594,110,46,64,484,26,73,127,133,18,39,68
"2011","Barnsley 005B","E01007358","Total",643,160,64,96,483,39,82,107,155,11,29,60
"2011","Barnsley 005C","E01007359","Total",660,199,90,109,461,36,94,97,120,16,33,65
"2011","Barnsley 005D","E01007360","Total",659,169,97,72,490,25,128,73,125,12,40,87
"2011","Barnsley 005E","E01007386","Total",769,202,108,94,567,21,162,107,156,8,27,86
"2011","Barnsley 006A","E01007328","Total",801,247,103,144,554,67,77,103,141,17,58,91
"2011","Barnsley 006B","E01007330","Total",725,177,81,96,548,37,108,99,164,12,37,91
"2011","Barnsley 006C","E01007332","Total",979,288,119,169,691,85,88,134,242,27,37,78
"2011","Barnsley 006D","E01007333","Total",494,92,38,54,402,60,60,66,80,22,36,78
"2011","Barnsley 007A","E01007323","Total",614,167,48,119,447,58,47,103,122,17,31,69
"2011","Barnsley 007B","E01007324","Total",747,249,121,128,498,62,78,85,133,13,36,91
"2011","Barnsley 007C","E01007325","Total",613,113,41,72,500,105,46,90,96,38,41,84
"2011","Barnsley 007D","E01007326","Total",651,206,111,95,445,38,71,74,116,16,45,85
"2011","Barnsley 007E","E01007327","Total",804,299,169,130,505,38,126,65,146,14,33,83
"2011","Barnsley 007F","E01007411","Total",489,162,59,103,327,51,37,53,75,19,36,56
"2011","Barnsley 008A","E01007341","Total",513,149,54,95,364,51,54,58,86,15,40,60
"2011","Barnsley 008B","E01007345","Total",675,189,68,121,486,62,63,100,139,14,29,79
"2011","Barnsley 008C","E01007346","Total",664,173,71,102,491,60,66,101,120,11,42,91
"2011","Barnsley 008D","E01007347","Total",666,182,75,107,484,29,81,114,127,14,39,80
"2011","Barnsley 009A","E01007334","Total",554,101,35,66,453,19,83,81,138,5,31,96
"2011","Barnsley 009B","E01007335","Total",603,143,74,69,460,21,80,90,132,15,24,98
"2011","Barnsley 009C","E01007400","Total",848,200,106,94,648,33,118,142,198,25,34,98
"2011","Barnsley 009D","E01007404","Total",606,169,106,63,437,17,120,45,151,6,22,76
"2011","Barnsley 009E","E01007406","Total",837,345,150,195,492,55,111,76,129,17,33,71
"2011","Barnsley 010C","E01007408","Total",637,183,86,97,454,30,96,95,110,15,41,67
"2011","Barnsley 010D","E01007409","Total",624,198,87,111,426,19,73,94,114,7,32,87
"2011","Barnsley 010E","E01007410","Total",854,373,118,255,481,51,101,75,155,8,24,67
"2011","Barnsley 010G","E01032550","Total",1177,334,121,213,843,87,105,185,224,31,75,136
"2011","Barnsley 010H","E01032551","Total",1084,290,117,173,794,46,140,172,230,35,56,115
"2011","Barnsley 011A","E01007344","Total",889,240,81,159,649,58,91,146,182,28,45,99
"2011","Barnsley 011B","E01007402","Total",657,161,70,91,496,59,68,101,121,30,50,67
"2011","Barnsley 011C","E01007403","Total",613,160,84,76,453,54,60,77,116,24,35,87
"2011","Barnsley 011D","E01007405","Total",590,154,83,71,436,24,117,45,130,14,25,81
"2011","Barnsley 012A","E01007379","Total",695,164,86,78,531,25,134,77,170,12,40,73
"2011","Barnsley 012B","E01007380","Total",737,163,85,78,574,20,109,127,169,14,37,98
"2011","Barnsley 012C","E01007381","Total",661,187,107,80,474,24,101,88,119,10,38,94
"2011","Barnsley 012D","E01007387","Total",619,158,78,80,461,23,78,96,147,20,30,67
"2011","Barnsley 012E","E01007442","Total",642,183,126,57,459,9,167,61,123,5,28,66
"2011","Barnsley 012F","E01007444","Total",768,305,147,158,463,30,125,78,140,7,17,66
"2011","Barnsley 012G","E01007446","Total",642,221,122,99,421,21,140,64,117,12,15,52
"2011","Barnsley 013A","E01007336","Total",764,306,79,227,458,53,67,82,149,5,20,82
"2011","Barnsley 013B","E01007340","Total",744,266,61,205,478,59,35,94,162,15,33,80
"2011","Barnsley 013C","E01007415","Total",634,167,74,93,467,24,86,91,146,17,34,69
"2011","Barnsley 013D","E01007417","Total",734,255,83,172,479,82,51,91,161,9,17,68
"2011","Barnsley 013E","E01007441","Total",737,260,73,187,477,65,49,104,167,4,24,64
"2011","Barnsley 013F","E01007443","Total",1005,429,79,350,576,76,51,105,229,15,28,72
"2011","Barnsley 013G","E01007445","Total",731,303,100,203,428,39,69,83,155,10,18,54
"2011","Barnsley 014A","E01007372","Total",540,178,105,73,362,59,51,56,84,26,31,55
"2011","Barnsley 014B","E01007373","Total",675,202,72,130,473,71,73,77,110,21,42,79
"2011","Barnsley 014C","E01007374","Total",657,168,89,79,489,40,135,80,115,7,24,88
"2011","Barnsley 014D","E01007375","Total",685,185,101,84,500,26,101,85,140,12,38,98
"2011","Barnsley 014E","E01007377","Total",443,122,48,74,321,41,37,63,74,13,31,62
"2011","Barnsley 014F","E01007378","Total",750,325,152,173,425,68,62,66,101,25,25,78
"2011","Barnsley 015A","E01007319","Total",613,128,73,55,485,14,130,90,120,9,36,86
"2011","Barnsley 015B","E01007321","Total",655,182,109,73,473,14,141,76,127,5,24,86
"2011","Barnsley 015C","E01007322","Total",905,284,82,202,621,69,55,131,226,18,37,85
"2011","Barnsley 015D","E01007337","Total",870,334,60,274,536,58,53,127,204,10,21,63
"2011","Barnsley 016A","E01007418","Total",602,190,115,75,412,17,132,66,109,8,22,58
"2011","Barnsley 016B","E01007419","Total",714,155,83,72,559,23,130,133,155,16,24,78
"2011","Barnsley 016C","E01007420","Total",618,149,98,51,469,19,113,100,125,5,24,83
"2011","Barnsley 016D","E01007425","Total",632,140,78,62,492,9,141,92,132,13,19,86
"2011","Barnsley 017A","E01007338","Total",916,526,275,251,390,37,116,54,111,7,15,50
"2011","Barnsley 017B","E01007339","Total",728,298,72,226,430,56,50,87,147,12,25,53
"2011","Barnsley 017C","E01007413","Total",605,215,74,141,390,76,49,77,93,21,26,48
"2011","Barnsley 017D","E01007414","Total",706,227,83,144,479,68,54,96,153,15,26,67
"2011","Barnsley 018A","E01007317","Total",653,198,86,112,455,46,85,77,123,17,37,70
"2011","Barnsley 018B","E01007318","Total",644,177,72,105,467,67,58,95,137,21,35,54
"2011","Barnsley 018C","E01007320","Total",673,186,70,116,487,70,69,88,123,20,33,84
"2011","Barnsley 018D","E01007416","Total",517,157,68,89,360,41,60,62,97,16,31,53
"2011","Barnsley 019A","E01007382","Total",689,235,99,136,454,35,110,85,113,12,30,69
"2011","Barnsley 019B","E01007383","Total",513,84,21,63,429,18,37,116,123,9,40,86
"2011","Barnsley 019C","E01007384","Total",703,175,102,73,528,25,117,97,168,8,30,83
"2011","Barnsley 019D","E01007385","Total",668,267,134,133,401,27,109,67,101,7,33,57
"2011","Barnsley 020A","E01007348","Total",613,185,121,64,428,40,103,58,100,16,30,81
"2011","Barnsley 020B","E01007349","Total",668,208,96,112,460,43,98,90,119,12,38,60
"2011","Barnsley 020C","E01007350","Total",523,114,71,43,409,14,145,37,109,10,24,70
"2011","Barnsley 020D","E01007351","Total",643,188,77,111,455,36,99,91,137,13,25,54
"2011","Barnsley 020E","E01007352","Total",623,191,103,88,432,56,68,70,120,14,27,77
"2011","Barnsley 020F","E01007353","Total",657,153,47,106,504,53,79,100,134,21,28,89
"2011","Barnsley 020G","E01007354","Total",697,177,58,119,520,41,83,106,155,13,33,89
"2011","Barnsley 021A","E01007458","Total",619,176,51,125,443,29,67,77,145,14,37,74
"2011","Barnsley 021B","E01007459","Total",733,215,137,78,518,24,182,54,151,4,19,84
"2011","Barnsley 021C","E01007460","Total",612,160,81,79,452,23,110,58,127,14,41,79
"2011","Barnsley 021D","E01007461","Total",776,303,121,182,473,64,77,83,123,14,37,75
"2011","Barnsley 021E","E01007462","Total",658,193,84,109,465,56,73,88,110,21,44,73
"2011","Barnsley 021F","E01007463","Total",782,257,120,137,525,84,105,94,115,13,42,72
"2011","Barnsley 022A","E01007369","Total",687,229,55,174,458,60,68,81,156,25,15,53
"2011","Barnsley 022B","E01007370","Total",605,177,79,98,428,54,63,75,109,12,31,84
"2011","Barnsley 022C","E01007371","Total",817,204,65,139,613,60,102,126,161,19,52,93
"2011","Barnsley 022D","E01007376","Total",639,232,92,140,407,43,46,76,137,18,25,62
"2011","Barnsley 023A","E01007447","Total",657,197,124,73,460,38,93,89,112,16,40,72
"2011","Barnsley 023B","E01007448","Total",773,286,61,225,487,67,58,94,162,15,17,74
"2011","Barnsley 023C","E01007449","Total",815,236,75,161,579,53,93,103,208,15,22,85
"2011","Barnsley 023D","E01007450","Total",709,263,123,140,446,34,101,67,120,14,29,81
"2011","Barnsley 024A","E01007427","Total",671,172,67,105,499,20,104,112,159,16,26,62
"2011","Barnsley 024B","E01007428","Total",654,201,100,101,453,28,81,90,148,11,24,71
"2011","Barnsley 024C","E01007429","Total",726,310,211,99,416,27,96,57,139,8,29,60
"2011","Barnsley 024D","E01007430","Total",896,170,56,114,726,48,62,211,252,21,46,86
"2011","Barnsley 024E","E01007431","Total",543,100,47,53,443,21,84,87,123,7,30,91
"2011","Barnsley 024F","E01007432","Total",577,128,61,67,449,21,82,99,115,15,30,87
"2011","Barnsley 025A","E01007364","Total",593,176,93,83,417,38,76,74,102,12,40,75
"2011","Barnsley 025B","E01007365","Total",514,156,73,83,358,37,55,73,90,12,33,58
"2011","Barnsley 025C","E01007366","Total",847,193,71,122,654,38,99,148,212,18,30,109
"2011","Barnsley 025D","E01007367","Total",473,115,58,57,358,40,43,59,102,13,31,70
"2011","Barnsley 025E","E01007368","Total",698,213,80,133,485,46,57,103,151,22,35,71
"2011","Barnsley 026A","E01007451","Total",728,219,99,120,509,49,73,111,144,15,34,83
"2011","Barnsley 026B","E01007452","Total",634,132,54,78,502,40,70,120,154,16,26,76
"2011","Barnsley 026C","E01007453","Total",646,204,119,85,442,58,68,67,100,24,46,79
"2011","Barnsley 026E","E01007455","Total",587,122,58,64,465,14,131,60,136,10,30,84
"2011","Barnsley 026F","E01032924","Total",602,131,29,102,471,26,27,146,172,16,39,45
"2011","Barnsley 026G","E01032925","Total",603,197,112,85,406,43,75,99,107,8,27,47
"2011","Barnsley 027A","E01007421","Total",563,119,51,68,444,4,115,73,140,6,24,82
"2011","Barnsley 027B","E01007422","Total",635,144,69,75,491,22,94,103,137,20,46,69
"2011","Barnsley 027C","E01007423","Total",705,175,95,80,530,27,130,93,144,14,41,81
"2011","Barnsley 027D","E01007426","Total",692,200,94,106,492,24,104,85,160,15,31,73
"2011","Barnsley 028A","E01007396","Total",740,262,119,143,478,44,77,97,148,14,31,67
"2011","Barnsley 028B","E01007397","Total",677,237,142,95,440,33,113,78,114,12,24,66
"2011","Barnsley 028C","E01007398","Total",769,225,136,89,544,24,200,86,134,6,17,77
"2011","Barnsley 028D","E01007399","Total",895,260,100,160,635,49,99,155,185,14,39,94
"2011","Barnsley 028E","E01007424","Total",726,194,100,94,532,26,99,131,165,8,26,77
"2011","Barnsley 029A","E01007388","Total",694,180,49,131,514,30,67,118,172,19,16,92
"2011","Barnsley 029B","E01007393","Total",811,274,113,161,537,53,77,110,155,22,34,86
"2011","Barnsley 029C","E01007394","Total",565,151,84,67,414,39,75,63,94,20,34,89
"2011","Barnsley 029D","E01007456","Total",766,194,66,128,572,40,102,137,183,12,18,80
"2011","Barnsley 029E","E01007457","Total",689,172,67,105,517,42,85,116,151,23,38,62
"2011","Barnsley 030A","E01007389","Total",666,179,103,76,487,14,170,56,143,3,19,82
"2011","Barnsley 030B","E01007390","Total",646,147,71,76,499,34,100,100,144,8,27,86
"2011","Barnsley 030C","E01007391","Total",684,247,143,104,437,52,82,72,116,13,23,79
"2011","Barnsley 030D","E01007392","Total",609,167,83,84,442,37,59,80,115,26,44,81
"2011","Barnsley 030E","E01007395","Total",820,236,119,117,584,66,96,105,132,37,51,97
"2011","Doncaster 001A","E01007632","Total",615,131,51,80,484,40,59,103,123,22,51,86
"2011","Doncaster 001B","E01007633","Total",514,120,43,77,394,40,51,82,93,31,33,64
"2011","Doncaster 001C","E01007634","Total",653,162,76,86,491,49,79,102,124,35,32,70
"2011","Doncaster 001D","E01007635","Total",618,145,65,80,473,32,130,66,144,18,23,60
"2011","Doncaster 002A","E01007487","Total",691,189,103,86,502,41,121,85,122,15,32,86
"2011","Doncaster 002B","E01007488","Total",726,182,76,106,544,25,128,78,152,20,37,104
"2011","Doncaster 002C","E01007489","Total",722,192,73,119,530,47,90,98,157,20,29,89
"2011","Doncaster 002D","E01007490","Total",631,155,74,81,476,25,104,70,125,21,36,95
"2011","Doncaster 002E","E01007491","Total",661,158,49,109,503,82,68,87,95,33,51,87
"2011","Doncaster 002F","E01007492","Total",664,247,130,117,417,39,95,50,95,19,52,67
"2011","Doncaster 002G","E01007493","Total",715,168,71,97,547,21,110,126,146,19,34,91
"2011","Doncaster 003A","E01007636","Total",654,198,94,104,456,53,92,86,99,18,32,76
"2011","Doncaster 003B","E01007637","Total",655,172,89,83,483,58,121,74,120,16,23,71
"2011","Doncaster 003C","E01007638","Total",706,214,100,114,492,53,120,68,122,15,35,79
"2011","Doncaster 003D","E01007639","Total",899,365,119,246,534,40,105,97,172,9,26,85
"2011","Doncaster 003E","E01007640","Total",725,175,97,78,550,18,148,91,181,7,20,85
"2011","Doncaster 003F","E01007641","Total",588,130,61,69,458,26,71,100,127,18,31,85
"2011","Doncaster 003G","E01007642","Total",649,177,88,89,472,44,74,81,122,35,45,71
"2011","Doncaster 004A","E01007625","Total",620,128,69,59,492,22,112,97,122,13,42,84
"2011","Doncaster 004B","E01007626","Total",546,203,66,137,343,32,70,36,99,12,41,53
"2011","Doncaster 004C","E01007627","Total",701,215,115,100,486,57,96,98,95,17,38,85
"2011","Doncaster 004D","E01007628","Total",541,126,46,80,415,48,48,79,103,20,42,75
"2011","Doncaster 004E","E01007629","Total",663,201,96,105,462,64,72,84,108,26,36,72
"2011","Doncaster 005A","E01007468","Total",607,149,96,53,458,11,170,50,134,6,16,71
"2011","Doncaster 005B","E01007469","Total",543,134,43,91,409,31,73,92,108,16,27,62
"2011","Doncaster 005C","E01007470","Total",553,130,48,82,423,46,49,96,101,24,31,76
"2011","Doncaster 005D","E01007472","Total",654,212,93,119,442,49,65,72,99,32,41,84
"2011","Doncaster 005E","E01007473","Total",616,171,49,122,445,63,52,87,112,18,28,85
"2011","Doncaster 005F","E01007474","Total",649,257,159,98,392,58,102,48,102,17,16,49
"2011","Doncaster 006A","E01007554","Total",676,170,57,113,506,25,86,117,155,12,32,79
"2011","Doncaster 006B","E01007555","Total",626,189,109,80,437,44,109,68,97,17,36,66
"2011","Doncaster 006C","E01007556","Total",533,123,51,72,410,49,45,94,89,16,28,89
"2011","Doncaster 006D","E01007561","Total",556,99,43,56,457,17,111,98,111,13,33,74
"2011","Doncaster 006E","E01007562","Total",610,187,68,119,423,29,83,73,128,16,26,68
"2011","Doncaster 006F","E01007563","Total",525,112,32,80,413,54,49,89,87,33,37,64
"2011","Doncaster 007A","E01007621","Total",539,116,36,80,423,20,55,108,106,17,36,81
"2011","Doncaster 007B","E01007622","Total",666,183,75,108,483,22,108,83,137,17,26,90
"2011","Doncaster 007C","E01007623","Total",585,218,90,128,367,30,86,80,97,11,9,54
"2011","Doncaster 007D","E01007624","Total",750,175,61,114,575,34,84,152,163,24,41,77
"2011","Doncaster 007E","E01007630","Total",652,211,139,72,441,26,159,52,110,9,27,58
"2011","Doncaster 007F","E01007631","Total",534,125,78,47,409,9,120,81,120,8,22,49
"2011","Doncaster 008A","E01007553","Total",715,190,88,102,525,21,118,89,157,9,37,94
"2011","Doncaster 008B","E01007557","Total",419,105,41,64,314,15,74,56,88,15,20,46
"2011","Doncaster 008C","E01007558","Total",622,155,80,75,467,26,97,92,129,11,32,80
"2011","Doncaster 008D","E01007559","Total",405,91,52,39,314,11,95,37,80,7,20,64
"2011","Doncaster 008E","E01007560","Total",644,151,79,72,493,28,143,70,121,8,34,89
"2011","Doncaster 009A","E01007464","Total",600,154,59,95,446,52,51,81,121,19,44,78
"2011","Doncaster 009B","E01007465","Total",629,183,104,79,446,45,80,74,109,22,29,87
"2011","Doncaster 009C","E01007466","Total",640,121,42,79,519,79,56,114,114,41,46,69
"2011","Doncaster 009D","E01007467","Total",645,196,95,101,449,42,68,76,123,25,27,88
"2011","Doncaster 009E","E01007471","Total",591,122,41,81,469,15,76,104,123,9,37,105
"2011","Doncaster 009F","E01007504","Total",622,164,84,80,458,31,67,76,125,21,43,95
"2011","Doncaster 009G","E01007507","Total",496,116,36,80,380,48,26,77,80,33,43,73
"2011","Doncaster 010A","E01007506","Total",545,150,51,99,395,42,58,69,80,20,54,72
"2011","Doncaster 010B","E01007508","Total",695,216,70,146,479,81,47,103,97,29,36,86
"2011","Doncaster 010C","E01007509","Total",814,298,144,154,516,78,83,81,151,27,23,73
"2011","Doncaster 010D","E01007510","Total",734,281,139,142,453,54,68,95,128,4,33,71
"2011","Doncaster 010E","E01007511","Total",609,148,62,86,461,47,75,87,104,26,48,74
"2011","Doncaster 011A","E01007475","Total",627,130,50,80,497,26,67,118,155,15,28,88
"2011","Doncaster 011B","E01007476","Total",643,223,146,77,420,24,97,84,91,12,29,83
"2011","Doncaster 011C","E01007477","Total",598,151,81,70,447,19,119,70,105,16,34,84
"2011","Doncaster 011D","E01007478","Total",653,179,87,92,474,25,86,79,143,17,27,97
"2011","Doncaster 012A","E01007512","Total",717,184,101,83,533,39,84,107,177,20,32,74
"2011","Doncaster 012B","E01007513","Total",641,220,136,84,421,39,95,69,103,15,36,64
"2011","Doncaster 012C","E01007515","Total",661,197,108,89,464,42,79,73,118,23,37,92
"2011","Doncaster 012D","E01007518","Total",603,158,79,79,445,20,87,77,102,16,48,95
"2011","Doncaster 012E","E01007519","Total",527,146,57,89,381,30,42,73,101,13,43,79
"2011","Doncaster 013A","E01007505","Total",721,189,100,89,532,29,106,92,166,8,30,101
"2011","Doncaster 013B","E01007514","Total",664,230,53,177,434,51,43,90,134,13,19,84
"2011","Doncaster 013C","E01007516","Total",570,154,88,66,416,28,75,65,122,11,40,75
"2011","Doncaster 013D","E01007517","Total",701,237,66,171,464,73,49,95,128,13,30,76
"2011","Doncaster 014A","E01007479","Total",674,172,93,79,502,40,119,90,121,21,35,76
"2011","Doncaster 014B","E01007480","Total",549,112,48,64,437,45,48,84,104,13,57,86
"2011","Doncaster 014D","E01007482","Total",641,253,146,107,388,26,90,67,109,15,25,56
"2011","Doncaster 014E","E01033259","Total",655,169,30,139,486,40,43,142,163,11,25,62
"2011","Doncaster 014F","E01033260","Total",632,148,42,106,484,47,28,131,141,19,45,73
"2011","Doncaster 015A","E01007570","Total",645,186,114,72,459,16,115,71,127,16,30,84
"2011","Doncaster 015B","E01007650","Total",826,335,182,153,491,14,119,86,157,9,27,79
"2011","Doncaster 015C","E01007651","Total",676,138,48,90,538,78,55,110,114,43,40,98
"2011","Doncaster 015D","E01007652","Total",770,263,116,147,507,55,71,91,110,25,60,95
"2011","Doncaster 015E","E01007653","Total",638,158,66,92,480,38,62,104,126,13,30,107
"2011","Doncaster 015F","E01007656","Total",638,177,100,77,461,43,89,72,108,28,48,73
"2011","Doncaster 016A","E01007581","Total",626,121,53,68,505,19,111,111,120,10,40,94
"2011","Doncaster 016B","E01007582","Total",615,146,62,84,469,31,84,103,136,11,23,81
"2011","Doncaster 016C","E01007588","Total",669,137,82,55,532,36,111,115,125,22,48,75
"2011","Doncaster 016D","E01007589","Total",715,186,121,65,529,14,146,98,109,19,39,104
"2011","Doncaster 017A","E01007483","Total",610,162,63,99,448,18,88,77,147,9,34,75
"2011","Doncaster 017B","E01007484","Total",626,208,110,98,418,22,95,66,115,12,30,78
"2011","Doncaster 017C","E01007485","Total",592,137,51,86,455,22,62,113,144,14,26,74
"2011","Doncaster 017D","E01007486","Total",635,188,120,68,447,12,149,49,143,5,15,74
"2011","Doncaster 018A","E01007564","Total",605,170,84,86,435,50,66,91,88,32,34,74
"2011","Doncaster 018B","E01007565","Total",641,177,104,73,464,9,93,106,134,20,39,63
"2011","Doncaster 018C","E01007566","Total",780,316,134,182,464,49,84,79,135,12,38,67
"2011","Doncaster 018D","E01007567","Total",516,123,71,52,393,31,54,72,110,16,37,73
"2011","Doncaster 018E","E01007568","Total",595,133,47,86,462,77,38,89,97,37,62,62
"2011","Doncaster 018F","E01007569","Total",627,168,89,79,459,38,64,89,107,26,42,93
"2011","Doncaster 019A","E01007644","Total",587,145,71,74,442,22,67,93,114,13,38,95
"2011","Doncaster 019B","E01007646","Total",607,218,60,158,389,22,62,55,130,8,28,84
"2011","Doncaster 019C","E01007647","Total",692,277,117,160,415,17,61,71,141,12,30,83
"2011","Doncaster 019D","E01007648","Total",854,370,79,291,484,43,38,64,180,19,37,103
"2011","Doncaster 019E","E01007649","Total",616,152,57,95,464,26,61,91,135,17,39,95
"2011","Doncaster 019F","E01007654","Total",609,182,44,138,427,37,57,75,115,16,41,86
"2011","Doncaster 020A","E01007583","Total",632,154,74,80,478,13,136,69,136,9,32,83
"2011","Doncaster 020B","E01007586","Total",654,169,97,72,485,17,110,84,144,3,33,94
"2011","Doncaster 020C","E01007587","Total",728,226,126,100,502,19,151,62,151,10,24,85
"2011","Doncaster 020D","E01007620","Total",701,156,82,74,545,16,135,88,178,3,28,97
"2011","Doncaster 021A","E01007584","Total",671,187,83,104,484,29,103,100,140,16,30,66
"2011","Doncaster 021B","E01007585","Total",630,145,65,80,485,33,96,105,105,15,46,85
"2011","Doncaster 021C","E01007617","Total",643,138,94,44,505,22,156,96,121,7,26,77
"2011","Doncaster 021D","E01007618","Total",505,98,61,37,407,20,96,60,111,9,33,78
"2011","Doncaster 021E","E01007619","Total",716,135,72,63,581,20,132,139,135,19,45,91
"2011","Doncaster 022A","E01007529","Total",654,221,32,189,433,68,31,87,146,17,24,60
"2011","Doncaster 022B","E01007530","Total",512,183,53,130,329,40,27,75,87,14,31,55
"2011","Doncaster 022C","E01007531","Total",792,332,149,183,460,51,77,87,138,13,34,60
"2011","Doncaster 022D","E01007643","Total",662,194,86,108,468,60,48,93,109,36,34,88
"2011","Doncaster 022E","E01007645","Total",830,293,71,222,537,48,34,83,169,31,56,116
"2011","Doncaster 022F","E01007655","Total",868,331,57,274,537,64,43,97,200,8,35,90
"2011","Doncaster 023A","E01007494","Total",675,200,64,136,475,46,52,95,167,11,26,78
"2011","Doncaster 023B","E01007532","Total",1017,610,177,433,407,51,57,89,126,14,24,46
"2011","Doncaster 023C","E01007533","Total",623,214,99,115,409,24,73,75,114,13,40,70
"2011","Doncaster 023D","E01007535","Total",638,176,67,109,462,62,52,82,136,19,34,77
"2011","Doncaster 024A","E01007522","Total",755,339,180,159,416,38,90,66,118,18,25,61
"2011","Doncaster 024B","E01007525","Total",671,222,147,75,449,40,95,71,102,24,30,87
"2011","Doncaster 024C","E01007528","Total",634,219,146,73,415,42,105,82,93,14,31,48
"2011","Doncaster 024D","E01007604","Total",574,117,64,53,457,17,112,70,116,14,25,103
"2011","Doncaster 025A","E01007521","Total",599,144,79,65,455,18,114,76,111,18,35,83
"2011","Doncaster 025B","E01007523","Total",661,221,118,103,440,9,106,73,109,13,33,97
"2011","Doncaster 025C","E01007524","Total",720,217,108,109,503,11,155,72,140,12,31,82
"2011","Doncaster 025D","E01007526","Total",667,161,95,66,506,15,132,84,131,15,37,92
"2011","Doncaster 025E","E01007607","Total",607,172,78,94,435,49,89,70,105,13,26,83
"2011","Doncaster 026A","E01007599","Total",715,133,69,64,582,25,131,120,162,14,37,93
"2011","Doncaster 026B","E01007600","Total",604,128,67,61,476,14,119,79,139,10,23,92
"2011","Doncaster 026C","E01007601","Total",610,164,102,62,446,14,146,68,106,13,28,71
"2011","Doncaster 026D","E01007602","Total",614,140,68,72,474,20,109,72,135,18,34,86
"2011","Doncaster 026E","E01007603","Total",603,123,64,59,480,25,106,92,139,7,36,75
"2011","Doncaster 027A","E01007520","Total",605,155,110,45,450,8,142,63,110,16,34,77
"2011","Doncaster 027B","E01007527","Total",1015,290,50,240,725,35,93,154,274,24,35,110
"2011","Doncaster 027C","E01007605","Total",633,147,102,45,486,15,136,69,120,18,39,89
"2011","Doncaster 027D","E01007606","Total",607,120,73,47,487,7,127,69,130,22,43,89
"2011","Doncaster 028A","E01007495","Total",757,207,65,142,550,68,56,105,159,29,39,94
"2011","Doncaster 028B","E01007500","Total",577,192,123,69,385,53,77,70,81,14,31,59
"2011","Doncaster 028C","E01007502","Total",1080,241,21,220,839,40,46,244,290,30,53,136
"2011","Doncaster 028D","E01007534","Total",916,338,45,293,578,84,42,122,197,22,36,75
"2011","Doncaster 029A","E01007496","Total",606,152,58,94,454,70,31,98,100,30,56,69
"2011","Doncaster 029B","E01007497","Total",542,102,47,55,440,62,71,79,119,17,23,69
"2011","Doncaster 029C","E01007498","Total",657,196,55,141,461,44,59,96,123,20,36,83
"2011","Doncaster 029D","E01007499","Total",655,270,144,126,385,40,67,63,94,29,30,62
"2011","Doncaster 029E","E01007501","Total",643,176,108,68,467,14,154,64,103,11,34,87
"2011","Doncaster 029F","E01007503","Total",683,154,63,91,529,15,93,101,186,21,26,87
"2011","Doncaster 030A","E01007575","Total",627,246,139,107,381,59,66,48,79,29,30,70
"2011","Doncaster 030B","E01007578","Total",685,208,91,117,477,50,74,75,118,27,34,99
"2011","Doncaster 030C","E01007579","Total",691,240,75,165,451,29,63,104,138,13,21,83
"2011","Doncaster 030D","E01007580","Total",620,157,79,78,463,21,128,47,137,11,30,89
"2011","Doncaster 031A","E01007571","Total",690,202,80,122,488,39,57,102,157,8,46,79
"2011","Doncaster 031B","E01007572","Total",574,120,72,48,454,36,95,71,110,11,34,97
"2011","Doncaster 031C","E01007573","Total",667,240,108,132,427,55,63,68,106,26,49,60
"2011","Doncaster 031D","E01007574","Total",638,209,54,155,429,52,51,89,109,22,24,82
"2011","Doncaster 031E","E01007576","Total",646,182,76,106,464,27,62,75,142,14,35,109
"2011","Doncaster 031F","E01007577","Total",711,281,74,207,430,65,58,96,121,13,20,57
"2011","Doncaster 032A","E01007536","Total",890,278,72,206,612,50,91,116,214,17,28,96
"2011","Doncaster 032B","E01007542","Total",787,287,119,168,500,56,79,83,142,29,34,77
"2011","Doncaster 032C","E01007543","Total",687,261,148,113,426,36,91,54,103,11,48,83
"2011","Doncaster 032D","E01007544","Total",750,292,153,139,458,76,85,58,97,29,36,77
"2011","Doncaster 033A","E01007546","Total",619,177,84,93,442,58,77,77,114,11,33,72
"2011","Doncaster 033B","E01007551","Total",725,192,86,106,533,26,135,93,152,16,28,83
"2011","Doncaster 033C","E01007552","Total",603,163,85,78,440,19,106,82,110,14,24,85
"2011","Doncaster 033D","E01007613","Total",673,158,85,73,515,7,148,64,153,14,33,96
"2011","Doncaster 034A","E01007545","Total",616,168,47,121,448,41,47,91,154,14,31,70
"2011","Doncaster 034B","E01007547","Total",607,154,55,99,453,51,51,72,126,29,40,84
"2011","Doncaster 034C","E01007548","Total",425,93,46,47,332,49,53,54,70,28,22,56
"2011","Doncaster 034D","E01007549","Total",653,234,129,105,419,37,84,59,114,21,34,70
"2011","Doncaster 034E","E01007550","Total",696,184,125,59,512,46,105,68,112,11,62,108
"2011","Doncaster 035A","E01007537","Total",706,180,75,105,526,37,84,102,136,28,27,112
"2011","Doncaster 035B","E01007538","Total",590,137,84,53,453,34,64,88,104,21,53,89
"2011","Doncaster 035C","E01007539","Total",545,131,53,78,414,45,55,80,104,20,41,69
"2011","Doncaster 035D","E01007540","Total",639,138,73,65,501,37,74,104,115,22,40,109
"2011","Doncaster 035E","E01007541","Total",646,186,104,82,460,33,108,71,103,11,45,89
"2011","Doncaster 036A","E01007591","Total",607,157,78,79,450,30,96,75,111,13,29,96
"2011","Doncaster 036B","E01007594","Total",825,183,48,135,642,39,72,162,228,22,46,73
"2011","Doncaster 036C","E01007596","Total",499,91,48,43,408,12,91,48,142,15,26,74
"2011","Doncaster 036D","E01007598","Total",665,147,63,84,518,18,106,84,182,8,25,95
"2011","Doncaster 037A","E01007590","Total",476,109,45,64,367,35,45,63,96,13,42,73
"2011","Doncaster 037B","E01007592","Total",641,195,97,98,446,57,73,105,86,29,35,61
"2011","Doncaster 037C","E01007593","Total",508,115,34,81,393,39,54,75,103,23,30,69
"2011","Doncaster 037D","E01007595","Total",633,198,106,92,435,38,92,73,101,15,42,74
"2011","Doncaster 037E","E01007597","Total",683,250,126,124,433,77,50,80,97,31,36,62
"2011","Doncaster 038A","E01007608","Total",623,110,17,93,513,70,15,138,130,29,39,92
"2011","Doncaster 038B","E01007609","Total",1023,322,139,183,701,38,146,136,209,30,52,90
"2011","Doncaster 038C","E01007610","Total",813,243,126,117,570,20,165,111,142,14,19,99
"2011","Doncaster 039A","E01007611","Total",583,171,97,74,412,24,119,49,113,12,29,66
"2011","Doncaster 039B","E01007612","Total",638,181,101,80,457,14,162,68,117,8,20,68
"2011","Doncaster 039C","E01007614","Total",532,118,54,64,414,19,86,85,123,10,18,73
"2011","Doncaster 039D","E01007615","Total",641,252,162,90,389,20,151,60,95,8,12,43
"2011","Doncaster 039E","E01007616","Total",587,182,108,74,405,18,138,69,100,4,16,60
"2011","Rotherham 001A","E01007693","Total",941,293,85,208,648,52,67,172,223,16,38,80
"2011","Rotherham 001B","E01007694","Total",737,222,113,109,515,52,56,97,154,25,43,88
"2011","Rotherham 001C","E01007695","Total",972,215,96,119,757,59,79,226,204,29,42,118
"2011","Rotherham 001D","E01007697","Total",662,228,127,101,434,39,81,79,101,17,40,77
"2011","Rotherham 001E","E01007698","Total",634,170,57,113,464,30,73,87,146,9,30,89
"2011","Rotherham 002A","E01007816","Total",649,147,80,67,502,33,86,114,120,19,45,85
"2011","Rotherham 002B","E01007817","Total",638,211,119,92,427,29,102,69,115,10,35,67
"2011","Rotherham 002C","E01007819","Total",627,167,111,56,460,15,123,81,115,12,27,87
"2011","Rotherham 002D","E01007820","Total",625,167,43,124,458,66,44,95,136,16,31,70
"2011","Rotherham 002E","E01007821","Total",670,218,127,91,452,34,90,94,110,13,31,80
"2011","Rotherham 002F","E01007822","Total",710,243,126,117,467,56,111,75,127,13,33,52
"2011","Rotherham 003A","E01007796","Total",573,244,150,94,329,57,63,57,86,9,19,38
"2011","Rotherham 003B","E01007797","Total",580,147,62,85,433,27,116,90,84,7,29,80
"2011","Rotherham 003C","E01007798","Total",543,121,70,51,422,15,102,69,129,10,21,76
"2011","Rotherham 003D","E01007799","Total",613,180,102,78,433,24,113,76,102,15,36,67
"2011","Rotherham 003E","E01007800","Total",698,268,90,178,430,34,70,87,145,12,15,67
"2011","Rotherham 003F","E01007818","Total",674,161,95,66,513,12,132,93,141,14,36,85
"2011","Rotherham 004A","E01007777","Total",651,163,83,80,488,43,73,96,136,20,34,86
"2011","Rotherham 004B","E01007793","Total",628,216,115,101,412,24,91,69,114,5,35,74
"2011","Rotherham 004C","E01007794","Total",553,117,58,59,436,48,83,81,93,24,38,69
"2011","Rotherham 004D","E01007795","Total",634,139,68,71,495,17,88,76,192,6,21,95
"2011","Rotherham 005A","E01007778","Total",593,105,64,41,488,20,92,91,135,8,44,98
"2011","Rotherham 005B","E01007779","Total",582,214,83,131,368,33,95,61,95,14,16,54
"2011","Rotherham 005C","E01007780","Total",616,166,94,72,450,19,120,63,120,12,34,82
"2011","Rotherham 005D","E01007781","Total",656,209,109,100,447,39,86,89,102,18,35,78
"2011","Rotherham 005E","E01007782","Total",597,155,67,88,442,46,57,73,117,28,44,77
"2011","Rotherham 006A","E01007771","Total",620,145,71,74,475,30,112,82,148,13,25,65
"2011","Rotherham 006B","E01007772","Total",556,151,68,83,405,34,53,82,122,13,27,74
"2011","Rotherham 006C","E01007773","Total",642,207,105,102,435,48,72,100,126,11,19,59
"2011","Rotherham 006D","E01007774","Total",605,136,52,84,469,66,43,106,127,16,33,78
"2011","Rotherham 007A","E01007696","Total",662,194,103,91,468,15,134,93,127,10,15,74
"2011","Rotherham 007B","E01007801","Total",614,121,52,69,493,28,81,93,162,10,25,94
"2011","Rotherham 007C","E01007802","Total",581,155,64,91,426,14,97,70,130,7,22,86
"2011","Rotherham 007D","E01007803","Total",547,132,61,71,415,32,79,69,110,15,34,76
"2011","Rotherham 007E","E01007808","Total",590,116,44,72,474,10,66,81,161,12,26,118
"2011","Rotherham 008A","E01007775","Total",545,160,74,86,385,60,47,71,94,29,24,60
"2011","Rotherham 008B","E01007776","Total",652,199,83,116,453,37,79,75,141,17,37,67
"2011","Rotherham 008C","E01007783","Total",813,340,187,153,473,38,95,92,138,16,23,71
"2011","Rotherham 008D","E01007784","Total",762,274,44,230,488,66,37,114,171,13,27,60
"2011","Rotherham 009A","E01007728","Total",483,129,69,60,354,24,95,51,83,7,19,75
"2011","Rotherham 009B","E01007729","Total",846,412,131,281,434,36,71,71,142,6,27,81
"2011","Rotherham 009C","E01007730","Total",702,301,111,190,401,38,83,60,104,13,26,77
"2011","Rotherham 009D","E01007731","Total",566,194,95,99,372,21,71,55,131,7,20,67
"2011","Rotherham 009E","E01007732","Total",766,385,133,252,381,26,106,51,98,8,24,68
"2011","Rotherham 009F","E01007733","Total",629,233,99,134,396,30,101,69,99,10,28,59
"2011","Rotherham 010A","E01007719","Total",525,157,79,78,368,43,58,65,97,12,36,57
"2011","Rotherham 010B","E01007720","Total",638,185,87,98,453,33,109,76,116,17,31,71
"2011","Rotherham 010C","E01007721","Total",711,235,93,142,476,61,73,92,133,20,16,81
"2011","Rotherham 010D","E01007727","Total",684,252,143,109,432,39,90,58,109,11,42,83
"2011","Rotherham 011A","E01007740","Total",595,154,80,74,441,37,67,85,103,13,39,97
"2011","Rotherham 011B","E01007804","Total",661,256,124,132,405,34,87,68,98,15,36,67
"2011","Rotherham 011C","E01007805","Total",641,249,130,119,392,34,70,78,93,14,42,61
"2011","Rotherham 011D","E01007806","Total",518,141,73,68,377,53,39,80,88,20,39,58
"2011","Rotherham 011E","E01007807","Total",607,164,93,71,443,34,92,79,118,19,39,62
"2011","Rotherham 012A","E01007681","Total",576,140,86,54,436,17,118,66,128,13,17,77
"2011","Rotherham 012B","E01007691","Total",884,189,104,85,695,23,171,142,217,11,29,102
"2011","Rotherham 012C","E01007692","Total",712,235,108,127,477,23,100,111,157,13,12,61
"2011","Rotherham 012E","E01032926","Total",642,123,11,112,519,52,15,196,137,24,36,59
"2011","Rotherham 012F","E01032927","Total",634,190,65,125,444,47,54,103,124,18,37,61
"2011","Rotherham 013A","E01007723","Total",589,190,79,111,399,50,69,61,94,19,41,65
"2011","Rotherham 013B","E01007735","Total",556,153,60,93,403,78,34,75,86,26,34,70
"2011","Rotherham 013C","E01007737","Total",595,170,24,146,425,90,30,77,79,36,45,68
"2011","Rotherham 013D","E01007738","Total",554,122,36,86,432,73,55,68,94,24,45,73
"2011","Rotherham 013E","E01007739","Total",619,200,123,77,419,35,83,56,82,29,58,76
"2011","Rotherham 014A","E01007736","Total",678,267,96,171,411,73,41,72,96,27,50,52
"2011","Rotherham 014B","E01007765","Total",641,188,62,126,453,50,52,85,134,14,37,81
"2011","Rotherham 014C","E01007766","Total",519,98,46,52,421,52,45,63,86,23,54,98
"2011","Rotherham 014D","E01007768","Total",816,396,95,301,420,36,55,71,91,39,73,55
"2011","Rotherham 014E","E01007770","Total",613,134,60,74,479,46,61,62,112,30,66,102
"2011","Rotherham 015A","E01007741","Total",680,180,110,70,500,15,122,81,163,6,29,84
"2011","Rotherham 015B","E01007742","Total",607,167,99,68,440,38,102,78,95,15,29,83
"2011","Rotherham 015C","E01007743","Total",502,79,30,49,423,17,74,78,116,3,35,100
"2011","Rotherham 015D","E01007744","Total",713,250,95,155,463,43,79,77,153,10,32,69
"2011","Rotherham 015E","E01007745","Total",677,218,118,100,459,56,78,84,121,18,35,67
"2011","Rotherham 015F","E01007746","Total",587,103,52,51,484,30,84,92,130,12,39,97
"2011","Rotherham 016A","E01007715","Total",643,184,27,157,459,88,31,95,103,41,54,47
"2011","Rotherham 016B","E01007716","Total",744,294,83,211,450,33,58,59,115,32,81,72
"2011","Rotherham 016C","E01007717","Total",813,270,82,188,543,64,58,120,156,18,45,82
"2011","Rotherham 016D","E01007718","Total",653,237,63,174,416,60,36,91,128,16,29,56
"2011","Rotherham 017A","E01007677","Total",558,223,87,136,335,53,36,47,73,23,43,60
"2011","Rotherham 017B","E01007714","Total",990,529,149,380,461,37,47,58,161,33,52,73
"2011","Rotherham 017C","E01007767","Total",671,260,93,167,411,45,52,62,131,14,45,62
"2011","Rotherham 017D","E01007769","Total",614,175,45,130,439,41,23,99,107,49,62,58
"2011","Rotherham 018A","E01007685","Total",597,121,59,62,476,20,111,97,129,10,26,83
"2011","Rotherham 018B","E01007754","Total",523,107,25,82,416,21,33,104,115,8,50,85
"2011","Rotherham 018C","E01007755","Total",573,116,34,82,457,23,57,94,163,11,24,85
"2011","Rotherham 018D","E01007756","Total",601,135,70,65,466,15,85,97,132,9,28,100
"2011","Rotherham 018E","E01007761","Total",701,210,129,81,491,51,85,86,131,15,37,86
"2011","Rotherham 018F","E01007762","Total",582,152,84,68,430,22,129,75,81,12,30,81
"2011","Rotherham 019A","E01007682","Total",555,107,52,55,448,23,84,85,106,18,35,97
"2011","Rotherham 019B","E01007683","Total",582,123,55,68,459,14,76,72,160,13,27,97
"2011","Rotherham 019C","E01007686","Total",686,243,171,72,443,15,164,60,98,8,19,79
"2011","Rotherham 019D","E01007688","Total",654,177,121,56,477,29,150,75,123,9,22,69
"2011","Rotherham 019E","E01007725","Total",477,89,45,44,388,18,44,90,109,16,27,84
"2011","Rotherham 019F","E01007726","Total",733,287,141,146,446,72,57,87,116,25,28,61
"2011","Rotherham 020A","E01007757","Total",674,133,74,59,541,32,110,96,143,15,36,109
"2011","Rotherham 020B","E01007758","Total",565,172,95,77,393,38,63,78,98,11,30,75
"2011","Rotherham 020C","E01007759","Total",670,228,112,116,442,37,75,86,128,8,34,74
"2011","Rotherham 020D","E01007760","Total",786,260,67,193,526,85,58,97,153,29,42,62
"2011","Rotherham 020E","E01007763","Total",674,234,109,125,440,58,70,65,118,22,31,76
"2011","Rotherham 020F","E01007764","Total",691,214,86,128,477,81,69,76,101,32,43,75
"2011","Rotherham 021A","E01007708","Total",761,288,152,136,473,53,88,81,123,18,39,71
"2011","Rotherham 021B","E01007709","Total",611,131,89,42,480,12,129,92,132,10,32,73
"2011","Rotherham 021C","E01007710","Total",656,139,95,44,517,10,154,80,130,15,28,100
"2011","Rotherham 021D","E01007711","Total",688,141,95,46,547,19,137,102,129,16,44,100
"2011","Rotherham 021E","E01007724","Total",584,130,72,58,454,16,107,90,126,8,23,84
"2011","Rotherham 021F","E01007734","Total",768,281,168,113,487,62,68,90,107,18,49,93
"2011","Rotherham 022A","E01007684","Total",666,152,57,95,514,42,72,122,142,13,34,89
"2011","Rotherham 022B","E01007687","Total",644,190,123,67,454,22,128,81,106,10,32,75
"2011","Rotherham 022C","E01007689","Total",623,156,102,54,467,21,71,114,119,19,30,93
"2011","Rotherham 022D","E01007690","Total",694,147,90,57,547,13,181,97,128,11,36,81
"2011","Rotherham 023A","E01007675","Total",653,168,78,90,485,19,78,80,104,39,78,87
"2011","Rotherham 023B","E01007678","Total",662,159,81,78,503,13,155,57,130,14,45,89
"2011","Rotherham 023C","E01007679","Total",748,247,117,130,501,19,103,82,122,30,61,84
"2011","Rotherham 023D","E01007680","Total",684,229,96,133,455,24,69,61,109,38,84,70
"2011","Rotherham 023E","E01007712","Total",747,163,85,78,584,11,121,122,152,34,53,91
"2011","Rotherham 023F","E01007713","Total",632,123,85,38,509,11,168,89,103,12,49,77
"2011","Rotherham 024A","E01007811","Total",579,149,95,54,430,14,109,75,115,14,22,81
"2011","Rotherham 024B","E01007812","Total",544,170,88,82,374,29,77,58,103,8,32,67
"2011","Rotherham 024C","E01007813","Total",591,171,75,96,420,23,93,90,125,7,23,59
"2011","Rotherham 024D","E01007814","Total",474,132,73,59,342,6,94,65,88,10,17,62
"2011","Rotherham 025A","E01007676","Total",719,201,94,107,518,40,107,95,157,13,33,73
"2011","Rotherham 025B","E01007702","Total",614,125,45,80,489,59,57,92,137,20,36,88
"2011","Rotherham 025C","E01007703","Total",500,110,77,33,390,17,99,73,78,10,33,80
"2011","Rotherham 025D","E01007704","Total",670,237,120,117,433,23,100,89,108,15,24,74
"2011","Rotherham 025E","E01007705","Total",593,117,64,53,476,27,111,88,103,13,43,91
"2011","Rotherham 025F","E01007707","Total",649,157,91,66,492,15,142,78,119,9,34,95
"2011","Rotherham 026A","E01007666","Total",570,126,66,60,444,15,86,56,139,4,35,109
"2011","Rotherham 026B","E01007809","Total",726,274,112,162,452,46,111,73,114,15,30,63
"2011","Rotherham 026C","E01007810","Total",793,202,119,83,591,35,120,118,138,23,46,111
"2011","Rotherham 026D","E01007815","Total",705,187,77,110,518,54,85,104,132,20,33,90
"2011","Rotherham 027A","E01007665","Total",702,141,55,86,561,21,104,136,141,14,37,108
"2011","Rotherham 027B","E01007699","Total",755,203,76,127,552,35,68,126,181,27,45,70
"2011","Rotherham 027C","E01007700","Total",719,170,52,118,549,45,64,158,173,13,31,65
"2011","Rotherham 027D","E01007701","Total",723,245,114,131,478,43,88,90,129,19,35,74
"2011","Rotherham 027E","E01007706","Total",556,96,23,73,460,27,62,86,133,9,42,101
"2011","Rotherham 028A","E01007787","Total",1197,293,98,195,904,51,161,173,341,26,57,95
"2011","Rotherham 028B","E01007788","Total",659,178,79,99,481,29,109,95,145,9,26,68
"2011","Rotherham 028C","E01007789","Total",739,266,116,150,473,43,100,89,115,20,31,75
"2011","Rotherham 028D","E01007792","Total",484,71,40,31,413,10,49,88,109,8,62,87
"2011","Rotherham 029A","E01007657","Total",582,109,55,54,473,26,108,89,124,12,31,83
"2011","Rotherham 029B","E01007659","Total",472,106,45,61,366,15,76,76,97,11,27,64
"2011","Rotherham 029C","E01007785","Total",519,105,57,48,414,29,66,77,109,10,51,72
"2011","Rotherham 029D","E01007786","Total",486,127,82,45,359,24,79,66,109,10,21,50
"2011","Rotherham 029E","E01007790","Total",696,265,102,163,431,76,79,58,117,14,26,61
"2011","Rotherham 029F","E01007791","Total",551,164,67,97,387,31,49,86,96,19,37,69
"2011","Rotherham 030A","E01007667","Total",579,164,72,92,415,29,80,94,102,9,36,65
"2011","Rotherham 030B","E01007668","Total",690,253,136,117,437,47,82,74,100,25,38,71
"2011","Rotherham 030C","E01007669","Total",647,155,98,57,492,18,148,71,112,12,29,102
"2011","Rotherham 030D","E01007670","Total",610,131,64,67,479,13,107,82,154,7,29,87
"2011","Rotherham 030E","E01007672","Total",589,113,42,71,476,29,95,102,140,9,23,78
"2011","Rotherham 030F","E01007673","Total",640,188,106,82,452,72,75,77,117,21,21,69
"2011","Rotherham 031A","E01007671","Total",822,157,63,94,665,52,93,164,166,16,56,118
"2011","Rotherham 031B","E01007674","Total",817,197,69,128,620,22,110,146,206,20,41,75
"2011","Rotherham 031C","E01007747","Total",537,153,94,59,384,24,74,74,91,11,37,73
"2011","Rotherham 031D","E01007750","Total",642,142,89,53,500,24,145,69,124,15,32,91
"2011","Rotherham 032A","E01007658","Total",581,137,54,83,444,25,74,89,134,11,28,83
"2011","Rotherham 032B","E01007660","Total",488,88,47,41,400,7,86,74,118,10,23,82
"2011","Rotherham 032C","E01007661","Total",574,112,67,45,462,19,113,84,135,11,30,70
"2011","Rotherham 032D","E01007662","Total",470,164,99,65,306,32,78,62,59,12,20,43
"2011","Rotherham 032E","E01007663","Total",637,145,90,55,492,21,151,80,123,10,20,87
"2011","Rotherham 032F","E01007664","Total",828,201,116,85,627,16,221,87,166,10,36,91
"2011","Rotherham 033A","E01007748","Total",648,164,110,54,484,18,165,63,124,8,32,74
"2011","Rotherham 033B","E01007749","Total",762,197,88,109,565,25,128,139,141,21,37,74
"2011","Rotherham 033C","E01007751","Total",834,247,91,156,587,43,80,159,180,20,40,65
"2011","Rotherham 033D","E01007752","Total",619,125,56,69,494,10,124,114,136,14,21,75
"2011","Rotherham 033E","E01007753","Total",670,193,134,59,477,17,125,99,121,10,33,72
"2011","Sheffield 001A","E01008144","Total",716,224,86,138,492,33,94,109,153,17,33,53
"2011","Sheffield 001B","E01008145","Total",712,292,157,135,420,34,104,52,110,20,27,73
"2011","Sheffield 001C","E01008148","Total",637,153,79,74,484,32,119,78,125,15,32,83
"2011","Sheffield 001D","E01008149","Total",653,166,67,99,487,25,104,97,150,10,29,72
"2011","Sheffield 001E","E01008150","Total",638,227,107,120,411,40,78,83,123,12,22,53
"2011","Sheffield 002A","E01008142","Total",623,189,81,108,434,38,69,86,125,20,33,63
"2011","Sheffield 002B","E01008143","Total",776,285,95,190,491,39,93,108,161,12,27,51
"2011","Sheffield 002C","E01008146","Total",523,77,38,39,446,8,115,100,112,18,20,73
"2011","Sheffield 002D","E01008147","Total",617,146,91,55,471,13,128,81,129,10,19,91
"2011","Sheffield 003A","E01007888","Total",553,86,25,61,467,16,91,95,145,9,29,82
"2011","Sheffield 003B","E01007892","Total",639,209,115,94,430,47,82,67,111,16,36,71
"2011","Sheffield 003C","E01007893","Total",627,126,76,50,501,10,126,100,143,5,23,94
"2011","Sheffield 003D","E01007898","Total",619,163,66,97,456,19,49,111,159,8,34,76
"2011","Sheffield 003E","E01007899","Total",612,122,60,62,490,14,136,79,126,9,38,88
"2011","Sheffield 003F","E01007900","Total",760,228,106,122,532,58,106,104,147,10,28,79
"2011","Sheffield 003G","E01007901","Total",712,290,170,120,422,49,95,71,92,17,32,66
"2011","Sheffield 004A","E01007887","Total",605,189,107,82,416,20,69,97,126,9,28,67
"2011","Sheffield 004B","E01007889","Total",1044,233,89,144,811,32,97,227,245,35,65,110
"2011","Sheffield 004C","E01007890","Total",585,118,59,59,467,10,116,107,134,11,24,65
"2011","Sheffield 004D","E01007891","Total",659,147,107,40,512,15,151,77,132,17,30,90
"2011","Sheffield 004E","E01007894","Total",639,197,83,114,442,36,75,77,149,16,27,62
"2011","Sheffield 004F","E01007895","Total",645,214,123,91,431,28,111,63,115,9,31,74
"2011","Sheffield 004G","E01007896","Total",551,126,65,61,425,16,85,78,128,8,21,89
"2011","Sheffield 005A","E01007897","Total",622,124,76,48,498,19,166,63,154,9,20,67
"2011","Sheffield 005B","E01008134","Total",616,188,113,75,428,10,124,63,131,6,29,65
"2011","Sheffield 005C","E01008135","Total",758,220,76,144,538,28,91,115,187,6,33,78
"2011","Sheffield 005D","E01008137","Total",626,140,84,56,486,4,162,89,119,3,28,81
"2011","Sheffield 005E","E01008141","Total",667,154,80,74,513,13,146,98,130,16,25,85
"2011","Sheffield 006A","E01008053","Total",565,200,95,105,365,31,82,50,89,18,22,73
"2011","Sheffield 006B","E01008056","Total",594,148,64,84,446,47,73,89,97,11,34,95
"2011","Sheffield 006C","E01008058","Total",620,176,88,88,444,18,108,81,98,7,30,102
"2011","Sheffield 006D","E01008138","Total",630,270,178,92,360,17,99,68,84,11,24,57
"2011","Sheffield 006E","E01008139","Total",707,203,97,106,504,31,136,82,136,10,34,75
"2011","Sheffield 007A","E01007856","Total",543,156,63,93,387,46,62,64,92,24,31,68
"2011","Sheffield 007B","E01008054","Total",537,141,43,98,396,83,46,75,75,21,30,66
"2011","Sheffield 007C","E01008055","Total",607,165,65,100,442,78,43,97,106,24,25,69
"2011","Sheffield 007D","E01008057","Total",600,167,70,97,433,70,51,97,92,30,34,59
"2011","Sheffield 008A","E01008126","Total",646,136,85,51,510,13,161,91,112,16,37,80
"2011","Sheffield 008C","E01008128","Total",723,165,66,99,558,13,111,107,195,20,32,80
"2011","Sheffield 008D","E01008136","Total",584,177,77,100,407,24,86,85,104,14,31,63
"2011","Sheffield 008E","E01008140","Total",848,288,130,158,560,55,100,123,176,11,23,72
"2011","Sheffield 008F","E01033275","Total",655,170,25,145,485,40,36,133,160,25,25,66
"2011","Sheffield 008G","E01033280","Total",601,103,44,59,498,24,79,118,137,17,45,78
"2011","Sheffield 009A","E01008085","Total",617,228,103,125,389,50,70,57,90,17,33,72
"2011","Sheffield 009B","E01008086","Total",575,175,61,114,400,55,66,80,98,19,31,51
"2011","Sheffield 009C","E01008116","Total",552,156,74,82,396,64,64,59,91,21,30,67
"2011","Sheffield 009D","E01008117","Total",555,233,104,129,322,34,67,50,59,15,32,65
"2011","Sheffield 009E","E01008118","Total",616,200,103,97,416,47,79,68,113,15,28,66
"2011","Sheffield 009F","E01008119","Total",469,111,45,66,358,64,38,52,74,23,45,62
"2011","Sheffield 009G","E01008125","Total",612,187,99,88,425,26,86,63,101,25,42,82
"2011","Sheffield 010A","E01007849","Total",866,280,105,175,586,99,73,108,123,25,73,85
"2011","Sheffield 010B","E01007857","Total",650,182,87,95,468,89,71,80,98,15,42,73
"2011","Sheffield 010C","E01008059","Total",633,202,78,124,431,65,59,95,99,17,36,60
"2011","Sheffield 010D","E01008060","Total",624,201,79,122,423,77,71,86,102,17,21,49
"2011","Sheffield 011A","E01008061","Total",649,192,101,91,457,60,69,101,93,32,33,69
"2011","Sheffield 011B","E01008063","Total",702,277,96,181,425,20,110,83,94,17,25,76
"2011","Sheffield 011E","E01033277","Total",954,278,101,177,676,111,84,127,164,45,54,91
"2011","Sheffield 012A","E01008087","Total",667,183,76,107,484,26,96,96,152,6,26,82
"2011","Sheffield 012B","E01008088","Total",658,197,85,112,461,31,117,69,133,6,22,83
"2011","Sheffield 012C","E01008090","Total",742,244,82,162,498,98,75,90,135,10,28,62
"2011","Sheffield 012D","E01008092","Total",726,358,119,239,368,58,71,71,91,10,23,44
"2011","Sheffield 012E","E01008122","Total",548,159,51,108,389,74,51,87,69,24,25,59
"2011","Sheffield 012F","E01008124","Total",663,223,53,170,440,95,46,94,122,21,31,31
"2011","Sheffield 013A","E01007848","Total",689,217,93,124,472,86,52,78,123,28,39,66
"2011","Sheffield 013B","E01007851","Total",524,131,50,81,393,51,48,59,76,33,50,76
"2011","Sheffield 013C","E01007947","Total",868,507,204,303,361,40,71,38,105,31,29,47
"2011","Sheffield 013D","E01007948","Total",612,160,84,76,452,63,60,73,75,45,68,68
"2011","Sheffield 013E","E01008062","Total",608,181,99,82,427,48,64,87,72,34,64,58
"2011","Sheffield 014A","E01007847","Total",643,273,91,182,370,35,85,61,91,16,24,58
"2011","Sheffield 014B","E01007850","Total",619,113,54,59,506,41,117,64,114,9,55,106
"2011","Sheffield 014C","E01007852","Total",637,179,42,137,458,35,66,84,142,14,29,88
"2011","Sheffield 014D","E01007853","Total",691,201,94,107,490,24,109,97,136,11,29,84
"2011","Sheffield 014E","E01007854","Total",645,162,42,120,483,88,27,135,114,19,44,56
"2011","Sheffield 014F","E01007855","Total",785,199,35,164,586,100,54,108,166,23,51,84
"2011","Sheffield 015A","E01007941","Total",656,218,129,89,438,51,74,73,100,21,33,86
"2011","Sheffield 015B","E01007945","Total",747,225,95,130,522,93,76,93,106,15,41,98
"2011","Sheffield 015C","E01007946","Total",623,164,56,108,459,95,48,87,99,26,43,61
"2011","Sheffield 015D","E01007950","Total",634,174,88,86,460,99,69,96,91,23,31,51
"2011","Sheffield 015E","E01008123","Total",519,138,52,86,381,62,46,73,86,25,21,68
"2011","Sheffield 016A","E01007987","Total",593,142,48,94,451,23,62,96,134,9,37,90
"2011","Sheffield 016B","E01007988","Total",651,180,103,77,471,25,95,102,127,12,25,85
"2011","Sheffield 016C","E01007989","Total",607,161,55,106,446,19,59,107,146,7,25,83
"2011","Sheffield 016D","E01007991","Total",623,157,95,62,466,70,95,73,94,14,43,77
"2011","Sheffield 017A","E01007995","Total",696,239,55,184,457,48,33,77,195,13,21,70
"2011","Sheffield 017B","E01008089","Total",672,199,67,132,473,54,79,77,112,36,43,72
"2011","Sheffield 017C","E01008091","Total",647,186,31,155,461,34,44,88,172,7,30,86
"2011","Sheffield 017D","E01008093","Total",773,366,115,251,407,28,51,82,163,9,16,58
"2011","Sheffield 018A","E01007903","Total",589,190,83,107,399,13,71,72,82,27,67,67
"2011","Sheffield 018B","E01007904","Total",675,231,106,125,444,54,83,59,80,46,63,59
"2011","Sheffield 018C","E01007913","Total",477,116,31,85,361,46,22,63,62,53,64,51
"2011","Sheffield 018D","E01007914","Total",494,108,41,67,386,42,32,89,60,45,73,45
"2011","Sheffield 019A","E01007870","Total",738,269,67,202,469,52,72,70,122,16,59,78
"2011","Sheffield 019B","E01007871","Total",855,379,144,235,476,51,97,70,117,22,47,72
"2011","Sheffield 019C","E01007943","Total",794,291,139,152,503,103,81,95,112,22,24,66
"2011","Sheffield 019D","E01008094","Total",471,122,52,70,349,42,70,62,86,10,17,62
"2011","Sheffield 020A","E01007869","Total",508,111,30,81,397,31,36,64,65,52,75,74
"2011","Sheffield 020B","E01007872","Total",627,212,88,124,415,32,62,57,79,46,76,63
"2011","Sheffield 020C","E01007873","Total",647,219,71,148,428,42,54,82,80,36,68,66
"2011","Sheffield 020D","E01007942","Total",518,99,30,69,419,42,28,64,57,56,88,84
"2011","Sheffield 020E","E01007949","Total",502,103,24,79,399,35,39,81,67,47,63,67
"2011","Sheffield 021A","E01007990","Total",661,192,116,76,469,30,126,76,122,18,25,72
"2011","Sheffield 021B","E01007992","Total",698,208,87,121,490,24,71,116,157,16,30,76
"2011","Sheffield 021C","E01007993","Total",689,178,88,90,511,37,112,87,120,35,29,91
"2011","Sheffield 021D","E01007994","Total",607,151,45,106,456,28,53,122,153,9,18,73
"2011","Sheffield 021E","E01007996","Total",702,223,113,110,479,36,100,92,151,16,24,60
"2011","Sheffield 022A","E01007874","Total",669,187,56,131,482,97,52,59,94,41,73,66
"2011","Sheffield 022B","E01007875","Total",607,167,49,118,440,77,40,73,60,48,79,63
"2011","Sheffield 022D","E01007877","Total",418,91,26,65,327,40,35,41,46,46,80,39
"2011","Sheffield 022E","E01007940","Total",630,193,57,136,437,78,51,83,74,41,61,49
"2011","Sheffield 022F","E01007944","Total",593,115,20,95,478,42,31,105,80,69,85,66
"2011","Sheffield 022G","E01033269","Total",666,217,51,166,449,83,20,70,74,70,63,69
"2011","Sheffield 022H","E01033270","Total",787,372,24,348,415,35,12,47,243,19,17,42
"2011","Sheffield 023A","E01008129","Total",578,159,81,78,419,23,89,68,103,17,39,80
"2011","Sheffield 023B","E01008130","Total",647,164,96,68,483,18,146,78,118,13,27,83
"2011","Sheffield 023C","E01008131","Total",650,148,73,75,502,19,116,97,127,18,34,91
"2011","Sheffield 023D","E01008132","Total",558,108,53,55,450,14,86,102,110,10,28,100
"2011","Sheffield 023E","E01008133","Total",744,268,181,87,476,16,172,71,110,14,25,68
"2011","Sheffield 024A","E01008151","Total",699,223,52,171,476,17,31,74,214,8,15,117
"2011","Sheffield 024B","E01008153","Total",839,318,94,224,521,25,68,78,245,11,13,81
"2011","Sheffield 024C","E01008154","Total",807,293,108,185,514,24,88,101,197,8,16,80
"2011","Sheffield 024D","E01008155","Total",722,220,56,164,502,31,54,65,237,10,22,83
"2011","Sheffield 024E","E01008156","Total",674,193,69,124,481,13,93,81,197,9,16,72
"2011","Sheffield 024F","E01008160","Total",657,233,112,121,424,25,69,75,149,10,22,74
"2011","Sheffield 025A","E01007997","Total",644,166,96,70,478,28,144,90,110,14,26,66
"2011","Sheffield 025B","E01007998","Total",891,519,244,275,372,31,104,70,76,12,19,60
"2011","Sheffield 025C","E01008152","Total",665,228,101,127,437,24,108,93,113,7,15,77
"2011","Sheffield 025D","E01008158","Total",730,258,119,139,472,51,106,87,126,14,18,70
"2011","Sheffield 026A","E01008065","Total",965,552,178,374,413,67,46,61,90,39,36,74
"2011","Sheffield 026B","E01008068","Total",891,395,73,322,496,51,26,90,119,36,29,145
"2011","Sheffield 026C","E01008072","Total",656,242,83,159,414,47,52,67,116,22,38,72
"2011","Sheffield 026D","E01008157","Total",859,437,221,216,422,44,87,57,133,14,17,70
"2011","Sheffield 026E","E01008161","Total",805,275,67,208,530,34,88,91,209,12,17,79
"2011","Sheffield 027A","E01007883","Total",414,94,42,52,320,42,29,45,54,37,67,46
"2011","Sheffield 027B","E01007902","Total",792,348,164,184,444,57,84,55,114,30,51,53
"2011","Sheffield 027C","E01007905","Total",513,73,13,60,440,48,18,124,62,43,88,57
"2011","Sheffield 027D","E01007906","Total",631,140,66,74,491,36,53,85,73,76,97,71
"2011","Sheffield 028A","E01008064","Total",628,160,41,119,468,18,28,59,137,8,11,207
"2011","Sheffield 028B","E01008066","Total",456,87,19,68,369,1,17,21,72,3,8,247
"2011","Sheffield 028C","E01008069","Total",573,138,56,82,435,10,20,36,125,6,9,229
"2011","Sheffield 028D","E01008074","Total",561,125,38,87,436,14,32,64,152,6,10,158
"2011","Sheffield 029A","E01007951","Total",695,215,110,105,480,18,86,82,157,22,22,93
"2011","Sheffield 029B","E01007960","Total",694,209,83,126,485,22,60,76,169,13,13,132
"2011","Sheffield 029C","E01007962","Total",628,207,85,122,421,8,53,50,150,9,7,144
"2011","Sheffield 029D","E01008159","Total",762,265,85,180,497,29,72,72,238,12,12,62
"2011","Sheffield 030A","E01007866","Total",572,180,45,135,392,8,17,50,107,13,25,172
"2011","Sheffield 030B","E01007867","Total",634,177,41,136,457,7,15,25,116,9,7,278
"2011","Sheffield 030C","E01007868","Total",493,194,75,119,299,6,35,46,115,13,14,70
"2011","Sheffield 030D","E01008067","Total",472,128,12,116,344,7,8,15,74,2,6,232
"2011","Sheffield 030E","E01008073","Total",700,267,62,205,433,17,38,52,140,9,15,162
"2011","Sheffield 032A","E01007907","Total",585,141,51,90,444,22,60,87,99,32,75,69
"2011","Sheffield 032B","E01007908","Total",658,199,62,137,459,24,69,112,148,9,31,66
"2011","Sheffield 032C","E01007909","Total",869,238,88,150,631,38,96,151,197,23,46,80
"2011","Sheffield 032D","E01007911","Total",592,139,81,58,453,23,111,97,111,5,25,81
"2011","Sheffield 032E","E01008014","Total",686,264,141,123,422,39,92,68,108,21,43,51
"2011","Sheffield 032F","E01008016","Total",621,197,94,103,424,45,77,71,112,18,28,73
"2011","Sheffield 033A","E01007952","Total",644,146,89,57,498,12,122,122,119,12,34,77
"2011","Sheffield 033B","E01007953","Total",844,385,203,182,459,9,191,54,124,12,23,46
"2011","Sheffield 033C","E01007954","Total",650,142,77,65,508,14,102,146,114,13,31,88
"2011","Sheffield 033D","E01007961","Total",591,128,80,48,463,15,97,112,99,19,36,85
"2011","Sheffield 036A","E01007859","Total",459,134,27,107,325,6,38,34,82,7,8,150
"2011","Sheffield 036B","E01007860","Total",607,244,69,175,363,3,22,48,122,15,16,137
"2011","Sheffield 036C","E01007863","Total",660,240,83,157,420,12,44,73,111,12,18,150
"2011","Sheffield 036D","E01007864","Total",521,77,23,54,444,4,13,16,72,0,3,336
"2011","Sheffield 036E","E01008104","Total",511,155,50,105,356,21,43,52,88,15,18,119
"2011","Sheffield 037A","E01007910","Total",727,267,119,148,460,59,85,73,123,23,37,60
"2011","Sheffield 037B","E01007912","Total",696,229,137,92,467,20,116,84,127,11,28,81
"2011","Sheffield 037C","E01007971","Total",619,203,108,95,416,39,91,72,102,21,27,64
"2011","Sheffield 037D","E01007973","Total",640,168,113,55,472,17,121,98,113,18,29,76
"2011","Sheffield 038A","E01007858","Total",649,258,62,196,391,23,54,81,141,23,17,52
"2011","Sheffield 038B","E01007861","Total",676,211,81,130,465,15,116,95,124,17,24,74
"2011","Sheffield 038C","E01007862","Total",682,227,64,163,455,11,49,47,83,13,25,227
"2011","Sheffield 038D","E01007865","Total",762,261,120,141,501,35,72,133,159,19,24,59
"2011","Sheffield 039A","E01008011","Total",684,236,71,165,448,100,47,83,84,30,38,66
"2011","Sheffield 039B","E01008012","Total",964,351,79,272,613,116,71,122,154,31,46,73
"2011","Sheffield 039C","E01008013","Total",527,195,55,140,332,56,34,51,96,24,27,44
"2011","Sheffield 039D","E01008015","Total",741,295,115,180,446,54,74,82,116,18,36,66
"2011","Sheffield 039E","E01008017","Total",709,272,127,145,437,49,70,74,98,25,42,79
"2011","Sheffield 039F","E01008018","Total",553,181,78,103,372,51,56,74,85,14,31,61
"2011","Sheffield 040A","E01008105","Total",734,224,31,193,510,24,16,41,133,21,43,232
"2011","Sheffield 040C","E01008107","Total",630,237,59,178,393,43,24,56,115,12,42,101
"2011","Sheffield 040D","E01008111","Total",574,192,33,159,382,9,23,33,91,14,19,193
"2011","Sheffield 040E","E01033271","Total",778,436,58,378,342,43,25,92,126,19,15,22
"2011","Sheffield 040F","E01033272","Total",675,379,60,319,296,21,11,39,181,8,9,27
"2011","Sheffield 041A","E01007955","Total",538,104,72,32,434,6,125,80,94,22,32,75
"2011","Sheffield 041B","E01007956","Total",910,233,130,103,677,24,188,186,133,14,54,78
"2011","Sheffield 041C","E01007957","Total",645,141,90,51,504,9,116,130,113,25,33,78
"2011","Sheffield 041D","E01007958","Total",618,159,85,74,459,9,135,91,115,28,23,58
"2011","Sheffield 041E","E01007959","Total",595,138,90,48,457,11,104,112,109,26,30,65
"2011","Sheffield 042A","E01008108","Total",722,193,21,172,529,26,22,48,186,18,41,188
"2011","Sheffield 042B","E01008109","Total",727,240,76,164,487,20,41,46,124,26,44,186
"2011","Sheffield 042D","E01008112","Total",575,137,28,109,438,28,26,70,95,42,57,120
"2011","Sheffield 042E","E01008113","Total",648,188,55,133,460,16,33,85,147,23,53,103
"2011","Sheffield 042F","E01033273","Total",550,154,39,115,396,23,16,35,98,6,22,196
"2011","Sheffield 042G","E01033274","Total",569,233,3,230,336,11,1,23,176,1,1,123
"2011","Sheffield 043A","E01008095","Total",629,266,81,185,363,42,37,39,168,24,13,40
"2011","Sheffield 043B","E01008096","Total",939,323,112,211,616,82,81,106,160,28,52,107
"2011","Sheffield 043C","E01008097","Total",710,257,126,131,453,86,73,65,99,29,33,68
"2011","Sheffield 043D","E01008101","Total",823,295,90,205,528,55,91,97,154,19,35,77
"2011","Sheffield 044A","E01007965","Total",839,305,224,81,534,60,128,95,86,30,38,97
"2011","Sheffield 044B","E01007969","Total",626,188,87,101,438,22,97,64,133,11,28,83
"2011","Sheffield 044C","E01007972","Total",613,131,73,58,482,20,126,96,121,10,33,76
"2011","Sheffield 044D","E01007974","Total",561,110,39,71,451,29,64,107,109,8,49,85
"2011","Sheffield 045A","E01007963","Total",721,312,124,188,409,26,87,78,122,7,24,65
"2011","Sheffield 045B","E01007967","Total",780,294,133,161,486,46,109,94,120,16,43,58
"2011","Sheffield 045C","E01007999","Total",562,141,60,81,421,14,76,61,125,9,31,105
"2011","Sheffield 045D","E01008008","Total",741,260,112,148,481,56,103,76,107,8,46,85
"2011","Sheffield 045E","E01008009","Total",615,169,69,100,446,117,47,86,68,24,46,58
"2011","Sheffield 046A","E01008043","Total",684,179,86,93,505,12,88,103,155,27,39,81
"2011","Sheffield 046B","E01008044","Total",621,169,111,58,452,18,116,95,79,28,48,68
"2011","Sheffield 046C","E01008047","Total",607,175,35,140,432,10,27,39,158,5,15,178
"2011","Sheffield 046D","E01008048","Total",537,125,27,98,412,10,43,41,101,17,14,186
"2011","Sheffield 046E","E01008050","Total",593,148,21,127,445,21,26,57,188,5,15,133
"2011","Sheffield 047A","E01007931","Total",644,149,110,39,495,13,102,106,128,27,28,91
"2011","Sheffield 047B","E01007934","Total",590,162,69,93,428,19,64,132,97,24,20,72
"2011","Sheffield 047C","E01007935","Total",557,120,29,91,437,23,30,111,129,8,13,123
"2011","Sheffield 047D","E01007936","Total",662,158,34,124,504,42,32,125,182,14,15,94
"2011","Sheffield 047E","E01007937","Total",575,148,87,61,427,13,66,119,121,13,24,71
"2011","Sheffield 047F","E01007938","Total",591,125,67,58,466,13,100,131,109,17,34,62
"2011","Sheffield 048A","E01008098","Total",632,166,63,103,466,92,61,89,86,27,35,76
"2011","Sheffield 048B","E01008100","Total",551,164,67,97,387,79,54,53,100,15,32,54
"2011","Sheffield 048C","E01008102","Total",540,230,100,130,310,50,63,55,66,15,16,45
"2011","Sheffield 048D","E01008103","Total",598,178,52,126,420,94,62,68,91,20,24,61
"2011","Sheffield 049A","E01007964","Total",716,253,98,155,463,34,90,78,152,18,22,69
"2011","Sheffield 049B","E01007966","Total",652,190,77,113,462,26,56,82,145,8,51,94
"2011","Sheffield 049C","E01007968","Total",622,201,120,81,421,49,78,68,102,17,45,62
"2011","Sheffield 049D","E01007970","Total",986,626,279,347,360,41,99,55,111,7,12,35
"2011","Sheffield 050A","E01008042","Total",643,226,58,168,417,24,59,65,127,29,43,70
"2011","Sheffield 050B","E01008045","Total",541,194,59,135,347,14,34,64,101,15,54,65
"2011","Sheffield 050C","E01008046","Total",704,222,45,177,482,38,42,103,180,19,35,65
"2011","Sheffield 050D","E01008049","Total",763,341,154,187,422,12,67,68,164,9,25,77
"2011","Sheffield 050E","E01008051","Total",642,190,33,157,452,15,42,74,146,29,53,93
"2011","Sheffield 050F","E01008052","Total",791,280,55,225,511,17,45,90,210,14,40,95
"2011","Sheffield 051A","E01007975","Total",814,365,144,221,449,33,69,82,154,26,25,60
"2011","Sheffield 051B","E01007976","Total",664,256,96,160,408,20,65,80,127,13,28,75
"2011","Sheffield 051C","E01007977","Total",849,465,144,321,384,45,83,55,107,13,14,67
"2011","Sheffield 051D","E01007979","Total",666,221,89,132,445,96,57,71,78,34,31,78
"2011","Sheffield 051E","E01008099","Total",654,168,42,126,486,45,42,99,173,10,20,97
"2011","Sheffield 052A","E01008000","Total",690,248,129,119,442,28,88,79,149,5,22,71
"2011","Sheffield 052B","E01008001","Total",662,195,86,109,467,48,97,94,128,11,30,59
"2011","Sheffield 052C","E01008004","Total",739,265,162,103,474,39,111,88,113,15,41,67
"2011","Sheffield 052D","E01008005","Total",711,211,110,101,500,25,136,73,144,13,27,82
"2011","Sheffield 052E","E01008010","Total",592,148,76,72,444,62,73,81,93,15,45,75
"2011","Sheffield 053A","E01007978","Total",759,274,38,236,485,52,25,89,191,11,39,78
"2011","Sheffield 053B","E01007980","Total",669,213,35,178,456,45,31,91,176,14,25,74
"2011","Sheffield 053C","E01007981","Total",602,186,39,147,416,18,35,104,142,20,27,70
"2011","Sheffield 053D","E01007983","Total",651,194,46,148,457,31,30,103,178,17,25,73
"2011","Sheffield 053E","E01007985","Total",662,194,57,137,468,36,88,88,128,14,35,79
"2011","Sheffield 054A","E01007982","Total",802,282,78,204,520,67,73,97,135,26,42,80
"2011","Sheffield 054B","E01008002","Total",695,175,93,82,520,19,141,95,155,8,26,76
"2011","Sheffield 054C","E01008003","Total",634,200,111,89,434,11,106,74,126,9,24,84
"2011","Sheffield 054D","E01008006","Total",637,200,99,101,437,22,132,56,125,9,17,76
"2011","Sheffield 055A","E01007927","Total",656,158,98,60,498,13,144,105,99,21,38,78
"2011","Sheffield 055B","E01007928","Total",706,171,102,69,535,12,138,102,113,30,39,101
"2011","Sheffield 055C","E01007929","Total",641,142,53,89,499,17,98,115,129,25,28,87
"2011","Sheffield 055D","E01007930","Total",543,94,65,29,449,9,103,100,92,27,43,75
"2011","Sheffield 055E","E01007932","Total",595,166,110,56,429,15,100,91,99,16,36,72
"2011","Sheffield 055F","E01007939","Total",653,178,107,71,475,18,119,99,118,20,27,74
"2011","Sheffield 056A","E01008028","Total",665,196,75,121,469,35,82,75,135,21,32,89
"2011","Sheffield 056B","E01008029","Total",598,157,78,79,441,46,72,85,105,23,37,73
"2011","Sheffield 056C","E01008032","Total",637,209,105,104,428,36,83,85,119,11,29,65
"2011","Sheffield 056D","E01008034","Total",684,172,85,87,512,41,67,110,117,16,47,114
"2011","Sheffield 059A","E01007828","Total",749,253,114,139,496,42,83,98,141,22,35,75
"2011","Sheffield 059B","E01007829","Total",731,223,60,163,508,39,74,114,193,10,18,60
"2011","Sheffield 059C","E01007831","Total",672,223,66,157,449,23,58,91,176,17,29,55
"2011","Sheffield 059D","E01007832","Total",686,221,88,133,465,38,71,115,127,12,27,75
"2011","Sheffield 059E","E01007986","Total",662,226,55,171,436,35,61,83,185,7,20,45
"2011","Sheffield 060A","E01008007","Total",826,403,167,236,423,38,106,57,93,21,48,60
"2011","Sheffield 060B","E01008075","Total",623,224,61,163,399,79,60,67,87,17,33,56
"2011","Sheffield 060C","E01008076","Total",625,245,99,146,380,49,64,71,95,18,19,64
"2011","Sheffield 060D","E01008077","Total",692,283,122,161,409,40,80,69,95,15,31,79
"2011","Sheffield 061A","E01008031","Total",630,193,96,97,437,17,87,88,127,11,32,75
"2011","Sheffield 061B","E01008033","Total",604,179,62,117,425,11,109,45,148,8,26,78
"2011","Sheffield 061C","E01008038","Total",742,218,129,89,524,13,193,66,155,7,20,70
"2011","Sheffield 061D","E01008040","Total",693,159,55,104,534,36,63,117,160,15,37,106
"2011","Sheffield 062A","E01007835","Total",618,181,97,84,437,15,127,86,108,10,28,63
"2011","Sheffield 062B","E01007836","Total",698,213,141,72,485,13,155,98,90,20,31,78
"2011","Sheffield 062C","E01007843","Total",776,316,177,139,460,55,85,82,127,18,25,68
"2011","Sheffield 062D","E01007846","Total",642,181,106,75,461,27,99,77,123,16,30,89
"2011","Sheffield 063A","E01008030","Total",558,138,42,96,420,18,64,106,115,18,28,71
"2011","Sheffield 063B","E01008035","Total",473,88,45,43,385,5,69,85,107,9,30,80
"2011","Sheffield 063C","E01008036","Total",601,160,30,130,441,18,40,103,151,13,29,87
"2011","Sheffield 063D","E01008041","Total",563,84,22,62,479,29,38,135,138,15,30,94
"2011","Sheffield 064A","E01007827","Total",701,222,104,118,479,20,98,86,170,7,20,78
"2011","Sheffield 064B","E01007830","Total",663,230,142,88,433,11,112,84,103,7,38,78
"2011","Sheffield 064C","E01007833","Total",795,298,210,88,497,11,157,91,122,7,27,82
"2011","Sheffield 064D","E01007984","Total",590,135,71,64,455,12,102,104,125,10,32,70
"2011","Sheffield 064E","E01008078","Total",650,248,126,122,402,15,115,57,109,11,19,76
"2011","Sheffield 064F","E01008079","Total",505,109,64,45,396,15,97,85,99,11,24,65
"2011","Sheffield 065A","E01008019","Total",735,174,66,108,561,49,75,108,158,21,50,100
"2011","Sheffield 065B","E01008020","Total",613,162,60,102,451,20,83,80,136,13,31,88
"2011","Sheffield 065C","E01008022","Total",773,373,84,289,400,66,52,69,115,16,28,54
"2011","Sheffield 065D","E01008027","Total",699,251,101,150,448,48,95,93,121,12,28,51
"2011","Sheffield 065E","E01008037","Total",720,260,142,118,460,44,154,42,134,5,12,69
"2011","Sheffield 065F","E01008039","Total",609,175,90,85,434,12,126,62,140,5,17,72
"2011","Sheffield 066A","E01007824","Total",562,129,80,49,433,9,101,97,106,17,28,75
"2011","Sheffield 066B","E01007825","Total",603,160,113,47,443,10,106,106,121,10,16,74
"2011","Sheffield 066C","E01007826","Total",582,112,64,48,470,13,101,117,104,20,33,82
"2011","Sheffield 066D","E01007834","Total",767,287,170,117,480,21,123,96,117,28,17,78
"2011","Sheffield 068A","E01007920","Total",688,165,106,59,523,8,173,101,116,16,30,79
"2011","Sheffield 068B","E01007921","Total",750,278,185,93,472,18,172,72,100,18,33,59
"2011","Sheffield 068C","E01007923","Total",813,256,141,115,557,20,154,114,143,19,31,76
"2011","Sheffield 068D","E01007925","Total",753,266,132,134,487,21,136,103,117,20,30,60
"2011","Sheffield 068E","E01007926","Total",708,168,117,51,540,12,163,99,134,26,36,70
"2011","Sheffield 068F","E01007933","Total",632,112,70,42,520,8,130,115,110,24,42,91
"2011","Sheffield 069A","E01007823","Total",820,334,188,146,486,27,136,99,124,10,25,65
"2011","Sheffield 069B","E01007916","Total",735,330,108,222,405,77,61,70,89,29,23,56
"2011","Sheffield 069C","E01007919","Total",784,334,118,216,450,89,55,106,111,15,18,56
"2011","Sheffield 069D","E01008080","Total",672,242,105,137,430,21,100,83,108,14,30,74
"2011","Sheffield 070A","E01008081","Total",795,411,127,284,384,47,81,51,101,12,30,62
"2011","Sheffield 070B","E01008082","Total",811,406,161,245,405,66,98,60,106,11,21,43
"2011","Sheffield 070C","E01008083","Total",709,308,111,197,401,59,60,74,105,22,29,52
"2011","Sheffield 070D","E01008084","Total",818,356,81,275,462,105,73,74,120,28,18,44
"2011","Sheffield 071A","E01007915","Total",609,154,93,61,455,11,141,103,104,12,23,61
"2011","Sheffield 071B","E01007917","Total",691,234,137,97,457,18,161,67,102,19,20,70
"2011","Sheffield 071C","E01007918","Total",752,269,122,147,483,24,134,102,107,19,29,68
"2011","Sheffield 071D","E01007922","Total",578,130,69,61,448,9,107,86,112,13,37,84
"2011","Sheffield 071E","E01007924","Total",702,268,134,134,434,36,95,86,117,19,21,60
"2011","Sheffield 072A","E01008021","Total",561,96,33,63,465,10,74,110,132,10,46,83
"2011","Sheffield 072B","E01008023","Total",924,277,47,230,647,37,72,185,222,15,40,76
"2011","Sheffield 072C","E01008024","Total",755,197,95,102,558,34,93,142,156,20,33,80
"2011","Sheffield 072D","E01008025","Total",860,224,104,120,636,34,119,150,193,21,39,80
"2011","Sheffield 072E","E01032585","Total",663,196,93,103,467,11,155,76,128,8,20,69
"2011","Sheffield 073A","E01033261","Total",718,246,22,224,472,1,2,19,267,3,3,177
"2011","Sheffield 073B","E01033262","Total",608,321,7,314,287,8,1,15,167,1,1,94
"2011","Sheffield 073C","E01033263","Total",626,225,11,214,401,20,3,49,240,11,8,70
"2011","Sheffield 073D","E01033264","Total",632,270,3,267,362,7,2,20,239,0,1,93
"2011","Sheffield 073E","E01033276","Total",686,296,1,295,390,4,0,14,168,2,3,199
"2011","Sheffield 074A","E01008114","Total",841,305,21,284,536,60,18,53,119,23,45,218
"2011","Sheffield 074B","E01008115","Total",538,125,16,109,413,20,17,19,109,8,22,218
"2011","Sheffield 074C","E01033265","Total",600,337,10,327,263,5,3,9,208,0,1,37
"2011","Sheffield 074D","E01033266","Total",609,242,8,234,367,10,1,17,170,7,9,153
"2011","Sheffield 074E","E01033267","Total",567,191,4,187,376,3,5,8,145,1,2,212
"2011","Sheffield 075A","E01007878","Total",649,175,78,97,474,61,57,60,80,29,25,162
"2011","Sheffield 075B","E01007879","Total",712,318,138,180,394,19,55,50,106,20,30,114
"2011","Sheffield 075C","E01007881","Total",675,205,84,121,470,54,79,57,135,29,37,79
"2011","Sheffield 075D","E01007882","Total",614,155,43,112,459,18,62,71,109,15,32,152
"2011","Sheffield 075E","E01007885","Total",692,239,33,206,453,64,45,80,145,28,27,64
"2011","Sheffield 075F","E01007886","Total",672,190,76,114,482,110,58,77,106,28,34,69
"2011","Sheffield 075G","E01033268","Total",1054,415,134,281,639,163,75,38,160,14,10,179
"2011","Sheffield 076A","E01007838","Total",644,176,81,95,468,26,81,88,135,16,33,89
"2011","Sheffield 076B","E01007839","Total",667,140,49,91,527,33,77,143,153,13,22,86
"2011","Sheffield 076C","E01007841","Total",637,146,66,80,491,30,81,107,125,22,38,88
"2011","Sheffield 076D","E01007842","Total",685,206,119,87,479,44,93,92,117,11,37,85
"2011","Sheffield 076E","E01033278","Total",1173,473,238,235,700,98,146,120,174,30,43,89
"2011","Sheffield 076F","E01033279","Total",1014,342,147,195,672,59,124,138,160,28,50,113
"2011","Bradford 001A","E01010646","Total",623,216,140,76,407,10,127,83,112,10,17,48
"2011","Bradford 001B","E01010647","Total",509,182,112,70,327,21,100,68,67,4,18,49
"2011","Bradford 001C","E01010648","Total",619,176,87,89,443,17,157,73,125,14,17,40
"2011","Bradford 001D","E01010692","Total",828,297,149,148,531,11,144,97,143,23,38,75
"2011","Bradford 002A","E01010691","Total",645,169,117,52,476,7,160,92,108,21,38,50
"2011","Bradford 002B","E01010693","Total",560,97,59,38,463,7,152,95,89,20,38,62
"2011","Bradford 002C","E01010694","Total",621,141,83,58,480,16,157,61,110,30,41,65
"2011","Bradford 002D","E01010695","Total",843,390,243,147,453,37,87,98,144,21,18,48
"2011","Bradford 002E","E01010696","Total",600,131,80,51,469,11,120,110,93,27,33,75
"2011","Bradford 002F","E01010697","Total",659,212,125,87,447,6,152,94,100,22,28,45
"2011","Bradford 002G","E01010698","Total",847,325,143,182,522,27,82,117,175,21,24,76
"2011","Bradford 002H","E01010699","Total",781,267,145,122,514,40,106,100,140,25,28,75
"2011","Bradford 003A","E01010767","Total",633,213,126,87,420,19,115,91,86,26,24,59
"2011","Bradford 003B","E01010768","Total",637,113,45,68,524,14,110,161,120,19,35,65
"2011","Bradford 003C","E01010769","Total",730,269,113,156,461,23,74,132,148,10,12,62
"2011","Bradford 003D","E01010771","Total",478,63,38,25,415,8,109,109,91,12,24,62
"2011","Bradford 004A","E01010638","Total",653,175,86,89,478,19,125,82,127,12,21,92
"2011","Bradford 004B","E01010639","Total",844,309,128,181,535,33,142,111,148,13,25,63
"2011","Bradford 004C","E01010640","Total",796,280,88,192,516,39,64,122,185,16,24,66
"2011","Bradford 004D","E01010641","Total",622,163,93,70,459,19,106,72,128,12,37,85
"2011","Bradford 004E","E01010642","Total",738,136,82,54,602,19,168,84,189,12,41,89
"2011","Bradford 004F","E01010643","Total",620,192,74,118,428,28,64,80,158,11,21,66
"2011","Bradford 004G","E01010644","Total",635,159,69,90,476,26,83,109,137,18,35,68
"2011","Bradford 004H","E01010645","Total",542,120,80,40,422,10,94,83,132,13,26,64
"2011","Bradford 005A","E01010770","Total",619,95,51,44,524,9,108,131,138,22,35,81
"2011","Bradford 005B","E01010772","Total",501,87,71,16,414,4,125,71,91,25,23,75
"2011","Bradford 005C","E01010773","Total",619,207,123,84,412,10,90,92,110,20,29,61
"2011","Bradford 005D","E01010774","Total",736,241,119,122,495,18,132,80,162,18,26,59
"2011","Bradford 006A","E01010706","Total",709,197,84,113,512,17,106,134,152,13,29,61
"2011","Bradford 006B","E01010707","Total",756,212,90,122,544,18,139,99,161,16,32,79
"2011","Bradford 006C","E01010708","Total",654,160,69,91,494,28,102,72,143,28,50,71
"2011","Bradford 006D","E01010709","Total",1054,243,131,112,811,29,142,195,233,40,64,108
"2011","Bradford 007A","E01010719","Total",495,100,45,55,395,34,49,58,61,51,82,60
"2011","Bradford 007B","E01010727","Total",743,249,121,128,494,10,95,70,165,19,38,97
"2011","Bradford 007C","E01010728","Total",528,120,47,73,408,29,52,37,82,42,93,73
"2011","Bradford 007D","E01010729","Total",483,84,44,40,399,9,92,56,77,39,54,72
"2011","Bradford 008A","E01010700","Total",450,97,29,68,353,37,22,47,57,48,83,59
"2011","Bradford 008B","E01010701","Total",430,111,43,68,319,12,22,48,61,60,77,39
"2011","Bradford 008C","E01010702","Total",510,123,50,73,387,16,28,38,27,62,150,66
"2011","Bradford 008D","E01010703","Total",663,194,86,108,469,31,62,108,135,26,32,75
"2011","Bradford 008E","E01010704","Total",611,175,62,113,436,36,67,87,118,17,30,81
"2011","Bradford 008F","E01010705","Total",674,140,68,72,534,27,131,84,123,26,43,100
"2011","Bradford 008G","E01010710","Total",884,424,78,346,460,42,33,80,125,41,75,64
"2011","Bradford 009A","E01010712","Total",487,92,22,70,395,42,24,81,55,72,72,49
"2011","Bradford 009B","E01010720","Total",618,180,90,90,438,59,57,90,86,38,32,76
"2011","Bradford 009C","E01010721","Total",622,208,84,124,414,46,83,70,95,23,35,62
"2011","Bradford 009D","E01010723","Total",489,110,31,79,379,36,17,73,78,66,68,41
"2011","Bradford 009E","E01010724","Total",611,209,86,123,402,59,55,82,93,16,31,66
"2011","Bradford 009F","E01010725","Total",696,248,128,120,448,53,82,83,121,20,25,64
"2011","Bradford 010A","E01010579","Total",633,138,79,59,495,9,146,108,122,7,34,69
"2011","Bradford 010B","E01010580","Total",999,239,115,124,760,29,120,214,219,34,42,102
"2011","Bradford 010C","E01010764","Total",673,142,82,60,531,8,145,95,145,15,33,90
"2011","Bradford 010D","E01010765","Total",1067,377,187,190,690,41,148,126,217,14,29,115
"2011","Bradford 010E","E01010766","Total",538,111,66,45,427,15,92,93,125,12,26,64
"2011","Bradford 011A","E01010711","Total",803,518,204,314,285,21,52,37,86,21,27,41
"2011","Bradford 011B","E01010713","Total",572,165,73,92,407,53,79,68,96,18,26,67
"2011","Bradford 011C","E01010714","Total",599,208,87,121,391,42,54,78,94,16,41,66
"2011","Bradford 011D","E01010716","Total",854,295,105,190,559,60,83,126,172,14,29,75
"2011","Bradford 012A","E01010715","Total",467,141,62,79,326,30,62,64,68,10,42,50
"2011","Bradford 012B","E01010717","Total",671,204,91,113,467,51,65,114,111,25,37,64
"2011","Bradford 012C","E01010718","Total",665,231,89,142,434,54,47,70,114,23,40,86
"2011","Bradford 012D","E01010726","Total",623,141,87,54,482,14,124,70,116,16,45,97
"2011","Bradford 012E","E01010859","Total",681,140,77,63,541,15,109,100,173,10,36,98
"2011","Bradford 013A","E01010573","Total",726,157,83,74,569,22,118,120,155,20,40,94
"2011","Bradford 013B","E01010574","Total",626,200,108,92,426,13,116,63,129,10,23,72
"2011","Bradford 013C","E01010575","Total",752,279,154,125,473,11,115,105,115,13,30,84
"2011","Bradford 013D","E01010577","Total",662,162,73,89,500,19,118,118,122,16,21,86
"2011","Bradford 014A","E01010722","Total",625,166,44,122,459,69,58,86,108,27,39,72
"2011","Bradford 014B","E01010860","Total",667,169,77,92,498,14,79,98,185,14,31,77
"2011","Bradford 014C","E01010862","Total",712,182,75,107,530,38,60,135,171,11,33,82
"2011","Bradford 014D","E01010863","Total",618,133,56,77,485,20,89,114,139,12,27,84
"2011","Bradford 015A","E01010578","Total",716,266,73,193,450,27,72,82,166,9,25,69
"2011","Bradford 015B","E01010581","Total",709,184,84,100,525,42,87,127,162,17,29,61
"2011","Bradford 015C","E01010582","Total",723,234,64,170,489,28,50,116,182,18,31,64
"2011","Bradford 015D","E01010584","Total",885,386,133,253,499,58,75,80,172,12,24,78
"2011","Bradford 015E","E01010585","Total",986,445,243,202,541,47,93,111,176,15,25,74
"2011","Bradford 016A","E01010568","Total",822,288,131,157,534,36,118,109,147,14,27,83
"2011","Bradford 016B","E01010569","Total",826,334,149,185,492,33,100,98,142,14,39,66
"2011","Bradford 016C","E01010571","Total",828,351,98,253,477,44,63,98,171,13,26,62
"2011","Bradford 016D","E01010572","Total",639,181,108,73,458,16,119,86,115,10,28,84
"2011","Bradford 016E","E01010576","Total",651,170,75,95,481,16,116,79,136,14,37,83
"2011","Bradford 017A","E01010683","Total",705,204,45,159,501,16,70,110,179,12,32,82
"2011","Bradford 017B","E01010684","Total",661,191,89,102,470,27,83,93,143,9,28,87
"2011","Bradford 017C","E01010685","Total",724,200,73,127,524,21,102,106,170,13,34,78
"2011","Bradford 017D","E01010686","Total",714,183,98,85,531,21,132,101,155,17,25,80
"2011","Bradford 018A","E01010570","Total",550,93,58,35,457,8,124,76,113,17,27,92
"2011","Bradford 018B","E01010583","Total",770,305,90,215,465,54,82,81,127,21,24,76
"2011","Bradford 018C","E01010784","Total",760,288,71,217,472,32,50,97,183,18,15,77
"2011","Bradford 018D","E01010785","Total",807,376,135,241,431,24,65,96,166,10,18,52
"2011","Bradford 018E","E01010786","Total",548,135,84,51,413,8,88,76,107,26,51,57
"2011","Bradford 018F","E01010790","Total",597,132,69,63,465,12,130,83,128,21,24,67
"2011","Bradford 019A","E01010680","Total",892,406,132,274,486,59,63,85,171,19,31,58
"2011","Bradford 019B","E01010681","Total",502,74,42,32,428,10,76,82,113,12,47,88
"2011","Bradford 019C","E01010682","Total",659,234,123,111,425,41,75,77,109,15,36,72
"2011","Bradford 019D","E01010687","Total",732,164,34,130,568,18,63,164,184,14,39,86
"2011","Bradford 019E","E01010688","Total",831,302,69,233,529,37,59,136,167,10,37,83
"2011","Bradford 019F","E01010689","Total",767,241,82,159,526,45,74,107,182,13,27,78
"2011","Bradford 019G","E01010690","Total",820,262,144,118,558,36,93,108,150,25,51,95
"2011","Bradford 020B","E01010782","Total",882,406,130,276,476,52,46,77,185,19,38,59
"2011","Bradford 020C","E01010787","Total",696,231,134,97,465,12,98,93,121,21,28,92
"2011","Bradford 020D","E01010788","Total",585,199,80,119,386,16,42,69,114,22,36,87
"2011","Bradford 020E","E01033689","Total",727,393,68,325,334,33,17,60,192,1,6,25
"2011","Bradford 020F","E01033694","Total",518,210,50,160,308,18,25,50,154,3,14,44
"2011","Bradford 021A","E01010776","Total",677,187,50,137,490,40,72,114,122,25,48,69
"2011","Bradford 021B","E01010777","Total",730,337,92,245,393,61,33,87,118,16,34,44
"2011","Bradford 021C","E01010779","Total",640,207,74,133,433,50,82,73,125,16,33,54
"2011","Bradford 021D","E01010781","Total",574,136,40,96,438,43,44,101,120,31,34,65
"2011","Bradford 021E","E01010783","Total",664,189,90,99,475,40,105,86,112,21,35,76
"2011","Bradford 022A","E01010586","Total",700,167,87,80,533,20,140,92,167,15,26,73
"2011","Bradford 022B","E01010587","Total",813,245,84,161,568,31,95,116,187,18,40,81
"2011","Bradford 022C","E01010588","Total",682,176,83,93,506,19,95,110,138,11,40,93
"2011","Bradford 022D","E01010589","Total",645,152,72,80,493,21,113,101,137,9,29,83
"2011","Bradford 022E","E01010591","Total",691,251,122,129,440,30,76,80,132,26,28,68
"2011","Bradford 022F","E01010593","Total",752,218,108,110,534,58,111,107,140,15,29,74
"2011","Bradford 022G","E01010596","Total",617,152,79,73,465,12,125,75,129,14,38,72
"2011","Bradford 023A","E01010854","Total",828,304,110,194,524,40,72,129,177,12,24,70
"2011","Bradford 023B","E01010855","Total",752,202,105,97,550,24,117,105,167,22,31,84
"2011","Bradford 023C","E01010856","Total",763,308,95,213,455,34,57,95,176,15,19,59
"2011","Bradford 023D","E01010857","Total",697,166,76,90,531,23,122,71,178,9,29,99
"2011","Bradford 023E","E01010858","Total",694,204,80,124,490,27,75,123,168,15,22,60
"2011","Bradford 023F","E01010861","Total",742,148,55,93,594,25,110,129,184,21,30,95
"2011","Bradford 024A","E01010603","Total",631,151,75,76,480,25,88,96,100,26,48,97
"2011","Bradford 024B","E01010604","Total",723,180,133,47,543,16,117,73,139,31,44,123
"2011","Bradford 024C","E01010605","Total",621,197,113,84,424,47,51,74,94,16,56,86
"2011","Bradford 024D","E01010775","Total",697,135,63,72,562,23,105,124,126,27,56,101
"2011","Bradford 024E","E01010778","Total",755,220,64,156,535,62,68,109,131,30,52,83
"2011","Bradford 025A","E01010789","Total",665,201,62,139,464,23,72,66,117,46,75,65
"2011","Bradford 025B","E01010791","Total",523,122,52,70,401,18,45,47,73,44,94,80
"2011","Bradford 025C","E01010792","Total",570,170,40,130,400,23,29,53,67,51,102,75
"2011","Bradford 025D","E01010793","Total",549,141,35,106,408,19,30,55,68,55,109,72
"2011","Bradford 026A","E01010652","Total",739,270,140,130,469,25,118,77,129,12,30,78
"2011","Bradford 026B","E01010653","Total",686,232,90,142,454,77,56,87,118,16,38,62
"2011","Bradford 026C","E01010655","Total",529,122,34,88,407,72,39,78,88,27,48,55
"2011","Bradford 026D","E01010656","Total",608,180,106,74,428,17,92,67,90,24,38,100
"2011","Bradford 026E","E01010657","Total",673,202,69,133,471,47,64,92,144,16,31,77
"2011","Bradford 027A","E01010649","Total",605,181,59,122,424,51,68,80,121,13,33,58
"2011","Bradford 027B","E01010650","Total",575,116,38,78,459,111,29,85,76,33,45,80
"2011","Bradford 027C","E01010654","Total",582,191,80,111,391,52,55,97,84,18,31,54
"2011","Bradford 027D","E01010826","Total",521,150,50,100,371,43,33,68,81,40,64,42
"2011","Bradford 028A","E01010597","Total",581,166,65,101,415,36,60,74,85,26,56,78
"2011","Bradford 028B","E01010598","Total",668,170,86,84,498,15,95,87,118,18,65,100
"2011","Bradford 028C","E01010599","Total",473,98,27,71,375,27,39,68,87,15,57,82
"2011","Bradford 028D","E01010600","Total",493,86,35,51,407,32,50,87,89,24,49,76
"2011","Bradford 028E","E01010602","Total",609,175,80,95,434,28,79,83,97,30,40,77
"2011","Bradford 029A","E01010670","Total",458,96,30,66,362,25,22,48,71,31,83,82
"2011","Bradford 029B","E01010671","Total",483,108,60,48,375,16,45,68,30,42,91,83
"2011","Bradford 029C","E01010673","Total",501,129,29,100,372,27,26,60,53,52,104,50
"2011","Bradford 029D","E01010675","Total",622,183,92,91,439,12,75,48,72,34,97,101
"2011","Bradford 030A","E01010669","Total",640,134,78,56,506,35,75,94,103,70,66,63
"2011","Bradford 030B","E01010674","Total",509,110,56,54,399,39,37,73,61,69,65,55
"2011","Bradford 030C","E01010677","Total",638,124,60,64,514,70,31,114,75,75,86,63
"2011","Bradford 030D","E01010805","Total",473,100,32,68,373,11,55,59,70,30,84,64
"2011","Bradford 031A","E01010590","Total",766,232,77,155,534,34,87,98,149,19,46,101
"2011","Bradford 031B","E01010592","Total",670,210,119,91,460,22,130,80,115,8,27,78
"2011","Bradford 031C","E01010594","Total",686,164,77,87,522,25,99,97,142,15,47,97
"2011","Bradford 031D","E01010595","Total",795,261,107,154,534,63,76,119,143,18,34,81
"2011","Bradford 032A","E01010601","Total",735,246,95,151,489,40,68,97,134,24,44,82
"2011","Bradford 032B","E01010651","Total",621,165,91,74,456,26,77,85,133,18,45,72
"2011","Bradford 032C","E01010825","Total",522,112,41,71,410,37,58,74,116,20,39,66
"2011","Bradford 032D","E01010827","Total",526,161,58,103,365,30,59,74,85,19,50,48
"2011","Bradford 033A","E01010804","Total",485,37,16,21,448,13,29,54,31,41,167,113
"2011","Bradford 033B","E01010806","Total",486,158,62,96,328,13,36,53,42,43,78,63
"2011","Bradford 033C","E01010807","Total",742,324,86,238,418,25,30,70,79,36,112,66
"2011","Bradford 033D","E01010808","Total",539,58,17,41,481,23,20,77,44,97,136,84
"2011","Bradford 033E","E01010809","Total",481,54,19,35,427,11,19,39,37,63,156,102
"2011","Bradford 034A","E01010676","Total",513,60,15,45,453,30,19,34,36,73,184,77
"2011","Bradford 034B","E01010679","Total",495,220,29,191,275,13,11,24,28,26,111,62
"2011","Bradford 034C","E01010824","Total",720,395,58,337,325,15,20,79,78,20,68,45
"2011","Bradford 034D","E01010840","Total",501,174,90,84,327,19,38,42,26,34,102,66
"2011","Bradford 034E","E01010841","Total",471,161,28,133,310,10,19,24,25,52,115,65
"2011","Bradford 035A","E01010828","Total",742,312,150,162,430,60,64,54,111,24,52,65
"2011","Bradford 035B","E01010829","Total",602,221,67,154,381,24,33,57,88,52,67,60
"2011","Bradford 035C","E01010830","Total",631,177,59,118,454,42,39,73,94,68,57,81
"2011","Bradford 035D","E01010831","Total",558,158,15,143,400,33,23,43,57,73,109,62
"2011","Bradford 035E","E01010832","Total",462,103,47,56,359,29,26,65,42,53,88,56
"2011","Bradford 036A","E01010672","Total",522,123,50,73,399,15,67,89,118,18,26,66
"2011","Bradford 036B","E01010678","Total",556,161,56,105,395,16,74,63,109,18,47,68
"2011","Bradford 036C","E01010799","Total",649,201,86,115,448,42,72,76,135,26,37,60
"2011","Bradford 036D","E01010800","Total",710,242,111,131,468,119,38,103,68,44,35,61
"2011","Bradford 036E","E01010801","Total",616,153,54,99,463,31,55,87,100,51,76,63
"2011","Bradford 036F","E01010802","Total",632,191,51,140,441,63,45,79,98,35,41,80
"2011","Bradford 037A","E01010803","Total",538,129,28,101,409,21,28,79,65,59,85,72
"2011","Bradford 037B","E01010810","Total",531,76,45,31,455,24,50,81,39,74,116,71
"2011","Bradford 037C","E01010811","Total",552,95,18,77,457,28,20,77,48,89,134,61
"2011","Bradford 037D","E01010813","Total",531,148,50,98,383,26,24,82,48,72,89,42
"2011","Bradford 038A","E01010618","Total",510,128,50,78,382,21,28,50,68,56,106,53
"2011","Bradford 038B","E01010619","Total",521,60,35,25,461,24,28,43,39,62,165,100
"2011","Bradford 038C","E01010625","Total",499,103,34,69,396,48,31,63,55,49,83,67
"2011","Bradford 038D","E01010626","Total",495,51,20,31,444,34,33,60,49,66,134,68
"2011","Bradford 038E","E01010627","Total",536,143,35,108,393,42,25,72,70,37,71,76
"2011","Bradford 039A","E01010606","Total",609,182,57,125,427,33,20,71,61,71,94,77
"2011","Bradford 039B","E01010607","Total",594,152,13,139,442,52,19,77,48,63,122,61
"2011","Bradford 039C","E01010617","Total",595,276,96,180,319,42,23,57,83,39,36,39
"2011","Bradford 039E","E01010842","Total",595,221,48,173,374,33,24,55,47,56,97,62
"2011","Bradford 039G","E01033690","Total",694,382,5,377,312,10,0,38,219,10,3,32
"2011","Bradford 039H","E01033691","Total",620,297,71,226,323,18,26,39,104,26,68,42
"2011","Bradford 039I","E01033692","Total",595,315,25,290,280,14,11,42,153,18,13,29
"2011","Bradford 039J","E01033693","Total",659,180,11,169,479,20,17,92,81,62,141,66
"2011","Bradford 040A","E01010628","Total",669,210,93,117,459,32,81,92,104,27,45,78
"2011","Bradford 040B","E01010629","Total",619,141,57,84,478,36,56,79,83,66,77,81
"2011","Bradford 040C","E01010630","Total",606,188,120,68,418,35,66,86,79,53,30,69
"2011","Bradford 040D","E01010631","Total",550,150,38,112,400,60,39,80,84,45,46,46
"2011","Bradford 040E","E01010632","Total",500,122,24,98,378,65,26,85,82,34,38,48
"2011","Bradford 041A","E01010658","Total",598,116,41,75,482,29,34,85,83,72,81,98
"2011","Bradford 041B","E01010812","Total",642,183,38,145,459,29,25,88,81,82,91,63
"2011","Bradford 041C","E01010833","Total",523,159,57,102,364,20,22,58,59,36,85,84
"2011","Bradford 041D","E01010843","Total",453,61,9,52,392,12,13,42,29,55,161,80
"2011","Bradford 042A","E01010620","Total",517,124,39,85,393,38,22,51,56,62,104,60
"2011","Bradford 042B","E01010621","Total",528,43,9,34,485,32,14,70,43,104,139,83
"2011","Bradford 042C","E01010622","Total",627,115,27,88,512,55,18,76,79,94,122,68
"2011","Bradford 042D","E01010623","Total",529,166,58,108,363,42,18,56,53,39,85,70
"2011","Bradford 042E","E01010624","Total",602,135,32,103,467,34,17,73,56,73,149,65
"2011","Bradford 043A","E01010794","Total",775,238,125,113,537,46,125,92,131,18,46,79
"2011","Bradford 043B","E01010795","Total",754,221,56,165,533,35,66,129,162,14,46,81
"2011","Bradford 043C","E01010796","Total",687,233,100,133,454,36,74,86,121,16,46,75
"2011","Bradford 043D","E01010797","Total",540,92,31,61,448,15,68,113,128,8,33,83
"2011","Bradford 043E","E01010798","Total",692,225,76,149,467,46,69,96,144,20,26,66
"2011","Bradford 044A","E01010834","Total",676,327,8,319,349,4,6,27,103,9,69,131
"2011","Bradford 044B","E01010835","Total",780,128,35,93,652,14,43,58,82,96,204,155
"2011","Bradford 044C","E01010836","Total",524,150,19,131,374,6,16,35,52,40,85,140
"2011","Bradford 044D","E01010837","Total",515,55,19,36,460,13,26,56,53,68,137,107
"2011","Bradford 044E","E01010838","Total",492,98,19,79,394,23,21,55,54,56,129,56
"2011","Bradford 044F","E01010839","Total",491,146,37,109,345,26,15,54,62,37,101,50
"2011","Bradford 045A","E01010608","Total",492,84,14,70,408,39,13,72,42,89,96,57
"2011","Bradford 045B","E01010613","Total",635,241,87,154,394,66,54,55,92,18,45,64
"2011","Bradford 045C","E01010730","Total",801,406,92,314,395,68,32,68,106,17,29,75
"2011","Bradford 045D","E01010734","Total",516,120,26,94,396,69,16,78,76,37,64,56
"2011","Bradford 046A","E01010609","Total",686,252,114,138,434,56,67,90,107,12,33,69
"2011","Bradford 046B","E01010610","Total",702,284,94,190,418,95,35,72,94,36,31,55
"2011","Bradford 046C","E01010611","Total",878,287,99,188,591,71,51,137,142,37,71,82
"2011","Bradford 046D","E01010614","Total",558,168,50,118,390,58,42,72,109,21,28,60
"2011","Bradford 047A","E01010633","Total",624,163,65,98,461,30,68,87,125,15,47,89
"2011","Bradford 047B","E01010634","Total",586,131,73,58,455,24,89,82,127,12,42,79
"2011","Bradford 047C","E01010635","Total",664,290,123,167,374,62,59,77,68,19,41,48
"2011","Bradford 047D","E01010636","Total",746,237,117,120,509,31,80,106,139,16,43,94
"2011","Bradford 047E","E01010637","Total",532,129,39,90,403,41,38,99,111,16,35,63
"2011","Bradford 048A","E01010731","Total",702,367,59,308,335,22,20,41,90,21,73,68
"2011","Bradford 048B","E01010732","Total",692,211,27,184,481,53,17,117,105,54,85,50
"2011","Bradford 048C","E01010733","Total",701,275,67,208,426,59,28,88,71,38,72,70
"2011","Bradford 048D","E01010736","Total",715,209,39,170,506,56,22,115,114,65,69,65
"2011","Bradford 048E","E01010737","Total",522,155,30,125,367,35,20,60,49,46,104,53
"2011","Bradford 049A","E01010659","Total",600,153,59,94,447,56,32,85,65,54,76,79
"2011","Bradford 049D","E01010662","Total",487,94,33,61,393,29,48,75,94,18,46,83
"2011","Bradford 049E","E01010664","Total",528,130,62,68,398,20,69,56,85,26,65,77
"2011","Bradford 049G","E01010761","Total",683,219,102,117,464,42,83,94,123,22,38,62
"2011","Bradford 049H","E01033695","Total",701,145,24,121,556,46,30,174,139,31,45,91
"2011","Bradford 049I","E01033696","Total",652,199,55,144,453,38,63,110,127,16,32,67
"2011","Bradford 049J","E01033697","Total",791,154,48,106,637,41,39,113,95,101,139,109
"2011","Bradford 050A","E01010663","Total",638,242,76,166,396,42,38,59,107,35,66,49
"2011","Bradford 050B","E01010665","Total",602,159,45,114,443,31,67,78,92,41,57,77
"2011","Bradford 050C","E01010666","Total",662,277,119,158,385,59,46,68,106,25,35,46
"2011","Bradford 050D","E01010667","Total",614,175,44,131,439,43,56,93,107,41,50,49
"2011","Bradford 051A","E01010735","Total",507,87,28,59,420,68,28,70,54,75,65,60
"2011","Bradford 051B","E01010738","Total",556,96,20,76,460,48,18,94,56,67,109,68
"2011","Bradford 051C","E01010739","Total",614,176,75,101,438,77,30,85,67,66,66,47
"2011","Bradford 051D","E01010740","Total",538,148,54,94,390,34,29,42,47,56,96,86
"2011","Bradford 051E","E01010744","Total",480,73,25,48,407,23,21,81,53,57,111,61
"2011","Bradford 052A","E01010612","Total",576,213,37,176,363,84,35,65,69,30,27,53
"2011","Bradford 052B","E01010819","Total",651,220,100,120,431,118,55,71,74,18,46,49
"2011","Bradford 052C","E01010820","Total",604,191,87,104,413,74,54,85,73,33,50,44
"2011","Bradford 052D","E01010821","Total",812,220,58,162,592,131,28,159,129,41,36,68
"2011","Bradford 052E","E01010822","Total",549,179,67,112,370,64,44,84,80,15,32,51
"2011","Bradford 053A","E01010615","Total",566,148,50,98,418,39,45,80,122,23,40,69
"2011","Bradford 053B","E01010616","Total",588,125,52,73,463,44,55,80,71,47,80,86
"2011","Bradford 053C","E01010742","Total",608,183,64,119,425,38,21,75,63,74,93,61
"2011","Bradford 053D","E01010743","Total",676,255,73,182,421,46,36,60,97,54,73,55
"2011","Bradford 054A","E01010847","Total",674,213,82,131,461,55,66,94,120,25,26,75
"2011","Bradford 054B","E01010848","Total",650,214,97,117,436,29,78,82,116,12,45,74
"2011","Bradford 054C","E01010852","Total",663,221,128,93,442,55,87,74,91,42,34,59
"2011","Bradford 054D","E01010853","Total",506,113,56,57,393,26,65,69,105,20,34,74
"2011","Bradford 055A","E01010668","Total",516,122,64,58,394,19,85,52,95,28,43,72
"2011","Bradford 055B","E01010755","Total",671,187,52,135,484,108,33,125,104,26,32,56
"2011","Bradford 055C","E01010762","Total",601,161,66,95,440,38,57,96,105,25,59,60
"2011","Bradford 055D","E01010763","Total",621,174,84,90,447,32,89,70,110,19,32,95
"2011","Bradford 055E","E01010846","Total",849,232,75,157,617,51,80,125,163,38,62,98
"2011","Bradford 056A","E01010745","Total",618,173,47,126,445,73,41,74,95,38,56,68
"2011","Bradford 056B","E01010747","Total",644,210,106,104,434,29,60,81,105,33,56,70
"2011","Bradford 056C","E01010748","Total",670,229,132,97,441,76,62,70,112,11,44,66
"2011","Bradford 056D","E01010749","Total",614,226,103,123,388,45,60,67,107,13,36,60
"2011","Bradford 057A","E01010814","Total",797,327,106,221,470,61,63,85,151,9,39,62
"2011","Bradford 057B","E01010815","Total",873,208,58,150,665,75,52,180,149,37,73,99
"2011","Bradford 057C","E01010816","Total",758,166,50,116,592,40,95,133,183,21,40,80
"2011","Bradford 057D","E01010817","Total",881,276,91,185,605,122,63,135,113,26,54,92
"2011","Bradford 057E","E01010818","Total",691,142,45,97,549,41,68,128,135,25,56,96
"2011","Bradford 058A","E01010752","Total",818,306,82,224,512,48,70,112,170,11,27,74
"2011","Bradford 058B","E01010753","Total",597,113,66,47,484,18,117,73,143,7,29,97
"2011","Bradford 058C","E01010754","Total",662,191,80,111,471,38,55,115,127,21,41,74
"2011","Bradford 058D","E01010756","Total",604,166,51,115,438,39,45,82,137,12,41,82
"2011","Bradford 058E","E01010758","Total",477,65,21,44,412,14,40,105,125,10,32,86
"2011","Bradford 058F","E01010759","Total",660,202,102,100,458,45,77,98,111,19,33,75
"2011","Bradford 058G","E01010760","Total",605,120,51,69,485,27,72,113,134,16,33,90
"2011","Bradford 059A","E01010741","Total",656,216,61,155,440,34,82,91,102,12,26,93
"2011","Bradford 059B","E01010845","Total",848,301,140,161,547,78,69,102,136,41,60,61
"2011","Bradford 059C","E01010849","Total",605,172,95,77,433,14,93,88,108,17,24,89
"2011","Bradford 059D","E01010850","Total",507,120,36,84,387,66,26,75,85,28,51,56
"2011","Bradford 059E","E01010851","Total",662,183,55,128,479,40,73,89,131,20,35,91
"2011","Bradford 059F","E01010864","Total",526,138,40,98,388,54,36,98,100,20,32,48
"2011","Bradford 059G","E01010867","Total",581,140,40,100,441,63,55,97,101,25,33,67
"2011","Bradford 059H","E01010874","Total",512,187,85,102,325,51,35,63,84,20,25,47
"2011","Bradford 060A","E01010746","Total",684,181,101,80,503,28,126,60,126,13,47,103
"2011","Bradford 060B","E01010750","Total",693,202,96,106,491,35,98,92,123,16,29,98
"2011","Bradford 060C","E01010751","Total",676,218,127,91,458,33,101,69,118,17,27,93
"2011","Bradford 060D","E01010865","Total",709,187,68,119,522,43,84,111,168,12,27,77
"2011","Bradford 060E","E01010866","Total",607,182,56,126,425,37,58,85,154,12,27,52
"2011","Bradford 061A","E01010868","Total",700,252,58,194,448,49,58,80,134,20,43,64
"2011","Bradford 061B","E01010869","Total",742,218,83,135,524,57,87,93,149,12,37,89
"2011","Bradford 061C","E01010870","Total",684,206,109,97,478,25,95,86,164,5,26,77
"2011","Bradford 061D","E01010871","Total",756,242,77,165,514,66,76,92,143,14,32,91
"2011","Bradford 061E","E01010872","Total",656,194,86,108,462,59,74,84,101,24,39,81
"2011","Bradford 061F","E01010873","Total",509,114,62,52,395,16,104,65,92,8,32,78
"2011","Calderdale 001A","E01010911","Total",711,169,68,101,542,37,99,88,165,19,43,91
"2011","Calderdale 001B","E01010912","Total",688,252,109,143,436,52,91,84,87,26,36,60
"2011","Calderdale 001C","E01010913","Total",550,134,92,42,416,15,104,66,116,3,28,84
"2011","Calderdale 001D","E01010915","Total",576,137,54,83,439,28,74,94,122,8,37,76
"2011","Calderdale 002A","E01010914","Total",784,237,71,166,547,71,76,95,152,28,50,75
"2011","Calderdale 002B","E01010924","Total",643,341,62,279,302,47,51,31,99,13,22,39
"2011","Calderdale 002C","E01010925","Total",575,171,71,100,404,49,63,51,106,20,39,76
"2011","Calderdale 002D","E01010926","Total",439,93,30,63,346,69,30,88,72,24,25,38
"2011","Calderdale 003A","E01010931","Total",613,187,103,84,426,18,97,85,102,9,41,74
"2011","Calderdale 003B","E01010932","Total",679,175,78,97,504,21,124,95,144,4,21,95
"2011","Calderdale 003C","E01010933","Total",701,205,107,98,496,34,98,82,149,12,31,90
"2011","Calderdale 003D","E01010935","Total",691,183,88,95,508,29,142,94,121,7,18,97
"2011","Calderdale 003E","E01010936","Total",814,219,123,96,595,31,112,165,128,23,49,87
"2011","Calderdale 003F","E01010937","Total",685,199,92,107,486,24,105,101,135,20,21,80
"2011","Calderdale 004A","E01010881","Total",718,208,53,155,510,47,68,119,165,15,24,72
"2011","Calderdale 004B","E01010882","Total",649,230,120,110,419,21,75,91,129,21,27,55
"2011","Calderdale 004C","E01010883","Total",644,174,69,105,470,13,86,109,153,14,34,61
"2011","Calderdale 004D","E01010887","Total",710,196,55,141,514,24,101,99,173,16,27,74
"2011","Calderdale 004E","E01010888","Total",794,345,95,250,449,54,53,89,181,6,19,47
"2011","Calderdale 004F","E01010923","Total",795,324,84,240,471,64,48,91,186,15,18,49
"2011","Calderdale 005A","E01010916","Total",578,168,78,90,410,65,58,75,80,15,44,73
"2011","Calderdale 005B","E01010939","Total",712,167,70,97,545,18,91,128,149,20,47,92
"2011","Calderdale 005C","E01010941","Total",522,134,71,63,388,57,43,66,91,19,39,73
"2011","Calderdale 005D","E01010942","Total",773,349,99,250,424,59,58,70,111,20,40,66
"2011","Calderdale 005E","E01010944","Total",595,210,99,111,385,62,52,72,93,24,24,58
"2011","Calderdale 006A","E01010938","Total",613,208,55,153,405,73,53,83,95,25,19,57
"2011","Calderdale 006B","E01010940","Total",637,208,72,136,429,45,63,75,126,15,25,80
"2011","Calderdale 006C","E01010943","Total",603,174,45,129,429,79,45,89,83,15,42,76
"2011","Calderdale 006D","E01010961","Total",532,190,40,150,342,57,32,55,119,12,15,52
"2011","Calderdale 007A","E01010917","Total",862,307,128,179,555,27,129,115,173,15,22,74
"2011","Calderdale 007B","E01010918","Total",725,203,104,99,522,32,101,120,145,13,34,77
"2011","Calderdale 007C","E01010919","Total",772,313,171,142,459,41,113,80,120,15,30,60
"2011","Calderdale 007D","E01010920","Total",726,207,72,135,519,29,89,96,167,19,33,86
"2011","Calderdale 007E","E01010921","Total",720,237,87,150,483,42,94,105,125,24,36,57
"2011","Calderdale 008A","E01010934","Total",911,307,105,202,604,39,105,110,210,15,27,98
"2011","Calderdale 008D","E01010967","Total",786,395,117,278,391,58,53,81,116,14,15,54
"2011","Calderdale 008E","E01010994","Total",1046,717,190,527,329,19,59,44,140,5,22,40
"2011","Calderdale 008F","E01032923","Total",1126,457,128,329,669,85,100,142,198,16,38,90
"2011","Calderdale 009A","E01010927","Total",692,149,91,58,543,26,128,92,170,14,43,70
"2011","Calderdale 009B","E01010928","Total",616,194,73,121,422,72,55,73,112,24,28,58
"2011","Calderdale 009C","E01010997","Total",625,163,98,65,462,17,132,67,117,5,42,82
"2011","Calderdale 009D","E01010999","Total",637,146,75,71,491,21,120,79,149,13,31,78
"2011","Calderdale 010A","E01010929","Total",901,258,83,175,643,74,57,166,149,67,54,76
"2011","Calderdale 010B","E01010930","Total",737,279,113,166,458,88,71,98,100,14,27,60
"2011","Calderdale 010C","E01010998","Total",715,276,137,139,439,46,76,86,110,16,46,59
"2011","Calderdale 010D","E01011000","Total",604,130,55,75,474,45,38,101,65,64,93,68
"2011","Calderdale 011A","E01010904","Total",593,139,61,78,454,25,85,94,137,6,22,85
"2011","Calderdale 011B","E01010906","Total",593,125,79,46,468,16,134,94,124,12,28,60
"2011","Calderdale 011C","E01010907","Total",598,158,60,98,440,22,86,101,113,11,26,81
"2011","Calderdale 011D","E01010909","Total",713,266,111,155,447,45,87,89,132,12,23,59
"2011","Calderdale 012A","E01010960","Total",472,94,28,66,378,36,22,61,68,44,90,57
"2011","Calderdale 012B","E01010964","Total",585,238,82,156,347,42,26,62,48,41,71,57
"2011","Calderdale 012C","E01010965","Total",512,246,95,151,266,15,26,27,27,31,82,58
"2011","Calderdale 012D","E01010966","Total",517,141,37,104,376,35,20,64,47,52,96,62
"2011","Calderdale 012E","E01010995","Total",399,124,29,95,275,23,12,38,40,25,88,49
"2011","Calderdale 013A","E01010982","Total",597,187,67,120,410,23,92,71,125,14,31,54
"2011","Calderdale 013B","E01010983","Total",742,331,111,220,411,38,64,73,136,13,33,54
"2011","Calderdale 013C","E01010985","Total",630,191,58,133,439,26,73,88,158,10,28,56
"2011","Calderdale 013D","E01010986","Total",772,285,70,215,487,61,53,91,162,26,27,67
"2011","Calderdale 013E","E01010987","Total",767,245,118,127,522,45,86,123,150,16,22,80
"2011","Calderdale 013F","E01010988","Total",648,207,88,119,441,47,73,73,122,16,33,77
"2011","Calderdale 014A","E01010996","Total",429,89,34,55,340,26,18,56,27,55,89,69
"2011","Calderdale 014B","E01011001","Total",459,87,19,68,372,31,22,51,61,47,93,67
"2011","Calderdale 014C","E01011002","Total",637,181,55,126,456,38,50,91,106,40,73,58
"2011","Calderdale 014D","E01011003","Total",549,248,97,151,301,54,22,40,83,24,28,50
"2011","Calderdale 015A","E01010878","Total",896,400,135,265,496,53,72,83,177,23,14,74
"2011","Calderdale 015B","E01010879","Total",824,239,117,122,585,17,147,105,180,19,32,85
"2011","Calderdale 015C","E01010905","Total",760,193,89,104,567,27,101,145,167,18,28,81
"2011","Calderdale 015D","E01010908","Total",952,307,119,188,645,46,109,151,210,12,31,86
"2011","Calderdale 015E","E01010910","Total",573,205,90,115,368,30,81,67,86,18,25,61
"2011","Calderdale 016A","E01010969","Total",742,234,88,146,508,36,88,91,163,21,30,79
"2011","Calderdale 016B","E01010970","Total",872,360,136,224,512,25,88,88,176,24,34,77
"2011","Calderdale 016C","E01010974","Total",614,239,110,129,375,36,48,63,84,24,61,59
"2011","Calderdale 016D","E01010977","Total",674,184,82,102,490,35,115,71,146,11,28,84
"2011","Calderdale 017A","E01010975","Total",745,280,185,95,465,19,153,61,117,14,28,73
"2011","Calderdale 017B","E01010976","Total",779,212,111,101,567,15,108,106,188,19,39,92
"2011","Calderdale 017C","E01010978","Total",572,176,51,125,396,46,37,88,122,13,23,67
"2011","Calderdale 017D","E01010979","Total",838,441,104,337,397,38,53,63,163,8,23,49
"2011","Calderdale 017E","E01010980","Total",676,229,60,169,447,53,51,87,162,15,20,59
"2011","Calderdale 017F","E01010981","Total",691,250,56,194,441,54,50,77,157,12,30,61
"2011","Calderdale 018A","E01010989","Total",738,303,96,207,435,20,93,55,151,21,31,64
"2011","Calderdale 018B","E01010990","Total",728,234,88,146,494,45,91,109,131,13,32,73
"2011","Calderdale 018C","E01010991","Total",681,172,71,101,509,37,117,115,134,12,16,78
"2011","Calderdale 018D","E01010992","Total",773,273,101,172,500,53,67,117,163,10,33,57
"2011","Calderdale 018E","E01010993","Total",735,248,92,156,487,59,56,107,134,13,50,68
"2011","Calderdale 019A","E01010875","Total",779,218,143,75,561,19,168,119,147,16,24,68
"2011","Calderdale 019B","E01010876","Total",684,166,78,88,518,27,121,113,135,12,39,71
"2011","Calderdale 019C","E01010877","Total",772,339,124,215,433,35,103,73,134,4,27,57
"2011","Calderdale 019D","E01010880","Total",713,288,87,201,425,52,82,85,115,15,26,50
"2011","Calderdale 019E","E01010949","Total",741,297,105,192,444,56,65,75,141,14,27,66
"2011","Calderdale 020A","E01010922","Total",808,221,56,165,587,50,86,147,161,17,31,95
"2011","Calderdale 020B","E01010956","Total",685,195,51,144,490,24,97,80,163,13,29,84
"2011","Calderdale 020C","E01010958","Total",671,254,153,101,417,42,100,60,97,21,36,61
"2011","Calderdale 020D","E01010959","Total",717,149,66,83,568,53,113,110,146,22,27,97
"2011","Calderdale 021A","E01010968","Total",767,269,89,180,498,26,88,96,147,15,40,86
"2011","Calderdale 021B","E01010971","Total",820,258,131,127,562,34,108,133,147,29,36,75
"2011","Calderdale 021C","E01010972","Total",666,187,107,80,479,22,107,90,128,22,36,74
"2011","Calderdale 021D","E01010973","Total",777,269,144,125,508,32,126,104,134,12,23,77
"2011","Calderdale 022A","E01010884","Total",770,295,166,129,475,41,111,70,147,17,27,62
"2011","Calderdale 022B","E01010885","Total",654,222,79,143,432,26,74,93,147,10,17,65
"2011","Calderdale 022C","E01010886","Total",509,172,62,110,337,15,69,61,109,14,20,49
"2011","Calderdale 022D","E01010984","Total",579,191,42,149,388,41,59,80,119,14,17,58
"2011","Calderdale 023A","E01010946","Total",566,120,86,34,446,11,144,66,98,16,34,77
"2011","Calderdale 023B","E01010947","Total",639,167,85,82,472,20,102,119,123,6,25,77
"2011","Calderdale 023C","E01010950","Total",687,279,64,215,408,41,67,86,110,15,19,70
"2011","Calderdale 023D","E01010951","Total",664,226,70,156,438,53,70,87,141,9,16,62
"2011","Calderdale 024A","E01010891","Total",808,287,100,187,521,61,93,107,144,19,28,69
"2011","Calderdale 024B","E01010892","Total",738,151,57,94,587,40,85,155,154,20,44,89
"2011","Calderdale 024C","E01010895","Total",653,228,95,133,425,36,85,79,114,13,21,77
"2011","Calderdale 024D","E01010945","Total",671,159,63,96,512,29,100,100,141,21,31,90
"2011","Calderdale 024E","E01010948","Total",640,221,128,93,419,20,115,70,105,15,22,72
"2011","Calderdale 025A","E01010889","Total",887,402,158,244,485,55,96,74,156,17,33,54
"2011","Calderdale 025B","E01010890","Total",843,298,80,218,545,53,77,101,210,13,36,55
"2011","Calderdale 025C","E01010893","Total",618,211,106,105,407,30,76,93,96,11,36,65
"2011","Calderdale 025D","E01010894","Total",730,269,79,190,461,61,61,102,122,18,25,72
"2011","Calderdale 025E","E01010901","Total",717,192,88,104,525,25,139,92,152,15,24,78
"2011","Calderdale 025F","E01010903","Total",724,215,107,108,509,41,118,109,118,10,40,73
"2011","Calderdale 026A","E01010896","Total",665,145,41,104,520,14,95,120,161,21,29,80
"2011","Calderdale 026B","E01010897","Total",749,244,75,169,505,22,74,101,181,17,31,79
"2011","Calderdale 026C","E01010898","Total",800,325,114,211,475,48,55,107,158,11,26,70
"2011","Calderdale 026D","E01010899","Total",574,130,75,55,444,38,81,91,119,17,29,69
"2011","Calderdale 026E","E01010900","Total",662,150,58,92,512,15,111,119,152,12,24,79
"2011","Calderdale 026F","E01010902","Total",656,176,72,104,480,63,57,103,134,26,38,59
"2011","Calderdale 027A","E01010952","Total",716,254,138,116,462,31,74,80,154,17,32,74
"2011","Calderdale 027B","E01010953","Total",598,142,63,79,456,24,76,112,129,16,27,72
"2011","Calderdale 027C","E01010954","Total",958,223,68,155,735,43,86,219,226,38,40,83
"2011","Calderdale 027D","E01010955","Total",606,172,39,133,434,23,70,95,138,8,26,74
"2011","Calderdale 027E","E01010957","Total",640,161,58,103,479,16,79,107,170,8,23,76
"2011","Kirklees 001A","E01011051","Total",680,182,80,102,498,30,99,115,138,10,29,77
"2011","Kirklees 001B","E01011055","Total",547,153,73,80,394,18,82,77,127,14,27,49
"2011","Kirklees 001C","E01011056","Total",694,187,100,87,507,30,107,113,140,12,28,77
"2011","Kirklees 001D","E01011057","Total",617,204,92,112,413,24,80,87,123,8,26,65
"2011","Kirklees 001E","E01011058","Total",502,109,61,48,393,33,89,91,87,11,20,62
"2011","Kirklees 002A","E01011048","Total",859,412,190,222,447,37,93,57,148,10,19,83
"2011","Kirklees 002B","E01011049","Total",684,183,81,102,501,42,91,87,137,19,40,85
"2011","Kirklees 002C","E01011050","Total",620,129,58,71,491,16,108,91,129,20,30,97
"2011","Kirklees 002D","E01011052","Total",707,208,66,142,499,45,67,126,138,16,30,77
"2011","Kirklees 002E","E01011053","Total",623,139,57,82,484,17,106,105,134,10,23,89
"2011","Kirklees 002F","E01011059","Total",614,172,40,132,442,88,35,104,106,31,29,49
"2011","Kirklees 003A","E01011062","Total",732,203,62,141,529,43,89,114,163,16,24,80
"2011","Kirklees 003B","E01011064","Total",644,192,70,122,452,53,90,86,132,12,28,51
"2011","Kirklees 003C","E01011068","Total",718,191,85,106,527,28,107,119,142,12,28,91
"2011","Kirklees 003D","E01011069","Total",608,185,82,103,423,15,103,78,127,12,22,66
"2011","Kirklees 004A","E01011241","Total",646,121,59,62,525,23,92,137,146,17,30,80
"2011","Kirklees 004B","E01011242","Total",676,193,97,96,483,38,108,94,109,17,38,79
"2011","Kirklees 004C","E01011243","Total",727,187,82,105,540,30,122,106,157,8,28,89
"2011","Kirklees 004D","E01011244","Total",830,191,46,145,639,57,89,155,184,22,38,94
"2011","Kirklees 005A","E01011060","Total",789,317,112,205,472,20,96,88,152,13,31,72
"2011","Kirklees 005B","E01011061","Total",866,432,147,285,434,51,61,84,137,13,31,57
"2011","Kirklees 005C","E01011063","Total",970,360,129,231,610,49,122,143,176,15,31,74
"2011","Kirklees 005D","E01011065","Total",693,198,54,144,495,46,50,113,140,19,33,94
"2011","Kirklees 005E","E01011066","Total",624,148,83,65,476,19,111,97,110,14,30,95
"2011","Kirklees 006A","E01011027","Total",498,116,41,75,382,38,62,63,110,17,30,62
"2011","Kirklees 006B","E01011028","Total",666,258,70,188,408,49,53,89,111,18,27,61
"2011","Kirklees 006C","E01011030","Total",574,129,35,94,445,71,36,108,93,30,32,75
"2011","Kirklees 006D","E01011031","Total",658,143,87,56,515,15,117,83,141,16,37,106
"2011","Kirklees 006E","E01011054","Total",580,125,60,65,455,14,138,60,128,10,21,84
"2011","Kirklees 007A","E01011013","Total",627,148,102,46,479,12,140,75,134,22,29,67
"2011","Kirklees 007B","E01011014","Total",607,202,54,148,405,34,37,81,111,30,47,65
"2011","Kirklees 007C","E01011023","Total",630,178,58,120,452,17,82,77,99,43,51,83
"2011","Kirklees 007D","E01011024","Total",663,199,51,148,464,40,55,107,87,42,46,87
"2011","Kirklees 008A","E01011067","Total",670,180,85,95,490,31,100,79,142,13,42,83
"2011","Kirklees 008B","E01011247","Total",648,140,53,87,508,32,66,115,173,12,33,77
"2011","Kirklees 008C","E01011249","Total",659,177,93,84,482,47,97,100,115,22,33,68
"2011","Kirklees 008D","E01011251","Total",703,248,103,145,455,69,62,88,103,28,38,67
"2011","Kirklees 009A","E01011245","Total",634,164,52,112,470,26,94,95,117,19,37,82
"2011","Kirklees 009B","E01011246","Total",621,195,63,132,426,49,40,98,109,27,31,72
"2011","Kirklees 009C","E01011248","Total",679,237,141,96,442,26,100,88,113,13,30,72
"2011","Kirklees 009D","E01011250","Total",846,391,105,286,455,46,56,95,171,10,21,56
"2011","Kirklees 010A","E01011015","Total",550,203,105,98,347,23,40,44,51,41,79,69
"2011","Kirklees 010B","E01011029","Total",677,304,104,200,373,43,52,71,95,37,32,43
"2011","Kirklees 010C","E01011032","Total",578,181,81,100,397,45,48,81,80,37,60,46
"2011","Kirklees 010D","E01011034","Total",469,106,45,61,363,24,32,47,54,49,92,65
"2011","Kirklees 011A","E01011157","Total",574,141,37,104,433,26,53,81,103,33,60,77
"2011","Kirklees 011B","E01011161","Total",528,128,42,86,400,25,69,93,99,17,29,68
"2011","Kirklees 011C","E01011163","Total",589,204,96,108,385,55,72,69,69,18,22,80
"2011","Kirklees 011D","E01011164","Total",695,166,82,84,529,34,120,114,129,15,41,76
"2011","Kirklees 011E","E01011165","Total",564,88,22,66,476,25,50,98,94,35,82,92
"2011","Kirklees 011F","E01011166","Total",658,228,82,146,430,27,58,90,117,26,43,69
"2011","Kirklees 011G","E01011167","Total",732,268,94,174,464,54,67,89,93,29,59,73
"2011","Kirklees 012A","E01011033","Total",667,178,64,114,489,31,72,88,133,26,41,98
"2011","Kirklees 012B","E01011035","Total",481,106,39,67,375,23,40,56,47,49,91,69
"2011","Kirklees 012C","E01011036","Total",586,152,53,99,434,51,44,97,77,50,60,55
"2011","Kirklees 012D","E01011037","Total",802,221,52,169,581,53,73,130,159,48,53,65
"2011","Kirklees 013A","E01011016","Total",541,150,32,118,391,14,27,68,101,28,71,82
"2011","Kirklees 013B","E01011017","Total",467,92,52,40,375,20,27,41,46,42,98,101
"2011","Kirklees 013C","E01011018","Total",433,96,44,52,337,15,19,47,44,61,76,75
"2011","Kirklees 013D","E01011019","Total",526,96,40,56,430,13,54,55,83,32,73,120
"2011","Kirklees 013E","E01011020","Total",446,126,32,94,320,28,25,80,59,33,54,41
"2011","Kirklees 014A","E01011021","Total",690,196,78,118,494,22,97,104,127,14,36,94
"2011","Kirklees 014B","E01011022","Total",597,152,73,79,445,20,86,85,113,10,35,96
"2011","Kirklees 014C","E01011126","Total",771,329,133,196,442,37,97,78,125,14,23,68
"2011","Kirklees 014D","E01011127","Total",590,158,72,86,432,21,87,89,106,18,32,79
"2011","Kirklees 015A","E01011156","Total",687,231,127,104,456,17,106,92,126,15,36,64
"2011","Kirklees 015B","E01011158","Total",716,197,66,131,519,39,67,103,153,21,51,85
"2011","Kirklees 015C","E01011159","Total",726,194,89,105,532,26,115,119,142,20,25,85
"2011","Kirklees 015D","E01011160","Total",553,123,34,89,430,23,61,103,122,15,45,61
"2011","Kirklees 015E","E01011162","Total",674,192,103,89,482,23,123,84,145,14,22,71
"2011","Kirklees 016A","E01011025","Total",582,132,41,91,450,72,33,78,106,35,47,79
"2011","Kirklees 016B","E01011026","Total",557,178,94,84,379,19,56,70,87,21,66,60
"2011","Kirklees 016C","E01011136","Total",592,183,65,118,409,51,59,85,94,33,32,55
"2011","Kirklees 016D","E01011137","Total",641,203,58,145,438,58,34,101,128,20,29,68
"2011","Kirklees 017A","E01011128","Total",788,282,66,216,506,43,40,84,149,56,60,74
"2011","Kirklees 017B","E01011130","Total",949,483,119,364,466,43,61,66,176,26,47,47
"2011","Kirklees 017E","E01033542","Total",995,309,96,213,686,32,82,125,151,55,118,123
"2011","Kirklees 018A","E01011121","Total",628,190,46,144,438,59,37,84,134,23,34,67
"2011","Kirklees 018B","E01011122","Total",493,111,32,79,382,68,33,74,60,36,41,70
"2011","Kirklees 018C","E01011123","Total",688,258,89,169,430,31,86,75,116,15,46,61
"2011","Kirklees 018D","E01011124","Total",850,287,105,182,563,49,72,132,193,17,22,78
"2011","Kirklees 018E","E01011125","Total",671,195,102,93,476,51,92,94,114,15,28,82
"2011","Kirklees 018F","E01011129","Total",501,97,34,63,404,28,54,78,94,19,38,93
"2011","Kirklees 019A","E01011138","Total",655,245,57,188,410,67,31,79,78,45,56,54
"2011","Kirklees 019B","E01011139","Total",462,79,30,49,383,14,48,74,76,32,62,77
"2011","Kirklees 019C","E01011140","Total",474,77,25,52,397,51,21,81,62,60,69,53
"2011","Kirklees 019D","E01011141","Total",535,131,38,93,404,19,26,93,64,59,72,71
"2011","Kirklees 020A","E01011132","Total",544,93,63,30,451,10,117,90,82,17,34,101
"2011","Kirklees 020B","E01011142","Total",686,196,93,103,490,19,104,94,146,7,39,81
"2011","Kirklees 020C","E01011217","Total",734,187,116,71,547,24,184,89,147,5,19,79
"2011","Kirklees 020D","E01011218","Total",733,238,125,113,495,33,109,91,137,19,34,72
"2011","Kirklees 021A","E01011216","Total",574,137,74,63,437,16,98,98,106,13,26,80
"2011","Kirklees 021B","E01011219","Total",683,185,77,108,498,19,115,92,146,5,22,99
"2011","Kirklees 021C","E01011220","Total",730,222,92,130,508,66,57,93,130,27,58,77
"2011","Kirklees 021D","E01011221","Total",722,167,95,72,555,32,126,105,149,14,40,89
"2011","Kirklees 022A","E01011046","Total",508,84,56,28,424,10,114,68,105,13,35,79
"2011","Kirklees 022B","E01011100","Total",719,308,136,172,411,58,63,60,113,14,34,69
"2011","Kirklees 022C","E01011102","Total",520,96,38,58,424,18,60,87,115,20,39,85
"2011","Kirklees 022D","E01011108","Total",644,193,65,128,451,37,81,68,144,10,22,89
"2011","Kirklees 023A","E01011133","Total",472,136,36,100,336,30,32,57,53,48,72,44
"2011","Kirklees 023B","E01011134","Total",600,150,32,118,450,62,20,85,65,79,84,55
"2011","Kirklees 023C","E01011143","Total",521,170,36,134,351,37,16,77,60,46,78,37
"2011","Kirklees 023D","E01011144","Total",498,177,61,116,321,35,17,62,49,42,74,42
"2011","Kirklees 023E","E01011260","Total",533,167,55,112,366,26,51,84,87,37,28,53
"2011","Kirklees 024A","E01011257","Total",498,36,9,27,462,6,30,58,34,47,157,130
"2011","Kirklees 024B","E01011258","Total",414,26,15,11,388,6,33,31,25,33,143,117
"2011","Kirklees 024C","E01011259","Total",583,172,56,116,411,30,43,67,90,37,74,70
"2011","Kirklees 024D","E01011261","Total",444,124,37,87,320,27,20,69,51,64,50,39
"2011","Kirklees 024E","E01011262","Total",536,157,63,94,379,42,33,61,58,61,73,51
"2011","Kirklees 024F","E01011263","Total",627,165,66,99,462,33,68,82,117,30,53,79
"2011","Kirklees 025A","E01011101","Total",737,225,49,176,512,145,42,106,104,23,37,55
"2011","Kirklees 025B","E01011103","Total",638,249,85,164,389,73,64,67,98,13,16,58
"2011","Kirklees 025C","E01011104","Total",785,343,113,230,442,75,79,67,115,14,31,61
"2011","Kirklees 025D","E01011105","Total",791,201,60,141,590,97,45,185,132,28,50,53
"2011","Kirklees 026A","E01011212","Total",796,319,182,137,477,38,121,94,122,10,22,70
"2011","Kirklees 026B","E01011213","Total",654,135,91,44,519,22,161,91,117,13,39,76
"2011","Kirklees 026C","E01011214","Total",690,205,67,138,485,34,92,96,156,15,28,64
"2011","Kirklees 026D","E01011215","Total",974,396,148,248,578,38,124,114,195,13,29,65
"2011","Kirklees 027A","E01011039","Total",673,174,90,84,499,22,129,63,91,24,79,91
"2011","Kirklees 027B","E01011042","Total",639,176,67,109,463,19,68,86,148,23,41,78
"2011","Kirklees 027C","E01011047","Total",649,137,83,54,512,8,166,87,122,11,29,89
"2011","Kirklees 027D","E01011210","Total",812,238,69,169,574,36,75,133,177,21,49,83
"2011","Kirklees 028A","E01011252","Total",487,81,38,43,406,12,91,45,154,5,29,70
"2011","Kirklees 028B","E01011253","Total",513,139,64,75,374,38,66,62,89,17,35,67
"2011","Kirklees 028C","E01011254","Total",646,161,90,71,485,4,132,74,154,13,29,79
"2011","Kirklees 028D","E01011255","Total",625,199,68,131,426,62,61,86,97,19,35,66
"2011","Kirklees 028E","E01011256","Total",607,218,96,122,389,31,73,88,94,9,29,65
"2011","Kirklees 029A","E01011038","Total",684,256,100,156,428,88,54,107,66,28,32,53
"2011","Kirklees 029B","E01011041","Total",662,268,65,203,394,59,49,63,96,26,38,63
"2011","Kirklees 029C","E01011106","Total",680,243,78,165,437,102,32,101,111,13,32,46
"2011","Kirklees 029D","E01011107","Total",826,381,48,333,445,69,35,81,119,24,30,87
"2011","Kirklees 030A","E01011201","Total",883,392,193,199,491,43,84,104,190,9,22,39
"2011","Kirklees 030B","E01011203","Total",728,168,96,72,560,33,118,139,115,13,40,102
"2011","Kirklees 030C","E01011209","Total",640,142,96,46,498,15,133,97,113,18,38,84
"2011","Kirklees 030D","E01011211","Total",680,188,102,86,492,18,139,81,127,19,32,76
"2011","Kirklees 031A","E01011040","Total",682,219,44,175,463,39,28,81,118,42,63,92
"2011","Kirklees 031B","E01011043","Total",889,327,68,259,562,44,42,85,138,38,92,123
"2011","Kirklees 031C","E01011044","Total",543,144,47,97,399,27,51,83,79,31,63,65
"2011","Kirklees 031D","E01011045","Total",725,300,83,217,425,34,47,60,90,40,75,79
"2011","Kirklees 032A","E01011089","Total",603,193,98,95,410,46,99,74,108,6,23,54
"2011","Kirklees 032B","E01011091","Total",573,105,49,56,468,29,85,106,131,14,34,69
"2011","Kirklees 032C","E01011092","Total",568,148,80,68,420,5,111,71,136,11,19,67
"2011","Kirklees 032D","E01011200","Total",906,176,52,124,730,45,71,204,233,20,54,103
"2011","Kirklees 033A","E01011204","Total",545,113,62,51,432,10,117,75,93,15,46,76
"2011","Kirklees 033B","E01011206","Total",805,331,114,217,474,38,83,99,148,13,40,53
"2011","Kirklees 033C","E01011208","Total",773,306,91,215,467,58,74,95,149,15,20,56
"2011","Kirklees 033D","E01011240","Total",757,274,112,162,483,43,85,92,129,16,47,71
"2011","Kirklees 034A","E01011231","Total",751,285,111,174,466,39,84,75,176,15,20,57
"2011","Kirklees 034B","E01011236","Total",779,420,52,368,359,18,20,45,130,17,30,99
"2011","Kirklees 034C","E01011238","Total",751,346,96,250,405,17,74,52,136,14,38,74
"2011","Kirklees 034D","E01011239","Total",691,255,86,169,436,21,58,73,141,20,49,74
"2011","Kirklees 035A","E01011093","Total",681,275,58,217,406,97,42,55,107,19,26,60
"2011","Kirklees 035B","E01011094","Total",674,270,120,150,404,77,61,67,61,18,45,75
"2011","Kirklees 035C","E01011096","Total",615,165,93,72,450,34,73,61,118,18,55,91
"2011","Kirklees 035D","E01011098","Total",669,240,58,182,429,37,44,80,135,13,25,95
"2011","Kirklees 036A","E01011146","Total",638,141,66,75,497,22,65,100,169,11,34,96
"2011","Kirklees 036B","E01011151","Total",648,143,53,90,505,22,81,116,151,18,36,81
"2011","Kirklees 036C","E01011202","Total",710,260,156,104,450,30,105,74,120,11,36,74
"2011","Kirklees 036D","E01011205","Total",696,196,71,125,500,25,86,93,159,8,38,91
"2011","Kirklees 037A","E01011090","Total",677,219,85,134,458,40,90,91,109,14,31,83
"2011","Kirklees 037B","E01011095","Total",628,195,107,88,433,30,106,72,116,10,27,72
"2011","Kirklees 037C","E01011097","Total",697,265,111,154,432,31,71,84,113,12,37,84
"2011","Kirklees 037D","E01011099","Total",621,158,77,81,463,35,100,97,105,11,28,87
"2011","Kirklees 038A","E01011150","Total",694,198,71,127,496,34,64,103,176,13,33,73
"2011","Kirklees 038B","E01011155","Total",873,292,75,217,581,39,98,124,209,14,22,75
"2011","Kirklees 038C","E01011207","Total",606,133,77,56,473,26,115,95,115,15,37,70
"2011","Kirklees 038D","E01011234","Total",703,278,81,197,425,62,56,87,110,15,27,68
"2011","Kirklees 039A","E01011232","Total",675,320,99,221,355,30,51,36,84,14,59,81
"2011","Kirklees 039B","E01011233","Total",647,190,64,126,457,26,59,129,113,24,44,62
"2011","Kirklees 039C","E01011235","Total",869,468,132,336,401,33,51,32,125,13,46,101
"2011","Kirklees 039D","E01011237","Total",647,208,60,148,439,65,49,82,98,30,58,57
"2011","Kirklees 040A","E01011004","Total",710,343,169,174,367,57,77,63,100,6,23,41
"2011","Kirklees 040B","E01011006","Total",651,198,113,85,453,40,81,76,121,13,34,88
"2011","Kirklees 040C","E01011008","Total",642,213,43,170,429,34,35,79,148,16,25,92
"2011","Kirklees 040D","E01011012","Total",710,202,82,120,508,52,72,116,139,14,25,90
"2011","Kirklees 041A","E01011145","Total",637,159,69,90,478,25,95,108,126,9,33,82
"2011","Kirklees 041B","E01011147","Total",637,171,56,115,466,39,54,99,154,12,24,84
"2011","Kirklees 041C","E01011148","Total",761,317,128,189,444,69,69,65,110,27,28,76
"2011","Kirklees 041D","E01011152","Total",777,238,54,184,539,47,61,112,224,9,26,60
"2011","Kirklees 042A","E01011007","Total",659,228,61,167,431,32,59,76,147,13,23,81
"2011","Kirklees 042B","E01011223","Total",726,198,62,136,528,84,58,116,139,28,20,83
"2011","Kirklees 042C","E01011225","Total",733,196,51,145,537,76,54,78,166,16,24,123
"2011","Kirklees 042D","E01011229","Total",936,540,101,439,396,21,24,37,190,16,31,77
"2011","Kirklees 043A","E01011080","Total",775,270,74,196,505,66,46,105,123,35,57,73
"2011","Kirklees 043B","E01011081","Total",729,301,65,236,428,42,36,76,119,27,65,63
"2011","Kirklees 043C","E01011082","Total",481,106,28,78,375,23,12,62,48,50,115,65
"2011","Kirklees 043D","E01011230","Total",559,103,35,68,456,35,35,74,52,65,110,85
"2011","Kirklees 044A","E01011005","Total",670,194,123,71,476,18,139,75,125,10,29,80
"2011","Kirklees 044B","E01011009","Total",612,208,90,118,404,33,105,67,107,10,20,62
"2011","Kirklees 044C","E01011010","Total",647,185,83,102,462,67,70,79,117,25,37,67
"2011","Kirklees 044D","E01011011","Total",695,188,102,86,507,11,144,88,142,20,26,76
"2011","Kirklees 045A","E01011077","Total",717,217,66,151,500,35,72,97,172,15,32,77
"2011","Kirklees 045B","E01011149","Total",923,412,70,342,511,59,44,111,173,14,26,84
"2011","Kirklees 045C","E01011153","Total",755,228,93,135,527,47,97,92,155,13,42,81
"2011","Kirklees 045D","E01011154","Total",633,176,54,122,457,53,48,113,124,32,26,61
"2011","Kirklees 046A","E01011191","Total",662,164,86,78,498,22,115,102,125,20,28,86
"2011","Kirklees 046B","E01011192","Total",712,240,118,122,472,32,96,98,133,22,32,59
"2011","Kirklees 046C","E01011193","Total",785,161,65,96,624,38,109,152,193,20,28,84
"2011","Kirklees 046D","E01011194","Total",599,142,99,43,457,10,139,69,137,12,24,66
"2011","Kirklees 047A","E01011079","Total",875,382,127,255,493,58,61,88,147,25,44,70
"2011","Kirklees 047B","E01011083","Total",713,195,101,94,518,29,103,106,124,28,47,81
"2011","Kirklees 047C","E01011084","Total",641,160,34,126,481,88,28,92,92,58,50,73
"2011","Kirklees 047D","E01011085","Total",691,234,124,110,457,37,120,78,104,17,32,69
"2011","Kirklees 048A","E01011224","Total",750,279,100,179,471,61,58,93,137,12,25,85
"2011","Kirklees 048B","E01011226","Total",649,171,93,78,478,26,105,71,127,14,46,89
"2011","Kirklees 048C","E01011227","Total",842,404,180,224,438,64,87,58,129,7,32,61
"2011","Kirklees 048D","E01011228","Total",642,186,77,109,456,20,95,74,127,13,38,89
"2011","Kirklees 049A","E01011071","Total",702,172,81,91,530,40,106,97,134,12,39,102
"2011","Kirklees 049B","E01011072","Total",662,174,69,105,488,31,70,128,128,6,29,96
"2011","Kirklees 049C","E01011073","Total",678,222,65,157,456,45,86,96,136,11,26,56
"2011","Kirklees 049D","E01011078","Total",834,323,107,216,511,37,84,135,184,17,17,37
"2011","Kirklees 050A","E01011086","Total",719,193,114,79,526,13,167,92,131,16,20,87
"2011","Kirklees 050B","E01011087","Total",769,295,138,157,474,47,100,88,133,9,25,72
"2011","Kirklees 050C","E01011088","Total",606,144,93,51,462,11,130,81,123,7,20,90
"2011","Kirklees 050D","E01011222","Total",1003,514,100,414,489,51,82,77,188,5,18,68
"2011","Kirklees 051A","E01011190","Total",729,203,74,129,526,17,124,94,175,13,23,80
"2011","Kirklees 051B","E01011195","Total",447,110,57,53,337,5,95,65,82,12,20,58
"2011","Kirklees 051C","E01011196","Total",726,154,66,88,572,6,104,144,168,23,36,91
"2011","Kirklees 051D","E01011197","Total",667,199,83,116,468,34,85,89,135,13,25,87
"2011","Kirklees 052A","E01011070","Total",661,146,65,81,515,27,100,121,158,13,25,71
"2011","Kirklees 052B","E01011074","Total",832,233,101,132,599,28,93,145,193,20,28,92
"2011","Kirklees 052C","E01011075","Total",662,229,94,135,433,22,92,76,137,19,20,67
"2011","Kirklees 052D","E01011076","Total",626,157,66,91,469,32,96,91,129,17,18,86
"2011","Kirklees 053A","E01011169","Total",607,138,69,69,469,11,112,96,134,10,29,77
"2011","Kirklees 053B","E01011170","Total",740,168,82,86,572,16,106,139,155,20,38,98
"2011","Kirklees 053C","E01011171","Total",632,210,65,145,422,16,71,104,136,7,26,62
"2011","Kirklees 053D","E01011172","Total",531,265,185,80,266,26,65,44,65,9,23,34
"2011","Kirklees 053E","E01011173","Total",525,109,65,44,416,13,102,101,101,14,27,58
"2011","Kirklees 053F","E01011176","Total",577,131,63,68,446,16,104,99,108,19,27,73
"2011","Kirklees 054A","E01011109","Total",723,151,55,96,572,36,88,113,182,28,35,90
"2011","Kirklees 054B","E01011113","Total",740,186,86,100,554,18,141,107,157,13,31,87
"2011","Kirklees 054C","E01011114","Total",688,242,142,100,446,31,101,75,117,20,24,78
"2011","Kirklees 054D","E01011119","Total",660,179,96,83,481,23,127,85,144,12,32,58
"2011","Kirklees 055A","E01011168","Total",672,150,83,67,522,16,137,94,132,18,38,87
"2011","Kirklees 055B","E01011174","Total",704,135,60,75,569,16,122,118,165,14,50,84
"2011","Kirklees 055C","E01011175","Total",598,159,69,90,439,58,69,78,112,25,32,65
"2011","Kirklees 055D","E01011177","Total",722,163,76,87,559,25,118,106,185,18,31,76
"2011","Kirklees 055E","E01011178","Total",871,338,156,182,533,37,109,86,160,25,48,68
"2011","Kirklees 056A","E01011118","Total",634,142,58,84,492,18,81,133,149,12,34,65
"2011","Kirklees 056B","E01011120","Total",592,103,47,56,489,13,78,123,132,27,37,79
"2011","Kirklees 056C","E01011198","Total",662,164,85,79,498,17,118,119,133,17,19,75
"2011","Kirklees 056D","E01011199","Total",621,153,90,63,468,32,90,116,109,16,30,75
"2011","Kirklees 057A","E01011110","Total",584,155,53,102,429,16,100,103,108,11,21,70
"2011","Kirklees 057B","E01011111","Total",643,144,76,68,499,27,97,99,137,17,41,81
"2011","Kirklees 057C","E01011112","Total",667,155,80,75,512,39,87,113,152,11,32,78
"2011","Kirklees 057D","E01011115","Total",772,214,80,134,558,22,110,132,175,20,22,77
"2011","Kirklees 057E","E01011116","Total",691,144,67,77,547,27,128,106,144,12,27,103
"2011","Kirklees 057F","E01011117","Total",729,152,83,69,577,24,124,124,169,18,45,73
"2011","Kirklees 058A","E01011180","Total",799,188,89,99,611,30,112,147,176,15,33,98
"2011","Kirklees 058B","E01011182","Total",766,233,98,135,533,25,89,123,181,20,29,66
"2011","Kirklees 058C","E01011186","Total",678,183,97,86,495,22,125,78,141,14,36,79
"2011","Kirklees 058D","E01011188","Total",699,167,90,77,532,27,117,109,141,17,45,76
"2011","Kirklees 059A","E01011179","Total",765,186,63,123,579,29,120,126,182,9,35,78
"2011","Kirklees 059B","E01011181","Total",846,304,84,220,542,30,85,119,205,15,31,57
"2011","Kirklees 059C","E01011183","Total",793,172,46,126,621,20,94,161,186,22,48,90
"2011","Kirklees 059D","E01011184","Total",582,142,66,76,440,40,78,84,102,21,40,75
"2011","Kirklees 059E","E01011185","Total",701,216,104,112,485,33,96,115,142,10,32,57
"2011","Kirklees 059F","E01011187","Total",685,139,55,84,546,28,101,110,130,34,39,104
"2011","Kirklees 059G","E01011189","Total",675,148,78,70,527,11,126,109,159,21,14,87
"2011","Leeds 001A","E01011698","Total",634,158,74,84,476,26,120,73,122,19,33,83
"2011","Leeds 001B","E01011699","Total",583,138,71,67,445,12,122,77,133,15,17,69
"2011","Leeds 001C","E01011701","Total",529,125,73,52,404,14,94,73,113,17,30,63
"2011","Leeds 001D","E01011702","Total",483,84,58,26,399,7,126,61,97,16,24,68
"2011","Leeds 001E","E01011703","Total",556,123,81,42,433,3,167,63,100,9,27,64
"2011","Leeds 002A","E01011697","Total",558,151,78,73,407,19,96,90,120,18,13,51
"2011","Leeds 002B","E01011700","Total",500,154,89,65,346,8,96,70,86,4,21,61
"2011","Leeds 002C","E01011704","Total",985,488,281,207,497,33,138,89,168,10,11,48
"2011","Leeds 002D","E01011705","Total",636,221,144,77,415,43,97,78,102,19,21,55
"2011","Leeds 003A","E01011581","Total",626,156,88,68,470,25,132,84,113,15,27,74
"2011","Leeds 003B","E01011582","Total",752,293,171,122,459,36,80,102,128,24,35,54
"2011","Leeds 003C","E01011583","Total",601,129,74,55,472,33,103,80,121,16,34,85
"2011","Leeds 003D","E01011584","Total",555,177,104,73,378,32,87,63,94,16,27,59
"2011","Leeds 004A","E01011569","Total",804,310,107,203,494,23,93,106,165,11,23,73
"2011","Leeds 004B","E01011571","Total",758,287,137,150,471,23,96,74,171,16,28,63
"2011","Leeds 004C","E01011572","Total",816,273,96,177,543,32,71,114,205,17,24,80
"2011","Leeds 004D","E01011573","Total",536,114,62,52,422,16,85,73,122,15,34,77
"2011","Leeds 004E","E01011574","Total",711,301,175,126,410,19,92,79,136,13,13,58
"2011","Leeds 005A","E01011707","Total",616,194,136,58,422,10,127,81,106,17,24,57
"2011","Leeds 005B","E01011709","Total",660,176,110,66,484,5,157,107,107,23,29,56
"2011","Leeds 005C","E01011710","Total",638,197,99,98,441,22,76,96,153,18,23,53
"2011","Leeds 005D","E01011711","Total",656,228,136,92,428,18,128,79,116,9,26,52
"2011","Leeds 005E","E01011712","Total",586,145,68,77,441,19,91,73,152,8,30,68
"2011","Leeds 006A","E01011561","Total",533,162,72,90,371,14,75,64,116,13,23,66
"2011","Leeds 006B","E01011696","Total",656,182,126,56,474,11,154,86,113,22,25,63
"2011","Leeds 006C","E01011706","Total",616,140,75,65,476,16,137,114,99,23,23,64
"2011","Leeds 006D","E01011708","Total",612,144,72,72,468,16,118,83,120,15,40,76
"2011","Leeds 006E","E01011713","Total",737,153,66,87,584,23,145,129,137,24,40,86
"2011","Leeds 007A","E01011570","Total",959,264,122,142,695,25,148,193,187,34,32,76
"2011","Leeds 007C","E01011576","Total",594,146,86,60,448,8,133,71,112,14,42,68
"2011","Leeds 007E","E01032503","Total",600,157,73,84,443,13,101,95,117,17,31,69
"2011","Leeds 007F","E01032504","Total",673,177,136,41,496,13,154,113,105,13,33,65
"2011","Leeds 008A","E01011266","Total",893,255,52,203,638,26,97,141,228,19,35,92
"2011","Leeds 008B","E01011270","Total",649,118,66,52,531,7,164,96,128,22,42,72
"2011","Leeds 008C","E01011279","Total",573,169,86,83,404,20,91,101,110,8,12,62
"2011","Leeds 008D","E01011280","Total",715,151,59,92,564,30,106,127,164,25,27,85
"2011","Leeds 009A","E01011265","Total",748,303,168,135,445,27,63,94,165,10,24,62
"2011","Leeds 009B","E01011267","Total",666,218,116,102,448,33,98,89,117,24,17,70
"2011","Leeds 009C","E01011271","Total",903,234,103,131,669,34,120,181,178,21,39,96
"2011","Leeds 009D","E01011272","Total",571,81,39,42,490,20,89,118,130,18,31,84
"2011","Leeds 010A","E01011268","Total",615,214,76,138,401,48,65,77,102,22,33,54
"2011","Leeds 010B","E01011273","Total",700,265,87,178,435,25,77,88,152,10,21,62
"2011","Leeds 010C","E01011274","Total",680,274,128,146,406,38,76,90,111,19,23,49
"2011","Leeds 010D","E01011275","Total",602,188,85,103,414,30,86,80,123,11,19,65
"2011","Leeds 011A","E01011264","Total",565,159,91,68,406,16,101,66,110,11,23,79
"2011","Leeds 011B","E01011269","Total",735,265,133,132,470,36,114,78,138,11,29,64
"2011","Leeds 011C","E01011276","Total",611,182,66,116,429,31,72,91,138,13,21,63
"2011","Leeds 011D","E01011578","Total",625,213,107,106,412,30,89,57,141,9,23,63
"2011","Leeds 012A","E01011554","Total",603,150,76,74,453,20,115,89,110,22,24,73
"2011","Leeds 012B","E01011562","Total",628,137,87,50,491,14,136,83,99,13,45,101
"2011","Leeds 012C","E01011563","Total",618,167,99,68,451,4,168,81,93,12,33,60
"2011","Leeds 012D","E01011564","Total",605,141,75,66,464,10,105,99,116,23,28,83
"2011","Leeds 012E","E01011567","Total",562,138,69,69,424,15,79,94,112,19,27,78
"2011","Leeds 013A","E01011376","Total",623,127,77,50,496,12,124,97,125,10,28,100
"2011","Leeds 013B","E01011377","Total",607,173,124,49,434,8,150,73,79,7,34,83
"2011","Leeds 013C","E01011378","Total",685,306,74,232,379,37,62,69,114,20,21,56
"2011","Leeds 013D","E01011382","Total",662,201,121,80,461,21,122,100,125,14,19,60
"2011","Leeds 014A","E01011277","Total",607,136,39,97,471,32,48,138,148,12,28,65
"2011","Leeds 014B","E01011278","Total",716,204,91,113,512,28,90,128,156,13,16,81
"2011","Leeds 014C","E01011579","Total",493,102,51,51,391,25,59,102,108,10,26,61
"2011","Leeds 014D","E01011580","Total",603,177,104,73,426,11,97,90,128,10,21,69
"2011","Leeds 015A","E01011556","Total",759,305,105,200,454,36,73,126,136,13,23,47
"2011","Leeds 015B","E01011557","Total",646,220,108,112,426,14,97,74,97,15,44,85
"2011","Leeds 015C","E01011565","Total",592,151,90,61,441,21,106,91,107,11,28,77
"2011","Leeds 015D","E01011566","Total",569,186,76,110,383,24,74,81,95,18,19,72
"2011","Leeds 015E","E01011568","Total",861,320,133,187,541,20,123,89,173,16,39,81
"2011","Leeds 016A","E01011380","Total",679,204,96,108,475,15,133,89,130,13,27,68
"2011","Leeds 016B","E01011381","Total",509,113,68,45,396,17,92,63,90,12,42,80
"2011","Leeds 016C","E01011385","Total",525,152,84,68,373,12,87,64,103,13,32,62
"2011","Leeds 016D","E01011386","Total",621,188,85,103,433,12,100,91,118,17,24,71
"2011","Leeds 017A","E01011379","Total",768,342,133,209,426,44,90,85,135,15,22,35
"2011","Leeds 017B","E01011384","Total",660,210,88,122,450,30,92,88,122,12,31,75
"2011","Leeds 017E","E01032501","Total",498,120,62,58,378,23,86,63,116,17,18,55
"2011","Leeds 017F","E01032502","Total",801,265,77,188,536,93,63,114,133,22,24,87
"2011","Leeds 018A","E01011555","Total",561,123,48,75,438,12,108,72,118,12,34,82
"2011","Leeds 018B","E01011558","Total",722,274,99,175,448,76,62,89,110,26,33,52
"2011","Leeds 018C","E01011559","Total",568,225,105,120,343,54,34,73,84,13,27,58
"2011","Leeds 018D","E01011560","Total",883,391,133,258,492,78,68,91,138,16,37,64
"2011","Leeds 019A","E01011383","Total",742,283,160,123,459,21,100,73,145,20,31,69
"2011","Leeds 019B","E01011388","Total",643,240,136,104,403,13,90,79,106,17,35,63
"2011","Leeds 019C","E01011684","Total",638,183,85,98,455,30,82,75,115,16,39,98
"2011","Leeds 019D","E01011695","Total",704,278,96,182,426,85,56,86,94,17,26,62
"2011","Leeds 020A","E01011650","Total",594,177,68,109,417,13,77,83,123,17,34,70
"2011","Leeds 020B","E01011651","Total",637,206,62,144,431,30,55,115,135,18,16,62
"2011","Leeds 020C","E01011653","Total",606,245,96,149,361,17,43,68,115,11,27,80
"2011","Leeds 020D","E01011655","Total",703,313,146,167,390,12,89,69,152,15,22,31
"2011","Leeds 021A","E01011455","Total",481,102,65,37,379,12,105,93,87,10,20,52
"2011","Leeds 021B","E01011456","Total",728,226,95,131,502,10,142,108,107,21,35,79
"2011","Leeds 021C","E01011459","Total",743,247,116,131,496,19,125,82,168,12,25,65
"2011","Leeds 021D","E01011461","Total",611,125,85,40,486,13,141,94,97,19,42,80
"2011","Leeds 022A","E01011311","Total",463,68,40,28,395,12,97,85,89,14,27,71
"2011","Leeds 022B","E01011649","Total",647,172,90,82,475,12,131,92,139,10,22,69
"2011","Leeds 022C","E01011715","Total",527,130,65,65,397,16,94,72,103,14,27,71
"2011","Leeds 022D","E01011719","Total",628,151,103,48,477,22,152,75,125,4,28,71
"2011","Leeds 023A","E01011509","Total",637,257,158,99,380,9,97,73,105,12,31,53
"2011","Leeds 023B","E01011511","Total",529,179,116,63,350,8,60,74,78,13,44,73
"2011","Leeds 023C","E01011512","Total",654,212,77,135,442,26,70,73,130,17,39,87
"2011","Leeds 023D","E01011515","Total",652,222,79,143,430,20,75,60,162,18,27,68
"2011","Leeds 023E","E01011516","Total",644,138,62,76,506,14,73,129,121,19,45,105
"2011","Leeds 024A","E01011508","Total",463,80,36,44,383,7,23,98,91,25,59,80
"2011","Leeds 024B","E01011517","Total",731,249,66,183,482,42,59,97,156,17,40,71
"2011","Leeds 024C","E01011652","Total",501,117,40,77,384,18,47,81,114,11,41,72
"2011","Leeds 024D","E01011654","Total",530,98,52,46,432,15,60,128,108,20,30,71
"2011","Leeds 025A","E01011505","Total",658,178,99,79,480,31,99,95,115,10,47,83
"2011","Leeds 025B","E01011506","Total",513,121,50,71,392,10,52,98,80,21,39,92
"2011","Leeds 025C","E01011507","Total",660,172,85,87,488,17,83,99,160,11,36,82
"2011","Leeds 025D","E01011510","Total",865,477,223,254,388,54,87,68,99,13,20,47
"2011","Leeds 025E","E01011514","Total",632,163,63,100,469,13,72,85,148,21,40,90
"2011","Leeds 027A","E01011452","Total",616,136,53,83,480,7,104,117,138,23,27,64
"2011","Leeds 027B","E01011454","Total",669,184,68,116,485,21,69,110,191,11,16,67
"2011","Leeds 027C","E01011457","Total",591,141,71,70,450,11,96,105,113,22,26,77
"2011","Leeds 027D","E01011458","Total",556,120,66,54,436,13,108,105,104,16,24,66
"2011","Leeds 027E","E01011465","Total",785,335,172,163,450,27,86,71,181,11,11,63
"2011","Leeds 028A","E01011453","Total",661,189,89,100,472,17,107,91,153,18,20,66
"2011","Leeds 028B","E01011460","Total",655,247,84,163,408,27,47,77,159,15,24,59
"2011","Leeds 028C","E01011462","Total",699,207,97,110,492,39,75,87,149,16,37,89
"2011","Leeds 028D","E01011463","Total",749,273,145,128,476,39,84,83,159,15,28,68
"2011","Leeds 028E","E01011464","Total",821,270,68,202,551,27,71,93,269,10,15,66
"2011","Leeds 029A","E01011714","Total",605,142,81,61,463,35,90,76,117,16,36,93
"2011","Leeds 029B","E01011716","Total",607,152,73,79,455,12,129,70,103,12,40,89
"2011","Leeds 029C","E01011717","Total",655,204,109,95,451,61,77,68,114,16,35,80
"2011","Leeds 029D","E01011718","Total",601,201,66,135,400,45,49,89,107,18,25,67
"2011","Leeds 029E","E01011720","Total",691,258,130,128,433,42,82,60,131,21,32,65
"2011","Leeds 030A","E01011296","Total",771,207,140,67,564,18,187,103,154,10,16,76
"2011","Leeds 030B","E01011297","Total",632,149,71,78,483,23,84,114,130,21,34,77
"2011","Leeds 030C","E01011309","Total",654,171,81,90,483,26,115,91,142,14,21,74
"2011","Leeds 030D","E01011310","Total",716,230,116,114,486,17,129,100,124,19,30,67
"2011","Leeds 031A","E01011513","Total",936,270,70,200,666,44,70,174,229,30,31,88
"2011","Leeds 031B","E01011688","Total",608,152,35,117,456,27,50,118,143,12,34,72
"2011","Leeds 031C","E01011689","Total",765,308,132,176,457,23,98,84,145,15,19,73
"2011","Leeds 031D","E01011691","Total",645,210,84,126,435,65,55,71,106,16,27,95
"2011","Leeds 032A","E01011504","Total",749,388,111,277,361,71,56,64,95,8,21,46
"2011","Leeds 032B","E01011641","Total",618,175,68,107,443,14,63,116,118,26,23,83
"2011","Leeds 032C","E01011642","Total",487,128,48,80,359,21,54,67,93,22,39,63
"2011","Leeds 032D","E01011645","Total",608,214,73,141,394,22,45,102,119,11,35,60
"2011","Leeds 033A","E01011484","Total",671,236,94,142,435,63,51,104,101,24,32,60
"2011","Leeds 033B","E01011485","Total",746,317,98,219,429,54,58,81,140,7,34,55
"2011","Leeds 033E","E01011686","Total",810,376,148,228,434,61,79,75,130,14,28,47
"2011","Leeds 033F","E01032493","Total",619,203,68,135,416,21,64,80,154,10,16,71
"2011","Leeds 033G","E01032494","Total",716,212,72,140,504,71,48,86,141,24,43,91
"2011","Leeds 034A","E01011350","Total",713,223,77,146,490,16,71,105,176,12,38,72
"2011","Leeds 034B","E01011351","Total",878,350,103,247,528,18,60,72,279,5,11,83
"2011","Leeds 034C","E01011352","Total",887,397,117,280,490,18,45,65,226,7,17,112
"2011","Leeds 034D","E01011353","Total",822,235,70,165,587,26,53,106,259,21,33,89
"2011","Leeds 035A","E01011656","Total",597,166,56,110,431,89,32,83,89,27,24,87
"2011","Leeds 035B","E01011657","Total",602,235,69,166,367,57,41,69,95,14,21,70
"2011","Leeds 035C","E01011659","Total",648,278,88,190,370,41,57,65,109,10,36,52
"2011","Leeds 035D","E01011661","Total",852,464,208,256,388,47,83,53,103,13,26,63
"2011","Leeds 037A","E01011643","Total",594,212,109,103,382,21,82,64,112,11,26,66
"2011","Leeds 037B","E01011644","Total",542,204,78,126,338,24,82,58,90,10,28,46
"2011","Leeds 037C","E01011646","Total",644,179,75,104,465,32,65,98,117,26,46,81
"2011","Leeds 037D","E01011647","Total",498,103,40,63,395,27,42,56,64,30,102,74
"2011","Leeds 037E","E01011648","Total",566,113,58,55,453,24,76,77,78,35,83,80
"2011","Leeds 038A","E01011354","Total",624,228,40,188,396,91,41,75,84,8,37,60
"2011","Leeds 038B","E01011355","Total",576,174,77,97,402,55,42,69,115,23,26,72
"2011","Leeds 038C","E01011357","Total",880,397,101,296,483,111,37,88,107,30,45,65
"2011","Leeds 038D","E01011450","Total",523,163,49,114,360,25,50,70,108,13,26,68
"2011","Leeds 039A","E01011588","Total",691,164,62,102,527,30,72,141,169,18,28,69
"2011","Leeds 039B","E01011589","Total",699,229,89,140,470,17,77,125,171,17,15,48
"2011","Leeds 039C","E01011590","Total",639,142,61,81,497,21,117,108,148,11,28,64
"2011","Leeds 039D","E01011592","Total",719,291,111,180,428,12,84,77,174,13,9,59
"2011","Leeds 039E","E01011593","Total",789,218,70,148,571,29,103,105,210,14,30,80
"2011","Leeds 040A","E01011421","Total",607,203,103,100,404,36,74,64,80,22,51,77
"2011","Leeds 040B","E01011425","Total",606,157,64,93,449,30,80,90,81,17,35,116
"2011","Leeds 040C","E01011658","Total",631,259,135,124,372,100,63,49,74,14,27,45
"2011","Leeds 040D","E01011660","Total",588,221,94,127,367,51,58,74,84,19,25,56
"2011","Leeds 040E","E01011662","Total",496,179,33,146,317,68,24,56,69,20,35,45
"2011","Leeds 041A","E01011721","Total",621,178,78,100,443,72,77,85,89,30,26,64
"2011","Leeds 041B","E01011722","Total",812,276,108,168,536,57,57,116,170,22,45,69
"2011","Leeds 041C","E01011723","Total",617,212,133,79,405,87,64,65,87,13,36,53
"2011","Leeds 041D","E01011724","Total",830,305,110,195,525,73,75,107,147,19,38,66
"2011","Leeds 042A","E01011356","Total",897,385,71,314,512,49,52,78,164,11,50,108
"2011","Leeds 042B","E01011358","Total",695,304,126,178,391,62,55,64,106,15,27,62
"2011","Leeds 042C","E01011359","Total",745,311,51,260,434,39,42,69,136,22,38,88
"2011","Leeds 042D","E01011360","Total",722,241,71,170,481,92,40,63,67,45,90,84
"2011","Leeds 042E","E01011361","Total",1090,510,98,412,580,109,51,89,127,39,67,98
"2011","Leeds 044A","E01011435","Total",562,130,23,107,432,2,11,12,107,0,8,292
"2011","Leeds 044D","E01011440","Total",611,210,68,142,401,3,18,12,143,1,4,220
"2011","Leeds 044E","E01011441","Total",649,191,30,161,458,10,15,26,112,9,18,268
"2011","Leeds 044F","E01032945","Total",848,172,34,138,676,0,25,26,115,3,18,489
"2011","Leeds 045A","E01011477","Total",866,355,81,274,511,48,53,80,184,28,25,93
"2011","Leeds 045B","E01011480","Total",624,149,75,74,475,5,99,60,130,16,35,130
"2011","Leeds 045C","E01011488","Total",666,216,68,148,450,38,36,54,199,6,11,106
"2011","Leeds 045D","E01011489","Total",823,339,118,221,484,43,70,56,183,7,26,99
"2011","Leeds 046A","E01011324","Total",510,177,38,139,333,69,18,72,63,24,30,57
"2011","Leeds 046B","E01011325","Total",653,210,58,152,443,44,51,92,158,7,31,60
"2011","Leeds 046C","E01011326","Total",575,155,69,86,420,67,53,76,119,16,29,60
"2011","Leeds 046D","E01011332","Total",558,195,57,138,363,50,53,70,95,19,30,46
"2011","Leeds 047A","E01011423","Total",607,169,70,99,438,76,50,91,73,29,49,70
"2011","Leeds 047B","E01011424","Total",516,99,32,67,417,63,47,91,55,52,57,52
"2011","Leeds 047C","E01011427","Total",563,142,47,95,421,70,26,71,60,63,75,56
"2011","Leeds 047D","E01011431","Total",769,280,82,198,489,108,42,88,99,38,58,56
"2011","Leeds 048A","E01011422","Total",495,186,21,165,309,29,15,39,43,37,81,65
"2011","Leeds 048B","E01011426","Total",493,140,38,102,353,31,19,68,45,49,96,45
"2011","Leeds 048C","E01011428","Total",601,168,39,129,433,41,18,83,73,47,80,91
"2011","Leeds 048D","E01011429","Total",693,277,65,212,416,54,28,47,60,45,103,79
"2011","Leeds 050A","E01011663","Total",430,81,26,55,349,81,14,87,63,23,41,40
"2011","Leeds 050B","E01011664","Total",477,148,83,65,329,46,53,63,74,10,24,59
"2011","Leeds 050C","E01011665","Total",626,228,68,160,398,34,73,61,120,11,41,58
"2011","Leeds 050D","E01011667","Total",511,102,46,56,409,130,16,80,59,29,45,50
"2011","Leeds 051A","E01011323","Total",576,200,123,77,376,21,94,59,94,12,26,70
"2011","Leeds 051B","E01011329","Total",662,180,72,108,482,26,88,75,175,9,30,79
"2011","Leeds 051C","E01011330","Total",556,164,62,102,392,38,78,72,109,11,32,52
"2011","Leeds 051D","E01011333","Total",559,160,63,97,399,44,71,80,107,8,19,70
"2011","Leeds 052A","E01011327","Total",624,245,55,190,379,33,43,75,131,13,26,58
"2011","Leeds 052B","E01011328","Total",665,204,92,112,461,53,71,97,137,17,20,66
"2011","Leeds 052C","E01011335","Total",792,263,79,184,529,59,65,100,205,12,27,61
"2011","Leeds 052D","E01011591","Total",810,275,57,218,535,25,68,102,266,8,9,57
"2011","Leeds 053A","E01011430","Total",451,106,26,80,345,37,23,62,42,42,71,68
"2011","Leeds 053B","E01011432","Total",571,203,35,168,368,66,17,79,59,43,61,43
"2011","Leeds 053C","E01011433","Total",668,268,36,232,400,96,15,82,95,28,31,53
"2011","Leeds 053D","E01011434","Total",612,234,30,204,378,78,17,99,96,31,18,39
"2011","Leeds 054A","E01011445","Total",436,48,1,47,388,4,2,7,61,1,10,303
"2011","Leeds 054B","E01011446","Total",465,117,5,112,348,6,7,13,43,5,17,257
"2011","Leeds 054C","E01011447","Total",405,84,14,70,321,9,8,9,48,5,15,227
"2011","Leeds 054D","E01011448","Total",460,113,21,92,347,28,8,15,57,9,16,214
"2011","Leeds 054E","E01011449","Total",566,140,19,121,426,32,13,19,200,12,9,141
"2011","Leeds 055A","E01011670","Total",916,401,100,301,515,73,60,62,139,25,27,129
"2011","Leeds 055B","E01011671","Total",644,214,48,166,430,94,45,63,92,17,35,84
"2011","Leeds 055F","E01033002","Total",761,414,102,312,347,24,21,70,182,10,5,35
"2011","Leeds 055G","E01033003","Total",1109,697,35,662,412,40,14,112,198,11,9,28
"2011","Leeds 055H","E01033005","Total",876,395,50,345,481,40,17,40,161,17,26,180
"2011","Leeds 056A","E01011478","Total",752,280,64,216,472,28,32,36,182,10,12,172
"2011","Leeds 056B","E01011479","Total",543,154,25,129,389,17,4,14,119,2,5,228
"2011","Leeds 056C","E01011481","Total",639,219,28,191,420,30,18,37,137,20,19,159
"2011","Leeds 056D","E01011482","Total",820,308,68,240,512,33,31,56,244,5,15,128
"2011","Leeds 056E","E01011483","Total",665,280,75,205,385,35,27,39,109,14,36,125
"2011","Leeds 057A","E01011406","Total",590,156,92,64,434,18,104,85,107,6,30,84
"2011","Leeds 057B","E01011407","Total",653,221,112,109,432,48,95,70,108,12,22,77
"2011","Leeds 057C","E01011408","Total",735,265,177,88,470,19,176,49,129,8,21,68
"2011","Leeds 057D","E01011409","Total",635,220,70,150,415,26,69,59,148,9,24,80
"2011","Leeds 057E","E01011410","Total",616,217,95,122,399,16,103,62,133,7,16,62
"2011","Leeds 057F","E01011412","Total",624,187,114,73,437,8,134,76,118,7,35,59
"2011","Leeds 058A","E01011331","Total",591,217,104,113,374,29,53,62,136,15,19,60
"2011","Leeds 058B","E01011334","Total",598,226,49,177,372,31,43,71,124,11,30,62
"2011","Leeds 058C","E01011336","Total",777,379,184,195,398,43,64,69,117,19,28,58
"2011","Leeds 058D","E01011337","Total",469,104,26,78,365,78,21,76,53,36,49,52
"2011","Leeds 059A","E01011281","Total",824,288,64,224,536,57,53,94,195,19,29,89
"2011","Leeds 059B","E01011282","Total",610,209,72,137,401,49,55,88,112,13,27,57
"2011","Leeds 059C","E01011283","Total",538,156,55,101,382,65,55,73,76,17,41,55
"2011","Leeds 059D","E01011286","Total",538,157,50,107,381,20,55,78,123,7,25,73
"2011","Leeds 059E","E01011295","Total",686,245,39,206,441,62,44,93,134,17,23,68
"2011","Leeds 060A","E01011339","Total",823,358,113,245,465,52,80,85,104,31,53,60
"2011","Leeds 060B","E01011340","Total",693,217,103,114,476,86,64,83,117,18,33,75
"2011","Leeds 060C","E01011342","Total",569,176,54,122,393,88,44,62,85,28,35,51
"2011","Leeds 060D","E01011346","Total",821,331,128,203,490,86,95,77,105,27,40,60
"2011","Leeds 061A","E01011341","Total",637,196,83,113,441,43,70,97,113,19,27,72
"2011","Leeds 061B","E01011343","Total",807,322,91,231,485,42,67,78,178,13,31,76
"2011","Leeds 061C","E01011345","Total",627,221,106,115,406,65,60,66,103,19,35,58
"2011","Leeds 061D","E01011666","Total",594,141,77,64,453,18,73,79,118,22,37,106
"2011","Leeds 062A","E01011585","Total",650,218,106,112,432,42,61,93,141,8,26,61
"2011","Leeds 062B","E01011587","Total",757,237,62,175,520,29,78,104,193,11,23,82
"2011","Leeds 062C","E01011594","Total",605,179,106,73,426,50,55,94,97,15,34,81
"2011","Leeds 062D","E01011596","Total",759,231,71,160,528,23,75,121,204,14,24,67
"2011","Leeds 062E","E01011598","Total",734,259,67,192,475,27,72,98,186,12,24,56
"2011","Leeds 063B","E01011678","Total",663,321,58,263,342,13,22,17,145,8,9,128
"2011","Leeds 063D","E01011681","Total",673,295,26,269,378,49,18,27,115,11,25,133
"2011","Leeds 063E","E01033006","Total",1016,457,19,438,559,20,14,42,220,4,19,240
"2011","Leeds 064A","E01011338","Total",740,352,77,275,388,75,34,76,80,36,45,42
"2011","Leeds 064B","E01011673","Total",810,399,65,334,411,87,10,107,94,25,37,51
"2011","Leeds 064D","E01011677","Total",786,387,96,291,399,67,50,74,110,22,22,54
"2011","Leeds 064E","E01033031","Total",782,450,59,391,332,16,31,45,191,11,11,27
"2011","Leeds 064F","E01033035","Total",752,436,29,407,316,60,9,92,81,28,14,32
"2011","Leeds 065A","E01011344","Total",824,346,68,278,478,118,28,89,125,25,29,64
"2011","Leeds 065B","E01011347","Total",776,304,59,245,472,132,31,95,113,17,25,59
"2011","Leeds 065C","E01011348","Total",636,207,48,159,429,89,54,72,72,37,39,66
"2011","Leeds 065D","E01011349","Total",962,544,159,385,418,56,63,74,128,14,21,62
"2011","Leeds 066A","E01011586","Total",597,156,89,67,441,23,99,75,106,17,51,70
"2011","Leeds 066B","E01011595","Total",639,144,83,61,495,16,96,78,96,24,74,111
"2011","Leeds 066C","E01011597","Total",557,142,67,75,415,32,57,88,92,21,45,80
"2011","Leeds 066D","E01011599","Total",647,194,102,92,453,24,75,110,121,16,29,78
"2011","Leeds 067B","E01011287","Total",599,198,75,123,401,29,70,83,122,9,26,62
"2011","Leeds 067G","E01032499","Total",702,180,76,104,522,6,98,98,152,17,50,101
"2011","Leeds 067H","E01032500","Total",568,262,55,207,306,36,23,41,121,11,21,53
"2011","Leeds 067I","E01032606","Total",906,326,87,239,580,65,83,109,167,13,51,92
"2011","Leeds 067J","E01032607","Total",547,255,84,171,292,36,33,47,108,12,12,44
"2011","Leeds 067K","E01032608","Total",500,177,40,137,323,28,32,51,111,9,29,63
"2011","Leeds 068A","E01011608","Total",583,173,77,96,410,38,64,75,119,11,33,70
"2011","Leeds 068B","E01011609","Total",668,269,77,192,399,42,59,91,107,15,29,56
"2011","Leeds 068C","E01011610","Total",616,203,76,127,413,18,74,83,125,10,28,75
"2011","Leeds 068D","E01011611","Total",603,202,83,119,401,65,62,73,90,15,23,73
"2011","Leeds 068E","E01011614","Total",807,245,78,167,562,31,105,88,202,20,35,81
"2011","Leeds 069A","E01011413","Total",584,112,68,44,472,25,80,97,106,18,41,105
"2011","Leeds 069B","E01011415","Total",718,228,79,149,490,31,93,95,148,15,23,85
"2011","Leeds 069C","E01011416","Total",606,136,65,71,470,30,91,106,112,15,22,94
"2011","Leeds 069D","E01011417","Total",724,278,163,115,446,17,135,62,115,10,28,79
"2011","Leeds 069E","E01011420","Total",624,198,143,55,426,5,165,41,113,11,18,73
"2011","Leeds 070A","E01011615","Total",639,181,68,113,458,54,65,89,125,20,26,79
"2011","Leeds 070B","E01011617","Total",679,183,71,112,496,90,69,110,113,15,31,68
"2011","Leeds 070C","E01011618","Total",725,261,68,193,464,93,41,106,118,13,21,72
"2011","Leeds 070D","E01011621","Total",588,163,61,102,425,73,56,69,87,19,50,71
"2011","Leeds 071A","E01011284","Total",878,376,50,326,502,80,28,72,208,15,23,76
"2011","Leeds 071B","E01011292","Total",823,415,148,267,408,68,52,61,110,15,29,73
"2011","Leeds 071C","E01011293","Total",743,270,68,202,473,52,56,93,145,23,48,56
"2011","Leeds 071D","E01011294","Total",462,181,55,126,281,46,39,58,68,9,24,37
"2011","Leeds 071E","E01011363","Total",735,307,81,226,428,94,48,90,94,7,34,61
"2011","Leeds 072A","E01011616","Total",680,275,97,178,405,73,72,60,91,9,33,67
"2011","Leeds 072B","E01011620","Total",490,104,45,59,386,88,49,51,67,18,48,65
"2011","Leeds 072C","E01011622","Total",657,188,49,139,469,114,24,111,84,19,38,79
"2011","Leeds 072D","E01011624","Total",714,231,109,122,483,106,42,88,94,37,52,64
"2011","Leeds 073A","E01011411","Total",665,167,74,93,498,26,89,122,143,11,26,81
"2011","Leeds 073B","E01011414","Total",623,166,69,97,457,11,106,92,114,13,37,84
"2011","Leeds 073C","E01011418","Total",612,154,59,95,458,20,61,111,147,10,32,77
"2011","Leeds 073D","E01011419","Total",496,88,36,52,408,6,105,61,111,14,29,82
"2011","Leeds 074A","E01011396","Total",800,265,103,162,535,43,79,97,167,13,30,106
"2011","Leeds 074B","E01011399","Total",623,166,86,80,457,40,91,89,112,10,27,88
"2011","Leeds 074C","E01011400","Total",597,161,84,77,436,25,92,97,98,13,20,91
"2011","Leeds 074D","E01011403","Total",613,210,154,56,403,9,128,78,94,8,26,60
"2011","Leeds 075B","E01011623","Total",703,291,55,236,412,103,33,63,101,26,28,58
"2011","Leeds 075C","E01011625","Total",698,284,47,237,414,80,46,84,98,17,26,63
"2011","Leeds 075D","E01011626","Total",949,478,105,373,471,78,38,44,201,19,32,59
"2011","Leeds 075E","E01033021","Total",697,391,124,267,306,49,41,36,112,15,18,35
"2011","Leeds 075F","E01033033","Total",740,381,43,338,359,16,24,17,264,0,2,36
"2011","Leeds 075G","E01033034","Total",645,316,10,306,329,2,1,15,288,0,1,22
"2011","Leeds 076A","E01011602","Total",743,312,168,144,431,25,105,78,127,16,22,58
"2011","Leeds 076B","E01011603","Total",658,205,92,113,453,21,87,102,129,6,24,84
"2011","Leeds 076C","E01011605","Total",636,164,97,67,472,18,114,99,129,11,19,82
"2011","Leeds 076D","E01011606","Total",642,142,73,69,500,39,110,93,105,30,55,68
"2011","Leeds 076E","E01011613","Total",549,147,57,90,402,50,53,75,132,14,29,49
"2011","Leeds 077A","E01011397","Total",602,136,68,68,466,29,77,88,120,16,33,103
"2011","Leeds 077B","E01011398","Total",498,95,33,62,403,18,58,82,118,12,26,89
"2011","Leeds 077C","E01011401","Total",601,115,65,50,486,19,113,128,116,16,25,69
"2011","Leeds 077D","E01011404","Total",522,109,54,55,413,19,84,101,96,14,23,76
"2011","Leeds 077E","E01011405","Total",627,155,117,38,472,16,173,66,107,8,19,83
"2011","Leeds 078A","E01011725","Total",699,283,79,204,416,85,45,83,90,25,39,49
"2011","Leeds 078B","E01011729","Total",741,331,78,253,410,60,37,74,132,8,30,69
"2011","Leeds 078C","E01011730","Total",657,199,51,148,458,83,37,95,132,24,34,53
"2011","Leeds 078D","E01011735","Total",738,278,109,169,460,75,64,84,104,19,37,77
"2011","Leeds 079A","E01011600","Total",671,201,88,113,470,20,79,110,155,7,23,76
"2011","Leeds 079B","E01011601","Total",624,184,59,125,440,43,65,106,107,17,36,66
"2011","Leeds 079C","E01011604","Total",601,205,77,128,396,20,56,104,139,13,22,42
"2011","Leeds 079D","E01011607","Total",685,186,59,127,499,51,73,127,152,16,20,60
"2011","Leeds 079E","E01011612","Total",687,356,199,157,331,15,93,55,110,12,13,33
"2011","Leeds 080A","E01011726","Total",634,218,62,156,416,61,60,77,111,13,35,59
"2011","Leeds 080B","E01011727","Total",674,169,55,114,505,38,90,114,162,7,30,64
"2011","Leeds 080C","E01011728","Total",626,183,100,83,443,22,115,78,121,13,28,66
"2011","Leeds 080D","E01011739","Total",699,256,66,190,443,56,78,68,112,16,29,84
"2011","Leeds 081A","E01011362","Total",974,493,105,388,481,63,31,97,202,19,18,51
"2011","Leeds 081B","E01011731","Total",609,166,88,78,443,15,81,93,140,10,24,80
"2011","Leeds 081C","E01011732","Total",777,211,93,118,566,30,92,121,180,21,33,89
"2011","Leeds 081D","E01011733","Total",691,238,113,125,453,27,87,77,147,7,30,78
"2011","Leeds 082A","E01011366","Total",757,339,82,257,418,75,38,89,105,22,29,60
"2011","Leeds 082C","E01011368","Total",611,295,38,257,316,50,16,65,102,13,33,37
"2011","Leeds 082D","E01011370","Total",698,294,43,251,404,29,31,78,119,23,49,75
"2011","Leeds 082E","E01033013","Total",647,298,63,235,349,26,31,43,205,6,15,23
"2011","Leeds 082F","E01033032","Total",789,417,37,380,372,14,14,47,262,1,5,29
"2011","Leeds 083A","E01011734","Total",1011,291,81,210,720,54,91,165,255,15,47,93
"2011","Leeds 083B","E01011736","Total",648,173,66,107,475,23,98,102,137,8,28,79
"2011","Leeds 083C","E01011737","Total",760,301,95,206,459,86,49,74,151,11,22,66
"2011","Leeds 083D","E01011738","Total",632,191,72,119,441,20,73,97,145,10,28,68
"2011","Leeds 085A","E01011364","Total",785,345,69,276,440,65,49,76,137,23,26,64
"2011","Leeds 085B","E01011371","Total",728,384,183,201,344,40,72,46,79,20,25,62
"2011","Leeds 085C","E01011373","Total",574,196,52,144,378,76,28,63,80,37,39,55
"2011","Leeds 085D","E01011374","Total",595,256,45,211,339,56,23,60,128,6,19,47
"2011","Leeds 086A","E01011312","Total",669,311,39,272,358,71,17,61,74,33,56,46
"2011","Leeds 086B","E01011316","Total",720,325,41,284,395,71,28,63,100,30,42,61
"2011","Leeds 086C","E01011372","Total",521,220,33,187,301,51,13,46,59,41,55,36
"2011","Leeds 086D","E01011375","Total",689,288,39,249,401,42,20,73,79,65,72,50
"2011","Leeds 087A","E01011390","Total",612,176,101,75,436,42,84,68,113,14,42,73
"2011","Leeds 087B","E01011391","Total",726,214,141,73,512,25,172,58,114,19,37,87
"2011","Leeds 087C","E01011392","Total",643,165,93,72,478,32,123,74,136,11,29,73
"2011","Leeds 087D","E01011402","Total",813,253,154,99,560,23,179,94,136,6,34,88
"2011","Leeds 088A","E01011298","Total",675,202,89,113,473,54,76,92,141,20,24,66
"2011","Leeds 088B","E01011299","Total",947,236,87,149,711,52,118,169,222,24,41,85
"2011","Leeds 088C","E01011302","Total",619,142,81,61,477,13,139,54,146,5,13,107
"2011","Leeds 088D","E01011303","Total",486,120,69,51,366,31,87,74,85,13,20,56
"2011","Leeds 089A","E01011300","Total",614,165,83,82,449,57,79,110,101,18,27,57
"2011","Leeds 089B","E01011301","Total",547,96,45,51,451,23,95,91,143,7,18,74
"2011","Leeds 089C","E01011304","Total",699,246,131,115,453,40,62,97,129,21,33,71
"2011","Leeds 089D","E01011305","Total",634,158,52,106,476,28,72,101,157,13,33,72
"2011","Leeds 089E","E01011306","Total",544,101,49,52,443,19,92,84,129,7,40,72
"2011","Leeds 090A","E01011315","Total",646,196,79,117,450,32,77,78,119,18,47,79
"2011","Leeds 090B","E01011317","Total",856,398,131,267,458,87,52,82,131,24,34,48
"2011","Leeds 090C","E01011318","Total",637,218,51,167,419,88,33,93,103,19,33,50
"2011","Leeds 090D","E01011321","Total",637,201,64,137,436,73,43,91,91,23,37,78
"2011","Leeds 090E","E01011369","Total",727,265,137,128,462,57,95,65,127,21,29,68
"2011","Leeds 091A","E01011313","Total",649,202,60,142,447,54,45,83,124,26,41,74
"2011","Leeds 091B","E01011314","Total",674,247,81,166,427,42,49,86,157,19,30,44
"2011","Leeds 091C","E01011319","Total",624,203,78,125,421,35,68,78,97,27,40,76
"2011","Leeds 091D","E01011320","Total",679,184,75,109,495,41,92,94,118,16,43,91
"2011","Leeds 091E","E01011322","Total",673,205,97,108,468,51,91,73,124,18,30,81
"2011","Leeds 092A","E01011471","Total",636,224,79,145,412,82,55,51,116,12,27,69
"2011","Leeds 092B","E01011472","Total",700,271,121,150,429,71,78,71,86,22,28,73
"2011","Leeds 092C","E01011473","Total",632,246,55,191,386,95,19,82,81,24,35,50
"2011","Leeds 092D","E01011474","Total",641,262,83,179,379,66,37,65,92,23,41,55
"2011","Leeds 093A","E01011518","Total",957,276,77,199,681,58,71,147,257,24,37,87
"2011","Leeds 093B","E01011524","Total",540,144,52,92,396,20,81,76,122,10,24,63
"2011","Leeds 093C","E01011526","Total",489,71,22,49,418,18,45,111,129,11,31,73
"2011","Leeds 093D","E01011531","Total",676,205,131,74,471,12,158,59,130,5,28,79
"2011","Leeds 094A","E01011466","Total",654,230,96,134,424,53,82,62,93,10,32,92
"2011","Leeds 094B","E01011469","Total",641,182,58,124,459,24,75,91,158,14,22,75
"2011","Leeds 094C","E01011475","Total",690,258,62,196,432,89,38,84,116,13,25,67
"2011","Leeds 094D","E01011476","Total",497,138,72,66,359,69,49,61,78,17,21,64
"2011","Leeds 095A","E01011519","Total",648,200,86,114,448,46,64,100,129,14,26,69
"2011","Leeds 095B","E01011522","Total",589,122,50,72,467,12,109,100,137,10,24,75
"2011","Leeds 095C","E01011525","Total",702,222,57,165,480,34,74,110,160,12,23,67
"2011","Leeds 095D","E01011528","Total",622,127,49,78,495,27,46,142,148,11,38,83
"2011","Leeds 095E","E01011532","Total",710,267,129,138,443,51,66,76,130,23,43,54
"2011","Leeds 096A","E01011520","Total",654,171,81,90,483,22,123,89,144,11,34,60
"2011","Leeds 096B","E01011521","Total",908,283,107,176,625,44,115,130,218,12,24,82
"2011","Leeds 096C","E01011523","Total",771,260,137,123,511,31,78,130,157,14,30,71
"2011","Leeds 096D","E01011527","Total",772,191,74,117,581,29,148,111,164,8,24,97
"2011","Leeds 096E","E01011529","Total",580,146,65,81,434,46,64,92,117,24,32,59
"2011","Leeds 097B","E01011635","Total",705,219,97,122,486,33,112,89,149,11,31,61
"2011","Leeds 097C","E01011637","Total",735,174,50,124,561,40,86,138,173,18,32,74
"2011","Leeds 097D","E01011638","Total",617,164,82,82,453,21,115,99,99,19,33,67
"2011","Leeds 097F","E01032487","Total",448,145,97,48,303,36,62,46,81,11,17,50
"2011","Leeds 097G","E01032488","Total",735,154,91,63,581,25,129,129,145,18,37,98
"2011","Leeds 098A","E01011627","Total",592,155,100,55,437,45,91,72,122,14,30,63
"2011","Leeds 098B","E01011628","Total",597,169,109,60,428,18,124,63,120,11,18,74
"2011","Leeds 098C","E01011629","Total",605,200,94,106,405,49,75,66,117,7,16,75
"2011","Leeds 098D","E01011632","Total",605,213,105,108,392,50,67,81,105,17,27,45
"2011","Leeds 098E","E01011633","Total",622,168,84,84,454,21,90,102,130,4,21,86
"2011","Leeds 099A","E01011490","Total",1178,422,77,345,756,62,65,191,305,13,41,79
"2011","Leeds 099C","E01011502","Total",595,192,92,100,403,48,74,87,99,13,24,58
"2011","Leeds 099E","E01032497","Total",640,203,60,143,437,92,47,78,120,28,28,44
"2011","Leeds 099F","E01032498","Total",697,214,112,102,483,27,141,77,120,8,29,81
"2011","Leeds 100A","E01011496","Total",606,129,21,108,477,35,36,142,166,13,28,57
"2011","Leeds 100B","E01011630","Total",886,212,67,145,674,52,85,177,238,10,24,88
"2011","Leeds 100C","E01011634","Total",664,201,91,110,463,35,112,71,135,16,39,55
"2011","Leeds 100D","E01011636","Total",722,215,111,104,507,20,142,85,138,11,38,73
"2011","Leeds 100E","E01011639","Total",645,184,96,88,461,55,86,79,115,19,26,81
"2011","Leeds 101A","E01011491","Total",608,225,80,145,383,77,45,74,85,13,40,49
"2011","Leeds 101B","E01011492","Total",553,184,84,100,369,72,55,65,59,22,41,55
"2011","Leeds 101C","E01011493","Total",644,196,65,131,448,82,64,84,98,19,38,63
"2011","Leeds 101D","E01011494","Total",541,153,72,81,388,68,36,86,94,14,29,61
"2011","Leeds 101E","E01011497","Total",671,221,83,138,450,82,56,90,91,24,41,66
"2011","Leeds 102B","E01011540","Total",641,203,87,116,438,57,72,88,129,18,26,48
"2011","Leeds 102F","E01032489","Total",894,297,73,224,597,51,60,102,257,9,41,77
"2011","Leeds 102G","E01032490","Total",570,142,23,119,428,30,32,122,150,16,28,50
"2011","Leeds 102H","E01032491","Total",489,89,20,69,400,30,38,106,141,12,20,53
"2011","Leeds 102I","E01032492","Total",997,420,89,331,577,84,65,101,224,21,31,51
"2011","Leeds 103A","E01011307","Total",610,148,63,85,462,41,83,77,129,19,35,78
"2011","Leeds 103B","E01011308","Total",655,181,107,74,474,38,112,97,111,18,29,69
"2011","Leeds 103C","E01011393","Total",693,184,99,85,509,23,83,148,129,22,40,64
"2011","Leeds 103D","E01011394","Total",497,133,72,61,364,13,68,79,102,12,29,61
"2011","Leeds 103E","E01011395","Total",464,102,18,84,362,28,28,120,109,14,21,42
"2011","Leeds 104A","E01011533","Total",687,305,102,203,382,38,67,58,158,7,18,36
"2011","Leeds 104B","E01011541","Total",1010,557,234,323,453,36,84,72,197,5,14,45
"2011","Leeds 104C","E01011545","Total",651,240,78,162,411,37,52,86,150,8,26,52
"2011","Leeds 104D","E01011547","Total",834,310,113,197,524,48,69,107,186,21,30,63
"2011","Leeds 105C","E01011499","Total",1053,279,51,228,774,60,61,220,266,27,60,80
"2011","Leeds 105D","E01011500","Total",689,188,110,78,501,30,97,86,159,11,30,88
"2011","Leeds 105E","E01032495","Total",922,174,44,130,748,86,35,210,264,27,55,71
"2011","Leeds 105F","E01032496","Total",878,236,74,162,642,54,80,169,205,15,31,88
"2011","Leeds 106A","E01011530","Total",651,166,62,104,485,18,108,95,178,10,22,54
"2011","Leeds 106B","E01011534","Total",684,255,92,163,429,33,74,94,146,12,15,55
"2011","Leeds 106C","E01011546","Total",743,238,69,169,505,49,64,107,171,15,23,76
"2011","Leeds 106D","E01011548","Total",639,180,90,90,459,25,114,90,127,12,26,65
"2011","Leeds 106E","E01011550","Total",552,113,50,63,439,27,74,99,120,12,41,66
"2011","Leeds 107A","E01011537","Total",947,307,138,169,640,34,173,105,191,16,35,86
"2011","Leeds 107B","E01011538","Total",662,217,107,110,445,44,82,86,117,15,38,63
"2011","Leeds 107C","E01011551","Total",647,156,27,129,491,39,45,130,165,16,29,67
"2011","Leeds 107D","E01011552","Total",575,146,71,75,429,42,67,97,91,24,43,65
"2011","Leeds 108A","E01011535","Total",658,125,64,61,533,28,109,123,123,14,37,99
"2011","Leeds 108B","E01011536","Total",660,151,77,74,509,27,112,106,127,9,35,93
"2011","Leeds 108C","E01011549","Total",512,51,9,42,461,11,21,130,125,9,45,120
"2011","Leeds 108D","E01011553","Total",615,139,50,89,476,36,84,92,157,12,22,73
"2011","Leeds 109A","E01011685","Total",777,275,69,206,502,11,65,87,196,17,26,100
"2011","Leeds 109B","E01011687","Total",574,134,62,72,440,15,73,83,124,12,38,95
"2011","Leeds 109C","E01011690","Total",661,277,124,153,384,12,67,41,149,10,18,87
"2011","Leeds 109D","E01011692","Total",666,251,62,189,415,12,53,71,186,12,15,66
"2011","Leeds 109E","E01011693","Total",725,266,47,219,459,22,24,39,236,4,11,123
"2011","Leeds 109F","E01011694","Total",615,129,59,70,486,12,47,66,125,14,29,193
"2011","Leeds 109G","E01032876","Total",533,127,39,88,406,10,82,61,127,13,22,91
"2011","Leeds 110A","E01011442","Total",543,154,18,136,389,6,10,11,146,4,11,201
"2011","Leeds 110B","E01011443","Total",479,193,22,171,286,8,5,6,106,4,8,149
"2011","Leeds 110C","E01011444","Total",586,196,16,180,390,10,3,7,112,3,13,242
"2011","Leeds 110D","E01011451","Total",466,208,43,165,258,8,17,23,138,7,7,58
"2011","Leeds 110E","E01011668","Total",517,136,14,122,381,19,8,16,114,4,9,211
"2011","Leeds 110F","E01011669","Total",518,187,15,172,331,23,8,43,121,4,13,119
"2011","Leeds 110G","E01032946","Total",778,302,128,174,476,10,32,25,188,7,16,198
"2011","Leeds 111A","E01033008","Total",704,364,4,360,340,3,3,20,298,1,2,13
"2011","Leeds 111B","E01033010","Total",690,400,3,397,290,0,1,16,246,1,1,25
"2011","Leeds 111C","E01033011","Total",761,415,12,403,346,6,0,6,305,0,1,28
"2011","Leeds 111D","E01033015","Total",705,299,4,295,406,2,1,25,357,0,1,20
"2011","Leeds 111E","E01033016","Total",709,441,5,436,268,0,4,16,234,0,2,12
"2011","Leeds 112A","E01011467","Total",647,252,54,198,395,53,30,86,142,14,24,46
"2011","Leeds 112B","E01011468","Total",743,338,108,230,405,71,67,56,94,17,29,71
"2011","Leeds 112C","E01011470","Total",607,222,80,142,385,48,59,56,135,9,22,56
"2011","Leeds 112D","E01033018","Total",729,363,1,362,366,5,2,21,326,1,0,11
"2011","Leeds 112E","E01033019","Total",766,365,3,362,401,9,1,19,351,0,0,21
"2011","Wakefield 001A","E01011740","Total",660,193,85,108,467,81,74,92,119,13,21,67
"2011","Wakefield 001B","E01011741","Total",636,153,83,70,483,24,117,78,136,14,28,86
"2011","Wakefield 001C","E01011742","Total",716,244,146,98,472,56,78,85,117,16,40,80
"2011","Wakefield 001D","E01011745","Total",697,187,62,125,510,90,60,91,117,43,29,80
"2011","Wakefield 001E","E01011746","Total",564,147,48,99,417,69,48,69,106,25,28,72
"2011","Wakefield 002A","E01011752","Total",722,249,82,167,473,49,64,92,155,14,24,75
"2011","Wakefield 002B","E01011753","Total",627,215,97,118,412,31,75,71,119,11,25,80
"2011","Wakefield 002C","E01011756","Total",758,351,172,179,407,37,106,39,123,14,16,72
"2011","Wakefield 002D","E01011760","Total",795,287,91,196,508,52,57,95,183,11,21,89
"2011","Wakefield 002E","E01011762","Total",737,248,80,168,489,44,80,99,162,9,21,74
"2011","Wakefield 003A","E01011743","Total",597,102,63,39,495,9,128,83,133,9,27,106
"2011","Wakefield 003B","E01011744","Total",669,140,78,62,529,15,117,134,144,6,25,88
"2011","Wakefield 003C","E01011747","Total",726,252,93,159,474,66,63,119,120,16,35,55
"2011","Wakefield 003D","E01011750","Total",603,176,66,110,427,58,55,66,97,36,43,72
"2011","Wakefield 003E","E01011754","Total",630,173,118,55,457,32,90,72,132,15,29,87
"2011","Wakefield 004A","E01011757","Total",744,178,84,94,566,56,84,134,153,21,30,88
"2011","Wakefield 004B","E01011759","Total",831,276,110,166,555,59,93,94,143,17,32,117
"2011","Wakefield 004C","E01011761","Total",792,205,83,122,587,26,119,105,200,16,39,82
"2011","Wakefield 004D","E01011763","Total",744,326,156,170,418,40,91,81,120,4,22,60
"2011","Wakefield 004E","E01011764","Total",714,284,105,179,430,43,74,95,110,15,18,75
"2011","Wakefield 005A","E01011748","Total",656,136,56,80,520,30,102,97,138,16,32,105
"2011","Wakefield 005B","E01011749","Total",969,300,91,209,669,74,68,144,237,10,30,106
"2011","Wakefield 005C","E01011751","Total",517,108,37,71,409,16,43,84,149,9,31,77
"2011","Wakefield 005D","E01011755","Total",677,132,57,75,545,18,93,97,186,12,35,104
"2011","Wakefield 006A","E01011873","Total",679,172,49,123,507,22,57,135,182,9,27,75
"2011","Wakefield 006B","E01011877","Total",544,101,42,59,443,24,75,102,119,7,28,88
"2011","Wakefield 006C","E01011894","Total",543,96,39,57,447,20,69,104,119,6,38,91
"2011","Wakefield 006D","E01011895","Total",587,139,50,89,448,18,63,104,117,16,37,93
"2011","Wakefield 007A","E01011875","Total",676,259,118,141,417,38,74,95,131,14,16,49
"2011","Wakefield 007B","E01011876","Total",653,246,118,128,407,36,67,85,128,8,26,57
"2011","Wakefield 007C","E01011878","Total",668,171,57,114,497,28,75,94,164,8,32,96
"2011","Wakefield 007D","E01011880","Total",660,173,55,118,487,28,87,122,159,6,14,71
"2011","Wakefield 008A","E01011881","Total",660,185,75,110,475,37,108,90,136,11,19,74
"2011","Wakefield 008B","E01011887","Total",498,117,56,61,381,19,70,79,98,11,24,80
"2011","Wakefield 008C","E01011893","Total",574,127,55,72,447,16,77,101,150,6,35,62
"2011","Wakefield 008D","E01011896","Total",627,198,114,84,429,38,94,75,115,7,27,73
"2011","Wakefield 008E","E01011897","Total",698,288,159,129,410,37,96,67,120,10,28,52
"2011","Wakefield 009A","E01011874","Total",665,141,70,71,524,10,121,103,149,21,27,93
"2011","Wakefield 009B","E01011879","Total",637,180,71,109,457,33,77,99,138,11,22,77
"2011","Wakefield 009C","E01011882","Total",641,148,94,54,493,8,146,89,121,11,27,91
"2011","Wakefield 009D","E01011883","Total",642,226,118,108,416,21,89,82,111,9,33,71
"2011","Wakefield 010A","E01011805","Total",707,306,114,192,401,35,83,54,122,11,29,67
"2011","Wakefield 010B","E01011807","Total",662,258,104,154,404,34,44,82,129,21,24,70
"2011","Wakefield 010C","E01011808","Total",770,247,119,128,523,38,117,75,153,19,33,88
"2011","Wakefield 010D","E01011810","Total",582,109,47,62,473,33,63,84,124,18,44,107
"2011","Wakefield 011A","E01011803","Total",583,168,58,110,415,53,56,76,111,16,34,69
"2011","Wakefield 011B","E01011804","Total",708,180,87,93,528,43,110,106,155,19,25,70
"2011","Wakefield 011C","E01011806","Total",664,193,72,121,471,34,84,87,145,9,27,85
"2011","Wakefield 011D","E01011809","Total",736,308,159,149,428,24,93,58,136,15,34,68
"2011","Wakefield 011E","E01011811","Total",661,186,79,107,475,74,56,74,144,14,48,65
"2011","Wakefield 012A","E01011835","Total",640,136,58,78,504,25,118,78,165,7,17,94
"2011","Wakefield 012B","E01011836","Total",576,113,36,77,463,36,50,106,168,15,26,62
"2011","Wakefield 012C","E01011839","Total",642,113,52,61,529,54,112,105,115,16,27,100
"2011","Wakefield 012D","E01011843","Total",643,135,57,78,508,65,72,111,128,16,40,76
"2011","Wakefield 012E","E01011844","Total",729,110,35,75,619,35,54,205,192,19,30,84
"2011","Wakefield 013A","E01011758","Total",614,207,78,129,407,44,65,73,118,9,28,70
"2011","Wakefield 013B","E01011812","Total",1010,194,58,136,816,38,78,215,274,27,63,121
"2011","Wakefield 013C","E01011820","Total",636,184,78,106,452,29,60,119,138,12,29,65
"2011","Wakefield 013D","E01011821","Total",599,203,111,92,396,21,89,78,101,6,26,75
"2011","Wakefield 014A","E01011885","Total",597,145,89,56,452,26,114,75,125,7,22,83
"2011","Wakefield 014B","E01011886","Total",649,178,85,93,471,24,103,83,137,7,31,86
"2011","Wakefield 014C","E01011888","Total",598,124,64,60,474,10,119,89,125,9,18,104
"2011","Wakefield 014D","E01011890","Total",489,83,35,48,406,19,71,92,105,12,25,82
"2011","Wakefield 014E","E01011891","Total",716,262,138,124,454,40,102,68,130,11,28,75
"2011","Wakefield 015A","E01011834","Total",613,135,49,86,478,54,54,124,138,23,29,56
"2011","Wakefield 015B","E01011837","Total",613,188,64,124,425,26,77,61,124,23,29,85
"2011","Wakefield 015C","E01011838","Total",1102,580,161,419,522,51,73,79,226,11,27,55
"2011","Wakefield 015D","E01011841","Total",706,243,119,124,463,20,103,83,131,10,34,82
"2011","Wakefield 015E","E01011842","Total",689,285,122,163,404,65,73,76,103,14,20,53
"2011","Wakefield 016A","E01011813","Total",700,247,128,119,453,59,73,96,107,25,26,67
"2011","Wakefield 016B","E01011814","Total",803,330,72,258,473,52,58,97,145,16,34,71
"2011","Wakefield 016C","E01011815","Total",685,209,110,99,476,43,85,72,162,14,24,76
"2011","Wakefield 016D","E01011816","Total",630,240,133,107,390,45,77,65,90,13,39,61
"2011","Wakefield 016E","E01011819","Total",717,243,81,162,474,29,52,102,158,8,29,96
"2011","Wakefield 016F","E01011822","Total",636,193,69,124,443,55,71,80,130,15,24,68
"2011","Wakefield 017A","E01011884","Total",961,258,54,204,703,46,88,162,251,16,46,94
"2011","Wakefield 017B","E01011912","Total",687,338,115,223,349,14,47,41,113,14,57,63
"2011","Wakefield 017C","E01011913","Total",546,157,57,100,389,23,27,62,74,33,67,103
"2011","Wakefield 017D","E01011916","Total",1205,746,211,535,459,20,68,42,221,8,26,74
"2011","Wakefield 018A","E01011840","Total",685,207,106,101,478,48,88,86,145,16,27,68
"2011","Wakefield 018B","E01011850","Total",628,172,84,88,456,73,74,64,99,17,43,86
"2011","Wakefield 018C","E01011852","Total",651,159,89,70,492,86,58,107,108,25,32,76
"2011","Wakefield 018D","E01011853","Total",588,170,118,52,418,30,81,71,82,24,36,94
"2011","Wakefield 019A","E01011920","Total",702,291,66,225,411,31,47,69,144,17,43,60
"2011","Wakefield 019B","E01011923","Total",714,213,57,156,501,25,91,92,169,19,33,72
"2011","Wakefield 019C","E01011924","Total",655,201,62,139,454,31,81,75,136,16,37,78
"2011","Wakefield 019D","E01011925","Total",667,180,70,110,487,80,52,107,109,36,32,71
"2011","Wakefield 020A","E01011909","Total",595,151,70,81,444,29,83,54,146,17,31,84
"2011","Wakefield 020B","E01011910","Total",730,351,150,201,379,31,91,55,94,17,39,52
"2011","Wakefield 020C","E01011911","Total",629,195,71,124,434,77,52,84,93,26,34,68
"2011","Wakefield 020D","E01011914","Total",667,224,64,160,443,60,48,82,132,20,33,68
"2011","Wakefield 020E","E01011915","Total",631,195,38,157,436,40,42,101,113,19,57,64
"2011","Wakefield 021A","E01011823","Total",619,186,77,109,433,22,91,88,137,9,15,71
"2011","Wakefield 021B","E01011824","Total",620,184,85,99,436,62,42,98,109,24,37,64
"2011","Wakefield 021C","E01011825","Total",771,194,84,110,577,54,68,160,185,20,29,61
"2011","Wakefield 021D","E01011826","Total",590,124,73,51,466,20,111,100,122,8,27,78
"2011","Wakefield 021E","E01011827","Total",526,134,81,53,392,18,113,55,110,8,16,72
"2011","Wakefield 021F","E01011828","Total",631,165,62,103,466,41,77,92,158,14,18,66
"2011","Wakefield 022A","E01011889","Total",502,89,28,61,413,30,58,121,104,10,27,63
"2011","Wakefield 022B","E01011892","Total",779,251,131,120,528,43,80,133,139,17,35,81
"2011","Wakefield 022C","E01011919","Total",832,309,70,239,523,51,58,107,177,18,37,75
"2011","Wakefield 022D","E01011921","Total",608,142,83,59,466,33,99,82,125,16,28,83
"2011","Wakefield 022E","E01011926","Total",645,202,59,143,443,46,48,80,117,32,50,70
"2011","Wakefield 022F","E01011927","Total",568,187,85,102,381,39,56,72,98,16,34,66
"2011","Wakefield 023A","E01011845","Total",626,149,107,42,477,9,147,61,158,5,26,71
"2011","Wakefield 023B","E01011846","Total",594,156,72,84,438,24,109,80,112,8,29,76
"2011","Wakefield 023C","E01011847","Total",615,150,89,61,465,22,107,95,133,3,26,79
"2011","Wakefield 023D","E01011848","Total",624,141,89,52,483,26,156,74,114,7,29,77
"2011","Wakefield 023E","E01011851","Total",690,275,148,127,415,26,78,69,134,12,25,71
"2011","Wakefield 024A","E01011775","Total",1131,221,77,144,910,36,91,252,319,37,65,110
"2011","Wakefield 024B","E01011776","Total",619,155,73,82,464,52,83,88,110,23,39,69
"2011","Wakefield 024C","E01011777","Total",622,202,93,109,420,26,103,74,123,7,21,66
"2011","Wakefield 024D","E01011778","Total",652,150,78,72,502,54,84,98,140,17,20,89
"2011","Wakefield 024E","E01011817","Total",557,149,76,73,408,49,61,78,103,14,31,72
"2011","Wakefield 024F","E01011818","Total",592,147,73,74,445,33,87,74,154,10,17,70
"2011","Wakefield 025A","E01011829","Total",613,160,65,95,453,31,70,100,137,13,19,83
"2011","Wakefield 025B","E01011830","Total",660,274,158,116,386,13,129,66,111,6,17,44
"2011","Wakefield 025C","E01011831","Total",776,248,88,160,528,45,88,105,161,17,23,89
"2011","Wakefield 025D","E01011832","Total",621,194,105,89,427,33,82,84,115,11,23,79
"2011","Wakefield 025E","E01011833","Total",667,197,72,125,470,23,91,115,135,5,20,81
"2011","Wakefield 026A","E01011899","Total",542,96,39,57,446,69,62,82,78,25,52,78
"2011","Wakefield 026B","E01011900","Total",752,329,146,183,423,41,82,68,121,17,30,64
"2011","Wakefield 026C","E01011901","Total",584,114,46,68,470,86,59,88,71,35,50,81
"2011","Wakefield 026D","E01011904","Total",500,92,41,51,408,67,53,83,73,37,37,58
"2011","Wakefield 026E","E01011918","Total",634,158,67,91,476,66,72,91,129,25,27,66
"2011","Wakefield 026F","E01011922","Total",639,258,77,181,381,42,45,65,108,23,39,59
"2011","Wakefield 027A","E01011779","Total",598,143,76,67,455,47,81,79,90,14,35,109
"2011","Wakefield 027B","E01011780","Total",870,345,170,175,525,71,123,85,123,18,37,68
"2011","Wakefield 027C","E01011781","Total",804,286,114,172,518,68,85,117,152,10,24,62
"2011","Wakefield 027D","E01011782","Total",640,171,94,77,469,29,100,89,113,11,34,93
"2011","Wakefield 027E","E01011783","Total",594,194,56,138,400,33,72,75,119,4,27,70
"2011","Wakefield 028A","E01011902","Total",674,263,134,129,411,26,98,62,119,7,21,78
"2011","Wakefield 028B","E01011903","Total",617,250,101,149,367,20,97,43,114,6,24,63
"2011","Wakefield 028C","E01011905","Total",684,172,111,61,512,13,148,107,120,14,37,73
"2011","Wakefield 028D","E01011907","Total",875,397,135,262,478,28,80,74,153,12,33,98
"2011","Wakefield 029A","E01011793","Total",729,192,108,84,537,25,140,86,165,8,23,90
"2011","Wakefield 029B","E01011794","Total",613,192,86,106,421,36,71,82,109,14,36,73
"2011","Wakefield 029C","E01011795","Total",595,196,105,91,399,32,79,82,125,9,15,57
"2011","Wakefield 029D","E01011796","Total",582,116,62,54,466,28,83,100,134,15,26,80
"2011","Wakefield 029E","E01011799","Total",775,303,208,95,472,49,118,88,116,7,26,68
"2011","Wakefield 029F","E01011800","Total",718,202,71,131,516,40,94,113,146,20,20,83
"2011","Wakefield 030A","E01011898","Total",717,309,40,269,408,44,40,81,148,12,19,64
"2011","Wakefield 030B","E01011906","Total",672,226,74,152,446,96,49,96,96,22,32,55
"2011","Wakefield 030C","E01011908","Total",934,299,103,196,635,50,70,123,212,22,62,96
"2011","Wakefield 030D","E01011917","Total",699,286,74,212,413,42,31,61,146,26,46,61
"2011","Wakefield 030E","E01011944","Total",589,180,35,145,409,47,41,89,123,18,24,67
"2011","Wakefield 031A","E01011797","Total",706,156,77,79,550,31,113,140,147,9,27,83
"2011","Wakefield 031B","E01011798","Total",662,257,94,163,405,24,73,76,160,7,14,51
"2011","Wakefield 031C","E01011801","Total",645,178,55,123,467,57,60,88,137,20,27,78
"2011","Wakefield 031D","E01011802","Total",647,176,87,89,471,36,97,64,150,7,24,93
"2011","Wakefield 032A","E01011765","Total",640,173,82,91,467,26,86,87,117,15,39,97
"2011","Wakefield 032B","E01011766","Total",584,106,48,58,478,38,68,119,102,13,32,106
"2011","Wakefield 032C","E01011773","Total",609,110,70,40,499,15,134,74,126,8,28,114
"2011","Wakefield 032D","E01011774","Total",590,156,80,76,434,21,81,89,120,10,30,83
"2011","Wakefield 033A","E01011939","Total",639,138,92,46,501,16,148,94,129,12,13,89
"2011","Wakefield 033B","E01011945","Total",648,209,135,74,439,15,114,70,127,6,37,70
"2011","Wakefield 033C","E01011947","Total",670,113,82,31,557,9,214,76,134,11,23,90
"2011","Wakefield 033D","E01011948","Total",665,135,92,43,530,10,150,97,139,17,24,93
"2011","Wakefield 034A","E01011767","Total",740,171,94,77,569,16,157,86,156,19,37,98
"2011","Wakefield 034B","E01011768","Total",583,121,51,70,462,26,111,82,134,11,24,74
"2011","Wakefield 034C","E01011769","Total",930,238,75,163,692,42,90,174,251,16,28,91
"2011","Wakefield 034D","E01011770","Total",795,226,124,102,569,48,109,105,158,20,34,95
"2011","Wakefield 034E","E01011849","Total",730,202,119,83,528,7,186,75,151,10,25,74
"2011","Wakefield 034F","E01011857","Total",721,165,100,65,556,20,166,94,158,11,21,86
"2011","Wakefield 035A","E01011928","Total",625,198,111,87,427,28,107,72,121,9,18,72
"2011","Wakefield 035B","E01011931","Total",637,142,76,66,495,25,114,101,147,12,25,71
"2011","Wakefield 035C","E01011932","Total",607,136,60,76,471,24,101,75,147,16,30,78
"2011","Wakefield 035D","E01011938","Total",570,134,66,68,436,19,69,91,140,16,28,73
"2011","Wakefield 036A","E01011929","Total",746,204,110,94,542,19,142,75,189,5,28,84
"2011","Wakefield 036B","E01011930","Total",713,167,64,103,546,21,95,129,175,18,27,81
"2011","Wakefield 036C","E01011933","Total",657,144,46,98,513,36,91,103,161,17,31,74
"2011","Wakefield 036D","E01011937","Total",606,152,68,84,454,11,104,86,128,6,33,86
"2011","Wakefield 037A","E01011934","Total",621,180,68,112,441,10,92,82,129,7,28,93
"2011","Wakefield 037B","E01011936","Total",659,221,124,97,438,37,85,91,99,13,37,76
"2011","Wakefield 037C","E01011940","Total",614,169,72,97,445,46,71,86,117,14,25,86
"2011","Wakefield 037D","E01011943","Total",806,298,154,144,508,78,83,90,127,22,27,81
"2011","Wakefield 038A","E01011935","Total",756,185,64,121,571,18,82,155,196,13,30,77
"2011","Wakefield 038B","E01011941","Total",646,178,124,54,468,14,127,86,129,5,29,78
"2011","Wakefield 038C","E01011942","Total",554,133,74,59,421,12,130,63,128,17,14,57
"2011","Wakefield 038D","E01011946","Total",617,150,68,82,467,22,105,82,127,2,23,106
"2011","Wakefield 039A","E01011785","Total",608,131,49,82,477,49,74,86,118,21,52,77
"2011","Wakefield 039B","E01011789","Total",510,168,80,88,342,34,67,57,70,11,30,73
"2011","Wakefield 039C","E01011791","Total",626,173,100,73,453,51,91,70,111,17,34,79
"2011","Wakefield 039D","E01011792","Total",631,200,81,119,431,63,75,72,89,17,47,68
"2011","Wakefield 040A","E01011771","Total",615,222,148,74,393,36,109,44,91,10,31,72
"2011","Wakefield 040B","E01011772","Total",692,174,64,110,518,37,92,92,183,8,29,77
"2011","Wakefield 040C","E01011784","Total",772,217,94,123,555,54,96,93,157,22,40,93
"2011","Wakefield 040D","E01011786","Total",620,120,34,86,500,55,57,88,141,24,40,95
"2011","Wakefield 041A","E01011854","Total",513,148,60,88,365,40,44,85,98,16,24,58
"2011","Wakefield 041B","E01011855","Total",686,197,90,107,489,44,85,91,143,16,35,75
"2011","Wakefield 041C","E01011856","Total",622,170,78,92,452,43,85,67,137,17,26,77
"2011","Wakefield 041D","E01011858","Total",638,170,87,83,468,29,79,114,98,16,49,83
"2011","Wakefield 042A","E01011787","Total",765,208,94,114,557,37,117,100,171,9,28,95
"2011","Wakefield 042B","E01011788","Total",729,177,90,87,552,22,127,86,174,7,35,101
"2011","Wakefield 042C","E01011790","Total",761,284,126,158,477,52,85,89,120,15,32,84
"2011","Wakefield 042D","E01011865","Total",754,263,156,107,491,50,116,83,97,14,34,97
"2011","Wakefield 042E","E01011867","Total",684,187,78,109,497,45,77,87,139,15,51,83
"2011","Wakefield 043A","E01011859","Total",688,263,163,100,425,46,117,54,93,19,32,64
"2011","Wakefield 043B","E01011869","Total",683,259,96,163,424,60,52,78,126,18,19,71
"2011","Wakefield 043C","E01011870","Total",641,188,102,86,453,13,124,66,120,7,22,101
"2011","Wakefield 043D","E01011871","Total",661,180,59,121,481,42,68,84,155,17,39,76
"2011","Wakefield 044A","E01011860","Total",642,159,88,71,483,24,109,91,125,9,34,91
"2011","Wakefield 044B","E01011861","Total",815,193,76,117,622,53,104,142,154,22,51,96
"2011","Wakefield 044C","E01011862","Total",606,186,77,109,420,44,59,82,114,18,34,69
"2011","Wakefield 044D","E01011863","Total",609,222,133,89,387,47,65,67,103,14,21,70
"2011","Wakefield 045A","E01011864","Total",662,190,90,100,472,47,76,89,94,24,46,96
"2011","Wakefield 045B","E01011866","Total",641,174,90,84,467,41,88,70,117,26,43,82
"2011","Wakefield 045C","E01011868","Total",814,264,101,163,550,58,82,116,151,25,40,78
"2011","Wakefield 045D","E01011872","Total",629,156,75,81,473,58,75,88,107,21,32,92
"2011","Derby 001A","E01013461","Total",711,194,112,82,517,12,147,97,147,14,32,68
"2011","Derby 001B","E01013462","Total",633,174,111,63,459,16,100,122,105,16,23,77
"2011","Derby 001C","E01013463","Total",607,117,62,55,490,20,113,112,112,10,38,85
"2011","Derby 001D","E01013464","Total",634,177,133,44,457,14,163,86,79,12,27,76
"2011","Derby 002A","E01013465","Total",694,188,127,61,506,11,166,99,81,32,29,88
"2011","Derby 002B","E01013466","Total",648,154,109,45,494,13,137,109,118,9,27,81
"2011","Derby 002C","E01013467","Total",609,162,95,67,447,20,168,82,83,15,30,49
"2011","Derby 002D","E01013468","Total",698,192,137,55,506,11,177,86,99,15,29,89
"2011","Derby 002E","E01013469","Total",722,333,228,105,389,5,172,36,108,5,11,52
"2011","Derby 003A","E01013574","Total",536,98,40,58,438,10,78,92,131,8,34,85
"2011","Derby 003B","E01013575","Total",602,148,44,104,454,13,61,100,178,15,22,65
"2011","Derby 003C","E01013576","Total",566,106,26,80,460,17,50,113,146,12,31,91
"2011","Derby 003D","E01013577","Total",596,120,22,98,476,16,52,131,135,23,43,76
"2011","Derby 003E","E01013578","Total",555,112,22,90,443,24,38,120,162,17,25,57
"2011","Derby 003F","E01013579","Total",631,180,56,124,451,33,80,99,133,9,36,61
"2011","Derby 003G","E01013580","Total",701,244,48,196,457,35,68,96,179,10,19,50
"2011","Derby 004A","E01013530","Total",622,145,53,92,477,44,68,103,146,26,36,54
"2011","Derby 004B","E01013531","Total",601,174,90,84,427,35,86,89,106,15,24,72
"2011","Derby 004C","E01013532","Total",618,174,93,81,444,53,88,80,105,19,29,70
"2011","Derby 004D","E01013581","Total",610,147,62,85,463,84,62,101,101,23,32,60
"2011","Derby 005A","E01013526","Total",735,229,110,119,506,23,117,102,159,19,27,59
"2011","Derby 005B","E01013527","Total",638,178,91,87,460,16,97,96,145,18,30,58
"2011","Derby 005C","E01013528","Total",731,275,114,161,456,21,79,100,137,15,26,78
"2011","Derby 005D","E01013529","Total",1032,374,183,191,658,58,73,136,225,18,34,114
"2011","Derby 006A","E01013505","Total",608,149,67,82,459,27,73,99,111,20,32,97
"2011","Derby 006B","E01013506","Total",696,201,129,72,495,33,146,60,117,20,33,86
"2011","Derby 006C","E01013513","Total",500,119,61,58,381,41,74,54,83,20,39,70
"2011","Derby 006D","E01013534","Total",662,181,87,94,481,39,76,113,101,28,37,87
"2011","Derby 006E","E01013582","Total",694,213,112,101,481,51,103,102,115,9,25,76
"2011","Derby 007A","E01013533","Total",705,259,108,151,446,93,40,106,93,21,33,60
"2011","Derby 007B","E01013535","Total",521,83,30,53,438,105,29,83,57,38,53,73
"2011","Derby 007C","E01013536","Total",680,236,47,189,444,78,37,87,124,28,27,63
"2011","Derby 007D","E01013537","Total",725,227,116,111,498,43,109,86,135,15,34,76
"2011","Derby 007E","E01013538","Total",625,192,67,125,433,56,59,68,112,21,33,84
"2011","Derby 008A","E01013522","Total",918,424,112,312,494,70,50,63,206,5,11,89
"2011","Derby 008B","E01013523","Total",836,436,107,329,400,27,46,48,172,4,20,83
"2011","Derby 008C","E01013524","Total",676,353,51,302,323,14,26,34,165,2,8,74
"2011","Derby 008D","E01013525","Total",1062,454,86,368,608,47,48,88,318,16,10,81
"2011","Derby 009A","E01013548","Total",639,200,128,72,439,34,84,65,107,17,39,93
"2011","Derby 009B","E01013549","Total",622,186,120,66,436,47,88,89,98,15,24,75
"2011","Derby 009C","E01013552","Total",738,255,156,99,483,54,89,92,119,25,33,71
"2011","Derby 009D","E01013553","Total",646,185,108,77,461,50,92,64,128,19,35,73
"2011","Derby 009E","E01013555","Total",598,162,97,65,436,32,64,90,95,17,52,86
"2011","Derby 010A","E01013592","Total",635,189,83,106,446,21,103,90,134,12,17,69
"2011","Derby 010B","E01013594","Total",630,191,115,76,439,11,167,51,106,9,29,66
"2011","Derby 010C","E01013596","Total",692,204,107,97,488,20,152,87,115,12,26,76
"2011","Derby 010D","E01013599","Total",618,162,100,62,456,18,133,59,127,9,25,85
"2011","Derby 011A","E01013547","Total",809,281,59,222,528,43,42,61,216,9,17,140
"2011","Derby 011B","E01013550","Total",538,162,63,99,376,39,51,60,117,18,32,59
"2011","Derby 011C","E01013551","Total",687,210,41,169,477,37,20,64,187,6,11,152
"2011","Derby 011D","E01013554","Total",805,325,70,255,480,66,36,72,168,5,15,118
"2011","Derby 012A","E01013507","Total",643,152,74,78,491,25,98,86,150,13,35,84
"2011","Derby 012B","E01013508","Total",488,117,64,53,371,43,65,72,72,18,48,53
"2011","Derby 012C","E01013509","Total",713,191,81,110,522,42,96,108,149,23,26,78
"2011","Derby 012D","E01013510","Total",624,180,93,87,444,59,77,78,92,26,37,75
"2011","Derby 012E","E01013511","Total",637,147,87,60,490,17,134,87,100,16,29,107
"2011","Derby 012F","E01013512","Total",632,194,58,136,438,52,81,82,109,20,34,60
"2011","Derby 013A","E01013453","Total",1121,510,78,432,611,67,35,81,218,13,25,172
"2011","Derby 013B","E01013454","Total",543,167,53,114,376,50,31,64,125,14,24,68
"2011","Derby 013C","E01013456","Total",1053,506,125,381,547,82,38,87,193,14,24,109
"2011","Derby 013D","E01013457","Total",822,279,64,215,543,65,43,92,207,13,30,93
"2011","Derby 013E","E01013460","Total",909,364,39,325,545,65,27,60,220,6,22,145
"2011","Derby 013F","E01013479","Total",1142,702,69,633,440,32,15,63,199,4,15,112
"2011","Derby 014A","E01013593","Total",591,135,77,58,456,12,127,74,128,14,25,76
"2011","Derby 014B","E01013595","Total",957,293,108,185,664,65,93,155,191,35,39,86
"2011","Derby 014C","E01013597","Total",650,215,130,85,435,38,103,66,105,14,32,77
"2011","Derby 014D","E01013598","Total",632,168,77,91,464,41,84,86,116,13,50,74
"2011","Derby 015A","E01013556","Total",611,149,65,84,462,25,101,90,136,9,29,72
"2011","Derby 015B","E01013557","Total",605,148,110,38,457,5,177,67,107,12,17,72
"2011","Derby 015C","E01013558","Total",853,217,111,106,636,50,148,116,169,24,41,88
"2011","Derby 015D","E01013559","Total",579,131,61,70,448,23,111,76,125,7,20,86
"2011","Derby 015E","E01013564","Total",809,169,85,84,640,16,137,132,174,20,42,119
"2011","Derby 016A","E01013480","Total",1085,651,144,507,434,36,41,64,155,13,30,95
"2011","Derby 016B","E01013483","Total",699,203,39,164,496,42,40,95,101,41,86,91
"2011","Derby 016C","E01013485","Total",639,137,34,103,502,58,26,87,89,55,98,89
"2011","Derby 016D","E01013565","Total",541,138,27,111,403,47,37,83,45,47,73,71
"2011","Derby 016E","E01013566","Total",720,266,88,178,454,52,25,62,84,58,89,84
"2011","Derby 017A","E01013455","Total",812,274,84,190,538,48,76,103,161,18,42,90
"2011","Derby 017B","E01013458","Total",569,188,87,101,381,11,77,39,80,20,56,98
"2011","Derby 017C","E01013542","Total",696,220,92,128,476,23,94,98,113,26,43,79
"2011","Derby 017D","E01013546","Total",645,147,83,64,498,15,109,90,115,34,44,91
"2011","Derby 018A","E01013481","Total",585,166,39,127,419,52,22,63,66,34,103,79
"2011","Derby 018C","E01013484","Total",695,226,68,158,469,60,38,88,81,51,87,64
"2011","Derby 018D","E01013486","Total",573,135,30,105,438,33,19,73,61,51,115,86
"2011","Derby 018E","E01013487","Total",761,236,42,194,525,71,22,113,94,51,104,70
"2011","Derby 018F","E01033166","Total",584,356,61,295,228,19,20,48,101,5,15,20
"2011","Derby 018G","E01033167","Total",621,364,107,257,257,29,26,39,89,11,19,44
"2011","Derby 019A","E01013540","Total",645,178,98,80,467,18,93,95,121,15,35,90
"2011","Derby 019B","E01013560","Total",595,120,67,53,475,15,79,89,139,15,37,101
"2011","Derby 019C","E01013561","Total",687,185,120,65,502,12,142,92,148,12,22,74
"2011","Derby 019D","E01013562","Total",719,335,221,114,384,13,132,54,110,9,17,49
"2011","Derby 019E","E01013563","Total",627,204,78,126,423,12,77,71,149,8,30,76
"2011","Derby 020A","E01013459","Total",595,110,47,63,485,35,66,82,74,35,104,89
"2011","Derby 020B","E01013567","Total",633,158,37,121,475,63,25,84,67,57,85,94
"2011","Derby 020C","E01013568","Total",751,240,68,172,511,78,55,74,95,41,93,75
"2011","Derby 020D","E01013569","Total",541,146,66,80,395,40,56,75,54,36,58,76
"2011","Derby 021A","E01013539","Total",718,63,11,52,655,24,33,203,107,44,112,132
"2011","Derby 021B","E01013541","Total",651,165,28,137,486,80,34,133,132,24,36,47
"2011","Derby 021C","E01013543","Total",624,98,52,46,526,17,72,138,122,29,53,95
"2011","Derby 021D","E01013544","Total",670,118,46,72,552,13,98,134,119,17,61,110
"2011","Derby 021E","E01013545","Total",714,242,102,140,472,42,99,97,108,15,40,71
"2011","Derby 022A","E01013488","Total",572,118,73,45,454,14,107,72,83,16,46,116
"2011","Derby 022B","E01013489","Total",618,163,100,63,455,14,130,57,92,23,44,95
"2011","Derby 022C","E01013490","Total",587,128,77,51,459,21,110,73,93,11,53,98
"2011","Derby 022D","E01013491","Total",600,159,89,70,441,21,89,77,77,29,70,78
"2011","Derby 023A","E01013570","Total",681,198,63,135,483,60,40,84,88,52,76,83
"2011","Derby 023B","E01013571","Total",670,175,62,113,495,76,69,86,96,36,61,71
"2011","Derby 023C","E01013572","Total",688,242,126,116,446,20,94,88,93,26,40,85
"2011","Derby 023D","E01013573","Total",813,246,44,202,567,106,44,115,118,40,63,81
"2011","Derby 024A","E01013470","Total",625,180,93,87,445,35,107,72,111,15,23,82
"2011","Derby 024B","E01013474","Total",719,286,109,177,433,30,91,90,124,16,23,59
"2011","Derby 024C","E01013476","Total",723,262,76,186,461,28,74,87,193,9,8,62
"2011","Derby 024E","E01033171","Total",655,201,72,129,454,42,60,74,197,13,14,54
"2011","Derby 024F","E01033172","Total",730,304,52,252,426,61,30,82,180,14,15,44
"2011","Derby 025A","E01013471","Total",806,264,70,194,542,80,49,114,162,22,34,81
"2011","Derby 025B","E01013473","Total",670,231,109,122,439,64,60,82,116,18,26,73
"2011","Derby 025C","E01013475","Total",573,130,38,92,443,64,34,82,96,41,52,74
"2011","Derby 025D","E01013477","Total",765,233,95,138,532,50,85,97,147,22,32,99
"2011","Derby 025E","E01013502","Total",614,204,113,91,410,45,67,81,99,15,40,63
"2011","Derby 025F","E01013503","Total",615,152,72,80,463,44,85,83,108,21,38,84
"2011","Derby 026A","E01013472","Total",965,393,122,271,572,109,78,106,129,31,42,77
"2011","Derby 026B","E01013497","Total",617,179,76,103,438,74,45,71,108,31,34,75
"2011","Derby 026C","E01013504","Total",714,186,61,125,528,70,57,103,121,39,58,80
"2011","Derby 026D","E01013583","Total",582,129,52,77,453,62,50,83,107,41,49,61
"2011","Derby 026E","E01013590","Total",643,190,63,127,453,84,32,85,75,40,63,74
"2011","Derby 026F","E01013591","Total",819,243,59,184,576,109,34,139,141,35,34,84
"2011","Derby 027A","E01013492","Total",594,128,68,60,466,10,123,79,87,17,49,101
"2011","Derby 027B","E01013493","Total",647,216,114,102,431,32,90,77,94,18,28,92
"2011","Derby 027C","E01013494","Total",795,241,123,118,554,61,105,119,135,24,38,72
"2011","Derby 027D","E01013495","Total",712,191,81,110,521,44,92,104,131,22,43,85
"2011","Derby 028A","E01013496","Total",661,219,79,140,442,79,60,89,105,36,28,45
"2011","Derby 028B","E01013498","Total",585,141,80,61,444,20,104,77,103,18,33,89
"2011","Derby 028C","E01013499","Total",646,249,142,107,397,22,94,72,95,13,34,67
"2011","Derby 028D","E01013500","Total",724,181,103,78,543,38,156,81,130,14,30,94
"2011","Derby 028E","E01013501","Total",620,193,128,65,427,15,101,78,126,4,24,79
"2011","Derby 029A","E01013584","Total",635,141,32,109,494,87,39,107,75,39,69,78
"2011","Derby 029B","E01013585","Total",660,199,75,124,461,52,37,106,96,37,50,83
"2011","Derby 029C","E01013586","Total",618,175,40,135,443,104,28,100,102,21,37,51
"2011","Derby 029D","E01013587","Total",590,154,57,97,436,35,66,72,99,19,52,93
"2011","Derby 029E","E01013588","Total",662,242,94,148,420,45,75,67,96,32,41,64
"2011","Derby 029F","E01013589","Total",551,131,52,79,420,15,78,75,102,13,37,100
"2011","Derby 030B","E01013517","Total",667,236,131,105,431,19,141,54,120,16,15,66
"2011","Derby 030C","E01013518","Total",581,155,85,70,426,16,111,73,109,10,28,79
"2011","Derby 030D","E01013521","Total",691,346,169,177,345,25,75,59,95,11,29,51
"2011","Derby 030E","E01033168","Total",494,79,29,50,415,29,67,120,106,19,26,48
"2011","Derby 030F","E01033169","Total",558,53,3,50,505,34,15,224,108,31,48,45
"2011","Derby 030G","E01033170","Total",566,199,72,127,367,26,74,106,107,8,18,28
"2011","Derby 031A","E01013514","Total",684,188,99,89,496,39,89,93,128,18,33,96
"2011","Derby 031B","E01013515","Total",730,225,135,90,505,50,65,133,99,16,51,91
"2011","Derby 031C","E01013519","Total",587,101,16,85,486,70,26,159,111,27,40,53
"2011","Derby 031D","E01013520","Total",645,162,89,73,483,21,101,103,133,12,33,80
"2011","Leicester 001A","E01013615","Total",543,82,20,62,461,23,24,118,139,10,55,92
"2011","Leicester 001B","E01013616","Total",683,204,26,178,479,69,39,103,167,16,32,53
"2011","Leicester 001C","E01013618","Total",685,237,69,168,448,54,45,87,132,11,29,90
"2011","Leicester 001D","E01013619","Total",639,178,36,142,461,83,40,79,89,28,66,76
"2011","Leicester 002A","E01013733","Total",619,155,30,125,464,45,39,124,124,28,36,68
"2011","Leicester 002B","E01013734","Total",531,119,73,46,412,7,69,53,78,17,49,139
"2011","Leicester 002C","E01013735","Total",469,95,59,36,374,6,60,45,62,7,49,145
"2011","Leicester 002D","E01013736","Total",720,220,84,136,500,25,99,103,122,24,40,87
"2011","Leicester 002E","E01013737","Total",465,65,30,35,400,17,43,70,70,11,62,127
"2011","Leicester 003A","E01013600","Total",755,233,96,137,522,97,71,86,87,33,54,94
"2011","Leicester 003B","E01013601","Total",644,207,98,109,437,46,47,63,80,40,61,100
"2011","Leicester 003C","E01013602","Total",797,283,79,204,514,95,56,99,132,16,37,79
"2011","Leicester 003D","E01013603","Total",798,331,77,254,467,98,65,81,105,15,45,58
"2011","Leicester 003E","E01013604","Total",648,201,88,113,447,65,56,92,81,21,50,82
"2011","Leicester 003F","E01013605","Total",698,209,60,149,489,58,62,90,110,18,56,95
"2011","Leicester 004A","E01013617","Total",936,231,32,199,705,49,31,171,207,31,81,135
"2011","Leicester 004B","E01013620","Total",694,212,35,177,482,120,32,94,82,33,53,68
"2011","Leicester 004C","E01013621","Total",743,276,50,226,467,92,28,98,83,36,62,68
"2011","Leicester 004D","E01013622","Total",729,312,50,262,417,78,39,81,94,27,39,59
"2011","Leicester 004E","E01013623","Total",807,169,31,138,638,37,63,133,183,26,64,132
"2011","Leicester 005A","E01013732","Total",742,155,55,100,587,36,75,127,119,39,71,120
"2011","Leicester 005B","E01013739","Total",570,166,87,79,404,21,72,56,70,18,48,119
"2011","Leicester 005C","E01013740","Total",499,83,47,36,416,11,70,58,68,12,58,139
"2011","Leicester 005D","E01013741","Total",529,95,53,42,434,22,45,67,54,19,92,135
"2011","Leicester 006A","E01013625","Total",668,205,60,145,463,30,58,89,87,10,54,135
"2011","Leicester 006B","E01013628","Total",645,255,83,172,390,34,50,64,104,19,42,77
"2011","Leicester 006C","E01013715","Total",439,90,49,41,349,9,55,45,50,6,62,122
"2011","Leicester 006D","E01013716","Total",560,97,50,47,463,12,56,79,65,14,90,147
"2011","Leicester 006E","E01013738","Total",491,80,52,28,411,13,80,38,59,15,70,136
"2011","Leicester 007A","E01013624","Total",511,116,63,53,395,31,53,56,64,25,60,106
"2011","Leicester 007B","E01013626","Total",574,103,42,61,471,22,37,101,66,24,87,134
"2011","Leicester 007C","E01013627","Total",421,74,35,39,347,5,43,42,50,9,62,136
"2011","Leicester 007D","E01013629","Total",527,87,40,47,440,31,33,57,63,21,83,152
"2011","Leicester 007E","E01013630","Total",576,84,33,51,492,37,43,101,66,29,75,141
"2011","Leicester 008A","E01013606","Total",693,189,96,93,504,29,120,85,93,18,50,109
"2011","Leicester 008B","E01013607","Total",1136,419,78,341,717,38,64,119,249,16,66,165
"2011","Leicester 008C","E01013680","Total",822,213,73,140,609,38,70,127,176,19,60,119
"2011","Leicester 008D","E01013685","Total",616,159,69,90,457,21,93,98,119,9,28,89
"2011","Leicester 008E","E01013686","Total",708,160,99,61,548,21,105,90,128,12,60,132
"2011","Leicester 009A","E01013696","Total",818,143,45,98,675,61,65,179,123,35,90,122
"2011","Leicester 009B","E01013697","Total",921,251,98,153,670,43,67,141,152,31,95,141
"2011","Leicester 009C","E01013699","Total",644,182,97,85,462,18,78,75,96,14,56,125
"2011","Leicester 009E","E01032862","Total",693,133,8,125,560,72,7,171,143,45,56,66
"2011","Leicester 009F","E01032863","Total",612,132,5,127,480,41,14,124,152,26,50,73
"2011","Leicester 009G","E01032865","Total",681,105,12,93,576,31,16,187,122,18,90,112
"2011","Leicester 010A","E01013713","Total",489,97,51,46,392,17,44,54,54,7,79,137
"2011","Leicester 010B","E01013714","Total",503,72,47,25,431,9,60,51,31,17,83,180
"2011","Leicester 010C","E01013717","Total",495,83,29,54,412,30,36,84,62,24,72,104
"2011","Leicester 010D","E01013718","Total",558,153,73,80,405,29,42,57,74,16,70,117
"2011","Leicester 010E","E01013719","Total",480,65,28,37,415,10,49,53,57,19,82,145
"2011","Leicester 010F","E01013720","Total",606,255,154,101,351,31,90,42,61,7,33,87
"2011","Leicester 011A","E01013651","Total",648,197,53,144,451,57,47,108,74,35,55,75
"2011","Leicester 011B","E01013652","Total",576,120,45,75,456,63,24,97,77,43,76,76
"2011","Leicester 011C","E01013653","Total",683,179,77,102,504,62,54,88,99,29,67,105
"2011","Leicester 011D","E01013655","Total",717,227,57,170,490,50,32,114,82,32,67,113
"2011","Leicester 012A","E01013721","Total",658,207,95,112,451,25,93,83,117,24,41,68
"2011","Leicester 012B","E01013723","Total",480,106,52,54,374,70,46,49,65,27,47,70
"2011","Leicester 012C","E01013725","Total",528,166,81,85,362,69,34,85,59,29,37,49
"2011","Leicester 012D","E01013726","Total",885,421,166,255,464,126,68,84,104,15,22,45
"2011","Leicester 012E","E01013728","Total",542,115,50,65,427,57,43,84,69,40,50,84
"2011","Leicester 013A","E01013694","Total",650,172,77,95,478,78,64,125,83,21,42,65
"2011","Leicester 013B","E01013700","Total",615,197,113,84,418,28,66,75,97,17,46,89
"2011","Leicester 013C","E01013770","Total",551,173,101,72,378,26,86,61,65,19,49,72
"2011","Leicester 013D","E01013771","Total",519,97,44,53,422,12,51,80,69,26,61,123
"2011","Leicester 013E","E01013773","Total",576,181,109,72,395,22,72,72,64,25,39,101
"2011","Leicester 016A","E01013681","Total",772,234,43,191,538,76,20,106,181,13,41,101
"2011","Leicester 016B","E01013682","Total",772,230,44,186,542,94,27,100,186,13,40,82
"2011","Leicester 016C","E01013683","Total",980,355,56,299,625,74,40,120,258,19,27,87
"2011","Leicester 016D","E01013684","Total",894,348,77,271,546,75,21,111,186,9,35,109
"2011","Leicester 017A","E01013654","Total",835,312,117,195,523,75,55,98,102,40,70,83
"2011","Leicester 017B","E01013656","Total",502,78,26,52,424,18,27,79,54,29,104,113
"2011","Leicester 017C","E01013657","Total",529,108,38,70,421,25,29,66,54,51,105,91
"2011","Leicester 017D","E01013658","Total",561,104,24,80,457,22,32,105,75,39,82,102
"2011","Leicester 017E","E01013659","Total",565,110,49,61,455,15,32,87,57,54,110,100
"2011","Leicester 017F","E01013743","Total",428,63,21,42,365,12,28,44,37,23,107,114
"2011","Leicester 017G","E01013745","Total",423,58,22,36,365,4,23,40,38,37,112,111
"2011","Leicester 018A","E01013742","Total",462,60,29,31,402,15,28,56,32,43,114,114
"2011","Leicester 018B","E01013744","Total",482,49,23,26,433,14,37,51,30,40,139,122
"2011","Leicester 018C","E01013746","Total",724,282,65,217,442,19,49,75,86,40,77,96
"2011","Leicester 018D","E01013748","Total",682,223,67,156,459,15,41,79,89,41,94,100
"2011","Leicester 018E","E01013754","Total",705,229,91,138,476,77,43,128,51,71,51,55
"2011","Leicester 018F","E01013755","Total",720,188,77,111,532,104,29,152,59,75,56,57
"2011","Leicester 019A","E01013660","Total",647,196,79,117,451,45,23,90,85,35,64,109
"2011","Leicester 019B","E01013661","Total",633,203,54,149,430,76,38,73,95,24,63,61
"2011","Leicester 019C","E01013664","Total",777,291,73,218,486,62,42,107,110,22,57,86
"2011","Leicester 019D","E01013665","Total",620,159,52,107,461,26,48,78,77,32,80,120
"2011","Leicester 019E","E01013667","Total",678,282,136,146,396,29,78,60,71,23,63,72
"2011","Leicester 019F","E01013668","Total",578,169,73,96,409,25,55,92,81,28,57,71
"2011","Leicester 020A","E01013729","Total",545,147,75,72,398,33,66,74,118,13,26,68
"2011","Leicester 020B","E01013780","Total",622,169,77,92,453,21,69,103,134,9,32,85
"2011","Leicester 020C","E01013783","Total",619,165,67,98,454,16,75,97,117,14,44,91
"2011","Leicester 020D","E01013785","Total",542,111,61,50,431,4,82,73,110,25,42,95
"2011","Leicester 020E","E01013786","Total",700,255,75,180,445,31,55,69,162,16,32,80
"2011","Leicester 021A","E01013662","Total",517,79,26,53,438,12,45,68,59,35,102,117
"2011","Leicester 021B","E01013663","Total",512,66,42,24,446,15,52,77,51,24,112,115
"2011","Leicester 021C","E01013747","Total",532,77,42,35,455,25,40,63,58,48,103,118
"2011","Leicester 021D","E01013749","Total",449,76,41,35,373,9,37,63,39,36,95,94
"2011","Leicester 021E","E01013750","Total",416,70,27,43,346,9,41,44,31,25,100,96
"2011","Leicester 021F","E01013758","Total",428,51,26,25,377,11,41,33,39,39,104,110
"2011","Leicester 022A","E01013751","Total",524,82,37,45,442,11,33,74,64,40,109,111
"2011","Leicester 022B","E01013752","Total",444,83,50,33,361,9,37,55,33,31,86,110
"2011","Leicester 022C","E01013753","Total",517,112,28,84,405,28,24,81,47,45,65,115
"2011","Leicester 022D","E01013760","Total",698,285,38,247,413,16,21,54,102,18,57,145
"2011","Leicester 022E","E01013761","Total",619,142,47,95,477,53,23,112,49,69,78,93
"2011","Leicester 022F","E01013762","Total",542,119,33,86,423,17,35,53,64,34,91,129
"2011","Leicester 023A","E01013774","Total",704,194,32,162,510,47,20,60,169,3,27,184
"2011","Leicester 023B","E01013776","Total",754,336,39,297,418,29,17,51,135,7,20,159
"2011","Leicester 023C","E01013778","Total",939,397,55,342,542,52,21,75,214,15,31,134
"2011","Leicester 023D","E01013779","Total",893,360,36,324,533,40,13,77,220,9,16,158
"2011","Leicester 023E","E01013781","Total",768,366,32,334,402,25,19,48,178,6,21,105
"2011","Leicester 023F","E01013782","Total",673,277,109,168,396,27,41,78,133,11,24,82
"2011","Leicester 023G","E01013784","Total",525,164,49,115,361,10,31,45,100,4,26,145
"2011","Leicester 025A","E01013666","Total",597,131,95,36,466,8,135,56,77,11,53,126
"2011","Leicester 025B","E01013669","Total",457,68,52,16,389,8,92,47,46,14,63,119
"2011","Leicester 025C","E01013670","Total",707,238,129,109,469,18,100,67,101,17,54,112
"2011","Leicester 025D","E01013671","Total",589,127,71,56,462,19,59,77,85,32,91,99
"2011","Leicester 025E","E01013672","Total",511,132,95,37,379,6,110,48,58,8,67,82
"2011","Leicester 026A","E01013631","Total",544,107,46,61,437,54,47,96,90,30,51,69
"2011","Leicester 026B","E01013632","Total",740,273,104,169,467,91,50,67,79,35,69,76
"2011","Leicester 026C","E01013638","Total",664,200,95,105,464,108,39,81,71,40,44,81
"2011","Leicester 026D","E01013640","Total",636,121,33,88,515,113,24,108,83,67,56,64
"2011","Leicester 027A","E01013756","Total",675,183,45,138,492,31,52,73,108,33,68,127
"2011","Leicester 027B","E01013757","Total",489,96,55,41,393,5,56,56,49,32,87,108
"2011","Leicester 027C","E01013759","Total",531,68,44,24,463,13,53,51,52,52,113,129
"2011","Leicester 027D","E01013763","Total",828,353,49,304,475,33,20,65,125,29,46,157
"2011","Leicester 027E","E01013764","Total",458,70,37,33,388,15,37,47,45,19,92,133
"2011","Leicester 027F","E01013765","Total",548,150,37,113,398,17,20,56,58,25,60,162
"2011","Leicester 027G","E01013766","Total",500,96,36,60,404,6,38,47,37,41,116,119
"2011","Leicester 028A","E01013633","Total",681,231,88,143,450,60,54,82,99,28,41,86
"2011","Leicester 028B","E01013634","Total",622,200,125,75,422,49,74,77,72,20,33,97
"2011","Leicester 028C","E01013637","Total",764,290,121,169,474,65,52,85,105,31,63,73
"2011","Leicester 028D","E01013639","Total",538,116,34,82,422,63,26,106,102,32,44,49
"2011","Leicester 028E","E01013641","Total",617,168,36,132,449,33,37,68,130,15,46,120
"2011","Leicester 029A","E01013635","Total",595,164,61,103,431,15,72,72,103,10,38,121
"2011","Leicester 029B","E01013636","Total",492,93,37,56,399,13,76,52,88,6,47,117
"2011","Leicester 029C","E01013775","Total",968,310,29,281,658,56,32,121,258,3,28,160
"2011","Leicester 029D","E01013777","Total",731,238,41,197,493,54,28,74,208,7,22,100
"2011","Leicester 030A","E01013642","Total",837,337,52,285,500,17,58,75,196,8,21,125
"2011","Leicester 030B","E01013643","Total",738,217,63,154,521,17,37,77,169,8,24,189
"2011","Leicester 030C","E01013649","Total",684,322,83,239,362,4,30,38,189,6,10,85
"2011","Leicester 030D","E01013650","Total",742,197,47,150,545,21,21,54,216,4,7,222
"2011","Leicester 030E","E01013702","Total",623,182,77,105,441,17,66,84,113,15,33,113
"2011","Leicester 030F","E01013710","Total",714,356,106,250,358,8,49,76,143,11,25,46
"2011","Leicester 030G","E01013711","Total",728,359,106,253,369,11,70,55,126,19,20,68
"2011","Leicester 031A","E01013613","Total",775,281,48,233,494,78,40,105,198,6,17,50
"2011","Leicester 031B","E01013614","Total",714,226,75,151,488,54,70,87,172,18,19,68
"2011","Leicester 031C","E01013687","Total",737,298,33,265,439,63,23,86,166,5,25,71
"2011","Leicester 031D","E01013688","Total",699,291,71,220,408,36,31,90,134,8,14,95
"2011","Leicester 032A","E01013703","Total",513,117,43,74,396,12,83,78,104,17,18,84
"2011","Leicester 032B","E01013704","Total",597,198,70,128,399,16,54,78,136,16,29,70
"2011","Leicester 032C","E01013706","Total",646,165,79,86,481,10,84,109,130,22,37,89
"2011","Leicester 032D","E01013707","Total",602,135,66,69,467,21,73,131,103,25,42,72
"2011","Leicester 032E","E01013712","Total",570,212,114,98,358,6,89,71,98,10,32,52
"2011","Leicester 034A","E01013608","Total",627,134,66,68,493,28,90,105,142,15,27,86
"2011","Leicester 034B","E01013609","Total",741,271,116,155,470,22,115,84,127,8,23,91
"2011","Leicester 034C","E01013610","Total",747,271,131,140,476,50,70,101,130,15,33,77
"2011","Leicester 034D","E01013611","Total",604,176,67,109,428,38,75,65,105,24,40,81
"2011","Leicester 034E","E01013612","Total",631,175,73,102,456,26,88,84,134,18,25,81
"2011","Leicester 035A","E01013678","Total",644,161,81,80,483,54,84,96,101,30,30,88
"2011","Leicester 035B","E01013679","Total",520,110,37,73,410,68,31,67,62,44,58,80
"2011","Leicester 035C","E01013691","Total",606,161,43,118,445,88,57,65,77,28,62,68
"2011","Leicester 035D","E01013692","Total",483,111,42,69,372,68,35,71,54,29,54,61
"2011","Leicester 035E","E01013693","Total",522,124,56,68,398,77,47,55,65,22,52,80
"2011","Leicester 036A","E01013673","Total",611,199,105,94,412,55,61,83,71,24,44,74
"2011","Leicester 036B","E01013674","Total",774,330,192,138,444,66,94,55,108,22,30,69
"2011","Leicester 036C","E01013675","Total",667,185,95,90,482,65,69,70,122,26,47,83
"2011","Leicester 036D","E01013676","Total",823,261,89,172,562,105,51,118,150,31,47,60
"2011","Leicester 036E","E01013677","Total",672,231,94,137,441,66,64,74,113,23,31,70
"2011","Leicester 037A","E01013695","Total",609,166,96,70,443,77,71,68,86,24,38,79
"2011","Leicester 037B","E01013698","Total",587,148,93,55,439,47,73,79,85,18,40,97
"2011","Leicester 037C","E01013767","Total",567,139,81,58,428,31,87,60,64,21,47,118
"2011","Leicester 037D","E01013768","Total",705,290,159,131,415,43,123,59,84,13,27,66
"2011","Leicester 037E","E01013772","Total",616,167,83,84,449,63,67,88,90,18,54,69
"2011","Leicester 037F","E01032597","Total",655,258,114,144,397,66,76,76,85,19,34,41
"2011","Leicester 038A","E01013689","Total",519,182,42,140,337,12,20,39,100,7,18,141
"2011","Leicester 038B","E01013690","Total",656,197,46,151,459,43,59,78,124,11,29,115
"2011","Leicester 038C","E01013705","Total",667,240,90,150,427,32,71,91,92,16,42,83
"2011","Leicester 038D","E01013709","Total",552,120,66,54,432,14,92,76,70,19,56,105
"2011","Leicester 038E","E01032599","Total",580,118,69,49,462,25,91,96,96,16,45,93
"2011","Leicester 039A","E01013722","Total",598,143,74,69,455,59,57,101,69,36,49,84
"2011","Leicester 039B","E01013727","Total",649,237,84,153,412,56,49,79,110,20,37,61
"2011","Leicester 039C","E01013730","Total",758,329,73,256,429,120,39,90,104,20,16,40
"2011","Leicester 039D","E01013731","Total",648,170,30,140,478,75,36,126,128,20,35,58
"2011","Leicester 039E","E01032602","Total",601,157,64,93,444,72,51,83,65,36,52,85
"2011","Leicester 040A","E01013646","Total",1099,624,62,562,475,5,29,46,210,2,21,162
"2011","Leicester 040B","E01013647","Total",947,581,68,513,366,25,21,26,136,7,11,140
"2011","Leicester 040C","E01013648","Total",746,183,26,157,563,50,15,53,116,9,32,288
"2011","Leicester 040D","E01032875","Total",423,181,13,168,242,10,3,11,64,1,6,147
"2011","Leicester 041A","E01032867","Total",813,466,26,440,347,10,7,46,215,3,7,59
"2011","Leicester 041B","E01032868","Total",483,198,2,196,285,13,0,21,154,1,3,93
"2011","Leicester 041C","E01032872","Total",778,445,6,439,333,3,1,25,258,2,2,42
"2011","Leicester 041D","E01032873","Total",887,604,41,563,283,3,0,22,182,2,2,72
"2011","Nottingham 001A","E01013887","Total",637,118,58,60,519,22,145,72,136,9,34,101
"2011","Nottingham 001B","E01013892","Total",600,128,67,61,472,16,165,58,99,10,35,89
"2011","Nottingham 001C","E01013893","Total",583,184,25,159,399,100,39,78,90,15,32,45
"2011","Nottingham 001D","E01013894","Total",638,169,72,97,469,28,125,60,118,11,33,94
"2011","Nottingham 002A","E01013879","Total",573,194,72,122,379,86,43,65,95,19,26,45
"2011","Nottingham 002B","E01013880","Total",678,244,124,120,434,71,70,72,117,20,25,59
"2011","Nottingham 002C","E01013881","Total",649,217,99,118,432,79,51,90,105,17,31,59
"2011","Nottingham 002D","E01013882","Total",628,214,90,124,414,77,57,63,110,13,26,68
"2011","Nottingham 002E","E01013885","Total",769,304,102,202,465,89,54,82,137,18,35,50
"2011","Nottingham 004A","E01013886","Total",660,221,73,148,439,39,67,79,131,9,29,85
"2011","Nottingham 004B","E01013888","Total",696,260,114,146,436,33,84,73,121,16,30,79
"2011","Nottingham 004C","E01013889","Total",721,205,102,103,516,37,107,89,151,12,39,81
"2011","Nottingham 004D","E01013890","Total",661,181,52,129,480,56,70,96,137,15,22,84
"2011","Nottingham 004E","E01013891","Total",731,273,68,205,458,65,50,90,111,21,38,83
"2011","Nottingham 005A","E01013875","Total",521,98,41,57,423,25,49,91,125,16,34,83
"2011","Nottingham 005B","E01013876","Total",757,258,84,174,499,71,58,104,137,20,44,65
"2011","Nottingham 005C","E01013877","Total",680,318,81,237,362,108,41,53,72,29,18,41
"2011","Nottingham 005D","E01013878","Total",538,175,52,123,363,81,37,56,80,24,36,49
"2011","Nottingham 005E","E01013883","Total",681,230,67,163,451,68,59,80,136,10,32,66
"2011","Nottingham 005F","E01013884","Total",639,252,64,188,387,80,44,74,113,11,19,46
"2011","Nottingham 006A","E01013853","Total",653,217,79,138,436,26,112,84,102,13,33,66
"2011","Nottingham 006B","E01013854","Total",639,235,63,172,404,58,52,78,101,16,33,66
"2011","Nottingham 006C","E01013855","Total",642,171,34,137,471,122,37,116,100,33,27,36
"2011","Nottingham 006D","E01013856","Total",638,182,75,107,456,62,49,101,110,23,40,71
"2011","Nottingham 006F","E01033397","Total",694,161,24,137,533,81,35,144,146,18,39,70
"2011","Nottingham 006G","E01033398","Total",637,330,31,299,307,46,16,72,128,7,13,25
"2011","Nottingham 007A","E01013963","Total",718,262,113,149,456,84,54,77,131,14,33,63
"2011","Nottingham 007B","E01013964","Total",671,153,64,89,518,48,78,113,142,19,36,82
"2011","Nottingham 007C","E01013965","Total",617,202,98,104,415,42,57,71,104,28,32,81
"2011","Nottingham 007D","E01013966","Total",568,169,52,117,399,49,39,82,99,18,41,71
"2011","Nottingham 007E","E01013967","Total",478,149,53,96,329,23,45,66,94,11,28,62
"2011","Nottingham 008A","E01013827","Total",608,188,74,114,420,76,32,104,98,18,32,60
"2011","Nottingham 008B","E01013828","Total",790,296,92,204,494,60,61,86,178,8,26,75
"2011","Nottingham 008C","E01013834","Total",642,184,94,90,458,95,46,86,96,25,39,71
"2011","Nottingham 008D","E01013835","Total",715,237,85,152,478,75,62,88,130,18,28,77
"2011","Nottingham 008E","E01013836","Total",872,322,85,237,550,102,40,120,182,26,26,54
"2011","Nottingham 009A","E01013829","Total",797,325,97,228,472,65,55,91,165,13,28,55
"2011","Nottingham 009B","E01013830","Total",696,186,83,103,510,47,103,71,135,20,44,90
"2011","Nottingham 009C","E01013831","Total",672,184,72,112,488,25,87,99,145,16,25,91
"2011","Nottingham 009D","E01013832","Total",745,307,79,228,438,51,66,64,130,15,38,74
"2011","Nottingham 009E","E01013833","Total",561,173,59,114,388,68,40,62,94,15,30,79
"2011","Nottingham 010A","E01013935","Total",744,284,96,188,460,23,122,88,146,11,11,59
"2011","Nottingham 010B","E01013968","Total",669,324,188,136,345,9,97,49,107,8,16,59
"2011","Nottingham 010C","E01013969","Total",798,328,61,267,470,30,54,71,202,7,25,81
"2011","Nottingham 010D","E01013970","Total",670,212,39,173,458,26,41,113,162,12,32,72
"2011","Nottingham 010E","E01013971","Total",769,363,74,289,406,29,30,82,177,9,8,71
"2011","Nottingham 011A","E01013817","Total",642,156,56,100,486,149,35,96,81,38,34,53
"2011","Nottingham 011B","E01013818","Total",579,112,29,83,467,111,31,73,75,38,78,61
"2011","Nottingham 011C","E01013822","Total",641,153,44,109,488,147,29,88,92,28,51,53
"2011","Nottingham 011D","E01013825","Total",690,154,54,100,536,94,46,99,116,38,49,94
"2011","Nottingham 011E","E01013826","Total",706,160,35,125,546,167,33,118,82,43,55,48
"2011","Nottingham 012A","E01013837","Total",736,208,58,150,528,26,67,116,158,25,35,101
"2011","Nottingham 012B","E01013838","Total",664,182,64,118,482,28,79,92,155,27,32,69
"2011","Nottingham 012C","E01013839","Total",862,373,84,289,489,82,30,99,173,22,25,58
"2011","Nottingham 012D","E01013840","Total",982,348,50,298,634,61,47,125,240,29,39,93
"2011","Nottingham 012E","E01013841","Total",692,243,31,212,449,67,24,93,155,24,30,56
"2011","Nottingham 013A","E01013819","Total",735,263,97,166,472,91,60,90,99,31,44,57
"2011","Nottingham 013B","E01013820","Total",669,140,46,94,529,126,32,130,99,28,45,69
"2011","Nottingham 013C","E01013821","Total",627,144,32,112,483,125,42,102,80,24,44,66
"2011","Nottingham 013D","E01013823","Total",666,146,52,94,520,88,45,112,91,35,66,83
"2011","Nottingham 013E","E01013824","Total",599,120,42,78,479,110,38,101,101,37,23,69
"2011","Nottingham 014A","E01013864","Total",710,268,30,238,442,127,25,115,107,13,22,33
"2011","Nottingham 014B","E01013865","Total",752,344,179,165,408,63,78,61,92,20,33,61
"2011","Nottingham 014C","E01013866","Total",609,215,98,117,394,36,75,72,73,16,45,77
"2011","Nottingham 014D","E01013867","Total",598,132,47,85,466,96,46,88,99,30,45,62
"2011","Nottingham 015A","E01013937","Total",748,230,51,179,518,31,81,95,188,20,30,73
"2011","Nottingham 015B","E01013938","Total",704,292,84,208,412,10,56,80,146,17,37,66
"2011","Nottingham 015C","E01013941","Total",827,415,95,320,412,18,47,56,214,6,11,60
"2011","Nottingham 015D","E01013943","Total",812,408,33,375,404,23,25,52,186,11,16,91
"2011","Nottingham 015E","E01013972","Total",693,290,62,228,403,37,31,72,165,8,20,70
"2011","Nottingham 016A","E01013936","Total",1057,367,67,300,690,71,71,116,310,11,33,78
"2011","Nottingham 016B","E01013939","Total",769,316,89,227,453,36,71,71,170,8,29,68
"2011","Nottingham 016C","E01013940","Total",753,271,35,236,482,96,31,89,148,25,41,52
"2011","Nottingham 016D","E01013942","Total",958,400,91,309,558,90,51,101,156,39,43,78
"2011","Nottingham 017A","E01013843","Total",663,304,63,241,359,13,31,44,139,17,26,89
"2011","Nottingham 017B","E01013844","Total",621,240,49,191,381,31,12,65,133,25,35,80
"2011","Nottingham 017C","E01013845","Total",606,163,33,130,443,24,23,95,128,53,49,71
"2011","Nottingham 017D","E01013847","Total",433,112,31,81,321,18,17,18,75,16,78,99
"2011","Nottingham 018A","E01013810","Total",617,186,45,141,431,48,26,94,99,38,56,70
"2011","Nottingham 018B","E01013811","Total",588,253,35,218,335,31,18,44,75,28,37,102
"2011","Nottingham 018C","E01013812","Total",570,161,18,143,409,62,26,62,77,26,63,93
"2011","Nottingham 018D","E01013842","Total",648,197,33,164,451,56,20,75,132,39,50,79
"2011","Nottingham 018E","E01013846","Total",684,295,64,231,389,20,15,47,116,33,55,103
"2011","Nottingham 019A","E01013930","Total",731,214,41,173,517,50,55,94,124,47,73,74
"2011","Nottingham 019B","E01013931","Total",622,176,125,51,446,11,127,47,64,31,71,95
"2011","Nottingham 019C","E01013932","Total",658,183,99,84,475,19,102,52,94,42,68,98
"2011","Nottingham 019D","E01013933","Total",780,277,83,194,503,97,50,92,112,25,51,76
"2011","Nottingham 019E","E01013934","Total",647,227,128,99,420,27,71,67,95,14,41,105
"2011","Nottingham 020A","E01013859","Total",732,315,172,143,417,21,100,59,123,15,24,75
"2011","Nottingham 020B","E01013861","Total",722,313,183,130,409,39,112,47,99,20,42,50
"2011","Nottingham 020C","E01013868","Total",627,237,111,126,390,46,77,47,63,34,53,70
"2011","Nottingham 020D","E01013929","Total",751,239,113,126,512,44,82,75,126,21,71,93
"2011","Nottingham 021A","E01013954","Total",594,223,54,169,371,59,37,48,110,18,40,59
"2011","Nottingham 021B","E01013959","Total",841,341,91,250,500,106,59,91,108,29,36,71
"2011","Nottingham 021C","E01013960","Total",770,387,83,304,383,77,35,83,74,14,34,66
"2011","Nottingham 021D","E01013962","Total",859,357,90,267,502,84,58,87,137,13,34,89
"2011","Nottingham 022A","E01013813","Total",758,430,55,375,328,29,16,39,96,9,12,127
"2011","Nottingham 022B","E01013814","Total",841,383,15,368,458,16,4,15,232,10,18,163
"2011","Nottingham 022C","E01013815","Total",627,285,18,267,342,12,7,12,125,8,17,161
"2011","Nottingham 022D","E01013816","Total",914,381,53,328,533,15,23,21,264,17,19,174
"2011","Nottingham 023C","E01013958","Total",838,342,101,241,496,102,47,79,137,22,39,70
"2011","Nottingham 023D","E01013961","Total",853,290,64,226,563,51,28,46,135,27,24,252
"2011","Nottingham 023E","E01033399","Total",569,310,43,267,259,28,13,26,105,11,11,65
"2011","Nottingham 023F","E01033401","Total",559,243,8,235,316,18,7,21,208,1,10,51
"2011","Nottingham 023G","E01033405","Total",711,455,20,435,256,16,9,11,186,0,1,33
"2011","Nottingham 023H","E01033409","Total",619,432,34,398,187,7,18,4,114,0,3,41
"2011","Nottingham 023I","E01033411","Total",578,332,101,231,246,50,20,44,52,20,12,48
"2011","Nottingham 024A","E01013913","Total",688,193,85,108,495,29,91,80,115,21,57,102
"2011","Nottingham 024B","E01013914","Total",627,140,64,76,487,20,93,75,105,31,68,95
"2011","Nottingham 024C","E01013915","Total",656,216,113,103,440,30,115,66,84,20,49,76
"2011","Nottingham 024D","E01013916","Total",622,185,60,125,437,89,49,85,100,21,40,53
"2011","Nottingham 024E","E01013917","Total",783,288,62,226,495,63,40,106,147,18,49,72
"2011","Nottingham 025A","E01013858","Total",592,176,77,99,416,38,79,79,89,23,45,63
"2011","Nottingham 025B","E01013860","Total",713,273,182,91,440,36,91,69,102,26,32,84
"2011","Nottingham 025C","E01013862","Total",640,231,103,128,409,62,47,73,75,35,48,69
"2011","Nottingham 025D","E01013863","Total",620,189,96,93,431,38,69,74,123,16,38,73
"2011","Nottingham 026A","E01013944","Total",651,215,79,136,436,23,56,76,91,42,57,91
"2011","Nottingham 026B","E01013945","Total",610,217,38,179,393,44,17,57,106,29,44,96
"2011","Nottingham 026D","E01013947","Total",759,272,55,217,487,38,19,87,142,23,48,130
"2011","Nottingham 026E","E01013948","Total",754,500,52,448,254,41,4,43,88,13,20,45
"2011","Nottingham 026F","E01013953","Total",513,109,25,84,404,8,3,25,93,5,11,259
"2011","Nottingham 026G","E01033395","Total",549,274,3,271,275,19,3,13,120,2,5,113
"2011","Nottingham 026H","E01033396","Total",552,267,62,205,285,43,15,39,94,10,9,75
"2011","Nottingham 027A","E01013977","Total",766,210,102,108,556,18,111,125,141,26,33,102
"2011","Nottingham 027B","E01013978","Total",669,189,106,83,480,25,67,106,123,26,46,87
"2011","Nottingham 027C","E01013979","Total",601,131,63,68,470,14,76,127,114,20,44,75
"2011","Nottingham 027D","E01013981","Total",653,148,80,68,505,21,86,83,150,21,48,96
"2011","Nottingham 028E","E01032520","Total",1058,378,64,314,680,6,65,55,402,7,12,133
"2011","Nottingham 028F","E01032522","Total",1002,403,60,343,599,7,50,55,334,9,9,135
"2011","Nottingham 028G","E01033404","Total",1219,435,63,372,784,15,22,25,190,9,28,495
"2011","Nottingham 029A","E01013918","Total",781,255,52,203,526,56,28,104,157,36,43,102
"2011","Nottingham 029B","E01013919","Total",836,285,33,252,551,56,32,80,189,25,59,110
"2011","Nottingham 029C","E01013920","Total",1219,670,127,543,549,72,61,88,179,25,26,98
"2011","Nottingham 029D","E01013921","Total",882,342,86,256,540,80,23,90,142,67,55,83
"2011","Nottingham 029E","E01013957","Total",654,214,44,170,440,80,32,92,107,21,39,69
"2011","Nottingham 030A","E01013980","Total",666,165,92,73,501,15,107,107,138,19,39,76
"2011","Nottingham 030B","E01013982","Total",625,145,98,47,480,13,118,90,111,22,47,79
"2011","Nottingham 030C","E01013983","Total",733,359,114,245,374,51,65,58,103,10,25,62
"2011","Nottingham 030D","E01013984","Total",643,180,138,42,463,10,171,64,92,18,33,75
"2011","Nottingham 030E","E01013985","Total",739,214,134,80,525,13,156,106,85,17,45,103
"2011","Nottingham 031C","E01013924","Total",723,435,73,362,288,11,11,16,55,0,5,190
"2011","Nottingham 031E","E01013926","Total",633,217,46,171,416,28,18,30,112,12,23,193
"2011","Nottingham 031G","E01013928","Total",548,115,22,93,433,8,15,50,113,11,13,223
"2011","Nottingham 031H","E01033408","Total",1014,324,56,268,690,16,48,32,101,12,31,450
"2011","Nottingham 031I","E01033410","Total",820,205,63,142,615,9,32,28,106,14,13,413
"2011","Nottingham 032A","E01013973","Total",401,190,54,136,211,31,17,47,69,4,10,33
"2011","Nottingham 032B","E01013974","Total",667,246,132,114,421,6,100,47,93,13,23,139
"2011","Nottingham 032C","E01013975","Total",425,126,65,61,299,8,65,46,66,8,31,75
"2011","Nottingham 032D","E01013976","Total",679,185,38,147,494,67,31,112,161,22,24,77
"2011","Nottingham 034A","E01013895","Total",636,155,115,40,481,13,147,73,102,18,28,100
"2011","Nottingham 034B","E01013896","Total",588,249,71,178,339,41,60,54,82,17,29,56
"2011","Nottingham 034C","E01013901","Total",639,194,65,129,445,20,75,94,152,12,27,65
"2011","Nottingham 034D","E01013902","Total",677,205,108,97,472,14,106,93,161,7,23,68
"2011","Nottingham 035A","E01013897","Total",641,223,106,117,418,41,87,52,110,9,45,74
"2011","Nottingham 035B","E01013898","Total",436,162,85,77,274,17,35,40,75,10,29,68
"2011","Nottingham 035C","E01013899","Total",492,120,63,57,372,42,44,51,91,21,34,89
"2011","Nottingham 035D","E01013900","Total",672,245,80,165,427,42,62,69,133,24,25,72
"2011","Nottingham 035E","E01013903","Total",491,107,62,45,384,22,80,50,87,16,38,91
"2011","Nottingham 035F","E01013907","Total",756,378,198,180,378,48,78,58,87,14,31,62
"2011","Nottingham 036A","E01013905","Total",633,187,96,91,446,44,57,87,117,21,46,74
"2011","Nottingham 036B","E01013908","Total",774,286,200,86,488,60,136,99,76,17,32,68
"2011","Nottingham 036C","E01013909","Total",786,366,130,236,420,66,75,63,115,12,21,68
"2011","Nottingham 036D","E01013912","Total",666,177,86,91,489,26,88,72,138,14,28,123
"2011","Nottingham 037A","E01013904","Total",626,174,101,73,452,50,78,66,103,24,51,80
"2011","Nottingham 037B","E01013906","Total",689,226,113,113,463,48,70,87,108,18,33,99
"2011","Nottingham 037C","E01013910","Total",628,207,112,95,421,42,73,76,93,24,24,89
"2011","Nottingham 037D","E01013911","Total",690,252,122,130,438,40,101,77,109,12,35,64
"2011","Nottingham 038A","E01013849","Total",693,262,103,159,431,92,48,72,103,24,27,65
"2011","Nottingham 038B","E01013850","Total",715,316,114,202,399,51,101,44,85,17,40,61
"2011","Nottingham 038C","E01013851","Total",786,348,126,222,438,103,50,63,117,12,30,63
"2011","Nottingham 038D","E01013852","Total",763,323,125,198,440,37,100,73,121,17,18,74
"2011","Nottingham 038E","E01032621","Total",704,253,91,162,451,38,113,59,98,17,33,93
"2011","Nottingham 039A","E01013874","Total",684,258,47,211,426,28,33,60,171,10,21,103
"2011","Nottingham 039B","E01033400","Total",599,234,35,199,365,47,17,44,155,18,28,56
"2011","Nottingham 039C","E01033402","Total",623,328,2,326,295,1,2,18,235,1,2,36
"2011","Nottingham 039D","E01033403","Total",639,334,14,320,305,15,5,20,220,4,8,33
"2011","Nottingham 039E","E01033406","Total",602,277,1,276,325,3,0,4,250,0,6,62
"2011","Nottingham 039F","E01033407","Total",640,309,15,294,331,4,10,15,248,3,0,51
"2011","Nottingham 040A","E01013870","Total",1026,476,115,361,550,68,41,82,232,20,39,68
"2011","Nottingham 040B","E01013871","Total",858,437,174,263,421,71,56,75,91,24,38,66
"2011","Nottingham 040C","E01013872","Total",821,360,86,274,461,51,41,83,130,27,45,84
"2011","Nottingham 040D","E01013873","Total",619,158,22,136,461,57,22,53,135,20,52,122
"2011","Rutland 001A","E01013788","Total",1014,231,117,114,783,30,176,206,214,32,42,83
"2011","Rutland 001B","E01013789","Total",596,146,72,74,450,14,122,57,148,17,29,63
"2011","Rutland 001C","E01013790","Total",501,106,51,55,395,9,97,63,114,13,22,77
"2011","Rutland 001D","E01013796","Total",565,130,68,62,435,15,97,116,114,19,23,51
"2011","Rutland 002A","E01013793","Total",610,163,78,85,447,21,157,73,115,15,22,44
"2011","Rutland 002B","E01013800","Total",659,175,92,83,484,17,131,76,115,21,30,94
"2011","Rutland 002C","E01013801","Total",725,254,112,142,471,38,83,85,128,29,27,81
"2011","Rutland 002D","E01013809","Total",525,102,50,52,423,11,127,67,119,11,24,64
"2011","Rutland 003A","E01013798","Total",579,122,53,69,457,25,87,99,127,15,26,78
"2011","Rutland 003B","E01013799","Total",651,298,132,166,353,35,51,70,124,14,19,40
"2011","Rutland 003C","E01013802","Total",1178,359,213,146,819,32,289,140,206,21,35,96
"2011","Rutland 003D","E01013803","Total",982,261,162,99,721,43,200,118,175,34,37,114
"2011","Rutland 004A","E01013791","Total",483,146,97,49,337,16,110,63,76,13,14,45
"2011","Rutland 004B","E01013792","Total",684,158,91,67,526,18,150,109,130,19,29,71
"2011","Rutland 004C","E01013797","Total",724,179,94,85,545,19,127,128,169,14,22,66
"2011","Rutland 004D","E01013804","Total",661,168,81,87,493,25,117,80,130,13,24,104
"2011","Rutland 004E","E01013805","Total",536,128,79,49,408,22,88,80,118,16,23,61
"2011","Rutland 005A","E01013787","Total",540,151,79,72,389,13,100,59,112,18,40,47
"2011","Rutland 005B","E01013794","Total",561,122,55,67,439,11,137,70,138,11,20,52
"2011","Rutland 005C","E01013795","Total",488,122,77,45,366,10,120,46,111,10,14,55
"2011","Rutland 005D","E01013806","Total",498,164,76,88,334,14,76,64,104,7,24,45
"2011","Rutland 005E","E01013807","Total",622,207,98,109,415,31,109,83,113,14,23,42
"2011","Rutland 005F","E01013808","Total",620,219,115,104,401,35,96,82,116,7,16,49
"2011","Amber Valley 001A","E01019400","Total",669,166,61,105,503,45,87,80,164,22,36,69
"2011","Amber Valley 001B","E01019401","Total",771,317,154,163,454,34,91,73,123,11,33,89
"2011","Amber Valley 001C","E01019402","Total",646,145,59,86,501,27,74,102,165,19,25,89
"2011","Amber Valley 001D","E01019404","Total",759,271,127,144,488,28,111,78,156,10,24,81
"2011","Amber Valley 002A","E01019406","Total",482,143,82,61,339,15,102,45,114,6,21,36
"2011","Amber Valley 002B","E01019423","Total",556,163,72,91,393,11,107,76,121,6,16,56
"2011","Amber Valley 002C","E01019424","Total",506,134,80,54,372,12,87,60,118,13,24,58
"2011","Amber Valley 002D","E01019477","Total",1006,289,165,124,717,25,204,104,228,19,31,106
"2011","Amber Valley 003A","E01019403","Total",675,259,133,126,416,41,92,71,100,15,41,56
"2011","Amber Valley 003B","E01019444","Total",594,205,77,128,389,77,52,71,105,19,22,43
"2011","Amber Valley 003C","E01019468","Total",650,172,71,101,478,31,74,82,163,20,34,74
"2011","Amber Valley 003D","E01019469","Total",657,153,57,96,504,65,53,114,137,32,36,67
"2011","Amber Valley 003E","E01019471","Total",642,248,99,149,394,47,48,74,123,19,28,55
"2011","Amber Valley 004A","E01019443","Total",713,212,134,78,501,23,145,77,148,9,20,79
"2011","Amber Valley 004B","E01019470","Total",707,183,67,116,524,32,75,102,181,18,29,87
"2011","Amber Valley 004C","E01019473","Total",536,91,51,40,445,12,64,93,153,3,27,93
"2011","Amber Valley 004D","E01019474","Total",518,120,37,83,398,11,72,84,140,4,22,65
"2011","Amber Valley 004E","E01019475","Total",532,173,79,94,359,21,74,70,95,7,19,73
"2011","Amber Valley 004F","E01019476","Total",637,201,126,75,436,6,142,64,126,5,26,67
"2011","Amber Valley 005A","E01019420","Total",601,206,76,130,395,28,75,61,120,13,21,77
"2011","Amber Valley 005B","E01019442","Total",649,155,49,106,494,18,83,76,180,14,32,91
"2011","Amber Valley 005C","E01019445","Total",640,212,59,153,428,26,59,85,151,9,20,78
"2011","Amber Valley 005D","E01019455","Total",627,218,76,142,409,24,63,75,155,11,22,59
"2011","Amber Valley 005E","E01019456","Total",763,220,69,151,543,36,77,114,174,23,43,76
"2011","Amber Valley 005F","E01019457","Total",548,118,67,51,430,22,97,70,114,11,37,79
"2011","Amber Valley 006A","E01019429","Total",700,190,88,102,510,15,121,87,159,9,29,90
"2011","Amber Valley 006B","E01019454","Total",632,163,93,70,469,13,144,76,130,8,25,73
"2011","Amber Valley 006C","E01019460","Total",664,153,62,91,511,22,80,111,152,14,34,98
"2011","Amber Valley 006D","E01019461","Total",657,235,151,84,422,17,95,70,128,14,23,75
"2011","Amber Valley 006E","E01019462","Total",544,131,77,54,413,7,124,69,127,9,13,64
"2011","Amber Valley 007A","E01019405","Total",592,114,67,47,478,4,167,63,122,8,37,77
"2011","Amber Valley 007B","E01019414","Total",705,161,100,61,544,8,154,83,173,6,31,89
"2011","Amber Valley 007C","E01019428","Total",630,160,81,79,470,25,115,78,133,15,33,71
"2011","Amber Valley 007D","E01019430","Total",800,169,101,68,631,24,123,128,207,12,37,100
"2011","Amber Valley 008A","E01019421","Total",818,200,97,103,618,26,134,107,168,11,39,133
"2011","Amber Valley 008B","E01019422","Total",653,158,82,76,495,19,125,80,130,13,33,95
"2011","Amber Valley 008C","E01019432","Total",847,198,121,77,649,28,171,111,188,17,40,94
"2011","Amber Valley 008D","E01019458","Total",712,230,78,152,482,44,66,101,168,6,24,73
"2011","Amber Valley 008E","E01019459","Total",598,197,91,106,401,40,77,62,93,14,35,80
"2011","Amber Valley 008F","E01019463","Total",639,200,99,101,439,59,71,78,83,25,36,87
"2011","Amber Valley 009A","E01019408","Total",643,162,64,98,481,30,93,103,137,13,24,81
"2011","Amber Valley 009B","E01019409","Total",743,166,91,75,577,25,167,105,151,14,24,91
"2011","Amber Valley 009C","E01019412","Total",579,96,29,67,483,16,55,140,125,21,39,87
"2011","Amber Valley 009D","E01019413","Total",548,124,24,100,424,32,44,144,105,10,41,48
"2011","Amber Valley 009E","E01019416","Total",641,176,97,79,465,10,140,72,126,15,27,75
"2011","Amber Valley 010A","E01019407","Total",1017,416,126,290,601,37,104,119,224,13,32,72
"2011","Amber Valley 010B","E01019415","Total",801,264,115,149,537,33,104,107,182,15,26,70
"2011","Amber Valley 010C","E01019417","Total",912,344,165,179,568,61,107,93,169,18,34,86
"2011","Amber Valley 010D","E01019419","Total",913,295,97,198,618,34,122,115,246,5,27,69
"2011","Amber Valley 011A","E01019410","Total",631,161,61,100,470,24,61,104,162,11,24,84
"2011","Amber Valley 011B","E01019411","Total",644,189,90,99,455,23,88,87,124,18,37,78
"2011","Amber Valley 011C","E01019418","Total",703,153,57,96,550,31,94,136,140,21,37,91
"2011","Amber Valley 011D","E01019447","Total",651,173,94,79,478,19,136,79,142,14,28,60
"2011","Amber Valley 011E","E01019449","Total",784,231,88,143,553,29,101,100,194,15,34,80
"2011","Amber Valley 012A","E01019431","Total",600,135,74,61,465,33,66,93,139,14,36,84
"2011","Amber Valley 012B","E01019433","Total",769,179,85,94,590,46,114,105,173,20,41,91
"2011","Amber Valley 012C","E01019438","Total",667,162,56,106,505,32,67,122,126,26,41,91
"2011","Amber Valley 012D","E01019451","Total",830,225,69,156,605,39,88,125,198,18,37,100
"2011","Amber Valley 012E","E01019464","Total",792,156,77,79,636,23,129,151,173,18,35,107
"2011","Amber Valley 013A","E01019434","Total",540,157,61,96,383,30,87,64,115,10,21,56
"2011","Amber Valley 013B","E01019435","Total",662,145,49,96,517,31,59,123,177,24,34,69
"2011","Amber Valley 013C","E01019436","Total",558,151,57,94,407,20,76,83,114,12,27,75
"2011","Amber Valley 013D","E01019439","Total",516,118,51,67,398,19,57,74,106,11,40,91
"2011","Amber Valley 013E","E01019440","Total",662,186,95,91,476,23,94,99,150,12,20,78
"2011","Amber Valley 015A","E01019446","Total",509,104,40,64,405,12,68,70,152,9,25,69
"2011","Amber Valley 015B","E01019448","Total",686,148,65,83,538,11,121,109,154,27,31,85
"2011","Amber Valley 015C","E01019450","Total",639,199,75,124,440,39,83,88,121,15,22,72
"2011","Amber Valley 015D","E01019465","Total",525,176,106,70,349,14,99,46,92,12,26,60
"2011","Amber Valley 015E","E01019467","Total",650,166,87,79,484,9,135,71,154,12,33,70
"2011","Amber Valley 016A","E01019425","Total",639,132,98,34,507,20,156,99,81,22,49,80
"2011","Amber Valley 016B","E01019426","Total",672,236,163,73,436,18,125,72,100,24,38,59
"2011","Amber Valley 016C","E01019427","Total",717,187,101,86,530,30,106,131,99,41,52,71
"2011","Amber Valley 016D","E01019472","Total",1123,273,129,144,850,21,243,127,222,25,55,157
"2011","Amber Valley 017A","E01019437","Total",610,171,96,75,439,13,108,76,103,15,51,73
"2011","Amber Valley 017B","E01019441","Total",672,220,99,121,452,53,73,89,132,15,19,71
"2011","Amber Valley 017C","E01019452","Total",733,240,120,120,493,56,108,82,130,18,28,71
"2011","Amber Valley 017D","E01019453","Total",808,256,84,172,552,85,72,126,143,17,32,77
"2011","Amber Valley 017E","E01032613","Total",532,153,68,85,379,13,110,61,105,7,26,57
"2011","Bolsover 001A","E01019478","Total",652,159,53,106,493,27,101,112,148,17,23,65
"2011","Bolsover 001B","E01019479","Total",690,168,80,88,522,16,102,123,128,20,41,92
"2011","Bolsover 001C","E01019491","Total",981,285,100,185,696,55,120,159,202,18,50,92
"2011","Bolsover 001D","E01019493","Total",663,155,62,93,508,27,98,93,152,8,39,91
"2011","Bolsover 001E","E01019494","Total",913,309,159,150,604,28,160,85,169,9,47,106
"2011","Bolsover 002A","E01019492","Total",796,255,136,119,541,41,118,96,157,13,36,80
"2011","Bolsover 002B","E01019495","Total",703,170,76,94,533,31,132,72,164,14,33,87
"2011","Bolsover 002C","E01019524","Total",587,150,76,74,437,20,109,76,129,7,26,70
"2011","Bolsover 002D","E01019525","Total",652,181,99,82,471,36,90,87,140,8,26,84
"2011","Bolsover 003A","E01019496","Total",625,208,66,142,417,35,73,79,144,15,17,54
"2011","Bolsover 003B","E01019497","Total",651,214,130,84,437,30,115,54,124,10,26,78
"2011","Bolsover 003C","E01019498","Total",731,187,53,134,544,82,50,107,157,26,44,78
"2011","Bolsover 003D","E01019523","Total",500,193,87,106,307,36,57,50,98,10,15,41
"2011","Bolsover 004A","E01019483","Total",857,225,72,153,632,73,75,130,176,33,47,98
"2011","Bolsover 004B","E01019484","Total",864,239,99,140,625,36,139,82,194,13,53,108
"2011","Bolsover 004C","E01019485","Total",555,191,111,80,364,16,100,62,106,12,14,54
"2011","Bolsover 004D","E01019488","Total",643,234,65,169,409,57,44,90,115,18,31,54
"2011","Bolsover 005A","E01019486","Total",439,100,51,49,339,13,65,66,98,11,17,69
"2011","Bolsover 005B","E01019487","Total",715,283,174,109,432,37,78,70,108,23,39,77
"2011","Bolsover 005C","E01019489","Total",535,138,72,66,397,12,121,66,114,11,8,65
"2011","Bolsover 005D","E01019490","Total",475,116,56,60,359,15,60,69,113,12,34,56
"2011","Bolsover 005E","E01019502","Total",703,224,136,88,479,24,125,82,146,14,27,61
"2011","Bolsover 005F","E01019504","Total",611,206,116,90,405,19,96,70,126,7,24,63
"2011","Bolsover 006A","E01019508","Total",827,237,150,87,590,44,145,98,124,22,48,109
"2011","Bolsover 006B","E01019509","Total",489,137,74,63,352,57,51,70,70,14,33,57
"2011","Bolsover 006C","E01019510","Total",561,197,133,64,364,25,97,43,75,14,32,78
"2011","Bolsover 006D","E01019512","Total",1092,283,124,159,809,51,128,167,256,19,68,120
"2011","Bolsover 007A","E01019503","Total",1046,306,139,167,740,37,179,109,257,28,37,93
"2011","Bolsover 007B","E01019505","Total",605,161,59,102,444,31,65,85,114,27,26,96
"2011","Bolsover 007C","E01019506","Total",565,144,73,71,421,27,91,68,110,14,28,83
"2011","Bolsover 007D","E01019507","Total",778,298,130,168,480,39,87,104,106,15,43,86
"2011","Bolsover 007E","E01019511","Total",837,206,90,116,631,54,92,119,160,30,49,127
"2011","Bolsover 008A","E01019480","Total",677,203,95,108,474,25,136,82,127,10,30,64
"2011","Bolsover 008B","E01019482","Total",670,184,99,85,486,18,117,78,159,12,26,76
"2011","Bolsover 008C","E01019520","Total",724,175,78,97,549,29,97,107,163,21,36,96
"2011","Bolsover 008D","E01019521","Total",663,194,88,106,469,23,95,99,121,17,29,85
"2011","Bolsover 008E","E01019522","Total",648,202,86,116,446,35,60,103,133,20,29,66
"2011","Bolsover 009A","E01019481","Total",541,153,87,66,388,34,64,81,87,22,31,69
"2011","Bolsover 009B","E01019514","Total",661,180,67,113,481,35,67,103,152,17,37,70
"2011","Bolsover 009C","E01019515","Total",675,205,106,99,470,41,72,99,110,24,40,84
"2011","Bolsover 009D","E01019516","Total",682,215,86,129,467,35,104,67,160,11,23,67
"2011","Bolsover 009E","E01019519","Total",788,232,107,125,556,52,90,128,148,21,27,90
"2011","Bolsover 010A","E01019499","Total",599,200,84,116,399,29,71,68,131,12,22,66
"2011","Bolsover 010B","E01019500","Total",597,167,87,80,430,33,77,84,113,14,26,83
"2011","Bolsover 010C","E01019501","Total",654,180,104,76,474,16,110,85,150,10,25,78
"2011","Bolsover 010D","E01019513","Total",559,159,53,106,400,19,77,84,129,13,20,58
"2011","Bolsover 010E","E01019517","Total",657,161,56,105,496,26,63,124,170,9,26,78
"2011","Bolsover 010F","E01019518","Total",665,152,27,125,513,17,81,130,172,13,37,63
"2011","Chesterfield 001A","E01019526","Total",620,190,58,132,430,31,82,84,129,11,24,69
"2011","Chesterfield 001B","E01019528","Total",704,198,104,94,506,22,120,81,163,18,20,82
"2011","Chesterfield 001C","E01019572","Total",642,265,120,145,377,44,78,76,84,11,24,60
"2011","Chesterfield 001D","E01019573","Total",678,228,71,157,450,25,76,82,168,10,24,65
"2011","Chesterfield 001E","E01019574","Total",642,234,128,106,408,22,108,77,113,13,20,55
"2011","Chesterfield 002A","E01019563","Total",647,163,63,100,484,51,79,86,109,28,59,72
"2011","Chesterfield 002B","E01019564","Total",650,163,88,75,487,21,122,74,150,13,39,68
"2011","Chesterfield 002C","E01019565","Total",652,231,113,118,421,44,67,75,113,20,23,79
"2011","Chesterfield 002D","E01019566","Total",722,259,72,187,463,58,74,75,119,23,45,69
"2011","Chesterfield 002E","E01019568","Total",557,130,68,62,427,50,48,84,87,35,50,73
"2011","Chesterfield 003A","E01019527","Total",693,285,96,189,408,55,66,77,114,23,26,47
"2011","Chesterfield 003B","E01019529","Total",649,195,72,123,454,23,83,107,134,17,20,70
"2011","Chesterfield 003C","E01019530","Total",689,257,61,196,432,47,42,87,162,11,24,59
"2011","Chesterfield 003D","E01019531","Total",630,190,52,138,440,48,59,90,141,14,28,60
"2011","Chesterfield 003E","E01019553","Total",737,191,76,115,546,33,69,147,170,29,40,58
"2011","Chesterfield 004A","E01019541","Total",667,198,93,105,469,36,114,79,115,18,31,76
"2011","Chesterfield 004B","E01019542","Total",841,370,88,282,471,60,74,97,159,13,13,55
"2011","Chesterfield 004C","E01019543","Total",768,307,118,189,461,54,96,82,135,19,17,58
"2011","Chesterfield 004D","E01019544","Total",724,239,142,97,485,41,127,77,122,15,25,78
"2011","Chesterfield 004E","E01019571","Total",638,204,109,95,434,59,85,84,92,21,27,66
"2011","Chesterfield 005A","E01019532","Total",535,144,63,81,391,29,70,83,115,7,18,69
"2011","Chesterfield 005B","E01019533","Total",630,161,64,97,469,16,94,101,169,6,20,63
"2011","Chesterfield 005C","E01019534","Total",615,207,141,66,408,11,129,58,99,5,25,81
"2011","Chesterfield 005D","E01019535","Total",638,162,82,80,476,22,137,75,124,9,32,77
"2011","Chesterfield 005E","E01019536","Total",814,319,140,179,495,63,83,109,134,16,29,61
"2011","Chesterfield 006A","E01019549","Total",529,128,64,64,401,31,80,55,97,29,38,71
"2011","Chesterfield 006B","E01019550","Total",670,161,99,62,509,26,124,91,129,22,43,74
"2011","Chesterfield 006C","E01019551","Total",706,161,82,79,545,15,170,75,161,9,27,88
"2011","Chesterfield 006D","E01019552","Total",517,135,67,68,382,25,64,62,111,18,39,63
"2011","Chesterfield 006E","E01019567","Total",768,271,127,144,497,54,96,95,123,18,30,81
"2011","Chesterfield 007A","E01019537","Total",627,159,106,53,468,16,124,76,125,16,33,78
"2011","Chesterfield 007B","E01019569","Total",857,391,103,288,466,31,79,87,185,4,14,66
"2011","Chesterfield 007C","E01019570","Total",599,212,136,76,387,22,117,45,104,7,30,62
"2011","Chesterfield 007D","E01019580","Total",659,239,90,149,420,38,82,72,119,16,34,59
"2011","Chesterfield 007E","E01019581","Total",688,320,113,207,368,37,61,65,112,14,29,50
"2011","Chesterfield 008A","E01019557","Total",617,183,62,121,434,22,66,103,113,15,41,74
"2011","Chesterfield 008B","E01019558","Total",581,110,45,65,471,7,83,85,157,10,28,101
"2011","Chesterfield 008C","E01019559","Total",494,115,52,63,379,8,79,73,115,9,16,79
"2011","Chesterfield 008D","E01019560","Total",622,179,98,81,443,45,101,80,123,10,19,65
"2011","Chesterfield 008E","E01019561","Total",738,412,133,279,326,45,54,47,116,11,14,39
"2011","Chesterfield 008F","E01019562","Total",628,275,121,154,353,34,90,47,101,8,20,53
"2011","Chesterfield 009A","E01019539","Total",745,255,124,131,490,15,129,89,135,16,24,82
"2011","Chesterfield 009B","E01019540","Total",630,170,74,96,460,27,100,88,141,3,26,75
"2011","Chesterfield 009C","E01019555","Total",775,334,187,147,441,45,90,96,118,6,31,55
"2011","Chesterfield 009D","E01019590","Total",848,250,135,115,598,13,204,89,160,12,26,94
"2011","Chesterfield 009E","E01019591","Total",657,200,92,108,457,29,84,97,120,18,47,62
"2011","Chesterfield 010A","E01019538","Total",803,320,94,226,483,27,67,83,199,10,26,71
"2011","Chesterfield 010B","E01019554","Total",725,319,74,245,406,55,36,79,159,8,17,52
"2011","Chesterfield 010C","E01019556","Total",705,285,97,188,420,59,54,55,139,10,25,78
"2011","Chesterfield 010D","E01019579","Total",786,330,79,251,456,52,46,83,155,20,33,67
"2011","Chesterfield 010F","E01033387","Total",621,283,23,260,338,31,24,70,171,3,10,29
"2011","Chesterfield 010G","E01033388","Total",631,211,61,150,420,44,55,82,158,12,23,46
"2011","Chesterfield 011A","E01019586","Total",616,176,75,101,440,13,124,72,131,12,19,69
"2011","Chesterfield 011B","E01019587","Total",642,180,70,110,462,13,90,103,135,15,32,74
"2011","Chesterfield 011C","E01019588","Total",623,140,87,53,483,13,157,63,122,10,28,90
"2011","Chesterfield 011D","E01019589","Total",609,147,93,54,462,21,140,77,134,5,22,63
"2011","Chesterfield 011E","E01019592","Total",684,172,107,65,512,17,160,89,110,19,33,84
"2011","Chesterfield 011F","E01019593","Total",498,138,96,42,360,9,119,61,95,8,16,52
"2011","Chesterfield 012A","E01019545","Total",619,166,102,64,453,19,124,79,120,7,31,73
"2011","Chesterfield 012B","E01019546","Total",643,183,69,114,460,26,83,89,150,6,27,79
"2011","Chesterfield 012C","E01019547","Total",653,246,85,161,407,60,43,96,130,7,33,38
"2011","Chesterfield 012D","E01019548","Total",965,246,87,159,719,42,144,173,191,18,51,100
"2011","Chesterfield 012E","E01019582","Total",634,171,72,99,463,23,93,88,158,8,27,66
"2011","Chesterfield 012F","E01019583","Total",611,134,52,82,477,40,88,98,150,8,29,64
"2011","Chesterfield 012G","E01019585","Total",999,312,88,224,687,38,115,126,258,17,34,99
"2011","Chesterfield 013A","E01019575","Total",700,185,84,101,515,94,63,110,119,20,35,74
"2011","Chesterfield 013B","E01019576","Total",716,241,86,155,475,33,109,70,132,12,40,79
"2011","Chesterfield 013C","E01019577","Total",762,286,111,175,476,23,112,91,154,7,19,70
"2011","Chesterfield 013D","E01019578","Total",814,391,134,257,423,73,58,57,137,21,36,41
"2011","Derbyshire Dales 001A","E01019602","Total",841,263,129,134,578,27,156,89,169,18,36,83
"2011","Derbyshire Dales 001B","E01019614","Total",726,186,102,84,540,9,135,114,153,23,31,75
"2011","Derbyshire Dales 001C","E01019615","Total",937,275,170,105,662,24,157,120,185,28,38,110
"2011","Derbyshire Dales 001D","E01019631","Total",798,244,122,122,554,26,112,118,162,22,28,86
"2011","Derbyshire Dales 002A","E01019600","Total",762,280,139,141,482,18,147,65,132,12,28,80
"2011","Derbyshire Dales 002B","E01019604","Total",823,222,131,91,601,19,200,83,181,19,26,73
"2011","Derbyshire Dales 002C","E01019606","Total",780,248,153,95,532,17,186,80,145,26,17,61
"2011","Derbyshire Dales 002D","E01019618","Total",734,191,106,85,543,9,170,92,158,15,28,71
"2011","Derbyshire Dales 003A","E01019599","Total",653,184,123,61,469,13,166,68,124,17,22,59
"2011","Derbyshire Dales 003B","E01019601","Total",718,268,186,82,450,15,145,66,111,16,25,72
"2011","Derbyshire Dales 003C","E01019613","Total",687,168,99,69,519,16,117,68,153,22,39,104
"2011","Derbyshire Dales 003D","E01019617","Total",705,230,133,97,475,13,110,67,144,20,22,99
"2011","Derbyshire Dales 004A","E01019608","Total",774,263,157,106,511,45,125,102,130,16,20,73
"2011","Derbyshire Dales 004B","E01019610","Total",672,169,103,66,503,23,136,83,140,13,27,81
"2011","Derbyshire Dales 004C","E01019630","Total",783,200,101,99,583,30,124,107,168,20,43,91
"2011","Derbyshire Dales 005A","E01019609","Total",946,267,123,144,679,22,173,119,225,15,39,86
"2011","Derbyshire Dales 005B","E01019621","Total",547,146,57,89,401,14,82,72,131,11,24,67
"2011","Derbyshire Dales 005C","E01019622","Total",689,197,86,111,492,27,111,89,147,12,27,79
"2011","Derbyshire Dales 005D","E01019624","Total",529,111,51,60,418,19,105,68,133,14,12,67
"2011","Derbyshire Dales 005E","E01019627","Total",513,132,73,59,381,12,88,60,120,8,18,75
"2011","Derbyshire Dales 005F","E01019628","Total",498,129,78,51,369,20,106,63,109,9,10,52
"2011","Derbyshire Dales 006A","E01019619","Total",699,233,91,142,466,17,145,56,148,11,22,67
"2011","Derbyshire Dales 006B","E01019620","Total",683,201,69,132,482,15,95,90,156,10,30,86
"2011","Derbyshire Dales 006C","E01019623","Total",670,322,121,201,348,22,64,59,123,8,17,55
"2011","Derbyshire Dales 006D","E01019625","Total",677,221,151,70,456,46,80,93,104,27,40,66
"2011","Derbyshire Dales 006E","E01019626","Total",668,218,112,106,450,14,106,75,138,12,26,79
"2011","Derbyshire Dales 006F","E01019632","Total",732,195,103,92,537,18,152,78,158,17,30,84
"2011","Derbyshire Dales 007A","E01019633","Total",636,162,91,71,474,31,107,92,104,18,31,91
"2011","Derbyshire Dales 007B","E01019634","Total",660,199,85,114,461,18,114,73,137,24,22,73
"2011","Derbyshire Dales 007C","E01019635","Total",574,183,95,88,391,9,120,55,124,12,20,51
"2011","Derbyshire Dales 007D","E01019636","Total",712,261,135,126,451,23,88,77,140,18,32,73
"2011","Derbyshire Dales 008A","E01019595","Total",915,291,118,173,624,30,147,106,193,18,38,92
"2011","Derbyshire Dales 008B","E01019605","Total",781,185,78,107,596,21,148,115,170,26,28,88
"2011","Derbyshire Dales 008C","E01019611","Total",702,174,82,92,528,13,130,78,139,25,40,103
"2011","Derbyshire Dales 008D","E01019616","Total",758,162,88,74,596,23,178,100,167,15,38,75
"2011","Derbyshire Dales 009A","E01019594","Total",769,232,147,85,537,52,125,105,122,20,34,79
"2011","Derbyshire Dales 009B","E01019596","Total",708,242,154,88,466,21,109,105,128,14,35,54
"2011","Derbyshire Dales 009C","E01019597","Total",592,121,58,63,471,36,86,98,126,9,40,76
"2011","Derbyshire Dales 009D","E01019598","Total",727,217,75,142,510,53,59,119,164,23,27,65
"2011","Derbyshire Dales 010A","E01019603","Total",699,173,85,88,526,23,136,97,143,25,23,79
"2011","Derbyshire Dales 010B","E01019607","Total",765,171,94,77,594,14,157,103,165,23,37,95
"2011","Derbyshire Dales 010C","E01019612","Total",828,224,129,95,604,27,145,121,156,27,31,97
"2011","Derbyshire Dales 010D","E01019629","Total",674,139,73,66,535,20,119,94,148,25,41,88
"2011","Erewash 001A","E01019644","Total",714,280,102,178,434,40,82,85,140,7,18,62
"2011","Erewash 001B","E01019646","Total",631,170,48,122,461,66,52,90,124,27,26,76
"2011","Erewash 001C","E01019663","Total",689,288,133,155,401,75,65,74,92,24,22,49
"2011","Erewash 001D","E01019664","Total",494,127,61,66,367,44,53,68,84,27,36,55
"2011","Erewash 001E","E01019665","Total",631,194,92,102,437,36,127,59,106,14,24,71
"2011","Erewash 003A","E01019657","Total",774,246,112,134,528,51,85,100,152,23,21,96
"2011","Erewash 003B","E01019660","Total",853,258,101,157,595,35,115,113,195,10,40,87
"2011","Erewash 003C","E01019661","Total",605,198,66,132,407,36,63,79,134,5,25,65
"2011","Erewash 003D","E01019662","Total",773,331,87,244,442,54,60,102,145,12,18,51
"2011","Erewash 003E","E01019672","Total",729,250,92,158,479,47,77,92,145,9,27,82
"2011","Erewash 003F","E01019690","Total",550,179,57,122,371,40,55,90,107,8,13,58
"2011","Erewash 004A","E01019670","Total",751,172,76,96,579,23,129,136,156,16,32,87
"2011","Erewash 004B","E01019671","Total",784,205,121,84,579,14,169,107,166,7,18,98
"2011","Erewash 004C","E01019701","Total",935,292,164,128,643,27,164,96,187,19,45,105
"2011","Erewash 005A","E01019673","Total",516,119,82,37,397,9,109,77,88,8,30,76
"2011","Erewash 005B","E01019702","Total",753,149,88,61,604,21,132,103,169,23,33,123
"2011","Erewash 005C","E01019703","Total",651,149,67,82,502,18,94,91,160,17,31,91
"2011","Erewash 005D","E01019704","Total",630,151,89,62,479,9,130,86,134,13,25,82
"2011","Erewash 006A","E01019658","Total",794,228,58,170,566,51,56,154,189,18,27,71
"2011","Erewash 006B","E01019659","Total",712,154,57,97,558,30,101,119,165,16,39,88
"2011","Erewash 006C","E01019674","Total",513,129,67,62,384,22,97,66,103,6,20,70
"2011","Erewash 006D","E01019688","Total",648,215,78,137,433,42,65,77,126,14,28,81
"2011","Erewash 006E","E01019689","Total",643,180,86,94,463,26,86,96,131,18,24,82
"2011","Erewash 007A","E01019666","Total",612,169,104,65,443,50,84,90,87,22,38,72
"2011","Erewash 007B","E01019667","Total",692,178,103,75,514,53,105,94,139,20,24,79
"2011","Erewash 007C","E01019668","Total",673,274,170,104,399,38,96,66,94,16,31,58
"2011","Erewash 007D","E01019669","Total",690,189,115,74,501,14,140,74,133,9,36,95
"2011","Erewash 008A","E01019656","Total",501,134,84,50,367,3,95,67,113,8,23,58
"2011","Erewash 008B","E01019691","Total",642,147,74,73,495,24,104,113,107,12,28,107
"2011","Erewash 008C","E01019692","Total",655,221,106,115,434,49,78,80,104,28,29,66
"2011","Erewash 008D","E01019693","Total",847,294,104,190,553,74,77,92,184,22,34,70
"2011","Erewash 008E","E01019694","Total",496,100,49,51,396,14,101,53,111,7,23,87
"2011","Erewash 008F","E01019696","Total",585,157,82,75,428,7,113,66,132,8,27,75
"2011","Erewash 009A","E01019683","Total",549,116,59,57,433,21,113,77,124,3,22,73
"2011","Erewash 009B","E01019684","Total",694,170,67,103,524,24,85,117,172,11,26,89
"2011","Erewash 009C","E01019685","Total",662,208,97,111,454,12,123,79,125,8,21,86
"2011","Erewash 009D","E01019686","Total",606,157,100,57,449,12,135,96,117,2,29,58
"2011","Erewash 009E","E01019687","Total",664,211,149,62,453,46,105,72,112,15,29,74
"2011","Erewash 010A","E01019648","Total",648,166,76,90,482,30,90,92,133,19,35,83
"2011","Erewash 010B","E01019649","Total",795,268,66,202,527,54,56,115,182,13,30,77
"2011","Erewash 010C","E01019650","Total",748,291,130,161,457,53,92,94,93,15,36,74
"2011","Erewash 010D","E01019651","Total",621,167,92,75,454,24,90,92,135,14,29,70
"2011","Erewash 010E","E01019695","Total",602,154,50,104,448,32,77,85,144,7,29,74
"2011","Erewash 011A","E01019641","Total",620,152,79,73,468,6,145,73,132,8,24,80
"2011","Erewash 011B","E01019652","Total",640,180,75,105,460,35,73,89,112,24,37,90
"2011","Erewash 011C","E01019653","Total",595,144,74,70,451,15,115,73,130,5,26,87
"2011","Erewash 011D","E01019707","Total",635,160,37,123,475,34,47,107,181,8,23,75
"2011","Erewash 011E","E01019708","Total",634,107,57,50,527,19,105,122,139,14,35,93
"2011","Erewash 012A","E01019647","Total",972,420,105,315,552,99,57,113,190,13,18,62
"2011","Erewash 012B","E01019675","Total",752,288,89,199,464,54,63,104,154,9,30,50
"2011","Erewash 012C","E01019679","Total",742,207,51,156,535,52,74,106,172,16,28,87
"2011","Erewash 012D","E01019682","Total",793,374,124,250,419,64,47,76,149,7,11,65
"2011","Erewash 013A","E01019642","Total",641,198,119,79,443,22,130,77,103,10,26,75
"2011","Erewash 013B","E01019643","Total",709,204,109,95,505,14,144,89,132,9,35,82
"2011","Erewash 013C","E01019654","Total",708,216,90,126,492,25,108,92,156,16,18,77
"2011","Erewash 013D","E01019655","Total",675,187,47,140,488,55,67,102,156,10,23,75
"2011","Erewash 014A","E01019676","Total",653,193,67,126,460,40,87,100,133,10,18,72
"2011","Erewash 014B","E01019677","Total",637,177,87,90,460,17,116,75,139,9,23,81
"2011","Erewash 014C","E01019678","Total",670,164,28,136,506,35,60,124,169,12,36,70
"2011","Erewash 014D","E01019680","Total",653,190,69,121,463,27,73,106,153,18,24,62
"2011","Erewash 014E","E01019681","Total",680,181,86,95,499,22,137,74,151,6,22,87
"2011","Erewash 014F","E01019698","Total",612,166,56,110,446,25,84,81,159,10,21,66
"2011","Erewash 015A","E01019697","Total",624,142,50,92,482,35,117,94,120,18,29,69
"2011","Erewash 015B","E01019699","Total",725,294,181,113,431,57,104,64,96,17,27,66
"2011","Erewash 015C","E01019700","Total",1006,278,142,136,728,41,179,133,208,14,47,106
"2011","Erewash 015D","E01019705","Total",800,244,78,166,556,45,75,121,195,21,24,75
"2011","Erewash 015E","E01019706","Total",512,114,58,56,398,12,107,83,94,14,28,60
"2011","Erewash 015F","E01019709","Total",527,148,55,93,379,49,41,82,101,13,27,66
"2011","Erewash 016A","E01019638","Total",513,101,43,58,412,14,75,88,109,11,42,73
"2011","Erewash 016B","E01019639","Total",428,88,36,52,340,24,46,70,94,16,32,58
"2011","Erewash 016C","E01019640","Total",586,118,20,98,468,19,29,151,168,15,25,61
"2011","Erewash 016D","E01019645","Total",702,216,92,124,486,27,92,94,158,9,31,75
"2011","Erewash 016E","E01032614","Total",493,78,19,59,415,22,36,125,123,6,26,77
"2011","High Peak 001A","E01019733","Total",650,182,88,94,468,38,92,89,136,9,28,76
"2011","High Peak 001B","E01019752","Total",557,158,37,121,399,35,34,106,127,22,21,54
"2011","High Peak 001C","E01019753","Total",627,167,59,108,460,33,50,90,166,14,31,76
"2011","High Peak 001D","E01019763","Total",917,283,111,172,634,40,87,124,207,27,52,97
"2011","High Peak 002A","E01019728","Total",518,197,100,97,321,54,40,72,56,24,28,47
"2011","High Peak 002B","E01019729","Total",528,155,54,101,373,60,52,73,68,23,29,68
"2011","High Peak 002C","E01019730","Total",850,274,112,162,576,72,88,112,155,25,41,83
"2011","High Peak 002D","E01019731","Total",490,89,47,42,401,15,64,97,95,15,37,78
"2011","High Peak 002E","E01019732","Total",608,145,75,70,463,28,79,81,116,14,37,108
"2011","High Peak 003A","E01019738","Total",614,203,61,142,411,41,43,89,142,11,23,62
"2011","High Peak 003B","E01019739","Total",821,334,100,234,487,47,78,78,196,7,24,57
"2011","High Peak 003C","E01019740","Total",526,161,50,111,365,23,49,97,125,3,14,54
"2011","High Peak 003D","E01019750","Total",577,186,101,85,391,30,76,65,119,11,26,64
"2011","High Peak 003E","E01019751","Total",881,203,83,120,678,27,86,197,197,32,50,89
"2011","High Peak 003F","E01019768","Total",1044,393,160,233,651,55,118,132,208,20,34,84
"2011","High Peak 004A","E01019727","Total",756,207,130,77,549,7,182,79,124,13,36,108
"2011","High Peak 004B","E01019749","Total",492,92,41,51,400,12,71,74,112,17,25,89
"2011","High Peak 004C","E01019754","Total",774,209,108,101,565,15,130,93,166,18,32,111
"2011","High Peak 004D","E01019756","Total",636,64,28,36,572,29,54,178,132,20,44,115
"2011","High Peak 004E","E01019757","Total",550,113,55,58,437,26,92,75,127,17,22,78
"2011","High Peak 004F","E01019758","Total",587,91,35,56,496,16,90,105,144,12,32,97
"2011","High Peak 005A","E01019746","Total",693,204,49,155,489,19,90,102,154,12,36,76
"2011","High Peak 005B","E01019747","Total",518,136,66,70,382,13,90,62,129,11,20,57
"2011","High Peak 005C","E01019748","Total",665,220,61,159,445,21,50,99,157,12,24,82
"2011","High Peak 005D","E01019755","Total",838,198,68,130,640,14,140,119,207,15,41,104
"2011","High Peak 005E","E01019766","Total",614,145,66,79,469,19,92,83,154,17,23,81
"2011","High Peak 006A","E01019711","Total",593,179,84,95,414,22,76,85,137,9,14,71
"2011","High Peak 006B","E01019734","Total",911,278,135,143,633,29,124,137,194,22,27,100
"2011","High Peak 006C","E01019743","Total",587,197,109,88,390,41,57,73,101,21,23,74
"2011","High Peak 006D","E01019744","Total",645,199,93,106,446,21,101,80,132,12,24,76
"2011","High Peak 006E","E01019745","Total",491,176,89,87,315,26,47,62,104,10,17,49
"2011","High Peak 008A","E01019712","Total",607,142,72,70,465,18,103,81,135,13,40,75
"2011","High Peak 008B","E01019713","Total",429,95,56,39,334,8,87,42,94,16,23,64
"2011","High Peak 008C","E01019764","Total",655,179,112,67,476,21,106,113,92,15,32,97
"2011","High Peak 008D","E01019765","Total",859,325,105,220,534,45,78,104,194,14,28,71
"2011","High Peak 008E","E01019767","Total",666,166,75,91,500,24,111,91,128,26,31,89
"2011","High Peak 010A","E01019710","Total",902,344,135,209,558,30,101,106,176,17,24,104
"2011","High Peak 010B","E01019715","Total",702,287,88,199,415,40,42,75,150,9,17,82
"2011","High Peak 010C","E01019717","Total",678,400,167,233,278,25,57,32,109,4,13,38
"2011","High Peak 010D","E01019722","Total",734,164,60,104,570,30,83,126,161,25,35,110
"2011","High Peak 010E","E01019723","Total",893,405,205,200,488,21,157,56,154,9,17,74
"2011","High Peak 011A","E01019716","Total",547,155,58,97,392,24,83,64,121,16,29,55
"2011","High Peak 011B","E01019724","Total",525,169,67,102,356,37,61,79,75,17,22,65
"2011","High Peak 011C","E01019759","Total",665,205,88,117,460,46,93,84,122,9,37,69
"2011","High Peak 011D","E01019760","Total",625,181,96,85,444,36,79,84,116,16,25,88
"2011","High Peak 011E","E01019761","Total",576,112,46,66,464,71,43,106,95,45,39,65
"2011","High Peak 012A","E01019714","Total",1016,224,99,125,792,56,133,175,236,31,54,107
"2011","High Peak 012B","E01019725","Total",581,131,51,80,450,23,89,89,127,13,32,77
"2011","High Peak 012C","E01019726","Total",544,133,43,90,411,26,62,100,121,18,29,55
"2011","High Peak 012D","E01019762","Total",771,211,117,94,560,7,181,92,127,16,39,98
"2011","High Peak 013E","E01019718","Total",950,241,112,129,709,52,142,130,198,26,38,123
"2011","High Peak 013F","E01019719","Total",678,220,88,132,458,37,91,87,126,20,22,75
"2011","High Peak 013G","E01019720","Total",663,204,131,73,459,14,121,67,143,12,30,72
"2011","High Peak 013H","E01019721","Total",470,106,56,50,364,15,88,65,101,17,18,60
"2011","High Peak 013A","E01019735","Total",655,157,92,65,498,18,134,84,139,12,31,80
"2011","High Peak 013B","E01019736","Total",504,128,59,69,376,8,81,50,139,13,29,56
"2011","High Peak 013C","E01019737","Total",559,189,124,65,370,20,119,57,102,10,16,46
"2011","High Peak 013I","E01019741","Total",466,120,54,66,346,17,83,61,89,13,20,63
"2011","High Peak 013D","E01019742","Total",468,131,51,80,337,19,61,62,95,15,25,60
"2011","North East Derbyshire 001A","E01019801","Total",459,106,29,77,353,16,50,52,122,6,19,88
"2011","North East Derbyshire 001B","E01019802","Total",546,133,64,69,413,12,76,81,118,7,30,89
"2011","North East Derbyshire 001C","E01019803","Total",516,120,59,61,396,35,72,77,95,12,34,71
"2011","North East Derbyshire 001D","E01019804","Total",528,111,35,76,417,13,43,83,142,9,32,95
"2011","North East Derbyshire 001E","E01019805","Total",534,107,43,64,427,27,51,106,112,7,39,85
"2011","North East Derbyshire 001F","E01019806","Total",641,159,73,86,482,26,82,71,154,9,28,112
"2011","North East Derbyshire 001G","E01019807","Total",621,185,97,88,436,44,59,70,105,22,42,94
"2011","North East Derbyshire 002A","E01019778","Total",754,186,141,45,568,16,220,89,120,15,25,83
"2011","North East Derbyshire 002B","E01019779","Total",750,203,129,74,547,15,240,82,114,9,19,68
"2011","North East Derbyshire 002C","E01019790","Total",850,238,75,163,612,22,100,111,206,12,39,122
"2011","North East Derbyshire 002D","E01019816","Total",757,205,106,99,552,13,147,92,150,8,46,96
"2011","North East Derbyshire 004A","E01019780","Total",610,175,93,82,435,48,79,97,103,14,30,64
"2011","North East Derbyshire 004B","E01019781","Total",630,189,103,86,441,18,122,81,125,8,25,62
"2011","North East Derbyshire 004C","E01019782","Total",605,254,124,130,351,20,82,68,84,12,25,60
"2011","North East Derbyshire 004D","E01019786","Total",739,284,137,147,455,41,104,78,133,11,25,63
"2011","North East Derbyshire 004E","E01019827","Total",803,221,127,94,582,31,144,99,144,14,48,102
"2011","North East Derbyshire 005A","E01019770","Total",837,232,127,105,605,17,184,106,151,15,33,99
"2011","North East Derbyshire 005B","E01019787","Total",771,210,109,101,561,16,157,107,139,18,32,92
"2011","North East Derbyshire 005C","E01019788","Total",677,136,80,56,541,8,171,88,135,14,32,93
"2011","North East Derbyshire 005D","E01019794","Total",595,114,80,34,481,4,177,67,117,12,24,80
"2011","North East Derbyshire 006A","E01019783","Total",520,104,55,49,416,15,120,94,87,8,22,70
"2011","North East Derbyshire 006B","E01019784","Total",504,111,44,67,393,10,97,93,93,14,22,64
"2011","North East Derbyshire 006C","E01019785","Total",516,85,48,37,431,10,121,82,102,14,24,78
"2011","North East Derbyshire 006D","E01019793","Total",638,155,93,62,483,10,143,71,140,8,26,85
"2011","North East Derbyshire 006E","E01019795","Total",958,261,153,108,697,32,137,173,189,14,38,114
"2011","North East Derbyshire 007A","E01019798","Total",603,145,84,61,458,14,105,80,134,6,24,95
"2011","North East Derbyshire 007B","E01019821","Total",608,166,95,71,442,21,126,59,116,5,28,87
"2011","North East Derbyshire 007C","E01019822","Total",678,196,92,104,482,12,95,86,145,14,43,87
"2011","North East Derbyshire 007D","E01019823","Total",525,210,111,99,315,22,65,67,73,6,25,57
"2011","North East Derbyshire 008A","E01019771","Total",956,306,179,127,650,18,200,106,159,16,41,110
"2011","North East Derbyshire 008B","E01019772","Total",635,133,76,57,502,20,125,85,123,17,31,101
"2011","North East Derbyshire 008C","E01019828","Total",682,190,145,45,492,4,215,51,118,4,19,81
"2011","North East Derbyshire 008D","E01019829","Total",621,159,85,74,462,11,109,82,139,14,25,82
"2011","North East Derbyshire 009A","E01019796","Total",490,156,82,74,334,38,66,63,75,13,18,61
"2011","North East Derbyshire 009B","E01019797","Total",598,200,61,139,398,28,61,75,125,12,29,68
"2011","North East Derbyshire 009C","E01019799","Total",901,318,119,199,583,80,119,85,171,23,39,66
"2011","North East Derbyshire 009D","E01019800","Total",704,165,78,87,539,39,95,98,144,8,50,105
"2011","North East Derbyshire 009E","E01019808","Total",697,203,102,101,494,53,84,91,152,21,33,60
"2011","North East Derbyshire 009F","E01019826","Total",637,230,123,107,407,33,77,84,94,16,34,69
"2011","North East Derbyshire 010A","E01019769","Total",798,186,100,86,612,18,188,84,155,12,45,110
"2011","North East Derbyshire 010B","E01019774","Total",738,213,144,69,525,10,224,53,128,5,20,85
"2011","North East Derbyshire 010C","E01019824","Total",516,147,81,66,369,13,98,57,90,9,26,76
"2011","North East Derbyshire 010D","E01019830","Total",524,93,57,36,431,15,117,71,125,12,17,74
"2011","North East Derbyshire 010E","E01019831","Total",587,142,55,87,445,17,82,96,156,14,23,57
"2011","North East Derbyshire 011A","E01019809","Total",534,173,91,82,361,12,94,53,116,4,18,64
"2011","North East Derbyshire 011B","E01019810","Total",697,257,68,189,440,41,65,65,170,8,23,68
"2011","North East Derbyshire 011C","E01019811","Total",673,168,71,97,505,15,107,106,158,9,25,85
"2011","North East Derbyshire 011D","E01019812","Total",781,194,76,118,587,30,117,108,192,16,27,97
"2011","North East Derbyshire 011E","E01019813","Total",746,262,125,137,484,36,76,108,132,27,42,63
"2011","North East Derbyshire 011F","E01019825","Total",547,100,49,51,447,15,89,85,133,16,38,71
"2011","North East Derbyshire 012A","E01019773","Total",1104,400,185,215,704,56,114,129,236,22,39,108
"2011","North East Derbyshire 012B","E01019775","Total",808,305,101,204,503,36,80,88,157,23,30,89
"2011","North East Derbyshire 012C","E01019776","Total",629,205,84,121,424,21,110,59,130,8,20,76
"2011","North East Derbyshire 012D","E01019777","Total",1063,343,169,174,720,70,130,142,197,25,49,107
"2011","North East Derbyshire 013A","E01019814","Total",756,218,130,88,538,18,124,107,174,7,21,87
"2011","North East Derbyshire 013B","E01019817","Total",523,164,88,76,359,25,79,73,81,15,31,55
"2011","North East Derbyshire 013C","E01019818","Total",644,186,92,94,458,42,87,89,107,26,34,73
"2011","North East Derbyshire 013D","E01019819","Total",629,157,68,89,472,14,123,81,150,6,25,73
"2011","North East Derbyshire 013E","E01019820","Total",618,132,59,73,486,18,147,68,144,10,25,74
"2011","North East Derbyshire 014A","E01019791","Total",748,236,118,118,512,39,101,77,133,17,42,103
"2011","North East Derbyshire 014B","E01019792","Total",879,305,139,166,574,48,126,98,128,22,44,108
"2011","North East Derbyshire 014C","E01019815","Total",1091,272,101,171,819,49,115,209,240,29,55,122
"2011","North East Derbyshire 014D","E01032586","Total",743,239,142,97,504,38,125,85,119,13,29,95
"2011","South Derbyshire 001A","E01019839","Total",681,125,37,88,556,13,90,134,164,21,43,91
"2011","South Derbyshire 001B","E01019845","Total",570,161,54,107,409,22,65,99,130,13,27,53
"2011","South Derbyshire 001C","E01019846","Total",553,176,95,81,377,28,66,73,108,12,23,67
"2011","South Derbyshire 001D","E01019866","Total",896,183,79,104,713,23,164,140,206,20,43,117
"2011","South Derbyshire 002A","E01019840","Total",666,180,110,70,486,31,122,97,108,23,31,74
"2011","South Derbyshire 002B","E01019841","Total",636,149,91,58,487,13,158,76,119,15,30,76
"2011","South Derbyshire 002C","E01019847","Total",590,159,88,71,431,18,115,81,108,17,28,64
"2011","South Derbyshire 002D","E01019848","Total",792,139,11,128,653,37,34,221,212,25,47,77
"2011","South Derbyshire 002F","E01033532","Total",554,108,20,88,446,34,30,143,139,27,29,44
"2011","South Derbyshire 002G","E01033533","Total",599,92,15,77,507,34,34,194,134,24,31,56
"2011","South Derbyshire 002H","E01033534","Total",493,189,6,183,304,26,4,101,125,11,18,19
"2011","South Derbyshire 003A","E01019873","Total",573,146,25,121,427,44,40,92,132,24,34,61
"2011","South Derbyshire 003B","E01019874","Total",589,123,44,79,466,23,87,84,144,13,26,89
"2011","South Derbyshire 003C","E01019875","Total",485,79,11,68,406,27,28,89,91,11,54,106
"2011","South Derbyshire 003D","E01019881","Total",573,131,72,59,442,14,121,70,115,14,25,83
"2011","South Derbyshire 003E","E01019882","Total",683,195,96,99,488,29,110,79,140,19,35,76
"2011","South Derbyshire 004A","E01019832","Total",803,257,99,158,546,21,126,94,198,12,24,71
"2011","South Derbyshire 004B","E01019833","Total",746,173,101,72,573,19,138,144,141,18,37,76
"2011","South Derbyshire 004C","E01019834","Total",646,169,91,78,477,16,119,100,127,14,30,71
"2011","South Derbyshire 004D","E01019835","Total",605,107,27,80,498,16,49,128,150,16,45,94
"2011","South Derbyshire 005A","E01019867","Total",618,151,77,74,467,9,124,72,153,10,21,78
"2011","South Derbyshire 005B","E01019868","Total",661,168,92,76,493,22,102,89,135,28,37,80
"2011","South Derbyshire 005C","E01019869","Total",538,160,65,95,378,10,85,82,100,12,21,68
"2011","South Derbyshire 005D","E01019880","Total",655,148,61,87,507,21,100,104,144,21,27,90
"2011","South Derbyshire 006A","E01019843","Total",673,196,93,103,477,19,117,81,150,14,28,68
"2011","South Derbyshire 006B","E01019853","Total",635,147,70,77,488,20,100,99,136,23,40,70
"2011","South Derbyshire 006C","E01019854","Total",860,363,175,188,497,29,109,109,141,16,21,72
"2011","South Derbyshire 006D","E01019855","Total",648,164,71,93,484,25,115,92,126,19,40,67
"2011","South Derbyshire 007A","E01019844","Total",662,154,99,55,508,33,151,79,118,18,32,77
"2011","South Derbyshire 007B","E01019856","Total",638,194,97,97,444,50,82,86,96,13,31,86
"2011","South Derbyshire 007C","E01019857","Total",479,82,23,59,397,19,43,111,116,14,25,69
"2011","South Derbyshire 007D","E01019858","Total",646,139,78,61,507,67,94,91,117,26,26,86
"2011","South Derbyshire 007E","E01019859","Total",716,169,97,72,547,28,142,86,153,13,36,89
"2011","South Derbyshire 008A","E01019860","Total",510,86,50,36,424,13,79,82,124,17,37,72
"2011","South Derbyshire 008B","E01019861","Total",766,209,89,120,557,37,103,108,157,17,32,103
"2011","South Derbyshire 008C","E01019862","Total",645,170,84,86,475,30,122,70,141,9,28,75
"2011","South Derbyshire 008D","E01019863","Total",732,281,92,189,451,61,77,78,112,22,32,69
"2011","South Derbyshire 008E","E01019864","Total",602,154,38,116,448,32,60,98,123,13,30,92
"2011","South Derbyshire 008F","E01019865","Total",520,105,43,62,415,31,49,82,135,24,18,76
"2011","South Derbyshire 009A","E01019876","Total",812,234,115,119,578,32,122,107,142,33,42,100
"2011","South Derbyshire 009B","E01019877","Total",789,367,162,205,422,43,71,75,128,11,29,65
"2011","South Derbyshire 009C","E01019878","Total",654,166,75,91,488,36,79,89,153,15,31,85
"2011","South Derbyshire 009D","E01019879","Total",754,149,64,85,605,9,89,114,214,11,43,125
"2011","South Derbyshire 011A","E01019850","Total",658,151,95,56,507,10,125,79,157,15,29,92
"2011","South Derbyshire 011B","E01019851","Total",673,168,64,104,505,37,95,76,158,24,29,86
"2011","South Derbyshire 011C","E01019852","Total",738,181,57,124,557,28,98,105,172,25,40,89
"2011","South Derbyshire 011D","E01019870","Total",649,171,96,75,478,20,136,79,118,15,26,84
"2011","South Derbyshire 011E","E01019871","Total",750,183,97,86,567,30,137,97,171,27,29,76
"2011","South Derbyshire 011F","E01019872","Total",828,229,94,135,599,25,123,125,200,13,31,82
"2011","South Derbyshire 012A","E01019837","Total",814,219,52,167,595,64,70,143,193,22,26,77
"2011","South Derbyshire 012B","E01019838","Total",734,247,94,153,487,50,77,99,134,22,32,73
"2011","South Derbyshire 012C","E01033531","Total",672,191,15,176,481,34,12,155,186,21,26,47
"2011","South Derbyshire 012D","E01033536","Total",672,173,33,140,499,46,45,147,149,19,32,61
"2011","South Derbyshire 012E","E01033537","Total",703,167,68,99,536,51,85,99,178,22,28,73
"2011","South Derbyshire 013A","E01019842","Total",666,160,77,83,506,56,87,102,119,21,45,76
"2011","South Derbyshire 013B","E01019883","Total",1206,341,78,263,865,89,80,224,297,48,47,80
"2011","South Derbyshire 013C","E01019885","Total",730,198,53,145,532,28,59,116,196,19,28,86
"2011","South Derbyshire 013D","E01033535","Total",553,83,17,66,470,31,45,138,125,25,43,63
"2011","Blaby 002A","E01025631","Total",491,115,61,54,376,24,76,96,86,11,24,59
"2011","Blaby 002B","E01025632","Total",470,46,14,32,424,22,30,137,76,14,50,95
"2011","Blaby 002C","E01025633","Total",717,174,92,82,543,26,111,99,164,16,40,87
"2011","Blaby 002D","E01025635","Total",483,113,62,51,370,15,84,62,102,9,28,70
"2011","Blaby 003A","E01025634","Total",535,111,56,55,424,12,82,108,94,16,41,71
"2011","Blaby 003B","E01025638","Total",636,179,126,53,457,12,174,64,82,14,35,76
"2011","Blaby 003C","E01025639","Total",533,161,90,71,372,13,117,61,79,16,28,58
"2011","Blaby 003D","E01025640","Total",658,187,103,84,471,24,107,94,120,22,40,64
"2011","Blaby 003E","E01025645","Total",462,105,44,61,357,14,78,67,98,11,30,59
"2011","Blaby 004A","E01025666","Total",628,179,86,93,449,34,95,77,112,14,35,82
"2011","Blaby 004B","E01025667","Total",490,148,90,58,342,15,79,63,71,16,28,70
"2011","Blaby 004C","E01025668","Total",945,193,33,160,752,59,55,206,278,21,46,87
"2011","Blaby 004D","E01025669","Total",840,197,13,184,643,47,15,202,250,19,45,65
"2011","Blaby 005A","E01025636","Total",607,213,131,82,394,19,115,60,83,14,28,75
"2011","Blaby 005B","E01025637","Total",554,143,66,77,411,35,86,69,109,11,33,68
"2011","Blaby 005C","E01025652","Total",505,96,51,45,409,26,69,73,90,10,35,106
"2011","Blaby 005D","E01025653","Total",668,216,96,120,452,42,68,86,115,18,38,85
"2011","Blaby 005E","E01025654","Total",512,125,86,39,387,17,99,66,83,11,38,73
"2011","Blaby 005F","E01025655","Total",619,156,65,91,463,32,91,77,109,15,52,87
"2011","Blaby 005G","E01025656","Total",496,114,57,57,382,20,66,70,75,15,49,87
"2011","Blaby 006A","E01025625","Total",569,201,96,105,368,54,68,65,100,11,19,51
"2011","Blaby 006B","E01025626","Total",567,186,56,130,381,21,48,78,142,12,19,61
"2011","Blaby 006C","E01025627","Total",897,231,101,130,666,54,119,149,169,14,43,118
"2011","Blaby 006D","E01025651","Total",645,165,75,90,480,19,75,100,132,16,44,94
"2011","Blaby 006E","E01025657","Total",808,267,146,121,541,15,91,97,158,21,42,117
"2011","Blaby 006F","E01025660","Total",681,173,76,97,508,18,126,107,114,15,44,84
"2011","Blaby 007A","E01025641","Total",786,240,102,138,546,21,120,107,163,21,34,80
"2011","Blaby 007B","E01025642","Total",841,258,117,141,583,51,97,146,169,14,41,65
"2011","Blaby 007C","E01025643","Total",632,138,40,98,494,29,85,114,127,19,33,87
"2011","Blaby 007D","E01025649","Total",673,174,75,99,499,15,115,93,137,13,33,93
"2011","Blaby 007E","E01025650","Total",570,76,22,54,494,39,51,120,127,17,46,94
"2011","Blaby 008A","E01025610","Total",660,188,104,84,472,51,100,82,106,15,42,76
"2011","Blaby 008B","E01025611","Total",609,139,71,68,470,22,130,78,105,25,32,78
"2011","Blaby 008C","E01025612","Total",691,170,99,71,521,22,151,82,129,14,36,87
"2011","Blaby 008D","E01025658","Total",736,176,55,121,560,47,80,104,153,24,44,108
"2011","Blaby 008E","E01025659","Total",857,311,150,161,546,30,147,75,173,15,34,72
"2011","Blaby 009A","E01025615","Total",557,76,24,52,481,23,49,141,113,22,49,84
"2011","Blaby 009B","E01025646","Total",752,273,116,157,479,56,84,107,124,17,24,67
"2011","Blaby 009C","E01025647","Total",712,242,102,140,470,40,90,97,129,17,23,74
"2011","Blaby 009D","E01025648","Total",732,119,21,98,613,35,81,195,124,30,48,100
"2011","Blaby 010A","E01025613","Total",619,196,114,82,423,10,124,61,95,18,45,70
"2011","Blaby 010B","E01025614","Total",696,128,53,75,568,38,106,124,152,21,36,91
"2011","Blaby 010C","E01025620","Total",470,126,74,52,344,31,81,65,88,13,17,49
"2011","Blaby 010D","E01025621","Total",448,97,39,58,351,14,104,55,93,8,23,54
"2011","Blaby 010E","E01025644","Total",569,127,47,80,442,33,89,82,114,17,29,78
"2011","Blaby 011A","E01025616","Total",638,139,75,64,499,13,106,100,118,23,36,103
"2011","Blaby 011B","E01025617","Total",731,186,94,92,545,30,137,97,149,14,37,81
"2011","Blaby 011C","E01025618","Total",735,234,114,120,501,23,123,113,121,19,32,70
"2011","Blaby 011D","E01025619","Total",693,176,75,101,517,12,137,87,153,16,35,77
"2011","Blaby 012A","E01025661","Total",678,123,36,87,555,40,80,145,156,20,40,74
"2011","Blaby 012B","E01025662","Total",698,238,103,135,460,40,103,77,129,9,31,71
"2011","Blaby 012C","E01025663","Total",582,118,65,53,464,12,106,98,128,10,26,84
"2011","Blaby 012D","E01025664","Total",544,147,86,61,397,8,119,65,99,7,20,79
"2011","Blaby 012E","E01025665","Total",644,150,80,70,494,15,149,91,140,9,23,67
"2011","Blaby 013A","E01025622","Total",760,247,120,127,513,31,120,92,155,18,31,66
"2011","Blaby 013B","E01025623","Total",680,195,114,81,485,30,121,85,123,10,31,85
"2011","Blaby 013C","E01025624","Total",685,140,52,88,545,27,77,109,148,21,48,115
"2011","Blaby 013D","E01025629","Total",648,192,106,86,456,31,118,68,109,17,33,80
"2011","Blaby 013E","E01025630","Total",695,171,96,75,524,12,144,92,119,17,38,102
"2011","Blaby 013F","E01032603","Total",649,191,128,63,458,19,162,42,111,8,29,87
"2011","Charnwood 001B","E01025692","Total",808,191,63,128,617,40,75,123,206,20,39,114
"2011","Charnwood 001C","E01025693","Total",849,248,113,135,601,24,136,109,199,14,20,99
"2011","Charnwood 001E","E01033386","Total",943,263,73,190,680,35,113,107,223,15,39,148
"2011","Charnwood 002A","E01025699","Total",813,487,138,349,326,51,42,34,115,10,25,49
"2011","Charnwood 002B","E01025700","Total",735,263,28,235,472,56,28,111,133,26,40,78
"2011","Charnwood 002C","E01025701","Total",676,266,85,181,410,34,46,75,124,38,35,58
"2011","Charnwood 002D","E01025703","Total",842,318,56,262,524,32,43,85,191,16,50,107
"2011","Charnwood 002E","E01025704","Total",587,202,46,156,385,21,47,64,130,12,31,80
"2011","Charnwood 002F","E01025705","Total",520,144,22,122,376,37,22,70,120,22,37,68
"2011","Charnwood 002G","E01025706","Total",752,301,81,220,451,47,45,90,141,25,40,63
"2011","Charnwood 003A","E01025720","Total",680,216,53,163,464,19,37,47,110,10,9,232
"2011","Charnwood 003B","E01025721","Total",565,154,88,66,411,9,48,30,87,7,15,215
"2011","Charnwood 003C","E01025722","Total",421,109,53,56,312,16,69,40,83,10,25,69
"2011","Charnwood 003D","E01025723","Total",616,136,39,97,480,25,44,59,115,6,28,203
"2011","Charnwood 003E","E01025724","Total",561,132,37,95,429,16,12,36,116,6,10,233
"2011","Charnwood 003F","E01025725","Total",606,258,114,144,348,35,59,47,97,17,33,60
"2011","Charnwood 004A","E01025695","Total",662,186,54,132,476,11,114,68,156,10,30,87
"2011","Charnwood 004B","E01025696","Total",541,109,36,73,432,8,77,90,116,16,43,82
"2011","Charnwood 004C","E01025697","Total",686,324,198,126,362,18,105,37,106,3,20,73
"2011","Charnwood 004D","E01025698","Total",651,176,80,96,475,20,81,77,146,14,36,101
"2011","Charnwood 005A","E01025744","Total",772,147,66,81,625,25,121,132,181,19,36,111
"2011","Charnwood 005B","E01025745","Total",635,170,78,92,465,14,125,77,130,11,24,84
"2011","Charnwood 005C","E01025746","Total",777,237,100,137,540,51,105,99,146,13,41,85
"2011","Charnwood 005D","E01025747","Total",796,233,105,128,563,48,106,118,155,19,37,80
"2011","Charnwood 006A","E01025740","Total",688,230,62,168,458,38,91,80,146,8,16,79
"2011","Charnwood 006B","E01025741","Total",643,168,62,106,475,10,92,98,136,14,27,98
"2011","Charnwood 006C","E01025742","Total",671,206,90,116,465,42,90,85,120,23,32,73
"2011","Charnwood 006D","E01025743","Total",811,248,71,177,563,38,90,113,193,15,35,79
"2011","Charnwood 007A","E01025689","Total",757,199,85,114,558,30,91,65,133,20,49,170
"2011","Charnwood 007B","E01025690","Total",538,144,40,104,394,27,48,58,64,28,42,127
"2011","Charnwood 007C","E01025707","Total",558,137,74,63,421,9,104,78,79,14,29,108
"2011","Charnwood 007D","E01025709","Total",475,100,55,45,375,6,85,68,77,13,30,96
"2011","Charnwood 008A","E01025760","Total",544,109,64,45,435,13,99,97,121,11,28,66
"2011","Charnwood 008B","E01025761","Total",721,154,73,81,567,18,103,146,166,32,26,76
"2011","Charnwood 008C","E01025768","Total",582,146,71,75,436,12,111,80,116,17,35,65
"2011","Charnwood 008D","E01025769","Total",574,106,53,53,468,10,109,88,122,24,32,83
"2011","Charnwood 009A","E01025702","Total",527,127,48,79,400,15,88,59,126,8,19,85
"2011","Charnwood 009B","E01025715","Total",599,151,58,93,448,53,59,88,103,20,34,91
"2011","Charnwood 009C","E01025716","Total",616,164,73,91,452,35,79,91,88,28,37,94
"2011","Charnwood 009D","E01025717","Total",807,172,46,126,635,66,66,141,169,41,59,93
"2011","Charnwood 009E","E01025718","Total",674,339,116,223,335,30,41,36,123,9,20,76
"2011","Charnwood 009F","E01025719","Total",601,162,82,80,439,11,84,74,106,17,36,111
"2011","Charnwood 010A","E01025708","Total",519,102,63,39,417,10,146,61,90,12,23,75
"2011","Charnwood 010B","E01025710","Total",502,141,96,45,361,4,97,72,84,17,28,59
"2011","Charnwood 010C","E01025711","Total",645,151,115,36,494,11,168,80,92,18,37,88
"2011","Charnwood 010D","E01025712","Total",599,163,124,39,436,10,155,71,86,6,31,77
"2011","Charnwood 010E","E01025713","Total",482,113,68,45,369,12,72,90,84,6,31,74
"2011","Charnwood 010F","E01025714","Total",795,158,36,122,637,29,48,185,180,34,50,111
"2011","Charnwood 011A","E01025674","Total",646,173,79,94,473,20,99,86,139,16,26,87
"2011","Charnwood 011B","E01025675","Total",670,182,68,114,488,23,120,95,145,8,21,76
"2011","Charnwood 011C","E01025676","Total",841,186,76,110,655,35,112,169,168,28,50,93
"2011","Charnwood 011D","E01025677","Total",609,212,109,103,397,20,88,86,108,8,35,52
"2011","Charnwood 012A","E01025732","Total",651,164,53,111,487,24,75,125,140,11,25,87
"2011","Charnwood 012B","E01025733","Total",712,239,102,137,473,21,125,86,148,14,24,55
"2011","Charnwood 012C","E01025734","Total",637,160,101,59,477,8,141,93,97,20,36,82
"2011","Charnwood 012D","E01025735","Total",873,341,136,205,532,31,96,104,190,18,15,78
"2011","Charnwood 013A","E01025748","Total",918,272,74,198,646,48,81,139,218,18,48,94
"2011","Charnwood 013B","E01025749","Total",625,149,68,81,476,43,100,81,99,21,39,93
"2011","Charnwood 013C","E01025750","Total",602,151,69,82,451,23,84,95,132,18,18,81
"2011","Charnwood 013D","E01025751","Total",891,246,76,170,645,46,82,146,217,25,36,93
"2011","Charnwood 014A","E01025726","Total",793,227,48,179,566,49,55,152,176,15,32,87
"2011","Charnwood 014B","E01025727","Total",680,218,90,128,462,59,67,90,126,12,36,72
"2011","Charnwood 014C","E01025728","Total",748,166,90,76,582,35,135,121,142,19,39,91
"2011","Charnwood 014D","E01025729","Total",665,154,47,107,511,26,99,121,140,18,28,79
"2011","Charnwood 014E","E01025737","Total",750,196,81,115,554,29,92,162,141,23,32,75
"2011","Charnwood 014F","E01025739","Total",645,189,101,88,456,11,140,64,149,11,30,51
"2011","Charnwood 015A","E01025685","Total",542,123,65,58,419,30,87,86,95,12,32,77
"2011","Charnwood 015B","E01025686","Total",542,83,39,44,459,13,69,96,125,16,42,98
"2011","Charnwood 015C","E01025730","Total",662,185,86,99,477,17,139,76,125,10,30,80
"2011","Charnwood 015D","E01025731","Total",644,174,119,55,470,10,140,65,102,14,40,99
"2011","Charnwood 016A","E01025687","Total",682,166,96,70,516,11,154,80,139,17,23,92
"2011","Charnwood 016B","E01025688","Total",665,198,85,113,467,20,97,103,129,17,27,74
"2011","Charnwood 016C","E01025736","Total",624,139,94,45,485,16,133,72,146,12,35,71
"2011","Charnwood 016D","E01025738","Total",575,112,65,47,463,11,120,77,117,18,36,84
"2011","Charnwood 017A","E01025756","Total",855,287,82,205,568,72,79,116,172,16,38,75
"2011","Charnwood 017B","E01025757","Total",550,105,25,80,445,41,39,102,126,14,42,81
"2011","Charnwood 017C","E01025758","Total",651,130,59,71,521,25,74,117,128,17,59,101
"2011","Charnwood 017D","E01025759","Total",722,345,179,166,377,21,108,56,101,11,20,60
"2011","Charnwood 018A","E01025752","Total",800,193,92,101,607,25,99,126,183,14,45,115
"2011","Charnwood 018B","E01025753","Total",688,246,160,86,442,53,83,79,107,18,17,85
"2011","Charnwood 018C","E01025754","Total",522,106,49,57,416,16,95,78,110,11,20,86
"2011","Charnwood 018D","E01025755","Total",617,151,65,86,466,18,104,98,113,10,33,90
"2011","Charnwood 019A","E01025679","Total",989,231,132,99,758,53,155,185,162,21,58,124
"2011","Charnwood 019B","E01025680","Total",656,127,87,40,529,18,145,110,99,17,34,106
"2011","Charnwood 019C","E01025681","Total",662,163,100,63,499,23,139,68,138,9,41,81
"2011","Charnwood 019D","E01025682","Total",637,165,107,58,472,15,160,59,108,6,32,92
"2011","Charnwood 020A","E01025678","Total",652,142,81,61,510,17,97,120,103,13,55,105
"2011","Charnwood 020B","E01025683","Total",674,175,100,75,499,38,86,108,106,18,47,96
"2011","Charnwood 020C","E01025684","Total",772,217,118,99,555,49,94,121,122,19,47,103
"2011","Charnwood 021A","E01025762","Total",647,197,73,124,450,38,99,81,122,13,23,74
"2011","Charnwood 021B","E01025763","Total",715,234,108,126,481,15,113,91,122,12,40,88
"2011","Charnwood 021C","E01025764","Total",504,96,61,35,408,17,98,64,61,14,45,109
"2011","Charnwood 021D","E01025765","Total",606,126,71,55,480,18,120,60,89,14,50,129
"2011","Charnwood 021E","E01025766","Total",859,265,92,173,594,52,72,123,163,35,53,96
"2011","Charnwood 021F","E01025767","Total",613,178,77,101,435,21,81,61,113,9,46,104
"2011","Charnwood 022A","E01025670","Total",534,137,79,58,397,23,94,75,94,7,38,66
"2011","Charnwood 022B","E01025671","Total",769,194,85,109,575,52,119,103,139,25,39,98
"2011","Charnwood 022C","E01025672","Total",739,182,97,85,557,37,117,107,148,13,30,105
"2011","Charnwood 022D","E01025673","Total",769,301,153,148,468,36,112,84,133,11,30,62
"2011","Harborough 002A","E01025770","Total",803,217,92,125,586,21,158,94,156,32,35,90
"2011","Harborough 002B","E01025809","Total",930,223,104,119,707,21,171,164,176,35,49,91
"2011","Harborough 002C","E01025815","Total",848,222,82,140,626,18,143,112,170,24,49,110
"2011","Harborough 003A","E01025781","Total",600,133,52,81,467,31,89,90,110,27,42,78
"2011","Harborough 003B","E01025782","Total",617,228,144,84,389,16,103,84,99,6,21,60
"2011","Harborough 003C","E01025783","Total",611,133,66,67,478,8,149,88,109,13,39,72
"2011","Harborough 003D","E01025785","Total",902,260,99,161,642,38,114,151,193,32,31,83
"2011","Harborough 003E","E01025786","Total",678,210,143,67,468,34,85,85,113,20,42,89
"2011","Harborough 003F","E01025787","Total",720,193,98,95,527,16,144,81,149,17,33,87
"2011","Harborough 004A","E01025772","Total",880,175,52,123,705,64,58,233,185,26,54,85
"2011","Harborough 004B","E01025773","Total",525,66,18,48,459,18,46,137,122,22,54,60
"2011","Harborough 004C","E01025774","Total",474,63,26,37,411,14,52,101,110,15,32,87
"2011","Harborough 004D","E01025775","Total",769,230,126,104,539,18,119,106,143,15,40,98
"2011","Harborough 004E","E01025776","Total",774,157,66,91,617,22,99,135,177,26,45,113
"2011","Harborough 005A","E01025771","Total",1026,225,92,133,801,36,176,157,237,36,47,112
"2011","Harborough 005B","E01025778","Total",801,219,90,129,582,38,69,146,171,29,43,86
"2011","Harborough 005C","E01025779","Total",623,141,55,86,482,25,70,106,120,28,41,92
"2011","Harborough 005D","E01025780","Total",524,98,49,49,426,11,97,87,117,14,33,67
"2011","Harborough 005E","E01025784","Total",531,115,60,55,416,13,85,77,115,25,27,74
"2011","Harborough 005F","E01025788","Total",465,91,48,43,374,12,86,61,111,15,26,63
"2011","Harborough 006A","E01025777","Total",910,214,103,111,696,18,165,129,207,19,47,111
"2011","Harborough 006B","E01025808","Total",1031,238,110,128,793,19,167,184,211,38,47,127
"2011","Harborough 006C","E01025810","Total",919,184,100,84,735,14,162,130,212,25,59,133
"2011","Harborough 006D","E01025816","Total",889,170,80,90,719,29,162,159,192,27,47,103
"2011","Harborough 007A","E01025789","Total",476,127,52,75,349,15,74,70,106,11,19,54
"2011","Harborough 007B","E01025794","Total",724,159,71,88,565,16,102,133,149,28,49,88
"2011","Harborough 007C","E01025797","Total",713,175,96,79,538,27,145,111,131,19,28,77
"2011","Harborough 007D","E01025802","Total",617,188,94,94,429,11,153,77,103,6,22,57
"2011","Harborough 007E","E01025803","Total",582,86,47,39,496,9,100,112,139,26,38,72
"2011","Harborough 007F","E01025805","Total",661,170,102,68,491,15,141,84,122,23,25,81
"2011","Harborough 008A","E01025795","Total",848,371,181,190,477,18,126,88,137,11,23,74
"2011","Harborough 008B","E01025796","Total",862,286,132,154,576,42,94,118,174,24,35,89
"2011","Harborough 008C","E01025801","Total",618,288,119,169,330,25,67,55,115,9,17,42
"2011","Harborough 008D","E01025806","Total",680,272,162,110,408,29,65,91,105,17,38,63
"2011","Harborough 009A","E01025798","Total",839,288,148,140,551,19,150,118,158,8,26,72
"2011","Harborough 009B","E01025799","Total",704,77,13,64,627,34,54,249,128,44,46,72
"2011","Harborough 009C","E01025800","Total",538,169,46,123,369,22,66,80,138,10,17,36
"2011","Harborough 009D","E01025804","Total",842,238,139,99,604,29,172,112,151,25,33,82
"2011","Harborough 009E","E01025807","Total",595,166,46,120,429,40,40,102,153,16,33,45
"2011","Harborough 010A","E01025790","Total",921,194,118,76,727,27,150,160,180,33,52,125
"2011","Harborough 010B","E01025791","Total",937,249,163,86,688,33,188,116,169,30,46,106
"2011","Harborough 010C","E01025792","Total",1095,422,210,212,673,32,150,127,203,24,32,105
"2011","Harborough 010D","E01025793","Total",987,202,73,129,785,45,142,158,212,34,69,125
"2011","Harborough 011A","E01025812","Total",728,202,121,81,526,33,141,91,131,15,37,78
"2011","Harborough 011B","E01025813","Total",598,108,76,32,490,8,145,95,84,15,55,88
"2011","Harborough 011C","E01025814","Total",622,148,96,52,474,12,138,80,100,18,37,89
"2011","Harborough 011D","E01032598","Total",861,205,108,97,656,26,152,112,157,28,49,132
"2011","Hinckley and Bosworth 001A","E01025868","Total",663,207,118,89,456,19,131,63,126,12,36,69
"2011","Hinckley and Bosworth 001B","E01025869","Total",750,303,155,148,447,25,113,64,143,9,21,72
"2011","Hinckley and Bosworth 001C","E01025870","Total",597,144,98,46,453,23,122,77,107,20,39,65
"2011","Hinckley and Bosworth 001D","E01025871","Total",524,133,77,56,391,20,80,67,125,4,26,69
"2011","Hinckley and Bosworth 001E","E01025878","Total",1034,235,99,136,799,45,119,192,236,43,54,110
"2011","Hinckley and Bosworth 002A","E01025846","Total",821,174,98,76,647,27,146,140,163,20,43,108
"2011","Hinckley and Bosworth 002B","E01025847","Total",654,134,32,102,520,39,57,110,162,12,36,104
"2011","Hinckley and Bosworth 002C","E01025848","Total",708,221,117,104,487,22,146,72,140,13,22,72
"2011","Hinckley and Bosworth 003A","E01025845","Total",642,147,94,53,495,14,135,74,103,12,43,114
"2011","Hinckley and Bosworth 003B","E01025877","Total",728,233,96,137,495,45,87,106,153,19,27,58
"2011","Hinckley and Bosworth 003C","E01025879","Total",525,148,77,71,377,36,71,65,98,12,30,65
"2011","Hinckley and Bosworth 003D","E01025880","Total",637,141,80,61,496,27,86,125,132,16,26,84
"2011","Hinckley and Bosworth 004A","E01025819","Total",710,192,87,105,518,40,122,93,134,11,35,83
"2011","Hinckley and Bosworth 004B","E01025820","Total",657,148,63,85,509,30,73,105,160,13,34,94
"2011","Hinckley and Bosworth 004C","E01025837","Total",834,192,74,118,642,27,140,129,190,19,38,99
"2011","Hinckley and Bosworth 004D","E01025838","Total",671,207,130,77,464,6,153,69,132,9,22,73
"2011","Hinckley and Bosworth 004E","E01025882","Total",690,171,72,99,519,21,130,101,140,18,38,71
"2011","Hinckley and Bosworth 005A","E01025872","Total",653,149,83,66,504,9,157,58,141,9,25,105
"2011","Hinckley and Bosworth 005B","E01025873","Total",651,140,61,79,511,14,121,86,149,14,30,97
"2011","Hinckley and Bosworth 005C","E01025874","Total",674,184,104,80,490,27,130,66,125,16,35,91
"2011","Hinckley and Bosworth 005D","E01025875","Total",658,222,118,104,436,27,87,82,122,19,29,70
"2011","Hinckley and Bosworth 005E","E01025876","Total",742,161,70,91,581,21,132,112,180,22,33,81
"2011","Hinckley and Bosworth 006A","E01025839","Total",698,187,51,136,511,37,82,95,164,12,30,91
"2011","Hinckley and Bosworth 006B","E01025840","Total",685,203,81,122,482,25,101,69,158,13,22,94
"2011","Hinckley and Bosworth 006C","E01025841","Total",763,202,118,84,561,16,163,92,163,6,34,87
"2011","Hinckley and Bosworth 006D","E01025842","Total",764,229,85,144,535,62,70,122,149,37,26,69
"2011","Hinckley and Bosworth 006E","E01025843","Total",729,246,80,166,483,33,100,81,153,18,26,72
"2011","Hinckley and Bosworth 006F","E01025844","Total",751,262,69,193,489,67,67,74,146,29,44,62
"2011","Hinckley and Bosworth 007A","E01025821","Total",796,298,75,223,498,61,57,101,182,10,21,66
"2011","Hinckley and Bosworth 007B","E01025822","Total",654,227,120,107,427,46,84,58,122,15,20,82
"2011","Hinckley and Bosworth 007C","E01025823","Total",639,156,64,92,483,46,67,100,155,20,27,68
"2011","Hinckley and Bosworth 007D","E01025824","Total",629,189,89,100,440,34,82,62,131,14,36,81
"2011","Hinckley and Bosworth 007E","E01025825","Total",607,153,61,92,454,17,96,69,129,12,41,90
"2011","Hinckley and Bosworth 007F","E01025826","Total",583,155,51,104,428,18,60,96,137,14,33,70
"2011","Hinckley and Bosworth 008A","E01025817","Total",834,202,97,105,632,21,166,109,174,23,30,109
"2011","Hinckley and Bosworth 008B","E01025818","Total",557,120,49,71,437,19,103,64,126,19,25,81
"2011","Hinckley and Bosworth 008C","E01025864","Total",639,152,56,96,487,23,63,137,153,22,29,60
"2011","Hinckley and Bosworth 008D","E01025881","Total",616,159,105,54,457,7,149,64,128,17,20,72
"2011","Hinckley and Bosworth 009A","E01025859","Total",579,136,75,61,443,15,93,81,122,9,35,88
"2011","Hinckley and Bosworth 009B","E01025860","Total",543,81,42,39,462,10,64,103,143,8,23,111
"2011","Hinckley and Bosworth 009C","E01025861","Total",748,219,92,127,529,29,97,90,173,14,35,91
"2011","Hinckley and Bosworth 009D","E01025862","Total",655,154,102,52,501,21,177,64,133,6,23,77
"2011","Hinckley and Bosworth 010A","E01025850","Total",626,214,91,123,412,31,73,87,118,9,28,66
"2011","Hinckley and Bosworth 010B","E01025852","Total",856,394,69,325,462,55,56,108,164,9,17,53
"2011","Hinckley and Bosworth 010C","E01025858","Total",905,362,85,277,543,53,78,116,199,8,22,67
"2011","Hinckley and Bosworth 010D","E01025863","Total",708,190,108,82,518,31,116,106,141,16,30,78
"2011","Hinckley and Bosworth 010E","E01025865","Total",775,231,89,142,544,42,85,126,161,20,27,83
"2011","Hinckley and Bosworth 011A","E01025853","Total",1152,264,47,217,888,77,103,240,294,30,42,102
"2011","Hinckley and Bosworth 011B","E01025854","Total",726,155,50,105,571,43,73,144,195,13,31,72
"2011","Hinckley and Bosworth 011C","E01025855","Total",598,150,54,96,448,37,61,92,143,10,25,80
"2011","Hinckley and Bosworth 011D","E01025866","Total",717,233,80,153,484,43,100,81,138,12,34,76
"2011","Hinckley and Bosworth 011E","E01025867","Total",665,187,55,132,478,25,84,96,157,15,28,73
"2011","Hinckley and Bosworth 012A","E01025849","Total",795,306,105,201,489,34,90,82,176,9,29,69
"2011","Hinckley and Bosworth 012B","E01025851","Total",521,106,51,55,415,16,104,86,99,15,22,73
"2011","Hinckley and Bosworth 012C","E01025856","Total",649,287,143,144,362,47,69,77,93,7,16,53
"2011","Hinckley and Bosworth 012D","E01025857","Total",599,143,51,92,456,20,59,108,150,12,24,83
"2011","Hinckley and Bosworth 013A","E01025827","Total",701,267,187,80,434,29,145,49,115,10,28,58
"2011","Hinckley and Bosworth 013B","E01025828","Total",617,152,79,73,465,15,154,75,104,12,28,77
"2011","Hinckley and Bosworth 013C","E01025829","Total",643,236,119,117,407,29,85,87,92,16,32,66
"2011","Hinckley and Bosworth 013D","E01025830","Total",658,221,101,120,437,35,113,106,115,9,17,42
"2011","Hinckley and Bosworth 014A","E01025831","Total",602,209,98,111,393,17,86,84,123,13,21,49
"2011","Hinckley and Bosworth 014B","E01025832","Total",614,109,38,71,505,19,79,127,145,16,25,94
"2011","Hinckley and Bosworth 014C","E01025833","Total",673,177,83,94,496,32,110,102,136,14,30,72
"2011","Hinckley and Bosworth 014D","E01025834","Total",609,134,55,79,475,16,88,112,148,13,35,63
"2011","Hinckley and Bosworth 014E","E01025835","Total",715,191,128,63,524,10,170,76,146,9,26,87
"2011","Hinckley and Bosworth 014F","E01025836","Total",561,137,77,60,424,15,97,70,126,9,29,78
"2011","Melton 001A","E01025885","Total",738,147,88,59,591,12,146,122,154,21,41,95
"2011","Melton 001B","E01025886","Total",815,267,156,111,548,22,164,121,127,9,28,77
"2011","Melton 001C","E01025887","Total",791,211,91,120,580,18,131,99,195,17,36,84
"2011","Melton 001D","E01025890","Total",538,160,72,88,378,21,84,72,98,17,24,62
"2011","Melton 001E","E01025891","Total",545,133,64,69,412,22,85,87,118,17,28,55
"2011","Melton 001F","E01025892","Total",660,155,70,85,505,16,89,136,140,20,40,64
"2011","Melton 002A","E01025901","Total",793,262,171,91,531,20,169,81,133,10,21,97
"2011","Melton 002B","E01025902","Total",705,166,97,69,539,13,156,96,158,10,34,72
"2011","Melton 002C","E01025903","Total",837,297,74,223,540,54,53,100,225,14,24,70
"2011","Melton 002D","E01025904","Total",832,180,93,87,652,25,166,159,177,29,31,65
"2011","Melton 002E","E01025906","Total",648,110,44,66,538,23,71,150,128,22,47,97
"2011","Melton 003A","E01025883","Total",702,173,62,111,529,32,116,74,181,12,23,91
"2011","Melton 003B","E01025884","Total",752,228,109,119,524,45,79,122,161,18,33,66
"2011","Melton 003C","E01025888","Total",739,175,75,100,564,8,136,105,176,13,42,84
"2011","Melton 003D","E01025909","Total",808,200,97,103,608,28,119,103,197,22,31,108
"2011","Melton 004A","E01025896","Total",660,141,83,58,519,24,121,88,132,20,45,89
"2011","Melton 004B","E01025897","Total",941,338,142,196,603,68,65,145,196,14,34,81
"2011","Melton 004C","E01025898","Total",529,146,70,76,383,28,65,71,109,23,25,62
"2011","Melton 004D","E01025899","Total",489,168,31,137,321,28,33,61,107,12,22,58
"2011","Melton 004E","E01025900","Total",626,169,87,82,457,58,70,87,117,22,21,82
"2011","Melton 004F","E01025905","Total",716,205,93,112,511,63,95,83,127,29,37,77
"2011","Melton 005A","E01025893","Total",859,191,101,90,668,31,149,119,183,16,53,117
"2011","Melton 005B","E01025894","Total",804,388,194,194,416,32,98,53,147,13,31,42
"2011","Melton 005C","E01025895","Total",740,225,57,168,515,36,78,95,162,18,44,82
"2011","Melton 005D","E01025907","Total",696,180,80,100,516,47,89,87,119,26,44,104
"2011","Melton 005E","E01025908","Total",738,175,83,92,563,10,132,93,181,24,35,88
"2011","Melton 006A","E01025889","Total",720,160,70,90,560,8,151,90,160,24,33,94
"2011","Melton 006B","E01025910","Total",759,205,95,110,554,19,127,85,178,19,34,92
"2011","Melton 006C","E01025911","Total",644,169,77,92,475,19,101,90,157,15,20,73
"2011","Melton 006D","E01025912","Total",666,178,66,112,488,24,102,84,158,9,36,75
"2011","North West Leicestershire 001A","E01025924","Total",450,118,50,68,332,19,62,60,114,8,18,51
"2011","North West Leicestershire 001B","E01025925","Total",1190,440,131,309,750,35,140,171,263,9,38,94
"2011","North West Leicestershire 001C","E01025926","Total",649,152,62,90,497,23,102,93,145,19,35,80
"2011","North West Leicestershire 001D","E01025927","Total",669,178,91,87,491,46,118,73,106,20,38,90
"2011","North West Leicestershire 001E","E01025928","Total",618,126,52,74,492,13,97,121,144,13,25,79
"2011","North West Leicestershire 002A","E01025923","Total",590,139,63,76,451,13,117,81,133,16,20,71
"2011","North West Leicestershire 002B","E01025944","Total",625,162,75,87,463,13,105,103,128,13,22,79
"2011","North West Leicestershire 002C","E01025945","Total",666,189,87,102,477,21,106,75,142,16,22,95
"2011","North West Leicestershire 002D","E01025946","Total",717,222,109,113,495,35,84,84,139,17,25,111
"2011","North West Leicestershire 003A","E01025915","Total",553,180,104,76,373,7,88,81,102,16,17,62
"2011","North West Leicestershire 003B","E01025916","Total",652,193,71,122,459,21,77,96,158,9,20,78
"2011","North West Leicestershire 003C","E01025917","Total",854,215,59,156,639,49,102,168,181,28,29,82
"2011","North West Leicestershire 003D","E01025918","Total",693,244,97,147,449,46,66,92,133,19,35,58
"2011","North West Leicestershire 004A","E01025960","Total",621,149,75,74,472,13,111,75,142,18,24,89
"2011","North West Leicestershire 004B","E01025961","Total",640,166,95,71,474,21,123,72,138,14,25,81
"2011","North West Leicestershire 004C","E01025962","Total",594,171,85,86,423,31,92,61,109,17,28,85
"2011","North West Leicestershire 004D","E01025965","Total",583,179,65,114,404,13,88,68,136,8,17,74
"2011","North West Leicestershire 005A","E01025955","Total",576,141,65,76,435,12,123,74,106,26,27,67
"2011","North West Leicestershire 005B","E01025956","Total",484,137,65,72,347,19,70,74,95,7,23,59
"2011","North West Leicestershire 005C","E01025963","Total",624,143,61,82,481,23,88,103,138,26,26,77
"2011","North West Leicestershire 005D","E01025964","Total",661,159,78,81,502,9,102,101,136,20,39,95
"2011","North West Leicestershire 006A","E01025914","Total",531,97,56,41,434,10,99,113,88,17,33,74
"2011","North West Leicestershire 006B","E01025919","Total",589,151,84,67,438,22,90,90,98,19,34,85
"2011","North West Leicestershire 006C","E01025920","Total",657,181,104,77,476,21,108,97,109,33,32,76
"2011","North West Leicestershire 006D","E01025921","Total",721,229,135,94,492,27,127,84,131,10,31,82
"2011","North West Leicestershire 007A","E01025966","Total",643,167,99,68,476,34,94,76,120,21,38,93
"2011","North West Leicestershire 007B","E01025967","Total",736,190,134,56,546,13,201,73,119,11,28,101
"2011","North West Leicestershire 007C","E01025968","Total",778,187,79,108,591,24,121,119,176,18,32,101
"2011","North West Leicestershire 007D","E01025969","Total",809,291,119,172,518,42,61,113,167,13,37,85
"2011","North West Leicestershire 008A","E01025950","Total",731,240,112,128,491,61,74,95,123,23,43,72
"2011","North West Leicestershire 008B","E01025951","Total",691,150,65,85,541,24,91,124,138,19,47,98
"2011","North West Leicestershire 008C","E01025952","Total",650,171,106,65,479,20,146,61,132,16,24,80
"2011","North West Leicestershire 008D","E01025953","Total",468,121,65,56,347,27,50,72,109,13,21,55
"2011","North West Leicestershire 008E","E01025954","Total",605,152,46,106,453,28,66,118,122,20,26,73
"2011","North West Leicestershire 009A","E01025932","Total",541,134,61,73,407,33,49,70,80,33,42,100
"2011","North West Leicestershire 009B","E01025933","Total",538,103,44,59,435,28,83,74,120,12,30,88
"2011","North West Leicestershire 009C","E01025934","Total",646,199,50,149,447,68,58,77,103,29,36,76
"2011","North West Leicestershire 009D","E01025935","Total",544,144,102,42,400,10,154,42,106,6,16,66
"2011","North West Leicestershire 009E","E01025936","Total",559,183,138,45,376,20,109,48,90,15,32,62
"2011","North West Leicestershire 010A","E01025929","Total",833,212,68,144,621,38,71,133,173,32,68,106
"2011","North West Leicestershire 010B","E01025930","Total",727,266,63,203,461,53,68,91,130,20,24,75
"2011","North West Leicestershire 010C","E01025931","Total",789,272,98,174,517,44,72,107,159,12,29,94
"2011","North West Leicestershire 010D","E01025957","Total",776,235,77,158,541,60,57,139,147,28,36,74
"2011","North West Leicestershire 011B","E01025937","Total",668,185,73,112,483,28,89,95,151,18,33,69
"2011","North West Leicestershire 011C","E01025958","Total",652,149,54,95,503,29,76,114,142,19,41,82
"2011","North West Leicestershire 011D","E01025959","Total",874,215,119,96,659,31,139,125,174,28,40,122
"2011","North West Leicestershire 011E","E01033102","Total",649,155,39,116,494,31,44,155,168,18,27,51
"2011","North West Leicestershire 011F","E01033103","Total",638,105,38,67,533,23,63,145,155,16,52,79
"2011","North West Leicestershire 012A","E01025913","Total",918,223,114,109,695,20,162,142,196,25,44,106
"2011","North West Leicestershire 012B","E01025947","Total",758,181,101,80,577,24,139,92,153,19,31,119
"2011","North West Leicestershire 012C","E01025948","Total",676,156,50,106,520,51,57,138,141,25,42,66
"2011","North West Leicestershire 012D","E01025949","Total",722,233,89,144,489,47,102,88,118,23,35,76
"2011","North West Leicestershire 013A","E01025938","Total",532,140,69,71,392,13,65,86,135,12,23,58
"2011","North West Leicestershire 013B","E01025939","Total",794,194,65,129,600,32,87,142,178,32,46,83
"2011","North West Leicestershire 013C","E01025940","Total",837,235,98,137,602,39,110,146,168,22,33,84
"2011","North West Leicestershire 013D","E01025941","Total",630,136,64,72,494,20,123,80,139,16,39,77
"2011","North West Leicestershire 013E","E01025942","Total",698,126,61,65,572,23,97,115,169,12,47,109
"2011","North West Leicestershire 013F","E01025943","Total",811,276,127,149,535,55,114,95,129,21,34,87
"2011","Oadby and Wigston 003A","E01025970","Total",507,88,61,27,419,5,108,66,69,17,54,100
"2011","Oadby and Wigston 003B","E01025971","Total",478,127,102,25,351,14,82,46,64,12,45,88
"2011","Oadby and Wigston 003C","E01025972","Total",461,95,63,32,366,12,94,64,57,14,36,89
"2011","Oadby and Wigston 003D","E01025976","Total",575,195,125,70,380,19,97,53,74,21,43,73
"2011","Oadby and Wigston 003E","E01025977","Total",605,223,152,71,382,12,105,55,100,14,29,67
"2011","Oadby and Wigston 003F","E01025978","Total",684,236,114,122,448,25,107,54,121,14,36,91
"2011","Oadby and Wigston 005A","E01025992","Total",745,322,174,148,423,43,95,76,123,5,22,59
"2011","Oadby and Wigston 005B","E01025994","Total",578,143,84,59,435,35,74,74,84,29,50,89
"2011","Oadby and Wigston 005C","E01025997","Total",578,165,104,61,413,24,67,79,87,21,37,98
"2011","Oadby and Wigston 005D","E01025999","Total",625,193,64,129,432,50,81,86,111,14,26,64
"2011","Oadby and Wigston 005E","E01026005","Total",719,226,139,87,493,15,124,81,122,15,42,94
"2011","Oadby and Wigston 006A","E01025985","Total",589,168,132,36,421,8,177,44,65,10,19,98
"2011","Oadby and Wigston 006B","E01025986","Total",607,151,101,50,456,11,150,71,100,9,27,88
"2011","Oadby and Wigston 006C","E01025987","Total",633,220,71,149,413,55,41,92,118,17,33,57
"2011","Oadby and Wigston 006D","E01025988","Total",681,218,44,174,463,59,35,133,136,14,31,55
"2011","Oadby and Wigston 006E","E01025989","Total",746,261,77,184,485,49,63,107,150,19,28,69
"2011","Oadby and Wigston 007A","E01025990","Total",600,171,109,62,429,10,128,62,93,7,30,99
"2011","Oadby and Wigston 007B","E01025991","Total",573,95,55,40,478,17,126,73,114,11,49,88
"2011","Oadby and Wigston 007C","E01025993","Total",576,98,74,24,478,17,134,85,98,24,33,87
"2011","Oadby and Wigston 007D","E01025998","Total",742,178,54,124,564,25,80,108,192,23,28,108
"2011","Oadby and Wigston 007E","E01026000","Total",532,105,46,59,427,9,104,73,112,11,33,85
"2011","Oadby and Wigston 007F","E01026001","Total",590,154,76,78,436,16,92,72,126,13,26,91
"2011","Oadby and Wigston 008A","E01025995","Total",581,145,89,56,436,14,114,71,74,19,52,92
"2011","Oadby and Wigston 008B","E01026003","Total",651,174,109,65,477,15,131,85,82,13,49,102
"2011","Oadby and Wigston 008C","E01026004","Total",682,142,88,54,540,9,142,94,120,23,38,114
"2011","Oadby and Wigston 008D","E01032600","Total",794,211,129,82,583,16,154,105,113,25,49,121
"2011","Oadby and Wigston 008E","E01032601","Total",569,120,78,42,449,12,113,91,86,7,45,95
"2011","Oadby and Wigston 009A","E01025973","Total",474,54,39,15,420,4,66,27,45,18,118,142
"2011","Oadby and Wigston 009B","E01025974","Total",565,141,61,80,424,29,64,106,102,11,37,75
"2011","Oadby and Wigston 009C","E01025975","Total",503,97,73,24,406,6,106,85,48,11,68,82
"2011","Oadby and Wigston 009E","E01025979","Total",490,94,57,37,396,19,77,80,70,16,54,80
"2011","Oadby and Wigston 009D","E01025980","Total",449,86,65,21,363,12,73,45,37,11,74,111
"2011","Oadby and Wigston 009F","E01025981","Total",589,135,84,51,454,14,88,76,80,17,71,108
"2011","Oadby and Wigston 009G","E01025982","Total",607,52,16,36,555,14,50,141,122,26,94,108
"2011","Oadby and Wigston 009H","E01025983","Total",479,127,66,61,352,15,57,65,84,8,50,73
"2011","Oadby and Wigston 009I","E01025984","Total",482,78,56,22,404,11,69,70,69,17,82,86
"2011","Boston 001A","E01026007","Total",474,112,66,46,362,10,106,61,95,7,21,62
"2011","Boston 001B","E01026008","Total",527,131,75,56,396,12,126,56,118,7,20,57
"2011","Boston 001C","E01026009","Total",516,113,65,48,403,13,108,60,103,12,37,70
"2011","Boston 001D","E01026023","Total",589,136,84,52,453,20,137,51,124,9,27,85
"2011","Boston 001E","E01026024","Total",829,190,128,62,639,29,167,103,155,32,44,109
"2011","Boston 002A","E01026010","Total",631,221,92,129,410,53,35,107,90,14,46,65
"2011","Boston 002B","E01026011","Total",1111,257,89,168,854,88,97,178,194,38,107,152
"2011","Boston 002C","E01026030","Total",994,394,201,193,600,80,113,95,128,22,59,103
"2011","Boston 002D","E01026032","Total",784,225,102,123,559,36,89,104,119,15,81,115
"2011","Boston 002E","E01026037","Total",599,243,110,133,356,39,55,51,90,19,39,63
"2011","Boston 003A","E01026006","Total",1149,431,95,336,718,74,60,130,243,10,74,127
"2011","Boston 003B","E01026021","Total",767,243,128,115,524,19,131,95,136,15,45,83
"2011","Boston 003C","E01026025","Total",988,368,74,294,620,74,58,136,199,7,50,96
"2011","Boston 003D","E01026036","Total",687,238,69,169,449,24,56,69,133,13,43,111
"2011","Boston 004A","E01026012","Total",549,185,134,51,364,34,128,52,76,9,23,42
"2011","Boston 004B","E01026015","Total",643,182,50,132,461,36,64,119,163,7,23,49
"2011","Boston 004C","E01026026","Total",819,285,165,120,534,62,93,91,109,31,48,100
"2011","Boston 004D","E01026027","Total",761,208,89,119,553,40,102,105,143,16,45,102
"2011","Boston 004E","E01026028","Total",851,333,192,141,518,35,119,85,139,15,42,83
"2011","Boston 006A","E01026016","Total",987,237,122,115,750,34,207,113,213,25,51,107
"2011","Boston 006B","E01026033","Total",789,150,63,87,639,31,162,96,178,23,52,97
"2011","Boston 006C","E01026034","Total",793,230,126,104,563,20,158,108,146,14,36,81
"2011","Boston 007A","E01026017","Total",691,184,109,75,507,24,131,60,155,14,39,84
"2011","Boston 007B","E01026018","Total",715,151,85,66,564,15,177,68,180,6,36,82
"2011","Boston 007C","E01026019","Total",1161,331,186,145,830,80,162,176,194,28,65,125
"2011","Boston 007D","E01026020","Total",926,218,98,120,708,45,171,132,194,17,52,97
"2011","Boston 007E","E01026041","Total",613,228,150,78,385,34,105,61,86,15,22,62
"2011","Boston 008A","E01026013","Total",625,160,103,57,465,6,125,86,127,11,24,86
"2011","Boston 008B","E01026014","Total",799,186,105,81,613,38,137,130,167,12,48,81
"2011","Boston 008C","E01026022","Total",867,187,126,61,680,24,230,120,142,18,48,98
"2011","Boston 008D","E01026038","Total",573,160,72,88,413,22,93,72,139,6,21,60
"2011","Boston 008E","E01026040","Total",497,108,54,54,389,15,81,80,99,13,29,72
"2011","Boston 009A","E01026029","Total",1007,210,99,111,797,50,148,188,221,26,53,111
"2011","Boston 009B","E01026031","Total",618,146,100,46,472,12,155,58,137,5,31,74
"2011","Boston 009C","E01026035","Total",869,188,123,65,681,21,186,114,188,10,49,113
"2011","Boston 009D","E01026039","Total",493,107,65,42,386,11,110,73,88,11,20,73
"2011","East Lindsey 001A","E01026045","Total",861,257,152,105,604,14,211,79,169,10,32,89
"2011","East Lindsey 001B","E01026061","Total",503,101,58,43,402,19,105,63,114,7,22,72
"2011","East Lindsey 001C","E01026062","Total",525,147,64,83,378,29,84,88,81,12,20,64
"2011","East Lindsey 001D","E01026063","Total",555,130,79,51,425,12,140,61,110,8,16,78
"2011","East Lindsey 001E","E01026080","Total",853,209,122,87,644,21,190,83,181,13,42,114
"2011","East Lindsey 001F","E01026106","Total",500,117,62,55,383,14,106,64,111,9,19,60
"2011","East Lindsey 001G","E01026107","Total",484,111,43,68,373,11,69,63,122,14,31,63
"2011","East Lindsey 002A","E01026058","Total",913,191,100,91,722,25,198,124,206,22,46,101
"2011","East Lindsey 002B","E01026076","Total",932,212,120,92,720,20,202,96,222,24,42,114
"2011","East Lindsey 002C","E01026079","Total",843,195,115,80,648,25,208,99,155,16,43,102
"2011","East Lindsey 003A","E01026077","Total",503,155,94,61,348,28,90,61,84,9,26,50
"2011","East Lindsey 003B","E01026078","Total",472,138,69,69,334,14,67,68,96,16,28,45
"2011","East Lindsey 003C","E01026087","Total",490,135,65,70,355,44,56,85,87,29,13,41
"2011","East Lindsey 003D","E01026088","Total",548,125,73,52,423,16,126,76,120,12,21,52
"2011","East Lindsey 003E","E01026090","Total",610,190,81,109,420,25,121,68,110,12,19,65
"2011","East Lindsey 003F","E01026091","Total",477,123,71,52,354,11,85,69,110,6,21,52
"2011","East Lindsey 003G","E01026108","Total",1051,330,116,214,721,84,135,141,189,32,46,94
"2011","East Lindsey 004A","E01026081","Total",1175,490,193,297,685,60,128,141,218,17,29,92
"2011","East Lindsey 004C","E01026089","Total",971,354,163,191,617,37,175,88,179,21,32,85
"2011","East Lindsey 004D","E01032986","Total",593,276,93,183,317,33,59,52,119,9,13,32
"2011","East Lindsey 004E","E01032987","Total",640,244,104,140,396,46,67,73,150,8,12,40
"2011","East Lindsey 005A","E01026072","Total",888,298,163,135,590,33,227,75,128,15,29,83
"2011","East Lindsey 005B","E01026073","Total",943,343,194,149,600,41,204,64,152,19,43,77
"2011","East Lindsey 005C","E01026074","Total",966,298,180,118,668,23,280,56,178,17,39,75
"2011","East Lindsey 005D","E01026099","Total",889,211,122,89,678,36,220,81,174,18,41,108
"2011","East Lindsey 006A","E01026103","Total",1009,361,251,110,648,29,309,50,152,10,36,62
"2011","East Lindsey 006B","E01026104","Total",1086,286,214,72,800,29,392,70,187,15,35,72
"2011","East Lindsey 006C","E01026109","Total",1149,449,221,228,700,19,323,43,188,14,30,83
"2011","East Lindsey 007A","E01026071","Total",951,242,109,133,709,27,212,91,233,20,36,90
"2011","East Lindsey 007B","E01026082","Total",1003,241,149,92,762,22,277,87,205,16,41,114
"2011","East Lindsey 007C","E01026121","Total",1105,324,171,153,781,24,244,122,203,27,52,109
"2011","East Lindsey 008A","E01026042","Total",672,207,98,109,465,51,99,85,122,19,24,65
"2011","East Lindsey 008B","E01026043","Total",720,213,126,87,507,43,143,81,126,22,23,69
"2011","East Lindsey 008C","E01026044","Total",587,155,100,55,432,9,152,58,98,11,28,76
"2011","East Lindsey 008D","E01026113","Total",886,222,130,92,664,16,230,63,184,26,47,98
"2011","East Lindsey 008E","E01026117","Total",778,199,107,92,579,8,187,82,154,14,36,98
"2011","East Lindsey 009A","E01026060","Total",565,132,77,55,433,9,149,44,133,10,26,62
"2011","East Lindsey 009B","E01026068","Total",942,250,118,132,692,19,207,91,216,21,44,94
"2011","East Lindsey 009C","E01026070","Total",837,201,98,103,636,15,188,99,182,14,25,113
"2011","East Lindsey 009D","E01026105","Total",959,239,122,117,720,18,237,100,206,17,42,100
"2011","East Lindsey 010A","E01026048","Total",756,251,135,116,505,30,204,43,133,6,16,73
"2011","East Lindsey 010B","E01026049","Total",727,217,114,103,510,16,185,61,146,10,27,65
"2011","East Lindsey 010C","E01026050","Total",798,226,174,52,572,24,256,33,166,6,26,61
"2011","East Lindsey 010D","E01026069","Total",978,325,184,141,653,41,228,53,213,11,34,73
"2011","East Lindsey 011A","E01026064","Total",654,224,92,132,430,36,91,79,120,14,29,61
"2011","East Lindsey 011B","E01026065","Total",828,251,154,97,577,11,212,112,154,8,26,54
"2011","East Lindsey 011C","E01026066","Total",876,246,143,103,630,28,239,102,160,10,23,68
"2011","East Lindsey 011D","E01026067","Total",933,407,178,229,526,31,116,108,151,16,34,70
"2011","East Lindsey 012A","E01026084","Total",683,218,108,110,465,35,110,89,107,12,37,75
"2011","East Lindsey 012B","E01026085","Total",1094,324,194,130,770,49,310,79,218,15,12,87
"2011","East Lindsey 012C","E01026115","Total",802,265,145,120,537,37,181,70,147,16,31,55
"2011","East Lindsey 012D","E01026116","Total",713,197,89,108,516,31,110,79,150,21,39,86
"2011","East Lindsey 013A","E01026046","Total",531,154,83,71,377,23,119,56,106,9,20,44
"2011","East Lindsey 013B","E01026047","Total",588,177,115,62,411,14,180,44,99,3,13,58
"2011","East Lindsey 013C","E01026055","Total",485,116,75,41,369,3,122,51,108,9,25,51
"2011","East Lindsey 013D","E01026059","Total",452,98,64,34,354,8,109,36,99,16,28,58
"2011","East Lindsey 013E","E01026100","Total",808,258,109,149,550,59,109,124,150,18,27,63
"2011","East Lindsey 013F","E01026101","Total",590,244,139,105,346,36,87,65,85,13,18,42
"2011","East Lindsey 014A","E01026092","Total",630,231,71,160,399,34,59,83,114,12,35,62
"2011","East Lindsey 014B","E01026093","Total",852,427,124,303,425,46,67,76,133,11,32,60
"2011","East Lindsey 014C","E01026095","Total",483,164,65,99,319,25,62,58,85,10,29,50
"2011","East Lindsey 014D","E01026114","Total",730,335,140,195,395,35,84,69,116,10,20,61
"2011","East Lindsey 015A","E01026083","Total",795,292,128,164,503,52,107,89,116,29,41,69
"2011","East Lindsey 015B","E01026094","Total",836,306,182,124,530,53,161,67,159,14,27,49
"2011","East Lindsey 015C","E01026096","Total",614,157,79,78,457,16,104,110,111,19,37,60
"2011","East Lindsey 015D","E01026097","Total",771,320,191,129,451,26,171,44,110,8,27,65
"2011","East Lindsey 016A","E01026051","Total",525,125,53,72,400,12,106,64,106,12,21,79
"2011","East Lindsey 016B","E01026052","Total",644,143,65,78,501,25,123,129,146,12,21,45
"2011","East Lindsey 016C","E01026053","Total",763,131,46,85,632,63,78,199,156,35,27,74
"2011","East Lindsey 016D","E01026054","Total",725,254,120,134,471,36,87,91,144,13,40,60
"2011","East Lindsey 016E","E01026118","Total",777,199,137,62,578,16,261,83,131,15,21,51
"2011","East Lindsey 016F","E01026119","Total",502,137,96,41,365,9,173,44,72,8,18,41
"2011","East Lindsey 016G","E01026120","Total",663,226,137,89,437,30,143,60,108,14,32,50
"2011","East Lindsey 017A","E01026056","Total",474,94,58,36,380,12,116,52,96,12,33,59
"2011","East Lindsey 017B","E01026110","Total",644,168,107,61,476,29,151,57,134,6,35,64
"2011","East Lindsey 017C","E01026111","Total",652,149,83,66,503,23,138,79,131,17,36,79
"2011","East Lindsey 017D","E01026112","Total",502,164,82,82,338,43,57,51,96,18,23,50
"2011","East Lindsey 018A","E01026057","Total",825,186,95,91,639,14,187,85,185,16,40,112
"2011","East Lindsey 018B","E01026075","Total",927,228,132,96,699,13,217,103,196,12,46,112
"2011","East Lindsey 018C","E01026098","Total",880,240,145,95,640,30,200,95,168,20,36,91
"2011","East Lindsey 018D","E01026102","Total",946,204,115,89,742,25,183,115,206,27,59,127
"2011","Lincoln 001A","E01026149","Total",791,312,108,204,479,55,75,97,149,10,23,70
"2011","Lincoln 001B","E01026150","Total",766,384,128,256,382,64,70,83,102,9,15,39
"2011","Lincoln 001C","E01026166","Total",537,178,90,88,359,43,66,54,97,13,32,54
"2011","Lincoln 001D","E01026168","Total",616,198,68,130,418,74,67,71,94,20,30,62
"2011","Lincoln 002A","E01026153","Total",1090,362,129,233,728,51,113,130,274,28,45,87
"2011","Lincoln 002B","E01026155","Total",744,229,55,174,515,28,70,108,209,8,31,61
"2011","Lincoln 002C","E01026157","Total",628,222,96,126,406,54,110,64,106,13,14,45
"2011","Lincoln 002D","E01026165","Total",715,332,159,173,383,37,89,70,101,12,13,61
"2011","Lincoln 003A","E01026125","Total",500,173,47,126,327,28,41,70,113,8,14,53
"2011","Lincoln 003B","E01026144","Total",628,208,63,145,420,14,35,56,137,14,17,147
"2011","Lincoln 003C","E01026147","Total",1025,298,95,203,727,27,101,163,297,12,26,101
"2011","Lincoln 003D","E01026148","Total",936,437,152,285,499,41,81,53,210,8,13,93
"2011","Lincoln 003E","E01026151","Total",835,295,116,179,540,30,97,100,189,19,29,76
"2011","Lincoln 003F","E01026164","Total",558,164,98,66,394,12,110,63,120,9,33,47
"2011","Lincoln 003G","E01026167","Total",775,338,148,190,437,13,137,49,157,8,19,54
"2011","Lincoln 004A","E01026122","Total",749,287,74,213,462,27,37,76,207,8,18,89
"2011","Lincoln 004B","E01026123","Total",1009,338,77,261,671,73,69,136,239,24,51,79
"2011","Lincoln 004C","E01026124","Total",645,189,44,145,456,40,37,80,153,12,24,110
"2011","Lincoln 004D","E01026126","Total",852,429,100,329,423,27,48,58,173,8,21,88
"2011","Lincoln 004E","E01026152","Total",565,141,53,88,424,78,41,91,76,32,45,61
"2011","Lincoln 004F","E01026154","Total",512,117,60,57,395,30,49,65,93,22,54,82
"2011","Lincoln 004G","E01026156","Total",474,97,49,48,377,45,52,77,77,19,35,72
"2011","Lincoln 005A","E01026132","Total",784,426,98,328,358,27,30,36,199,2,10,54
"2011","Lincoln 005B","E01026143","Total",711,264,43,221,447,18,40,51,173,6,14,145
"2011","Lincoln 005C","E01026145","Total",619,188,50,138,431,20,53,65,137,8,22,126
"2011","Lincoln 005D","E01026146","Total",726,322,136,186,404,22,28,28,121,6,6,193
"2011","Lincoln 006A","E01026134","Total",764,349,119,230,415,38,46,83,149,13,16,70
"2011","Lincoln 006B","E01026176","Total",890,467,70,397,423,32,29,61,177,2,25,97
"2011","Lincoln 006C","E01026177","Total",777,224,48,176,553,54,31,99,185,7,30,147
"2011","Lincoln 006D","E01026178","Total",771,309,81,228,462,42,57,72,152,7,29,103
"2011","Lincoln 007A","E01026127","Total",639,235,97,138,404,81,45,77,109,15,23,54
"2011","Lincoln 007B","E01026128","Total",1185,351,113,238,834,81,123,182,286,29,43,90
"2011","Lincoln 007C","E01026129","Total",705,196,36,160,509,112,21,121,127,36,40,52
"2011","Lincoln 007D","E01026131","Total",597,170,78,92,427,39,91,70,102,20,20,85
"2011","Lincoln 008A","E01026133","Total",995,347,90,257,648,62,80,111,216,23,36,120
"2011","Lincoln 008B","E01026135","Total",676,161,91,70,515,12,110,103,152,16,41,81
"2011","Lincoln 008C","E01026136","Total",616,156,98,58,460,15,119,84,118,11,33,80
"2011","Lincoln 008D","E01026174","Total",604,212,38,174,392,39,36,75,137,11,26,68
"2011","Lincoln 009A","E01026130","Total",588,142,64,78,446,19,141,62,129,11,17,67
"2011","Lincoln 009B","E01026158","Total",648,184,103,81,464,15,129,79,135,13,23,70
"2011","Lincoln 009C","E01026159","Total",643,199,66,133,444,42,46,92,163,15,27,59
"2011","Lincoln 009D","E01026160","Total",606,174,71,103,432,25,78,86,154,10,28,51
"2011","Lincoln 009E","E01026162","Total",621,165,76,89,456,23,109,77,123,16,26,82
"2011","Lincoln 009F","E01026163","Total",602,146,35,111,456,28,64,94,177,4,22,67
"2011","Lincoln 010A","E01026161","Total",675,288,120,168,387,48,68,61,128,7,14,61
"2011","Lincoln 010B","E01026170","Total",591,154,70,84,437,52,72,68,111,18,40,76
"2011","Lincoln 010C","E01026172","Total",575,186,71,115,389,31,56,84,84,25,35,74
"2011","Lincoln 010D","E01026173","Total",697,290,80,210,407,77,55,87,76,33,29,50
"2011","Lincoln 010E","E01026175","Total",883,373,63,310,510,61,48,129,172,7,30,63
"2011","Lincoln 011A","E01026137","Total",465,92,42,50,373,14,53,93,98,12,26,77
"2011","Lincoln 011B","E01026138","Total",618,157,70,87,461,8,82,89,152,18,30,82
"2011","Lincoln 011C","E01026139","Total",496,100,68,32,396,14,109,62,105,7,26,73
"2011","Lincoln 011D","E01026140","Total",624,257,85,172,367,48,46,67,128,14,19,45
"2011","Lincoln 011E","E01026141","Total",557,118,58,60,439,16,68,117,108,18,39,73
"2011","Lincoln 011F","E01026142","Total",508,120,54,66,388,45,54,54,105,7,41,82
"2011","Lincoln 011G","E01026169","Total",752,256,152,104,496,19,143,55,135,16,44,84
"2011","Lincoln 011H","E01026171","Total",667,190,136,54,477,12,150,65,141,10,17,82
"2011","North Kesteven 001A","E01026186","Total",690,161,98,63,529,16,164,76,155,8,33,77
"2011","North Kesteven 001B","E01026187","Total",750,146,39,107,604,38,60,167,185,28,38,88
"2011","North Kesteven 001C","E01026189","Total",809,204,122,82,605,24,212,92,167,11,17,82
"2011","North Kesteven 001D","E01026203","Total",802,223,138,85,579,18,201,96,135,7,31,91
"2011","North Kesteven 001E","E01026204","Total",738,180,103,77,558,11,189,80,156,10,34,78
"2011","North Kesteven 001F","E01026206","Total",780,202,102,100,578,24,107,125,163,20,46,93
"2011","North Kesteven 003B","E01026182","Total",579,131,60,71,448,22,89,100,137,13,32,55
"2011","North Kesteven 003C","E01026193","Total",615,148,71,77,467,23,119,70,156,13,24,62
"2011","North Kesteven 003D","E01026199","Total",954,220,107,113,734,18,198,141,206,23,44,104
"2011","North Kesteven 003E","E01026225","Total",678,182,69,113,496,32,79,128,142,13,41,61
"2011","North Kesteven 003F","E01026226","Total",812,208,145,63,604,10,222,68,170,10,31,93
"2011","North Kesteven 003G","E01032990","Total",919,176,13,163,743,61,29,231,288,38,45,51
"2011","North Kesteven 003H","E01032994","Total",556,143,59,84,413,27,65,93,138,7,23,60
"2011","North Kesteven 004A","E01026184","Total",508,58,34,24,450,21,34,185,109,36,25,40
"2011","North Kesteven 004B","E01026185","Total",810,274,168,106,536,21,169,81,136,9,42,78
"2011","North Kesteven 004C","E01026188","Total",1041,399,199,200,642,48,124,161,197,19,34,59
"2011","North Kesteven 004D","E01026190","Total",646,197,119,78,449,28,129,88,96,13,20,75
"2011","North Kesteven 004E","E01026237","Total",492,127,71,56,365,26,103,46,101,4,20,65
"2011","North Kesteven 004F","E01026238","Total",526,101,57,44,425,16,73,95,125,18,30,68
"2011","North Kesteven 005A","E01026191","Total",697,150,74,76,547,38,112,108,154,24,36,75
"2011","North Kesteven 005B","E01026205","Total",665,214,139,75,451,34,132,66,118,22,18,61
"2011","North Kesteven 005C","E01026211","Total",746,126,54,72,620,22,113,122,219,21,40,83
"2011","North Kesteven 005D","E01026212","Total",663,142,81,61,521,42,125,91,153,14,30,66
"2011","North Kesteven 005E","E01026213","Total",794,269,167,102,525,22,174,76,138,15,28,72
"2011","North Kesteven 006A","E01026192","Total",496,115,51,64,381,15,90,74,120,12,18,52
"2011","North Kesteven 006B","E01026194","Total",803,200,114,86,603,41,177,118,153,16,24,74
"2011","North Kesteven 006C","E01026195","Total",814,185,90,95,629,26,164,121,185,24,38,71
"2011","North Kesteven 006D","E01026196","Total",651,180,96,84,471,26,132,75,134,15,27,62
"2011","North Kesteven 007A","E01026180","Total",604,137,61,76,467,18,119,82,137,23,21,67
"2011","North Kesteven 007B","E01026183","Total",1096,302,154,148,794,45,225,125,213,29,55,102
"2011","North Kesteven 007C","E01026210","Total",957,223,116,107,734,26,190,104,243,26,48,97
"2011","North Kesteven 007D","E01026224","Total",763,256,146,110,507,46,121,81,118,23,42,76
"2011","North Kesteven 008A","E01026179","Total",437,82,29,53,355,11,39,130,101,24,22,28
"2011","North Kesteven 008B","E01026197","Total",605,161,60,101,444,21,115,73,135,12,24,64
"2011","North Kesteven 008C","E01026198","Total",446,47,6,41,399,20,15,164,133,25,16,26
"2011","North Kesteven 008D","E01026223","Total",899,215,121,94,684,30,194,112,188,17,44,99
"2011","North Kesteven 009A","E01026209","Total",961,265,172,93,696,24,260,94,169,13,37,99
"2011","North Kesteven 009B","E01026221","Total",1039,285,132,153,754,41,200,118,237,28,46,84
"2011","North Kesteven 009C","E01026222","Total",817,210,119,91,607,27,224,88,147,16,40,65
"2011","North Kesteven 010A","E01026227","Total",752,374,141,233,378,31,64,81,122,5,22,53
"2011","North Kesteven 010B","E01026230","Total",534,173,82,91,361,34,70,58,97,22,27,53
"2011","North Kesteven 010C","E01026231","Total",1091,258,98,160,833,49,114,202,251,26,56,135
"2011","North Kesteven 010D","E01026232","Total",1015,370,181,189,645,37,146,126,191,18,35,92
"2011","North Kesteven 010E","E01026235","Total",731,273,113,160,458,57,89,84,118,14,28,68
"2011","North Kesteven 011A","E01026228","Total",618,149,41,108,469,35,65,102,155,18,32,62
"2011","North Kesteven 011B","E01026229","Total",614,126,46,80,488,38,73,112,140,14,40,71
"2011","North Kesteven 011C","E01026233","Total",723,179,97,82,544,23,115,127,142,14,36,87
"2011","North Kesteven 011D","E01026234","Total",1051,184,56,128,867,35,150,210,238,30,64,140
"2011","North Kesteven 011E","E01026236","Total",524,146,87,59,378,21,135,50,88,9,23,52
"2011","North Kesteven 012A","E01026200","Total",696,186,79,107,510,24,118,108,147,8,26,79
"2011","North Kesteven 012B","E01026201","Total",858,210,105,105,648,42,187,113,168,20,42,76
"2011","North Kesteven 012C","E01026202","Total",852,271,188,83,581,19,235,88,138,9,20,72
"2011","North Kesteven 012D","E01026207","Total",523,130,62,68,393,13,122,59,100,9,23,67
"2011","North Kesteven 012E","E01026208","Total",662,131,65,66,531,23,112,96,172,22,38,68
"2011","North Kesteven 013A","E01026220","Total",1019,272,188,84,747,30,259,97,190,16,47,108
"2011","North Kesteven 013B","E01032988","Total",599,181,79,102,418,41,62,85,123,9,32,66
"2011","North Kesteven 013C","E01032989","Total",551,119,9,110,432,47,17,118,168,17,22,43
"2011","North Kesteven 013D","E01032993","Total",623,167,95,72,456,8,136,69,119,11,37,76
"2011","North Kesteven 014A","E01026214","Total",513,150,80,70,363,22,92,66,94,12,19,58
"2011","North Kesteven 014B","E01026215","Total",464,111,86,25,353,4,122,59,75,12,28,53
"2011","North Kesteven 014C","E01026218","Total",565,190,120,70,375,12,134,42,102,4,19,62
"2011","North Kesteven 014D","E01026219","Total",506,109,61,48,397,12,117,77,82,12,19,78
"2011","North Kesteven 014E","E01032991","Total",630,178,95,83,452,18,114,83,127,9,34,67
"2011","North Kesteven 014F","E01032992","Total",600,171,90,81,429,25,127,67,109,8,16,77
"2011","South Holland 001A","E01026242","Total",621,140,79,61,481,17,137,67,130,10,38,82
"2011","South Holland 001B","E01026243","Total",570,152,81,71,418,28,102,72,107,14,30,65
"2011","South Holland 001C","E01026244","Total",545,111,64,47,434,12,115,53,127,16,25,86
"2011","South Holland 001D","E01026247","Total",815,215,121,94,600,27,187,86,154,17,31,98
"2011","South Holland 001E","E01026276","Total",972,196,104,92,776,14,202,117,225,19,60,139
"2011","South Holland 002A","E01026246","Total",951,182,100,82,769,21,209,99,233,27,63,117
"2011","South Holland 002B","E01026248","Total",892,176,77,99,716,28,144,109,214,29,51,141
"2011","South Holland 002C","E01026257","Total",856,224,154,70,632,13,260,80,151,20,33,75
"2011","South Holland 003A","E01026250","Total",841,291,162,129,550,64,104,88,174,12,34,74
"2011","South Holland 003B","E01026251","Total",792,219,153,66,573,25,178,87,146,18,36,83
"2011","South Holland 003C","E01026252","Total",779,233,160,73,546,32,179,75,137,16,39,68
"2011","South Holland 003D","E01026253","Total",797,221,132,89,576,43,168,108,146,15,29,67
"2011","South Holland 004A","E01026281","Total",538,102,59,43,436,8,121,77,125,7,33,65
"2011","South Holland 004B","E01026282","Total",713,179,120,59,534,22,151,89,123,18,46,85
"2011","South Holland 004C","E01026283","Total",726,160,92,68,566,19,167,93,147,19,32,89
"2011","South Holland 004D","E01026285","Total",609,133,77,56,476,14,143,60,141,17,33,68
"2011","South Holland 004E","E01026286","Total",498,94,54,40,404,23,98,65,98,22,25,73
"2011","South Holland 005A","E01026241","Total",772,139,36,103,633,37,92,134,212,22,38,98
"2011","South Holland 005B","E01026258","Total",747,158,103,55,589,6,188,79,160,15,35,106
"2011","South Holland 005C","E01026259","Total",703,150,80,70,553,19,116,87,168,19,37,107
"2011","South Holland 005D","E01026260","Total",857,246,154,92,611,49,161,95,147,15,47,97
"2011","South Holland 006B","E01026266","Total",919,349,139,210,570,34,79,126,177,8,38,108
"2011","South Holland 006C","E01026273","Total",716,174,110,64,542,16,172,82,137,16,36,83
"2011","South Holland 006D","E01026274","Total",755,156,59,97,599,44,104,165,132,29,37,88
"2011","South Holland 006E","E01026275","Total",859,238,149,89,621,37,149,119,168,11,38,99
"2011","South Holland 006F","E01032995","Total",692,306,147,159,386,28,81,60,121,6,27,63
"2011","South Holland 006G","E01032996","Total",542,113,72,41,429,11,106,95,100,13,24,80
"2011","South Holland 007A","E01026268","Total",873,270,181,89,603,55,133,109,166,14,33,93
"2011","South Holland 007B","E01026269","Total",925,219,132,87,706,19,230,104,173,13,51,116
"2011","South Holland 007C","E01026270","Total",744,183,70,113,561,72,92,94,122,27,45,109
"2011","South Holland 007D","E01026271","Total",756,259,154,105,497,35,80,97,118,13,52,102
"2011","South Holland 007E","E01026272","Total",559,182,90,92,377,18,97,60,92,10,24,76
"2011","South Holland 008A","E01026254","Total",835,251,171,80,584,21,211,75,165,11,29,72
"2011","South Holland 008B","E01026255","Total",864,261,141,120,603,31,185,97,166,9,27,88
"2011","South Holland 008C","E01026256","Total",688,163,105,58,525,21,134,76,150,15,47,82
"2011","South Holland 008D","E01026277","Total",704,235,133,102,469,50,87,74,115,23,38,82
"2011","South Holland 008E","E01026278","Total",609,139,77,62,470,18,131,77,134,14,27,69
"2011","South Holland 008F","E01026279","Total",614,175,109,66,439,29,150,64,99,12,27,58
"2011","South Holland 009A","E01026262","Total",638,128,73,55,510,12,135,74,134,17,26,112
"2011","South Holland 009B","E01026263","Total",805,193,97,96,612,36,97,165,181,19,36,78
"2011","South Holland 009C","E01026264","Total",636,163,85,78,473,37,99,88,112,18,36,83
"2011","South Holland 009D","E01026265","Total",511,124,66,58,387,18,82,74,95,10,31,77
"2011","South Holland 009E","E01026267","Total",1177,278,124,154,899,58,179,186,266,20,80,110
"2011","South Holland 010A","E01026245","Total",933,253,160,93,680,22,214,93,199,16,35,101
"2011","South Holland 010B","E01026249","Total",773,146,84,62,627,13,176,93,192,14,37,102
"2011","South Holland 010C","E01026280","Total",1020,187,96,91,833,31,201,138,246,26,63,128
"2011","South Holland 011A","E01026239","Total",778,235,105,130,543,29,120,132,154,15,33,60
"2011","South Holland 011B","E01026240","Total",964,213,120,93,751,24,167,163,197,29,55,116
"2011","South Holland 011C","E01026284","Total",781,127,61,66,654,30,159,121,166,29,42,107
"2011","South Kesteven 001A","E01026313","Total",653,158,92,66,495,19,113,88,150,19,28,78
"2011","South Kesteven 001B","E01026314","Total",561,145,76,69,416,27,105,94,111,10,23,46
"2011","South Kesteven 001C","E01026329","Total",786,188,109,79,598,28,185,94,150,23,49,69
"2011","South Kesteven 001D","E01026333","Total",1017,193,98,95,824,36,171,176,248,31,48,114
"2011","South Kesteven 002A","E01026291","Total",840,203,123,80,637,21,197,112,170,15,37,85
"2011","South Kesteven 002B","E01026340","Total",966,268,169,99,698,41,222,114,155,24,40,102
"2011","South Kesteven 002C","E01026355","Total",999,221,147,74,778,34,239,143,189,32,40,101
"2011","South Kesteven 002D","E01026365","Total",993,203,123,80,790,16,277,122,208,20,43,104
"2011","South Kesteven 003A","E01026325","Total",613,159,100,59,454,47,85,90,98,28,30,76
"2011","South Kesteven 003B","E01026326","Total",609,148,90,58,461,24,106,82,109,21,32,87
"2011","South Kesteven 003C","E01026327","Total",610,175,110,65,435,29,118,60,126,8,30,64
"2011","South Kesteven 003D","E01026328","Total",600,174,94,80,426,65,63,82,93,21,38,64
"2011","South Kesteven 003E","E01026352","Total",561,154,107,47,407,9,123,70,107,8,20,70
"2011","South Kesteven 003F","E01026353","Total",857,436,210,226,421,50,87,68,140,6,19,51
"2011","South Kesteven 003G","E01026354","Total",489,86,56,30,403,11,101,61,129,10,27,64
"2011","South Kesteven 004A","E01026320","Total",654,131,59,72,523,10,114,109,134,18,50,88
"2011","South Kesteven 004B","E01026321","Total",537,131,67,64,406,9,97,68,117,14,38,63
"2011","South Kesteven 004C","E01026322","Total",534,166,70,96,368,15,106,52,124,6,17,48
"2011","South Kesteven 004D","E01026323","Total",948,452,186,266,496,32,71,91,181,13,28,80
"2011","South Kesteven 004E","E01026324","Total",885,180,81,99,705,33,111,167,200,28,48,118
"2011","South Kesteven 005A","E01026308","Total",596,162,38,124,434,99,30,101,85,28,26,65
"2011","South Kesteven 005B","E01026309","Total",693,196,80,116,497,45,103,101,133,15,25,75
"2011","South Kesteven 005C","E01026310","Total",454,81,35,46,373,36,72,71,82,18,34,60
"2011","South Kesteven 005D","E01026311","Total",666,164,71,93,502,50,84,102,125,22,40,79
"2011","South Kesteven 005E","E01026312","Total",452,62,21,41,390,83,22,85,62,33,42,63
"2011","South Kesteven 006A","E01026317","Total",978,364,77,287,614,77,57,118,218,12,43,89
"2011","South Kesteven 006B","E01026318","Total",856,286,81,205,570,86,45,139,163,22,37,78
"2011","South Kesteven 006C","E01026319","Total",932,249,98,151,683,39,168,119,211,21,33,92
"2011","South Kesteven 006D","E01026343","Total",909,404,104,300,505,62,67,107,162,10,27,70
"2011","South Kesteven 006E","E01026344","Total",682,224,66,158,458,34,79,84,149,12,29,71
"2011","South Kesteven 006F","E01026345","Total",628,189,104,85,439,52,109,64,101,14,37,62
"2011","South Kesteven 007A","E01026292","Total",618,135,59,76,483,30,93,100,166,7,20,67
"2011","South Kesteven 007B","E01026293","Total",844,179,64,115,665,36,121,163,211,22,36,76
"2011","South Kesteven 007C","E01026294","Total",647,111,21,90,536,38,56,141,184,14,42,61
"2011","South Kesteven 007D","E01026316","Total",1038,255,132,123,783,31,212,127,221,31,48,113
"2011","South Kesteven 007E","E01026332","Total",945,240,139,101,705,20,176,122,208,29,51,99
"2011","South Kesteven 008A","E01026290","Total",905,180,89,91,725,25,174,129,199,18,58,122
"2011","South Kesteven 008B","E01026341","Total",619,145,87,58,474,22,114,94,113,14,25,92
"2011","South Kesteven 008C","E01026342","Total",570,116,37,79,454,20,66,113,144,22,38,51
"2011","South Kesteven 008D","E01026361","Total",1130,291,132,159,839,55,218,158,222,17,54,115
"2011","South Kesteven 009A","E01026315","Total",922,237,130,107,685,37,189,93,213,25,37,91
"2011","South Kesteven 009B","E01026331","Total",1042,259,127,132,783,37,209,137,232,31,47,90
"2011","South Kesteven 009C","E01026338","Total",527,118,52,66,409,17,100,75,133,15,21,48
"2011","South Kesteven 009D","E01026339","Total",539,168,57,111,371,28,52,78,129,9,23,52
"2011","South Kesteven 010A","E01026299","Total",718,219,112,107,499,35,91,112,138,20,22,81
"2011","South Kesteven 010B","E01026300","Total",628,131,93,38,497,12,139,87,127,15,24,93
"2011","South Kesteven 010C","E01026301","Total",694,182,109,73,512,8,174,82,135,13,26,74
"2011","South Kesteven 010D","E01026302","Total",491,111,52,59,380,11,62,93,104,14,21,75
"2011","South Kesteven 011B","E01026296","Total",651,131,77,54,520,9,163,75,141,14,49,69
"2011","South Kesteven 011C","E01026297","Total",586,170,107,63,416,15,116,61,102,11,32,79
"2011","South Kesteven 011D","E01026298","Total",868,370,199,171,498,49,100,96,135,14,34,70
"2011","South Kesteven 011E","E01032997","Total",472,100,18,82,372,32,25,126,110,17,19,43
"2011","South Kesteven 011F","E01032998","Total",482,103,13,90,379,30,12,116,119,21,32,49
"2011","South Kesteven 011G","E01032999","Total",521,148,89,59,373,23,94,77,105,9,16,49
"2011","South Kesteven 012A","E01026330","Total",868,165,77,88,703,24,162,136,196,25,59,101
"2011","South Kesteven 012B","E01026360","Total",885,185,106,79,700,30,150,133,205,24,36,122
"2011","South Kesteven 012C","E01026362","Total",671,120,58,62,551,14,90,151,144,18,31,103
"2011","South Kesteven 012D","E01026363","Total",531,116,48,68,415,12,112,96,115,20,21,39
"2011","South Kesteven 012E","E01026364","Total",709,153,81,72,556,28,138,128,135,19,26,82
"2011","South Kesteven 013A","E01026334","Total",619,112,60,52,507,13,97,104,138,14,41,100
"2011","South Kesteven 013B","E01026335","Total",721,248,131,117,473,20,134,76,136,8,20,79
"2011","South Kesteven 013C","E01026336","Total",693,217,84,133,476,41,104,88,113,23,26,81
"2011","South Kesteven 013D","E01026337","Total",653,155,87,68,498,29,112,78,143,12,31,93
"2011","South Kesteven 014A","E01026303","Total",521,91,25,66,430,22,45,108,128,16,30,81
"2011","South Kesteven 014B","E01026304","Total",609,106,47,59,503,20,119,89,165,11,23,76
"2011","South Kesteven 014C","E01026305","Total",596,164,24,140,432,41,32,100,170,11,22,56
"2011","South Kesteven 014D","E01026306","Total",709,228,142,86,481,36,128,79,132,16,28,62
"2011","South Kesteven 014E","E01026307","Total",550,129,64,65,421,15,89,81,132,11,20,73
"2011","South Kesteven 015A","E01026287","Total",623,175,75,100,448,24,98,61,126,15,32,92
"2011","South Kesteven 015B","E01026288","Total",744,255,134,121,489,63,75,95,140,18,24,74
"2011","South Kesteven 015C","E01026289","Total",858,212,80,132,646,48,100,155,203,15,39,86
"2011","South Kesteven 015D","E01026346","Total",512,140,51,89,372,20,66,81,116,10,17,62
"2011","South Kesteven 015E","E01026347","Total",843,367,199,168,476,25,124,82,169,6,16,54
"2011","South Kesteven 015F","E01026348","Total",466,97,56,41,369,38,71,57,90,18,23,72
"2011","South Kesteven 016A","E01026349","Total",791,324,162,162,467,70,90,84,139,16,13,55
"2011","South Kesteven 016B","E01026350","Total",848,415,196,219,433,25,128,63,152,6,12,47
"2011","South Kesteven 016C","E01026351","Total",850,456,175,281,394,20,106,53,159,6,8,42
"2011","South Kesteven 016D","E01026356","Total",580,117,33,84,463,28,47,121,156,13,27,71
"2011","South Kesteven 016E","E01026357","Total",588,115,35,80,473,26,82,84,157,15,24,85
"2011","South Kesteven 016F","E01026358","Total",624,144,77,67,480,17,131,89,146,8,22,67
"2011","South Kesteven 016G","E01026359","Total",667,142,89,53,525,21,148,107,133,23,22,71
"2011","West Lindsey 001A","E01026367","Total",741,247,127,120,494,27,136,74,137,13,24,83
"2011","West Lindsey 001B","E01026368","Total",687,174,94,80,513,37,109,91,146,12,27,91
"2011","West Lindsey 001C","E01026387","Total",1089,231,108,123,858,19,187,135,266,35,65,151
"2011","West Lindsey 001D","E01026416","Total",552,132,64,68,420,10,114,75,129,15,22,55
"2011","West Lindsey 001G","E01032683","Total",998,276,140,136,722,36,184,93,228,24,41,116
"2011","West Lindsey 002A","E01026380","Total",736,156,79,77,580,39,100,123,176,17,44,81
"2011","West Lindsey 002B","E01026401","Total",621,113,62,51,508,18,127,99,143,14,23,84
"2011","West Lindsey 002C","E01026402","Total",828,243,114,129,585,30,138,111,191,15,28,72
"2011","West Lindsey 002D","E01026403","Total",558,139,63,76,419,14,93,66,134,19,35,58
"2011","West Lindsey 002E","E01026407","Total",558,138,70,68,420,8,93,85,115,19,35,65
"2011","West Lindsey 002F","E01026408","Total",580,155,86,69,425,21,111,74,135,2,18,64
"2011","West Lindsey 003A","E01026389","Total",784,294,107,187,490,47,121,81,159,16,20,46
"2011","West Lindsey 003B","E01026390","Total",841,294,153,141,547,46,148,87,123,17,27,99
"2011","West Lindsey 003C","E01026391","Total",818,207,116,91,611,26,198,87,169,12,32,87
"2011","West Lindsey 003D","E01026392","Total",1281,323,173,150,958,34,248,167,280,33,57,139
"2011","West Lindsey 003E","E01026415","Total",406,110,36,74,296,18,53,61,84,17,19,44
"2011","West Lindsey 004A","E01026378","Total",721,215,75,140,506,63,71,100,137,25,34,76
"2011","West Lindsey 004B","E01026379","Total",733,260,96,164,473,32,86,86,136,21,30,82
"2011","West Lindsey 004C","E01026381","Total",799,303,142,161,496,54,91,83,155,16,28,69
"2011","West Lindsey 004D","E01026382","Total",740,247,115,132,493,41,95,99,150,17,28,63
"2011","West Lindsey 004E","E01026383","Total",614,298,70,228,316,35,35,60,117,9,11,49
"2011","West Lindsey 004F","E01026384","Total",892,422,152,270,470,53,78,71,140,23,28,77
"2011","West Lindsey 005A","E01026385","Total",511,124,71,53,387,22,108,53,123,5,23,53
"2011","West Lindsey 005B","E01026386","Total",522,115,31,84,407,22,61,81,122,21,36,64
"2011","West Lindsey 005C","E01026399","Total",607,138,67,71,469,21,104,91,139,13,34,67
"2011","West Lindsey 005D","E01026411","Total",1045,254,110,144,791,23,186,128,259,17,55,123
"2011","West Lindsey 006A","E01026374","Total",641,219,74,145,422,78,41,100,114,19,22,48
"2011","West Lindsey 006B","E01026375","Total",664,216,75,141,448,50,73,87,102,28,31,77
"2011","West Lindsey 006C","E01026376","Total",778,256,130,126,522,75,105,82,140,25,32,63
"2011","West Lindsey 006D","E01026377","Total",898,244,116,128,654,67,104,144,167,33,42,97
"2011","West Lindsey 007A","E01026388","Total",933,217,150,67,716,21,208,111,215,16,40,105
"2011","West Lindsey 007B","E01026404","Total",962,251,136,115,711,20,168,119,222,18,48,116
"2011","West Lindsey 007C","E01026409","Total",511,118,53,65,393,16,98,61,129,7,28,54
"2011","West Lindsey 007D","E01026410","Total",746,181,119,62,565,12,274,57,132,12,21,57
"2011","West Lindsey 008A","E01026372","Total",1030,259,155,104,771,39,183,137,208,32,46,126
"2011","West Lindsey 008B","E01026412","Total",722,213,130,83,509,38,114,113,125,11,30,78
"2011","West Lindsey 008C","E01026413","Total",871,171,92,79,700,37,136,152,165,39,61,110
"2011","West Lindsey 008D","E01026414","Total",694,131,56,75,563,33,136,95,160,14,35,90
"2011","West Lindsey 009A","E01026396","Total",545,119,78,41,426,14,152,56,107,5,16,76
"2011","West Lindsey 009B","E01026397","Total",993,255,69,186,738,33,151,136,253,29,38,98
"2011","West Lindsey 009C","E01026398","Total",707,239,134,105,468,22,135,74,127,12,20,78
"2011","West Lindsey 009D","E01026400","Total",622,86,22,64,536,34,57,158,146,26,39,76
"2011","West Lindsey 010A","E01026393","Total",636,173,125,48,463,13,166,75,97,10,24,78
"2011","West Lindsey 010B","E01026394","Total",770,207,101,106,563,21,129,106,186,9,39,73
"2011","West Lindsey 010C","E01026395","Total",658,197,128,69,461,22,165,56,110,5,32,71
"2011","West Lindsey 010D","E01026405","Total",523,94,52,42,429,9,107,99,96,14,37,67
"2011","West Lindsey 010E","E01026406","Total",525,97,58,39,428,8,138,72,101,9,29,71
"2011","West Lindsey 011A","E01026366","Total",915,251,129,122,664,25,172,110,209,20,31,97
"2011","West Lindsey 011B","E01026369","Total",486,149,101,48,337,20,101,43,87,8,20,58
"2011","West Lindsey 011C","E01026370","Total",940,244,131,113,696,27,227,126,185,19,31,81
"2011","West Lindsey 011D","E01026371","Total",525,116,68,48,409,13,130,71,104,12,18,61
"2011","West Lindsey 011E","E01026373","Total",828,176,91,85,652,28,152,111,203,30,32,96
"2011","Corby 001A","E01026971","Total",739,216,123,93,523,44,81,117,141,13,40,87
"2011","Corby 001B","E01026979","Total",566,131,68,63,435,20,84,85,133,19,28,66
"2011","Corby 001C","E01026980","Total",652,140,86,54,512,13,124,83,152,17,29,94
"2011","Corby 001D","E01026982","Total",787,200,66,134,587,84,60,131,148,23,42,99
"2011","Corby 002A","E01026969","Total",802,331,173,158,471,39,115,74,118,12,28,85
"2011","Corby 002B","E01026970","Total",656,151,63,88,505,52,53,108,124,21,37,110
"2011","Corby 002C","E01026972","Total",766,210,80,130,556,80,62,125,145,16,38,90
"2011","Corby 002D","E01026976","Total",544,147,36,111,397,53,40,63,101,23,36,81
"2011","Corby 002E","E01026981","Total",480,99,55,44,381,26,84,50,121,10,30,60
"2011","Corby 002F","E01026983","Total",464,138,48,90,326,23,51,54,84,11,27,76
"2011","Corby 003A","E01026957","Total",727,278,99,179,449,34,81,78,146,11,23,76
"2011","Corby 003B","E01026958","Total",738,198,40,158,540,73,47,135,142,19,31,93
"2011","Corby 003C","E01026977","Total",838,196,98,98,642,33,152,118,220,12,33,74
"2011","Corby 003D","E01026978","Total",604,160,76,84,444,33,86,83,119,17,36,70
"2011","Corby 004A","E01026962","Total",602,172,93,79,430,50,82,63,104,6,27,98
"2011","Corby 004B","E01026973","Total",587,159,80,79,428,31,77,82,107,24,30,77
"2011","Corby 004C","E01026974","Total",476,101,57,44,375,21,105,46,88,9,30,76
"2011","Corby 004D","E01026975","Total",645,244,130,114,401,51,78,67,103,11,23,68
"2011","Corby 004E","E01026984","Total",752,248,109,139,504,37,107,101,115,14,42,88
"2011","Corby 004F","E01026985","Total",637,165,75,90,472,24,132,63,105,7,37,104
"2011","Corby 005A","E01026949","Total",613,218,82,136,395,35,85,55,124,5,34,57
"2011","Corby 005B","E01026950","Total",614,175,60,115,439,66,53,82,95,23,40,80
"2011","Corby 005C","E01026951","Total",495,123,45,78,372,43,48,76,77,17,41,70
"2011","Corby 005D","E01026952","Total",499,143,62,81,356,25,56,52,105,11,31,76
"2011","Corby 006A","E01026959","Total",646,226,91,135,420,55,57,71,114,14,28,81
"2011","Corby 006B","E01026960","Total",609,175,64,111,434,74,62,73,88,18,49,70
"2011","Corby 006C","E01026961","Total",502,129,34,95,373,51,44,67,89,23,39,60
"2011","Corby 006D","E01026965","Total",426,130,24,106,296,49,28,43,74,12,38,52
"2011","Corby 006E","E01026966","Total",564,142,58,84,422,45,76,56,96,19,29,101
"2011","Corby 006F","E01026967","Total",693,191,79,112,502,46,91,87,108,28,40,102
"2011","Corby 006G","E01026968","Total",611,239,47,192,372,68,32,69,90,19,30,64
"2011","Corby 008A","E01026953","Total",590,150,77,73,440,15,105,56,144,14,29,77
"2011","Corby 008B","E01026954","Total",534,119,36,83,415,39,58,72,108,16,36,86
"2011","Corby 008C","E01026955","Total",557,82,38,44,475,12,74,83,144,11,41,110
"2011","Corby 008D","E01026956","Total",818,236,64,172,582,56,58,122,176,20,41,109
"2011","Corby 009A","E01026963","Total",550,138,25,113,412,69,31,97,118,16,23,58
"2011","Corby 009B","E01032963","Total",613,116,18,98,497,29,35,126,174,27,39,67
"2011","Corby 009C","E01032964","Total",584,85,7,78,499,41,32,147,137,24,54,64
"2011","Corby 009D","E01032965","Total",492,65,6,59,427,26,18,134,143,22,38,46
"2011","Corby 009E","E01032966","Total",603,68,6,62,535,37,23,179,165,24,35,72
"2011","Corby 009F","E01032967","Total",540,62,3,59,478,46,13,140,113,37,67,62
"2011","Daventry 001A","E01027005","Total",823,166,75,91,657,19,150,140,184,32,45,87
"2011","Daventry 001B","E01027026","Total",794,187,92,95,607,18,137,125,177,22,40,88
"2011","Daventry 001C","E01027030","Total",731,180,93,87,551,15,125,84,149,21,44,113
"2011","Daventry 002A","E01027000","Total",608,170,95,75,438,28,77,100,121,24,25,63
"2011","Daventry 002B","E01027001","Total",510,58,16,42,452,14,43,121,99,24,53,98
"2011","Daventry 002C","E01027002","Total",638,133,59,74,505,14,107,91,138,27,38,90
"2011","Daventry 002D","E01027003","Total",593,159,56,103,434,30,64,81,134,15,31,79
"2011","Daventry 002E","E01027022","Total",745,177,93,84,568,23,120,91,171,28,31,104
"2011","Daventry 003A","E01026994","Total",453,121,85,36,332,8,87,52,113,10,19,43
"2011","Daventry 003D","E01026999","Total",776,188,98,90,588,28,150,101,186,10,30,83
"2011","Daventry 003E","E01027006","Total",745,165,101,64,580,27,117,131,143,22,45,95
"2011","Daventry 003F","E01032968","Total",909,191,101,90,718,30,201,110,194,22,45,116
"2011","Daventry 004A","E01026998","Total",742,166,77,89,576,13,135,75,194,14,43,102
"2011","Daventry 004B","E01027015","Total",522,121,73,48,401,11,90,69,112,8,35,76
"2011","Daventry 004C","E01027016","Total",616,129,49,80,487,25,83,85,160,19,28,87
"2011","Daventry 004D","E01027021","Total",768,165,80,85,603,19,155,118,174,23,40,74
"2011","Daventry 004E","E01027027","Total",903,183,96,87,720,35,132,179,167,40,58,109
"2011","Daventry 005A","E01026997","Total",682,151,96,55,531,19,115,87,152,21,43,94
"2011","Daventry 005B","E01027018","Total",623,161,80,81,462,11,139,65,112,16,38,81
"2011","Daventry 005C","E01027019","Total",652,230,103,127,422,17,92,83,119,8,30,73
"2011","Daventry 005D","E01027020","Total",535,167,117,50,368,20,104,51,90,7,27,69
"2011","Daventry 005E","E01027023","Total",824,168,94,74,656,23,148,123,179,36,44,103
"2011","Daventry 006A","E01026987","Total",516,138,64,74,378,19,88,58,100,11,26,76
"2011","Daventry 006B","E01026989","Total",592,154,18,136,438,50,42,117,127,23,27,52
"2011","Daventry 006C","E01026990","Total",1069,237,30,207,832,80,70,207,281,27,44,123
"2011","Daventry 006D","E01027012","Total",726,150,59,91,576,44,136,91,166,27,27,85
"2011","Daventry 006E","E01027014","Total",799,140,41,99,659,46,59,195,174,32,67,86
"2011","Daventry 007A","E01026986","Total",1134,268,87,181,866,84,91,234,224,48,62,123
"2011","Daventry 007B","E01026988","Total",596,113,53,60,483,56,75,96,114,26,42,74
"2011","Daventry 007C","E01026991","Total",759,228,142,86,531,10,203,57,163,4,18,76
"2011","Daventry 007D","E01026992","Total",931,446,208,238,485,42,91,83,159,17,19,74
"2011","Daventry 007E","E01027010","Total",489,92,49,43,397,9,106,54,117,13,24,74
"2011","Daventry 008A","E01027007","Total",536,126,37,89,410,43,49,81,108,19,35,75
"2011","Daventry 008B","E01027008","Total",888,268,62,206,620,37,98,122,231,16,28,88
"2011","Daventry 008C","E01027009","Total",595,163,46,117,432,42,46,104,118,26,40,56
"2011","Daventry 008D","E01027013","Total",715,217,54,163,498,86,39,98,110,37,53,75
"2011","Daventry 009A","E01027011","Total",820,199,90,109,621,13,165,94,193,24,31,101
"2011","Daventry 009B","E01027017","Total",670,244,114,130,426,34,109,71,96,8,32,76
"2011","Daventry 009C","E01027024","Total",714,149,61,88,565,16,124,113,177,19,26,90
"2011","Daventry 009D","E01027025","Total",751,256,98,158,495,34,92,105,165,21,21,57
"2011","Daventry 010A","E01026993","Total",824,190,106,84,634,15,173,109,188,12,32,105
"2011","Daventry 010B","E01027004","Total",773,187,95,92,586,14,154,116,159,24,29,90
"2011","Daventry 010C","E01027028","Total",887,234,82,152,653,39,111,130,198,22,43,110
"2011","Daventry 010D","E01027029","Total",671,218,80,138,453,41,66,106,118,25,37,60
"2011","East Northamptonshire 001A","E01027033","Total",802,216,114,102,586,29,133,101,195,14,36,78
"2011","East Northamptonshire 001B","E01027043","Total",805,179,86,93,626,28,173,110,164,21,38,92
"2011","East Northamptonshire 001C","E01027050","Total",791,181,93,88,610,20,161,134,165,23,38,69
"2011","East Northamptonshire 002A","E01027031","Total",832,169,78,91,663,17,149,136,194,27,51,89
"2011","East Northamptonshire 002B","E01027044","Total",839,182,104,78,657,17,168,130,195,24,35,88
"2011","East Northamptonshire 002C","E01027046","Total",513,114,48,66,399,21,75,98,95,14,33,63
"2011","East Northamptonshire 002D","E01027047","Total",561,145,76,69,416,11,104,71,122,10,25,73
"2011","East Northamptonshire 002E","E01027048","Total",614,205,84,121,409,35,106,67,109,14,23,55
"2011","East Northamptonshire 002F","E01027049","Total",439,174,97,77,265,8,76,53,65,8,18,37
"2011","East Northamptonshire 003A","E01027032","Total",779,185,90,95,594,22,136,105,194,21,39,77
"2011","East Northamptonshire 003B","E01027045","Total",819,202,106,96,617,25,154,103,187,23,32,93
"2011","East Northamptonshire 003C","E01027075","Total",804,161,48,113,643,40,100,186,161,30,52,74
"2011","East Northamptonshire 003D","E01027076","Total",926,266,121,145,660,36,128,146,199,26,45,80
"2011","East Northamptonshire 003E","E01027077","Total",736,128,45,83,608,28,65,156,184,28,55,92
"2011","East Northamptonshire 004A","E01027057","Total",718,169,60,109,549,19,124,108,171,16,36,75
"2011","East Northamptonshire 004B","E01027074","Total",858,160,79,81,698,28,145,135,198,17,53,122
"2011","East Northamptonshire 004C","E01027078","Total",888,216,110,106,672,33,159,108,203,23,46,100
"2011","East Northamptonshire 005A","E01027051","Total",750,224,99,125,526,31,72,108,176,23,35,81
"2011","East Northamptonshire 005B","E01027052","Total",576,128,47,81,448,21,82,96,131,19,28,71
"2011","East Northamptonshire 005C","E01027053","Total",624,144,64,80,480,16,95,71,160,22,34,82
"2011","East Northamptonshire 005D","E01027054","Total",515,125,67,58,390,8,99,54,113,14,24,78
"2011","East Northamptonshire 005E","E01027055","Total",465,102,42,60,363,20,83,71,91,14,24,60
"2011","East Northamptonshire 005F","E01027056","Total",625,166,74,92,459,37,80,94,111,24,34,79
"2011","East Northamptonshire 006A","E01027038","Total",675,172,59,113,503,46,104,89,140,20,31,73
"2011","East Northamptonshire 006B","E01027039","Total",737,241,75,166,496,42,89,116,125,17,40,67
"2011","East Northamptonshire 006C","E01027040","Total",707,193,62,131,514,19,98,115,171,18,29,64
"2011","East Northamptonshire 006D","E01027041","Total",728,259,106,153,469,47,88,84,138,25,24,63
"2011","East Northamptonshire 006E","E01027042","Total",721,114,33,81,607,42,61,152,212,16,39,85
"2011","East Northamptonshire 007A","E01027034","Total",739,282,159,123,457,22,91,85,137,19,30,73
"2011","East Northamptonshire 007B","E01027035","Total",588,153,74,79,435,36,87,67,134,23,24,64
"2011","East Northamptonshire 007D","E01027037","Total",836,152,60,92,684,28,109,181,189,37,50,90
"2011","East Northamptonshire 007E","E01033244","Total",925,170,71,99,755,33,100,220,221,25,48,108
"2011","East Northamptonshire 007F","E01033245","Total",423,103,39,64,320,18,47,71,112,10,19,43
"2011","East Northamptonshire 008A","E01027061","Total",757,213,82,131,544,48,84,127,149,25,27,84
"2011","East Northamptonshire 008B","E01027062","Total",929,264,111,153,665,58,97,138,206,34,38,94
"2011","East Northamptonshire 008C","E01027063","Total",730,142,60,82,588,24,103,115,195,19,35,97
"2011","East Northamptonshire 008D","E01027064","Total",641,116,53,63,525,15,150,89,154,17,27,73
"2011","East Northamptonshire 008E","E01027072","Total",608,115,53,62,493,65,85,97,91,40,41,74
"2011","East Northamptonshire 008F","E01027073","Total",889,265,127,138,624,43,118,124,185,29,36,89
"2011","East Northamptonshire 009A","E01027058","Total",622,167,78,89,455,49,98,69,121,21,31,66
"2011","East Northamptonshire 009B","E01027059","Total",750,249,89,160,501,46,78,109,151,28,25,64
"2011","East Northamptonshire 009C","E01027060","Total",845,348,134,214,497,55,78,97,173,16,26,52
"2011","East Northamptonshire 009D","E01027065","Total",847,350,104,246,497,50,65,92,184,21,33,52
"2011","East Northamptonshire 009E","E01027069","Total",805,354,139,215,451,30,90,74,175,10,12,60
"2011","East Northamptonshire 010A","E01027066","Total",808,135,70,65,673,19,131,164,173,36,54,96
"2011","East Northamptonshire 010B","E01027067","Total",675,151,94,57,524,12,191,81,118,16,26,80
"2011","East Northamptonshire 010C","E01027068","Total",1118,194,53,141,924,39,112,242,300,38,71,122
"2011","East Northamptonshire 010D","E01027070","Total",682,159,71,88,523,19,108,107,165,17,34,73
"2011","East Northamptonshire 010E","E01027071","Total",598,132,63,69,466,17,95,83,128,16,42,85
"2011","Kettering 001A","E01027090","Total",615,166,65,101,449,12,113,79,139,12,27,67
"2011","Kettering 001B","E01027103","Total",682,147,78,69,535,30,130,91,156,20,27,81
"2011","Kettering 001C","E01027129","Total",949,247,127,120,702,19,177,117,227,24,31,107
"2011","Kettering 002B","E01027094","Total",649,181,112,69,468,13,130,79,137,13,32,64
"2011","Kettering 002C","E01027095","Total",576,137,57,80,439,23,76,98,129,18,38,57
"2011","Kettering 002D","E01027107","Total",565,152,64,88,413,38,80,72,133,10,12,68
"2011","Kettering 002E","E01027108","Total",526,85,48,37,441,4,144,59,110,15,20,89
"2011","Kettering 002F","E01027109","Total",505,114,39,75,391,21,87,78,96,17,27,65
"2011","Kettering 002G","E01032969","Total",490,92,6,86,398,32,16,145,137,21,20,27
"2011","Kettering 002H","E01032970","Total",571,134,45,89,437,40,54,111,116,28,32,56
"2011","Kettering 002I","E01032971","Total",508,202,59,143,306,32,36,82,111,12,10,23
"2011","Kettering 003A","E01027123","Total",662,168,96,72,494,28,127,76,117,25,37,84
"2011","Kettering 003B","E01027124","Total",1003,375,119,256,628,59,109,116,187,30,44,83
"2011","Kettering 003C","E01027125","Total",709,128,67,61,581,18,116,122,164,20,33,108
"2011","Kettering 003D","E01027126","Total",992,367,141,226,625,69,113,106,197,28,31,81
"2011","Kettering 004A","E01027079","Total",739,214,81,133,525,53,82,105,143,20,35,87
"2011","Kettering 004B","E01027080","Total",752,159,74,85,593,23,123,128,149,17,45,108
"2011","Kettering 004C","E01027087","Total",495,125,43,82,370,20,71,83,103,13,24,56
"2011","Kettering 004D","E01027088","Total",482,85,32,53,397,21,50,101,99,20,31,75
"2011","Kettering 004E","E01027089","Total",809,170,84,86,639,40,114,160,183,28,36,78
"2011","Kettering 005A","E01027081","Total",613,199,82,117,414,43,51,81,116,34,36,53
"2011","Kettering 005B","E01027082","Total",703,234,51,183,469,70,40,84,156,19,41,59
"2011","Kettering 005C","E01027083","Total",648,235,71,164,413,75,61,91,101,15,21,49
"2011","Kettering 005D","E01027127","Total",780,234,103,131,546,64,91,87,139,26,60,79
"2011","Kettering 005E","E01027128","Total",676,165,74,91,511,75,80,83,113,33,37,90
"2011","Kettering 006A","E01027105","Total",918,336,62,274,582,49,37,128,218,27,43,80
"2011","Kettering 006B","E01027106","Total",876,324,56,268,552,63,41,135,187,21,34,71
"2011","Kettering 006C","E01027111","Total",916,319,58,261,597,78,44,126,217,14,30,88
"2011","Kettering 006D","E01027112","Total",935,304,75,229,631,83,59,135,207,18,41,88
"2011","Kettering 007A","E01027104","Total",1096,444,152,292,652,64,88,138,218,25,37,82
"2011","Kettering 007B","E01027110","Total",1110,712,287,425,398,35,79,69,157,9,11,38
"2011","Kettering 007C","E01027113","Total",963,396,183,213,567,36,119,107,156,19,46,84
"2011","Kettering 007D","E01027115","Total",485,112,78,34,373,10,112,81,84,14,20,52
"2011","Kettering 007E","E01027116","Total",817,148,27,121,669,51,52,217,192,28,39,90
"2011","Kettering 007F","E01027117","Total",610,189,80,109,421,14,109,81,137,6,19,55
"2011","Kettering 008A","E01027096","Total",453,92,48,44,361,17,83,72,81,18,33,57
"2011","Kettering 008B","E01027097","Total",592,146,50,96,446,20,114,81,127,9,28,67
"2011","Kettering 008C","E01027098","Total",482,113,47,66,369,21,50,91,101,17,28,61
"2011","Kettering 008D","E01027099","Total",670,202,124,78,468,18,147,74,129,19,20,61
"2011","Kettering 008E","E01027122","Total",503,125,77,48,378,14,98,70,98,12,22,64
"2011","Kettering 009A","E01027100","Total",683,195,103,92,488,25,106,103,131,16,34,73
"2011","Kettering 009B","E01027114","Total",680,186,81,105,494,27,81,102,156,22,29,77
"2011","Kettering 009C","E01027130","Total",788,227,115,112,561,39,113,114,145,25,22,103
"2011","Kettering 009D","E01027131","Total",994,467,130,337,527,66,54,108,196,21,25,57
"2011","Kettering 010A","E01027084","Total",642,162,113,49,480,20,179,77,103,12,29,60
"2011","Kettering 010B","E01027085","Total",517,118,64,54,399,22,112,74,89,12,30,60
"2011","Kettering 010C","E01027086","Total",684,146,74,72,538,23,139,112,127,20,41,76
"2011","Kettering 010D","E01027120","Total",521,122,25,97,399,22,34,106,118,14,33,72
"2011","Kettering 010E","E01027121","Total",533,59,35,24,474,14,110,87,116,19,37,91
"2011","Kettering 011A","E01027091","Total",762,206,82,124,556,47,97,125,135,22,41,89
"2011","Kettering 011B","E01027092","Total",619,153,70,83,466,17,101,79,141,24,30,74
"2011","Kettering 011C","E01027101","Total",1017,293,128,165,724,54,101,181,216,34,43,95
"2011","Kettering 011D","E01027102","Total",679,159,82,77,520,32,111,120,124,17,34,82
"2011","Kettering 011F","E01027119","Total",748,215,126,89,533,31,127,103,153,15,30,74
"2011","Kettering 011G","E01032972","Total",578,109,55,54,469,17,90,83,151,18,24,86
"2011","Kettering 011H","E01032973","Total",596,90,10,80,506,30,22,206,149,37,26,36
"2011","Kettering 011I","E01032974","Total",535,119,40,79,416,28,62,105,138,14,18,51
"2011","Northampton 001A","E01027145","Total",567,122,67,55,445,19,107,57,126,13,42,81
"2011","Northampton 001B","E01027148","Total",572,116,49,67,456,20,72,97,127,19,24,97
"2011","Northampton 001C","E01027149","Total",612,168,65,103,444,22,81,65,145,12,29,90
"2011","Northampton 001D","E01027232","Total",622,187,78,109,435,48,69,65,112,9,40,92
"2011","Northampton 002A","E01027218","Total",701,185,104,81,516,16,167,60,146,15,28,84
"2011","Northampton 002B","E01027219","Total",798,253,177,76,545,14,201,61,139,12,33,85
"2011","Northampton 002C","E01027221","Total",748,210,107,103,538,27,122,97,134,19,34,105
"2011","Northampton 002D","E01027222","Total",497,89,29,60,408,14,65,80,122,5,27,95
"2011","Northampton 003A","E01027143","Total",530,131,62,69,399,22,103,68,103,12,21,70
"2011","Northampton 003B","E01027144","Total",635,137,76,61,498,10,126,72,144,7,34,105
"2011","Northampton 003C","E01027146","Total",635,155,83,72,480,28,129,94,107,11,29,82
"2011","Northampton 003D","E01027147","Total",809,337,180,157,472,48,97,76,150,15,26,60
"2011","Northampton 004A","E01027195","Total",607,213,33,180,394,59,31,68,76,29,52,79
"2011","Northampton 004B","E01027245","Total",667,197,32,165,470,61,50,109,134,19,31,66
"2011","Northampton 004C","E01027247","Total",619,154,31,123,465,52,42,90,130,33,45,73
"2011","Northampton 004D","E01027248","Total",586,148,41,107,438,89,34,72,94,31,38,80
"2011","Northampton 004E","E01027249","Total",683,179,35,144,504,103,42,83,100,43,46,87
"2011","Northampton 005A","E01027174","Total",515,93,36,57,422,15,77,72,134,10,43,71
"2011","Northampton 005B","E01027175","Total",599,149,27,122,450,66,28,91,124,27,35,79
"2011","Northampton 005C","E01027178","Total",781,195,49,146,586,124,37,119,148,35,45,78
"2011","Northampton 005D","E01027200","Total",577,165,48,117,412,72,42,97,90,23,38,50
"2011","Northampton 005E","E01027246","Total",756,241,42,199,515,106,27,115,126,27,46,68
"2011","Northampton 006A","E01027171","Total",683,266,118,148,417,29,92,69,112,17,32,66
"2011","Northampton 006B","E01027172","Total",658,206,123,83,452,27,101,86,109,14,37,78
"2011","Northampton 006C","E01027182","Total",606,165,105,60,441,15,104,61,127,16,43,75
"2011","Northampton 006D","E01027183","Total",613,171,105,66,442,5,158,42,105,9,27,96
"2011","Northampton 007A","E01027196","Total",527,85,32,53,442,43,67,65,93,28,58,88
"2011","Northampton 007B","E01027197","Total",605,212,76,136,393,36,57,72,104,17,44,63
"2011","Northampton 007C","E01027198","Total",650,231,40,191,419,75,30,94,91,21,41,67
"2011","Northampton 007D","E01027199","Total",504,124,48,76,380,92,23,62,73,41,33,56
"2011","Northampton 008A","E01027190","Total",778,329,170,159,449,20,118,63,135,19,9,85
"2011","Northampton 008B","E01027191","Total",761,251,55,196,510,57,51,89,168,24,31,90
"2011","Northampton 008C","E01027193","Total",619,158,64,94,461,21,93,86,148,9,25,79
"2011","Northampton 008D","E01027194","Total",626,194,114,80,432,8,145,66,114,11,23,65
"2011","Northampton 009A","E01027192","Total",538,132,34,98,406,33,41,76,117,19,35,85
"2011","Northampton 009B","E01027229","Total",613,178,66,112,435,58,55,85,88,21,38,90
"2011","Northampton 009C","E01027230","Total",618,154,51,103,464,99,36,95,113,24,22,75
"2011","Northampton 009D","E01027231","Total",800,320,109,211,480,64,53,98,119,17,34,95
"2011","Northampton 010A","E01027179","Total",770,238,104,134,532,48,88,92,127,30,53,94
"2011","Northampton 010B","E01027180","Total",707,256,161,95,451,32,108,77,111,18,26,79
"2011","Northampton 010C","E01027181","Total",770,282,207,75,488,10,164,82,125,12,27,68
"2011","Northampton 011A","E01027140","Total",461,131,46,85,330,51,29,56,79,26,46,43
"2011","Northampton 011B","E01027142","Total",601,203,81,122,398,29,83,74,124,19,33,36
"2011","Northampton 011C","E01027176","Total",602,152,53,99,450,27,62,89,145,13,34,80
"2011","Northampton 011D","E01027177","Total",630,200,55,145,430,85,49,77,101,39,27,52
"2011","Northampton 012A","E01027168","Total",728,294,93,201,434,74,45,90,91,30,38,66
"2011","Northampton 012B","E01027169","Total",585,127,49,78,458,29,64,100,101,35,43,86
"2011","Northampton 012C","E01027170","Total",621,181,63,118,440,92,44,98,86,19,38,63
"2011","Northampton 012D","E01027173","Total",600,136,51,85,464,63,60,88,91,25,47,90
"2011","Northampton 013A","E01027136","Total",776,321,83,238,455,26,36,100,160,21,26,86
"2011","Northampton 013B","E01027186","Total",668,153,47,106,515,22,78,112,130,25,46,102
"2011","Northampton 013C","E01027188","Total",732,202,81,121,530,74,67,98,113,28,54,96
"2011","Northampton 013D","E01027220","Total",596,190,121,69,406,7,148,52,95,11,21,72
"2011","Northampton 014A","E01027208","Total",602,144,64,80,458,29,78,106,134,15,31,65
"2011","Northampton 014B","E01027209","Total",551,179,40,139,372,35,39,88,140,10,20,40
"2011","Northampton 014C","E01027211","Total",629,162,89,73,467,19,135,59,156,9,19,70
"2011","Northampton 014D","E01027212","Total",566,124,18,106,442,22,42,102,159,11,38,68
"2011","Northampton 015A","E01027184","Total",625,217,82,135,408,35,34,90,158,6,20,65
"2011","Northampton 015B","E01027185","Total",595,245,82,163,350,31,54,67,99,18,23,58
"2011","Northampton 015C","E01027187","Total",539,180,53,127,359,18,46,42,126,10,37,80
"2011","Northampton 015D","E01027189","Total",734,260,89,171,474,36,67,83,162,16,27,83
"2011","Northampton 016A","E01027137","Total",631,219,73,146,412,68,47,68,144,18,29,38
"2011","Northampton 016B","E01027138","Total",635,161,63,98,474,23,88,81,175,19,32,56
"2011","Northampton 016C","E01027139","Total",616,180,28,152,436,40,31,94,147,20,33,71
"2011","Northampton 016D","E01027141","Total",540,84,32,52,456,23,81,81,109,11,44,107
"2011","Northampton 016E","E01027259","Total",581,87,35,52,494,16,82,93,144,14,45,100
"2011","Northampton 017A","E01027239","Total",666,248,100,148,418,75,43,69,80,40,62,49
"2011","Northampton 017B","E01027241","Total",711,225,57,168,486,58,39,100,135,35,43,76
"2011","Northampton 017C","E01027242","Total",595,142,71,71,453,70,51,66,111,25,55,75
"2011","Northampton 017D","E01027243","Total",674,229,86,143,445,75,67,78,103,30,33,59
"2011","Northampton 017E","E01027244","Total",684,253,41,212,431,121,35,94,80,30,38,33
"2011","Northampton 018A","E01027213","Total",642,207,71,136,435,33,80,83,104,21,36,78
"2011","Northampton 018B","E01027214","Total",746,307,116,191,439,45,95,62,136,17,31,53
"2011","Northampton 018C","E01027216","Total",776,278,132,146,498,13,139,68,153,4,26,95
"2011","Northampton 018D","E01027240","Total",512,150,59,91,362,54,63,56,73,25,35,56
"2011","Northampton 019A","E01027207","Total",605,153,96,57,452,11,161,65,97,16,20,82
"2011","Northampton 019B","E01027210","Total",451,97,57,40,354,18,82,67,75,13,32,67
"2011","Northampton 019C","E01027215","Total",601,136,83,53,465,24,100,85,132,14,33,77
"2011","Northampton 019D","E01027217","Total",941,278,172,106,663,38,178,120,187,15,31,94
"2011","Northampton 020A","E01027255","Total",540,100,55,45,440,14,130,75,97,12,29,83
"2011","Northampton 020B","E01027256","Total",630,184,114,70,446,13,124,69,123,17,38,62
"2011","Northampton 020C","E01027258","Total",497,65,13,52,432,14,49,118,101,20,48,82
"2011","Northampton 020D","E01027260","Total",584,127,68,59,457,13,140,60,105,13,33,93
"2011","Northampton 021B","E01027152","Total",742,253,50,203,489,59,29,89,166,20,19,107
"2011","Northampton 021C","E01027153","Total",994,575,124,451,419,53,34,62,175,8,27,60
"2011","Northampton 021D","E01027154","Total",778,260,52,208,518,68,38,103,173,21,28,87
"2011","Northampton 021E","E01032978","Total",799,451,68,383,348,51,16,56,164,15,11,35
"2011","Northampton 021F","E01032979","Total",743,414,32,382,329,73,13,63,130,12,10,28
"2011","Northampton 022A","E01027132","Total",937,358,62,296,579,45,33,98,256,11,43,93
"2011","Northampton 022B","E01027133","Total",759,240,70,170,519,46,56,106,184,16,17,94
"2011","Northampton 022C","E01027134","Total",690,200,44,156,490,31,49,93,148,14,52,103
"2011","Northampton 022D","E01027135","Total",716,190,83,107,526,27,69,127,152,18,35,98
"2011","Northampton 023A","E01027155","Total",980,373,75,298,607,65,21,98,237,17,51,118
"2011","Northampton 023B","E01027225","Total",724,276,29,247,448,41,21,70,172,11,36,97
"2011","Northampton 023C","E01027227","Total",659,213,34,179,446,57,23,72,158,20,34,82
"2011","Northampton 023D","E01027228","Total",929,390,73,317,539,48,25,78,246,9,39,94
"2011","Northampton 024A","E01027151","Total",728,279,58,221,449,48,33,86,152,9,42,79
"2011","Northampton 024B","E01027236","Total",679,251,137,114,428,10,110,75,126,12,28,67
"2011","Northampton 024C","E01027237","Total",882,274,88,186,608,50,80,125,219,18,31,85
"2011","Northampton 024D","E01027238","Total",960,410,114,296,550,67,58,109,193,15,30,78
"2011","Northampton 025A","E01027223","Total",1107,574,73,501,533,46,35,69,277,8,15,83
"2011","Northampton 025B","E01027224","Total",904,439,78,361,465,47,46,81,187,17,20,67
"2011","Northampton 025C","E01027226","Total",853,375,82,293,478,52,44,73,182,7,34,86
"2011","Northampton 025D","E01027257","Total",477,118,83,35,359,10,118,68,91,11,19,42
"2011","Northampton 026A","E01027233","Total",483,89,8,81,394,85,15,83,106,29,27,49
"2011","Northampton 026B","E01027234","Total",588,150,58,92,438,36,47,110,168,20,17,40
"2011","Northampton 026C","E01027235","Total",629,228,79,149,401,89,42,71,100,18,41,40
"2011","Northampton 026D","E01027252","Total",640,174,52,122,466,76,49,107,133,21,29,51
"2011","Northampton 027A","E01027156","Total",504,141,46,95,363,53,38,63,102,18,39,50
"2011","Northampton 027B","E01027159","Total",511,105,55,50,406,17,90,74,104,15,30,76
"2011","Northampton 027C","E01027160","Total",705,161,34,127,544,24,46,158,163,25,49,79
"2011","Northampton 027D","E01027161","Total",669,232,117,115,437,70,62,81,98,18,38,70
"2011","Northampton 028B","E01027158","Total",646,186,75,111,460,54,55,91,159,9,26,66
"2011","Northampton 028C","E01027201","Total",880,235,91,144,645,53,121,175,173,21,27,75
"2011","Northampton 028D","E01027202","Total",674,171,93,78,503,27,132,92,127,18,23,84
"2011","Northampton 028E","E01032980","Total",732,282,20,262,450,66,6,77,234,5,15,47
"2011","Northampton 028F","E01032981","Total",669,201,26,175,468,61,35,92,170,11,21,78
"2011","Northampton 029A","E01027250","Total",595,154,44,110,441,16,85,80,147,16,24,73
"2011","Northampton 029C","E01027253","Total",730,127,36,91,603,48,109,114,181,17,48,86
"2011","Northampton 029D","E01027254","Total",652,109,33,76,543,24,73,151,142,19,43,91
"2011","Northampton 029E","E01032975","Total",651,122,11,111,529,35,19,186,185,15,35,54
"2011","Northampton 029F","E01032976","Total",651,296,171,125,355,46,68,83,121,7,10,20
"2011","Northampton 029G","E01032977","Total",707,195,6,189,512,87,14,145,162,31,28,45
"2011","Northampton 030A","E01027162","Total",689,221,31,190,468,42,41,116,165,14,30,60
"2011","Northampton 030B","E01027163","Total",566,126,65,61,440,12,90,89,130,19,35,65
"2011","Northampton 030C","E01027164","Total",622,162,13,149,460,45,19,131,158,9,34,64
"2011","Northampton 030D","E01027165","Total",491,63,16,47,428,29,38,114,134,16,27,70
"2011","Northampton 030E","E01027166","Total",625,115,11,104,510,37,37,143,169,17,38,69
"2011","Northampton 030F","E01027167","Total",572,142,61,81,430,20,68,101,120,19,28,74
"2011","Northampton 031A","E01027203","Total",557,76,8,68,481,42,29,169,111,19,53,58
"2011","Northampton 031B","E01027204","Total",642,138,64,74,504,43,73,122,113,24,43,86
"2011","Northampton 031C","E01027205","Total",723,89,18,71,634,45,25,254,130,51,69,60
"2011","Northampton 031D","E01027206","Total",1027,158,65,93,869,36,127,284,184,39,85,114
"2011","South Northamptonshire 001A","E01027282","Total",653,143,77,66,510,29,92,83,150,18,51,87
"2011","South Northamptonshire 001B","E01027283","Total",611,111,69,42,500,10,106,103,147,15,41,78
"2011","South Northamptonshire 001C","E01027285","Total",689,144,80,64,545,27,134,81,144,22,46,91
"2011","South Northamptonshire 001D","E01027286","Total",654,161,103,58,493,20,139,86,116,18,29,85
"2011","South Northamptonshire 001E","E01027287","Total",679,152,95,57,527,23,161,87,136,22,32,66
"2011","South Northamptonshire 002A","E01027273","Total",763,186,95,91,577,37,169,98,161,17,37,58
"2011","South Northamptonshire 002B","E01027274","Total",623,117,61,56,506,28,96,100,146,16,37,83
"2011","South Northamptonshire 002C","E01027275","Total",600,139,71,68,461,18,144,74,101,18,30,76
"2011","South Northamptonshire 002D","E01027308","Total",687,175,88,87,512,23,113,90,170,19,26,71
"2011","South Northamptonshire 003A","E01027263","Total",796,210,111,99,586,21,177,93,163,13,32,87
"2011","South Northamptonshire 003C","E01027279","Total",743,225,131,94,518,20,141,76,144,18,29,90
"2011","South Northamptonshire 003D","E01027284","Total",756,144,66,78,612,17,103,119,191,19,43,120
"2011","South Northamptonshire 003E","E01027294","Total",744,155,56,99,589,34,107,113,171,27,38,99
"2011","South Northamptonshire 003F","E01032982","Total",500,155,39,116,345,32,26,99,97,17,30,44
"2011","South Northamptonshire 003G","E01032983","Total",523,83,10,73,440,28,18,183,112,31,35,33
"2011","South Northamptonshire 003H","E01032984","Total",539,84,5,79,455,19,14,196,114,34,32,46
"2011","South Northamptonshire 003I","E01032985","Total",611,125,65,60,486,13,123,99,128,15,34,74
"2011","South Northamptonshire 004A","E01027262","Total",675,160,63,97,515,9,114,105,165,13,27,82
"2011","South Northamptonshire 004B","E01027277","Total",760,163,61,102,597,31,124,124,197,14,33,74
"2011","South Northamptonshire 004C","E01027289","Total",714,173,92,81,541,17,138,97,163,17,26,83
"2011","South Northamptonshire 004D","E01027300","Total",523,80,33,47,443,16,54,88,135,17,36,97
"2011","South Northamptonshire 004E","E01027303","Total",639,203,68,135,436,15,69,90,140,16,31,75
"2011","South Northamptonshire 005A","E01027297","Total",695,146,84,62,549,13,134,108,156,19,27,92
"2011","South Northamptonshire 005B","E01027298","Total",516,95,48,47,421,11,69,90,129,10,33,79
"2011","South Northamptonshire 005C","E01027299","Total",616,172,65,107,444,22,82,94,128,9,31,78
"2011","South Northamptonshire 005D","E01027301","Total",909,272,77,195,637,41,70,188,206,20,47,65
"2011","South Northamptonshire 005E","E01027302","Total",672,265,140,125,407,41,61,85,112,18,24,66
"2011","South Northamptonshire 006A","E01027291","Total",590,138,93,45,452,12,117,85,107,20,36,75
"2011","South Northamptonshire 006B","E01027292","Total",466,117,78,39,349,15,79,64,75,14,32,70
"2011","South Northamptonshire 006C","E01027293","Total",483,98,56,42,385,13,77,82,104,9,24,76
"2011","South Northamptonshire 006D","E01027304","Total",729,167,78,89,562,18,129,113,164,25,35,78
"2011","South Northamptonshire 006E","E01027305","Total",769,188,97,91,581,21,126,96,187,24,29,98
"2011","South Northamptonshire 007A","E01027261","Total",776,168,80,88,608,17,112,147,148,18,53,113
"2011","South Northamptonshire 007B","E01027295","Total",858,174,66,108,684,31,131,152,197,21,44,108
"2011","South Northamptonshire 007C","E01027306","Total",722,189,75,114,533,20,120,98,157,20,34,84
"2011","South Northamptonshire 008A","E01027276","Total",1040,255,104,151,785,41,167,173,212,30,51,111
"2011","South Northamptonshire 008B","E01027280","Total",897,142,39,103,755,27,96,202,216,36,54,124
"2011","South Northamptonshire 008C","E01027281","Total",684,165,84,81,519,28,102,102,132,27,42,86
"2011","South Northamptonshire 008D","E01027307","Total",832,165,95,70,667,22,171,118,182,17,36,121
"2011","South Northamptonshire 009A","E01027265","Total",669,200,122,78,469,27,107,99,136,10,22,68
"2011","South Northamptonshire 009B","E01027266","Total",482,66,42,24,416,9,88,83,99,23,36,78
"2011","South Northamptonshire 009C","E01027270","Total",581,82,16,66,499,20,39,184,124,24,42,66
"2011","South Northamptonshire 009D","E01027271","Total",628,153,42,111,475,26,47,158,146,17,33,48
"2011","South Northamptonshire 009E","E01027272","Total",591,100,31,69,491,23,48,114,164,28,43,71
"2011","South Northamptonshire 010A","E01027264","Total",648,193,73,120,455,22,100,69,154,14,21,75
"2011","South Northamptonshire 010B","E01027267","Total",509,191,98,93,318,23,37,73,104,13,27,41
"2011","South Northamptonshire 010C","E01027268","Total",517,115,38,77,402,17,64,90,127,12,26,66
"2011","South Northamptonshire 010D","E01027269","Total",689,276,103,173,413,32,79,69,121,25,24,63
"2011","South Northamptonshire 011A","E01027288","Total",904,253,132,121,651,38,128,110,187,29,45,114
"2011","South Northamptonshire 011B","E01027290","Total",918,216,100,116,702,17,173,161,217,20,37,77
"2011","South Northamptonshire 011C","E01027296","Total",845,215,96,119,630,20,140,114,191,28,37,100
"2011","Wellingborough 001A","E01027326","Total",710,237,101,136,473,32,137,76,142,9,27,50
"2011","Wellingborough 001B","E01027327","Total",695,268,91,177,427,24,81,69,131,14,27,81
"2011","Wellingborough 001C","E01027328","Total",582,167,73,94,415,35,82,76,121,21,25,55
"2011","Wellingborough 001D","E01027338","Total",994,255,133,122,739,25,198,113,222,21,44,116
"2011","Wellingborough 002A","E01027330","Total",633,142,42,100,491,74,53,96,120,23,54,71
"2011","Wellingborough 002B","E01027331","Total",623,234,96,138,389,58,74,71,88,21,30,47
"2011","Wellingborough 002C","E01027332","Total",649,165,104,61,484,13,166,63,127,17,35,63
"2011","Wellingborough 002D","E01027333","Total",840,127,28,99,713,32,99,182,179,28,79,114
"2011","Wellingborough 002E","E01027334","Total",531,146,21,125,385,114,16,84,79,24,23,45
"2011","Wellingborough 003A","E01027343","Total",621,165,66,99,456,24,92,95,122,9,33,81
"2011","Wellingborough 003B","E01027344","Total",628,199,100,99,429,20,106,69,121,7,26,80
"2011","Wellingborough 003C","E01027345","Total",489,63,25,38,426,15,66,90,114,16,42,83
"2011","Wellingborough 003D","E01027346","Total",577,123,24,99,454,30,44,117,135,16,34,78
"2011","Wellingborough 003E","E01027347","Total",744,135,55,80,609,21,107,119,170,21,62,109
"2011","Wellingborough 004A","E01027313","Total",639,186,63,123,453,35,51,84,103,17,53,110
"2011","Wellingborough 004B","E01027314","Total",897,360,90,270,537,41,67,102,188,16,33,90
"2011","Wellingborough 004C","E01027315","Total",1062,404,93,311,658,85,67,137,230,8,41,90
"2011","Wellingborough 004D","E01027316","Total",650,210,74,136,440,44,58,82,134,15,39,68
"2011","Wellingborough 005A","E01027339","Total",555,169,66,103,386,80,52,67,69,18,39,61
"2011","Wellingborough 005B","E01027340","Total",658,214,103,111,444,56,115,61,94,24,22,72
"2011","Wellingborough 005C","E01027341","Total",593,158,52,106,435,58,61,91,90,32,45,58
"2011","Wellingborough 005D","E01027342","Total",652,255,85,170,397,70,41,91,105,21,17,52
"2011","Wellingborough 006A","E01027349","Total",860,470,115,355,390,36,53,66,146,9,25,55
"2011","Wellingborough 006B","E01027350","Total",672,243,112,131,429,30,102,59,126,7,30,75
"2011","Wellingborough 006C","E01027351","Total",794,349,169,180,445,67,96,68,110,16,16,72
"2011","Wellingborough 006D","E01027352","Total",638,253,102,151,385,27,64,75,105,19,28,67
"2011","Wellingborough 007A","E01027309","Total",651,162,98,64,489,17,152,80,125,9,24,82
"2011","Wellingborough 007B","E01027310","Total",607,204,42,162,403,85,33,90,76,30,35,54
"2011","Wellingborough 007C","E01027311","Total",483,102,38,64,381,16,69,74,91,13,46,72
"2011","Wellingborough 007D","E01027312","Total",627,188,89,99,439,42,95,95,112,17,18,60
"2011","Wellingborough 008A","E01027317","Total",644,211,104,107,433,49,85,89,92,14,41,63
"2011","Wellingborough 008B","E01027318","Total",591,156,46,110,435,107,44,102,80,30,26,46
"2011","Wellingborough 008C","E01027319","Total",605,172,59,113,433,51,59,90,91,25,45,72
"2011","Wellingborough 008D","E01027320","Total",744,193,63,130,551,47,89,133,132,30,44,76
"2011","Wellingborough 008E","E01027321","Total",580,96,20,76,484,30,57,136,135,20,40,66
"2011","Wellingborough 009A","E01027322","Total",511,154,58,96,357,20,51,73,119,8,28,58
"2011","Wellingborough 009B","E01027323","Total",610,175,90,85,435,38,79,98,104,17,31,68
"2011","Wellingborough 009C","E01027324","Total",503,97,66,31,406,11,121,68,119,11,12,64
"2011","Wellingborough 009D","E01027325","Total",673,191,66,125,482,37,94,94,141,26,28,62
"2011","Wellingborough 009E","E01027329","Total",791,222,136,86,569,21,173,83,165,13,31,83
"2011","Wellingborough 009F","E01027353","Total",772,212,111,101,560,20,154,92,170,11,24,89
"2011","Wellingborough 010A","E01027335","Total",632,147,81,66,485,22,128,71,135,12,28,89
"2011","Wellingborough 010B","E01027336","Total",652,239,134,105,413,39,77,71,122,15,20,69
"2011","Wellingborough 010C","E01027337","Total",793,231,90,141,562,35,125,126,153,17,29,77
"2011","Wellingborough 010D","E01027348","Total",890,220,94,126,670,29,153,125,235,21,37,70
"2011","Wellingborough 010E","E01027354","Total",1053,317,132,185,736,57,121,158,239,26,41,94
"2011","Wellingborough 010F","E01027355","Total",659,116,56,60,543,14,132,112,146,30,23,86
"2011","Ashfield 001A","E01027979","Total",699,193,97,96,506,17,159,59,146,9,35,81
"2011","Ashfield 001B","E01027980","Total",649,199,95,104,450,61,66,86,113,22,42,60
"2011","Ashfield 001C","E01027981","Total",678,164,85,79,514,23,144,76,150,10,29,82
"2011","Ashfield 001D","E01027983","Total",642,201,49,152,441,37,68,79,124,23,37,73
"2011","Ashfield 002A","E01027970","Total",609,162,58,104,447,25,85,90,132,10,32,73
"2011","Ashfield 002B","E01027971","Total",602,115,64,51,487,20,137,61,148,7,26,88
"2011","Ashfield 002C","E01027982","Total",666,225,114,111,441,21,114,69,128,14,22,73
"2011","Ashfield 002D","E01027984","Total",636,163,74,89,473,17,104,99,135,8,31,79
"2011","Ashfield 003A","E01027966","Total",636,262,145,117,374,49,77,52,78,23,39,56
"2011","Ashfield 003B","E01027986","Total",624,225,81,144,399,25,82,68,120,13,26,65
"2011","Ashfield 003C","E01027987","Total",746,194,82,112,552,78,77,109,149,26,45,68
"2011","Ashfield 003D","E01027990","Total",789,193,68,125,596,36,89,138,205,13,27,88
"2011","Ashfield 004A","E01027967","Total",756,252,71,181,504,73,60,119,132,12,33,75
"2011","Ashfield 004B","E01027972","Total",874,173,68,105,701,67,110,149,187,28,54,106
"2011","Ashfield 004C","E01027977","Total",782,217,91,126,565,49,75,111,168,23,36,103
"2011","Ashfield 004D","E01027978","Total",805,279,67,212,526,80,51,121,141,21,31,81
"2011","Ashfield 004E","E01027985","Total",757,199,71,128,558,57,68,124,168,30,33,78
"2011","Ashfield 005A","E01027964","Total",617,171,77,94,446,40,81,77,112,22,45,69
"2011","Ashfield 005B","E01027965","Total",563,171,85,86,392,68,47,64,106,19,36,52
"2011","Ashfield 005C","E01027968","Total",573,240,123,117,333,56,63,59,74,16,14,51
"2011","Ashfield 005D","E01027974","Total",671,219,67,152,452,72,68,50,89,41,56,76
"2011","Ashfield 005E","E01027976","Total",790,337,167,170,453,54,109,70,106,15,28,71
"2011","Ashfield 006A","E01027969","Total",575,150,52,98,425,44,65,84,127,11,26,68
"2011","Ashfield 006B","E01027975","Total",708,190,80,110,518,40,79,112,157,20,24,86
"2011","Ashfield 006C","E01027988","Total",693,171,79,92,522,32,124,104,140,9,29,84
"2011","Ashfield 006D","E01027989","Total",736,197,110,87,539,21,170,78,160,12,24,74
"2011","Ashfield 006E","E01027991","Total",539,163,62,101,376,28,70,66,95,17,28,72
"2011","Ashfield 006F","E01027992","Total",846,138,22,116,708,38,72,196,226,28,43,105
"2011","Ashfield 007A","E01027949","Total",646,154,70,84,492,28,104,87,143,20,30,80
"2011","Ashfield 007B","E01027951","Total",648,179,48,131,469,95,68,78,105,31,39,53
"2011","Ashfield 007C","E01027953","Total",636,136,80,56,500,27,126,71,147,15,33,81
"2011","Ashfield 007D","E01027954","Total",664,169,38,131,495,62,56,119,140,18,31,69
"2011","Ashfield 007E","E01027973","Total",647,121,84,37,526,10,131,127,132,11,34,81
"2011","Ashfield 008A","E01027952","Total",808,292,120,172,516,65,62,110,130,25,30,94
"2011","Ashfield 008B","E01027955","Total",512,123,33,90,389,45,47,72,120,16,27,62
"2011","Ashfield 008C","E01027956","Total",686,247,150,97,439,50,89,76,103,19,30,72
"2011","Ashfield 008D","E01027958","Total",596,180,76,104,416,57,50,87,100,19,33,70
"2011","Ashfield 009A","E01027947","Total",692,172,81,91,520,31,100,102,142,20,42,83
"2011","Ashfield 009B","E01027948","Total",792,216,83,133,576,28,96,119,180,17,37,99
"2011","Ashfield 009C","E01027950","Total",918,276,129,147,642,41,143,110,202,18,34,94
"2011","Ashfield 009D","E01027957","Total",524,134,73,61,390,22,77,81,104,8,24,74
"2011","Ashfield 009E","E01027959","Total",527,83,34,49,444,14,46,105,124,19,49,87
"2011","Ashfield 010A","E01027995","Total",681,158,81,77,523,33,103,78,187,11,25,86
"2011","Ashfield 010B","E01027996","Total",859,236,112,124,623,59,96,121,169,9,50,119
"2011","Ashfield 010C","E01027997","Total",740,190,102,88,550,22,143,69,174,16,25,101
"2011","Ashfield 010D","E01027998","Total",836,244,122,122,592,43,161,86,169,12,36,85
"2011","Ashfield 011A","E01027960","Total",740,238,100,138,502,37,126,86,121,9,33,90
"2011","Ashfield 011B","E01027961","Total",792,183,92,91,609,25,150,91,179,17,44,103
"2011","Ashfield 011C","E01027962","Total",608,136,56,80,472,29,72,98,143,17,26,87
"2011","Ashfield 011D","E01027963","Total",645,146,73,73,499,35,89,96,119,27,54,79
"2011","Ashfield 012A","E01027945","Total",726,201,82,119,525,48,100,95,138,16,35,93
"2011","Ashfield 012B","E01027946","Total",621,157,73,84,464,25,100,69,127,10,22,111
"2011","Ashfield 012C","E01027993","Total",655,161,76,85,494,17,129,90,140,13,32,73
"2011","Ashfield 012D","E01027994","Total",640,196,110,86,444,23,112,75,117,18,30,69
"2011","Ashfield 013A","E01027929","Total",1052,288,94,194,764,71,94,178,271,17,37,96
"2011","Ashfield 013B","E01027931","Total",899,295,99,196,604,75,99,101,196,17,41,75
"2011","Ashfield 013C","E01027934","Total",582,156,57,99,426,31,56,110,128,14,21,66
"2011","Ashfield 013D","E01027935","Total",503,120,44,76,383,20,57,74,115,9,41,67
"2011","Ashfield 013E","E01027936","Total",650,142,94,48,508,14,159,90,147,9,26,63
"2011","Ashfield 014A","E01027927","Total",934,349,151,198,585,62,96,130,168,21,38,70
"2011","Ashfield 014B","E01027928","Total",893,340,88,252,553,54,79,127,178,17,34,64
"2011","Ashfield 014C","E01027932","Total",898,242,63,179,656,80,86,147,189,26,44,84
"2011","Ashfield 014D","E01027933","Total",661,206,80,126,455,42,65,105,139,7,24,73
"2011","Ashfield 014E","E01027937","Total",648,264,105,159,384,49,62,85,106,13,17,52
"2011","Ashfield 015A","E01027925","Total",743,161,93,68,582,37,147,118,120,20,36,104
"2011","Ashfield 015B","E01027938","Total",489,87,27,60,402,17,34,102,118,13,35,83
"2011","Ashfield 015C","E01027940","Total",562,112,50,62,450,19,96,81,143,10,27,74
"2011","Ashfield 015D","E01027943","Total",592,152,75,77,440,32,82,88,130,12,26,70
"2011","Ashfield 015E","E01027944","Total",655,163,92,71,492,30,113,88,136,8,28,89
"2011","Ashfield 016A","E01027926","Total",657,180,91,89,477,26,131,74,134,8,25,79
"2011","Ashfield 016B","E01027930","Total",717,267,83,184,450,63,64,95,116,20,22,70
"2011","Ashfield 016C","E01027939","Total",601,179,98,81,422,59,63,68,92,19,36,85
"2011","Ashfield 016D","E01027941","Total",571,173,69,104,398,28,78,54,121,15,29,73
"2011","Ashfield 016E","E01027942","Total",524,111,47,64,413,55,70,70,98,22,25,73
"2011","Bassetlaw 001A","E01028000","Total",951,253,146,107,698,19,181,122,212,14,39,111
"2011","Bassetlaw 001B","E01028024","Total",775,203,98,105,572,36,123,110,157,12,44,90
"2011","Bassetlaw 001C","E01028025","Total",633,183,72,111,450,48,60,73,142,18,43,66
"2011","Bassetlaw 001D","E01028026","Total",661,200,116,84,461,46,99,83,109,22,38,64
"2011","Bassetlaw 001E","E01028027","Total",592,147,61,86,445,32,81,81,125,16,38,72
"2011","Bassetlaw 001F","E01028028","Total",677,188,107,81,489,38,105,101,135,20,35,55
"2011","Bassetlaw 002A","E01027999","Total",994,255,134,121,739,17,217,129,212,28,30,106
"2011","Bassetlaw 002B","E01028005","Total",822,187,95,92,635,15,190,83,185,19,33,110
"2011","Bassetlaw 002C","E01028031","Total",473,129,66,63,344,15,90,58,89,15,16,61
"2011","Bassetlaw 002D","E01028032","Total",559,123,67,56,436,10,95,92,126,19,34,60
"2011","Bassetlaw 002E","E01028035","Total",961,210,102,108,751,29,180,124,230,29,49,110
"2011","Bassetlaw 003A","E01028023","Total",947,204,101,103,743,25,173,136,225,25,35,124
"2011","Bassetlaw 003B","E01028034","Total",1010,235,120,115,775,33,210,130,221,24,42,115
"2011","Bassetlaw 003C","E01028036","Total",868,239,112,127,629,20,149,109,194,17,49,91
"2011","Bassetlaw 004A","E01028001","Total",593,217,123,94,376,55,69,67,97,15,29,44
"2011","Bassetlaw 004B","E01028002","Total",600,150,83,67,450,24,112,67,122,16,24,85
"2011","Bassetlaw 004C","E01028003","Total",600,148,77,71,452,25,110,68,130,12,26,81
"2011","Bassetlaw 004D","E01028004","Total",681,156,111,45,525,14,155,64,165,9,23,95
"2011","Bassetlaw 004E","E01028029","Total",524,157,84,73,367,32,76,53,104,9,25,68
"2011","Bassetlaw 004F","E01028030","Total",497,92,47,45,405,29,58,84,104,16,31,83
"2011","Bassetlaw 005A","E01028013","Total",783,260,156,104,523,38,135,74,133,21,49,73
"2011","Bassetlaw 005B","E01028014","Total",767,343,193,150,424,34,100,72,114,17,27,60
"2011","Bassetlaw 005C","E01028015","Total",628,136,60,76,492,19,86,107,155,7,27,91
"2011","Bassetlaw 005D","E01028016","Total",615,174,103,71,441,22,149,68,113,9,21,59
"2011","Bassetlaw 006A","E01028046","Total",673,168,73,95,505,28,101,108,151,8,18,91
"2011","Bassetlaw 006B","E01028047","Total",739,101,10,91,638,29,46,209,167,30,79,78
"2011","Bassetlaw 006C","E01028048","Total",611,81,30,51,530,28,56,138,159,19,38,92
"2011","Bassetlaw 006D","E01028049","Total",749,237,134,103,512,31,99,104,142,23,36,77
"2011","Bassetlaw 006E","E01028050","Total",729,150,57,93,579,29,58,153,157,16,53,113
"2011","Bassetlaw 008A","E01028008","Total",508,112,44,68,396,60,56,75,87,21,36,61
"2011","Bassetlaw 008B","E01028009","Total",630,151,81,70,479,9,185,60,117,9,18,81
"2011","Bassetlaw 008C","E01028010","Total",547,108,47,61,439,8,109,91,98,10,26,97
"2011","Bassetlaw 008D","E01028011","Total",794,357,118,239,437,52,78,72,148,12,23,52
"2011","Bassetlaw 008E","E01028012","Total",618,209,88,121,409,35,66,74,129,13,24,68
"2011","Bassetlaw 008F","E01028022","Total",659,195,51,144,464,47,59,97,143,12,32,74
"2011","Bassetlaw 009A","E01028055","Total",774,369,93,276,405,61,59,84,127,4,15,55
"2011","Bassetlaw 009B","E01028056","Total",507,118,60,58,389,32,54,89,107,15,27,65
"2011","Bassetlaw 009C","E01028058","Total",741,159,68,91,582,30,93,141,184,14,36,84
"2011","Bassetlaw 009D","E01028059","Total",640,78,27,51,562,30,41,161,158,34,45,93
"2011","Bassetlaw 010A","E01028017","Total",620,226,128,98,394,29,113,47,113,19,26,47
"2011","Bassetlaw 010B","E01028018","Total",625,146,57,89,479,31,81,88,159,8,34,78
"2011","Bassetlaw 010C","E01028019","Total",628,197,86,111,431,46,85,75,117,19,32,57
"2011","Bassetlaw 010D","E01028020","Total",864,351,75,276,513,48,60,113,185,22,21,64
"2011","Bassetlaw 010E","E01028021","Total",674,220,121,99,454,21,105,95,123,12,29,69
"2011","Bassetlaw 012A","E01028057","Total",602,242,43,199,360,48,26,66,133,5,23,59
"2011","Bassetlaw 012B","E01028065","Total",726,229,103,126,497,101,47,102,115,32,33,67
"2011","Bassetlaw 012C","E01028066","Total",684,209,82,127,475,69,52,79,130,36,40,69
"2011","Bassetlaw 012D","E01028068","Total",823,353,118,235,470,46,67,102,142,18,26,69
"2011","Bassetlaw 013A","E01028060","Total",727,161,102,59,566,13,185,89,137,13,36,93
"2011","Bassetlaw 013B","E01028061","Total",639,161,57,104,478,17,85,123,149,7,35,62
"2011","Bassetlaw 013C","E01028062","Total",912,342,102,240,570,48,104,98,196,19,26,79
"2011","Bassetlaw 013D","E01028067","Total",643,201,69,132,442,32,68,85,108,21,40,88
"2011","Bassetlaw 014A","E01028040","Total",434,113,56,57,321,24,69,68,87,7,22,44
"2011","Bassetlaw 014B","E01028041","Total",453,123,72,51,330,16,82,41,96,6,21,68
"2011","Bassetlaw 014C","E01028043","Total",601,126,77,49,475,20,123,78,121,5,44,84
"2011","Bassetlaw 014D","E01028063","Total",730,155,79,76,575,15,144,102,157,14,38,105
"2011","Bassetlaw 014E","E01028064","Total",533,135,66,69,398,31,76,69,93,18,33,78
"2011","Bassetlaw 015A","E01028006","Total",535,140,72,68,395,12,96,71,130,8,23,55
"2011","Bassetlaw 015B","E01028007","Total",455,99,51,48,356,18,81,65,96,9,27,60
"2011","Bassetlaw 015C","E01028033","Total",840,186,99,87,654,18,149,113,197,22,45,110
"2011","Bassetlaw 015D","E01028037","Total",687,160,63,97,527,27,115,95,157,19,33,81
"2011","Bassetlaw 015E","E01028038","Total",641,199,91,108,442,31,90,75,119,18,27,82
"2011","Bassetlaw 015F","E01028039","Total",504,118,70,48,386,9,101,53,128,16,17,62
"2011","Bassetlaw 016E","E01028042","Total",568,129,79,50,439,29,68,94,113,10,44,81
"2011","Bassetlaw 016F","E01028044","Total",755,318,176,142,437,41,91,80,125,16,25,59
"2011","Bassetlaw 016G","E01028045","Total",857,283,183,100,574,27,121,110,161,19,39,97
"2011","Bassetlaw 016A","E01028051","Total",737,267,136,131,470,20,130,72,155,9,16,68
"2011","Bassetlaw 016B","E01028052","Total",689,146,95,51,543,19,150,93,133,9,45,94
"2011","Bassetlaw 016C","E01028053","Total",782,336,107,229,446,32,91,77,160,16,14,56
"2011","Bassetlaw 016D","E01028054","Total",569,114,59,55,455,11,115,78,108,14,27,102
"2011","Broxtowe 001A","E01028092","Total",529,123,68,55,406,24,75,68,116,21,22,80
"2011","Broxtowe 001B","E01028093","Total",454,114,66,48,340,4,94,47,113,9,19,54
"2011","Broxtowe 001C","E01028107","Total",638,129,54,75,509,13,80,98,168,16,27,107
"2011","Broxtowe 001D","E01028108","Total",657,181,94,87,476,18,106,81,145,8,27,91
"2011","Broxtowe 001E","E01028114","Total",664,214,97,117,450,26,115,71,127,12,21,78
"2011","Broxtowe 002A","E01028110","Total",625,198,78,120,427,35,78,85,109,25,28,67
"2011","Broxtowe 002B","E01028111","Total",635,177,81,96,458,37,102,63,143,11,20,82
"2011","Broxtowe 002C","E01028112","Total",742,296,116,180,446,48,58,75,146,19,20,80
"2011","Broxtowe 002D","E01028113","Total",612,183,97,86,429,30,80,72,91,31,36,89
"2011","Broxtowe 003A","E01028109","Total",749,199,113,86,550,19,124,88,175,16,33,95
"2011","Broxtowe 003B","E01028115","Total",666,160,92,68,506,16,163,70,143,8,22,84
"2011","Broxtowe 003C","E01028116","Total",692,204,100,104,488,25,100,112,137,11,29,74
"2011","Broxtowe 003D","E01028117","Total",553,79,24,55,474,11,57,118,134,20,39,95
"2011","Broxtowe 003E","E01028118","Total",766,210,135,75,556,8,223,68,144,8,27,78
"2011","Broxtowe 004A","E01028102","Total",582,140,61,79,442,29,75,70,148,9,29,82
"2011","Broxtowe 004B","E01028103","Total",532,206,69,137,326,29,56,53,99,10,22,57
"2011","Broxtowe 004C","E01028104","Total",616,151,61,90,465,18,84,90,158,7,32,76
"2011","Broxtowe 004D","E01028122","Total",739,272,167,105,467,29,100,93,126,8,36,75
"2011","Broxtowe 004E","E01028123","Total",767,158,50,108,609,19,121,122,174,21,41,111
"2011","Broxtowe 004F","E01028124","Total",640,164,95,69,476,17,136,75,103,15,37,93
"2011","Broxtowe 007A","E01028087","Total",688,184,103,81,504,4,146,85,128,14,36,91
"2011","Broxtowe 007B","E01028088","Total",634,152,93,59,482,8,138,89,126,10,24,87
"2011","Broxtowe 007C","E01028089","Total",537,101,59,42,436,7,125,81,101,15,25,82
"2011","Broxtowe 007D","E01028090","Total",628,215,123,92,413,16,94,79,118,13,24,69
"2011","Broxtowe 007E","E01028091","Total",617,138,93,45,479,15,130,82,129,19,22,82
"2011","Broxtowe 008A","E01028125","Total",695,166,73,93,529,27,125,94,138,21,25,99
"2011","Broxtowe 008B","E01028126","Total",576,150,68,82,426,36,70,88,107,18,36,71
"2011","Broxtowe 008C","E01028127","Total",759,239,95,144,520,85,115,92,106,17,29,76
"2011","Broxtowe 008D","E01028134","Total",636,184,67,117,452,50,51,94,136,15,18,88
"2011","Broxtowe 009A","E01028076","Total",592,202,68,134,390,27,75,54,144,10,18,62
"2011","Broxtowe 009B","E01028077","Total",587,168,96,72,419,30,60,61,121,21,37,89
"2011","Broxtowe 009C","E01028078","Total",624,137,57,80,487,25,64,89,149,19,34,107
"2011","Broxtowe 009D","E01028079","Total",538,160,69,91,378,10,49,55,105,23,20,116
"2011","Broxtowe 009E","E01028084","Total",744,187,80,107,557,14,97,127,185,23,36,75
"2011","Broxtowe 010A","E01028128","Total",730,171,85,86,559,20,124,120,140,12,34,109
"2011","Broxtowe 010B","E01028129","Total",630,197,97,100,433,18,98,85,97,18,34,83
"2011","Broxtowe 010C","E01028130","Total",802,284,142,142,518,55,93,95,146,26,24,79
"2011","Broxtowe 010D","E01028131","Total",621,153,70,83,468,25,101,95,114,16,29,88
"2011","Broxtowe 010E","E01028132","Total",432,126,55,71,306,28,46,69,74,13,22,54
"2011","Broxtowe 010F","E01028133","Total",638,198,42,156,440,41,59,90,135,11,30,74
"2011","Broxtowe 011A","E01028073","Total",775,381,221,160,394,17,82,43,122,8,14,108
"2011","Broxtowe 011B","E01028074","Total",711,263,139,124,448,20,72,48,129,6,18,155
"2011","Broxtowe 011C","E01028075","Total",694,194,78,116,500,31,37,87,178,16,20,131
"2011","Broxtowe 011D","E01028085","Total",902,302,125,177,600,16,88,114,233,22,30,97
"2011","Broxtowe 011E","E01028086","Total",727,295,99,196,432,18,64,87,160,9,18,76
"2011","Broxtowe 012A","E01028080","Total",773,229,54,175,544,44,60,96,217,7,23,97
"2011","Broxtowe 012B","E01028081","Total",574,207,87,120,367,20,111,55,103,6,15,57
"2011","Broxtowe 012C","E01028082","Total",507,117,51,66,390,9,64,94,103,7,25,88
"2011","Broxtowe 012D","E01028083","Total",599,229,42,187,370,29,38,67,130,8,17,81
"2011","Broxtowe 013A","E01028097","Total",615,121,60,61,494,13,132,84,147,8,15,95
"2011","Broxtowe 013B","E01028098","Total",735,211,78,133,524,39,81,150,136,25,35,58
"2011","Broxtowe 013C","E01028099","Total",628,186,89,97,442,19,121,75,128,8,15,76
"2011","Broxtowe 013D","E01028100","Total",782,268,164,104,514,33,137,85,130,14,30,85
"2011","Broxtowe 013E","E01028101","Total",596,153,51,102,443,89,64,73,102,12,29,74
"2011","Broxtowe 014A","E01028069","Total",525,134,69,65,391,19,79,77,130,8,13,65
"2011","Broxtowe 014B","E01028070","Total",483,111,71,40,372,9,127,52,96,8,24,56
"2011","Broxtowe 014C","E01028094","Total",742,219,113,106,523,23,100,98,169,25,30,78
"2011","Broxtowe 014D","E01028095","Total",616,164,94,70,452,20,112,89,106,19,23,83
"2011","Broxtowe 014E","E01028096","Total",766,230,132,98,536,17,137,109,144,18,33,78
"2011","Broxtowe 015A","E01028135","Total",569,121,82,39,448,10,111,93,104,12,32,86
"2011","Broxtowe 015B","E01028136","Total",665,137,83,54,528,13,127,119,102,21,49,97
"2011","Broxtowe 015C","E01028137","Total",984,210,37,173,774,42,53,238,276,22,46,97
"2011","Broxtowe 015D","E01028138","Total",559,216,101,115,343,16,83,52,100,11,19,62
"2011","Broxtowe 015E","E01028139","Total",573,112,52,60,461,30,74,114,124,10,32,77
"2011","Broxtowe 016A","E01028105","Total",503,117,50,67,386,21,87,62,98,15,32,71
"2011","Broxtowe 016B","E01028106","Total",672,209,91,118,463,21,109,72,144,9,22,86
"2011","Broxtowe 016C","E01028119","Total",798,154,26,128,644,30,57,155,191,25,77,109
"2011","Broxtowe 016D","E01028120","Total",643,124,77,47,519,13,142,96,126,7,42,93
"2011","Broxtowe 016E","E01028121","Total",581,129,58,71,452,19,81,124,103,14,28,83
"2011","Broxtowe 016F","E01033412","Total",1007,225,136,89,782,26,197,126,224,12,53,144
"2011","Broxtowe 016G","E01033413","Total",950,245,97,148,705,41,126,142,218,10,52,116
"2011","Gedling 001A","E01028189","Total",949,260,107,153,689,30,123,128,207,15,62,124
"2011","Gedling 001B","E01028198","Total",621,149,106,43,472,15,144,86,128,6,27,66
"2011","Gedling 001C","E01028199","Total",657,147,100,47,510,11,207,71,125,9,23,64
"2011","Gedling 001D","E01028200","Total",692,164,78,86,528,27,136,89,148,12,33,83
"2011","Gedling 001E","E01028201","Total",495,124,81,43,371,4,115,80,77,10,16,69
"2011","Gedling 002A","E01028150","Total",615,161,95,66,454,17,132,58,138,9,24,76
"2011","Gedling 002B","E01028151","Total",467,98,48,50,369,19,77,77,107,4,18,67
"2011","Gedling 002C","E01028152","Total",625,155,72,83,470,27,99,89,117,10,40,88
"2011","Gedling 002D","E01028153","Total",585,196,104,92,389,48,70,65,106,17,18,65
"2011","Gedling 002E","E01028154","Total",695,148,67,81,547,52,75,107,154,20,32,107
"2011","Gedling 002F","E01028213","Total",886,312,114,198,574,12,197,86,146,20,38,75
"2011","Gedling 004A","E01028143","Total",633,257,134,123,376,32,98,59,99,17,19,52
"2011","Gedling 004B","E01028205","Total",523,132,61,71,391,32,69,71,105,10,29,75
"2011","Gedling 004C","E01028206","Total",633,159,78,81,474,29,110,76,137,10,30,82
"2011","Gedling 004D","E01028207","Total",524,99,64,35,425,18,113,71,108,15,30,70
"2011","Gedling 004E","E01028208","Total",485,145,68,77,340,33,74,72,95,9,24,33
"2011","Gedling 005A","E01028173","Total",441,177,95,82,264,45,42,41,51,12,34,39
"2011","Gedling 005B","E01028174","Total",585,138,67,71,447,42,62,100,89,26,46,82
"2011","Gedling 005C","E01028175","Total",804,246,105,141,558,42,117,119,154,15,28,83
"2011","Gedling 005D","E01028209","Total",616,186,83,103,430,55,64,76,118,13,20,84
"2011","Gedling 006A","E01028144","Total",663,197,81,116,466,68,79,88,118,15,29,69
"2011","Gedling 006B","E01028165","Total",747,335,160,175,412,45,87,70,117,17,25,51
"2011","Gedling 006C","E01028166","Total",715,212,70,142,503,53,91,85,122,19,50,83
"2011","Gedling 006D","E01028167","Total",832,286,77,209,546,58,73,105,169,15,39,87
"2011","Gedling 007A","E01028179","Total",588,138,51,87,450,15,102,85,114,10,29,95
"2011","Gedling 007B","E01028180","Total",648,175,81,94,473,33,122,88,118,10,20,82
"2011","Gedling 007C","E01028181","Total",666,246,71,175,420,26,56,86,160,3,22,67
"2011","Gedling 007D","E01028182","Total",653,166,65,101,487,27,84,86,138,23,47,82
"2011","Gedling 007E","E01028183","Total",598,187,120,67,411,19,137,56,121,13,13,52
"2011","Gedling 008A","E01028148","Total",836,190,116,74,646,14,210,131,141,20,34,96
"2011","Gedling 008B","E01028149","Total",749,257,151,106,492,22,121,114,126,8,24,77
"2011","Gedling 008C","E01028178","Total",927,271,129,142,656,26,187,94,181,26,55,87
"2011","Gedling 009A","E01028176","Total",613,144,81,63,469,14,111,90,126,16,44,68
"2011","Gedling 009B","E01028177","Total",750,251,99,152,499,46,110,87,161,9,16,70
"2011","Gedling 009C","E01028214","Total",633,182,105,77,451,16,111,95,114,14,32,69
"2011","Gedling 009D","E01028215","Total",510,101,55,46,409,13,73,102,90,17,26,88
"2011","Gedling 009E","E01028216","Total",516,110,68,42,406,12,91,81,101,9,38,74
"2011","Gedling 009F","E01028217","Total",585,211,79,132,374,7,81,64,124,14,32,52
"2011","Gedling 009G","E01028218","Total",665,180,105,75,485,10,161,72,122,14,29,77
"2011","Gedling 010A","E01028193","Total",672,304,171,133,368,15,71,71,112,12,26,61
"2011","Gedling 010B","E01028194","Total",644,216,70,146,428,20,54,102,139,16,21,76
"2011","Gedling 010C","E01028195","Total",621,180,59,121,441,23,62,95,157,8,23,73
"2011","Gedling 010D","E01028196","Total",580,128,51,77,452,13,81,86,136,18,35,83
"2011","Gedling 010E","E01028197","Total",608,178,98,80,430,24,117,74,109,14,27,65
"2011","Gedling 010F","E01028204","Total",583,142,58,84,441,21,112,76,117,8,18,89
"2011","Gedling 011A","E01028172","Total",462,106,50,56,356,19,69,80,88,11,23,66
"2011","Gedling 011B","E01028190","Total",646,146,64,82,500,35,85,107,129,10,38,96
"2011","Gedling 011C","E01028202","Total",649,205,112,93,444,17,123,70,109,14,31,80
"2011","Gedling 011D","E01028203","Total",606,164,71,93,442,29,94,71,123,13,25,87
"2011","Gedling 011E","E01028212","Total",620,140,62,78,480,60,67,99,119,17,43,75
"2011","Gedling 012A","E01028168","Total",541,142,78,64,399,16,90,85,111,12,25,60
"2011","Gedling 012B","E01028169","Total",604,124,68,56,480,15,145,82,111,8,37,82
"2011","Gedling 012C","E01028170","Total",619,199,119,80,420,21,86,72,102,15,36,88
"2011","Gedling 012D","E01028171","Total",563,157,57,100,406,27,64,74,122,13,44,62
"2011","Gedling 012E","E01028191","Total",735,182,71,111,553,44,75,112,164,24,48,86
"2011","Gedling 012F","E01028192","Total",638,183,63,120,455,53,68,89,120,17,40,68
"2011","Gedling 013A","E01028160","Total",657,205,67,138,452,30,68,103,123,13,32,83
"2011","Gedling 013B","E01028161","Total",654,221,70,151,433,42,61,87,139,18,21,65
"2011","Gedling 013C","E01028162","Total",631,183,67,116,448,58,64,91,116,16,30,73
"2011","Gedling 013D","E01028163","Total",639,184,77,107,455,16,106,84,123,14,26,86
"2011","Gedling 013E","E01028211","Total",588,164,73,91,424,32,94,66,115,11,31,75
"2011","Gedling 014A","E01028155","Total",626,210,102,108,416,33,72,69,107,14,35,86
"2011","Gedling 014B","E01028156","Total",655,276,120,156,379,30,77,58,128,13,19,54
"2011","Gedling 014C","E01028157","Total",493,97,50,47,396,10,77,65,105,16,41,82
"2011","Gedling 014D","E01028158","Total",761,303,119,184,458,40,81,65,161,16,29,66
"2011","Gedling 014E","E01028159","Total",600,228,84,144,372,35,66,63,106,17,23,62
"2011","Gedling 014F","E01028164","Total",570,203,76,127,367,49,54,55,89,13,30,77
"2011","Gedling 014G","E01028210","Total",688,283,130,153,405,44,64,83,135,10,24,45
"2011","Gedling 015A","E01028184","Total",481,107,25,82,374,14,69,76,121,13,29,52
"2011","Gedling 015B","E01028185","Total",885,330,118,212,555,87,91,102,162,15,36,62
"2011","Gedling 015C","E01028186","Total",761,336,84,252,425,59,39,98,138,6,25,60
"2011","Gedling 015D","E01028187","Total",676,233,32,201,443,101,23,98,156,8,16,41
"2011","Gedling 015E","E01028188","Total",648,189,22,167,459,47,23,114,184,7,21,63
"2011","Gedling 016A","E01028142","Total",849,223,104,119,626,36,162,102,201,18,32,75
"2011","Gedling 016B","E01028146","Total",653,181,31,150,472,49,39,88,169,10,21,96
"2011","Gedling 016C","E01028147","Total",474,179,23,156,295,54,27,62,76,15,23,38
"2011","Gedling 016D","E01032622","Total",544,118,49,69,426,16,89,75,109,14,26,97
"2011","Mansfield 001A","E01028224","Total",647,186,114,72,461,16,149,67,103,16,31,79
"2011","Mansfield 001B","E01028257","Total",596,109,61,48,487,48,65,105,99,22,58,90
"2011","Mansfield 001C","E01028258","Total",721,221,138,83,500,21,144,68,114,16,34,103
"2011","Mansfield 001D","E01028259","Total",563,115,58,57,448,36,57,80,117,24,47,87
"2011","Mansfield 002A","E01028223","Total",436,159,80,79,277,19,47,58,74,9,23,47
"2011","Mansfield 002B","E01028225","Total",640,165,110,55,475,22,107,77,123,16,43,87
"2011","Mansfield 002C","E01028226","Total",604,158,52,106,446,53,57,102,109,21,35,69
"2011","Mansfield 002D","E01028260","Total",728,194,116,78,534,25,101,77,187,11,37,96
"2011","Mansfield 003A","E01028251","Total",649,114,61,53,535,13,105,109,151,16,34,107
"2011","Mansfield 003B","E01028252","Total",826,217,92,125,609,50,132,126,152,15,42,92
"2011","Mansfield 003C","E01028253","Total",713,153,84,69,560,19,145,112,150,11,29,94
"2011","Mansfield 003D","E01028277","Total",526,125,73,52,401,9,108,55,118,8,15,88
"2011","Mansfield 003E","E01028278","Total",641,190,112,78,451,32,106,75,120,7,23,88
"2011","Mansfield 004A","E01028271","Total",792,309,104,205,483,65,69,84,150,14,40,61
"2011","Mansfield 004B","E01028279","Total",663,251,159,92,412,28,100,56,106,8,28,86
"2011","Mansfield 004C","E01028280","Total",547,152,95,57,395,28,68,59,94,17,42,87
"2011","Mansfield 004D","E01028281","Total",573,149,56,93,424,67,35,100,98,18,37,69
"2011","Mansfield 004E","E01028283","Total",772,187,79,108,585,35,117,120,171,19,32,91
"2011","Mansfield 005A","E01028242","Total",695,218,61,157,477,25,81,94,167,11,15,84
"2011","Mansfield 005B","E01028250","Total",605,120,41,79,485,30,105,93,122,9,27,99
"2011","Mansfield 005C","E01028272","Total",729,237,97,140,492,49,95,95,143,11,25,74
"2011","Mansfield 005D","E01028273","Total",624,143,45,98,481,38,71,86,150,10,29,97
"2011","Mansfield 006A","E01028229","Total",720,273,139,134,447,18,114,54,140,6,27,88
"2011","Mansfield 006B","E01028232","Total",656,170,96,74,486,27,131,69,134,17,25,83
"2011","Mansfield 006E","E01028267","Total",726,157,71,86,569,64,69,109,117,32,61,117
"2011","Mansfield 006F","E01028282","Total",515,166,104,62,349,41,62,52,102,13,24,55
"2011","Mansfield 006G","E01033392","Total",960,315,158,157,645,49,118,110,197,17,53,101
"2011","Mansfield 007A","E01028237","Total",659,151,75,76,508,14,128,85,135,12,25,109
"2011","Mansfield 007B","E01028238","Total",594,123,72,51,471,45,88,89,75,23,46,105
"2011","Mansfield 007C","E01028239","Total",657,155,65,90,502,41,86,103,134,13,32,93
"2011","Mansfield 007D","E01028240","Total",628,135,57,78,493,20,108,102,147,11,22,83
"2011","Mansfield 007E","E01028241","Total",884,160,49,111,724,39,89,204,207,18,58,109
"2011","Mansfield 007F","E01028243","Total",809,258,177,81,551,31,146,86,150,17,37,84
"2011","Mansfield 008A","E01028227","Total",608,201,94,107,407,53,69,87,109,5,22,62
"2011","Mansfield 008B","E01028228","Total",511,150,74,76,361,28,86,58,96,10,28,55
"2011","Mansfield 008C","E01028247","Total",789,321,60,261,468,79,34,90,133,12,34,86
"2011","Mansfield 008D","E01028268","Total",770,292,45,247,478,71,36,104,152,7,30,78
"2011","Mansfield 008E","E01028269","Total",656,230,45,185,426,44,36,103,140,18,17,68
"2011","Mansfield 008F","E01028284","Total",714,258,113,145,456,47,89,84,121,16,35,64
"2011","Mansfield 009A","E01028233","Total",806,249,56,193,557,79,60,110,170,14,37,87
"2011","Mansfield 009B","E01028234","Total",797,306,148,158,491,93,62,108,120,16,41,51
"2011","Mansfield 009C","E01028274","Total",691,337,70,267,354,26,37,69,134,11,29,48
"2011","Mansfield 009D","E01028275","Total",665,209,72,137,456,79,35,118,107,23,28,66
"2011","Mansfield 009E","E01028276","Total",767,352,123,229,415,64,62,78,114,17,22,58
"2011","Mansfield 010A","E01028230","Total",584,146,69,77,438,53,71,82,104,23,30,75
"2011","Mansfield 010B","E01028231","Total",652,231,130,101,421,46,82,70,100,9,37,77
"2011","Mansfield 010C","E01028244","Total",666,196,74,122,470,19,87,105,155,11,24,69
"2011","Mansfield 010D","E01028245","Total",589,199,102,97,390,45,58,81,107,11,29,59
"2011","Mansfield 010E","E01028246","Total",720,167,80,87,553,22,106,93,187,9,35,101
"2011","Mansfield 010F","E01028248","Total",634,180,91,89,454,37,97,72,113,15,36,84
"2011","Mansfield 010G","E01028249","Total",561,149,83,66,412,20,84,77,106,12,33,80
"2011","Mansfield 011A","E01028235","Total",678,162,71,91,516,22,104,105,162,11,31,81
"2011","Mansfield 011B","E01028236","Total",715,180,66,114,535,38,91,122,139,16,33,96
"2011","Mansfield 011C","E01028262","Total",618,127,63,64,491,13,100,83,153,14,35,93
"2011","Mansfield 011D","E01028264","Total",779,159,80,79,620,20,148,116,159,15,46,116
"2011","Mansfield 012A","E01028254","Total",561,137,55,82,424,27,114,62,109,15,24,73
"2011","Mansfield 012B","E01028256","Total",807,402,75,327,405,49,52,80,113,23,30,58
"2011","Mansfield 012C","E01028261","Total",686,203,53,150,483,57,63,82,117,33,47,84
"2011","Mansfield 012D","E01028263","Total",785,362,135,227,423,69,71,65,115,23,28,52
"2011","Mansfield 013A","E01028219","Total",626,167,100,67,459,13,141,67,142,6,19,71
"2011","Mansfield 013B","E01028220","Total",781,209,78,131,572,32,89,102,207,7,35,100
"2011","Mansfield 013D","E01028222","Total",680,170,119,51,510,9,156,75,132,14,36,88
"2011","Mansfield 013E","E01028255","Total",594,133,89,44,461,8,178,56,118,5,18,78
"2011","Mansfield 013F","E01028270","Total",651,185,106,79,466,22,92,96,132,6,40,78
"2011","Mansfield 013G","E01033389","Total",594,169,26,143,425,28,30,127,180,11,17,32
"2011","Mansfield 013H","E01033390","Total",584,102,7,95,482,35,15,165,172,23,32,40
"2011","Mansfield 013I","E01033391","Total",511,123,76,47,388,13,103,80,100,4,21,67
"2011","Newark and Sherwood 001A","E01028301","Total",727,185,46,139,542,70,55,107,128,37,47,98
"2011","Newark and Sherwood 001B","E01028302","Total",690,198,89,109,492,30,113,78,154,7,35,75
"2011","Newark and Sherwood 001C","E01028338","Total",665,185,108,77,480,33,85,101,110,9,42,100
"2011","Newark and Sherwood 001D","E01028339","Total",727,183,60,123,544,57,75,108,144,18,52,90
"2011","Newark and Sherwood 001E","E01028340","Total",710,277,154,123,433,31,84,74,122,9,33,80
"2011","Newark and Sherwood 001F","E01028341","Total",758,242,104,138,516,9,167,64,155,4,34,83
"2011","Newark and Sherwood 002A","E01028313","Total",849,258,132,126,591,58,130,103,165,25,36,74
"2011","Newark and Sherwood 002B","E01028314","Total",978,179,59,120,799,52,71,214,219,43,76,124
"2011","Newark and Sherwood 002C","E01028321","Total",717,201,109,92,516,13,156,76,163,6,25,77
"2011","Newark and Sherwood 002D","E01028322","Total",884,255,159,96,629,34,187,91,159,10,37,111
"2011","Newark and Sherwood 002E","E01028323","Total",667,171,63,108,496,51,69,121,138,16,33,68
"2011","Newark and Sherwood 003A","E01028303","Total",669,169,102,67,500,16,151,69,138,15,31,80
"2011","Newark and Sherwood 003B","E01028312","Total",937,193,115,78,744,15,192,117,227,23,53,117
"2011","Newark and Sherwood 003C","E01028337","Total",621,111,66,45,510,15,147,87,142,14,40,65
"2011","Newark and Sherwood 003D","E01028349","Total",631,142,68,74,489,16,115,77,150,12,34,85
"2011","Newark and Sherwood 003E","E01028350","Total",498,140,76,64,358,17,88,57,88,21,23,64
"2011","Newark and Sherwood 004A","E01028315","Total",653,195,122,73,458,11,155,74,112,13,21,72
"2011","Newark and Sherwood 004B","E01028316","Total",702,233,137,96,469,20,159,53,144,19,17,57
"2011","Newark and Sherwood 004C","E01028317","Total",642,120,59,61,522,15,134,84,140,21,39,89
"2011","Newark and Sherwood 004D","E01028353","Total",1159,280,151,129,879,43,218,186,236,21,59,116
"2011","Newark and Sherwood 005A","E01028295","Total",801,158,68,90,643,28,166,120,170,16,53,90
"2011","Newark and Sherwood 005B","E01028297","Total",815,252,119,133,563,65,94,97,145,27,51,84
"2011","Newark and Sherwood 005C","E01028327","Total",672,181,104,77,491,17,136,98,110,19,38,73
"2011","Newark and Sherwood 005D","E01028328","Total",738,192,126,66,546,15,162,108,139,14,28,80
"2011","Newark and Sherwood 005E","E01028329","Total",626,111,58,53,515,14,119,93,138,26,39,86
"2011","Newark and Sherwood 006A","E01028296","Total",554,164,79,85,390,20,70,81,110,20,20,69
"2011","Newark and Sherwood 006B","E01028298","Total",664,181,71,110,483,41,76,98,135,12,29,92
"2011","Newark and Sherwood 006C","E01028299","Total",525,130,47,83,395,39,50,89,109,11,28,69
"2011","Newark and Sherwood 006D","E01028300","Total",681,220,100,120,461,45,87,85,127,24,31,62
"2011","Newark and Sherwood 006E","E01028342","Total",622,169,33,136,453,52,38,107,132,18,27,79
"2011","Newark and Sherwood 006F","E01028343","Total",899,270,160,110,629,29,151,118,155,17,40,119
"2011","Newark and Sherwood 006G","E01028344","Total",610,144,55,89,466,22,80,92,161,9,31,71
"2011","Newark and Sherwood 007A","E01028294","Total",820,320,105,215,500,54,82,106,148,15,27,68
"2011","Newark and Sherwood 007B","E01028304","Total",648,241,81,160,407,49,51,79,119,26,27,56
"2011","Newark and Sherwood 007C","E01028305","Total",568,150,57,93,418,33,47,75,154,14,27,68
"2011","Newark and Sherwood 007D","E01028306","Total",688,203,98,105,485,43,80,92,141,21,29,79
"2011","Newark and Sherwood 007E","E01028307","Total",500,97,21,76,403,33,37,87,123,14,24,85
"2011","Newark and Sherwood 007F","E01028310","Total",888,411,109,302,477,57,49,84,196,10,16,65
"2011","Newark and Sherwood 007G","E01028311","Total",843,459,124,335,384,26,66,52,154,16,12,58
"2011","Newark and Sherwood 008A","E01028345","Total",999,362,219,143,637,34,203,91,160,27,37,85
"2011","Newark and Sherwood 008B","E01028346","Total",925,235,140,95,690,34,201,121,174,23,38,99
"2011","Newark and Sherwood 008C","E01028347","Total",638,164,93,71,474,21,141,90,91,21,38,72
"2011","Newark and Sherwood 008D","E01028348","Total",507,149,91,58,358,23,111,54,78,24,20,48
"2011","Newark and Sherwood 009A","E01028292","Total",902,165,68,97,737,23,144,173,217,46,34,100
"2011","Newark and Sherwood 009B","E01028293","Total",851,258,76,182,593,54,85,145,192,24,18,75
"2011","Newark and Sherwood 009C","E01028333","Total",614,197,86,111,417,39,82,78,125,6,19,68
"2011","Newark and Sherwood 009D","E01028334","Total",595,146,72,74,449,49,66,72,102,33,49,78
"2011","Newark and Sherwood 009E","E01028335","Total",865,391,134,257,474,38,78,80,166,17,28,67
"2011","Newark and Sherwood 010A","E01028308","Total",736,233,127,106,503,23,128,66,158,16,23,89
"2011","Newark and Sherwood 010B","E01028309","Total",632,171,90,81,461,12,124,65,139,7,27,87
"2011","Newark and Sherwood 010C","E01028318","Total",621,181,92,89,440,43,79,55,106,25,50,82
"2011","Newark and Sherwood 010D","E01028319","Total",848,310,165,145,538,67,90,89,137,32,38,85
"2011","Newark and Sherwood 010E","E01028320","Total",765,294,130,164,471,82,80,75,111,26,34,63
"2011","Newark and Sherwood 011A","E01028285","Total",527,145,39,106,382,31,57,90,114,7,25,58
"2011","Newark and Sherwood 011B","E01028286","Total",598,226,157,69,372,15,115,67,90,9,17,59
"2011","Newark and Sherwood 011C","E01028287","Total",640,186,107,79,454,22,131,90,109,14,17,71
"2011","Newark and Sherwood 011D","E01028288","Total",644,147,78,69,497,26,126,97,138,13,30,67
"2011","Newark and Sherwood 011E","E01028289","Total",642,218,91,127,424,22,105,83,133,5,11,65
"2011","Newark and Sherwood 011F","E01028290","Total",614,154,108,46,460,27,106,90,122,15,25,75
"2011","Newark and Sherwood 011G","E01028291","Total",638,145,63,82,493,52,86,88,128,19,34,86
"2011","Newark and Sherwood 012B","E01028325","Total",515,113,63,50,402,13,109,72,137,14,12,45
"2011","Newark and Sherwood 012C","E01028326","Total",583,162,98,64,421,21,125,61,129,10,25,50
"2011","Newark and Sherwood 012D","E01028336","Total",474,115,53,62,359,13,96,63,104,9,33,41
"2011","Newark and Sherwood 012E","E01028352","Total",468,73,35,38,395,4,103,78,103,21,27,59
"2011","Newark and Sherwood 012F","E01033393","Total",865,202,8,194,663,56,42,204,239,32,31,59
"2011","Newark and Sherwood 012G","E01033394","Total",561,152,84,68,409,20,112,69,123,9,20,56
"2011","Newark and Sherwood 013A","E01028330","Total",689,171,97,74,518,17,153,92,118,11,38,89
"2011","Newark and Sherwood 013B","E01028331","Total",598,161,81,80,437,14,108,88,112,14,27,74
"2011","Newark and Sherwood 013C","E01028332","Total",692,162,86,76,530,14,130,102,134,27,32,91
"2011","Newark and Sherwood 013D","E01028351","Total",481,84,50,34,397,4,123,63,92,25,31,59
"2011","Rushcliffe 001A","E01028371","Total",820,183,98,85,637,23,200,108,166,27,33,80
"2011","Rushcliffe 001B","E01028403","Total",944,267,154,113,677,36,187,123,160,29,46,96
"2011","Rushcliffe 001C","E01028411","Total",851,168,76,92,683,20,136,146,219,19,41,102
"2011","Rushcliffe 002A","E01028357","Total",631,152,104,48,479,12,152,82,109,14,28,82
"2011","Rushcliffe 002B","E01028358","Total",628,241,114,127,387,35,114,66,85,16,14,57
"2011","Rushcliffe 002C","E01028359","Total",667,132,45,87,535,19,103,151,150,21,29,62
"2011","Rushcliffe 002D","E01028360","Total",766,183,30,153,583,61,66,138,212,19,28,59
"2011","Rushcliffe 002E","E01028361","Total",604,169,78,91,435,37,65,107,128,17,21,60
"2011","Rushcliffe 002F","E01028362","Total",593,189,98,91,404,38,79,73,84,16,41,73
"2011","Rushcliffe 003A","E01028393","Total",502,129,79,50,373,6,128,54,97,8,24,56
"2011","Rushcliffe 003B","E01028394","Total",693,235,162,73,458,20,128,90,129,11,21,59
"2011","Rushcliffe 003C","E01028395","Total",571,109,41,68,462,21,75,135,137,18,21,55
"2011","Rushcliffe 003D","E01028413","Total",754,284,173,111,470,41,100,112,103,18,27,69
"2011","Rushcliffe 003E","E01028414","Total",692,203,101,102,489,15,172,94,119,14,17,58
"2011","Rushcliffe 003F","E01028415","Total",628,118,66,52,510,15,135,98,134,19,38,71
"2011","Rushcliffe 004A","E01028354","Total",598,136,59,77,462,12,76,127,123,29,30,65
"2011","Rushcliffe 004B","E01028355","Total",658,211,108,103,447,16,62,126,140,14,14,75
"2011","Rushcliffe 004C","E01028384","Total",667,180,37,143,487,11,58,139,129,24,28,98
"2011","Rushcliffe 004D","E01028385","Total",674,155,65,90,519,23,71,138,135,37,30,85
"2011","Rushcliffe 004E","E01028386","Total",632,164,33,131,468,24,43,121,135,18,37,90
"2011","Rushcliffe 005A","E01028396","Total",641,177,48,129,464,21,44,124,167,21,17,70
"2011","Rushcliffe 005B","E01028398","Total",690,273,125,148,417,40,35,101,162,14,13,52
"2011","Rushcliffe 005C","E01028399","Total",498,139,50,89,359,16,25,102,82,31,28,75
"2011","Rushcliffe 005D","E01028416","Total",691,314,114,200,377,20,24,52,118,13,15,135
"2011","Rushcliffe 005E","E01028417","Total",622,243,22,221,379,11,14,65,146,17,24,102
"2011","Rushcliffe 005F","E01028418","Total",679,320,107,213,359,13,37,75,123,5,20,86
"2011","Rushcliffe 006A","E01028356","Total",606,146,74,72,460,27,76,106,110,15,31,95
"2011","Rushcliffe 006B","E01028375","Total",794,245,37,208,549,74,42,133,195,22,32,51
"2011","Rushcliffe 006C","E01028376","Total",670,199,69,130,471,13,93,105,156,17,33,54
"2011","Rushcliffe 006D","E01028377","Total",735,164,60,104,571,18,54,197,149,25,43,85
"2011","Rushcliffe 006E","E01028397","Total",696,161,73,88,535,19,87,123,160,29,34,83
"2011","Rushcliffe 007A","E01028363","Total",510,77,20,57,433,11,44,114,100,18,46,100
"2011","Rushcliffe 007B","E01028364","Total",676,161,57,104,515,17,64,163,139,15,38,79
"2011","Rushcliffe 007C","E01028365","Total",681,214,76,138,467,16,54,97,155,21,40,84
"2011","Rushcliffe 007D","E01028391","Total",826,216,140,76,610,16,161,122,150,14,47,100
"2011","Rushcliffe 007E","E01028392","Total",934,380,229,151,554,43,124,109,149,20,37,72
"2011","Rushcliffe 008A","E01028372","Total",557,229,119,110,328,20,79,69,71,11,20,58
"2011","Rushcliffe 008B","E01028373","Total",562,123,85,38,439,8,140,71,89,24,35,72
"2011","Rushcliffe 008C","E01028374","Total",580,213,156,57,367,27,101,73,66,14,38,48
"2011","Rushcliffe 008D","E01028400","Total",584,104,58,46,480,5,81,122,118,20,47,87
"2011","Rushcliffe 008E","E01028401","Total",481,90,28,62,391,12,76,102,78,15,34,74
"2011","Rushcliffe 009A","E01028366","Total",515,122,54,68,393,54,52,82,78,21,28,78
"2011","Rushcliffe 009B","E01028367","Total",549,119,63,56,430,21,83,86,116,15,24,85
"2011","Rushcliffe 009C","E01028368","Total",632,157,69,88,475,29,69,87,160,15,20,95
"2011","Rushcliffe 009D","E01028369","Total",592,151,46,105,441,56,50,99,118,10,42,66
"2011","Rushcliffe 009E","E01028370","Total",640,193,80,113,447,28,100,76,131,10,30,72
"2011","Rushcliffe 010A","E01028402","Total",772,154,80,74,618,17,147,131,186,15,33,89
"2011","Rushcliffe 010B","E01028419","Total",1046,284,122,162,762,32,157,165,235,14,36,123
"2011","Rushcliffe 010C","E01028420","Total",579,137,67,70,442,19,130,82,98,20,22,71
"2011","Rushcliffe 011A","E01028404","Total",674,193,94,99,481,25,116,87,139,13,34,67
"2011","Rushcliffe 011B","E01028405","Total",899,320,153,167,579,66,88,136,175,15,25,74
"2011","Rushcliffe 011C","E01028406","Total",710,194,88,106,516,30,107,120,150,16,31,62
"2011","Rushcliffe 011D","E01028407","Total",863,213,74,139,650,31,134,132,210,19,36,88
"2011","Rushcliffe 012A","E01028379","Total",719,174,129,45,545,3,230,67,111,12,45,77
"2011","Rushcliffe 012B","E01028412","Total",793,171,115,56,622,10,197,125,150,15,28,97
"2011","Rushcliffe 012C","E01028421","Total",866,152,85,67,714,15,196,138,181,30,44,110
"2011","Rushcliffe 013A","E01028380","Total",530,170,66,104,360,49,61,61,81,24,22,62
"2011","Rushcliffe 013B","E01028381","Total",597,161,100,61,436,10,141,70,98,8,23,86
"2011","Rushcliffe 013C","E01028382","Total",628,170,101,69,458,12,153,93,105,11,28,56
"2011","Rushcliffe 013D","E01028383","Total",505,157,101,56,348,3,127,43,82,11,15,67
"2011","Rushcliffe 014A","E01028378","Total",892,251,123,128,641,28,176,90,185,17,35,110
"2011","Rushcliffe 014B","E01028387","Total",672,139,93,46,533,52,100,120,97,29,35,100
"2011","Rushcliffe 014C","E01028408","Total",861,198,104,94,663,33,150,135,185,21,32,107
"2011","Rushcliffe 015A","E01028388","Total",622,117,49,68,505,8,100,132,122,23,44,76
"2011","Rushcliffe 015B","E01028389","Total",669,197,136,61,472,14,164,72,112,5,22,83
"2011","Rushcliffe 015C","E01028390","Total",686,168,107,61,518,20,145,82,130,14,28,99
"2011","Rushcliffe 015D","E01028409","Total",508,99,48,51,409,14,96,81,104,13,28,73
"2011","Rushcliffe 015E","E01028410","Total",530,107,62,45,423,11,106,94,119,11,20,62
"2011","Herefordshire 001A","E01013998","Total",612,154,108,46,458,19,157,46,137,15,21,63
"2011","Herefordshire 001B","E01014051","Total",737,197,108,89,540,43,140,100,137,21,30,69
"2011","Herefordshire 001C","E01014052","Total",652,165,84,81,487,17,149,64,136,19,25,77
"2011","Herefordshire 001D","E01014096","Total",649,153,85,68,496,26,142,68,147,9,32,72
"2011","Herefordshire 002A","E01014041","Total",721,261,159,102,460,24,137,81,128,12,18,60
"2011","Herefordshire 002B","E01014042","Total",665,209,83,126,456,66,41,95,112,33,45,64
"2011","Herefordshire 002C","E01014043","Total",513,161,114,47,352,14,133,49,74,10,15,57
"2011","Herefordshire 002D","E01014044","Total",598,159,76,83,439,32,73,86,106,21,30,91
"2011","Herefordshire 003A","E01014045","Total",683,197,93,104,486,26,101,87,145,11,29,87
"2011","Herefordshire 003B","E01014046","Total",616,164,90,74,452,15,130,75,104,9,33,86
"2011","Herefordshire 003C","E01014047","Total",612,186,80,106,426,42,100,71,91,17,42,63
"2011","Herefordshire 003D","E01014048","Total",776,384,140,244,392,42,77,61,139,8,21,44
"2011","Herefordshire 004A","E01013999","Total",614,169,110,59,445,9,137,64,127,20,27,61
"2011","Herefordshire 004B","E01014017","Total",632,155,87,68,477,23,145,65,121,15,39,69
"2011","Herefordshire 004C","E01014024","Total",545,118,56,62,427,13,123,53,125,11,33,69
"2011","Herefordshire 004D","E01014025","Total",596,151,95,56,445,15,152,51,98,16,28,85
"2011","Herefordshire 004E","E01014055","Total",672,174,87,87,498,24,144,76,113,14,40,87
"2011","Herefordshire 004F","E01014097","Total",576,141,87,54,435,12,127,58,124,12,33,69
"2011","Herefordshire 005A","E01014000","Total",567,117,57,60,450,14,144,64,109,12,27,80
"2011","Herefordshire 005B","E01014001","Total",623,167,79,88,456,9,126,63,126,14,34,84
"2011","Herefordshire 005C","E01014002","Total",616,200,143,57,416,9,154,54,93,9,27,70
"2011","Herefordshire 005D","E01014003","Total",595,154,82,72,441,18,92,91,111,15,39,75
"2011","Herefordshire 005E","E01014004","Total",589,131,73,58,458,11,129,72,140,14,31,61
"2011","Herefordshire 005F","E01014005","Total",798,348,165,183,450,65,82,77,136,7,17,66
"2011","Herefordshire 005G","E01014015","Total",656,136,61,75,520,16,120,90,134,15,40,105
"2011","Herefordshire 006A","E01014008","Total",705,204,122,82,501,9,148,81,136,11,32,84
"2011","Herefordshire 006B","E01014009","Total",646,156,87,69,490,13,168,61,129,16,39,64
"2011","Herefordshire 006C","E01014033","Total",776,248,137,111,528,25,169,75,133,21,25,80
"2011","Herefordshire 006D","E01014034","Total",683,240,110,130,443,43,89,81,126,21,20,63
"2011","Herefordshire 006E","E01014056","Total",610,143,75,68,467,9,136,83,115,17,32,75
"2011","Herefordshire 007A","E01014006","Total",652,144,73,71,508,16,145,88,117,11,44,87
"2011","Herefordshire 007B","E01014012","Total",699,188,114,74,511,7,157,70,134,13,33,97
"2011","Herefordshire 007C","E01014013","Total",670,133,65,68,537,37,71,175,105,39,42,68
"2011","Herefordshire 007D","E01014016","Total",665,207,135,72,458,25,160,63,87,20,36,67
"2011","Herefordshire 007E","E01014100","Total",650,171,81,90,479,4,119,75,149,17,41,74
"2011","Herefordshire 007F","E01014101","Total",454,114,41,73,340,4,110,45,80,20,20,61
"2011","Herefordshire 008A","E01014022","Total",791,141,64,77,650,30,131,116,171,27,54,121
"2011","Herefordshire 008B","E01014023","Total",680,130,50,80,550,38,95,116,149,21,41,90
"2011","Herefordshire 008C","E01014081","Total",598,140,81,59,458,10,126,82,111,14,29,86
"2011","Herefordshire 008D","E01014082","Total",694,161,93,68,533,27,148,81,114,21,48,94
"2011","Herefordshire 009A","E01014027","Total",532,129,64,65,403,9,125,53,116,11,20,69
"2011","Herefordshire 009B","E01014028","Total",624,159,94,65,465,11,159,59,122,9,20,85
"2011","Herefordshire 009C","E01014029","Total",656,215,128,87,441,12,156,72,96,12,30,63
"2011","Herefordshire 009D","E01014030","Total",587,139,78,61,448,12,132,76,116,11,25,76
"2011","Herefordshire 010A","E01014083","Total",710,212,131,81,498,18,146,86,122,18,31,77
"2011","Herefordshire 010B","E01014084","Total",735,295,167,128,440,30,70,83,138,13,35,71
"2011","Herefordshire 010C","E01014085","Total",578,154,78,76,424,37,64,68,116,18,39,82
"2011","Herefordshire 010D","E01014087","Total",712,263,73,190,449,17,81,87,168,9,17,70
"2011","Herefordshire 010E","E01014088","Total",696,264,80,184,432,32,62,87,170,9,13,59
"2011","Herefordshire 010F","E01014089","Total",579,120,57,63,459,44,91,82,105,9,37,91
"2011","Herefordshire 011A","E01013987","Total",671,180,95,85,491,16,133,89,121,10,31,91
"2011","Herefordshire 011B","E01013988","Total",912,393,232,161,519,11,179,61,128,12,27,101
"2011","Herefordshire 011C","E01014007","Total",668,131,78,53,537,16,139,86,140,14,46,96
"2011","Herefordshire 011D","E01014095","Total",581,131,69,62,450,38,93,89,80,16,41,93
"2011","Herefordshire 012A","E01013986","Total",729,228,100,128,501,38,79,98,130,27,34,95
"2011","Herefordshire 012B","E01013989","Total",582,165,74,91,417,29,51,82,119,23,33,80
"2011","Herefordshire 012C","E01014010","Total",849,442,111,331,407,42,46,57,153,7,26,76
"2011","Herefordshire 012D","E01014011","Total",648,239,95,144,409,38,48,93,95,11,31,93
"2011","Herefordshire 012E","E01014086","Total",713,312,93,219,401,50,48,82,129,11,19,62
"2011","Herefordshire 012F","E01014092","Total",903,375,134,241,528,40,95,91,188,10,30,74
"2011","Herefordshire 013A","E01014075","Total",693,201,95,106,492,29,88,89,132,19,39,96
"2011","Herefordshire 013B","E01014076","Total",1030,406,120,286,624,62,77,137,201,19,28,100
"2011","Herefordshire 013C","E01014077","Total",710,221,114,107,489,16,124,96,147,13,29,64
"2011","Herefordshire 013D","E01014078","Total",599,172,98,74,427,21,96,71,94,29,39,77
"2011","Herefordshire 014A","E01014090","Total",601,144,108,36,457,12,125,100,66,14,43,97
"2011","Herefordshire 014B","E01014091","Total",634,160,118,42,474,16,153,65,117,17,38,68
"2011","Herefordshire 014C","E01014093","Total",598,183,102,81,415,28,100,72,91,8,36,80
"2011","Herefordshire 014D","E01014094","Total",589,120,73,47,469,18,121,79,96,19,39,97
"2011","Herefordshire 015A","E01014068","Total",609,149,81,68,460,19,111,70,121,14,33,92
"2011","Herefordshire 015B","E01014070","Total",897,234,120,114,663,26,88,162,188,23,58,118
"2011","Herefordshire 015C","E01014072","Total",826,208,82,126,618,56,88,120,165,31,58,100
"2011","Herefordshire 015D","E01014073","Total",801,257,97,160,544,74,55,168,123,30,28,66
"2011","Herefordshire 015E","E01014074","Total",722,288,135,153,434,73,60,68,100,13,33,87
"2011","Herefordshire 016A","E01013996","Total",680,198,71,127,482,29,72,112,161,16,32,60
"2011","Herefordshire 016B","E01013997","Total",822,211,66,145,611,35,69,153,194,17,36,107
"2011","Herefordshire 016C","E01014079","Total",641,131,66,65,510,12,130,92,119,21,34,102
"2011","Herefordshire 016D","E01014080","Total",598,176,115,61,422,20,141,59,98,5,34,65
"2011","Herefordshire 017A","E01013992","Total",594,166,45,121,428,42,35,93,124,16,36,82
"2011","Herefordshire 017B","E01013993","Total",606,121,57,64,485,49,94,80,108,24,51,79
"2011","Herefordshire 017C","E01013994","Total",632,165,70,95,467,66,64,98,102,20,37,80
"2011","Herefordshire 017D","E01013995","Total",734,212,70,142,522,132,54,108,113,24,30,61
"2011","Herefordshire 017E","E01014071","Total",610,194,79,115,416,54,63,69,90,22,34,84
"2011","Herefordshire 018A","E01013990","Total",751,220,131,89,531,30,159,65,143,19,30,85
"2011","Herefordshire 018B","E01013991","Total",536,129,64,65,407,16,89,79,108,14,38,63
"2011","Herefordshire 018C","E01014014","Total",729,165,87,78,564,17,115,104,160,21,42,105
"2011","Herefordshire 018D","E01014054","Total",585,143,70,73,442,10,125,68,131,8,27,73
"2011","Herefordshire 019A","E01014035","Total",790,318,157,161,472,42,89,107,107,16,31,80
"2011","Herefordshire 019B","E01014036","Total",690,228,155,73,462,13,156,58,117,14,23,81
"2011","Herefordshire 019C","E01014037","Total",733,257,191,66,476,14,188,67,114,5,27,61
"2011","Herefordshire 019D","E01014038","Total",624,172,80,92,452,18,115,85,118,18,34,64
"2011","Herefordshire 019E","E01014039","Total",721,160,61,99,561,34,112,144,156,32,29,54
"2011","Herefordshire 019F","E01014040","Total",757,269,167,102,488,20,139,75,147,13,24,70
"2011","Herefordshire 020A","E01014018","Total",628,161,87,74,467,18,138,56,109,24,41,81
"2011","Herefordshire 020B","E01014019","Total",671,195,100,95,476,18,121,65,125,27,35,85
"2011","Herefordshire 020C","E01014020","Total",636,156,87,69,480,16,121,78,119,23,37,86
"2011","Herefordshire 020D","E01014021","Total",638,185,105,80,453,17,144,83,95,10,27,77
"2011","Herefordshire 021A","E01014026","Total",896,231,105,126,665,20,189,111,165,21,41,118
"2011","Herefordshire 021B","E01014059","Total",780,185,104,81,595,10,158,98,140,27,52,110
"2011","Herefordshire 021C","E01014060","Total",646,141,79,62,505,16,133,69,138,22,40,87
"2011","Herefordshire 021D","E01014069","Total",793,237,48,189,556,60,51,166,179,20,31,49
"2011","Herefordshire 021E","E01014098","Total",583,108,66,42,475,30,93,103,97,18,45,89
"2011","Herefordshire 021F","E01014099","Total",735,170,96,74,565,19,161,85,142,15,50,93
"2011","Herefordshire 022A","E01014061","Total",683,190,127,63,493,9,189,80,111,10,27,67
"2011","Herefordshire 022B","E01014062","Total",819,353,185,168,466,34,107,73,157,6,23,66
"2011","Herefordshire 022C","E01014063","Total",734,207,120,87,527,38,126,96,128,20,34,85
"2011","Herefordshire 022D","E01014064","Total",779,339,119,220,440,49,55,83,139,18,25,71
"2011","Herefordshire 022E","E01014065","Total",634,168,62,106,466,34,102,78,130,10,35,77
"2011","Herefordshire 022F","E01014066","Total",541,224,115,109,317,17,80,51,90,6,15,58
"2011","Herefordshire 022G","E01014067","Total",594,140,94,46,454,12,127,85,105,14,34,77
"2011","Herefordshire 023A","E01014031","Total",631,174,73,101,457,14,121,73,126,23,31,69
"2011","Herefordshire 023B","E01014032","Total",689,185,107,78,504,15,142,82,134,14,35,82
"2011","Herefordshire 023C","E01014049","Total",666,154,85,69,512,16,154,81,144,16,26,75
"2011","Herefordshire 023D","E01014050","Total",706,139,70,69,567,21,148,94,141,16,49,98
"2011","Herefordshire 023E","E01014053","Total",719,180,78,102,539,10,153,93,147,16,33,87
"2011","Herefordshire 023F","E01014057","Total",726,172,101,71,554,28,164,85,149,16,37,75
"2011","Herefordshire 023G","E01014058","Total",699,151,90,61,548,6,194,83,156,11,30,68
"2011","Shropshire 025A","E01028853","Total",641,202,104,98,439,52,88,56,102,19,39,83
"2011","Shropshire 025B","E01028854","Total",665,193,78,115,472,14,106,77,149,9,27,90
"2011","Shropshire 025C","E01028855","Total",656,162,94,68,494,26,107,95,142,9,22,93
"2011","Shropshire 025D","E01028856","Total",602,219,94,125,383,23,79,67,134,10,18,52
"2011","Shropshire 025E","E01028857","Total",752,199,99,100,553,27,134,90,155,17,31,99
"2011","Shropshire 027A","E01028826","Total",760,245,143,102,515,30,130,65,154,14,28,94
"2011","Shropshire 027B","E01028827","Total",598,133,84,49,465,26,100,108,88,24,30,89
"2011","Shropshire 027C","E01028844","Total",478,62,27,35,416,17,54,165,107,22,16,35
"2011","Shropshire 027D","E01028845","Total",881,260,180,80,621,10,225,84,145,12,44,101
"2011","Shropshire 029A","E01028838","Total",649,207,100,107,442,38,96,78,128,13,24,65
"2011","Shropshire 029B","E01028839","Total",555,117,70,47,438,16,103,94,124,7,23,71
"2011","Shropshire 029C","E01028840","Total",534,115,61,54,419,19,83,77,120,16,16,88
"2011","Shropshire 029D","E01028841","Total",681,206,97,109,475,27,84,75,159,16,26,88
"2011","Shropshire 029E","E01028850","Total",931,221,71,150,710,18,128,148,240,15,38,123
"2011","Shropshire 029F","E01028851","Total",741,198,119,79,543,25,148,76,169,18,27,80
"2011","Shropshire 029G","E01028852","Total",708,206,119,87,502,23,135,83,127,18,30,86
"2011","Shropshire 031A","E01028830","Total",702,257,119,138,445,10,127,68,149,11,27,53
"2011","Shropshire 031B","E01028831","Total",635,143,82,61,492,23,143,93,129,11,21,72
"2011","Shropshire 031C","E01028836","Total",686,269,132,137,417,34,87,80,101,13,30,72
"2011","Shropshire 031D","E01028837","Total",660,206,107,99,454,12,110,73,123,15,28,93
"2011","Shropshire 033A","E01028832","Total",871,388,133,255,483,27,93,88,204,6,18,47
"2011","Shropshire 033B","E01028833","Total",670,236,124,112,434,14,126,71,117,9,24,73
"2011","Shropshire 033C","E01028834","Total",645,161,92,69,484,18,125,73,139,22,31,76
"2011","Shropshire 033D","E01028835","Total",632,172,85,87,460,19,111,79,122,11,24,94
"2011","Shropshire 034A","E01028828","Total",673,155,80,75,518,16,116,102,142,18,42,82
"2011","Shropshire 034B","E01028829","Total",579,144,86,58,435,13,148,60,106,8,31,69
"2011","Shropshire 034C","E01028842","Total",665,155,81,74,510,11,136,75,129,17,45,97
"2011","Shropshire 034D","E01028847","Total",617,146,73,73,471,8,118,75,138,10,34,88
"2011","Shropshire 034E","E01028859","Total",661,137,61,76,524,14,151,83,144,19,32,81
"2011","Shropshire 035A","E01028843","Total",681,157,93,64,524,15,133,98,133,18,40,87
"2011","Shropshire 035B","E01028846","Total",729,166,81,85,563,22,145,90,155,19,40,92
"2011","Shropshire 035C","E01028848","Total",690,138,76,62,552,20,181,79,135,17,36,84
"2011","Shropshire 035D","E01028849","Total",893,295,139,156,598,55,133,129,152,16,35,78
"2011","Shropshire 035E","E01028858","Total",839,177,91,86,662,18,208,89,168,11,54,114
"2011","Shropshire 001A","E01028891","Total",850,389,141,248,461,38,75,81,147,23,37,60
"2011","Shropshire 001B","E01028892","Total",593,146,86,60,447,12,129,59,129,14,23,81
"2011","Shropshire 001C","E01028894","Total",649,191,99,92,458,20,86,105,116,16,28,87
"2011","Shropshire 001D","E01028895","Total",684,195,82,113,489,32,93,82,132,16,50,84
"2011","Shropshire 001E","E01028896","Total",889,257,88,169,632,39,120,161,184,24,30,74
"2011","Shropshire 001F","E01028897","Total",617,177,112,65,440,28,105,79,108,15,34,71
"2011","Shropshire 002A","E01028880","Total",638,150,79,71,488,19,110,88,118,34,33,86
"2011","Shropshire 002B","E01028881","Total",523,118,91,27,405,6,112,48,108,15,32,84
"2011","Shropshire 002C","E01028882","Total",605,113,56,57,492,14,103,92,145,18,31,89
"2011","Shropshire 002D","E01028893","Total",605,135,71,64,470,6,111,77,129,16,35,96
"2011","Shropshire 002E","E01028899","Total",648,146,71,75,502,11,133,86,153,13,29,77
"2011","Shropshire 004A","E01028864","Total",611,169,81,88,442,7,92,67,138,18,35,85
"2011","Shropshire 004B","E01028865","Total",722,177,98,79,545,24,140,127,127,20,30,77
"2011","Shropshire 004C","E01028866","Total",593,202,87,115,391,25,88,75,103,14,28,58
"2011","Shropshire 004D","E01028867","Total",612,226,148,78,386,30,105,64,93,13,26,55
"2011","Shropshire 004E","E01028872","Total",560,105,47,58,455,16,108,71,121,15,35,89
"2011","Shropshire 005A","E01028873","Total",835,331,134,197,504,60,88,97,150,22,34,53
"2011","Shropshire 005B","E01028874","Total",615,173,106,67,442,12,169,53,111,14,15,68
"2011","Shropshire 005C","E01028875","Total",984,206,81,125,778,40,152,199,214,36,45,92
"2011","Shropshire 005D","E01028876","Total",841,352,183,169,489,37,97,106,135,17,28,69
"2011","Shropshire 005E","E01028877","Total",534,126,69,57,408,14,102,84,99,11,32,66
"2011","Shropshire 005F","E01028878","Total",683,199,81,118,484,26,121,79,137,22,31,68
"2011","Shropshire 005G","E01028879","Total",652,188,69,119,464,32,79,85,121,25,30,92
"2011","Shropshire 008A","E01028886","Total",757,244,103,141,513,53,86,116,151,24,27,56
"2011","Shropshire 008B","E01028887","Total",596,167,115,52,429,17,133,73,104,17,23,62
"2011","Shropshire 008C","E01028889","Total",622,218,141,77,404,9,135,48,106,18,16,72
"2011","Shropshire 008D","E01028890","Total",651,242,123,119,409,26,91,85,107,18,22,60
"2011","Shropshire 009A","E01028868","Total",592,119,62,57,473,13,123,81,118,25,31,82
"2011","Shropshire 009B","E01028869","Total",555,115,50,65,440,11,72,85,118,19,40,95
"2011","Shropshire 009C","E01028871","Total",484,118,53,65,366,14,78,64,96,12,33,69
"2011","Shropshire 009D","E01028885","Total",791,132,52,80,659,44,95,169,162,38,50,101
"2011","Shropshire 010A","E01028860","Total",720,170,100,70,550,25,127,127,111,21,47,92
"2011","Shropshire 010B","E01028862","Total",650,134,71,63,516,13,128,88,146,16,38,87
"2011","Shropshire 010C","E01028863","Total",497,93,50,43,404,11,91,87,109,14,26,66
"2011","Shropshire 010D","E01028888","Total",593,112,51,61,481,14,92,82,122,27,58,86
"2011","Shropshire 010E","E01028898","Total",555,96,58,38,459,8,92,63,146,21,43,86
"2011","Shropshire 013A","E01028861","Total",526,127,74,53,399,19,101,64,112,11,21,71
"2011","Shropshire 013B","E01028870","Total",578,89,39,50,489,10,107,108,129,20,35,80
"2011","Shropshire 013C","E01028883","Total",524,91,48,43,433,16,73,110,130,14,30,60
"2011","Shropshire 013D","E01028884","Total",647,176,106,70,471,32,109,79,116,19,37,79
"2011","Shropshire 003A","E01028910","Total",507,125,87,38,382,10,96,66,107,15,21,67
"2011","Shropshire 003B","E01028911","Total",539,128,80,48,411,8,102,59,103,11,37,91
"2011","Shropshire 003C","E01028912","Total",499,166,75,91,333,42,54,61,89,12,24,51
"2011","Shropshire 003D","E01028920","Total",525,139,83,56,386,17,83,62,107,18,20,79
"2011","Shropshire 003E","E01028921","Total",632,136,70,66,496,17,93,107,146,24,29,80
"2011","Shropshire 003F","E01028925","Total",531,135,62,73,396,9,94,55,118,12,31,77
"2011","Shropshire 003G","E01028926","Total",596,171,82,89,425,32,86,90,114,12,26,65
"2011","Shropshire 006C","E01028902","Total",498,171,103,68,327,11,96,39,85,11,22,63
"2011","Shropshire 006D","E01028903","Total",636,252,147,105,384,36,121,56,89,7,16,59
"2011","Shropshire 006E","E01028904","Total",577,134,74,60,443,22,72,93,115,16,48,77
"2011","Shropshire 006F","E01028905","Total",730,219,80,139,511,61,54,116,141,21,41,77
"2011","Shropshire 006G","E01028909","Total",607,180,88,92,427,40,77,73,100,18,25,94
"2011","Shropshire 006H","E01033528","Total",1050,277,85,192,773,44,91,206,242,22,48,120
"2011","Shropshire 007A","E01028906","Total",668,361,105,256,307,25,35,59,126,11,11,40
"2011","Shropshire 007B","E01028907","Total",809,296,166,130,513,27,132,86,154,13,24,77
"2011","Shropshire 007C","E01028908","Total",755,350,70,280,405,65,54,75,117,13,23,58
"2011","Shropshire 007D","E01028916","Total",699,202,143,59,497,15,188,78,100,11,17,88
"2011","Shropshire 007E","E01028917","Total",642,234,81,153,408,16,93,94,103,16,33,53
"2011","Shropshire 007F","E01028924","Total",632,143,61,82,489,25,69,122,140,22,40,71
"2011","Shropshire 011A","E01028913","Total",641,151,83,68,490,5,130,96,131,10,39,79
"2011","Shropshire 011B","E01028918","Total",580,122,45,77,458,18,97,94,124,16,30,79
"2011","Shropshire 011C","E01028919","Total",493,111,55,56,382,20,77,87,94,19,27,58
"2011","Shropshire 011D","E01028927","Total",427,89,47,42,338,9,93,62,91,9,25,49
"2011","Shropshire 011E","E01028928","Total",644,169,90,79,475,20,112,82,125,15,37,84
"2011","Shropshire 012A","E01028914","Total",460,100,54,46,360,7,115,51,87,5,21,74
"2011","Shropshire 012B","E01028915","Total",586,146,76,70,440,14,133,82,109,12,26,64
"2011","Shropshire 012C","E01028922","Total",494,93,45,48,401,10,97,65,108,14,31,76
"2011","Shropshire 012D","E01028923","Total",648,141,67,74,507,13,146,69,127,17,31,104
"2011","Shropshire 014A","E01028929","Total",593,125,56,69,468,18,105,101,130,12,32,70
"2011","Shropshire 014B","E01028969","Total",541,100,53,47,441,17,99,81,103,26,32,83
"2011","Shropshire 014C","E01028970","Total",493,126,57,69,367,8,97,63,76,16,37,70
"2011","Shropshire 014D","E01028971","Total",910,252,146,106,658,18,183,127,174,16,53,87
"2011","Shropshire 014E","E01028978","Total",616,139,55,84,477,29,107,90,120,17,33,81
"2011","Shropshire 014F","E01028979","Total",508,136,59,77,372,14,86,80,86,14,25,67
"2011","Shropshire 015A","E01028933","Total",655,163,72,91,492,37,85,107,117,14,38,94
"2011","Shropshire 015B","E01028934","Total",614,160,80,80,454,73,65,91,85,38,33,69
"2011","Shropshire 015C","E01028956","Total",642,148,90,58,494,17,142,92,106,18,31,88
"2011","Shropshire 015D","E01028957","Total",641,203,67,136,438,75,60,74,78,37,49,65
"2011","Shropshire 015E","E01028958","Total",764,197,107,90,567,51,94,106,142,19,34,121
"2011","Shropshire 016A","E01028932","Total",784,186,68,118,598,19,90,134,201,13,37,104
"2011","Shropshire 016B","E01028981","Total",668,161,77,84,507,25,91,96,155,16,36,88
"2011","Shropshire 016C","E01028982","Total",642,138,72,66,504,41,95,98,134,27,30,79
"2011","Shropshire 016D","E01028983","Total",810,236,109,127,574,54,91,97,127,29,59,117
"2011","Shropshire 017A","E01028930","Total",678,191,65,126,487,37,59,126,142,18,34,71
"2011","Shropshire 017B","E01028931","Total",925,375,91,284,550,49,64,109,216,14,21,77
"2011","Shropshire 017C","E01028944","Total",836,357,128,229,479,40,104,73,150,6,29,77
"2011","Shropshire 017D","E01028945","Total",1032,412,121,291,620,77,55,126,246,10,20,86
"2011","Shropshire 018A","E01028965","Total",641,256,117,139,385,42,73,63,104,20,30,53
"2011","Shropshire 018B","E01028966","Total",494,94,55,39,400,2,95,85,89,16,26,87
"2011","Shropshire 018C","E01028967","Total",655,217,98,119,438,59,78,80,77,20,47,77
"2011","Shropshire 018D","E01028968","Total",537,151,76,75,386,36,65,75,77,23,40,70
"2011","Shropshire 018E","E01028988","Total",710,203,75,128,507,40,70,114,146,19,23,95
"2011","Shropshire 018F","E01028989","Total",658,141,64,77,517,53,74,106,121,28,41,94
"2011","Shropshire 019A","E01028946","Total",1126,585,130,455,541,31,116,57,245,6,27,59
"2011","Shropshire 019B","E01028972","Total",738,209,133,76,529,12,147,113,124,20,26,87
"2011","Shropshire 019C","E01028973","Total",969,447,165,282,522,31,82,101,191,16,23,78
"2011","Shropshire 019D","E01028987","Total",1056,530,225,305,526,23,74,93,216,14,31,75
"2011","Shropshire 020A","E01028941","Total",835,313,135,178,522,47,83,104,157,13,29,89
"2011","Shropshire 020B","E01028942","Total",514,79,32,47,435,15,67,131,89,18,44,71
"2011","Shropshire 020C","E01028943","Total",1076,453,134,319,623,49,112,128,223,13,18,80
"2011","Shropshire 020D","E01028951","Total",674,202,98,104,472,30,133,80,117,21,27,64
"2011","Shropshire 020E","E01028953","Total",647,195,139,56,452,11,125,90,99,29,32,66
"2011","Shropshire 021A","E01028947","Total",637,177,137,40,460,5,177,82,98,13,16,69
"2011","Shropshire 021B","E01028948","Total",636,204,105,99,432,20,121,58,87,18,35,93
"2011","Shropshire 021C","E01028949","Total",648,177,95,82,471,17,124,88,131,9,24,78
"2011","Shropshire 021D","E01028985","Total",632,221,106,115,411,14,118,65,111,9,16,78
"2011","Shropshire 022A","E01028938","Total",874,432,171,261,442,35,84,71,161,15,22,54
"2011","Shropshire 022B","E01028939","Total",772,320,91,229,452,51,57,77,166,11,24,66
"2011","Shropshire 022C","E01028984","Total",689,267,116,151,422,31,87,73,152,6,18,55
"2011","Shropshire 022D","E01028986","Total",634,153,100,53,481,22,143,79,91,12,36,98
"2011","Shropshire 023A","E01028940","Total",678,179,110,69,499,25,106,109,135,12,41,71
"2011","Shropshire 023B","E01028952","Total",800,291,122,169,509,32,92,115,165,15,16,74
"2011","Shropshire 023C","E01028962","Total",676,213,92,121,463,69,62,70,94,24,36,108
"2011","Shropshire 023D","E01028963","Total",663,163,83,80,500,17,108,108,131,21,33,82
"2011","Shropshire 023E","E01028964","Total",675,156,85,71,519,21,130,97,130,20,34,87
"2011","Shropshire 023F","E01028974","Total",507,142,67,75,365,12,78,71,103,20,20,61
"2011","Shropshire 024A","E01028935","Total",630,142,95,47,488,14,154,77,108,10,29,96
"2011","Shropshire 024B","E01028936","Total",858,198,121,77,660,26,194,92,159,20,46,123
"2011","Shropshire 024C","E01028937","Total",637,171,91,80,466,27,104,83,107,7,46,92
"2011","Shropshire 024D","E01028959","Total",1098,321,138,183,777,23,164,154,248,23,55,110
"2011","Shropshire 026A","E01028954","Total",522,114,65,49,408,10,119,55,100,14,35,75
"2011","Shropshire 026B","E01028955","Total",494,161,83,78,333,20,91,61,87,12,11,51
"2011","Shropshire 026C","E01028975","Total",720,194,109,85,526,26,115,105,133,26,42,79
"2011","Shropshire 026D","E01028976","Total",684,141,80,61,543,10,156,83,141,20,41,92
"2011","Shropshire 026E","E01028977","Total",819,235,142,93,584,24,146,96,157,20,45,96
"2011","Shropshire 028A","E01028950","Total",978,264,138,126,714,38,199,122,174,30,42,109
"2011","Shropshire 028B","E01028960","Total",540,130,64,66,410,6,109,71,106,10,33,75
"2011","Shropshire 028C","E01028961","Total",525,111,52,59,414,13,87,90,105,12,40,67
"2011","Shropshire 028D","E01028980","Total",938,244,121,123,694,24,191,104,192,29,36,118
"2011","Shropshire 030A","E01028991","Total",519,138,69,69,381,17,105,55,98,14,37,55
"2011","Shropshire 030B","E01028992","Total",691,246,126,120,445,28,110,68,123,10,38,68
"2011","Shropshire 030D","E01033529","Total",431,96,48,48,335,6,81,52,99,10,21,66
"2011","Shropshire 030E","E01033530","Total",831,225,100,125,606,24,136,97,165,30,46,108
"2011","Shropshire 032A","E01028990","Total",467,86,54,32,381,12,101,64,90,17,30,67
"2011","Shropshire 032B","E01028997","Total",1075,347,233,114,728,22,317,84,170,15,34,86
"2011","Shropshire 032C","E01028998","Total",1105,364,217,147,741,28,253,101,204,18,39,98
"2011","Shropshire 036A","E01028993","Total",618,121,56,65,497,11,137,85,133,20,35,76
"2011","Shropshire 036B","E01029004","Total",447,107,52,55,340,9,95,52,106,2,14,62
"2011","Shropshire 036C","E01029013","Total",780,234,111,123,546,18,179,81,149,12,29,78
"2011","Shropshire 036D","E01029014","Total",504,158,80,78,346,51,60,64,68,22,23,58
"2011","Shropshire 036E","E01029015","Total",597,147,59,88,450,9,124,59,134,21,28,75
"2011","Shropshire 037A","E01028994","Total",557,179,106,73,378,6,133,55,88,21,21,54
"2011","Shropshire 037B","E01029003","Total",1040,287,136,151,753,18,245,95,216,31,38,110
"2011","Shropshire 037C","E01029005","Total",558,170,83,87,388,8,120,66,104,17,26,47
"2011","Shropshire 037D","E01029016","Total",595,147,75,72,448,10,149,63,118,15,29,64
"2011","Shropshire 038A","E01029006","Total",753,268,175,93,485,20,184,64,110,22,23,62
"2011","Shropshire 038B","E01029007","Total",504,168,59,109,336,42,69,58,77,21,24,45
"2011","Shropshire 038D","E01029009","Total",554,180,104,76,374,15,122,55,113,8,13,48
"2011","Shropshire 038E","E01029010","Total",582,162,61,101,420,30,64,68,138,28,27,65
"2011","Shropshire 038F","E01029011","Total",683,224,118,106,459,29,117,69,137,14,24,69
"2011","Shropshire 038G","E01029012","Total",796,194,70,124,602,47,145,118,157,41,37,57
"2011","Shropshire 038H","E01033526","Total",615,363,165,198,252,18,68,23,96,6,5,36
"2011","Shropshire 038I","E01033527","Total",686,327,185,142,359,10,155,33,106,5,10,40
"2011","Shropshire 039A","E01028995","Total",641,157,93,64,484,17,125,97,111,16,42,76
"2011","Shropshire 039B","E01028996","Total",573,152,78,74,421,11,140,69,106,8,25,62
"2011","Shropshire 039C","E01028999","Total",654,157,92,65,497,14,136,62,138,20,40,87
"2011","Shropshire 039D","E01029000","Total",477,111,58,53,366,8,118,33,106,12,26,63
"2011","Shropshire 039E","E01029001","Total",798,166,70,96,632,28,177,121,145,25,51,85
"2011","Shropshire 039F","E01029002","Total",551,156,81,75,395,29,95,68,90,16,36,61
"2011","Stoke-on-Trent 001A","E01014257","Total",640,185,77,108,455,40,73,72,144,26,21,79
"2011","Stoke-on-Trent 001B","E01014258","Total",541,80,22,58,461,20,30,116,127,17,54,97
"2011","Stoke-on-Trent 001C","E01014259","Total",647,179,85,94,468,31,107,66,148,10,22,84
"2011","Stoke-on-Trent 001D","E01014260","Total",604,215,109,106,389,36,86,57,109,19,26,56
"2011","Stoke-on-Trent 001E","E01014264","Total",772,193,100,93,579,46,93,125,146,16,52,101
"2011","Stoke-on-Trent 002A","E01014357","Total",705,270,131,139,435,58,102,67,111,16,24,57
"2011","Stoke-on-Trent 002B","E01014358","Total",590,193,75,118,397,79,53,65,88,19,31,62
"2011","Stoke-on-Trent 002C","E01014359","Total",758,216,79,137,542,65,93,104,131,21,50,78
"2011","Stoke-on-Trent 002D","E01014360","Total",784,156,67,89,628,54,66,164,191,25,38,90
"2011","Stoke-on-Trent 003A","E01014261","Total",577,180,65,115,397,83,40,68,84,29,27,66
"2011","Stoke-on-Trent 003B","E01014262","Total",528,146,77,69,382,37,68,63,79,21,40,74
"2011","Stoke-on-Trent 003C","E01014263","Total",624,130,30,100,494,59,42,109,111,36,43,94
"2011","Stoke-on-Trent 003D","E01014333","Total",605,123,53,70,482,25,95,92,147,10,25,88
"2011","Stoke-on-Trent 003E","E01014334","Total",756,322,245,77,434,13,159,37,125,8,20,72
"2011","Stoke-on-Trent 004A","E01014331","Total",639,186,74,112,453,61,79,83,102,21,39,68
"2011","Stoke-on-Trent 004B","E01014332","Total",790,240,153,87,550,17,172,82,152,7,29,91
"2011","Stoke-on-Trent 004C","E01014335","Total",751,223,79,144,528,31,110,106,148,13,36,84
"2011","Stoke-on-Trent 004D","E01014336","Total",717,274,86,188,443,53,63,78,122,27,40,60
"2011","Stoke-on-Trent 004E","E01014337","Total",722,205,94,111,517,46,95,100,126,26,29,95
"2011","Stoke-on-Trent 005A","E01014354","Total",846,374,136,238,472,84,78,94,119,18,30,49
"2011","Stoke-on-Trent 005B","E01014355","Total",753,250,84,166,503,51,50,99,134,35,62,72
"2011","Stoke-on-Trent 005C","E01014356","Total",746,243,64,179,503,56,72,96,128,21,56,74
"2011","Stoke-on-Trent 005D","E01014361","Total",667,221,39,182,446,93,31,84,111,16,49,62
"2011","Stoke-on-Trent 006A","E01014241","Total",656,201,83,118,455,51,68,61,120,26,38,91
"2011","Stoke-on-Trent 006B","E01014242","Total",628,201,98,103,427,56,79,81,90,17,37,67
"2011","Stoke-on-Trent 006C","E01014243","Total",599,159,72,87,440,16,104,74,118,7,34,87
"2011","Stoke-on-Trent 006D","E01014244","Total",606,157,65,92,449,82,50,95,101,31,39,51
"2011","Stoke-on-Trent 006E","E01014245","Total",706,201,81,120,505,31,78,114,131,23,52,76
"2011","Stoke-on-Trent 006F","E01014248","Total",660,234,51,183,426,49,45,107,122,9,22,72
"2011","Stoke-on-Trent 007A","E01014214","Total",628,134,84,50,494,12,151,72,128,9,21,101
"2011","Stoke-on-Trent 007B","E01014215","Total",610,143,88,55,467,21,101,100,96,21,20,108
"2011","Stoke-on-Trent 007C","E01014216","Total",634,179,125,54,455,28,113,79,137,6,16,76
"2011","Stoke-on-Trent 007D","E01014265","Total",681,179,91,88,502,18,120,101,144,6,25,88
"2011","Stoke-on-Trent 007E","E01014267","Total",1060,335,112,223,725,63,118,155,246,20,31,92
"2011","Stoke-on-Trent 007F","E01014272","Total",661,200,98,102,461,31,110,76,129,12,19,84
"2011","Stoke-on-Trent 008A","E01014246","Total",728,267,99,168,461,54,78,83,125,16,38,67
"2011","Stoke-on-Trent 008B","E01014266","Total",577,206,91,115,371,42,77,73,97,8,18,56
"2011","Stoke-on-Trent 008C","E01014268","Total",998,390,202,188,608,67,104,155,171,20,30,61
"2011","Stoke-on-Trent 008D","E01014270","Total",650,159,92,67,491,32,115,90,122,8,35,89
"2011","Stoke-on-Trent 008E","E01014271","Total",615,149,61,88,466,38,89,93,98,26,29,93
"2011","Stoke-on-Trent 009A","E01014247","Total",776,285,86,199,491,64,71,76,152,22,33,73
"2011","Stoke-on-Trent 009B","E01014250","Total",537,230,94,136,307,47,59,54,66,15,18,48
"2011","Stoke-on-Trent 009C","E01014251","Total",912,425,103,322,487,53,67,99,166,23,36,43
"2011","Stoke-on-Trent 009D","E01014252","Total",748,253,52,201,495,65,52,98,154,16,33,77
"2011","Stoke-on-Trent 009E","E01014255","Total",692,221,57,164,471,50,44,90,104,58,66,59
"2011","Stoke-on-Trent 010A","E01014269","Total",668,220,103,117,448,68,61,98,80,24,46,71
"2011","Stoke-on-Trent 010B","E01014324","Total",684,226,127,99,458,31,133,60,115,9,24,86
"2011","Stoke-on-Trent 010C","E01014325","Total",518,101,29,72,417,18,40,76,118,11,36,118
"2011","Stoke-on-Trent 010D","E01014326","Total",589,115,43,72,474,21,74,84,131,11,35,118
"2011","Stoke-on-Trent 011A","E01014249","Total",782,372,93,279,410,58,57,64,94,35,54,48
"2011","Stoke-on-Trent 011B","E01014253","Total",657,188,77,111,469,32,73,98,127,12,34,93
"2011","Stoke-on-Trent 011C","E01014254","Total",643,242,46,196,401,54,38,86,92,32,36,63
"2011","Stoke-on-Trent 011D","E01014256","Total",775,304,122,182,471,54,91,79,138,20,33,56
"2011","Stoke-on-Trent 012A","E01014210","Total",612,183,82,101,429,42,90,59,88,21,42,87
"2011","Stoke-on-Trent 012B","E01014211","Total",622,184,91,93,438,52,73,65,106,24,38,80
"2011","Stoke-on-Trent 012C","E01014212","Total",610,240,134,106,370,42,68,74,81,14,19,72
"2011","Stoke-on-Trent 012D","E01014213","Total",521,140,40,100,381,47,59,63,102,13,28,69
"2011","Stoke-on-Trent 012E","E01014217","Total",639,233,92,141,406,72,75,84,73,11,24,67
"2011","Stoke-on-Trent 013A","E01014323","Total",609,223,59,164,386,60,48,74,115,12,15,62
"2011","Stoke-on-Trent 013B","E01014327","Total",675,233,70,163,442,52,65,100,126,10,29,60
"2011","Stoke-on-Trent 013C","E01014328","Total",640,240,72,168,400,40,49,73,116,11,32,79
"2011","Stoke-on-Trent 013D","E01014329","Total",723,265,128,137,458,64,73,96,131,14,26,54
"2011","Stoke-on-Trent 013E","E01014330","Total",912,558,147,411,354,44,41,65,111,15,28,50
"2011","Stoke-on-Trent 014A","E01014218","Total",612,183,78,105,429,66,58,72,85,24,42,82
"2011","Stoke-on-Trent 014B","E01014219","Total",584,181,87,94,403,20,95,63,116,9,30,70
"2011","Stoke-on-Trent 014C","E01014225","Total",668,194,94,100,474,32,119,79,133,7,24,80
"2011","Stoke-on-Trent 014D","E01014226","Total",723,320,224,96,403,29,94,51,110,14,33,72
"2011","Stoke-on-Trent 014E","E01014228","Total",573,113,61,52,460,21,131,52,144,9,18,85
"2011","Stoke-on-Trent 014F","E01014230","Total",686,233,102,131,453,44,90,79,126,13,20,81
"2011","Stoke-on-Trent 015A","E01014281","Total",622,219,27,192,403,33,26,53,87,29,40,135
"2011","Stoke-on-Trent 015B","E01014285","Total",918,323,96,227,595,47,51,130,171,40,50,106
"2011","Stoke-on-Trent 015C","E01014286","Total",544,222,58,164,322,35,43,54,61,30,37,62
"2011","Stoke-on-Trent 015D","E01014287","Total",635,275,51,224,360,46,51,53,74,31,37,68
"2011","Stoke-on-Trent 016B","E01014231","Total",947,628,144,484,319,20,43,52,138,11,19,36
"2011","Stoke-on-Trent 016D","E01014282","Total",493,293,41,252,200,16,31,15,50,10,22,56
"2011","Stoke-on-Trent 016E","E01014283","Total",806,284,40,244,522,19,28,43,154,17,22,239
"2011","Stoke-on-Trent 016F","E01014284","Total",468,76,10,66,392,4,12,19,93,9,20,235
"2011","Stoke-on-Trent 016G","E01033216","Total",1186,450,147,303,736,52,140,126,255,16,28,119
"2011","Stoke-on-Trent 017A","E01014220","Total",717,251,101,150,466,86,60,93,109,18,31,69
"2011","Stoke-on-Trent 017B","E01014221","Total",657,205,62,143,452,70,54,81,101,22,39,85
"2011","Stoke-on-Trent 017C","E01014222","Total",647,228,77,151,419,79,48,78,86,21,37,70
"2011","Stoke-on-Trent 017D","E01014223","Total",749,300,84,216,449,80,71,74,109,16,29,70
"2011","Stoke-on-Trent 017E","E01014224","Total",671,232,91,141,439,75,81,78,86,24,28,67
"2011","Stoke-on-Trent 017F","E01014229","Total",771,248,108,140,523,107,70,116,128,25,34,43
"2011","Stoke-on-Trent 018A","E01014288","Total",728,251,68,183,477,41,48,88,168,14,28,90
"2011","Stoke-on-Trent 018B","E01014289","Total",666,171,62,109,495,20,88,83,170,17,30,87
"2011","Stoke-on-Trent 018C","E01014290","Total",673,216,58,158,457,35,63,99,147,16,26,71
"2011","Stoke-on-Trent 018D","E01014291","Total",624,247,70,177,377,25,46,66,129,17,24,70
"2011","Stoke-on-Trent 018E","E01014292","Total",692,210,58,152,482,30,66,79,162,18,32,95
"2011","Stoke-on-Trent 018F","E01014294","Total",597,252,85,167,345,30,53,54,100,10,48,50
"2011","Stoke-on-Trent 019A","E01014293","Total",772,289,42,247,483,56,41,83,178,12,23,90
"2011","Stoke-on-Trent 019B","E01014295","Total",794,281,124,157,513,25,136,106,130,13,28,75
"2011","Stoke-on-Trent 019C","E01014339","Total",803,317,70,247,486,61,46,102,167,12,14,84
"2011","Stoke-on-Trent 019D","E01014340","Total",863,306,92,214,557,69,60,123,181,15,27,82
"2011","Stoke-on-Trent 019E","E01014345","Total",893,449,93,356,444,51,52,77,153,20,17,74
"2011","Stoke-on-Trent 020A","E01014274","Total",858,304,90,214,554,93,82,113,168,19,22,57
"2011","Stoke-on-Trent 020B","E01014275","Total",754,390,159,231,364,62,60,61,99,14,25,43
"2011","Stoke-on-Trent 020C","E01014276","Total",735,268,75,193,467,58,68,101,134,9,26,71
"2011","Stoke-on-Trent 020D","E01014277","Total",711,228,88,140,483,32,87,93,152,12,25,82
"2011","Stoke-on-Trent 020E","E01014279","Total",803,299,55,244,504,60,67,100,163,16,35,63
"2011","Stoke-on-Trent 021A","E01014273","Total",577,193,34,159,384,78,34,80,112,12,23,45
"2011","Stoke-on-Trent 021B","E01014278","Total",588,177,52,125,411,37,63,72,133,14,24,68
"2011","Stoke-on-Trent 021C","E01014280","Total",610,191,74,117,419,27,89,67,132,4,21,79
"2011","Stoke-on-Trent 021D","E01014297","Total",487,71,16,55,416,22,39,78,129,11,33,104
"2011","Stoke-on-Trent 022A","E01014296","Total",608,163,54,109,445,31,69,81,136,18,28,82
"2011","Stoke-on-Trent 022B","E01014298","Total",687,231,70,161,456,57,59,87,122,19,47,65
"2011","Stoke-on-Trent 022C","E01014300","Total",623,211,100,111,412,58,58,80,102,10,32,72
"2011","Stoke-on-Trent 022D","E01014302","Total",926,416,174,242,510,61,107,80,149,21,35,57
"2011","Stoke-on-Trent 023A","E01014338","Total",676,244,77,167,432,17,90,81,123,9,32,80
"2011","Stoke-on-Trent 023B","E01014341","Total",764,254,70,184,510,18,76,85,165,26,37,103
"2011","Stoke-on-Trent 023C","E01014342","Total",598,170,94,76,428,56,67,74,86,26,41,78
"2011","Stoke-on-Trent 023D","E01014343","Total",843,327,84,243,516,51,52,107,181,25,25,75
"2011","Stoke-on-Trent 023E","E01014344","Total",615,181,68,113,434,43,59,87,100,27,42,76
"2011","Stoke-on-Trent 024A","E01014363","Total",624,173,112,61,451,23,154,47,121,10,27,69
"2011","Stoke-on-Trent 024B","E01014364","Total",597,173,75,98,424,27,84,86,126,12,34,55
"2011","Stoke-on-Trent 024C","E01014365","Total",638,155,91,64,483,25,151,60,123,3,31,90
"2011","Stoke-on-Trent 024D","E01014369","Total",556,132,67,65,424,36,95,58,130,10,29,66
"2011","Stoke-on-Trent 025A","E01014299","Total",598,136,46,90,462,31,57,82,165,10,27,90
"2011","Stoke-on-Trent 025B","E01014301","Total",651,122,32,90,529,27,43,159,147,12,50,91
"2011","Stoke-on-Trent 025C","E01014303","Total",656,139,38,101,517,35,57,118,177,13,33,84
"2011","Stoke-on-Trent 025D","E01014304","Total",645,196,93,103,449,29,113,76,116,15,30,70
"2011","Stoke-on-Trent 025E","E01014362","Total",586,114,60,54,472,16,101,92,145,11,30,77
"2011","Stoke-on-Trent 026A","E01014233","Total",629,177,108,69,452,19,139,64,117,13,28,72
"2011","Stoke-on-Trent 026B","E01014234","Total",564,108,46,62,456,57,45,99,95,28,56,76
"2011","Stoke-on-Trent 026C","E01014239","Total",601,149,74,75,452,17,91,83,113,19,48,81
"2011","Stoke-on-Trent 026D","E01014240","Total",626,178,83,95,448,31,74,85,112,26,35,85
"2011","Stoke-on-Trent 027A","E01014308","Total",768,262,151,111,506,16,142,73,126,6,35,108
"2011","Stoke-on-Trent 027B","E01014309","Total",599,259,121,138,340,33,92,62,79,9,20,45
"2011","Stoke-on-Trent 027C","E01014311","Total",617,217,90,127,400,39,89,55,116,12,23,66
"2011","Stoke-on-Trent 027D","E01014313","Total",830,402,250,152,428,30,134,71,100,15,21,57
"2011","Stoke-on-Trent 028A","E01014321","Total",642,192,68,124,450,24,87,80,134,13,28,84
"2011","Stoke-on-Trent 028B","E01014366","Total",809,311,105,206,498,62,92,97,97,38,42,70
"2011","Stoke-on-Trent 028C","E01014367","Total",666,267,102,165,399,60,63,80,91,20,35,50
"2011","Stoke-on-Trent 028D","E01014368","Total",676,206,87,119,470,67,79,86,98,21,35,84
"2011","Stoke-on-Trent 029A","E01014305","Total",481,157,48,109,324,34,36,53,53,40,59,49
"2011","Stoke-on-Trent 029B","E01014306","Total",539,182,44,138,357,50,33,65,84,18,47,60
"2011","Stoke-on-Trent 029C","E01014307","Total",462,129,33,96,333,50,29,48,57,34,67,48
"2011","Stoke-on-Trent 029D","E01014312","Total",593,173,83,90,420,29,88,76,100,17,34,76
"2011","Stoke-on-Trent 030A","E01014346","Total",729,217,129,88,512,11,149,82,146,7,16,101
"2011","Stoke-on-Trent 030B","E01014348","Total",615,163,106,57,452,13,161,75,115,13,17,58
"2011","Stoke-on-Trent 030C","E01014349","Total",642,182,123,59,460,15,140,79,117,4,26,79
"2011","Stoke-on-Trent 030D","E01014353","Total",706,202,93,109,504,72,58,108,129,20,36,81
"2011","Stoke-on-Trent 031A","E01014310","Total",751,146,56,90,605,30,92,163,143,29,66,82
"2011","Stoke-on-Trent 031B","E01014314","Total",523,86,26,60,437,11,64,97,114,17,42,92
"2011","Stoke-on-Trent 031C","E01014316","Total",616,196,81,115,420,78,40,89,78,32,49,54
"2011","Stoke-on-Trent 031D","E01014317","Total",692,255,127,128,437,64,73,86,93,20,28,73
"2011","Stoke-on-Trent 031E","E01014322","Total",656,179,59,120,477,40,68,79,126,28,63,73
"2011","Stoke-on-Trent 032A","E01014235","Total",765,343,128,215,422,47,88,63,97,15,36,76
"2011","Stoke-on-Trent 032B","E01014236","Total",986,331,99,232,655,87,66,160,171,32,57,82
"2011","Stoke-on-Trent 032C","E01014237","Total",777,377,83,294,400,58,57,76,92,19,37,61
"2011","Stoke-on-Trent 032D","E01014238","Total",666,259,71,188,407,52,60,61,109,37,30,58
"2011","Stoke-on-Trent 033A","E01014315","Total",598,131,76,55,467,9,142,65,145,5,20,81
"2011","Stoke-on-Trent 033B","E01014318","Total",597,146,69,77,451,14,78,102,121,10,33,93
"2011","Stoke-on-Trent 033C","E01014319","Total",597,135,65,70,462,36,76,117,104,10,44,75
"2011","Stoke-on-Trent 033D","E01014320","Total",477,75,18,57,402,19,42,90,104,13,36,98
"2011","Stoke-on-Trent 034A","E01014347","Total",583,123,45,78,460,16,67,87,154,6,30,100
"2011","Stoke-on-Trent 034B","E01014350","Total",553,98,56,42,455,13,116,77,124,6,34,85
"2011","Stoke-on-Trent 034C","E01014351","Total",566,144,37,107,422,15,65,90,139,11,18,84
"2011","Stoke-on-Trent 034D","E01014352","Total",579,116,66,50,463,7,87,96,159,6,16,92
"2011","Telford and Wrekin 001A","E01014171","Total",591,174,95,79,417,42,85,70,93,12,16,99
"2011","Telford and Wrekin 001B","E01014172","Total",518,81,40,41,437,16,73,84,107,17,32,108
"2011","Telford and Wrekin 001C","E01014173","Total",663,201,106,95,462,23,93,89,131,16,19,91
"2011","Telford and Wrekin 001D","E01014174","Total",593,102,54,48,491,10,85,128,118,20,43,87
"2011","Telford and Wrekin 002A","E01014112","Total",624,121,72,49,503,15,118,96,124,12,36,102
"2011","Telford and Wrekin 002B","E01014131","Total",584,108,67,41,476,4,90,77,136,22,38,109
"2011","Telford and Wrekin 002C","E01014132","Total",450,98,66,32,352,14,105,55,77,7,21,73
"2011","Telford and Wrekin 002D","E01014135","Total",477,83,31,52,394,11,96,65,99,13,32,78
"2011","Telford and Wrekin 003A","E01014175","Total",507,149,78,71,358,26,76,71,93,11,14,67
"2011","Telford and Wrekin 003B","E01014176","Total",632,165,94,71,467,20,130,64,116,15,26,96
"2011","Telford and Wrekin 003C","E01014177","Total",584,148,84,64,436,20,103,69,114,10,30,90
"2011","Telford and Wrekin 003D","E01014178","Total",665,249,109,140,416,26,66,62,154,7,19,82
"2011","Telford and Wrekin 004A","E01014111","Total",625,134,75,59,491,13,124,94,130,21,26,83
"2011","Telford and Wrekin 004B","E01014167","Total",688,106,37,69,582,39,52,181,138,26,54,92
"2011","Telford and Wrekin 004C","E01014168","Total",501,57,22,35,444,20,63,119,115,17,44,66
"2011","Telford and Wrekin 004D","E01014170","Total",658,187,120,67,471,25,141,77,117,13,33,65
"2011","Telford and Wrekin 005A","E01014125","Total",659,224,71,153,435,41,59,76,114,27,37,81
"2011","Telford and Wrekin 005B","E01014126","Total",597,160,90,70,437,32,113,63,96,18,45,70
"2011","Telford and Wrekin 005C","E01014127","Total",644,148,42,106,496,52,53,105,118,39,44,85
"2011","Telford and Wrekin 005D","E01014128","Total",814,209,101,108,605,38,80,142,175,30,51,89
"2011","Telford and Wrekin 005E","E01014169","Total",703,166,30,136,537,69,30,141,178,29,38,52
"2011","Telford and Wrekin 006A","E01014129","Total",534,247,110,137,287,15,83,46,80,11,10,42
"2011","Telford and Wrekin 006B","E01014130","Total",579,129,58,71,450,31,77,82,137,14,32,77
"2011","Telford and Wrekin 006C","E01014179","Total",487,102,63,39,385,17,105,68,91,10,23,71
"2011","Telford and Wrekin 006D","E01014180","Total",586,186,107,79,400,20,111,63,88,14,26,78
"2011","Telford and Wrekin 006E","E01014189","Total",589,107,43,64,482,35,60,105,141,22,40,79
"2011","Telford and Wrekin 006F","E01014190","Total",607,83,23,60,524,22,57,121,133,12,62,117
"2011","Telford and Wrekin 007A","E01014102","Total",674,110,47,63,564,18,85,137,157,18,54,95
"2011","Telford and Wrekin 007B","E01014103","Total",473,100,55,45,373,8,56,77,94,16,31,91
"2011","Telford and Wrekin 007C","E01014138","Total",603,173,75,98,430,40,64,74,116,25,40,71
"2011","Telford and Wrekin 007D","E01014140","Total",615,195,54,141,420,41,57,77,107,16,40,82
"2011","Telford and Wrekin 008A","E01014205","Total",596,145,88,57,451,6,125,62,135,17,22,84
"2011","Telford and Wrekin 008B","E01014206","Total",511,100,41,59,411,39,78,69,93,22,41,69
"2011","Telford and Wrekin 008C","E01014207","Total",492,83,39,44,409,17,70,80,118,13,40,71
"2011","Telford and Wrekin 008D","E01014208","Total",534,162,76,86,372,43,76,60,107,18,27,41
"2011","Telford and Wrekin 008E","E01014209","Total",591,159,94,65,432,22,105,68,89,16,44,88
"2011","Telford and Wrekin 009A","E01014137","Total",519,59,21,38,460,20,56,135,94,18,45,92
"2011","Telford and Wrekin 009B","E01014139","Total",517,147,94,53,370,22,45,83,75,29,45,71
"2011","Telford and Wrekin 009C","E01014141","Total",1086,237,62,175,849,110,70,219,245,35,57,113
"2011","Telford and Wrekin 009D","E01014142","Total",450,89,45,44,361,53,37,56,59,41,53,62
"2011","Telford and Wrekin 009E","E01014143","Total",602,179,89,90,423,41,73,86,92,19,41,71
"2011","Telford and Wrekin 010A","E01014136","Total",693,195,111,84,498,15,144,81,136,11,26,85
"2011","Telford and Wrekin 010B","E01014148","Total",700,226,58,168,474,17,84,72,197,13,28,63
"2011","Telford and Wrekin 010C","E01014149","Total",435,95,46,49,340,13,62,56,125,9,18,57
"2011","Telford and Wrekin 010D","E01014202","Total",899,167,59,108,732,28,116,165,210,27,63,123
"2011","Telford and Wrekin 010E","E01014203","Total",618,149,88,61,469,15,117,107,96,10,51,73
"2011","Telford and Wrekin 010F","E01014204","Total",750,147,61,86,603,25,103,126,148,31,48,122
"2011","Telford and Wrekin 011A","E01014104","Total",641,125,53,72,516,41,85,91,136,28,58,77
"2011","Telford and Wrekin 011B","E01014105","Total",698,174,64,110,524,64,65,90,106,45,62,92
"2011","Telford and Wrekin 011C","E01014113","Total",645,232,87,145,413,31,45,62,116,32,53,74
"2011","Telford and Wrekin 011D","E01014114","Total",647,228,113,115,419,11,96,61,140,12,37,62
"2011","Telford and Wrekin 012A","E01014133","Total",773,232,79,153,541,40,133,86,141,13,25,103
"2011","Telford and Wrekin 012B","E01014134","Total",590,166,119,47,424,11,143,67,105,14,22,62
"2011","Telford and Wrekin 012C","E01014144","Total",656,206,102,104,450,43,109,75,99,18,35,71
"2011","Telford and Wrekin 012D","E01014145","Total",874,355,111,244,519,52,67,98,195,16,30,61
"2011","Telford and Wrekin 013A","E01014185","Total",790,308,159,149,482,49,107,62,139,12,36,77
"2011","Telford and Wrekin 013B","E01014186","Total",627,187,87,100,440,46,60,86,135,16,25,72
"2011","Telford and Wrekin 013C","E01014187","Total",669,210,65,145,459,29,91,89,142,9,33,66
"2011","Telford and Wrekin 013D","E01014188","Total",607,123,48,75,484,25,62,106,161,10,33,87
"2011","Telford and Wrekin 014A","E01014150","Total",686,150,53,97,536,24,94,98,183,14,39,84
"2011","Telford and Wrekin 014B","E01014151","Total",639,192,98,94,447,48,76,94,102,20,38,69
"2011","Telford and Wrekin 014C","E01014152","Total",587,173,103,70,414,43,112,57,99,7,31,65
"2011","Telford and Wrekin 014D","E01014153","Total",793,285,106,179,508,40,82,104,144,12,28,98
"2011","Telford and Wrekin 014E","E01014154","Total",682,156,47,109,526,27,71,127,160,16,31,94
"2011","Telford and Wrekin 014F","E01014155","Total",676,169,83,86,507,43,90,103,125,21,40,85
"2011","Telford and Wrekin 015A","E01014181","Total",667,81,15,66,586,23,36,186,144,30,60,107
"2011","Telford and Wrekin 015B","E01014182","Total",469,82,31,51,387,16,56,77,122,13,36,67
"2011","Telford and Wrekin 015C","E01014183","Total",602,106,53,53,496,15,118,94,127,13,36,93
"2011","Telford and Wrekin 015D","E01014184","Total",529,81,37,44,448,31,68,121,98,19,31,80
"2011","Telford and Wrekin 016A","E01014146","Total",776,122,29,93,654,43,71,188,190,33,51,78
"2011","Telford and Wrekin 016B","E01014147","Total",783,128,46,82,655,44,62,154,220,31,44,100
"2011","Telford and Wrekin 016C","E01014156","Total",796,171,37,134,625,64,35,173,162,39,55,97
"2011","Telford and Wrekin 016D","E01014157","Total",530,88,23,65,442,14,37,99,123,19,52,98
"2011","Telford and Wrekin 016E","E01014158","Total",643,171,47,124,472,28,43,128,156,17,28,72
"2011","Telford and Wrekin 017A","E01014124","Total",755,276,122,154,479,64,78,72,139,24,30,72
"2011","Telford and Wrekin 017B","E01014163","Total",516,106,44,62,410,59,60,71,68,24,43,85
"2011","Telford and Wrekin 017C","E01014164","Total",691,220,73,147,471,82,71,80,102,35,34,67
"2011","Telford and Wrekin 017D","E01014165","Total",586,186,61,125,400,46,43,78,94,20,33,86
"2011","Telford and Wrekin 017E","E01014166","Total",641,165,70,95,476,33,67,101,133,20,40,82
"2011","Telford and Wrekin 018A","E01014191","Total",731,225,46,179,506,60,45,75,161,25,36,104
"2011","Telford and Wrekin 018B","E01014192","Total",480,70,27,43,410,36,40,84,78,28,41,103
"2011","Telford and Wrekin 018C","E01014193","Total",610,106,36,70,504,59,54,101,116,26,47,101
"2011","Telford and Wrekin 018D","E01014194","Total",595,139,47,92,456,52,58,81,116,21,49,79
"2011","Telford and Wrekin 018E","E01014195","Total",523,80,36,44,443,16,60,81,117,23,40,106
"2011","Telford and Wrekin 018F","E01014196","Total",649,192,105,87,457,51,73,67,117,26,35,88
"2011","Telford and Wrekin 019A","E01014119","Total",678,156,89,67,522,24,95,92,146,23,51,91
"2011","Telford and Wrekin 019B","E01014120","Total",767,270,129,141,497,58,71,92,120,31,38,87
"2011","Telford and Wrekin 019C","E01014121","Total",614,171,78,93,443,22,108,57,119,10,30,97
"2011","Telford and Wrekin 019D","E01014122","Total",731,240,34,206,491,62,42,95,191,12,28,61
"2011","Telford and Wrekin 019E","E01014123","Total",617,126,39,87,491,31,46,116,166,12,34,86
"2011","Telford and Wrekin 020A","E01014106","Total",618,145,46,99,473,43,70,94,120,29,44,73
"2011","Telford and Wrekin 020B","E01014107","Total",475,79,35,44,396,7,90,54,130,13,25,77
"2011","Telford and Wrekin 020C","E01014108","Total",645,241,34,207,404,74,34,82,104,24,36,50
"2011","Telford and Wrekin 020D","E01014109","Total",463,81,17,64,382,46,46,78,113,12,26,61
"2011","Telford and Wrekin 020E","E01014110","Total",470,62,17,45,408,76,24,86,67,32,54,69
"2011","Telford and Wrekin 021A","E01014197","Total",552,102,42,60,450,64,59,80,105,28,41,73
"2011","Telford and Wrekin 021B","E01014198","Total",412,95,43,52,317,61,36,53,65,22,36,44
"2011","Telford and Wrekin 021C","E01014199","Total",604,131,34,97,473,84,30,107,103,35,43,71
"2011","Telford and Wrekin 021D","E01014200","Total",452,73,25,48,379,77,36,75,66,32,32,61
"2011","Telford and Wrekin 021E","E01014201","Total",455,73,29,44,382,74,36,66,84,35,35,52
"2011","Telford and Wrekin 022A","E01014159","Total",594,232,114,118,362,30,78,65,99,10,26,54
"2011","Telford and Wrekin 022B","E01014160","Total",526,108,42,66,418,21,77,69,121,12,39,79
"2011","Telford and Wrekin 022C","E01014161","Total",499,135,53,82,364,27,63,63,115,7,20,69
"2011","Telford and Wrekin 022D","E01014162","Total",810,371,183,188,439,40,82,64,141,19,31,62
"2011","Telford and Wrekin 023A","E01014115","Total",549,144,60,84,405,37,64,69,111,28,25,71
"2011","Telford and Wrekin 023B","E01014116","Total",776,268,142,126,508,68,125,83,131,24,27,50
"2011","Telford and Wrekin 023C","E01014117","Total",485,78,37,41,407,15,126,51,107,9,24,75
"2011","Telford and Wrekin 023D","E01014118","Total",447,105,38,67,342,62,27,60,69,28,31,65
"2011","Cannock Chase 001A","E01029368","Total",510,79,49,30,431,9,149,60,99,2,21,91
"2011","Cannock Chase 001B","E01029369","Total",496,95,41,54,401,23,75,92,107,12,31,61
"2011","Cannock Chase 001C","E01029370","Total",577,126,61,65,451,5,126,61,127,10,38,84
"2011","Cannock Chase 001D","E01029371","Total",610,122,41,81,488,29,69,103,141,21,37,88
"2011","Cannock Chase 001E","E01029402","Total",839,212,125,87,627,18,165,136,168,14,34,92
"2011","Cannock Chase 002A","E01029372","Total",527,147,44,103,380,44,27,75,89,25,51,69
"2011","Cannock Chase 002B","E01029373","Total",881,231,85,146,650,40,84,165,148,33,71,109
"2011","Cannock Chase 002C","E01029401","Total",653,145,69,76,508,37,75,105,151,14,37,89
"2011","Cannock Chase 002D","E01029403","Total",620,166,74,92,454,28,76,102,119,18,31,80
"2011","Cannock Chase 002E","E01029404","Total",800,403,175,228,397,45,79,55,142,14,16,46
"2011","Cannock Chase 003A","E01029345","Total",658,157,66,91,501,45,74,97,141,25,44,75
"2011","Cannock Chase 003B","E01029346","Total",743,248,125,123,495,73,78,115,111,20,40,58
"2011","Cannock Chase 003C","E01029347","Total",642,154,94,60,488,10,151,73,141,6,13,94
"2011","Cannock Chase 003D","E01029348","Total",700,146,82,64,554,33,125,96,136,19,43,102
"2011","Cannock Chase 003E","E01029374","Total",955,223,94,129,732,65,105,167,188,24,51,132
"2011","Cannock Chase 004A","E01029383","Total",617,107,38,69,510,23,66,123,162,11,36,89
"2011","Cannock Chase 004B","E01029385","Total",608,120,57,63,488,13,84,82,172,11,29,97
"2011","Cannock Chase 004C","E01029388","Total",615,205,111,94,410,34,59,83,124,20,20,70
"2011","Cannock Chase 004D","E01029390","Total",453,134,49,85,319,33,41,43,85,18,33,66
"2011","Cannock Chase 005A","E01029384","Total",813,207,87,120,606,29,106,133,181,17,44,96
"2011","Cannock Chase 005B","E01029386","Total",603,154,58,96,449,37,89,94,107,16,22,84
"2011","Cannock Chase 005C","E01029387","Total",639,187,83,104,452,22,85,72,132,19,36,86
"2011","Cannock Chase 005D","E01029389","Total",784,268,74,194,516,38,89,97,186,10,28,68
"2011","Cannock Chase 006A","E01029379","Total",643,105,30,75,538,33,32,178,144,19,47,85
"2011","Cannock Chase 006B","E01029398","Total",690,156,86,70,534,20,125,102,134,18,35,100
"2011","Cannock Chase 006C","E01029399","Total",647,195,50,145,452,22,61,97,138,13,46,75
"2011","Cannock Chase 006D","E01029400","Total",636,141,50,91,495,19,57,103,150,22,50,94
"2011","Cannock Chase 007A","E01029354","Total",647,176,105,71,471,31,85,85,134,15,50,71
"2011","Cannock Chase 007B","E01029355","Total",657,209,109,100,448,37,73,92,110,16,42,78
"2011","Cannock Chase 007C","E01029356","Total",638,194,107,87,444,43,84,90,99,19,29,80
"2011","Cannock Chase 007D","E01029357","Total",551,135,57,78,416,30,73,62,107,15,33,96
"2011","Cannock Chase 007E","E01029358","Total",499,138,51,87,361,45,46,69,76,42,40,43
"2011","Cannock Chase 008A","E01029349","Total",615,211,103,108,404,29,102,63,122,7,23,58
"2011","Cannock Chase 008B","E01029350","Total",678,226,96,130,452,36,93,80,118,18,34,73
"2011","Cannock Chase 008C","E01029351","Total",651,223,56,167,428,66,56,73,110,13,44,66
"2011","Cannock Chase 008D","E01029352","Total",548,122,38,84,426,25,57,77,133,15,23,96
"2011","Cannock Chase 008E","E01029393","Total",756,241,109,132,515,25,120,83,142,9,31,105
"2011","Cannock Chase 009A","E01029380","Total",565,88,24,64,477,19,46,151,114,10,31,106
"2011","Cannock Chase 009B","E01029381","Total",692,234,104,130,458,29,107,82,141,9,22,68
"2011","Cannock Chase 009C","E01029382","Total",726,258,112,146,468,26,95,88,130,15,29,85
"2011","Cannock Chase 009D","E01029391","Total",673,152,64,88,521,16,113,92,139,16,42,103
"2011","Cannock Chase 009E","E01029392","Total",716,111,47,64,605,29,74,168,154,20,57,103
"2011","Cannock Chase 010A","E01029375","Total",893,114,15,99,779,37,48,241,243,31,60,119
"2011","Cannock Chase 010B","E01029376","Total",732,167,22,145,565,50,21,159,178,19,54,84
"2011","Cannock Chase 010C","E01029377","Total",513,71,7,64,442,23,17,132,120,16,52,82
"2011","Cannock Chase 010D","E01029378","Total",659,125,29,96,534,23,48,142,167,20,43,91
"2011","Cannock Chase 011A","E01029353","Total",690,250,122,128,440,25,127,70,124,12,11,71
"2011","Cannock Chase 011B","E01029364","Total",724,214,97,117,510,17,151,74,140,16,24,88
"2011","Cannock Chase 011C","E01029365","Total",652,180,79,101,472,18,96,83,134,11,40,90
"2011","Cannock Chase 011D","E01029366","Total",735,157,110,47,578,9,218,79,124,3,33,112
"2011","Cannock Chase 011E","E01029367","Total",944,293,137,156,651,33,128,132,187,24,42,105
"2011","Cannock Chase 012A","E01029359","Total",744,279,81,198,465,54,49,102,149,15,39,57
"2011","Cannock Chase 012B","E01029360","Total",734,322,152,170,412,42,84,73,114,12,21,66
"2011","Cannock Chase 012C","E01029361","Total",628,184,71,113,444,23,98,81,95,24,39,84
"2011","Cannock Chase 012D","E01029362","Total",685,233,70,163,452,72,52,94,99,16,37,82
"2011","Cannock Chase 012E","E01029363","Total",670,246,119,127,424,15,112,82,105,10,23,77
"2011","Cannock Chase 013A","E01029394","Total",634,152,78,74,482,21,141,62,129,15,24,90
"2011","Cannock Chase 013B","E01029395","Total",683,169,73,96,514,19,129,84,138,6,29,109
"2011","Cannock Chase 013C","E01029396","Total",721,169,72,97,552,27,93,111,175,12,34,100
"2011","Cannock Chase 013D","E01029397","Total",1052,264,122,142,788,82,89,216,173,42,70,116
"2011","East Staffordshire 001A","E01029405","Total",638,134,60,74,504,8,119,81,144,21,42,89
"2011","East Staffordshire 001B","E01029406","Total",474,91,41,50,383,6,71,76,104,15,32,79
"2011","East Staffordshire 001C","E01029422","Total",470,100,46,54,370,12,102,65,94,13,25,59
"2011","East Staffordshire 001D","E01029423","Total",670,192,79,113,478,47,77,94,123,15,41,81
"2011","East Staffordshire 001E","E01029467","Total",900,247,124,123,653,18,169,118,180,20,34,114
"2011","East Staffordshire 002A","E01029430","Total",603,133,74,59,470,17,88,103,138,11,24,89
"2011","East Staffordshire 002B","E01029431","Total",686,205,89,116,481,48,74,91,136,22,42,68
"2011","East Staffordshire 002C","E01029432","Total",632,156,87,69,476,27,135,70,115,13,30,86
"2011","East Staffordshire 002D","E01029433","Total",614,164,84,80,450,40,64,84,106,27,46,83
"2011","East Staffordshire 003A","E01029459","Total",624,150,42,108,474,28,53,133,136,19,33,72
"2011","East Staffordshire 003B","E01029460","Total",786,295,153,142,491,25,91,109,131,18,44,73
"2011","East Staffordshire 003C","E01029461","Total",843,291,124,167,552,35,93,104,169,23,54,74
"2011","East Staffordshire 003D","E01029462","Total",689,228,115,113,461,23,94,89,133,18,32,72
"2011","East Staffordshire 004A","E01029443","Total",707,162,95,67,545,12,159,111,137,14,31,81
"2011","East Staffordshire 004B","E01029444","Total",726,215,142,73,511,14,153,82,139,12,22,89
"2011","East Staffordshire 004C","E01029463","Total",508,115,55,60,393,10,103,69,109,15,31,56
"2011","East Staffordshire 004D","E01029464","Total",693,224,122,102,469,30,103,85,118,16,21,96
"2011","East Staffordshire 004E","E01029465","Total",702,210,108,102,492,25,121,80,164,8,17,77
"2011","East Staffordshire 004F","E01029466","Total",615,124,69,55,491,17,108,98,131,23,35,79
"2011","East Staffordshire 005A","E01029454","Total",642,108,68,40,534,8,134,94,126,16,42,114
"2011","East Staffordshire 005B","E01029455","Total",747,185,117,68,562,25,117,132,129,18,51,90
"2011","East Staffordshire 005C","E01029456","Total",747,299,132,167,448,33,113,79,141,12,24,46
"2011","East Staffordshire 005D","E01029457","Total",533,111,45,66,422,26,42,112,114,14,30,84
"2011","East Staffordshire 005E","E01029458","Total",616,133,82,51,483,22,121,81,118,15,31,95
"2011","East Staffordshire 006A","E01029411","Total",519,105,51,54,414,10,119,76,107,12,29,61
"2011","East Staffordshire 006B","E01029412","Total",576,164,88,76,412,11,104,73,128,13,21,62
"2011","East Staffordshire 006C","E01029424","Total",433,103,61,42,330,4,93,55,90,6,21,61
"2011","East Staffordshire 006D","E01029425","Total",601,124,59,65,477,16,115,83,121,10,34,98
"2011","East Staffordshire 006E","E01029473","Total",562,129,75,54,433,9,114,74,118,19,36,63
"2011","East Staffordshire 006F","E01029474","Total",517,130,78,52,387,12,117,79,98,9,24,48
"2011","East Staffordshire 007A","E01029434","Total",628,177,67,110,451,48,59,100,106,19,44,75
"2011","East Staffordshire 007B","E01029435","Total",641,194,119,75,447,20,128,70,97,18,34,80
"2011","East Staffordshire 007C","E01029436","Total",842,334,113,221,508,69,88,85,134,19,49,64
"2011","East Staffordshire 007D","E01029437","Total",924,269,111,158,655,95,56,153,170,34,52,95
"2011","East Staffordshire 007E","E01029438","Total",638,158,94,64,480,20,129,97,111,9,29,85
"2011","East Staffordshire 008A","E01029426","Total",713,250,69,181,463,49,43,113,123,33,45,57
"2011","East Staffordshire 008B","E01029427","Total",653,235,83,152,418,55,61,64,104,32,37,65
"2011","East Staffordshire 008C","E01029428","Total",645,163,33,130,482,45,53,125,150,19,30,60
"2011","East Staffordshire 008D","E01029429","Total",491,127,38,89,364,35,53,68,71,22,50,65
"2011","East Staffordshire 009A","E01029445","Total",849,329,64,265,520,59,49,101,151,21,42,97
"2011","East Staffordshire 009B","E01029446","Total",743,232,73,159,511,34,94,88,158,21,44,72
"2011","East Staffordshire 009C","E01029447","Total",605,174,34,140,431,40,21,79,102,39,84,66
"2011","East Staffordshire 009D","E01029448","Total",734,305,169,136,429,39,64,69,134,25,43,55
"2011","East Staffordshire 010A","E01029468","Total",693,241,79,162,452,72,53,81,100,37,43,66
"2011","East Staffordshire 010B","E01029469","Total",763,174,104,70,589,28,158,99,159,25,35,85
"2011","East Staffordshire 010C","E01029470","Total",635,157,62,95,478,48,89,97,116,16,42,70
"2011","East Staffordshire 010D","E01029471","Total",685,188,66,122,497,14,91,109,149,20,38,76
"2011","East Staffordshire 010E","E01029472","Total",654,167,78,89,487,49,104,67,117,20,44,86
"2011","East Staffordshire 011A","E01029407","Total",544,155,52,103,389,54,51,59,74,21,51,79
"2011","East Staffordshire 011B","E01029408","Total",825,238,41,197,587,59,42,119,168,38,67,94
"2011","East Staffordshire 011C","E01029409","Total",667,233,54,179,434,37,43,101,96,30,49,78
"2011","East Staffordshire 011D","E01029410","Total",601,196,61,135,405,34,39,81,100,30,48,73
"2011","East Staffordshire 011F","E01032896","Total",564,272,24,248,292,26,18,49,136,4,11,48
"2011","East Staffordshire 011G","E01032897","Total",577,234,75,159,343,20,53,84,128,7,15,36
"2011","East Staffordshire 011H","E01032898","Total",599,297,82,215,302,45,28,47,91,21,29,41
"2011","East Staffordshire 012A","E01029418","Total",823,147,49,98,676,16,105,152,202,20,42,139
"2011","East Staffordshire 012B","E01029419","Total",651,154,66,88,497,19,104,101,150,10,39,74
"2011","East Staffordshire 012C","E01029420","Total",737,223,133,90,514,25,106,113,135,17,33,85
"2011","East Staffordshire 013A","E01029413","Total",655,208,80,128,447,28,77,77,128,11,34,92
"2011","East Staffordshire 013B","E01029414","Total",686,209,55,154,477,17,55,109,166,21,32,77
"2011","East Staffordshire 013C","E01029415","Total",627,131,24,107,496,33,31,149,160,17,49,57
"2011","East Staffordshire 013D","E01029416","Total",538,142,74,68,396,16,106,68,98,12,26,70
"2011","East Staffordshire 013E","E01029417","Total",527,121,76,45,406,22,109,75,122,11,23,44
"2011","East Staffordshire 014A","E01029449","Total",698,195,79,116,503,28,86,81,166,9,26,107
"2011","East Staffordshire 014B","E01029450","Total",617,199,73,126,418,41,66,62,87,18,50,94
"2011","East Staffordshire 014C","E01029451","Total",849,355,151,204,494,45,99,85,155,22,33,55
"2011","East Staffordshire 014D","E01029452","Total",769,316,127,189,453,51,87,76,118,12,31,78
"2011","East Staffordshire 014E","E01029453","Total",703,279,101,178,424,62,76,78,102,20,28,58
"2011","East Staffordshire 015A","E01029439","Total",633,157,95,62,476,17,136,72,134,8,29,80
"2011","East Staffordshire 015B","E01029440","Total",526,119,55,64,407,12,90,91,113,18,24,59
"2011","East Staffordshire 015C","E01029441","Total",670,200,122,78,470,25,108,88,129,11,29,80
"2011","East Staffordshire 015D","E01029442","Total",556,142,92,50,414,14,107,89,101,13,34,56
"2011","Lichfield 001A","E01029480","Total",746,172,60,112,574,26,96,139,170,13,35,95
"2011","Lichfield 001B","E01029481","Total",804,228,119,109,576,24,148,97,177,17,24,89
"2011","Lichfield 001C","E01029482","Total",635,124,65,59,511,34,110,102,127,17,43,78
"2011","Lichfield 001D","E01029498","Total",711,131,80,51,580,14,156,84,151,18,35,122
"2011","Lichfield 002A","E01029477","Total",647,139,73,66,508,12,145,105,131,15,30,70
"2011","Lichfield 002B","E01029478","Total",645,153,104,49,492,16,136,98,102,24,40,76
"2011","Lichfield 002C","E01029479","Total",1040,163,60,103,877,38,107,240,260,41,70,121
"2011","Lichfield 002D","E01029509","Total",668,149,89,60,519,12,140,78,145,15,39,90
"2011","Lichfield 003A","E01029486","Total",615,140,76,64,475,9,144,76,121,4,28,93
"2011","Lichfield 003B","E01029507","Total",636,77,32,45,559,5,125,98,155,24,42,110
"2011","Lichfield 003C","E01029508","Total",919,178,71,107,741,24,156,173,192,28,48,120
"2011","Lichfield 003D","E01029515","Total",775,154,97,57,621,13,213,84,151,9,36,115
"2011","Lichfield 004A","E01029492","Total",767,170,66,104,597,104,88,114,106,29,48,108
"2011","Lichfield 004B","E01029499","Total",736,233,126,107,503,48,109,69,107,22,53,95
"2011","Lichfield 004C","E01029501","Total",613,132,82,50,481,28,119,77,110,20,39,88
"2011","Lichfield 004E","E01029526","Total",851,441,214,227,410,20,97,62,140,7,27,57
"2011","Lichfield 004F","E01032899","Total",831,441,276,165,390,17,132,47,121,7,11,55
"2011","Lichfield 004G","E01032900","Total",792,176,23,153,616,52,20,219,206,33,25,61
"2011","Lichfield 005A","E01029483","Total",617,94,48,46,523,3,135,76,156,19,33,101
"2011","Lichfield 005B","E01029484","Total",824,291,106,185,533,25,123,103,173,9,30,70
"2011","Lichfield 005C","E01029485","Total",650,152,62,90,498,15,106,76,170,14,22,95
"2011","Lichfield 005D","E01029500","Total",734,194,71,123,540,13,105,80,154,10,45,133
"2011","Lichfield 005E","E01029520","Total",602,80,49,31,522,5,128,95,135,21,31,107
"2011","Lichfield 005F","E01029524","Total",725,206,81,125,519,29,114,75,154,19,36,92
"2011","Lichfield 005G","E01029525","Total",750,181,114,67,569,14,176,80,136,15,33,115
"2011","Lichfield 006A","E01029487","Total",704,214,123,91,490,39,102,85,128,22,36,78
"2011","Lichfield 006B","E01029493","Total",810,184,74,110,626,27,115,135,190,20,46,93
"2011","Lichfield 006C","E01029494","Total",646,200,108,92,446,21,88,91,116,10,36,84
"2011","Lichfield 006D","E01029495","Total",671,120,61,59,551,16,103,121,177,15,32,87
"2011","Lichfield 006E","E01029497","Total",862,271,154,117,591,31,121,101,152,19,52,115
"2011","Lichfield 007A","E01029491","Total",775,233,103,130,542,37,131,91,134,22,30,97
"2011","Lichfield 007B","E01029511","Total",682,178,98,80,504,11,135,108,127,13,29,81
"2011","Lichfield 007C","E01029512","Total",762,191,91,100,571,28,109,150,159,14,36,75
"2011","Lichfield 007D","E01029518","Total",1114,252,111,141,862,36,160,209,255,34,53,115
"2011","Lichfield 007E","E01029519","Total",935,282,103,179,653,37,115,140,208,21,35,97
"2011","Lichfield 008A","E01029516","Total",743,132,64,68,611,14,162,110,164,29,40,92
"2011","Lichfield 008B","E01029517","Total",669,128,60,68,541,12,127,88,155,24,26,109
"2011","Lichfield 008C","E01029530","Total",676,148,63,85,528,37,96,117,137,19,40,82
"2011","Lichfield 008D","E01029531","Total",679,123,81,42,556,18,165,108,121,9,36,99
"2011","Lichfield 009A","E01029475","Total",842,188,105,83,654,12,176,131,170,22,35,108
"2011","Lichfield 009B","E01029476","Total",607,161,94,67,446,9,139,75,104,4,27,88
"2011","Lichfield 009C","E01029489","Total",653,138,97,41,515,18,147,79,116,12,28,115
"2011","Lichfield 009D","E01029490","Total",607,143,59,84,464,19,99,88,126,10,33,89
"2011","Lichfield 009E","E01029505","Total",649,142,81,61,507,18,140,88,138,11,27,85
"2011","Lichfield 009F","E01029506","Total",757,131,74,57,626,5,232,81,133,19,36,120
"2011","Lichfield 010A","E01029496","Total",753,213,111,102,540,63,79,93,132,26,55,92
"2011","Lichfield 010B","E01029527","Total",548,170,92,78,378,34,70,75,83,21,24,71
"2011","Lichfield 010C","E01029528","Total",523,125,59,66,398,24,87,92,85,16,21,73
"2011","Lichfield 010D","E01029529","Total",491,100,27,73,391,25,48,107,104,24,23,60
"2011","Lichfield 011A","E01029513","Total",491,69,35,34,422,10,127,58,80,14,51,82
"2011","Lichfield 011B","E01029514","Total",613,132,88,44,481,11,159,55,104,10,38,104
"2011","Lichfield 011C","E01029521","Total",692,152,100,52,540,9,161,89,131,15,40,95
"2011","Lichfield 011D","E01029522","Total",625,148,73,75,477,23,110,69,127,11,41,96
"2011","Lichfield 011E","E01029523","Total",625,114,64,50,511,20,148,90,115,10,33,95
"2011","Lichfield 012A","E01029488","Total",695,147,66,81,548,25,124,91,157,17,42,92
"2011","Lichfield 012B","E01029502","Total",644,126,71,55,518,28,98,94,122,29,44,103
"2011","Lichfield 012C","E01029503","Total",644,136,89,47,508,28,143,83,119,14,33,88
"2011","Lichfield 012D","E01029504","Total",704,234,109,125,470,41,95,76,137,14,24,83
"2011","Newcastle-under-Lyme 001A","E01029562","Total",528,112,41,71,416,17,65,106,105,18,31,74
"2011","Newcastle-under-Lyme 001B","E01029565","Total",468,77,18,59,391,14,42,88,106,14,28,99
"2011","Newcastle-under-Lyme 001C","E01029581","Total",675,175,72,103,500,18,107,116,131,8,25,95
"2011","Newcastle-under-Lyme 001D","E01029582","Total",792,205,109,96,587,26,127,105,168,21,36,104
"2011","Newcastle-under-Lyme 001E","E01029586","Total",541,112,61,51,429,10,115,68,140,4,13,79
"2011","Newcastle-under-Lyme 001F","E01029587","Total",539,138,69,69,401,15,93,91,106,13,14,69
"2011","Newcastle-under-Lyme 002A","E01029561","Total",602,144,82,62,458,55,100,84,95,18,31,75
"2011","Newcastle-under-Lyme 002B","E01029563","Total",601,168,86,82,433,18,103,73,105,14,32,88
"2011","Newcastle-under-Lyme 002C","E01029564","Total",542,138,55,83,404,47,60,71,102,17,37,70
"2011","Newcastle-under-Lyme 002D","E01029588","Total",735,295,111,184,440,32,54,79,148,11,29,87
"2011","Newcastle-under-Lyme 003A","E01029540","Total",636,207,129,78,429,17,117,70,103,9,23,90
"2011","Newcastle-under-Lyme 003B","E01029541","Total",624,164,83,81,460,51,58,85,114,27,47,78
"2011","Newcastle-under-Lyme 003C","E01029542","Total",641,229,74,155,412,29,89,69,132,9,15,69
"2011","Newcastle-under-Lyme 003D","E01029543","Total",474,116,62,54,358,23,67,52,76,17,50,73
"2011","Newcastle-under-Lyme 003E","E01029595","Total",591,175,67,108,416,13,118,62,138,4,12,69
"2011","Newcastle-under-Lyme 003F","E01029597","Total",622,196,79,117,426,33,70,89,99,21,48,66
"2011","Newcastle-under-Lyme 004A","E01029536","Total",644,143,75,68,501,14,141,86,135,11,39,75
"2011","Newcastle-under-Lyme 004B","E01029544","Total",517,117,42,75,400,10,42,72,119,21,38,98
"2011","Newcastle-under-Lyme 004C","E01029545","Total",616,118,34,84,498,30,86,109,138,10,35,90
"2011","Newcastle-under-Lyme 004D","E01029546","Total",484,53,15,38,431,14,27,107,124,22,38,99
"2011","Newcastle-under-Lyme 004E","E01029596","Total",522,131,85,46,391,14,147,34,98,4,23,71
"2011","Newcastle-under-Lyme 005A","E01029532","Total",642,210,100,110,432,14,79,84,128,18,33,76
"2011","Newcastle-under-Lyme 005B","E01029533","Total",651,163,83,80,488,11,97,78,168,13,39,82
"2011","Newcastle-under-Lyme 005C","E01029534","Total",673,180,81,99,493,21,115,83,145,16,27,86
"2011","Newcastle-under-Lyme 005D","E01029535","Total",601,185,79,106,416,43,60,78,105,12,43,75
"2011","Newcastle-under-Lyme 005E","E01029556","Total",1111,349,188,161,762,52,166,133,211,18,44,138
"2011","Newcastle-under-Lyme 006A","E01029537","Total",626,165,80,85,461,35,80,88,100,22,44,92
"2011","Newcastle-under-Lyme 006B","E01029538","Total",715,281,103,178,434,31,75,95,95,28,35,75
"2011","Newcastle-under-Lyme 006C","E01029539","Total",618,144,75,69,474,20,100,114,101,19,41,79
"2011","Newcastle-under-Lyme 006D","E01029552","Total",629,176,96,80,453,30,80,84,133,10,26,90
"2011","Newcastle-under-Lyme 006E","E01029558","Total",638,148,63,85,490,65,68,110,105,31,41,70
"2011","Newcastle-under-Lyme 007A","E01029547","Total",626,227,72,155,399,67,42,93,102,22,27,46
"2011","Newcastle-under-Lyme 007B","E01029548","Total",662,226,91,135,436,62,70,81,113,15,27,68
"2011","Newcastle-under-Lyme 007C","E01029559","Total",588,149,45,104,439,27,59,95,121,11,36,90
"2011","Newcastle-under-Lyme 007D","E01029560","Total",672,213,69,144,459,79,63,73,113,32,27,72
"2011","Newcastle-under-Lyme 007E","E01029568","Total",631,196,85,111,435,38,76,70,121,18,33,79
"2011","Newcastle-under-Lyme 008A","E01029583","Total",682,260,112,148,422,29,80,77,132,9,34,61
"2011","Newcastle-under-Lyme 008B","E01029584","Total",538,184,98,86,354,13,70,84,99,13,10,65
"2011","Newcastle-under-Lyme 008C","E01029585","Total",661,240,74,166,421,43,72,81,101,8,32,84
"2011","Newcastle-under-Lyme 008D","E01029609","Total",767,249,92,157,518,58,70,107,171,10,23,79
"2011","Newcastle-under-Lyme 008E","E01029611","Total",800,349,117,232,451,59,62,101,143,15,23,48
"2011","Newcastle-under-Lyme 009A","E01029577","Total",683,189,76,113,494,26,110,89,169,9,26,65
"2011","Newcastle-under-Lyme 009B","E01029579","Total",766,245,119,126,521,34,108,116,162,8,24,69
"2011","Newcastle-under-Lyme 009C","E01029580","Total",574,126,55,71,448,24,77,89,125,15,38,80
"2011","Newcastle-under-Lyme 009D","E01029610","Total",585,184,76,108,401,18,65,87,126,10,19,76
"2011","Newcastle-under-Lyme 009E","E01029612","Total",495,121,56,65,374,15,86,81,86,14,26,66
"2011","Newcastle-under-Lyme 010A","E01029553","Total",605,195,73,122,410,45,80,71,77,20,38,79
"2011","Newcastle-under-Lyme 010B","E01029554","Total",637,320,115,205,317,33,73,51,85,12,21,42
"2011","Newcastle-under-Lyme 010C","E01029566","Total",504,139,48,91,365,80,44,83,69,16,30,43
"2011","Newcastle-under-Lyme 010D","E01029567","Total",725,244,105,139,481,32,81,108,138,10,28,84
"2011","Newcastle-under-Lyme 010E","E01029598","Total",737,203,75,128,534,61,61,114,138,22,34,104
"2011","Newcastle-under-Lyme 010F","E01029599","Total",734,332,158,174,402,27,100,68,100,11,21,75
"2011","Newcastle-under-Lyme 011A","E01029555","Total",758,248,106,142,510,42,70,82,143,13,38,122
"2011","Newcastle-under-Lyme 011B","E01029578","Total",806,393,132,261,413,18,93,81,111,18,19,73
"2011","Newcastle-under-Lyme 011C","E01029602","Total",946,392,142,250,554,38,69,75,237,4,18,113
"2011","Newcastle-under-Lyme 011D","E01029603","Total",739,327,79,248,412,29,81,58,133,2,25,84
"2011","Newcastle-under-Lyme 011E","E01029604","Total",940,546,147,399,394,38,57,54,143,6,7,89
"2011","Newcastle-under-Lyme 012A","E01029576","Total",550,192,57,135,358,17,88,80,76,20,17,60
"2011","Newcastle-under-Lyme 012B","E01029593","Total",745,247,110,137,498,44,64,93,118,31,32,116
"2011","Newcastle-under-Lyme 012C","E01029594","Total",872,305,150,155,567,44,123,97,163,7,31,102
"2011","Newcastle-under-Lyme 013A","E01029557","Total",551,154,63,91,397,8,104,62,125,5,26,67
"2011","Newcastle-under-Lyme 013B","E01029573","Total",640,194,95,99,446,17,91,99,129,12,28,70
"2011","Newcastle-under-Lyme 013C","E01029574","Total",610,189,97,92,421,13,117,57,108,14,29,83
"2011","Newcastle-under-Lyme 013D","E01029575","Total",435,122,59,63,313,20,59,57,94,15,15,53
"2011","Newcastle-under-Lyme 014A","E01029549","Total",798,305,170,135,493,34,145,75,101,16,25,97
"2011","Newcastle-under-Lyme 014B","E01029551","Total",660,165,81,84,495,23,92,131,115,12,32,90
"2011","Newcastle-under-Lyme 014C","E01029591","Total",738,317,148,169,421,64,93,65,81,13,25,80
"2011","Newcastle-under-Lyme 014D","E01029600","Total",623,177,106,71,446,16,124,85,110,15,24,72
"2011","Newcastle-under-Lyme 014E","E01029605","Total",542,146,82,64,396,13,77,85,121,14,24,62
"2011","Newcastle-under-Lyme 014F","E01029607","Total",639,220,102,118,419,28,109,74,95,16,26,71
"2011","Newcastle-under-Lyme 015B","E01029589","Total",522,130,74,56,392,8,90,63,107,6,20,98
"2011","Newcastle-under-Lyme 015C","E01029590","Total",613,169,111,58,444,23,138,52,107,8,22,94
"2011","Newcastle-under-Lyme 015E","E01029601","Total",690,223,149,74,467,10,172,74,97,8,27,79
"2011","Newcastle-under-Lyme 015F","E01029606","Total",587,138,88,50,449,12,80,110,98,23,35,91
"2011","Newcastle-under-Lyme 015G","E01029608","Total",646,172,92,80,474,6,174,72,87,7,29,99
"2011","Newcastle-under-Lyme 015H","E01033257","Total",1113,345,125,220,768,54,147,154,221,16,45,131
"2011","Newcastle-under-Lyme 016A","E01029569","Total",595,144,74,70,451,7,120,66,128,15,34,81
"2011","Newcastle-under-Lyme 016B","E01029570","Total",1035,224,128,96,811,14,251,129,207,27,46,137
"2011","Newcastle-under-Lyme 016C","E01029571","Total",561,133,76,57,428,19,118,64,89,18,28,92
"2011","Newcastle-under-Lyme 016D","E01029572","Total",650,114,64,50,536,13,115,95,159,28,44,82
"2011","South Staffordshire 001A","E01029655","Total",890,274,171,103,616,33,185,98,139,13,30,118
"2011","South Staffordshire 001B","E01029656","Total",729,138,70,68,591,6,161,90,168,15,41,110
"2011","South Staffordshire 001C","E01029657","Total",622,78,28,50,544,24,49,140,138,22,47,124
"2011","South Staffordshire 001D","E01029658","Total",566,161,79,82,405,23,108,69,93,14,29,69
"2011","South Staffordshire 001E","E01029659","Total",578,115,76,39,463,12,127,69,135,19,30,71
"2011","South Staffordshire 001F","E01029660","Total",879,232,92,140,647,32,141,105,177,12,42,138
"2011","South Staffordshire 002A","E01029621","Total",607,145,81,64,462,24,94,77,112,10,38,107
"2011","South Staffordshire 002B","E01029646","Total",568,132,45,87,436,28,69,97,114,14,30,84
"2011","South Staffordshire 002C","E01029647","Total",877,214,71,143,663,51,67,170,182,27,58,108
"2011","South Staffordshire 002D","E01029648","Total",589,116,66,50,473,36,83,86,121,15,28,104
"2011","South Staffordshire 003A","E01029617","Total",681,147,91,56,534,15,154,82,127,18,40,98
"2011","South Staffordshire 003B","E01029618","Total",737,270,168,102,467,37,150,67,98,9,23,83
"2011","South Staffordshire 003C","E01029668","Total",524,115,65,50,409,13,113,68,121,7,24,63
"2011","South Staffordshire 003D","E01029669","Total",564,155,103,52,409,31,102,57,105,11,23,80
"2011","South Staffordshire 003E","E01029670","Total",640,134,72,62,506,9,106,97,157,14,26,97
"2011","South Staffordshire 004A","E01029620","Total",505,101,56,45,404,29,84,65,96,14,31,85
"2011","South Staffordshire 004B","E01029622","Total",633,172,82,90,461,25,106,83,87,11,38,111
"2011","South Staffordshire 004C","E01029623","Total",487,119,67,52,368,25,68,54,94,8,38,81
"2011","South Staffordshire 004D","E01029624","Total",549,84,30,54,465,16,58,117,120,9,45,100
"2011","South Staffordshire 004E","E01029625","Total",481,108,68,40,373,13,122,59,87,11,18,63
"2011","South Staffordshire 004F","E01029641","Total",685,139,56,83,546,26,115,87,151,11,38,118
"2011","South Staffordshire 004G","E01029642","Total",628,143,83,60,485,21,158,64,99,11,27,105
"2011","South Staffordshire 005A","E01029638","Total",885,264,166,98,621,38,166,86,132,11,44,144
"2011","South Staffordshire 005B","E01029639","Total",516,76,41,35,440,17,70,76,103,9,46,119
"2011","South Staffordshire 005C","E01029640","Total",562,91,27,64,471,35,44,111,140,17,40,84
"2011","South Staffordshire 005D","E01029643","Total",635,195,116,79,440,44,107,54,91,18,35,91
"2011","South Staffordshire 005E","E01029644","Total",600,137,92,45,463,17,125,45,112,7,46,111
"2011","South Staffordshire 006A","E01029616","Total",681,201,107,94,480,15,145,71,140,13,28,68
"2011","South Staffordshire 006B","E01029619","Total",841,241,152,89,600,20,175,103,152,9,36,105
"2011","South Staffordshire 006C","E01029636","Total",592,140,66,74,452,14,110,71,108,8,46,95
"2011","South Staffordshire 006D","E01029637","Total",673,133,36,97,540,14,71,133,150,16,57,99
"2011","South Staffordshire 007A","E01029632","Total",606,105,58,47,501,10,101,73,124,12,45,136
"2011","South Staffordshire 007B","E01029633","Total",667,124,78,46,543,17,117,105,118,18,44,124
"2011","South Staffordshire 007C","E01029634","Total",593,155,82,73,438,41,87,77,98,11,34,90
"2011","South Staffordshire 007D","E01029635","Total",724,220,86,134,504,42,74,104,124,18,40,102
"2011","South Staffordshire 008A","E01029613","Total",628,198,111,87,430,13,122,75,103,4,27,86
"2011","South Staffordshire 008B","E01029614","Total",700,178,102,76,522,42,102,98,121,16,45,98
"2011","South Staffordshire 008C","E01029615","Total",574,202,103,99,372,51,92,62,88,12,18,49
"2011","South Staffordshire 008D","E01029627","Total",665,267,163,104,398,37,94,66,96,9,16,80
"2011","South Staffordshire 009A","E01029626","Total",612,179,109,70,433,19,121,59,92,14,39,89
"2011","South Staffordshire 009B","E01029628","Total",512,122,85,37,390,3,126,70,92,12,23,64
"2011","South Staffordshire 009C","E01029629","Total",500,104,77,27,396,11,122,70,81,14,27,71
"2011","South Staffordshire 009D","E01029630","Total",547,137,66,71,410,9,112,66,89,18,35,81
"2011","South Staffordshire 009E","E01029631","Total",580,126,60,66,454,13,94,87,122,13,39,86
"2011","South Staffordshire 010A","E01029654","Total",953,226,120,106,727,25,194,135,185,12,41,135
"2011","South Staffordshire 010B","E01029661","Total",776,179,74,105,597,31,122,91,169,13,47,124
"2011","South Staffordshire 010C","E01029663","Total",597,140,53,87,457,15,69,108,121,17,22,105
"2011","South Staffordshire 010D","E01029665","Total",764,205,65,140,559,35,65,115,176,10,40,118
"2011","South Staffordshire 011A","E01029662","Total",831,124,49,75,707,26,103,149,165,21,62,181
"2011","South Staffordshire 011B","E01029664","Total",675,188,58,130,487,32,64,97,151,9,35,99
"2011","South Staffordshire 011C","E01029666","Total",768,343,138,205,425,52,46,80,137,13,33,64
"2011","South Staffordshire 012A","E01029671","Total",662,198,154,44,464,16,134,68,105,13,29,99
"2011","South Staffordshire 012B","E01029673","Total",672,201,110,91,471,22,129,76,101,18,42,83
"2011","South Staffordshire 012C","E01029676","Total",524,199,144,55,325,20,107,44,75,5,20,54
"2011","South Staffordshire 012D","E01029679","Total",623,192,67,125,431,48,78,76,111,14,32,72
"2011","South Staffordshire 012E","E01029680","Total",632,167,94,73,465,32,102,70,94,17,39,111
"2011","South Staffordshire 013A","E01029645","Total",875,239,119,120,636,18,234,64,163,16,33,108
"2011","South Staffordshire 013B","E01029667","Total",887,212,90,122,675,14,197,101,144,21,59,139
"2011","South Staffordshire 013C","E01029672","Total",626,136,88,48,490,6,115,81,134,15,40,99
"2011","South Staffordshire 013D","E01029674","Total",689,124,73,51,565,15,108,126,117,21,51,127
"2011","South Staffordshire 013E","E01029675","Total",678,219,158,61,459,8,169,69,80,5,27,101
"2011","South Staffordshire 013F","E01029677","Total",557,142,83,59,415,16,119,62,90,13,27,88
"2011","South Staffordshire 013G","E01029678","Total",683,122,44,78,561,19,82,126,156,17,27,134
"2011","South Staffordshire 014A","E01029649","Total",601,244,142,102,357,23,113,53,97,2,13,56
"2011","South Staffordshire 014B","E01029650","Total",660,172,85,87,488,14,150,66,121,11,35,91
"2011","South Staffordshire 014C","E01029651","Total",620,140,86,54,480,18,150,81,120,8,23,80
"2011","South Staffordshire 014D","E01029652","Total",672,111,61,50,561,9,163,71,134,13,50,121
"2011","South Staffordshire 014E","E01029653","Total",521,129,74,55,392,32,88,76,93,10,34,59
"2011","Stafford 001A","E01029702","Total",667,204,112,92,463,28,123,72,121,12,28,79
"2011","Stafford 001B","E01029703","Total",624,159,57,102,465,11,93,96,125,18,35,87
"2011","Stafford 001C","E01029704","Total",602,144,87,57,458,11,146,69,109,16,32,75
"2011","Stafford 001D","E01029705","Total",628,145,103,42,483,17,170,61,110,12,30,83
"2011","Stafford 002A","E01029681","Total",497,138,62,76,359,17,61,67,102,27,24,61
"2011","Stafford 002B","E01029682","Total",711,198,128,70,513,7,175,76,130,14,27,84
"2011","Stafford 002C","E01029683","Total",552,149,84,65,403,14,111,62,111,16,37,52
"2011","Stafford 002D","E01029748","Total",588,137,73,64,451,14,117,78,129,7,28,78
"2011","Stafford 002E","E01029749","Total",738,221,126,95,517,23,146,80,155,15,27,71
"2011","Stafford 003A","E01029740","Total",697,211,113,98,486,42,95,93,113,27,39,77
"2011","Stafford 003B","E01029744","Total",989,302,88,214,687,37,88,189,229,23,39,82
"2011","Stafford 003C","E01029745","Total",903,437,204,233,466,27,127,86,137,11,25,53
"2011","Stafford 003D","E01029746","Total",674,209,93,116,465,35,103,100,108,9,29,81
"2011","Stafford 003E","E01029753","Total",654,260,139,121,394,19,123,70,100,11,14,57
"2011","Stafford 003F","E01029756","Total",759,274,69,205,485,41,53,107,157,21,41,65
"2011","Stafford 004A","E01029733","Total",765,165,92,73,600,16,141,116,173,17,37,100
"2011","Stafford 004B","E01029739","Total",603,86,37,49,517,15,91,127,126,11,36,111
"2011","Stafford 004C","E01029741","Total",688,161,49,112,527,38,57,139,159,21,30,83
"2011","Stafford 004D","E01029754","Total",565,135,59,76,430,11,100,95,121,11,18,74
"2011","Stafford 004E","E01029755","Total",647,178,108,70,469,3,162,72,134,8,27,63
"2011","Stafford 005A","E01029695","Total",924,315,153,162,609,23,181,96,169,14,36,90
"2011","Stafford 005B","E01029696","Total",644,157,82,75,487,12,118,76,147,13,32,89
"2011","Stafford 005C","E01029697","Total",536,127,56,71,409,6,94,68,102,18,36,85
"2011","Stafford 005D","E01029698","Total",689,188,102,86,501,23,136,72,142,14,31,83
"2011","Stafford 005E","E01029747","Total",595,137,48,89,458,17,87,79,135,13,36,91
"2011","Stafford 006A","E01029690","Total",637,154,55,99,483,30,88,108,130,13,39,75
"2011","Stafford 006B","E01029718","Total",805,184,99,85,621,14,154,117,156,21,41,118
"2011","Stafford 006C","E01029743","Total",614,139,81,58,475,12,164,58,138,12,26,65
"2011","Stafford 006D","E01029751","Total",724,225,124,101,499,22,169,60,113,12,36,87
"2011","Stafford 007A","E01029719","Total",730,248,167,81,482,15,144,69,132,17,25,80
"2011","Stafford 007B","E01029720","Total",670,183,60,123,487,79,56,114,119,15,41,63
"2011","Stafford 007C","E01029721","Total",641,155,68,87,486,24,85,100,138,13,37,89
"2011","Stafford 007D","E01029750","Total",660,194,78,116,466,52,69,100,136,23,23,63
"2011","Stafford 007E","E01029752","Total",521,141,48,93,380,52,56,90,79,22,25,56
"2011","Stafford 008A","E01029687","Total",823,185,96,89,638,17,184,102,198,9,41,87
"2011","Stafford 008B","E01029710","Total",640,142,79,63,498,15,143,81,158,8,16,77
"2011","Stafford 008C","E01029711","Total",612,120,54,66,492,18,100,104,162,12,27,69
"2011","Stafford 008D","E01029712","Total",774,193,96,97,581,24,107,120,173,19,46,92
"2011","Stafford 008E","E01029713","Total",694,200,110,90,494,28,121,93,130,15,26,81
"2011","Stafford 009A","E01029692","Total",669,221,100,121,448,48,74,94,97,18,35,82
"2011","Stafford 009B","E01029693","Total",805,371,20,351,434,35,16,136,134,12,24,77
"2011","Stafford 009C","E01029722","Total",687,213,86,127,474,30,58,91,133,7,33,122
"2011","Stafford 009D","E01029725","Total",695,326,139,187,369,11,57,67,103,17,16,98
"2011","Stafford 010A","E01029689","Total",835,367,58,309,468,34,41,91,196,4,9,93
"2011","Stafford 010B","E01029691","Total",693,375,142,233,318,20,53,56,142,2,5,40
"2011","Stafford 010C","E01029694","Total",619,193,30,163,426,15,26,103,160,14,26,82
"2011","Stafford 010D","E01029699","Total",955,413,172,241,542,50,61,110,196,12,29,84
"2011","Stafford 010E","E01029701","Total",1131,609,139,470,522,57,53,83,250,10,10,59
"2011","Stafford 011A","E01029686","Total",607,157,100,57,450,14,123,99,111,11,27,65
"2011","Stafford 011B","E01029700","Total",536,130,42,88,406,24,57,83,134,7,25,76
"2011","Stafford 011C","E01029723","Total",687,173,64,109,514,18,130,95,137,12,27,95
"2011","Stafford 011D","E01029724","Total",680,152,70,82,528,22,99,96,129,11,47,124
"2011","Stafford 011E","E01029732","Total",601,121,49,72,480,26,98,69,157,23,27,80
"2011","Stafford 012A","E01029714","Total",647,129,49,80,518,19,78,118,167,13,23,100
"2011","Stafford 012B","E01029736","Total",602,115,34,81,487,18,64,121,166,6,36,76
"2011","Stafford 012C","E01029737","Total",666,210,93,117,456,26,110,74,108,15,36,87
"2011","Stafford 012D","E01029738","Total",583,145,62,83,438,12,99,91,135,13,27,61
"2011","Stafford 012E","E01029742","Total",861,194,114,80,667,9,220,95,193,20,30,100
"2011","Stafford 013A","E01029715","Total",785,293,93,200,492,65,45,109,174,9,26,64
"2011","Stafford 013B","E01029716","Total",681,219,102,117,462,48,95,75,98,22,38,86
"2011","Stafford 013C","E01029717","Total",770,240,76,164,530,95,76,90,137,24,43,65
"2011","Stafford 013D","E01029727","Total",689,267,92,175,422,57,76,72,88,21,40,68
"2011","Stafford 013E","E01029728","Total",621,177,106,71,444,32,99,99,103,11,27,73
"2011","Stafford 014A","E01029684","Total",596,136,78,58,460,10,119,106,95,13,32,85
"2011","Stafford 014B","E01029685","Total",637,142,108,34,495,13,157,85,97,17,41,85
"2011","Stafford 014C","E01029730","Total",445,76,47,29,369,10,130,61,79,9,15,65
"2011","Stafford 014D","E01029731","Total",638,114,69,45,524,27,134,127,92,16,33,95
"2011","Stafford 014E","E01029757","Total",640,147,72,75,493,31,83,118,123,17,37,84
"2011","Stafford 014F","E01029758","Total",656,135,84,51,521,17,170,93,125,12,31,73
"2011","Stafford 014G","E01029759","Total",726,166,103,63,560,24,139,115,144,8,27,103
"2011","Stafford 014H","E01029760","Total",668,158,118,40,510,8,195,83,89,18,37,80
"2011","Stafford 015A","E01029688","Total",914,208,108,100,706,18,201,123,180,33,45,106
"2011","Stafford 015B","E01029706","Total",660,142,75,67,518,9,126,86,168,17,26,86
"2011","Stafford 015C","E01029707","Total",674,234,124,110,440,36,111,81,115,15,22,60
"2011","Stafford 015D","E01029708","Total",773,152,77,75,621,21,143,106,178,16,45,112
"2011","Stafford 015E","E01029709","Total",620,153,74,79,467,18,104,67,129,13,33,103
"2011","Stafford 016A","E01029726","Total",702,165,94,71,537,27,132,86,133,30,36,93
"2011","Stafford 016B","E01029729","Total",868,428,132,296,440,33,82,84,156,13,22,50
"2011","Stafford 016C","E01029734","Total",949,331,102,229,618,107,68,150,135,34,52,72
"2011","Stafford 016D","E01029735","Total",948,239,87,152,709,43,118,152,192,24,52,128
"2011","Staffordshire Moorlands 001A","E01029797","Total",623,144,62,82,479,8,91,67,155,18,44,96
"2011","Staffordshire Moorlands 001B","E01029806","Total",677,200,117,83,477,21,134,70,142,12,23,75
"2011","Staffordshire Moorlands 001C","E01029808","Total",663,231,98,133,432,47,107,76,106,7,22,67
"2011","Staffordshire Moorlands 001D","E01029809","Total",618,181,87,94,437,40,95,79,90,13,36,84
"2011","Staffordshire Moorlands 001E","E01029810","Total",546,153,66,87,393,37,65,70,102,33,27,59
"2011","Staffordshire Moorlands 002A","E01029767","Total",727,189,106,83,538,9,136,84,165,11,30,103
"2011","Staffordshire Moorlands 002B","E01029769","Total",753,181,111,70,572,12,202,57,164,15,25,97
"2011","Staffordshire Moorlands 002C","E01029770","Total",839,206,107,99,633,20,141,128,191,11,25,117
"2011","Staffordshire Moorlands 002D","E01029802","Total",739,166,80,86,573,13,133,83,172,13,42,117
"2011","Staffordshire Moorlands 003A","E01029763","Total",682,217,90,127,465,72,73,88,97,23,42,70
"2011","Staffordshire Moorlands 003B","E01029764","Total",651,114,31,83,537,60,35,167,117,27,46,85
"2011","Staffordshire Moorlands 003C","E01029765","Total",541,143,76,67,398,28,69,84,80,19,43,75
"2011","Staffordshire Moorlands 003D","E01029766","Total",631,192,100,92,439,35,67,78,107,20,47,85
"2011","Staffordshire Moorlands 003E","E01029774","Total",919,325,101,224,594,65,105,111,180,20,39,74
"2011","Staffordshire Moorlands 004A","E01029768","Total",621,172,94,78,449,11,145,58,118,13,20,84
"2011","Staffordshire Moorlands 004B","E01029771","Total",724,192,128,64,532,12,205,74,125,13,23,80
"2011","Staffordshire Moorlands 004C","E01029772","Total",777,210,95,115,567,22,131,99,163,11,36,105
"2011","Staffordshire Moorlands 004D","E01029773","Total",663,157,92,65,506,21,139,78,139,12,33,84
"2011","Staffordshire Moorlands 005A","E01029804","Total",923,432,94,338,491,77,59,83,171,10,21,70
"2011","Staffordshire Moorlands 005B","E01029807","Total",547,238,103,135,309,18,68,65,100,4,20,34
"2011","Staffordshire Moorlands 005C","E01029811","Total",658,191,90,101,467,37,94,93,126,16,27,74
"2011","Staffordshire Moorlands 005D","E01029812","Total",993,438,125,313,555,67,71,126,181,23,23,64
"2011","Staffordshire Moorlands 005E","E01029814","Total",790,289,77,212,501,43,77,109,161,15,27,69
"2011","Staffordshire Moorlands 006A","E01029792","Total",996,286,96,190,710,19,134,145,236,30,65,81
"2011","Staffordshire Moorlands 006B","E01029793","Total",687,178,86,92,509,27,120,101,124,17,33,87
"2011","Staffordshire Moorlands 006C","E01029805","Total",731,235,131,104,496,19,119,101,119,15,32,91
"2011","Staffordshire Moorlands 006D","E01029813","Total",896,213,101,112,683,26,153,147,186,25,44,102
"2011","Staffordshire Moorlands 006E","E01029815","Total",676,190,111,79,486,18,139,79,127,6,30,87
"2011","Staffordshire Moorlands 006F","E01029816","Total",608,151,97,54,457,8,112,85,119,12,37,84
"2011","Staffordshire Moorlands 007A","E01029801","Total",776,197,103,94,579,16,146,105,169,13,35,95
"2011","Staffordshire Moorlands 007B","E01029803","Total",778,218,97,121,560,12,141,78,162,8,52,107
"2011","Staffordshire Moorlands 007C","E01029817","Total",823,272,117,155,551,13,120,86,170,16,29,117
"2011","Staffordshire Moorlands 008A","E01029762","Total",669,159,95,64,510,17,139,82,125,13,40,94
"2011","Staffordshire Moorlands 008B","E01029775","Total",670,156,106,50,514,15,181,68,121,13,28,88
"2011","Staffordshire Moorlands 008C","E01029776","Total",737,159,107,52,578,13,195,91,111,20,37,111
"2011","Staffordshire Moorlands 008D","E01029777","Total",632,168,108,60,464,22,111,96,109,17,31,78
"2011","Staffordshire Moorlands 009A","E01029779","Total",726,198,152,46,528,13,178,82,127,12,22,94
"2011","Staffordshire Moorlands 009B","E01029780","Total",650,159,82,77,491,36,127,93,113,16,24,82
"2011","Staffordshire Moorlands 009C","E01029794","Total",584,143,79,64,441,14,117,59,118,13,33,87
"2011","Staffordshire Moorlands 009D","E01029818","Total",618,122,55,67,496,22,90,94,162,10,27,91
"2011","Staffordshire Moorlands 009E","E01029819","Total",729,197,124,73,532,16,139,80,143,9,32,113
"2011","Staffordshire Moorlands 010A","E01029761","Total",596,173,93,80,423,16,131,66,104,7,27,72
"2011","Staffordshire Moorlands 010B","E01029782","Total",839,272,126,146,567,47,105,110,146,26,38,95
"2011","Staffordshire Moorlands 010C","E01029795","Total",767,255,111,144,512,18,129,81,162,12,37,73
"2011","Staffordshire Moorlands 010D","E01029796","Total",642,187,93,94,455,18,98,72,126,16,32,93
"2011","Staffordshire Moorlands 011A","E01029781","Total",662,175,81,94,487,28,116,82,124,10,32,95
"2011","Staffordshire Moorlands 011B","E01029783","Total",652,231,134,97,421,44,97,67,99,18,30,66
"2011","Staffordshire Moorlands 011C","E01029786","Total",589,115,52,63,474,19,95,81,147,7,37,88
"2011","Staffordshire Moorlands 011D","E01029787","Total",782,304,141,163,478,34,116,77,118,12,30,91
"2011","Staffordshire Moorlands 012A","E01029778","Total",707,164,84,80,543,21,132,75,143,13,37,122
"2011","Staffordshire Moorlands 012B","E01029789","Total",449,127,78,49,322,9,71,47,101,14,23,57
"2011","Staffordshire Moorlands 012C","E01029798","Total",749,208,98,110,541,43,121,98,133,11,24,111
"2011","Staffordshire Moorlands 012D","E01029799","Total",807,198,107,91,609,24,175,93,161,11,35,110
"2011","Staffordshire Moorlands 012E","E01029800","Total",670,174,98,76,496,13,107,99,144,16,26,91
"2011","Staffordshire Moorlands 013A","E01029784","Total",898,202,110,92,696,22,181,125,176,23,49,120
"2011","Staffordshire Moorlands 013B","E01029785","Total",728,149,76,73,579,16,126,123,153,17,40,104
"2011","Staffordshire Moorlands 013C","E01029788","Total",547,106,42,64,441,5,101,87,119,10,33,86
"2011","Staffordshire Moorlands 013D","E01029790","Total",785,183,88,95,602,32,116,120,150,28,42,114
"2011","Staffordshire Moorlands 013E","E01029791","Total",612,162,48,114,450,26,95,76,133,9,25,86
"2011","Tamworth 001A","E01029846","Total",521,104,63,41,417,20,108,69,105,11,27,77
"2011","Tamworth 001B","E01029847","Total",537,101,51,50,436,14,95,69,119,4,28,107
"2011","Tamworth 001C","E01029848","Total",515,108,64,44,407,12,113,67,111,12,24,68
"2011","Tamworth 001D","E01029852","Total",763,229,138,91,534,51,132,85,119,29,27,91
"2011","Tamworth 001E","E01029853","Total",672,190,99,91,482,43,107,78,115,17,46,76
"2011","Tamworth 001F","E01029854","Total",641,130,98,32,511,11,156,77,133,9,26,99
"2011","Tamworth 002A","E01029835","Total",1048,641,342,299,407,30,128,42,141,4,14,48
"2011","Tamworth 002B","E01029836","Total",587,196,65,131,391,37,68,88,125,9,11,53
"2011","Tamworth 002C","E01029849","Total",683,239,125,114,444,83,91,83,96,8,32,51
"2011","Tamworth 002D","E01029850","Total",574,199,94,105,375,39,69,72,87,18,33,57
"2011","Tamworth 002E","E01029851","Total",985,341,161,180,644,48,110,111,226,16,42,91
"2011","Tamworth 003A","E01029820","Total",585,117,35,82,468,33,69,90,117,25,41,93
"2011","Tamworth 003B","E01029821","Total",648,183,79,104,465,19,107,67,148,14,26,84
"2011","Tamworth 003C","E01029822","Total",526,59,10,49,467,24,31,141,104,18,61,88
"2011","Tamworth 003D","E01029824","Total",734,225,61,164,509,84,42,83,110,29,65,96
"2011","Tamworth 003E","E01029841","Total",608,149,62,87,459,17,90,71,147,15,31,88
"2011","Tamworth 004A","E01029823","Total",657,170,102,68,487,17,149,83,120,6,27,85
"2011","Tamworth 004B","E01029831","Total",634,189,75,114,445,36,83,88,107,16,30,85
"2011","Tamworth 004C","E01029832","Total",700,193,135,58,507,30,127,89,116,12,39,94
"2011","Tamworth 004D","E01029834","Total",680,214,115,99,466,49,103,83,108,17,30,76
"2011","Tamworth 004E","E01029844","Total",496,94,37,57,402,18,62,89,125,11,21,76
"2011","Tamworth 005A","E01029833","Total",684,149,33,116,535,34,50,124,191,20,33,83
"2011","Tamworth 005B","E01029837","Total",697,236,65,171,461,33,64,114,135,13,30,72
"2011","Tamworth 005C","E01029838","Total",714,222,68,154,492,36,73,113,172,4,29,65
"2011","Tamworth 005D","E01029839","Total",445,51,14,37,394,16,38,113,121,10,21,75
"2011","Tamworth 006A","E01029825","Total",512,101,37,64,411,20,48,79,118,11,42,93
"2011","Tamworth 006B","E01029826","Total",640,137,69,68,503,28,124,82,131,15,31,92
"2011","Tamworth 006C","E01029827","Total",541,143,76,67,398,55,44,77,82,26,37,77
"2011","Tamworth 006D","E01029828","Total",480,117,27,90,363,45,36,66,75,33,43,65
"2011","Tamworth 006E","E01029830","Total",543,186,62,124,357,45,56,67,110,8,16,55
"2011","Tamworth 007A","E01029840","Total",460,83,23,60,377,61,33,58,79,38,44,64
"2011","Tamworth 007B","E01029842","Total",518,134,28,106,384,67,29,81,88,22,36,61
"2011","Tamworth 007C","E01029843","Total",552,115,40,75,437,46,51,82,97,36,46,79
"2011","Tamworth 007D","E01029845","Total",472,183,84,99,289,47,37,48,52,29,33,43
"2011","Tamworth 007E","E01029859","Total",754,225,61,164,529,114,40,113,111,28,44,79
"2011","Tamworth 008A","E01029855","Total",547,74,23,51,473,42,48,98,127,19,53,86
"2011","Tamworth 008B","E01029856","Total",595,133,35,98,462,23,40,96,165,17,28,93
"2011","Tamworth 008C","E01029857","Total",567,138,40,98,429,50,39,71,130,32,34,73
"2011","Tamworth 008D","E01029858","Total",635,143,34,109,492,18,55,116,163,13,41,86
"2011","Tamworth 008E","E01029865","Total",602,88,21,67,514,19,44,103,155,21,44,128
"2011","Tamworth 009A","E01029860","Total",536,105,45,60,431,10,86,91,111,12,27,94
"2011","Tamworth 009B","E01029861","Total",595,175,129,46,420,23,115,73,91,7,27,84
"2011","Tamworth 009C","E01029862","Total",480,67,22,45,413,16,35,114,115,11,32,90
"2011","Tamworth 009D","E01029863","Total",756,193,75,118,563,23,108,125,180,14,31,82
"2011","Tamworth 009E","E01029864","Total",646,117,37,80,529,19,102,100,158,18,22,110
"2011","Tamworth 010A","E01029829","Total",781,147,39,108,634,64,67,145,205,25,43,85
"2011","Tamworth 010C","E01029867","Total",679,171,74,97,508,55,78,95,130,20,35,95
"2011","Tamworth 010D","E01029868","Total",500,57,15,42,443,8,40,95,125,17,49,109
"2011","Tamworth 010E","E01029869","Total",660,166,76,90,494,38,80,105,119,21,29,102
"2011","Tamworth 010F","E01032901","Total",634,141,20,121,493,50,31,145,158,28,29,52
"2011","Tamworth 010G","E01032902","Total",598,178,51,127,420,33,66,85,135,9,21,71
"2011","North Warwickshire 001A","E01031035","Total",749,150,73,77,599,33,120,107,150,21,40,128
"2011","North Warwickshire 001B","E01031036","Total",619,127,74,53,492,18,107,90,145,18,29,85
"2011","North Warwickshire 001C","E01031037","Total",645,187,97,90,458,25,116,83,108,16,34,76
"2011","North Warwickshire 001D","E01031038","Total",751,133,83,50,618,29,116,122,147,39,52,113
"2011","North Warwickshire 001E","E01031039","Total",656,101,50,51,555,17,133,99,139,16,50,101
"2011","North Warwickshire 001F","E01031040","Total",754,201,73,128,553,42,82,114,164,13,26,112
"2011","North Warwickshire 002A","E01031016","Total",678,184,107,77,494,43,116,67,133,17,30,88
"2011","North Warwickshire 002B","E01031025","Total",690,206,100,106,484,30,105,86,141,13,25,84
"2011","North Warwickshire 002C","E01031026","Total",596,111,42,69,485,39,61,102,108,25,41,109
"2011","North Warwickshire 002D","E01031031","Total",1015,238,92,146,777,55,130,169,205,32,69,117
"2011","North Warwickshire 002E","E01031032","Total",528,121,67,54,407,19,75,79,97,17,29,91
"2011","North Warwickshire 003A","E01031009","Total",971,287,103,184,684,45,113,129,227,23,23,124
"2011","North Warwickshire 003B","E01031010","Total",847,378,101,277,469,60,33,115,158,23,30,50
"2011","North Warwickshire 003C","E01031011","Total",788,167,93,74,621,24,138,129,155,14,42,119
"2011","North Warwickshire 003D","E01031012","Total",631,197,116,81,434,28,114,68,101,15,40,68
"2011","North Warwickshire 003E","E01031013","Total",484,151,88,63,333,11,98,47,88,6,17,66
"2011","North Warwickshire 003F","E01031014","Total",505,112,68,44,393,11,96,61,117,10,32,66
"2011","North Warwickshire 003G","E01031015","Total",598,188,89,99,410,40,73,75,97,22,35,68
"2011","North Warwickshire 004A","E01031023","Total",639,128,59,69,511,9,153,89,104,12,35,109
"2011","North Warwickshire 004B","E01031024","Total",675,147,81,66,528,10,122,77,165,8,46,100
"2011","North Warwickshire 004C","E01031033","Total",783,204,105,99,579,38,154,74,129,16,58,110
"2011","North Warwickshire 004D","E01031034","Total",767,157,69,88,610,21,102,106,204,18,46,113
"2011","North Warwickshire 005A","E01031005","Total",578,151,77,74,427,38,74,92,99,10,41,73
"2011","North Warwickshire 005B","E01031008","Total",578,180,66,114,398,44,49,72,114,16,34,69
"2011","North Warwickshire 005C","E01031017","Total",524,112,43,69,412,7,96,83,112,12,30,72
"2011","North Warwickshire 005D","E01031018","Total",461,128,55,73,333,15,74,57,88,13,22,64
"2011","North Warwickshire 005E","E01031029","Total",578,118,50,68,460,30,77,99,123,19,31,81
"2011","North Warwickshire 005F","E01031030","Total",984,309,127,182,675,49,128,118,198,20,46,116
"2011","North Warwickshire 006A","E01031019","Total",668,135,63,72,533,32,83,117,144,15,49,93
"2011","North Warwickshire 006B","E01031020","Total",700,220,92,128,480,27,104,90,143,12,25,79
"2011","North Warwickshire 006C","E01031021","Total",779,321,152,169,458,31,109,79,130,3,18,88
"2011","North Warwickshire 006D","E01031022","Total",687,217,111,106,470,13,110,78,112,13,41,103
"2011","North Warwickshire 006E","E01031041","Total",720,220,89,131,500,16,92,89,147,11,50,95
"2011","North Warwickshire 006F","E01031042","Total",721,189,103,86,532,29,112,92,128,9,41,121
"2011","North Warwickshire 007A","E01031006","Total",635,189,69,120,446,40,67,106,125,16,23,69
"2011","North Warwickshire 007B","E01031007","Total",489,106,55,51,383,10,74,75,118,15,26,65
"2011","North Warwickshire 007C","E01031027","Total",580,130,62,68,450,11,119,79,111,7,36,87
"2011","North Warwickshire 007D","E01031028","Total",761,176,76,100,585,20,129,97,166,17,48,108
"2011","Nuneaton and Bedworth 001A","E01031110","Total",655,188,115,73,467,13,138,67,110,17,41,81
"2011","Nuneaton and Bedworth 001B","E01031111","Total",412,61,34,27,351,6,72,49,81,9,42,92
"2011","Nuneaton and Bedworth 001C","E01031112","Total",661,156,95,61,505,35,124,106,103,14,38,85
"2011","Nuneaton and Bedworth 001D","E01031113","Total",607,136,78,58,471,13,134,91,107,11,29,86
"2011","Nuneaton and Bedworth 001E","E01031114","Total",745,317,168,149,428,28,79,70,137,8,32,74
"2011","Nuneaton and Bedworth 002C","E01031073","Total",821,238,126,112,583,41,116,115,163,22,35,91
"2011","Nuneaton and Bedworth 002D","E01031074","Total",723,269,85,184,454,42,79,100,127,17,26,63
"2011","Nuneaton and Bedworth 002E","E01031075","Total",709,217,78,139,492,73,59,94,137,18,36,75
"2011","Nuneaton and Bedworth 002F","E01032890","Total",822,177,67,110,645,114,63,110,148,47,64,99
"2011","Nuneaton and Bedworth 003A","E01031100","Total",503,80,33,47,423,14,55,81,122,10,42,99
"2011","Nuneaton and Bedworth 003B","E01031101","Total",516,71,40,31,445,8,69,90,106,17,52,103
"2011","Nuneaton and Bedworth 003C","E01031102","Total",582,170,50,120,412,31,67,80,137,16,18,63
"2011","Nuneaton and Bedworth 003D","E01031103","Total",490,72,46,26,418,6,95,75,101,15,40,86
"2011","Nuneaton and Bedworth 003E","E01031104","Total",642,167,137,30,475,5,195,56,94,8,28,89
"2011","Nuneaton and Bedworth 004A","E01031081","Total",655,147,41,106,508,53,52,122,136,29,49,67
"2011","Nuneaton and Bedworth 004B","E01031082","Total",504,84,20,64,420,23,27,97,113,18,39,103
"2011","Nuneaton and Bedworth 004C","E01031083","Total",626,141,52,89,485,32,97,112,115,12,41,76
"2011","Nuneaton and Bedworth 004D","E01031084","Total",868,189,37,152,679,53,58,173,201,29,46,119
"2011","Nuneaton and Bedworth 004E","E01031085","Total",523,72,19,53,451,16,63,97,140,12,25,98
"2011","Nuneaton and Bedworth 005A","E01031043","Total",906,512,139,373,394,35,62,59,140,13,38,47
"2011","Nuneaton and Bedworth 005B","E01031044","Total",752,256,80,176,496,66,52,120,138,13,33,74
"2011","Nuneaton and Bedworth 005C","E01031045","Total",763,262,109,153,501,34,89,94,150,18,39,77
"2011","Nuneaton and Bedworth 005D","E01031046","Total",716,238,58,180,478,55,29,109,122,18,46,99
"2011","Nuneaton and Bedworth 005E","E01031047","Total",845,332,80,252,513,36,49,107,156,37,56,72
"2011","Nuneaton and Bedworth 006A","E01031057","Total",687,274,103,171,413,75,46,95,77,26,27,67
"2011","Nuneaton and Bedworth 006B","E01031058","Total",623,157,60,97,466,55,95,67,126,12,24,87
"2011","Nuneaton and Bedworth 006C","E01031059","Total",637,195,76,119,442,39,70,92,121,15,26,79
"2011","Nuneaton and Bedworth 006D","E01031060","Total",635,196,94,102,439,32,101,68,112,16,29,81
"2011","Nuneaton and Bedworth 006E","E01031061","Total",602,142,47,95,460,32,40,114,136,16,36,86
"2011","Nuneaton and Bedworth 007A","E01031090","Total",620,212,57,155,408,54,46,70,114,35,25,64
"2011","Nuneaton and Bedworth 007B","E01031091","Total",599,147,71,76,452,22,106,92,111,20,32,69
"2011","Nuneaton and Bedworth 007C","E01031092","Total",622,189,72,117,433,53,69,86,115,25,27,58
"2011","Nuneaton and Bedworth 007D","E01031093","Total",538,109,49,60,429,18,87,77,115,11,41,80
"2011","Nuneaton and Bedworth 007E","E01031094","Total",506,155,45,110,351,34,54,89,93,19,20,42
"2011","Nuneaton and Bedworth 008A","E01031048","Total",511,113,41,72,398,20,51,85,121,13,24,84
"2011","Nuneaton and Bedworth 008B","E01031049","Total",929,254,107,147,675,43,95,153,209,23,55,97
"2011","Nuneaton and Bedworth 008C","E01031050","Total",776,210,47,163,566,48,62,128,190,16,33,89
"2011","Nuneaton and Bedworth 008D","E01031051","Total",581,149,90,59,432,17,100,63,124,17,26,85
"2011","Nuneaton and Bedworth 009A","E01031115","Total",713,237,100,137,476,30,67,81,122,26,57,93
"2011","Nuneaton and Bedworth 009B","E01031116","Total",719,246,106,140,473,87,78,87,97,20,37,67
"2011","Nuneaton and Bedworth 009C","E01031117","Total",589,155,79,76,434,51,70,79,105,24,41,64
"2011","Nuneaton and Bedworth 009D","E01031118","Total",483,122,69,53,361,47,58,56,93,16,33,58
"2011","Nuneaton and Bedworth 009E","E01031119","Total",731,312,113,199,419,35,66,75,109,28,42,64
"2011","Nuneaton and Bedworth 010A","E01031052","Total",639,192,60,132,447,56,34,105,140,18,32,62
"2011","Nuneaton and Bedworth 010B","E01031053","Total",713,353,173,180,360,23,91,63,96,10,21,56
"2011","Nuneaton and Bedworth 010C","E01031054","Total",661,168,82,86,493,51,93,87,128,16,28,90
"2011","Nuneaton and Bedworth 010D","E01031055","Total",664,158,27,131,506,50,41,161,151,15,31,57
"2011","Nuneaton and Bedworth 010E","E01031056","Total",615,154,66,88,461,38,102,81,119,12,36,73
"2011","Nuneaton and Bedworth 011A","E01031120","Total",585,144,53,91,441,16,79,84,129,10,33,90
"2011","Nuneaton and Bedworth 011B","E01031121","Total",454,59,27,32,395,8,88,66,98,9,29,97
"2011","Nuneaton and Bedworth 011C","E01031122","Total",623,134,88,46,489,13,123,82,127,6,29,109
"2011","Nuneaton and Bedworth 011D","E01031123","Total",507,86,49,37,421,3,119,70,111,4,31,83
"2011","Nuneaton and Bedworth 011E","E01031124","Total",638,137,86,51,501,10,163,75,114,15,33,91
"2011","Nuneaton and Bedworth 012A","E01031105","Total",590,162,79,83,428,25,88,89,108,14,33,71
"2011","Nuneaton and Bedworth 012B","E01031106","Total",624,166,76,90,458,25,128,74,107,10,32,82
"2011","Nuneaton and Bedworth 012C","E01031107","Total",469,106,34,72,363,27,53,84,95,9,27,68
"2011","Nuneaton and Bedworth 012D","E01031108","Total",545,116,41,75,429,22,53,99,117,14,33,91
"2011","Nuneaton and Bedworth 012E","E01031109","Total",738,275,122,153,463,54,69,97,114,19,27,83
"2011","Nuneaton and Bedworth 013A","E01031062","Total",494,87,60,27,407,17,119,64,89,14,24,80
"2011","Nuneaton and Bedworth 013B","E01031063","Total",660,277,106,171,383,52,95,54,96,9,21,56
"2011","Nuneaton and Bedworth 013C","E01031064","Total",571,237,136,101,334,18,83,48,89,7,35,54
"2011","Nuneaton and Bedworth 013D","E01031065","Total",623,176,71,105,447,33,78,75,119,15,44,83
"2011","Nuneaton and Bedworth 013E","E01031066","Total",637,245,128,117,392,58,72,72,86,22,23,59
"2011","Nuneaton and Bedworth 014A","E01031067","Total",733,282,143,139,451,31,146,54,113,8,26,73
"2011","Nuneaton and Bedworth 014B","E01031068","Total",739,201,123,78,538,14,176,84,123,15,30,96
"2011","Nuneaton and Bedworth 014C","E01031069","Total",667,189,140,49,478,8,187,79,101,9,25,69
"2011","Nuneaton and Bedworth 014D","E01031070","Total",655,151,86,65,504,8,179,61,123,10,22,101
"2011","Nuneaton and Bedworth 015A","E01031095","Total",496,104,50,54,392,57,68,81,86,16,20,64
"2011","Nuneaton and Bedworth 015B","E01031096","Total",600,191,46,145,409,45,50,76,115,10,27,86
"2011","Nuneaton and Bedworth 015C","E01031097","Total",751,279,114,165,472,54,71,87,127,17,35,81
"2011","Nuneaton and Bedworth 015D","E01031098","Total",559,123,53,70,436,30,58,105,93,15,48,87
"2011","Nuneaton and Bedworth 015E","E01031099","Total",935,248,39,209,687,45,76,171,208,18,56,113
"2011","Nuneaton and Bedworth 016A","E01031086","Total",773,215,130,85,558,51,99,98,142,30,32,106
"2011","Nuneaton and Bedworth 016B","E01031087","Total",890,238,113,125,652,76,84,150,167,24,45,106
"2011","Nuneaton and Bedworth 016C","E01031088","Total",772,177,66,111,595,39,81,148,159,24,40,104
"2011","Nuneaton and Bedworth 016D","E01031089","Total",639,163,104,59,476,18,134,64,133,11,18,98
"2011","Nuneaton and Bedworth 018A","E01031077","Total",612,190,80,110,422,64,45,85,112,12,36,68
"2011","Nuneaton and Bedworth 018B","E01031078","Total",811,200,83,117,611,37,107,113,161,26,45,122
"2011","Nuneaton and Bedworth 018C","E01031079","Total",642,197,100,97,445,25,125,65,98,7,37,88
"2011","Nuneaton and Bedworth 018D","E01031080","Total",669,230,103,127,439,51,80,82,107,12,40,67
"2011","Nuneaton and Bedworth 018E","E01032588","Total",571,154,82,72,417,13,104,67,105,16,40,72
"2011","Rugby 001B","E01031129","Total",510,164,76,88,346,14,103,60,85,9,26,49
"2011","Rugby 001C","E01031159","Total",691,156,86,70,535,28,140,86,144,16,34,87
"2011","Rugby 001D","E01031160","Total",905,237,112,125,668,15,160,113,187,19,46,128
"2011","Rugby 001E","E01031182","Total",839,155,85,70,684,25,137,161,181,28,48,104
"2011","Rugby 001F","E01032891","Total",694,188,8,180,506,20,11,155,212,21,35,52
"2011","Rugby 001G","E01032892","Total",766,185,81,104,581,14,93,154,160,26,42,92
"2011","Rugby 002A","E01031137","Total",561,202,47,155,359,30,48,70,133,8,24,46
"2011","Rugby 002B","E01031138","Total",450,56,13,43,394,27,38,87,132,7,33,70
"2011","Rugby 002C","E01031139","Total",686,96,14,82,590,13,65,147,193,22,47,103
"2011","Rugby 002D","E01031140","Total",537,102,46,56,435,25,86,69,117,15,27,96
"2011","Rugby 002E","E01031141","Total",749,196,48,148,553,52,50,156,183,27,22,63
"2011","Rugby 002F","E01031142","Total",688,223,25,198,465,88,22,96,130,31,36,62
"2011","Rugby 003A","E01031171","Total",607,160,53,107,447,29,72,87,129,21,38,71
"2011","Rugby 003B","E01031172","Total",735,234,112,122,501,72,86,89,136,30,27,61
"2011","Rugby 003C","E01031173","Total",994,557,220,337,437,48,58,74,151,20,22,64
"2011","Rugby 003D","E01031174","Total",739,270,63,207,469,40,56,86,123,19,45,100
"2011","Rugby 004A","E01031151","Total",620,126,78,48,494,8,153,87,98,19,32,97
"2011","Rugby 004B","E01031152","Total",495,140,75,65,355,12,94,48,104,8,22,67
"2011","Rugby 004C","E01031153","Total",589,154,68,86,435,36,89,95,106,19,28,62
"2011","Rugby 004D","E01031154","Total",763,191,72,119,572,21,133,97,197,19,31,74
"2011","Rugby 004E","E01031181","Total",728,163,89,74,565,17,127,135,132,17,40,97
"2011","Rugby 005A","E01031130","Total",764,214,33,181,550,58,43,123,190,15,30,91
"2011","Rugby 005B","E01031131","Total",687,232,50,182,455,50,44,95,113,21,29,103
"2011","Rugby 005C","E01031132","Total",867,310,82,228,557,48,54,111,189,15,39,101
"2011","Rugby 005D","E01031133","Total",715,253,69,184,462,54,53,98,144,21,24,68
"2011","Rugby 006A","E01031167","Total",551,143,57,86,408,23,69,77,112,13,33,81
"2011","Rugby 006B","E01031168","Total",1157,338,100,238,819,118,81,190,233,35,53,109
"2011","Rugby 006C","E01031169","Total",923,327,55,272,596,64,51,129,214,20,35,83
"2011","Rugby 006D","E01031170","Total",757,314,122,192,443,54,46,71,143,21,28,80
"2011","Rugby 007A","E01031125","Total",658,188,68,120,470,19,98,87,156,16,23,71
"2011","Rugby 007C","E01031127","Total",624,171,67,104,453,58,58,95,108,32,26,76
"2011","Rugby 007D","E01031164","Total",849,212,57,155,637,26,113,151,207,21,37,82
"2011","Rugby 007E","E01031165","Total",690,204,95,109,486,54,89,100,126,20,28,69
"2011","Rugby 007F","E01032893","Total",589,52,15,37,537,26,29,199,104,45,69,65
"2011","Rugby 007G","E01032894","Total",483,72,7,65,411,33,23,172,107,18,27,31
"2011","Rugby 007H","E01032895","Total",542,90,32,58,452,21,65,125,121,18,29,73
"2011","Rugby 008A","E01031155","Total",545,96,54,42,449,9,98,102,116,15,34,75
"2011","Rugby 008B","E01031156","Total",647,178,76,102,469,17,91,101,165,12,33,50
"2011","Rugby 008C","E01031157","Total",791,212,90,122,579,40,92,147,132,17,54,97
"2011","Rugby 008D","E01031158","Total",480,138,93,45,342,13,122,58,64,11,18,56
"2011","Rugby 009A","E01031143","Total",649,148,85,63,501,12,144,87,132,9,28,89
"2011","Rugby 009B","E01031144","Total",576,222,90,132,354,28,55,71,119,12,22,47
"2011","Rugby 009C","E01031145","Total",503,282,142,140,221,15,48,33,70,9,16,30
"2011","Rugby 009D","E01031146","Total",630,166,99,67,464,35,130,72,110,17,29,71
"2011","Rugby 010A","E01031161","Total",874,252,141,111,622,24,180,99,170,20,43,86
"2011","Rugby 010B","E01031162","Total",732,179,106,73,553,31,129,101,146,14,38,94
"2011","Rugby 010C","E01031163","Total",743,290,140,150,453,39,136,67,103,21,23,64
"2011","Rugby 010D","E01031179","Total",690,163,89,74,527,25,108,117,121,19,51,86
"2011","Rugby 010E","E01031180","Total",856,257,136,121,599,35,131,117,141,27,48,100
"2011","Rugby 011A","E01031134","Total",732,192,123,69,540,13,201,73,112,20,26,95
"2011","Rugby 011B","E01031135","Total",777,250,172,78,527,19,213,70,117,8,34,66
"2011","Rugby 011C","E01031136","Total",722,214,117,97,508,22,117,103,148,15,24,79
"2011","Rugby 011D","E01031175","Total",575,121,88,33,454,8,187,71,82,12,25,69
"2011","Rugby 011E","E01031176","Total",590,154,57,97,436,35,62,80,117,27,44,71
"2011","Rugby 011F","E01031177","Total",609,182,72,110,427,67,50,90,114,22,27,57
"2011","Rugby 011G","E01031178","Total",643,215,122,93,428,23,127,69,103,10,15,81
"2011","Rugby 012A","E01031147","Total",671,178,135,43,493,9,194,79,98,18,42,53
"2011","Rugby 012B","E01031148","Total",740,210,134,76,530,32,169,93,122,15,29,70
"2011","Rugby 012C","E01031149","Total",626,143,73,70,483,15,119,74,149,15,30,81
"2011","Rugby 012D","E01031150","Total",493,119,81,38,374,13,99,58,106,10,25,63
"2011","Rugby 012E","E01031166","Total",779,148,84,64,631,23,165,113,186,18,50,76
"2011","Stratford-on-Avon 001A","E01031213","Total",757,156,71,85,601,29,147,98,167,16,38,106
"2011","Stratford-on-Avon 001B","E01031243","Total",788,142,92,50,646,5,211,102,151,23,45,109
"2011","Stratford-on-Avon 001C","E01031244","Total",742,154,83,71,588,14,180,82,151,22,45,94
"2011","Stratford-on-Avon 002A","E01031195","Total",918,192,130,62,726,20,207,145,179,30,36,109
"2011","Stratford-on-Avon 002B","E01031202","Total",788,314,191,123,474,19,142,75,147,12,24,55
"2011","Stratford-on-Avon 002C","E01031203","Total",706,258,135,123,448,23,120,74,113,13,27,78
"2011","Stratford-on-Avon 002D","E01031204","Total",632,209,155,54,423,8,187,55,99,13,18,43
"2011","Stratford-on-Avon 003A","E01031239","Total",688,201,79,122,487,28,106,94,140,14,31,74
"2011","Stratford-on-Avon 003B","E01031240","Total",579,162,85,77,417,30,116,67,96,15,30,63
"2011","Stratford-on-Avon 003C","E01031241","Total",593,127,66,61,466,34,120,73,115,16,33,75
"2011","Stratford-on-Avon 003D","E01031242","Total",653,200,104,96,453,32,126,76,87,15,31,86
"2011","Stratford-on-Avon 004A","E01031219","Total",639,200,88,112,439,38,78,100,108,26,39,50
"2011","Stratford-on-Avon 004B","E01031220","Total",601,137,79,58,464,17,98,102,92,19,43,93
"2011","Stratford-on-Avon 004C","E01031221","Total",695,234,121,113,461,46,99,82,119,13,29,73
"2011","Stratford-on-Avon 004D","E01031222","Total",843,247,91,156,596,29,134,111,161,14,41,106
"2011","Stratford-on-Avon 004E","E01031223","Total",526,106,47,59,420,20,80,92,111,18,37,62
"2011","Stratford-on-Avon 004F","E01031224","Total",455,95,39,56,360,18,82,68,83,21,19,69
"2011","Stratford-on-Avon 005A","E01031197","Total",513,138,67,71,375,8,88,61,111,10,36,61
"2011","Stratford-on-Avon 005B","E01031198","Total",521,124,59,65,397,19,90,92,99,22,22,53
"2011","Stratford-on-Avon 005C","E01031199","Total",598,145,76,69,453,16,102,84,112,15,31,93
"2011","Stratford-on-Avon 005D","E01031200","Total",652,145,48,97,507,26,100,120,130,12,27,92
"2011","Stratford-on-Avon 005E","E01031201","Total",671,150,95,55,521,22,174,105,108,8,24,80
"2011","Stratford-on-Avon 005F","E01031210","Total",516,104,63,41,412,10,106,75,121,10,32,58
"2011","Stratford-on-Avon 005G","E01031211","Total",449,116,52,64,333,26,83,68,82,7,24,43
"2011","Stratford-on-Avon 006A","E01031183","Total",809,286,123,163,523,41,136,75,163,10,20,78
"2011","Stratford-on-Avon 006B","E01031184","Total",650,197,115,82,453,24,111,92,97,12,36,81
"2011","Stratford-on-Avon 006C","E01031185","Total",628,216,92,124,412,42,91,64,100,13,35,67
"2011","Stratford-on-Avon 006D","E01031186","Total",665,223,152,71,442,35,105,77,104,9,35,77
"2011","Stratford-on-Avon 007A","E01031187","Total",813,218,130,88,595,19,159,116,161,18,34,88
"2011","Stratford-on-Avon 007B","E01031188","Total",912,195,101,94,717,22,237,103,164,25,48,118
"2011","Stratford-on-Avon 007C","E01031208","Total",881,256,120,136,625,21,188,100,161,19,28,108
"2011","Stratford-on-Avon 008A","E01031217","Total",513,115,68,47,398,12,126,70,102,9,24,55
"2011","Stratford-on-Avon 008B","E01031218","Total",452,93,45,48,359,10,74,82,84,13,29,67
"2011","Stratford-on-Avon 008C","E01031249","Total",509,133,71,62,376,24,62,78,119,12,15,66
"2011","Stratford-on-Avon 008D","E01031250","Total",662,182,92,90,480,17,155,77,114,9,20,88
"2011","Stratford-on-Avon 008E","E01031251","Total",504,107,67,40,397,8,127,80,84,7,15,76
"2011","Stratford-on-Avon 008F","E01031252","Total",514,151,85,66,363,15,82,69,109,8,23,57
"2011","Stratford-on-Avon 008G","E01031253","Total",661,190,110,80,471,29,112,103,121,16,30,60
"2011","Stratford-on-Avon 009A","E01031228","Total",713,207,125,82,506,9,173,77,118,13,22,94
"2011","Stratford-on-Avon 009B","E01031229","Total",1005,484,200,284,521,21,151,61,209,7,16,56
"2011","Stratford-on-Avon 009C","E01031230","Total",972,238,85,153,734,50,102,166,218,26,43,129
"2011","Stratford-on-Avon 009D","E01031231","Total",1020,398,98,300,622,61,65,122,246,10,32,86
"2011","Stratford-on-Avon 009E","E01031236","Total",650,150,61,89,500,29,84,106,145,9,24,103
"2011","Stratford-on-Avon 009F","E01031238","Total",640,263,121,142,377,33,74,57,103,12,21,77
"2011","Stratford-on-Avon 010A","E01031225","Total",708,221,125,96,487,12,155,83,103,21,19,94
"2011","Stratford-on-Avon 010C","E01031227","Total",904,309,182,127,595,21,175,118,138,12,38,93
"2011","Stratford-on-Avon 010D","E01033250","Total",552,131,25,106,421,31,35,130,128,27,24,46
"2011","Stratford-on-Avon 010E","E01033251","Total",458,95,15,80,363,39,39,97,112,18,24,34
"2011","Stratford-on-Avon 010F","E01033252","Total",546,126,91,35,420,9,151,73,88,15,27,57
"2011","Stratford-on-Avon 011A","E01031232","Total",993,292,112,180,701,32,145,133,194,33,38,126
"2011","Stratford-on-Avon 011B","E01031233","Total",731,226,96,130,505,34,120,82,133,11,30,95
"2011","Stratford-on-Avon 011C","E01031234","Total",971,514,296,218,457,27,127,78,151,7,11,56
"2011","Stratford-on-Avon 011D","E01031235","Total",941,415,241,174,526,29,157,86,154,6,13,81
"2011","Stratford-on-Avon 011E","E01031237","Total",590,133,85,48,457,17,133,71,99,11,22,104
"2011","Stratford-on-Avon 012A","E01031189","Total",621,154,80,74,467,24,115,92,120,10,29,77
"2011","Stratford-on-Avon 012B","E01031190","Total",669,158,69,89,511,41,87,123,108,17,34,101
"2011","Stratford-on-Avon 012C","E01031191","Total",707,140,75,65,567,17,129,117,129,16,50,109
"2011","Stratford-on-Avon 012D","E01031192","Total",859,260,122,138,599,29,139,128,178,19,34,72
"2011","Stratford-on-Avon 012E","E01031248","Total",913,220,130,90,693,14,230,122,154,28,42,103
"2011","Stratford-on-Avon 013A","E01031194","Total",969,211,94,117,758,31,159,176,235,26,31,100
"2011","Stratford-on-Avon 013B","E01031205","Total",659,188,84,104,471,18,102,104,120,13,28,86
"2011","Stratford-on-Avon 013C","E01031206","Total",607,187,77,110,420,21,103,90,85,18,28,75
"2011","Stratford-on-Avon 013D","E01031207","Total",540,139,51,88,401,25,82,67,124,16,22,65
"2011","Stratford-on-Avon 013E","E01031247","Total",965,229,135,94,736,16,202,118,209,26,47,118
"2011","Stratford-on-Avon 014A","E01031196","Total",975,232,106,126,743,37,182,156,182,27,51,108
"2011","Stratford-on-Avon 014B","E01031212","Total",1105,270,110,160,835,63,177,180,233,27,49,106
"2011","Stratford-on-Avon 014C","E01031245","Total",544,153,95,58,391,10,133,62,87,13,21,65
"2011","Stratford-on-Avon 014D","E01031246","Total",464,121,79,42,343,11,79,71,97,9,16,60
"2011","Stratford-on-Avon 015A","E01031193","Total",948,270,144,126,678,26,186,119,181,14,47,105
"2011","Stratford-on-Avon 015B","E01031209","Total",975,280,162,118,695,23,218,121,204,15,31,83
"2011","Stratford-on-Avon 015C","E01031214","Total",776,187,107,80,589,22,177,116,138,27,34,75
"2011","Stratford-on-Avon 015D","E01031215","Total",865,349,170,179,516,27,119,94,165,8,21,82
"2011","Stratford-on-Avon 015E","E01031216","Total",677,236,147,89,441,26,119,67,114,11,21,83
"2011","Warwick 001A","E01031254","Total",624,145,88,57,479,6,112,107,127,8,28,91
"2011","Warwick 001B","E01031255","Total",627,155,88,67,472,14,123,104,127,18,29,57
"2011","Warwick 001C","E01031256","Total",795,274,137,137,521,20,187,72,138,13,19,72
"2011","Warwick 001D","E01031257","Total",666,272,79,193,394,32,48,76,141,13,25,59
"2011","Warwick 001E","E01031258","Total",775,345,189,156,430,28,106,83,130,11,19,53
"2011","Warwick 002A","E01031296","Total",718,210,74,136,508,41,65,110,174,17,30,71
"2011","Warwick 002B","E01031297","Total",876,303,100,203,573,43,103,131,160,22,37,77
"2011","Warwick 002C","E01031298","Total",796,292,179,113,504,27,127,110,137,7,26,70
"2011","Warwick 002D","E01031299","Total",560,87,54,33,473,14,139,90,98,17,36,79
"2011","Warwick 002E","E01031300","Total",708,157,64,93,551,17,119,132,157,17,35,74
"2011","Warwick 003A","E01031303","Total",714,293,151,142,421,34,104,72,110,19,17,65
"2011","Warwick 003B","E01031304","Total",603,153,96,57,450,27,124,84,75,23,32,85
"2011","Warwick 003C","E01031305","Total",654,169,138,31,485,7,189,77,95,14,28,75
"2011","Warwick 003D","E01031306","Total",601,152,75,77,449,18,104,95,97,23,36,76
"2011","Warwick 003E","E01031307","Total",664,209,112,97,455,11,155,73,95,13,28,80
"2011","Warwick 004A","E01031281","Total",626,157,69,88,469,12,104,84,144,18,31,76
"2011","Warwick 004B","E01031282","Total",669,215,92,123,454,22,123,78,130,14,23,64
"2011","Warwick 004C","E01031283","Total",526,120,51,69,406,16,88,69,125,11,33,64
"2011","Warwick 004D","E01031284","Total",506,103,48,55,403,18,102,65,107,17,19,75
"2011","Warwick 005A","E01031277","Total",642,162,91,71,480,17,122,109,104,17,23,88
"2011","Warwick 005B","E01031278","Total",566,117,53,64,449,9,115,87,101,20,41,76
"2011","Warwick 005C","E01031279","Total",622,193,113,80,429,19,162,58,86,12,21,71
"2011","Warwick 005D","E01031280","Total",524,105,45,60,419,14,91,86,100,12,21,95
"2011","Warwick 005E","E01031301","Total",590,126,76,50,464,18,117,58,138,19,28,86
"2011","Warwick 005F","E01031302","Total",434,120,61,59,314,20,55,60,86,7,24,62
"2011","Warwick 005G","E01031308","Total",850,304,99,205,546,18,141,106,143,17,37,84
"2011","Warwick 006A","E01031273","Total",656,299,32,267,357,66,42,61,97,12,21,58
"2011","Warwick 006B","E01031274","Total",621,193,87,106,428,74,67,75,94,17,25,76
"2011","Warwick 006C","E01031275","Total",529,131,76,55,398,9,124,66,86,12,30,71
"2011","Warwick 006D","E01031276","Total",636,178,83,95,458,53,62,80,128,15,42,78
"2011","Warwick 007B","E01031272","Total",784,259,60,199,525,25,81,67,199,23,26,104
"2011","Warwick 007C","E01031285","Total",1043,445,196,249,598,14,154,85,222,16,21,86
"2011","Warwick 007D","E01031286","Total",695,263,147,116,432,34,81,109,123,12,16,57
"2011","Warwick 007E","E01031287","Total",583,122,80,42,461,17,91,109,85,23,41,95
"2011","Warwick 007F","E01031288","Total",713,228,124,104,485,13,136,95,123,21,25,72
"2011","Warwick 007G","E01031289","Total",569,111,58,53,458,18,74,117,123,15,35,76
"2011","Warwick 007H","E01033253","Total",751,362,64,298,389,23,35,32,203,1,5,90
"2011","Warwick 007I","E01033256","Total",707,396,88,308,311,11,25,41,160,2,6,66
"2011","Warwick 008A","E01031309","Total",764,253,88,165,511,45,80,116,153,16,33,68
"2011","Warwick 008B","E01031310","Total",559,138,79,59,421,21,97,71,110,12,30,80
"2011","Warwick 008C","E01031311","Total",569,175,74,101,394,35,83,75,88,15,28,70
"2011","Warwick 008D","E01031312","Total",542,179,47,132,363,43,55,81,101,7,23,53
"2011","Warwick 008E","E01031313","Total",591,147,91,56,444,12,103,71,138,10,18,92
"2011","Warwick 008F","E01031314","Total",605,185,65,120,420,16,75,88,141,7,19,74
"2011","Warwick 009A","E01031290","Total",833,340,68,272,493,28,72,84,218,9,23,59
"2011","Warwick 009B","E01031291","Total",788,408,62,346,380,18,43,49,161,3,8,98
"2011","Warwick 009C","E01031292","Total",649,174,69,105,475,32,73,107,164,14,21,64
"2011","Warwick 009D","E01031293","Total",702,249,92,157,453,33,67,98,150,16,30,59
"2011","Warwick 009E","E01031294","Total",646,224,76,148,422,18,70,88,127,22,27,70
"2011","Warwick 009F","E01031295","Total",497,129,77,52,368,1,134,52,75,14,29,63
"2011","Warwick 010A","E01031271","Total",874,403,180,223,471,21,96,72,160,19,19,84
"2011","Warwick 010B","E01031332","Total",519,140,41,99,379,54,48,64,74,14,48,77
"2011","Warwick 010C","E01031333","Total",482,106,33,73,376,24,54,59,85,14,54,86
"2011","Warwick 010D","E01031334","Total",657,181,76,105,476,51,49,105,167,12,26,66
"2011","Warwick 010E","E01031335","Total",627,247,31,216,380,16,26,63,161,9,24,81
"2011","Warwick 010F","E01031336","Total",832,342,46,296,490,27,27,44,162,10,14,206
"2011","Warwick 010G","E01031337","Total",702,261,63,198,441,48,37,72,177,10,18,79
"2011","Warwick 011A","E01031321","Total",506,111,37,74,395,44,43,110,89,23,29,57
"2011","Warwick 011B","E01031322","Total",851,292,97,195,559,36,84,112,194,18,29,86
"2011","Warwick 011C","E01031323","Total",805,343,145,198,462,26,95,91,168,7,19,56
"2011","Warwick 011D","E01031324","Total",1245,698,167,531,547,53,89,60,272,7,11,55
"2011","Warwick 011E","E01031325","Total",617,202,99,103,415,51,56,83,116,13,25,71
"2011","Warwick 011G","E01033254","Total",574,112,5,107,462,38,14,163,184,13,21,29
"2011","Warwick 011H","E01033255","Total",640,132,41,91,508,28,61,130,158,21,37,73
"2011","Warwick 012A","E01031315","Total",800,148,46,102,652,58,70,170,153,28,67,106
"2011","Warwick 012B","E01031316","Total",767,372,197,175,395,22,105,64,126,10,20,48
"2011","Warwick 012C","E01031317","Total",749,316,157,159,433,18,149,75,118,15,13,45
"2011","Warwick 012D","E01031318","Total",677,112,31,81,565,29,81,191,121,22,52,69
"2011","Warwick 012E","E01031319","Total",855,277,89,188,578,33,91,144,179,18,38,75
"2011","Warwick 012F","E01031320","Total",632,195,60,135,437,19,76,79,149,16,19,79
"2011","Warwick 013A","E01031261","Total",589,182,65,117,407,38,43,48,98,17,38,125
"2011","Warwick 013B","E01031262","Total",637,258,72,186,379,37,22,81,118,11,25,85
"2011","Warwick 013C","E01031263","Total",641,146,49,97,495,41,32,51,107,11,47,206
"2011","Warwick 013D","E01031264","Total",621,150,78,72,471,55,55,81,98,30,41,111
"2011","Warwick 013E","E01031265","Total",516,118,50,68,398,45,36,62,77,24,31,123
"2011","Warwick 013F","E01031266","Total",861,423,61,362,438,32,20,43,183,4,27,129
"2011","Warwick 014A","E01031259","Total",509,93,27,66,416,21,61,116,98,8,28,84
"2011","Warwick 014B","E01031260","Total",512,138,61,77,374,26,99,65,97,12,27,48
"2011","Warwick 014C","E01031267","Total",736,148,79,69,588,15,166,97,152,22,26,110
"2011","Warwick 014D","E01031268","Total",1087,246,68,178,841,60,94,266,238,34,40,109
"2011","Warwick 014E","E01031269","Total",743,209,82,127,534,28,135,98,156,16,26,75
"2011","Warwick 015A","E01031327","Total",628,181,91,90,447,52,80,86,91,15,40,83
"2011","Warwick 015B","E01031328","Total",885,199,89,110,686,42,136,144,175,18,41,130
"2011","Warwick 015C","E01031329","Total",985,210,84,126,775,68,98,200,214,25,59,111
"2011","Warwick 015D","E01031330","Total",599,155,72,83,444,38,73,84,131,13,32,73
"2011","Warwick 015E","E01031331","Total",751,228,122,106,523,28,92,121,122,12,40,108
"2011","Birmingham 001A","E01009417","Total",608,174,130,44,434,19,90,109,91,18,38,69
"2011","Birmingham 001B","E01009418","Total",645,184,97,87,461,46,117,86,98,12,31,71
"2011","Birmingham 001C","E01009419","Total",579,185,89,96,394,21,118,64,70,14,33,74
"2011","Birmingham 001D","E01009433","Total",746,187,121,66,559,24,145,105,132,19,22,112
"2011","Birmingham 002A","E01009415","Total",672,168,107,61,504,14,138,108,115,13,28,88
"2011","Birmingham 002B","E01009422","Total",864,291,152,139,573,23,184,113,134,22,29,68
"2011","Birmingham 002C","E01009423","Total",759,287,153,134,472,34,115,65,109,17,48,84
"2011","Birmingham 002D","E01009425","Total",846,352,206,146,494,27,166,74,114,16,35,62
"2011","Birmingham 003A","E01009416","Total",1008,233,80,153,775,65,100,228,175,42,70,95
"2011","Birmingham 003B","E01009420","Total",632,160,111,49,472,29,96,109,111,19,32,76
"2011","Birmingham 003C","E01009426","Total",607,142,104,38,465,13,160,85,90,9,38,70
"2011","Birmingham 003D","E01009429","Total",588,115,63,52,473,13,148,110,89,18,23,72
"2011","Birmingham 003E","E01009431","Total",611,116,76,40,495,18,133,104,101,19,44,76
"2011","Birmingham 004A","E01009421","Total",639,112,77,35,527,1,161,90,108,16,42,109
"2011","Birmingham 004B","E01009424","Total",689,262,94,168,427,26,77,89,135,15,27,58
"2011","Birmingham 004C","E01009427","Total",702,265,121,144,437,20,105,62,124,16,32,78
"2011","Birmingham 004D","E01009428","Total",650,96,70,26,554,14,176,82,129,17,34,102
"2011","Birmingham 004E","E01009430","Total",648,139,92,47,509,10,150,79,115,16,43,96
"2011","Birmingham 004F","E01009468","Total",626,184,99,85,442,6,147,75,67,13,38,96
"2011","Birmingham 005A","E01009445","Total",686,221,98,123,465,108,41,88,88,25,53,62
"2011","Birmingham 005B","E01009446","Total",1008,304,130,174,704,59,94,174,187,21,67,102
"2011","Birmingham 005C","E01009447","Total",629,168,87,81,461,30,96,99,88,23,54,71
"2011","Birmingham 005D","E01009448","Total",673,201,110,91,472,63,79,76,92,14,49,99
"2011","Birmingham 005E","E01009452","Total",682,193,122,71,489,32,99,92,109,14,39,104
"2011","Birmingham 005F","E01009455","Total",721,361,130,231,360,40,74,69,112,3,19,43
"2011","Birmingham 006A","E01009432","Total",642,185,75,110,457,56,97,85,89,23,27,80
"2011","Birmingham 006B","E01009435","Total",711,148,37,111,563,20,69,149,167,19,47,92
"2011","Birmingham 006C","E01009437","Total",806,293,148,145,513,28,127,101,111,23,35,88
"2011","Birmingham 006D","E01009444","Total",623,130,89,41,493,6,150,87,107,17,31,95
"2011","Birmingham 006E","E01009454","Total",655,196,50,146,459,17,81,115,134,13,30,69
"2011","Birmingham 007A","E01009221","Total",593,154,74,80,439,35,79,80,82,20,46,97
"2011","Birmingham 007B","E01009464","Total",530,110,70,40,420,10,106,64,75,16,48,101
"2011","Birmingham 007C","E01009465","Total",503,91,51,40,412,18,76,92,82,10,48,86
"2011","Birmingham 007D","E01009467","Total",662,175,94,81,487,24,123,85,120,13,34,88
"2011","Birmingham 008A","E01009220","Total",628,164,67,97,464,52,59,110,112,10,46,75
"2011","Birmingham 008B","E01009222","Total",604,177,62,115,427,66,47,79,80,37,40,78
"2011","Birmingham 008C","E01009224","Total",620,177,100,77,443,33,125,71,77,18,45,74
"2011","Birmingham 008D","E01009233","Total",628,188,77,111,440,69,49,88,101,23,39,71
"2011","Birmingham 009A","E01009449","Total",949,428,183,245,521,35,90,81,210,16,26,63
"2011","Birmingham 009B","E01009451","Total",652,270,93,177,382,29,40,91,116,15,39,52
"2011","Birmingham 009C","E01009453","Total",526,98,54,44,428,19,57,90,86,20,43,113
"2011","Birmingham 009D","E01009466","Total",668,165,82,83,503,14,98,104,137,15,34,101
"2011","Birmingham 009E","E01009471","Total",701,219,109,110,482,13,80,85,129,20,41,114
"2011","Birmingham 010A","E01009135","Total",597,169,82,87,428,16,93,60,115,8,36,100
"2011","Birmingham 010B","E01009469","Total",591,145,69,76,446,11,127,75,98,14,26,95
"2011","Birmingham 010C","E01009470","Total",532,83,55,28,449,5,117,74,89,13,35,116
"2011","Birmingham 010D","E01009472","Total",635,136,73,63,499,23,108,105,94,33,35,101
"2011","Birmingham 010E","E01009473","Total",682,224,113,111,458,26,70,104,118,22,40,78
"2011","Birmingham 010F","E01009474","Total",635,167,103,64,468,22,69,111,110,18,36,102
"2011","Birmingham 011A","E01009127","Total",586,169,62,107,417,92,39,75,61,23,49,78
"2011","Birmingham 011B","E01009128","Total",532,159,56,103,373,47,48,54,79,34,47,64
"2011","Birmingham 011C","E01009130","Total",608,194,84,110,414,64,43,64,105,22,52,64
"2011","Birmingham 011D","E01009131","Total",517,132,46,86,385,50,34,62,72,33,60,74
"2011","Birmingham 011E","E01009133","Total",610,206,71,135,404,60,61,65,79,26,49,64
"2011","Birmingham 011F","E01009134","Total",664,239,102,137,425,63,73,65,80,22,40,82
"2011","Birmingham 011G","E01009137","Total",581,141,60,81,440,70,53,76,74,34,57,76
"2011","Birmingham 012A","E01009434","Total",626,153,39,114,473,24,59,128,135,22,36,69
"2011","Birmingham 012B","E01009436","Total",539,99,68,31,440,5,96,85,95,19,38,102
"2011","Birmingham 012C","E01009438","Total",608,163,48,115,445,12,68,98,132,12,29,94
"2011","Birmingham 012D","E01009440","Total",630,168,115,53,462,13,101,87,114,19,27,101
"2011","Birmingham 012E","E01009450","Total",679,185,90,95,494,20,115,90,106,10,43,110
"2011","Birmingham 013A","E01009223","Total",676,230,101,129,446,27,76,94,116,16,31,86
"2011","Birmingham 013B","E01009225","Total",764,330,202,128,434,62,105,62,86,17,41,61
"2011","Birmingham 013C","E01009227","Total",693,206,91,115,487,35,81,86,145,17,45,78
"2011","Birmingham 013D","E01009228","Total",677,193,106,87,484,49,74,105,103,18,42,93
"2011","Birmingham 014A","E01009121","Total",926,270,129,141,656,104,107,120,128,40,60,97
"2011","Birmingham 014B","E01009122","Total",665,258,114,144,407,64,48,66,79,28,49,73
"2011","Birmingham 014C","E01009129","Total",581,162,62,100,419,78,34,70,68,35,58,76
"2011","Birmingham 014D","E01009132","Total",616,201,94,107,415,76,39,84,79,32,37,68
"2011","Birmingham 014E","E01009136","Total",798,370,173,197,428,48,79,59,117,18,33,74
"2011","Birmingham 015A","E01009457","Total",608,108,69,39,500,12,160,57,112,21,34,104
"2011","Birmingham 015B","E01009459","Total",665,160,68,92,505,17,117,109,122,20,30,90
"2011","Birmingham 015C","E01009461","Total",522,94,55,39,428,8,116,75,103,12,31,83
"2011","Birmingham 015D","E01009463","Total",619,165,106,59,454,15,122,62,118,11,32,94
"2011","Birmingham 016A","E01009235","Total",625,134,69,65,491,35,92,101,103,17,36,107
"2011","Birmingham 016B","E01009243","Total",626,173,101,72,453,35,76,81,112,19,37,93
"2011","Birmingham 016C","E01009245","Total",565,149,73,76,416,33,70,98,62,17,29,107
"2011","Birmingham 016D","E01009246","Total",637,156,66,90,481,30,103,103,101,16,31,97
"2011","Birmingham 016E","E01009247","Total",571,135,74,61,436,32,69,89,91,17,52,86
"2011","Birmingham 017A","E01009226","Total",663,209,88,121,454,69,69,89,123,13,22,69
"2011","Birmingham 017B","E01009229","Total",637,167,84,83,470,32,73,96,110,18,38,103
"2011","Birmingham 017C","E01009230","Total",655,196,86,110,459,30,94,88,118,15,37,77
"2011","Birmingham 017D","E01009231","Total",758,212,128,84,546,37,101,89,118,22,51,128
"2011","Birmingham 018A","E01009001","Total",694,215,82,133,479,45,90,102,144,8,22,68
"2011","Birmingham 018B","E01009003","Total",690,254,81,173,436,25,88,54,119,13,30,107
"2011","Birmingham 018C","E01009456","Total",660,172,85,87,488,18,81,121,117,20,45,86
"2011","Birmingham 018D","E01009458","Total",784,399,264,135,385,19,133,67,73,6,31,56
"2011","Birmingham 018E","E01009460","Total",833,370,106,264,463,33,73,95,166,5,28,63
"2011","Birmingham 018F","E01009462","Total",798,303,138,165,495,37,71,97,170,5,25,90
"2011","Birmingham 019A","E01009234","Total",623,155,47,108,468,56,56,107,127,16,35,71
"2011","Birmingham 019B","E01009236","Total",636,173,91,82,463,49,70,101,106,23,25,89
"2011","Birmingham 019C","E01009244","Total",620,212,92,120,408,44,60,106,89,18,34,57
"2011","Birmingham 019D","E01009248","Total",696,139,55,84,557,64,72,110,147,23,42,99
"2011","Birmingham 020A","E01009403","Total",615,202,71,131,413,61,54,72,80,24,56,66
"2011","Birmingham 020B","E01009404","Total",632,176,68,108,456,76,53,83,99,19,42,84
"2011","Birmingham 020C","E01009405","Total",604,209,91,118,395,43,60,76,93,19,27,77
"2011","Birmingham 020D","E01009406","Total",775,339,160,179,436,51,62,87,109,19,38,70
"2011","Birmingham 020E","E01009407","Total",733,273,90,183,460,71,59,78,100,24,37,91
"2011","Birmingham 021A","E01009439","Total",619,179,114,65,440,20,133,77,113,12,26,59
"2011","Birmingham 021B","E01009441","Total",639,196,86,110,443,31,80,66,133,12,23,98
"2011","Birmingham 021C","E01009442","Total",605,154,112,42,451,17,113,87,93,12,31,98
"2011","Birmingham 021D","E01009443","Total",536,151,61,90,385,32,63,79,124,9,21,57
"2011","Birmingham 022A","E01009123","Total",611,219,82,137,392,52,57,70,85,16,41,71
"2011","Birmingham 022B","E01009124","Total",639,177,49,128,462,172,22,72,83,22,41,50
"2011","Birmingham 022C","E01009125","Total",689,198,89,109,491,60,65,85,105,30,57,89
"2011","Birmingham 022D","E01009232","Total",606,154,72,82,452,39,85,90,104,16,41,77
"2011","Birmingham 023A","E01009002","Total",653,237,75,162,416,121,36,83,73,20,25,58
"2011","Birmingham 023C","E01009006","Total",763,326,74,252,437,53,49,85,165,12,15,58
"2011","Birmingham 023D","E01009007","Total",777,358,104,254,419,66,30,78,124,19,25,77
"2011","Birmingham 023F","E01033632","Total",1018,409,155,254,609,132,84,99,118,30,51,95
"2011","Birmingham 024A","E01009237","Total",604,206,87,119,398,46,68,91,60,22,48,63
"2011","Birmingham 024B","E01009238","Total",632,186,112,74,446,23,90,58,87,26,60,102
"2011","Birmingham 024C","E01009240","Total",610,143,57,86,467,40,73,92,110,23,41,88
"2011","Birmingham 024D","E01009241","Total",608,136,64,72,472,43,65,92,80,31,63,98
"2011","Birmingham 024E","E01009242","Total",605,142,81,61,463,27,55,89,73,39,58,122
"2011","Birmingham 025A","E01009005","Total",643,288,121,167,355,29,66,70,109,15,19,47
"2011","Birmingham 025B","E01009009","Total",637,198,72,126,439,34,87,76,118,14,37,73
"2011","Birmingham 025C","E01009098","Total",933,330,134,196,603,64,102,131,152,23,48,83
"2011","Birmingham 025D","E01009100","Total",839,272,126,146,567,74,72,116,138,23,58,86
"2011","Birmingham 025E","E01009105","Total",653,167,71,96,486,24,98,110,116,17,35,86
"2011","Birmingham 026A","E01009126","Total",542,120,63,57,422,31,63,76,105,21,38,88
"2011","Birmingham 026B","E01009408","Total",657,204,92,112,453,45,47,77,88,32,69,95
"2011","Birmingham 026C","E01009409","Total",724,274,104,170,450,62,64,68,110,25,30,91
"2011","Birmingham 026D","E01009410","Total",764,297,142,155,467,49,74,71,105,14,53,101
"2011","Birmingham 028A","E01009008","Total",603,170,96,74,433,23,89,66,103,14,45,93
"2011","Birmingham 028B","E01009011","Total",783,287,129,158,496,37,99,82,108,19,39,112
"2011","Birmingham 028C","E01009012","Total",590,166,67,99,424,36,62,72,104,14,40,96
"2011","Birmingham 028D","E01009102","Total",630,207,80,127,423,62,46,86,94,20,40,75
"2011","Birmingham 028E","E01009104","Total",646,231,84,147,415,81,40,86,82,28,35,63
"2011","Birmingham 029A","E01009096","Total",774,319,112,207,455,53,101,58,103,20,46,74
"2011","Birmingham 029B","E01009097","Total",792,239,106,133,553,113,73,88,106,24,61,88
"2011","Birmingham 029C","E01009099","Total",811,306,79,227,505,133,55,80,122,19,42,54
"2011","Birmingham 029D","E01009101","Total",626,193,114,79,433,70,66,81,66,19,48,83
"2011","Birmingham 029E","E01009103","Total",657,229,115,114,428,84,73,64,82,13,51,61
"2011","Birmingham 029F","E01009106","Total",587,184,88,96,403,26,90,69,87,12,31,88
"2011","Birmingham 030A","E01008915","Total",506,138,48,90,368,53,32,70,71,40,36,66
"2011","Birmingham 030B","E01009411","Total",871,373,68,305,498,61,48,113,161,17,38,60
"2011","Birmingham 030C","E01009412","Total",651,211,79,132,440,42,47,79,93,17,64,98
"2011","Birmingham 030D","E01009413","Total",655,203,51,152,452,44,59,81,94,19,54,101
"2011","Birmingham 030E","E01009414","Total",768,232,39,193,536,76,45,95,145,29,48,98
"2011","Birmingham 031A","E01008998","Total",639,186,70,116,453,58,44,63,71,50,77,90
"2011","Birmingham 031B","E01008999","Total",522,151,59,92,371,28,47,49,52,29,73,93
"2011","Birmingham 031C","E01009000","Total",794,380,74,306,414,56,50,61,133,10,35,69
"2011","Birmingham 031D","E01009013","Total",857,373,94,279,484,57,49,95,126,26,46,85
"2011","Birmingham 031E","E01009400","Total",525,152,49,103,373,48,50,63,72,19,42,79
"2011","Birmingham 031F","E01009401","Total",636,219,46,173,417,62,41,64,78,28,57,87
"2011","Birmingham 031H","E01033630","Total",595,274,22,252,321,51,4,62,151,7,14,32
"2011","Birmingham 031I","E01033646","Total",772,404,89,315,368,62,29,70,95,11,37,64
"2011","Birmingham 032A","E01009049","Total",570,173,64,109,397,35,49,53,65,24,83,88
"2011","Birmingham 032B","E01009056","Total",749,297,39,258,452,48,33,78,79,29,83,102
"2011","Birmingham 032C","E01009263","Total",650,255,74,181,395,44,36,67,84,11,65,88
"2011","Birmingham 032D","E01009264","Total",585,352,69,283,233,40,16,43,88,6,16,24
"2011","Birmingham 032E","E01009265","Total",572,158,48,110,414,37,44,49,61,14,81,128
"2011","Birmingham 033A","E01009051","Total",478,104,35,69,374,31,19,34,48,42,74,126
"2011","Birmingham 033B","E01009053","Total",435,91,32,59,344,40,25,48,38,44,67,82
"2011","Birmingham 033C","E01009054","Total",417,51,26,25,366,9,41,45,24,41,99,107
"2011","Birmingham 033D","E01009058","Total",465,76,32,44,389,20,29,74,47,45,93,81
"2011","Birmingham 033E","E01009061","Total",432,70,28,42,362,22,27,33,30,38,137,75
"2011","Birmingham 033F","E01009239","Total",495,188,59,129,307,35,30,33,72,11,35,91
"2011","Birmingham 034A","E01009266","Total",615,163,49,114,452,56,43,73,76,27,64,113
"2011","Birmingham 034B","E01009269","Total",544,133,53,80,411,60,36,89,65,26,52,83
"2011","Birmingham 034C","E01009270","Total",646,186,62,124,460,75,28,65,57,37,91,107
"2011","Birmingham 034D","E01009271","Total",535,137,48,89,398,59,48,74,47,32,58,80
"2011","Birmingham 034E","E01009273","Total",512,121,64,57,391,32,49,45,46,36,75,108
"2011","Birmingham 035A","E01009050","Total",652,211,72,139,441,71,39,74,50,24,71,112
"2011","Birmingham 035D","E01009057","Total",647,197,47,150,450,62,41,69,48,51,92,87
"2011","Birmingham 035E","E01009059","Total",569,193,48,145,376,54,24,47,35,43,94,79
"2011","Birmingham 035F","E01009060","Total",426,103,25,78,323,32,16,41,33,36,89,76
"2011","Birmingham 035G","E01033621","Total",866,223,61,162,643,88,45,76,76,55,137,166
"2011","Birmingham 036A","E01009268","Total",432,57,31,26,375,14,49,59,41,21,78,113
"2011","Birmingham 036B","E01009272","Total",487,126,42,84,361,42,30,83,49,22,57,78
"2011","Birmingham 036C","E01009274","Total",739,239,66,173,500,67,39,87,53,29,100,125
"2011","Birmingham 036D","E01009349","Total",595,154,39,115,441,91,28,80,73,34,61,74
"2011","Birmingham 036E","E01009351","Total",564,114,34,80,450,81,41,80,61,28,68,91
"2011","Birmingham 036F","E01009354","Total",520,167,60,107,353,46,33,44,50,27,67,86
"2011","Birmingham 037A","E01008899","Total",478,200,61,139,278,47,21,55,52,30,39,34
"2011","Birmingham 037C","E01008901","Total",573,171,60,111,402,43,47,43,69,42,85,73
"2011","Birmingham 037E","E01008916","Total",454,103,30,73,351,47,22,61,52,67,61,41
"2011","Birmingham 037F","E01033636","Total",845,153,74,79,692,37,54,74,54,100,231,142
"2011","Birmingham 038A","E01009079","Total",719,278,42,236,441,114,55,63,79,27,39,64
"2011","Birmingham 038B","E01009080","Total",412,113,25,88,299,72,17,69,43,23,34,41
"2011","Birmingham 038C","E01009081","Total",558,232,89,143,326,71,35,42,53,26,43,56
"2011","Birmingham 038D","E01009083","Total",559,182,101,81,377,85,39,66,55,28,49,55
"2011","Birmingham 039A","E01009275","Total",476,114,38,76,362,48,29,47,51,26,83,78
"2011","Birmingham 039B","E01009350","Total",454,82,28,54,372,56,32,60,34,33,72,85
"2011","Birmingham 039C","E01009352","Total",465,105,28,77,360,35,33,37,31,29,106,89
"2011","Birmingham 039D","E01009353","Total",460,100,26,74,360,24,41,36,39,29,97,94
"2011","Birmingham 039E","E01009355","Total",522,181,35,146,341,37,29,41,46,17,95,76
"2011","Birmingham 039H","E01033635","Total",947,220,73,147,727,96,67,140,93,47,133,151
"2011","Birmingham 040A","E01008905","Total",421,72,16,56,349,25,23,43,25,58,107,68
"2011","Birmingham 040B","E01008907","Total",560,195,64,131,365,55,23,52,63,40,69,63
"2011","Birmingham 040C","E01009047","Total",552,182,60,122,370,41,37,35,39,30,103,85
"2011","Birmingham 040D","E01009048","Total",567,217,31,186,350,33,25,45,49,24,94,80
"2011","Birmingham 040E","E01009062","Total",476,108,34,74,368,42,19,47,39,50,112,59
"2011","Birmingham 041D","E01008909","Total",472,101,34,67,371,53,19,58,45,63,84,49
"2011","Birmingham 041F","E01033628","Total",754,245,105,140,509,57,37,81,51,65,127,91
"2011","Birmingham 041G","E01033637","Total",850,249,103,146,601,71,50,80,60,74,148,118
"2011","Birmingham 042A","E01009084","Total",515,103,58,45,412,32,63,54,38,45,105,75
"2011","Birmingham 042B","E01009085","Total",505,69,41,28,436,23,58,37,47,49,136,86
"2011","Birmingham 042C","E01009087","Total",582,154,90,64,428,17,90,71,86,28,45,91
"2011","Birmingham 042D","E01009089","Total",495,95,63,32,400,25,69,74,46,38,64,84
"2011","Birmingham 042E","E01009090","Total",540,120,61,59,420,29,64,48,53,43,91,92
"2011","Birmingham 043A","E01009201","Total",695,277,116,161,418,66,56,54,74,39,62,67
"2011","Birmingham 043B","E01009202","Total",593,205,61,144,388,83,41,65,65,36,44,54
"2011","Birmingham 043C","E01009203","Total",1145,431,85,346,714,222,39,172,89,62,68,62
"2011","Birmingham 044A","E01009082","Total",500,114,54,60,386,46,62,71,55,29,49,74
"2011","Birmingham 044B","E01009086","Total",605,145,64,81,460,31,73,75,63,48,86,84
"2011","Birmingham 044C","E01009480","Total",583,145,72,73,438,60,41,69,73,61,69,65
"2011","Birmingham 044D","E01009481","Total",696,173,88,85,523,46,48,82,66,82,115,84
"2011","Birmingham 044E","E01009486","Total",587,132,40,92,455,40,33,80,61,66,98,77
"2011","Birmingham 044F","E01009487","Total",604,141,45,96,463,34,35,70,46,71,142,65
"2011","Birmingham 045A","E01009088","Total",711,267,153,114,444,45,115,51,85,23,44,81
"2011","Birmingham 045B","E01009091","Total",663,224,83,141,439,52,80,80,105,17,43,62
"2011","Birmingham 045C","E01009305","Total",753,308,100,208,445,107,50,89,102,15,33,49
"2011","Birmingham 045D","E01009307","Total",759,334,142,192,425,83,77,76,92,10,23,64
"2011","Birmingham 045E","E01009309","Total",657,288,104,184,369,73,46,63,86,11,34,56
"2011","Birmingham 046A","E01009304","Total",836,332,158,174,504,74,69,105,120,15,53,68
"2011","Birmingham 046B","E01009306","Total",684,232,119,113,452,62,80,73,97,22,29,89
"2011","Birmingham 046C","E01009308","Total",805,263,109,154,542,101,69,123,105,36,46,62
"2011","Birmingham 046D","E01009310","Total",803,268,123,145,535,96,81,80,120,32,51,75
"2011","Birmingham 047A","E01009348","Total",801,259,63,196,542,88,47,95,142,27,53,90
"2011","Birmingham 047B","E01009358","Total",691,252,43,209,439,47,30,53,75,42,101,91
"2011","Birmingham 047C","E01009359","Total",710,184,56,128,526,79,42,80,103,35,69,118
"2011","Birmingham 047D","E01009360","Total",920,267,61,206,653,132,46,124,128,46,68,109
"2011","Birmingham 047E","E01009361","Total",827,275,89,186,552,114,44,130,94,27,64,79
"2011","Birmingham 048A","E01009478","Total",655,207,65,142,448,69,36,75,85,59,62,62
"2011","Birmingham 048B","E01009479","Total",607,147,78,69,460,35,31,55,50,81,117,91
"2011","Birmingham 048C","E01009482","Total",472,107,28,79,365,28,19,61,34,63,90,70
"2011","Birmingham 048D","E01009484","Total",515,154,53,101,361,45,23,51,41,51,98,52
"2011","Birmingham 048E","E01009485","Total",488,103,35,68,385,29,40,47,31,57,118,63
"2011","Birmingham 049A","E01008906","Total",476,101,34,67,375,39,21,58,24,66,109,58
"2011","Birmingham 049B","E01008911","Total",596,195,30,165,401,117,16,68,54,48,50,48
"2011","Birmingham 049D","E01009347","Total",755,294,62,232,461,100,45,75,98,28,43,72
"2011","Birmingham 049E","E01033559","Total",769,374,8,366,395,19,4,33,301,0,3,35
"2011","Birmingham 049F","E01033638","Total",668,260,71,189,408,103,32,60,58,46,58,51
"2011","Birmingham 050A","E01008910","Total",661,242,52,190,419,94,12,83,52,45,77,56
"2011","Birmingham 050B","E01008913","Total",681,339,61,278,342,79,32,62,61,30,42,36
"2011","Birmingham 050C","E01008914","Total",895,387,49,338,508,124,15,91,119,33,40,86
"2011","Birmingham 050E","E01033561","Total",492,212,46,166,280,47,8,23,92,10,25,75
"2011","Birmingham 050F","E01033617","Total",407,165,11,154,242,6,0,10,144,1,3,78
"2011","Birmingham 051A","E01009194","Total",679,141,49,92,538,36,18,63,40,86,182,113
"2011","Birmingham 051B","E01009483","Total",504,114,35,79,390,46,26,56,44,54,115,49
"2011","Birmingham 051C","E01009488","Total",688,181,71,110,507,81,47,70,73,69,91,76
"2011","Birmingham 051D","E01009489","Total",526,84,25,59,442,44,29,71,50,77,102,69
"2011","Birmingham 051E","E01009491","Total",470,101,33,68,369,13,31,39,44,69,105,68
"2011","Birmingham 052B","E01009192","Total",614,76,25,51,538,32,38,53,40,78,193,104
"2011","Birmingham 052D","E01009199","Total",577,221,31,190,356,54,15,92,72,24,43,56
"2011","Birmingham 052E","E01009204","Total",706,280,66,214,426,103,29,79,61,44,57,53
"2011","Birmingham 052F","E01033644","Total",810,149,35,114,661,79,35,70,72,86,189,130
"2011","Birmingham 053A","E01009151","Total",614,132,42,90,482,56,38,83,65,61,95,84
"2011","Birmingham 053B","E01009152","Total",624,177,42,135,447,33,27,49,64,34,115,125
"2011","Birmingham 053C","E01009153","Total",850,303,67,236,547,80,50,63,128,27,75,124
"2011","Birmingham 053D","E01009345","Total",527,145,38,107,382,98,17,62,48,39,58,60
"2011","Birmingham 053E","E01009346","Total",540,134,28,106,406,61,22,81,57,44,74,67
"2011","Birmingham 054A","E01009092","Total",632,181,62,119,451,124,27,85,69,33,50,63
"2011","Birmingham 054B","E01009093","Total",648,192,67,125,456,100,44,116,92,23,26,55
"2011","Birmingham 054C","E01009094","Total",532,131,39,92,401,66,51,74,74,30,37,69
"2011","Birmingham 054D","E01009298","Total",577,130,37,93,447,99,39,87,81,23,58,60
"2011","Birmingham 054E","E01009311","Total",583,126,44,82,457,81,42,97,79,34,51,73
"2011","Birmingham 054F","E01009511","Total",507,149,63,86,358,50,50,49,49,31,69,60
"2011","Birmingham 055A","E01009475","Total",589,129,47,82,460,58,41,62,45,74,105,75
"2011","Birmingham 055B","E01009476","Total",570,181,66,115,389,28,35,55,37,84,93,57
"2011","Birmingham 055C","E01009477","Total",573,132,46,86,441,55,41,78,83,42,58,84
"2011","Birmingham 055D","E01009490","Total",669,216,70,146,453,62,42,72,74,46,84,73
"2011","Birmingham 055E","E01009492","Total",542,131,43,88,411,45,33,71,58,63,72,69
"2011","Birmingham 056A","E01009095","Total",637,199,76,123,438,38,66,83,73,40,71,67
"2011","Birmingham 056B","E01009507","Total",606,270,107,163,336,58,45,44,55,21,59,54
"2011","Birmingham 056C","E01009508","Total",597,181,65,116,416,32,83,67,78,31,42,83
"2011","Birmingham 056D","E01009509","Total",634,226,55,171,408,42,51,58,74,35,84,64
"2011","Birmingham 056E","E01009510","Total",670,266,140,126,404,56,83,55,60,27,44,79
"2011","Birmingham 057A","E01009297","Total",727,263,122,141,464,51,95,66,114,13,34,91
"2011","Birmingham 057B","E01009299","Total",646,201,86,115,445,71,54,74,80,30,45,91
"2011","Birmingham 057C","E01009300","Total",713,206,80,126,507,108,44,80,109,37,44,85
"2011","Birmingham 057D","E01009301","Total",806,381,127,254,425,75,69,75,107,15,28,56
"2011","Birmingham 057E","E01009303","Total",723,309,98,211,414,59,71,87,105,11,26,55
"2011","Birmingham 058A","E01009195","Total",678,114,49,65,564,53,35,76,66,102,149,83
"2011","Birmingham 058C","E01009197","Total",452,77,23,54,375,41,20,67,44,61,93,49
"2011","Birmingham 058D","E01009198","Total",449,72,22,50,377,45,19,57,39,90,83,44
"2011","Birmingham 058E","E01033647","Total",403,81,27,54,322,39,29,65,43,59,60,27
"2011","Birmingham 058F","E01033649","Total",465,75,33,42,390,36,20,76,39,77,89,53
"2011","Birmingham 060A","E01009138","Total",547,122,36,86,425,21,41,85,89,21,67,101
"2011","Birmingham 060B","E01009139","Total",576,158,37,121,418,39,40,76,92,23,51,97
"2011","Birmingham 060C","E01009140","Total",732,272,61,211,460,34,57,60,99,18,62,130
"2011","Birmingham 060D","E01009145","Total",719,240,41,199,479,46,35,89,83,30,78,118
"2011","Birmingham 060E","E01009147","Total",657,305,29,276,352,31,21,46,90,13,42,109
"2011","Birmingham 062A","E01009512","Total",610,152,68,84,458,61,68,78,85,27,55,84
"2011","Birmingham 062B","E01009514","Total",594,228,86,142,366,61,42,58,57,22,51,75
"2011","Birmingham 062C","E01009516","Total",531,144,71,73,387,38,55,70,79,24,49,72
"2011","Birmingham 062D","E01009517","Total",665,204,102,102,461,51,43,107,88,26,58,88
"2011","Birmingham 063A","E01009325","Total",493,89,30,59,404,42,44,52,37,66,103,60
"2011","Birmingham 063D","E01009342","Total",438,81,35,46,357,26,31,48,34,41,100,77
"2011","Birmingham 063E","E01009343","Total",525,135,40,95,390,44,27,68,56,53,74,68
"2011","Birmingham 063F","E01033642","Total",820,139,65,74,681,62,64,98,63,98,187,109
"2011","Birmingham 064A","E01008986","Total",859,407,41,366,452,50,28,80,162,15,30,87
"2011","Birmingham 064B","E01008987","Total",637,256,89,167,381,26,26,34,103,10,23,159
"2011","Birmingham 064C","E01008988","Total",975,503,50,453,472,20,21,64,200,15,53,99
"2011","Birmingham 064D","E01008989","Total",930,539,128,411,391,44,35,63,167,4,22,56
"2011","Birmingham 064E","E01008990","Total",468,160,65,95,308,6,58,48,112,13,20,51
"2011","Birmingham 064F","E01008991","Total",581,150,80,70,431,10,124,92,81,14,42,68
"2011","Birmingham 066A","E01008882","Total",687,238,88,150,449,72,46,96,75,40,43,77
"2011","Birmingham 066B","E01008896","Total",564,161,49,112,403,50,44,77,60,43,57,72
"2011","Birmingham 066C","E01008898","Total",563,146,55,91,417,48,47,84,58,44,79,57
"2011","Birmingham 066D","E01009326","Total",560,123,54,69,437,40,34,61,54,72,91,85
"2011","Birmingham 066E","E01009341","Total",544,165,53,112,379,61,46,61,57,42,67,45
"2011","Birmingham 066F","E01009513","Total",616,178,76,102,438,46,44,81,75,47,65,80
"2011","Birmingham 067A","E01008881","Total",619,216,104,112,403,43,68,50,75,36,51,80
"2011","Birmingham 067B","E01008897","Total",602,158,62,96,444,29,62,64,84,40,70,95
"2011","Birmingham 067C","E01009515","Total",637,240,115,125,397,27,90,53,78,15,57,77
"2011","Birmingham 067D","E01009518","Total",697,256,138,118,441,34,83,59,112,17,49,87
"2011","Birmingham 067E","E01009521","Total",613,146,67,79,467,30,75,80,100,22,48,112
"2011","Birmingham 069A","E01009302","Total",635,194,94,100,441,37,111,61,112,10,25,85
"2011","Birmingham 069B","E01009314","Total",661,219,128,91,442,54,90,64,97,17,43,77
"2011","Birmingham 069C","E01009321","Total",791,286,148,138,505,111,66,96,96,24,44,68
"2011","Birmingham 069D","E01009322","Total",603,229,84,145,374,65,39,67,90,17,43,53
"2011","Birmingham 069E","E01009323","Total",569,169,92,77,400,41,64,61,81,24,53,76
"2011","Birmingham 070A","E01009329","Total",645,159,38,121,486,39,29,54,62,52,144,106
"2011","Birmingham 070B","E01009334","Total",425,76,44,32,349,16,27,31,15,41,136,83
"2011","Birmingham 070C","E01009337","Total",479,117,27,90,362,26,18,51,30,72,98,67
"2011","Birmingham 070D","E01009338","Total",408,73,22,51,335,30,20,47,36,40,92,70
"2011","Birmingham 070E","E01009380","Total",465,92,26,66,373,52,22,51,47,57,94,50
"2011","Birmingham 071A","E01009362","Total",516,216,33,183,300,53,20,54,46,34,46,47
"2011","Birmingham 071B","E01009363","Total",547,198,57,141,349,33,35,58,59,33,66,65
"2011","Birmingham 071C","E01009364","Total",515,185,23,162,330,89,25,52,46,32,41,45
"2011","Birmingham 071D","E01009365","Total",554,190,41,149,364,38,26,32,60,37,82,89
"2011","Birmingham 071E","E01009379","Total",686,347,156,191,339,35,50,38,49,40,71,56
"2011","Birmingham 072A","E01009312","Total",614,168,108,60,446,23,90,76,83,23,51,100
"2011","Birmingham 072B","E01009324","Total",727,228,131,97,499,47,107,84,129,9,39,84
"2011","Birmingham 072C","E01009519","Total",606,145,79,66,461,29,98,92,90,14,32,106
"2011","Birmingham 072D","E01009520","Total",717,222,119,103,495,23,99,87,108,19,62,97
"2011","Birmingham 073A","E01009066","Total",601,180,81,99,421,2,89,84,89,17,45,95
"2011","Birmingham 073B","E01009070","Total",687,231,93,138,456,18,76,108,128,22,32,72
"2011","Birmingham 073C","E01009252","Total",621,180,57,123,441,15,73,87,139,14,36,77
"2011","Birmingham 073D","E01009260","Total",640,233,137,96,407,9,103,55,82,13,48,97
"2011","Birmingham 073E","E01009261","Total",667,195,109,86,472,27,89,89,119,19,33,96
"2011","Birmingham 074A","E01008984","Total",754,363,108,255,391,30,42,72,78,16,29,124
"2011","Birmingham 074B","E01008994","Total",673,261,87,174,412,19,59,63,142,16,23,90
"2011","Birmingham 074C","E01008996","Total",599,227,89,138,372,59,53,55,44,31,71,59
"2011","Birmingham 074D","E01008997","Total",599,195,59,136,404,26,75,64,96,20,38,85
"2011","Birmingham 075A","E01009065","Total",661,207,73,134,454,20,65,118,123,22,31,75
"2011","Birmingham 075B","E01009067","Total",677,259,113,146,418,16,65,93,149,15,27,53
"2011","Birmingham 075C","E01009068","Total",714,271,89,182,443,17,46,78,166,13,17,106
"2011","Birmingham 075D","E01009069","Total",823,342,105,237,481,23,52,77,236,8,6,79
"2011","Birmingham 075E","E01009072","Total",802,318,95,223,484,27,51,75,225,13,20,73
"2011","Birmingham 076A","E01008885","Total",504,117,64,53,387,40,57,75,86,14,33,82
"2011","Birmingham 076B","E01008886","Total",714,282,115,167,432,53,59,85,115,18,29,73
"2011","Birmingham 076C","E01008888","Total",639,158,67,91,481,31,64,99,116,25,56,90
"2011","Birmingham 076D","E01009313","Total",630,178,82,96,452,44,95,85,75,15,45,93
"2011","Birmingham 077A","E01009368","Total",417,137,27,110,280,21,11,35,31,25,89,68
"2011","Birmingham 077D","E01009371","Total",478,86,21,65,392,39,19,58,38,49,106,83
"2011","Birmingham 077E","E01009397","Total",450,67,15,52,383,43,26,44,41,44,103,82
"2011","Birmingham 077F","E01033650","Total",671,132,60,72,539,27,42,69,48,84,157,112
"2011","Birmingham 078A","E01008883","Total",651,180,74,106,471,51,51,99,82,40,56,92
"2011","Birmingham 078B","E01008884","Total",682,205,78,127,477,94,25,99,92,41,57,69
"2011","Birmingham 078C","E01008887","Total",626,199,72,127,427,72,46,79,109,25,34,62
"2011","Birmingham 078D","E01008889","Total",659,242,82,160,417,31,61,72,93,39,54,67
"2011","Birmingham 079A","E01008982","Total",667,307,54,253,360,19,33,55,145,12,19,77
"2011","Birmingham 079C","E01008992","Total",482,161,66,95,321,5,61,59,94,14,32,56
"2011","Birmingham 079E","E01009283","Total",593,182,50,132,411,29,48,86,123,10,29,86
"2011","Birmingham 079F","E01033631","Total",836,263,59,204,573,5,91,85,177,22,51,142
"2011","Birmingham 080A","E01009249","Total",629,146,77,69,483,44,95,96,109,23,33,83
"2011","Birmingham 080B","E01009250","Total",689,183,71,112,506,53,113,71,129,17,39,84
"2011","Birmingham 080C","E01009251","Total",627,150,82,68,477,26,92,83,142,13,33,88
"2011","Birmingham 080D","E01009253","Total",624,145,68,77,479,37,95,90,113,16,39,89
"2011","Birmingham 080E","E01009255","Total",633,175,84,91,458,65,56,86,105,26,34,86
"2011","Birmingham 080F","E01009257","Total",596,165,68,97,431,53,69,82,79,34,39,75
"2011","Birmingham 081A","E01009315","Total",783,314,142,172,469,35,147,62,105,13,21,86
"2011","Birmingham 081B","E01009316","Total",683,207,88,119,476,33,79,83,123,21,47,90
"2011","Birmingham 081C","E01009317","Total",760,259,99,160,501,91,89,80,121,12,32,76
"2011","Birmingham 081D","E01009318","Total",627,157,77,80,470,32,87,83,124,18,36,90
"2011","Birmingham 081E","E01009319","Total",653,163,65,98,490,21,85,88,129,17,43,107
"2011","Birmingham 081F","E01009320","Total",609,149,76,73,460,23,95,77,95,21,40,109
"2011","Birmingham 082A","E01009372","Total",420,50,19,31,370,13,19,56,36,64,110,72
"2011","Birmingham 082B","E01009373","Total",466,77,34,43,389,20,25,61,38,60,115,70
"2011","Birmingham 082D","E01009396","Total",478,80,17,63,398,14,27,22,32,42,154,107
"2011","Birmingham 082F","E01033643","Total",814,147,59,88,667,59,46,89,77,92,180,124
"2011","Birmingham 083A","E01009367","Total",490,146,43,103,344,22,27,48,49,36,91,71
"2011","Birmingham 083B","E01009375","Total",522,120,29,91,402,35,15,62,41,63,114,72
"2011","Birmingham 083C","E01009377","Total",452,138,27,111,314,54,23,45,49,54,45,44
"2011","Birmingham 083D","E01009383","Total",418,114,25,89,304,17,23,24,45,29,75,91
"2011","Birmingham 083E","E01009399","Total",416,64,28,36,352,28,19,55,43,66,76,65
"2011","Birmingham 084A","E01009366","Total",517,151,47,104,366,25,34,61,67,50,82,47
"2011","Birmingham 084B","E01009374","Total",423,164,46,118,259,39,31,25,39,33,48,44
"2011","Birmingham 084C","E01009376","Total",564,210,54,156,354,49,26,42,62,36,83,56
"2011","Birmingham 084F","E01033648","Total",826,253,46,207,573,58,34,78,87,55,156,105
"2011","Birmingham 085A","E01009073","Total",657,183,43,140,474,167,32,95,74,26,32,48
"2011","Birmingham 085B","E01009074","Total",667,229,50,179,438,90,38,72,88,33,53,64
"2011","Birmingham 085C","E01009254","Total",669,235,102,133,434,43,83,77,95,9,42,85
"2011","Birmingham 085D","E01009256","Total",663,202,86,116,461,52,77,89,114,13,44,72
"2011","Birmingham 085E","E01009258","Total",661,248,106,142,413,89,56,65,76,20,45,62
"2011","Birmingham 087B","E01009071","Total",789,374,171,203,415,31,77,71,127,14,24,71
"2011","Birmingham 087C","E01009075","Total",829,441,171,270,388,40,55,50,97,13,19,114
"2011","Birmingham 087E","E01009078","Total",626,212,65,147,414,26,41,61,128,9,12,137
"2011","Birmingham 087F","E01033562","Total",1045,367,111,256,678,41,97,115,167,15,40,203
"2011","Birmingham 088C","E01009183","Total",572,150,44,106,422,9,63,65,107,19,59,100
"2011","Birmingham 088D","E01009186","Total",760,264,81,183,496,20,73,104,177,17,33,72
"2011","Birmingham 088E","E01033645","Total",863,171,47,124,692,47,35,73,75,69,214,179
"2011","Birmingham 089A","E01008890","Total",705,267,79,188,438,42,36,83,127,30,52,68
"2011","Birmingham 089B","E01008891","Total",689,237,88,149,452,41,74,88,116,18,33,82
"2011","Birmingham 089C","E01008892","Total",518,106,31,75,412,58,43,65,80,29,57,80
"2011","Birmingham 089D","E01008893","Total",725,261,57,204,464,32,50,91,132,29,42,88
"2011","Birmingham 089E","E01008894","Total",658,359,140,219,299,17,43,36,89,9,44,61
"2011","Birmingham 089F","E01008895","Total",771,240,51,189,531,45,49,114,175,26,44,78
"2011","Birmingham 089G","E01009015","Total",786,335,123,212,451,41,61,88,123,18,44,76
"2011","Birmingham 090A","E01009014","Total",657,134,49,85,523,56,51,96,91,54,72,103
"2011","Birmingham 090B","E01009018","Total",697,275,96,179,422,43,85,47,96,16,51,84
"2011","Birmingham 090C","E01009026","Total",581,147,45,102,434,99,44,81,75,37,47,51
"2011","Birmingham 090D","E01009028","Total",622,160,61,99,462,63,57,89,81,50,58,64
"2011","Birmingham 090E","E01009029","Total",528,138,61,77,390,49,36,79,65,34,57,70
"2011","Birmingham 092A","E01009182","Total",666,361,43,318,305,27,26,39,66,8,67,72
"2011","Birmingham 092B","E01009184","Total",724,328,79,249,396,13,23,52,166,14,49,79
"2011","Birmingham 092C","E01009187","Total",686,303,109,194,383,14,69,64,107,22,42,65
"2011","Birmingham 092D","E01009188","Total",665,270,78,192,395,19,49,76,112,16,48,75
"2011","Birmingham 092E","E01009384","Total",725,421,98,323,304,42,12,37,127,13,27,46
"2011","Birmingham 092F","E01009385","Total",615,301,67,234,314,18,26,34,145,10,26,55
"2011","Birmingham 093A","E01009185","Total",736,323,111,212,413,13,62,58,144,9,37,90
"2011","Birmingham 093B","E01009389","Total",474,93,23,70,381,13,60,34,37,20,115,102
"2011","Birmingham 093C","E01009390","Total",659,328,24,304,331,35,20,32,118,12,63,51
"2011","Birmingham 093D","E01009394","Total",755,383,84,299,372,17,39,36,130,18,74,58
"2011","Birmingham 094A","E01008918","Total",753,328,127,201,425,73,58,72,84,23,60,55
"2011","Birmingham 094B","E01008920","Total",556,124,66,58,432,43,75,85,100,11,33,85
"2011","Birmingham 094C","E01008921","Total",630,205,72,133,425,49,71,64,115,15,26,85
"2011","Birmingham 094D","E01008931","Total",647,245,84,161,402,81,52,75,90,19,34,51
"2011","Birmingham 094E","E01009259","Total",670,222,74,148,448,95,61,73,81,22,46,70
"2011","Birmingham 095A","E01008919","Total",704,268,119,149,436,53,53,86,112,17,36,79
"2011","Birmingham 095B","E01009064","Total",600,181,65,116,419,52,61,83,88,15,40,80
"2011","Birmingham 095C","E01009077","Total",718,206,85,121,512,40,107,105,134,16,27,83
"2011","Birmingham 095D","E01009291","Total",624,164,60,104,460,63,59,97,113,14,36,78
"2011","Birmingham 095E","E01009500","Total",637,209,76,133,428,60,60,77,98,27,37,69
"2011","Birmingham 096A","E01009284","Total",664,153,46,107,511,29,50,37,122,11,21,241
"2011","Birmingham 096C","E01009286","Total",504,55,25,30,449,9,12,18,24,8,8,370
"2011","Birmingham 096E","E01009289","Total",561,86,29,57,475,15,14,13,48,2,18,365
"2011","Birmingham 096F","E01009290","Total",465,49,18,31,416,2,11,11,33,6,10,343
"2011","Birmingham 096G","E01033634","Total",800,90,22,68,710,32,8,27,79,10,9,545
"2011","Birmingham 097A","E01009017","Total",491,93,51,42,398,24,53,44,54,41,89,93
"2011","Birmingham 097B","E01009043","Total",652,191,94,97,461,36,61,64,70,40,83,107
"2011","Birmingham 097C","E01009044","Total",463,96,32,64,367,21,40,53,40,44,88,81
"2011","Birmingham 097D","E01009045","Total",598,180,103,77,418,30,65,66,51,34,78,94
"2011","Birmingham 097E","E01009046","Total",610,157,112,45,453,11,65,72,77,42,72,114
"2011","Birmingham 097F","E01009395","Total",566,213,36,177,353,25,46,44,46,33,86,73
"2011","Birmingham 098A","E01009016","Total",732,354,186,168,378,23,65,68,87,21,44,70
"2011","Birmingham 098B","E01009022","Total",612,146,65,81,466,45,51,79,80,25,71,115
"2011","Birmingham 098C","E01009023","Total",572,109,63,46,463,46,62,83,80,41,44,107
"2011","Birmingham 098D","E01009030","Total",480,99,56,43,381,20,75,55,48,20,64,99
"2011","Birmingham 099A","E01009281","Total",660,278,148,130,382,19,84,92,93,12,15,67
"2011","Birmingham 099B","E01009292","Total",666,169,54,115,497,19,78,102,135,21,29,113
"2011","Birmingham 099C","E01009294","Total",809,263,90,173,546,73,93,101,148,25,25,81
"2011","Birmingham 099D","E01009295","Total",677,254,155,99,423,22,59,49,74,19,31,169
"2011","Birmingham 100A","E01009280","Total",571,194,71,123,377,32,56,73,105,15,20,76
"2011","Birmingham 100B","E01009282","Total",639,209,74,135,430,28,45,73,120,17,26,121
"2011","Birmingham 100C","E01009288","Total",437,139,54,85,298,15,81,34,74,13,15,66
"2011","Birmingham 100D","E01009293","Total",601,172,74,98,429,19,48,60,124,14,33,131
"2011","Birmingham 100E","E01009296","Total",581,176,47,129,405,27,31,51,125,9,33,129
"2011","Birmingham 101A","E01008924","Total",623,221,76,145,402,33,86,73,105,11,33,61
"2011","Birmingham 101B","E01009501","Total",629,190,69,121,439,92,53,64,86,16,46,82
"2011","Birmingham 101C","E01009502","Total",648,240,107,133,408,63,65,67,83,33,38,59
"2011","Birmingham 101D","E01009503","Total",615,175,63,112,440,64,51,75,103,23,42,82
"2011","Birmingham 101E","E01009505","Total",690,238,109,129,452,65,71,79,89,24,38,86
"2011","Birmingham 102A","E01008917","Total",523,125,49,76,398,35,51,68,98,13,40,93
"2011","Birmingham 102B","E01008923","Total",637,260,98,162,377,74,64,70,88,18,24,39
"2011","Birmingham 102C","E01008925","Total",515,103,34,69,412,18,67,74,111,10,37,95
"2011","Birmingham 102D","E01008927","Total",644,262,80,182,382,73,49,55,86,16,34,69
"2011","Birmingham 102E","E01008928","Total",684,272,116,156,412,74,76,59,79,18,42,64
"2011","Birmingham 103A","E01009019","Total",612,193,58,135,419,62,39,95,79,20,57,67
"2011","Birmingham 103B","E01009020","Total",557,140,76,64,417,34,61,71,92,23,54,82
"2011","Birmingham 103C","E01009021","Total",654,198,69,129,456,73,49,105,104,23,46,56
"2011","Birmingham 103D","E01009024","Total",606,169,59,110,437,63,60,84,79,23,49,79
"2011","Birmingham 103E","E01009025","Total",584,188,79,109,396,47,43,80,75,21,65,65
"2011","Birmingham 103F","E01009033","Total",677,203,55,148,474,64,49,77,97,37,61,89
"2011","Birmingham 104A","E01009175","Total",593,163,36,127,430,27,41,83,138,19,31,91
"2011","Birmingham 104B","E01009177","Total",647,215,61,154,432,25,32,102,145,26,37,65
"2011","Birmingham 104C","E01009178","Total",707,248,90,158,459,53,26,90,166,17,33,74
"2011","Birmingham 104D","E01009179","Total",651,180,83,97,471,13,88,85,98,25,52,110
"2011","Birmingham 104E","E01009189","Total",605,186,62,124,419,33,54,93,112,16,41,70
"2011","Birmingham 105A","E01008933","Total",549,121,46,75,428,33,62,73,77,24,56,103
"2011","Birmingham 105B","E01008934","Total",547,166,88,78,381,24,69,55,76,18,48,91
"2011","Birmingham 105C","E01009031","Total",601,170,84,86,431,12,82,75,73,20,70,99
"2011","Birmingham 105D","E01009037","Total",700,249,137,112,451,19,96,74,109,26,30,97
"2011","Birmingham 105E","E01009176","Total",670,233,105,128,437,36,84,64,93,14,59,87
"2011","Birmingham 106C","E01008929","Total",676,291,122,169,385,62,57,82,77,22,25,60
"2011","Birmingham 106D","E01008930","Total",605,156,45,111,449,58,39,102,123,19,30,78
"2011","Birmingham 106E","E01009495","Total",501,136,58,78,365,63,59,59,74,20,30,60
"2011","Birmingham 106F","E01033629","Total",1071,385,162,223,686,105,124,132,133,16,59,117
"2011","Birmingham 107A","E01008953","Total",638,186,48,138,452,44,56,98,120,13,47,74
"2011","Birmingham 107B","E01008963","Total",572,197,65,132,375,36,46,76,103,14,47,53
"2011","Birmingham 107C","E01008964","Total",634,239,108,131,395,31,59,72,117,19,35,62
"2011","Birmingham 107D","E01008965","Total",587,131,52,79,456,23,63,82,138,22,39,89
"2011","Birmingham 107E","E01008966","Total",688,245,92,153,443,52,49,97,105,22,48,70
"2011","Birmingham 108A","E01009032","Total",587,120,71,49,467,22,74,72,74,29,77,119
"2011","Birmingham 108B","E01009034","Total",533,98,55,43,435,13,74,62,71,26,83,106
"2011","Birmingham 108C","E01009035","Total",637,139,72,67,498,37,69,81,100,41,59,111
"2011","Birmingham 108D","E01009036","Total",540,125,57,68,415,17,91,65,76,22,57,87
"2011","Birmingham 109A","E01009494","Total",629,168,89,79,461,119,68,78,60,26,41,69
"2011","Birmingham 109B","E01009496","Total",627,173,111,62,454,26,122,64,92,13,32,105
"2011","Birmingham 109C","E01009497","Total",728,226,96,130,502,48,76,109,122,29,44,74
"2011","Birmingham 109D","E01009504","Total",619,183,111,72,436,19,121,83,90,21,29,73
"2011","Birmingham 109E","E01009506","Total",635,173,107,66,462,17,131,72,96,14,38,94
"2011","Birmingham 110A","E01008967","Total",665,185,91,94,480,22,117,77,93,22,46,103
"2011","Birmingham 110B","E01008968","Total",697,217,137,80,480,20,80,114,111,17,41,97
"2011","Birmingham 110C","E01008970","Total",621,164,61,103,457,82,70,85,89,27,41,63
"2011","Birmingham 110D","E01008981","Total",587,145,63,82,442,8,95,91,99,22,43,84
"2011","Birmingham 111A","E01008932","Total",670,252,84,168,418,43,62,59,111,34,43,66
"2011","Birmingham 111B","E01008935","Total",675,257,99,158,418,65,44,71,94,28,48,68
"2011","Birmingham 111C","E01008936","Total",643,229,100,129,414,46,76,47,74,21,60,90
"2011","Birmingham 111D","E01008938","Total",588,151,51,100,437,58,51,71,79,33,46,99
"2011","Birmingham 111E","E01008939","Total",673,235,100,135,438,55,62,86,106,18,36,75
"2011","Birmingham 112A","E01008951","Total",574,164,95,69,410,37,56,100,92,19,30,76
"2011","Birmingham 112B","E01008952","Total",761,299,58,241,462,47,26,83,185,9,28,84
"2011","Birmingham 112C","E01008955","Total",666,214,66,148,452,26,54,91,156,9,29,87
"2011","Birmingham 112D","E01008956","Total",577,158,96,62,419,21,58,109,103,20,35,73
"2011","Birmingham 112E","E01008957","Total",708,243,50,193,465,57,32,88,155,17,28,88
"2011","Birmingham 113A","E01008950","Total",718,305,119,186,413,27,129,61,96,14,21,65
"2011","Birmingham 113B","E01008954","Total",585,173,96,77,412,25,109,55,94,15,31,83
"2011","Birmingham 113C","E01008958","Total",787,365,213,152,422,47,81,61,108,10,34,81
"2011","Birmingham 113D","E01009493","Total",792,399,50,349,393,84,18,79,135,10,11,56
"2011","Birmingham 115A","E01008937","Total",607,215,102,113,392,31,79,52,89,15,51,75
"2011","Birmingham 115B","E01008940","Total",594,184,58,126,410,76,59,69,88,19,34,65
"2011","Birmingham 115C","E01008941","Total",585,161,84,77,424,61,65,64,77,31,46,80
"2011","Birmingham 115D","E01008944","Total",733,235,85,150,498,66,86,98,118,21,31,78
"2011","Birmingham 116A","E01008959","Total",790,295,169,126,495,56,100,91,113,23,33,79
"2011","Birmingham 116B","E01008960","Total",625,162,57,105,463,32,36,111,137,27,41,79
"2011","Birmingham 116C","E01008961","Total",738,331,105,226,407,31,64,60,139,17,28,68
"2011","Birmingham 116D","E01008962","Total",818,279,81,198,539,98,56,112,131,33,29,80
"2011","Birmingham 117A","E01008942","Total",618,170,73,97,448,65,46,77,87,34,43,96
"2011","Birmingham 117B","E01008943","Total",562,147,64,83,415,51,47,79,104,15,35,84
"2011","Birmingham 117C","E01008969","Total",697,208,109,99,489,21,68,118,158,23,33,68
"2011","Birmingham 117D","E01008971","Total",716,219,92,127,497,55,80,79,133,25,46,79
"2011","Birmingham 118A","E01008972","Total",741,228,82,146,513,80,61,97,120,23,43,89
"2011","Birmingham 118B","E01008973","Total",848,297,97,200,551,59,86,123,148,15,39,81
"2011","Birmingham 118C","E01008974","Total",1153,327,73,254,826,92,89,220,202,39,65,119
"2011","Birmingham 118D","E01008975","Total",669,209,112,97,460,27,85,85,142,13,34,74
"2011","Birmingham 119A","E01009172","Total",548,157,72,85,391,49,58,69,76,26,43,70
"2011","Birmingham 119B","E01009173","Total",656,182,60,122,474,66,37,81,121,34,61,74
"2011","Birmingham 119C","E01009174","Total",533,189,56,133,344,65,33,63,80,17,29,57
"2011","Birmingham 119D","E01009498","Total",688,208,71,137,480,86,57,87,117,12,42,79
"2011","Birmingham 119E","E01009499","Total",673,175,64,111,498,62,59,90,112,23,59,93
"2011","Birmingham 120A","E01009205","Total",615,163,79,84,452,30,90,73,104,21,40,94
"2011","Birmingham 120B","E01009206","Total",658,173,97,76,485,22,111,85,102,23,46,96
"2011","Birmingham 120C","E01009211","Total",676,252,72,180,424,23,60,77,131,8,29,96
"2011","Birmingham 120D","E01009218","Total",635,198,132,66,437,9,100,97,107,23,36,65
"2011","Birmingham 120E","E01009219","Total",609,141,60,81,468,73,73,83,116,17,39,67
"2011","Birmingham 121A","E01008976","Total",679,252,126,126,427,54,81,79,84,19,32,78
"2011","Birmingham 121B","E01008978","Total",744,413,119,294,331,110,44,57,62,12,15,31
"2011","Birmingham 121C","E01008979","Total",765,327,129,198,438,64,82,70,96,17,28,81
"2011","Birmingham 121D","E01008980","Total",681,256,106,150,425,59,72,69,72,30,49,74
"2011","Birmingham 122A","E01008945","Total",745,229,75,154,516,59,68,89,124,32,49,95
"2011","Birmingham 122B","E01008946","Total",643,233,107,126,410,28,62,75,104,14,45,82
"2011","Birmingham 122C","E01008947","Total",543,150,54,96,393,33,46,81,96,26,26,85
"2011","Birmingham 122D","E01008948","Total",627,166,94,72,461,33,103,80,125,12,19,89
"2011","Birmingham 122E","E01008949","Total",515,118,55,63,397,18,85,77,92,7,30,88
"2011","Birmingham 123A","E01008977","Total",698,240,67,173,458,45,55,104,150,13,24,67
"2011","Birmingham 123B","E01009109","Total",516,138,24,114,378,134,21,59,62,38,28,36
"2011","Birmingham 123C","E01009119","Total",641,241,113,128,400,38,73,68,107,12,29,73
"2011","Birmingham 123D","E01009120","Total",628,205,71,134,423,57,69,80,116,10,22,69
"2011","Birmingham 124A","E01009162","Total",653,164,90,74,489,57,71,90,125,11,37,98
"2011","Birmingham 124B","E01009207","Total",663,164,79,85,499,24,90,97,136,17,46,89
"2011","Birmingham 124C","E01009208","Total",618,144,65,79,474,20,95,99,109,16,40,95
"2011","Birmingham 124D","E01009209","Total",975,323,115,208,652,85,105,118,189,15,40,100
"2011","Birmingham 124E","E01009213","Total",699,268,124,144,431,35,106,61,107,21,25,76
"2011","Birmingham 125B","E01009155","Total",602,226,88,138,376,51,49,44,113,14,31,74
"2011","Birmingham 125D","E01009157","Total",632,211,62,149,421,60,71,64,84,27,43,72
"2011","Birmingham 125E","E01009160","Total",736,302,61,241,434,101,43,85,97,14,37,57
"2011","Birmingham 125F","E01009161","Total",617,202,76,126,415,42,77,76,107,12,39,62
"2011","Birmingham 125G","E01033633","Total",986,323,113,210,663,86,93,115,163,40,56,110
"2011","Birmingham 126A","E01009117","Total",820,279,104,175,541,126,46,125,81,53,41,69
"2011","Birmingham 126B","E01009210","Total",796,247,92,155,549,72,81,103,144,22,42,85
"2011","Birmingham 126C","E01009212","Total",767,286,101,185,481,76,84,96,98,17,35,75
"2011","Birmingham 126D","E01009214","Total",788,351,139,212,437,74,55,85,103,19,39,62
"2011","Birmingham 126E","E01009215","Total",884,439,145,294,445,92,55,73,131,13,21,60
"2011","Birmingham 127A","E01009108","Total",557,154,75,79,403,27,102,49,103,19,33,70
"2011","Birmingham 127B","E01009111","Total",550,128,47,81,422,38,68,76,103,12,26,99
"2011","Birmingham 127C","E01009112","Total",600,191,99,92,409,54,85,61,85,18,41,65
"2011","Birmingham 127D","E01009116","Total",579,157,113,44,422,8,111,63,100,15,46,79
"2011","Birmingham 127E","E01009118","Total",677,243,82,161,434,30,90,76,124,8,37,69
"2011","Birmingham 128A","E01009107","Total",829,350,106,244,479,145,42,87,104,18,27,56
"2011","Birmingham 128B","E01009110","Total",649,209,68,141,440,58,54,90,109,13,36,80
"2011","Birmingham 128C","E01009113","Total",624,249,122,127,375,66,48,57,67,30,54,53
"2011","Birmingham 128D","E01009114","Total",680,231,90,141,449,60,72,69,114,19,35,80
"2011","Birmingham 128E","E01009115","Total",618,204,82,122,414,46,82,60,102,16,29,79
"2011","Birmingham 129A","E01009158","Total",762,223,59,164,539,81,67,134,120,24,35,78
"2011","Birmingham 129B","E01009163","Total",635,207,92,115,428,78,74,66,101,8,38,63
"2011","Birmingham 129C","E01009165","Total",659,300,91,209,359,55,39,77,105,17,25,41
"2011","Birmingham 129D","E01009169","Total",682,179,78,101,503,53,88,126,104,17,43,72
"2011","Birmingham 130A","E01009159","Total",753,227,80,147,526,50,60,117,165,18,32,84
"2011","Birmingham 130B","E01009164","Total",634,187,71,116,447,41,74,91,121,14,29,77
"2011","Birmingham 130C","E01009167","Total",603,153,65,88,450,32,53,113,108,23,42,79
"2011","Birmingham 130D","E01009171","Total",694,240,106,134,454,57,61,104,106,24,33,69
"2011","Birmingham 131A","E01009166","Total",559,163,71,92,396,56,51,72,106,19,26,66
"2011","Birmingham 131B","E01009168","Total",621,165,65,100,456,38,86,78,112,13,44,85
"2011","Birmingham 131C","E01009170","Total",627,178,87,91,449,26,83,91,115,12,33,89
"2011","Birmingham 131D","E01009216","Total",816,240,100,140,576,60,102,113,108,23,44,126
"2011","Birmingham 131E","E01009217","Total",660,138,64,74,522,31,118,103,125,14,45,86
"2011","Birmingham 132A","E01009039","Total",641,159,89,70,482,19,85,112,100,27,45,94
"2011","Birmingham 132B","E01009040","Total",628,130,69,61,498,17,91,101,107,25,66,91
"2011","Birmingham 132C","E01009041","Total",627,143,61,82,484,30,62,110,127,25,45,85
"2011","Birmingham 132D","E01009042","Total",539,110,53,57,429,45,54,95,118,12,30,75
"2011","Birmingham 132E","E01032589","Total",578,201,114,87,377,28,63,68,79,17,42,80
"2011","Birmingham 133A","E01009262","Total",520,116,35,81,404,19,38,55,56,19,94,123
"2011","Birmingham 133B","E01009267","Total",567,150,94,56,417,7,71,51,45,15,87,141
"2011","Birmingham 133C","E01009276","Total",528,111,66,45,417,19,61,50,58,20,81,128
"2011","Birmingham 133D","E01009278","Total",540,98,41,57,442,22,49,60,58,24,96,133
"2011","Birmingham 133E","E01009279","Total",445,78,42,36,367,19,39,62,44,21,76,106
"2011","Birmingham 133F","E01032591","Total",483,71,43,28,412,11,71,45,47,15,100,123
"2011","Birmingham 134A","E01008995","Total",725,376,98,278,349,72,40,53,90,25,21,48
"2011","Birmingham 134B","E01033557","Total",836,416,8,408,420,5,5,43,324,1,4,38
"2011","Birmingham 134C","E01033624","Total",498,202,30,172,296,58,9,27,148,7,13,34
"2011","Birmingham 134D","E01033626","Total",556,248,37,211,308,37,14,37,152,11,9,48
"2011","Birmingham 134E","E01033640","Total",564,217,42,175,347,89,19,69,79,22,29,40
"2011","Birmingham 135A","E01009378","Total",1060,523,109,414,537,66,34,70,253,15,32,67
"2011","Birmingham 135B","E01033567","Total",712,335,4,331,377,8,3,29,299,0,1,37
"2011","Birmingham 135C","E01033615","Total",616,310,2,308,306,9,3,24,227,1,3,39
"2011","Birmingham 135D","E01033616","Total",714,510,43,467,204,3,12,19,134,1,8,27
"2011","Birmingham 136A","E01009143","Total",660,310,68,242,350,90,24,58,76,21,36,45
"2011","Birmingham 136B","E01009146","Total",892,607,77,530,285,55,21,42,110,6,10,41
"2011","Birmingham 136C","E01033564","Total",770,448,8,440,322,7,6,39,227,3,6,34
"2011","Birmingham 136D","E01033639","Total",828,326,37,289,502,97,23,81,157,26,29,89
"2011","Birmingham 137A","E01009141","Total",825,388,101,287,437,111,40,59,89,25,40,73
"2011","Birmingham 137B","E01033565","Total",623,282,3,279,341,3,2,18,289,0,2,27
"2011","Birmingham 137C","E01033618","Total",745,397,7,390,348,6,8,38,259,2,3,32
"2011","Birmingham 137D","E01033619","Total",605,246,19,227,359,25,9,34,231,6,8,46
"2011","Birmingham 137E","E01033627","Total",573,292,54,238,281,36,20,46,118,8,17,36
"2011","Birmingham 138A","E01033620","Total",702,439,16,423,263,7,1,16,209,0,0,30
"2011","Birmingham 138B","E01033622","Total",901,428,21,407,473,13,6,36,342,2,1,73
"2011","Birmingham 138C","E01033623","Total",772,480,14,466,292,17,4,8,225,1,0,37
"2011","Birmingham 138D","E01033625","Total",1058,535,0,535,523,0,5,44,424,0,1,49
"2011","Birmingham 139A","E01009200","Total",659,236,36,200,423,83,24,86,68,43,59,60
"2011","Birmingham 139B","E01009327","Total",412,58,30,28,354,22,24,50,40,74,79,65
"2011","Birmingham 139C","E01009328","Total",525,77,27,50,448,15,34,38,25,62,166,108
"2011","Birmingham 139D","E01009331","Total",557,105,39,66,452,37,42,64,36,60,128,85
"2011","Birmingham 139E","E01009332","Total",539,178,61,117,361,48,26,57,46,48,70,66
"2011","Birmingham 139F","E01009333","Total",436,73,18,55,363,32,21,55,38,78,80,59
"2011","Birmingham 139G","E01009335","Total",479,69,36,33,410,31,33,51,45,58,107,85
"2011","Birmingham 139H","E01009344","Total",460,112,32,80,348,42,20,55,33,65,70,63
"2011","Birmingham 140A","E01009339","Total",455,105,47,58,350,32,34,53,39,57,62,73
"2011","Birmingham 140B","E01009340","Total",941,263,57,206,678,89,46,145,131,85,89,93
"2011","Birmingham 140C","E01009382","Total",448,84,37,47,364,26,27,37,27,38,125,84
"2011","Birmingham 140D","E01009391","Total",522,125,31,94,397,43,28,91,63,58,55,59
"2011","Birmingham 140E","E01009392","Total",444,69,31,38,375,18,32,46,31,46,112,90
"2011","Birmingham 140F","E01009393","Total",473,87,23,64,386,41,31,76,43,68,63,64
"2011","Birmingham 140G","E01033641","Total",891,133,44,89,758,47,60,125,99,112,165,150
"2011","Coventry 001A","E01009589","Total",591,175,49,126,416,57,58,86,99,19,40,57
"2011","Coventry 001F","E01032536","Total",852,328,104,224,524,58,55,113,152,17,52,77
"2011","Coventry 001G","E01032537","Total",831,260,115,145,571,65,118,90,121,18,53,106
"2011","Coventry 001H","E01032538","Total",994,375,110,265,619,118,79,123,151,20,47,81
"2011","Coventry 002A","E01009590","Total",523,120,73,47,403,31,82,89,84,8,39,70
"2011","Coventry 002B","E01009591","Total",580,131,52,79,449,51,50,90,113,22,46,77
"2011","Coventry 002C","E01009593","Total",633,154,82,72,479,44,100,66,85,22,53,109
"2011","Coventry 002D","E01009598","Total",642,168,113,55,474,19,128,62,72,13,41,139
"2011","Coventry 004A","E01009604","Total",566,152,69,83,414,54,68,69,70,20,49,84
"2011","Coventry 004B","E01009605","Total",650,216,81,135,434,88,53,74,95,13,42,69
"2011","Coventry 004C","E01009607","Total",803,423,115,308,380,92,44,62,87,14,23,58
"2011","Coventry 004D","E01009608","Total",621,152,73,79,469,76,69,80,99,24,48,73
"2011","Coventry 004E","E01009610","Total",637,230,91,139,407,69,53,68,81,26,33,77
"2011","Coventry 005A","E01009564","Total",587,164,42,122,423,72,28,75,82,38,59,69
"2011","Coventry 005B","E01009575","Total",481,126,42,84,355,63,41,74,60,20,44,53
"2011","Coventry 005C","E01009606","Total",537,122,57,65,415,46,62,80,75,23,41,88
"2011","Coventry 005D","E01009609","Total",610,147,68,79,463,89,58,87,84,26,42,77
"2011","Coventry 006A","E01009524","Total",680,271,161,110,409,29,88,84,82,12,38,76
"2011","Coventry 006B","E01009525","Total",575,153,109,44,422,21,85,64,97,17,51,87
"2011","Coventry 006C","E01009527","Total",654,187,71,116,467,50,60,112,100,17,42,86
"2011","Coventry 006D","E01009594","Total",532,96,49,47,436,22,89,82,108,17,29,89
"2011","Coventry 007A","E01009577","Total",527,197,54,143,330,78,25,74,63,29,21,40
"2011","Coventry 007B","E01009579","Total",695,220,86,134,475,113,61,85,94,25,34,63
"2011","Coventry 007C","E01009581","Total",638,206,113,93,432,76,69,63,81,27,43,73
"2011","Coventry 007D","E01009584","Total",603,176,85,91,427,60,95,64,86,21,31,70
"2011","Coventry 007E","E01009585","Total",390,97,26,71,293,80,27,51,50,25,25,35
"2011","Coventry 007F","E01009709","Total",429,166,43,123,263,67,33,33,40,33,23,34
"2011","Coventry 008A","E01009576","Total",684,224,99,125,460,50,54,110,124,7,30,85
"2011","Coventry 008B","E01009578","Total",564,115,51,64,449,24,73,75,121,11,34,111
"2011","Coventry 008C","E01009582","Total",738,210,103,107,528,56,96,95,129,18,36,98
"2011","Coventry 008D","E01009583","Total",672,184,78,106,488,47,98,93,120,21,41,68
"2011","Coventry 008E","E01009586","Total",651,146,78,68,505,40,115,84,94,18,54,100
"2011","Coventry 009A","E01009565","Total",458,77,44,33,381,31,45,45,43,49,94,74
"2011","Coventry 009B","E01009566","Total",569,154,20,134,415,66,18,95,98,35,50,53
"2011","Coventry 009C","E01009567","Total",660,226,76,150,434,60,32,93,63,40,74,72
"2011","Coventry 009D","E01009568","Total",541,96,30,66,445,47,45,67,60,44,86,96
"2011","Coventry 010A","E01009523","Total",609,140,86,54,469,6,143,66,102,11,43,98
"2011","Coventry 010B","E01009526","Total",599,124,71,53,475,28,102,94,103,22,43,83
"2011","Coventry 010C","E01009528","Total",679,174,100,74,505,25,148,83,119,20,32,78
"2011","Coventry 010D","E01009531","Total",761,306,155,151,455,47,124,73,114,17,19,61
"2011","Coventry 011A","E01009587","Total",572,142,61,81,430,52,42,98,88,25,42,83
"2011","Coventry 011B","E01009624","Total",622,146,61,85,476,66,55,106,98,17,47,87
"2011","Coventry 011C","E01009625","Total",867,198,83,115,669,78,81,146,130,33,76,125
"2011","Coventry 011D","E01009626","Total",632,165,67,98,467,48,61,97,107,25,42,87
"2011","Coventry 012A","E01009622","Total",655,167,66,101,488,93,45,115,74,23,47,91
"2011","Coventry 012B","E01009623","Total",678,258,88,170,420,68,61,74,86,17,39,75
"2011","Coventry 012C","E01009627","Total",712,269,103,166,443,62,55,77,126,12,35,76
"2011","Coventry 012D","E01009628","Total",632,196,107,89,436,43,84,72,96,24,34,83
"2011","Coventry 013A","E01009599","Total",607,237,105,132,370,40,105,60,93,10,18,44
"2011","Coventry 013B","E01009663","Total",633,200,127,73,433,26,138,60,82,15,44,68
"2011","Coventry 013C","E01009710","Total",634,233,91,142,401,36,80,78,101,4,32,70
"2011","Coventry 013D","E01009711","Total",600,182,112,70,418,35,125,54,80,19,37,68
"2011","Coventry 014A","E01009522","Total",647,248,165,83,399,48,90,63,78,17,32,71
"2011","Coventry 014B","E01009529","Total",621,164,81,83,457,39,75,93,99,14,39,98
"2011","Coventry 014C","E01009530","Total",561,149,83,66,412,32,66,99,94,15,33,73
"2011","Coventry 014D","E01009645","Total",572,126,52,74,446,50,71,89,98,16,38,84
"2011","Coventry 015A","E01009569","Total",494,146,35,111,348,57,27,69,72,28,39,56
"2011","Coventry 015B","E01009570","Total",596,152,38,114,444,46,38,84,76,33,74,93
"2011","Coventry 015C","E01009571","Total",673,304,77,227,369,65,29,73,69,41,33,59
"2011","Coventry 015D","E01009572","Total",797,200,43,157,597,119,25,123,133,58,52,87
"2011","Coventry 015E","E01009573","Total",525,143,39,104,382,50,21,69,62,38,59,83
"2011","Coventry 015F","E01009574","Total",559,175,58,117,384,70,34,81,54,33,51,61
"2011","Coventry 016A","E01009655","Total",789,241,92,149,548,90,61,113,147,30,34,73
"2011","Coventry 016B","E01009656","Total",713,249,97,152,464,65,60,87,122,12,32,86
"2011","Coventry 016C","E01009659","Total",765,298,78,220,467,90,31,89,113,17,37,90
"2011","Coventry 016D","E01009662","Total",569,202,57,145,367,32,46,50,70,12,56,101
"2011","Coventry 016E","E01009664","Total",578,148,42,106,430,47,58,89,89,18,46,83
"2011","Coventry 017A","E01009643","Total",591,128,59,69,463,32,60,117,132,19,23,80
"2011","Coventry 017B","E01009644","Total",679,173,87,86,506,43,79,103,138,21,23,99
"2011","Coventry 017C","E01009647","Total",785,296,127,169,489,40,71,83,158,18,37,82
"2011","Coventry 017D","E01009648","Total",607,129,54,75,478,37,66,112,127,26,23,87
"2011","Coventry 017E","E01009652","Total",619,194,108,86,425,27,112,70,82,19,34,81
"2011","Coventry 017F","E01009653","Total",625,161,100,61,464,34,106,99,72,25,37,91
"2011","Coventry 018A","E01009613","Total",502,121,65,56,381,24,56,76,85,12,38,90
"2011","Coventry 018B","E01009657","Total",627,140,55,85,487,48,72,92,99,17,42,117
"2011","Coventry 018C","E01009712","Total",620,145,75,70,475,63,72,89,96,15,35,105
"2011","Coventry 018D","E01009714","Total",576,121,59,62,455,45,73,111,72,20,46,88
"2011","Coventry 018E","E01009716","Total",649,152,78,74,497,50,74,99,96,36,43,99
"2011","Coventry 019A","E01009580","Total",547,193,104,89,354,30,98,50,80,11,28,57
"2011","Coventry 019B","E01009713","Total",521,105,45,60,416,30,63,87,96,12,47,81
"2011","Coventry 019C","E01009715","Total",588,197,68,129,391,24,61,87,99,22,30,68
"2011","Coventry 019D","E01009717","Total",585,137,59,78,448,18,70,109,126,13,33,79
"2011","Coventry 019E","E01009718","Total",885,465,171,294,420,73,62,72,101,13,26,73
"2011","Coventry 020A","E01009629","Total",1079,332,45,287,747,83,50,158,198,39,63,156
"2011","Coventry 020B","E01009630","Total",708,228,70,158,480,84,45,94,120,23,29,85
"2011","Coventry 020C","E01009631","Total",577,209,69,140,368,69,35,59,95,15,19,76
"2011","Coventry 020D","E01009632","Total",943,546,135,411,397,47,34,49,192,7,8,60
"2011","Coventry 020E","E01009650","Total",790,437,40,397,353,25,22,32,134,8,19,113
"2011","Coventry 021A","E01009614","Total",585,155,56,99,430,46,69,73,104,19,41,78
"2011","Coventry 021B","E01009654","Total",710,171,60,111,539,59,76,134,141,16,34,79
"2011","Coventry 021C","E01009658","Total",585,169,51,118,416,38,62,80,74,21,32,109
"2011","Coventry 021D","E01009660","Total",658,197,61,136,461,28,51,75,91,23,64,129
"2011","Coventry 022A","E01009646","Total",619,158,65,93,461,37,73,102,120,20,36,73
"2011","Coventry 022B","E01009692","Total",531,139,97,42,392,17,149,58,72,9,26,61
"2011","Coventry 022C","E01009693","Total",692,222,115,107,470,47,110,84,123,16,16,74
"2011","Coventry 022D","E01009694","Total",623,186,119,67,437,21,121,78,105,19,28,65
"2011","Coventry 023A","E01009695","Total",754,267,162,105,487,19,176,84,113,8,25,62
"2011","Coventry 023B","E01009696","Total",640,167,64,103,473,17,143,82,104,14,24,89
"2011","Coventry 023C","E01009704","Total",596,129,49,80,467,20,94,83,122,16,30,102
"2011","Coventry 023D","E01009705","Total",578,104,44,60,474,18,132,82,106,10,34,92
"2011","Coventry 024A","E01009636","Total",967,332,59,273,635,81,29,109,200,21,46,149
"2011","Coventry 024B","E01009637","Total",481,125,24,101,356,60,24,66,37,44,57,68
"2011","Coventry 024C","E01009638","Total",732,393,78,315,339,74,9,78,71,24,30,53
"2011","Coventry 024D","E01009639","Total",545,113,33,80,432,36,56,73,57,34,87,89
"2011","Coventry 024E","E01009640","Total",707,204,31,173,503,109,35,92,106,42,53,66
"2011","Coventry 024F","E01009641","Total",902,365,66,299,537,61,28,51,194,25,30,148
"2011","Coventry 025A","E01009697","Total",644,182,84,98,462,30,117,82,119,13,26,75
"2011","Coventry 025B","E01009698","Total",624,127,69,58,497,18,147,86,112,13,35,86
"2011","Coventry 025C","E01009703","Total",1144,378,94,284,766,94,46,176,277,35,41,97
"2011","Coventry 025D","E01009706","Total",656,172,75,97,484,28,145,80,113,18,23,77
"2011","Coventry 026A","E01009649","Total",582,153,57,96,429,27,81,95,102,15,23,86
"2011","Coventry 026B","E01009684","Total",680,294,74,220,386,57,60,58,108,16,25,62
"2011","Coventry 026C","E01009685","Total",714,224,93,131,490,36,82,96,133,14,36,93
"2011","Coventry 026D","E01009686","Total",692,216,87,129,476,27,66,106,122,12,40,103
"2011","Coventry 026E","E01009687","Total",600,171,57,114,429,26,58,90,140,9,24,82
"2011","Coventry 027A","E01009615","Total",678,197,55,142,481,35,60,66,131,12,50,127
"2011","Coventry 027B","E01009616","Total",608,163,64,99,445,35,57,76,110,19,52,96
"2011","Coventry 027C","E01009617","Total",473,110,46,64,363,34,50,69,88,17,31,74
"2011","Coventry 027D","E01009618","Total",612,165,69,96,447,27,66,102,112,9,46,85
"2011","Coventry 027E","E01009620","Total",608,192,89,103,416,39,80,84,98,16,30,69
"2011","Coventry 027F","E01009621","Total",536,137,39,98,399,55,55,67,95,14,35,78
"2011","Coventry 028A","E01009633","Total",713,204,47,157,509,58,39,66,126,26,25,169
"2011","Coventry 028B","E01009634","Total",679,193,48,145,486,36,33,62,148,13,14,180
"2011","Coventry 028C","E01009635","Total",886,314,42,272,572,64,29,49,133,11,19,267
"2011","Coventry 028D","E01009661","Total",793,271,66,205,522,77,30,83,135,8,31,158
"2011","Coventry 029A","E01009674","Total",674,228,72,156,446,85,50,67,123,19,28,74
"2011","Coventry 029B","E01009699","Total",624,177,102,75,447,42,122,69,103,13,30,68
"2011","Coventry 029C","E01009700","Total",831,404,103,301,427,86,59,55,115,17,32,63
"2011","Coventry 029D","E01009701","Total",729,279,112,167,450,86,73,68,120,8,26,69
"2011","Coventry 029E","E01009702","Total",729,325,91,234,404,81,54,88,107,11,18,45
"2011","Coventry 030A","E01009688","Total",601,193,59,134,408,43,33,38,115,9,18,152
"2011","Coventry 030B","E01009689","Total",717,288,44,244,429,25,27,40,204,6,12,115
"2011","Coventry 030C","E01009690","Total",660,234,58,176,426,24,38,55,158,8,18,125
"2011","Coventry 030D","E01009691","Total",631,206,36,170,425,44,38,31,188,5,10,109
"2011","Coventry 031A","E01009548","Total",1038,414,112,302,624,55,65,95,242,14,32,121
"2011","Coventry 031B","E01009553","Total",687,348,39,309,339,17,14,28,125,4,20,131
"2011","Coventry 031C","E01009642","Total",963,470,95,375,493,30,19,33,288,1,10,112
"2011","Coventry 031D","E01009651","Total",874,519,83,436,355,77,32,56,100,13,23,54
"2011","Coventry 032A","E01009676","Total",600,151,65,86,449,44,52,85,120,20,32,96
"2011","Coventry 032B","E01009681","Total",535,151,65,86,384,21,84,70,96,13,21,79
"2011","Coventry 032C","E01009682","Total",601,140,69,71,461,25,79,90,105,22,35,105
"2011","Coventry 032D","E01009683","Total",560,154,55,99,406,66,41,73,110,17,24,75
"2011","Coventry 033A","E01009532","Total",577,173,97,76,404,33,95,79,93,11,23,70
"2011","Coventry 033B","E01009535","Total",558,109,69,40,449,26,148,62,97,10,26,80
"2011","Coventry 033C","E01009536","Total",613,160,97,63,453,12,139,72,92,10,41,87
"2011","Coventry 033D","E01009543","Total",560,43,9,34,517,9,37,160,116,13,56,126
"2011","Coventry 033E","E01009707","Total",727,160,53,107,567,42,80,141,136,21,40,107
"2011","Coventry 033F","E01009708","Total",626,181,78,103,445,28,91,79,108,14,27,98
"2011","Coventry 034A","E01009554","Total",571,186,64,122,385,28,47,72,120,7,19,92
"2011","Coventry 034B","E01009555","Total",601,131,72,59,470,11,114,73,127,14,29,102
"2011","Coventry 034C","E01009556","Total",772,376,103,273,396,24,59,68,127,10,21,87
"2011","Coventry 034D","E01009557","Total",539,96,66,30,443,7,139,56,111,8,20,102
"2011","Coventry 034E","E01009558","Total",643,196,34,162,447,25,36,85,170,8,36,87
"2011","Coventry 034F","E01009559","Total",606,234,143,91,372,9,106,49,86,12,35,75
"2011","Coventry 035C","E01009537","Total",612,184,91,93,428,50,68,88,108,16,29,69
"2011","Coventry 035D","E01009538","Total",601,160,77,83,441,65,79,64,110,17,34,72
"2011","Coventry 035E","E01009611","Total",772,181,51,130,591,128,35,140,109,39,62,78
"2011","Coventry 035F","E01009612","Total",566,169,59,110,397,63,44,67,103,27,41,52
"2011","Coventry 035G","E01032527","Total",631,159,52,107,472,66,63,82,119,16,46,80
"2011","Coventry 035H","E01032528","Total",697,219,112,107,478,81,85,75,124,14,23,76
"2011","Coventry 036C","E01009679","Total",614,216,115,101,398,47,60,50,82,18,35,106
"2011","Coventry 036E","E01032531","Total",1147,426,170,256,721,170,82,122,154,40,49,104
"2011","Coventry 036F","E01032532","Total",533,139,68,71,394,27,95,57,89,5,35,86
"2011","Coventry 036G","E01032533","Total",643,106,35,71,537,22,61,110,118,23,63,140
"2011","Coventry 037B","E01009549","Total",668,191,105,86,477,12,114,80,115,22,41,93
"2011","Coventry 037C","E01009550","Total",770,201,79,122,569,61,82,110,148,14,34,120
"2011","Coventry 037E","E01009552","Total",719,272,164,108,447,44,90,87,95,18,30,83
"2011","Coventry 037F","E01032534","Total",756,241,95,146,515,57,95,84,103,31,51,94
"2011","Coventry 037G","E01032535","Total",485,129,71,58,356,17,61,74,100,11,24,69
"2011","Coventry 038A","E01009544","Total",749,321,143,178,428,47,84,72,129,11,26,59
"2011","Coventry 038D","E01009619","Total",831,290,73,217,541,66,46,84,177,15,28,125
"2011","Coventry 038E","E01032529","Total",693,327,113,214,366,56,69,53,132,3,9,44
"2011","Coventry 038F","E01032530","Total",817,274,136,138,543,37,90,117,169,8,23,99
"2011","Coventry 039A","E01009539","Total",774,381,94,287,393,86,41,90,68,15,39,54
"2011","Coventry 039B","E01009540","Total",779,267,61,206,512,127,46,105,84,44,52,54
"2011","Coventry 039C","E01009541","Total",816,369,116,253,447,64,109,50,122,6,22,74
"2011","Coventry 039D","E01009542","Total",893,465,128,337,428,80,56,70,105,27,28,62
"2011","Coventry 040A","E01009560","Total",547,108,65,43,439,4,109,75,75,18,57,101
"2011","Coventry 040B","E01009561","Total",767,309,155,154,458,36,123,81,107,11,24,76
"2011","Coventry 040C","E01009562","Total",709,232,137,95,477,19,130,84,90,18,24,112
"2011","Coventry 040D","E01009563","Total",619,120,93,27,499,11,118,103,88,30,43,106
"2011","Coventry 040E","E01009672","Total",822,183,127,56,639,14,197,96,106,23,67,136
"2011","Coventry 041A","E01009666","Total",503,123,65,58,380,13,81,86,69,17,44,70
"2011","Coventry 041B","E01009667","Total",575,161,128,33,414,6,164,46,68,7,39,84
"2011","Coventry 041C","E01009668","Total",630,158,92,66,472,25,72,111,94,28,49,93
"2011","Coventry 041D","E01009670","Total",673,173,96,77,500,37,89,108,113,28,38,87
"2011","Coventry 042A","E01009665","Total",475,111,75,36,364,4,112,45,77,8,32,86
"2011","Coventry 042B","E01009669","Total",462,80,47,33,382,16,54,100,82,15,51,64
"2011","Coventry 042C","E01009671","Total",410,46,21,25,364,8,67,47,76,22,47,97
"2011","Coventry 042F","E01033058","Total",911,278,147,131,633,24,143,63,146,16,38,203
"2011","Coventry 043A","E01009588","Total",681,280,156,124,401,57,64,73,77,19,36,75
"2011","Coventry 043B","E01009592","Total",640,160,50,110,480,103,35,107,114,20,35,66
"2011","Coventry 043C","E01009596","Total",564,136,40,96,428,66,56,78,74,21,50,83
"2011","Coventry 043D","E01009597","Total",642,134,59,75,508,79,68,78,94,28,57,104
"2011","Coventry 043E","E01032587","Total",670,149,53,96,521,80,63,109,117,27,49,76
"2011","Dudley 001A","E01009763","Total",690,145,46,99,545,56,60,134,123,40,45,87
"2011","Dudley 001B","E01009764","Total",571,123,69,54,448,18,92,72,112,8,45,101
"2011","Dudley 001C","E01009767","Total",615,174,100,74,441,21,106,82,99,20,36,77
"2011","Dudley 001D","E01009769","Total",708,256,99,157,452,75,63,87,102,20,32,73
"2011","Dudley 001E","E01009770","Total",634,191,92,99,443,35,87,78,119,15,32,77
"2011","Dudley 002A","E01009773","Total",665,219,127,92,446,28,100,86,96,19,40,77
"2011","Dudley 002B","E01009777","Total",612,193,80,113,419,28,82,77,93,18,38,83
"2011","Dudley 002C","E01009778","Total",621,162,85,77,459,28,81,90,103,14,43,100
"2011","Dudley 002D","E01009895","Total",611,194,110,84,417,29,101,83,86,13,36,69
"2011","Dudley 003A","E01009896","Total",606,130,91,39,476,13,140,76,104,9,39,95
"2011","Dudley 003B","E01009897","Total",606,117,83,34,489,10,181,85,81,10,26,96
"2011","Dudley 003C","E01009898","Total",652,195,119,76,457,9,154,68,103,8,23,92
"2011","Dudley 003D","E01009901","Total",585,140,92,48,445,11,146,76,89,4,30,89
"2011","Dudley 003E","E01009902","Total",533,109,69,40,424,9,128,65,105,7,25,85
"2011","Dudley 004A","E01009765","Total",641,145,75,70,496,25,107,98,111,18,36,101
"2011","Dudley 004B","E01009766","Total",672,196,86,110,476,36,83,88,118,14,36,101
"2011","Dudley 004C","E01009768","Total",626,244,128,116,382,27,82,70,84,10,38,71
"2011","Dudley 004D","E01009771","Total",640,209,147,62,431,10,169,67,87,4,20,74
"2011","Dudley 004E","E01009775","Total",597,141,85,56,456,30,88,89,74,18,64,93
"2011","Dudley 004F","E01009776","Total",590,121,76,45,469,17,106,85,102,12,45,102
"2011","Dudley 005A","E01009758","Total",664,175,107,68,489,57,79,84,97,19,56,97
"2011","Dudley 005B","E01009760","Total",505,109,56,53,396,35,82,77,62,18,40,82
"2011","Dudley 005C","E01009772","Total",480,68,22,46,412,51,43,81,103,20,36,78
"2011","Dudley 005D","E01009774","Total",625,140,63,77,485,26,129,102,112,14,29,73
"2011","Dudley 005E","E01009788","Total",705,246,113,133,459,31,76,99,120,19,29,85
"2011","Dudley 006B","E01009756","Total",527,122,56,66,405,34,60,81,80,13,53,84
"2011","Dudley 006C","E01009757","Total",645,160,65,95,485,41,76,76,122,25,42,103
"2011","Dudley 006D","E01009759","Total",526,109,73,36,417,7,131,54,94,14,27,90
"2011","Dudley 006F","E01009762","Total",489,104,49,55,385,65,40,75,56,28,52,69
"2011","Dudley 006G","E01033187","Total",837,172,82,90,665,132,82,110,117,54,63,107
"2011","Dudley 007A","E01009781","Total",890,340,140,200,550,45,88,120,160,16,39,82
"2011","Dudley 007B","E01009786","Total",626,188,69,119,438,53,57,90,105,24,35,74
"2011","Dudley 007C","E01009789","Total",643,172,60,112,471,18,108,75,142,7,28,93
"2011","Dudley 007D","E01009790","Total",667,205,98,107,462,38,80,79,124,11,40,90
"2011","Dudley 008A","E01009779","Total",675,263,137,126,412,16,106,75,117,7,13,78
"2011","Dudley 008B","E01009782","Total",632,175,88,87,457,53,71,101,89,18,29,96
"2011","Dudley 008C","E01009783","Total",597,144,73,71,453,44,89,75,97,12,40,96
"2011","Dudley 008D","E01009785","Total",634,161,115,46,473,4,164,67,102,11,32,93
"2011","Dudley 008E","E01009899","Total",625,141,99,42,484,11,173,76,103,8,30,83
"2011","Dudley 008F","E01009900","Total",633,131,106,25,502,7,215,68,92,11,34,75
"2011","Dudley 009A","E01009780","Total",745,129,22,107,616,26,39,198,165,20,61,107
"2011","Dudley 009B","E01009784","Total",625,108,24,84,517,20,42,137,166,12,51,89
"2011","Dudley 009C","E01009787","Total",585,98,39,59,487,6,80,109,130,9,54,99
"2011","Dudley 009D","E01009880","Total",569,117,38,79,452,21,55,121,115,13,33,94
"2011","Dudley 009E","E01009882","Total",542,123,68,55,419,33,71,77,97,19,42,80
"2011","Dudley 010A","E01009891","Total",615,137,53,84,478,62,57,90,97,40,43,89
"2011","Dudley 010B","E01009892","Total",632,257,80,177,375,45,49,49,92,24,44,72
"2011","Dudley 010C","E01009893","Total",607,148,62,86,459,70,44,112,74,41,48,70
"2011","Dudley 010D","E01009894","Total",696,169,85,84,527,44,85,109,125,28,40,96
"2011","Dudley 011A","E01009844","Total",608,233,71,162,375,45,59,64,73,32,49,53
"2011","Dudley 011B","E01009879","Total",802,226,89,137,576,49,64,104,168,28,55,108
"2011","Dudley 011C","E01009881","Total",1131,701,237,464,430,38,59,91,128,20,37,57
"2011","Dudley 011D","E01009885","Total",682,240,98,142,442,42,99,74,93,11,42,81
"2011","Dudley 012A","E01009816","Total",607,121,77,44,486,19,133,86,119,11,26,92
"2011","Dudley 012B","E01009817","Total",544,133,99,34,411,16,131,78,80,11,25,70
"2011","Dudley 012C","E01009819","Total",662,176,51,125,486,33,82,119,141,10,23,78
"2011","Dudley 012D","E01009820","Total",644,180,103,77,464,30,102,85,119,6,37,85
"2011","Dudley 013A","E01009748","Total",649,173,100,73,476,78,70,85,92,16,51,84
"2011","Dudley 013B","E01009839","Total",582,146,68,78,436,27,71,68,96,29,55,90
"2011","Dudley 013C","E01009883","Total",569,186,96,90,383,44,64,83,72,19,32,69
"2011","Dudley 013D","E01009884","Total",645,205,93,112,440,36,81,94,105,20,41,63
"2011","Dudley 013E","E01009886","Total",833,411,202,209,422,32,122,79,84,13,31,61
"2011","Dudley 014A","E01009814","Total",515,105,72,33,410,11,122,75,90,6,32,74
"2011","Dudley 014B","E01009815","Total",498,77,51,26,421,14,94,68,91,15,42,97
"2011","Dudley 014C","E01009818","Total",511,187,112,75,324,17,69,49,79,15,30,65
"2011","Dudley 014D","E01009821","Total",602,135,94,41,467,11,172,71,92,10,24,87
"2011","Dudley 014E","E01009822","Total",657,195,117,78,462,12,150,79,104,14,20,83
"2011","Dudley 015A","E01009887","Total",637,146,68,78,491,30,75,87,112,26,62,99
"2011","Dudley 015B","E01009888","Total",660,179,76,103,481,35,93,88,123,26,33,83
"2011","Dudley 015C","E01009889","Total",681,213,66,147,468,65,64,60,100,23,62,94
"2011","Dudley 015D","E01009890","Total",665,198,87,111,467,59,51,90,92,32,61,82
"2011","Dudley 016A","E01009749","Total",594,142,56,86,452,14,102,67,124,12,29,104
"2011","Dudley 016B","E01009750","Total",595,118,71,47,477,29,104,63,118,24,39,100
"2011","Dudley 016C","E01009823","Total",537,86,45,41,451,8,92,76,124,15,31,105
"2011","Dudley 016D","E01009824","Total",703,219,126,93,484,40,97,102,108,25,40,72
"2011","Dudley 017A","E01009751","Total",651,207,88,119,444,42,89,76,101,18,33,85
"2011","Dudley 017B","E01009752","Total",595,158,73,85,437,60,54,87,100,19,47,70
"2011","Dudley 017C","E01009753","Total",615,164,87,77,451,69,55,93,82,31,44,77
"2011","Dudley 017D","E01009754","Total",640,149,78,71,491,46,64,97,124,15,41,104
"2011","Dudley 017E","E01009841","Total",631,188,70,118,443,60,74,66,100,28,54,61
"2011","Dudley 018A","E01009840","Total",533,163,52,111,370,42,44,76,73,33,33,69
"2011","Dudley 018B","E01009842","Total",902,428,105,323,474,49,63,84,150,25,31,72
"2011","Dudley 018C","E01009843","Total",659,173,94,79,486,33,104,82,126,16,34,91
"2011","Dudley 018D","E01009871","Total",833,285,80,205,548,34,99,89,168,21,31,106
"2011","Dudley 018E","E01009875","Total",623,162,82,80,461,36,88,95,115,18,36,73
"2011","Dudley 019A","E01009825","Total",604,177,90,87,427,25,90,75,95,17,30,95
"2011","Dudley 019B","E01009826","Total",638,144,104,40,494,13,173,80,99,11,22,96
"2011","Dudley 019C","E01009827","Total",633,128,102,26,505,8,134,103,116,16,46,82
"2011","Dudley 019D","E01009828","Total",573,126,66,60,447,19,134,61,96,11,35,91
"2011","Dudley 019E","E01009829","Total",635,142,94,48,493,18,142,81,112,15,38,87
"2011","Dudley 019F","E01009830","Total",624,115,72,43,509,15,152,79,96,16,46,105
"2011","Dudley 020A","E01009872","Total",615,231,79,152,384,40,36,77,81,26,49,75
"2011","Dudley 020B","E01009873","Total",620,151,80,71,469,25,109,56,119,18,43,99
"2011","Dudley 020C","E01009874","Total",581,120,54,66,461,39,62,89,90,24,48,109
"2011","Dudley 020D","E01009876","Total",653,144,75,69,509,42,109,84,107,27,51,89
"2011","Dudley 020E","E01009877","Total",633,183,83,100,450,57,73,84,101,26,34,75
"2011","Dudley 021A","E01009911","Total",611,180,65,115,431,7,111,71,120,4,30,88
"2011","Dudley 021B","E01009912","Total",691,144,60,84,547,33,113,125,148,10,35,83
"2011","Dudley 021C","E01009913","Total",648,163,111,52,485,23,125,87,127,14,36,73
"2011","Dudley 021D","E01009914","Total",593,111,70,41,482,11,156,97,103,8,23,84
"2011","Dudley 021E","E01009915","Total",712,207,59,148,505,21,103,94,154,11,28,94
"2011","Dudley 021F","E01009916","Total",725,227,97,130,498,25,86,101,127,17,35,107
"2011","Dudley 022A","E01009741","Total",1179,551,102,449,628,93,74,119,206,13,35,88
"2011","Dudley 022B","E01009744","Total",872,338,66,272,534,49,86,124,156,11,37,71
"2011","Dudley 022C","E01009746","Total",688,275,124,151,413,36,50,67,110,24,53,73
"2011","Dudley 022D","E01009747","Total",661,214,54,160,447,61,39,106,141,11,27,62
"2011","Dudley 023A","E01009731","Total",679,213,55,158,466,25,43,112,171,16,24,75
"2011","Dudley 023B","E01009740","Total",669,170,41,129,499,52,50,133,137,25,41,61
"2011","Dudley 023C","E01009742","Total",647,188,106,82,459,41,92,96,93,16,45,76
"2011","Dudley 023D","E01009743","Total",696,190,98,92,506,63,73,92,108,34,58,78
"2011","Dudley 023E","E01009745","Total",727,193,91,102,534,21,101,98,167,14,29,104
"2011","Dudley 024A","E01009917","Total",498,83,45,38,415,15,104,87,99,13,24,73
"2011","Dudley 024B","E01009918","Total",600,147,97,50,453,53,101,77,105,9,30,78
"2011","Dudley 024C","E01009919","Total",502,86,54,32,416,8,138,67,83,16,16,88
"2011","Dudley 024D","E01009920","Total",621,178,54,124,443,13,58,115,164,10,24,59
"2011","Dudley 025A","E01009864","Total",600,91,46,45,509,31,82,118,123,23,34,98
"2011","Dudley 025B","E01009865","Total",644,212,134,78,432,37,105,80,82,27,29,72
"2011","Dudley 025C","E01009866","Total",732,233,93,140,499,40,86,109,136,10,30,88
"2011","Dudley 025D","E01009867","Total",694,158,80,78,536,33,127,94,112,22,40,108
"2011","Dudley 025E","E01009878","Total",764,153,72,81,611,33,99,142,151,30,41,115
"2011","Dudley 026A","E01009791","Total",662,228,111,117,434,28,76,78,123,16,34,79
"2011","Dudley 026B","E01009792","Total",632,182,76,106,450,42,73,83,105,23,53,71
"2011","Dudley 026C","E01009795","Total",705,239,66,173,466,42,59,95,132,21,41,76
"2011","Dudley 026D","E01009796","Total",604,171,92,79,433,18,75,67,108,10,54,101
"2011","Dudley 026E","E01009798","Total",716,210,87,123,506,33,100,83,131,19,39,101
"2011","Dudley 027A","E01009719","Total",558,107,44,63,451,23,78,88,126,16,44,76
"2011","Dudley 027B","E01009722","Total",618,188,68,120,430,27,95,83,128,12,20,65
"2011","Dudley 027C","E01009727","Total",503,78,31,47,425,18,44,86,121,12,35,109
"2011","Dudley 027D","E01009728","Total",501,88,40,48,413,15,59,86,106,10,39,98
"2011","Dudley 027E","E01009729","Total",620,140,84,56,480,31,102,95,95,16,37,104
"2011","Dudley 028A","E01009720","Total",528,89,29,60,439,17,53,98,120,15,35,101
"2011","Dudley 028B","E01009723","Total",466,74,19,55,392,13,57,74,101,14,35,98
"2011","Dudley 028C","E01009724","Total",623,153,51,102,470,16,68,97,152,7,36,94
"2011","Dudley 028D","E01009730","Total",606,158,26,132,448,22,39,117,145,15,34,76
"2011","Dudley 029A","E01009903","Total",621,141,83,58,480,6,148,88,131,14,21,72
"2011","Dudley 029B","E01009904","Total",625,190,126,64,435,5,111,92,121,12,20,74
"2011","Dudley 029C","E01009909","Total",630,217,123,94,413,21,118,77,93,8,24,72
"2011","Dudley 029D","E01009910","Total",711,238,128,110,473,51,110,82,110,11,33,76
"2011","Dudley 030A","E01009793","Total",527,106,50,56,421,20,68,106,98,16,33,80
"2011","Dudley 030B","E01009794","Total",629,160,114,46,469,16,151,81,83,9,25,104
"2011","Dudley 030C","E01009797","Total",645,255,141,114,390,25,117,68,84,6,36,54
"2011","Dudley 030D","E01009801","Total",667,156,90,66,511,8,148,86,103,11,41,114
"2011","Dudley 031A","E01009721","Total",866,302,135,167,564,37,101,112,195,10,26,83
"2011","Dudley 031B","E01009725","Total",595,173,59,114,422,60,54,90,90,17,37,74
"2011","Dudley 031C","E01009726","Total",535,108,40,68,427,20,92,77,115,14,29,80
"2011","Dudley 031D","E01009834","Total",694,218,94,124,476,36,96,73,125,26,37,83
"2011","Dudley 032A","E01009833","Total",498,144,47,97,354,39,32,50,92,35,58,48
"2011","Dudley 032B","E01009835","Total",498,95,38,57,403,26,40,71,86,39,63,78
"2011","Dudley 032C","E01009869","Total",675,187,63,124,488,23,77,93,158,13,34,90
"2011","Dudley 032D","E01009870","Total",668,219,49,170,449,15,61,77,174,10,20,92
"2011","Dudley 033A","E01009809","Total",669,207,115,92,462,46,79,83,104,25,39,86
"2011","Dudley 033B","E01009813","Total",638,160,90,70,478,44,98,85,99,21,47,84
"2011","Dudley 033C","E01009861","Total",646,187,68,119,459,39,81,88,109,24,32,86
"2011","Dudley 033D","E01009862","Total",724,210,73,137,514,40,85,90,145,22,53,79
"2011","Dudley 033E","E01009863","Total",702,151,41,110,551,53,56,116,161,26,57,82
"2011","Dudley 033F","E01009868","Total",671,205,84,121,466,36,74,97,139,25,39,56
"2011","Dudley 034A","E01009734","Total",686,233,123,110,453,34,102,63,129,13,39,73
"2011","Dudley 034B","E01009735","Total",631,159,61,98,472,17,95,104,132,13,34,77
"2011","Dudley 034C","E01009736","Total",602,157,85,72,445,16,116,79,114,13,22,85
"2011","Dudley 034D","E01009737","Total",664,207,96,111,457,23,109,68,131,12,40,74
"2011","Dudley 034E","E01009738","Total",607,162,90,72,445,20,95,87,81,27,49,86
"2011","Dudley 035A","E01009856","Total",901,341,121,220,560,37,90,111,185,35,39,63
"2011","Dudley 035B","E01009905","Total",647,206,87,119,441,25,91,75,150,6,26,68
"2011","Dudley 035C","E01009906","Total",860,440,180,260,420,38,74,85,125,19,22,57
"2011","Dudley 035D","E01009907","Total",637,214,86,128,423,27,71,92,110,12,31,80
"2011","Dudley 035E","E01009908","Total",679,185,75,110,494,18,87,109,134,23,37,86
"2011","Dudley 036A","E01009800","Total",635,187,116,71,448,8,117,101,81,14,32,95
"2011","Dudley 036B","E01009802","Total",668,187,107,80,481,25,100,95,104,21,42,94
"2011","Dudley 036C","E01009803","Total",653,149,117,32,504,7,138,83,96,11,43,126
"2011","Dudley 036D","E01009804","Total",534,132,55,77,402,6,85,64,107,7,33,100
"2011","Dudley 037A","E01009831","Total",638,227,113,114,411,22,89,60,94,16,52,78
"2011","Dudley 037B","E01009836","Total",859,425,122,303,434,71,49,84,105,26,49,50
"2011","Dudley 037C","E01009837","Total",618,191,67,124,427,26,62,72,107,21,55,84
"2011","Dudley 037D","E01009838","Total",658,153,74,79,505,39,102,102,100,26,37,99
"2011","Dudley 038A","E01009847","Total",607,140,81,59,467,19,117,83,106,9,41,92
"2011","Dudley 038B","E01009848","Total",622,199,95,104,423,25,97,87,92,13,35,74
"2011","Dudley 038C","E01009849","Total",653,192,74,118,461,30,83,95,114,14,28,97
"2011","Dudley 038D","E01009851","Total",625,181,104,77,444,18,104,76,118,13,31,84
"2011","Dudley 039A","E01009732","Total",719,213,92,121,506,35,104,85,129,22,48,83
"2011","Dudley 039B","E01009733","Total",929,496,169,327,433,71,48,95,124,21,23,51
"2011","Dudley 039C","E01009739","Total",640,153,63,90,487,42,108,98,105,13,39,82
"2011","Dudley 039D","E01009799","Total",658,185,119,66,473,18,133,96,112,11,30,73
"2011","Dudley 039E","E01009805","Total",613,185,79,106,428,21,96,61,118,7,36,89
"2011","Dudley 039F","E01009806","Total",672,223,89,134,449,16,105,67,134,8,27,92
"2011","Dudley 040A","E01009854","Total",632,132,83,49,500,5,161,86,118,10,29,91
"2011","Dudley 040B","E01009857","Total",694,240,96,144,454,38,68,85,125,24,43,71
"2011","Dudley 040C","E01009858","Total",593,250,125,125,343,14,86,56,117,4,17,49
"2011","Dudley 040D","E01009859","Total",643,150,80,70,493,11,121,105,125,18,39,74
"2011","Dudley 041A","E01009845","Total",628,140,101,39,488,5,159,79,107,21,31,86
"2011","Dudley 041B","E01009846","Total",617,155,109,46,462,26,118,64,106,13,29,106
"2011","Dudley 041C","E01009850","Total",664,223,114,109,441,13,113,94,121,17,28,55
"2011","Dudley 041D","E01009852","Total",601,117,86,31,484,10,158,82,103,14,28,89
"2011","Dudley 042A","E01009832","Total",659,185,111,74,474,51,92,87,87,29,43,85
"2011","Dudley 042B","E01009853","Total",628,153,113,40,475,5,196,70,99,10,12,83
"2011","Dudley 042C","E01009855","Total",637,107,73,34,530,8,183,77,102,14,32,114
"2011","Dudley 042D","E01009860","Total",646,131,84,47,515,11,170,72,119,17,26,100
"2011","Dudley 043A","E01009807","Total",755,180,141,39,575,10,182,109,110,11,43,110
"2011","Dudley 043B","E01009808","Total",602,127,67,60,475,9,110,89,142,11,31,83
"2011","Dudley 043C","E01009810","Total",764,235,156,79,529,30,138,106,120,11,33,91
"2011","Dudley 043D","E01009811","Total",663,173,83,90,490,24,131,98,108,11,32,86
"2011","Dudley 043E","E01009812","Total",577,109,67,42,468,11,98,95,109,15,38,102
"2011","Sandwell 001A","E01010085","Total",606,169,75,94,437,23,69,84,104,16,41,100
"2011","Sandwell 001B","E01010086","Total",690,206,108,98,484,52,47,94,121,25,66,79
"2011","Sandwell 001C","E01010087","Total",615,121,63,58,494,45,68,90,103,21,57,110
"2011","Sandwell 001D","E01010088","Total",557,133,62,71,424,33,50,75,86,21,54,105
"2011","Sandwell 001E","E01010089","Total",697,173,98,75,524,53,74,96,99,29,62,111
"2011","Sandwell 002A","E01009969","Total",774,223,64,159,551,76,51,153,121,15,63,72
"2011","Sandwell 002B","E01009970","Total",629,181,103,78,448,37,98,90,95,19,31,78
"2011","Sandwell 002C","E01009971","Total",670,205,114,91,465,68,48,116,95,20,35,83
"2011","Sandwell 002D","E01009973","Total",761,122,39,83,639,40,48,153,99,40,97,162
"2011","Sandwell 003A","E01009960","Total",649,212,113,99,437,31,78,76,82,26,42,102
"2011","Sandwell 003B","E01009961","Total",534,136,76,60,398,12,97,71,102,6,20,90
"2011","Sandwell 003C","E01009966","Total",467,112,49,63,355,55,49,63,72,17,35,64
"2011","Sandwell 003D","E01009967","Total",770,220,99,121,550,48,91,128,142,18,40,83
"2011","Sandwell 003E","E01010092","Total",781,243,119,124,538,47,102,97,115,21,62,94
"2011","Sandwell 004A","E01009962","Total",499,108,60,48,391,52,60,56,79,21,31,92
"2011","Sandwell 004B","E01009963","Total",497,122,64,58,375,44,52,64,63,23,41,88
"2011","Sandwell 004C","E01009964","Total",564,136,63,73,428,58,47,65,83,34,54,87
"2011","Sandwell 004D","E01009965","Total",471,79,40,39,392,40,47,79,60,37,54,75
"2011","Sandwell 005A","E01010090","Total",708,231,77,154,477,73,77,75,123,14,45,70
"2011","Sandwell 005B","E01010091","Total",634,214,91,123,420,26,73,56,119,12,55,79
"2011","Sandwell 005C","E01010096","Total",714,294,160,134,420,30,113,58,90,14,33,82
"2011","Sandwell 005D","E01010097","Total",731,201,118,83,530,24,148,69,119,13,52,105
"2011","Sandwell 006A","E01009968","Total",646,237,103,134,409,21,99,56,94,11,39,89
"2011","Sandwell 006B","E01009972","Total",723,189,127,62,534,13,152,94,93,13,57,112
"2011","Sandwell 006C","E01009974","Total",608,155,95,60,453,13,122,64,105,12,38,99
"2011","Sandwell 006D","E01009975","Total",658,167,110,57,491,22,124,94,88,14,41,108
"2011","Sandwell 007A","E01010030","Total",654,231,84,147,423,67,73,78,82,16,37,70
"2011","Sandwell 007B","E01010034","Total",507,80,19,61,427,13,33,94,118,11,41,117
"2011","Sandwell 007C","E01010035","Total",589,127,56,71,462,11,138,69,123,5,29,87
"2011","Sandwell 007D","E01010036","Total",615,131,32,99,484,72,34,125,108,26,44,75
"2011","Sandwell 009A","E01009982","Total",528,101,44,57,427,40,38,74,85,36,53,101
"2011","Sandwell 009B","E01009983","Total",570,132,82,50,438,42,77,70,100,20,44,85
"2011","Sandwell 009C","E01010029","Total",536,142,73,69,394,58,72,63,60,32,36,73
"2011","Sandwell 009D","E01010037","Total",407,97,38,59,310,53,43,43,49,26,36,60
"2011","Sandwell 010A","E01009991","Total",797,222,97,125,575,64,77,126,97,28,71,112
"2011","Sandwell 010B","E01009994","Total",620,183,104,79,437,39,61,77,101,18,47,94
"2011","Sandwell 010C","E01009995","Total",612,136,51,85,476,49,78,106,102,20,36,85
"2011","Sandwell 010D","E01009996","Total",654,195,86,109,459,48,88,71,91,15,42,104
"2011","Sandwell 010E","E01009997","Total",627,149,50,99,478,54,61,87,95,28,60,93
"2011","Sandwell 010F","E01009998","Total",772,223,92,131,549,70,66,122,100,32,67,92
"2011","Sandwell 011A","E01010008","Total",627,174,98,76,453,34,104,76,75,15,56,93
"2011","Sandwell 011B","E01010010","Total",598,229,71,158,369,56,52,57,93,15,33,63
"2011","Sandwell 011C","E01010011","Total",688,213,97,116,475,27,102,91,93,23,41,98
"2011","Sandwell 011D","E01010012","Total",564,143,90,53,421,19,105,80,83,10,30,94
"2011","Sandwell 012A","E01010007","Total",507,126,55,71,381,39,69,64,76,20,31,82
"2011","Sandwell 012B","E01010009","Total",541,140,77,63,401,39,64,73,82,15,51,77
"2011","Sandwell 012C","E01010013","Total",513,125,79,46,388,33,111,57,66,11,22,88
"2011","Sandwell 012D","E01010014","Total",713,219,115,104,494,21,138,79,112,13,37,94
"2011","Sandwell 013A","E01010093","Total",477,168,66,102,309,28,43,61,84,10,30,53
"2011","Sandwell 013B","E01010094","Total",485,75,28,47,410,32,47,73,74,11,59,114
"2011","Sandwell 013C","E01010095","Total",488,98,45,53,390,34,51,62,74,25,52,92
"2011","Sandwell 013D","E01010098","Total",748,269,148,121,479,39,109,100,104,12,47,68
"2011","Sandwell 013E","E01010099","Total",655,159,71,88,496,26,107,95,110,11,43,104
"2011","Sandwell 013F","E01010100","Total",666,164,61,103,502,29,69,94,111,16,56,127
"2011","Sandwell 014A","E01009978","Total",625,126,74,52,499,18,86,75,88,16,77,139
"2011","Sandwell 014B","E01010031","Total",720,265,87,178,455,76,81,96,94,13,31,64
"2011","Sandwell 014C","E01010032","Total",467,76,33,43,391,62,31,62,71,56,48,61
"2011","Sandwell 014D","E01010033","Total",767,353,127,226,414,58,63,74,112,7,34,66
"2011","Sandwell 014E","E01010074","Total",953,263,89,174,690,79,89,152,202,27,41,100
"2011","Sandwell 015A","E01010066","Total",651,257,140,117,394,36,77,71,77,26,39,68
"2011","Sandwell 015B","E01010067","Total",641,269,58,211,372,45,39,64,87,33,50,54
"2011","Sandwell 015C","E01010068","Total",620,181,92,89,439,35,54,84,115,24,44,83
"2011","Sandwell 015D","E01010070","Total",719,250,120,130,469,37,80,84,133,17,33,85
"2011","Sandwell 015E","E01010075","Total",446,63,16,47,383,22,18,107,72,21,73,70
"2011","Sandwell 015F","E01010076","Total",578,237,127,110,341,28,78,58,60,20,31,66
"2011","Sandwell 016A","E01009976","Total",980,247,45,202,733,50,62,200,216,21,65,119
"2011","Sandwell 016B","E01009977","Total",711,182,44,138,529,53,61,115,149,24,41,86
"2011","Sandwell 016C","E01009979","Total",797,413,152,261,384,44,71,63,98,18,36,54
"2011","Sandwell 016D","E01009980","Total",825,232,66,166,593,51,60,126,127,29,76,124
"2011","Sandwell 016E","E01010069","Total",627,119,33,86,508,29,36,121,115,20,73,114
"2011","Sandwell 016F","E01010071","Total",682,225,56,169,457,42,50,96,102,17,61,89
"2011","Sandwell 017A","E01009947","Total",788,246,120,126,542,44,94,86,111,27,59,121
"2011","Sandwell 017B","E01009992","Total",615,161,72,89,454,41,59,80,78,23,67,106
"2011","Sandwell 017C","E01009993","Total",715,235,93,142,480,48,71,77,92,35,67,90
"2011","Sandwell 017D","E01010103","Total",782,296,118,178,486,74,59,83,100,27,39,104
"2011","Sandwell 017E","E01010104","Total",827,420,185,235,407,31,96,62,78,15,34,91
"2011","Sandwell 017F","E01010105","Total",517,144,45,99,373,23,51,56,44,9,67,123
"2011","Sandwell 018A","E01009981","Total",716,207,92,115,509,44,81,100,95,36,51,102
"2011","Sandwell 018C","E01009985","Total",674,217,99,118,457,39,94,71,70,32,67,84
"2011","Sandwell 018E","E01032887","Total",979,305,103,202,674,70,88,95,107,64,113,137
"2011","Sandwell 019A","E01009986","Total",453,111,53,58,342,24,55,32,48,31,60,92
"2011","Sandwell 019B","E01009987","Total",471,148,80,68,323,43,41,51,56,25,35,72
"2011","Sandwell 019C","E01009989","Total",642,215,131,84,427,35,61,75,77,27,51,101
"2011","Sandwell 019D","E01010106","Total",486,142,56,86,344,28,38,34,61,15,95,73
"2011","Sandwell 020A","E01009988","Total",734,270,145,125,464,52,74,78,96,31,59,74
"2011","Sandwell 020B","E01010101","Total",872,396,123,273,476,39,85,76,126,14,53,83
"2011","Sandwell 020C","E01010102","Total",683,236,111,125,447,42,80,62,76,24,71,92
"2011","Sandwell 020D","E01010107","Total",663,280,73,207,383,51,28,56,48,18,84,98
"2011","Sandwell 021A","E01010015","Total",619,165,75,90,454,23,78,75,84,22,59,113
"2011","Sandwell 021B","E01010016","Total",578,162,42,120,416,33,31,85,93,27,74,73
"2011","Sandwell 021C","E01010018","Total",862,272,79,193,590,83,62,143,153,13,48,88
"2011","Sandwell 021D","E01010072","Total",931,292,74,218,639,68,58,157,188,47,55,66
"2011","Sandwell 021E","E01010073","Total",593,143,44,99,450,49,56,88,115,12,39,91
"2011","Sandwell 022A","E01010077","Total",651,203,97,106,448,55,86,75,90,21,38,83
"2011","Sandwell 022B","E01010079","Total",612,140,49,91,472,19,101,94,111,15,42,90
"2011","Sandwell 022C","E01010080","Total",695,198,39,159,497,93,58,111,90,38,37,70
"2011","Sandwell 022D","E01010081","Total",626,147,63,84,479,26,81,91,128,15,28,110
"2011","Sandwell 022E","E01010082","Total",852,193,66,127,659,41,50,170,152,36,75,135
"2011","Sandwell 022F","E01010083","Total",674,169,94,75,505,43,85,111,110,27,34,95
"2011","Sandwell 022G","E01010084","Total",546,106,52,54,440,77,48,84,70,27,49,85
"2011","Sandwell 023A","E01010046","Total",581,114,31,83,467,44,19,96,63,50,119,76
"2011","Sandwell 023B","E01010047","Total",564,144,52,92,420,35,47,42,57,39,118,82
"2011","Sandwell 023C","E01010048","Total",514,89,47,42,425,38,46,59,54,23,86,119
"2011","Sandwell 023D","E01010049","Total",568,135,45,90,433,34,67,65,72,17,61,117
"2011","Sandwell 023E","E01010050","Total",496,114,62,52,382,21,51,56,43,22,72,117
"2011","Sandwell 023F","E01010052","Total",475,133,61,72,342,26,49,53,45,41,69,59
"2011","Sandwell 023G","E01010053","Total",576,136,58,78,440,62,27,70,50,40,113,78
"2011","Sandwell 024A","E01010017","Total",841,362,145,217,479,43,70,76,128,28,59,75
"2011","Sandwell 024B","E01010019","Total",621,183,54,129,438,41,38,89,85,48,57,80
"2011","Sandwell 024C","E01010020","Total",668,137,80,57,531,49,100,77,86,31,69,119
"2011","Sandwell 024D","E01010021","Total",654,176,62,114,478,60,59,88,96,17,62,96
"2011","Sandwell 025A","E01010039","Total",499,108,64,44,391,42,58,84,73,19,46,69
"2011","Sandwell 025B","E01010043","Total",592,140,82,58,452,23,113,85,81,13,33,104
"2011","Sandwell 025C","E01010044","Total",582,163,88,75,419,50,80,83,92,15,30,69
"2011","Sandwell 025D","E01010078","Total",517,116,74,42,401,6,128,52,89,8,26,92
"2011","Sandwell 026A","E01010059","Total",612,133,24,109,479,59,26,83,74,36,89,112
"2011","Sandwell 026B","E01010061","Total",523,97,35,62,426,40,33,63,56,42,100,92
"2011","Sandwell 026C","E01010062","Total",659,276,109,167,383,74,54,56,61,19,55,64
"2011","Sandwell 026D","E01010063","Total",775,266,59,207,509,95,31,91,83,50,88,71
"2011","Sandwell 026E","E01010064","Total",683,254,113,141,429,61,40,94,63,28,71,72
"2011","Sandwell 026F","E01010065","Total",845,169,31,138,676,91,27,139,127,69,116,107
"2011","Sandwell 027A","E01009934","Total",590,189,76,113,401,55,67,77,68,12,46,76
"2011","Sandwell 027B","E01009935","Total",885,357,127,230,528,65,119,115,90,12,43,84
"2011","Sandwell 027C","E01009936","Total",669,155,82,73,514,18,130,83,122,20,42,99
"2011","Sandwell 027D","E01010004","Total",773,343,118,225,430,44,90,62,120,16,36,62
"2011","Sandwell 028A","E01010054","Total",868,427,179,248,441,78,50,87,85,25,38,78
"2011","Sandwell 028B","E01010055","Total",643,192,49,143,451,41,35,115,70,27,66,97
"2011","Sandwell 028C","E01010056","Total",629,218,127,91,411,41,60,64,81,26,66,73
"2011","Sandwell 028D","E01010057","Total",658,218,121,97,440,27,59,70,52,36,84,112
"2011","Sandwell 028E","E01010060","Total",689,213,47,166,476,59,49,69,83,26,90,100
"2011","Sandwell 029A","E01010038","Total",669,161,64,97,508,55,73,118,96,21,55,90
"2011","Sandwell 029B","E01010040","Total",572,120,65,55,452,17,108,91,106,11,39,80
"2011","Sandwell 029C","E01010041","Total",744,235,107,128,509,58,101,93,126,22,40,69
"2011","Sandwell 029D","E01010045","Total",625,172,82,90,453,41,62,92,95,27,47,89
"2011","Sandwell 030A","E01010000","Total",674,232,129,103,442,27,95,77,112,10,43,78
"2011","Sandwell 030B","E01010002","Total",817,213,61,152,604,55,76,134,151,30,58,100
"2011","Sandwell 030C","E01010003","Total",712,311,124,187,401,51,46,65,114,13,36,76
"2011","Sandwell 030D","E01010005","Total",572,163,63,100,409,38,64,64,95,14,52,82
"2011","Sandwell 030E","E01010006","Total",640,162,83,79,478,24,82,89,110,18,55,100
"2011","Sandwell 031A","E01009938","Total",668,176,94,82,492,45,80,93,95,17,50,112
"2011","Sandwell 031B","E01009943","Total",478,95,57,38,383,37,57,49,62,25,66,87
"2011","Sandwell 031C","E01009944","Total",575,177,108,69,398,24,57,87,60,23,55,92
"2011","Sandwell 031D","E01010051","Total",465,125,69,56,340,45,43,53,59,20,41,79
"2011","Sandwell 031E","E01010058","Total",681,237,107,130,444,57,71,65,97,20,54,80
"2011","Sandwell 032A","E01009937","Total",599,148,85,63,451,47,69,90,96,23,47,79
"2011","Sandwell 032B","E01009939","Total",669,173,93,80,496,23,98,105,95,23,63,89
"2011","Sandwell 032C","E01009940","Total",618,193,92,101,425,33,76,89,84,16,41,86
"2011","Sandwell 032D","E01009941","Total",596,171,97,74,425,32,80,75,91,20,51,76
"2011","Sandwell 032E","E01009942","Total",627,134,70,64,493,43,81,95,94,17,42,121
"2011","Sandwell 033A","E01009929","Total",723,238,132,106,485,66,76,87,100,25,45,86
"2011","Sandwell 033B","E01009930","Total",634,195,104,91,439,38,86,93,94,19,38,71
"2011","Sandwell 033C","E01009931","Total",900,204,76,128,696,36,103,132,221,24,59,121
"2011","Sandwell 033D","E01009932","Total",809,391,196,195,418,44,61,83,98,22,28,82
"2011","Sandwell 033E","E01009999","Total",527,113,46,67,414,34,82,65,92,18,44,79
"2011","Sandwell 034A","E01009921","Total",715,248,65,183,467,41,39,103,171,8,26,79
"2011","Sandwell 034B","E01009922","Total",503,142,82,60,361,37,57,58,73,14,32,90
"2011","Sandwell 034C","E01009924","Total",616,186,57,129,430,28,60,98,155,11,16,62
"2011","Sandwell 034D","E01009925","Total",560,156,56,100,404,10,56,94,117,18,26,83
"2011","Sandwell 034E","E01009926","Total",615,176,56,120,439,32,45,108,157,9,29,59
"2011","Sandwell 034F","E01009927","Total",714,281,91,190,433,28,41,99,125,15,34,91
"2011","Sandwell 034G","E01009928","Total",756,239,64,175,517,75,44,104,175,9,33,77
"2011","Sandwell 035A","E01009933","Total",541,114,55,59,427,44,66,82,89,18,48,80
"2011","Sandwell 035B","E01009952","Total",885,363,105,258,522,70,46,101,150,36,41,78
"2011","Sandwell 035C","E01009955","Total",812,315,112,203,497,43,75,69,140,32,50,88
"2011","Sandwell 035D","E01009956","Total",678,236,107,129,442,38,72,91,109,21,40,71
"2011","Sandwell 035E","E01009959","Total",591,131,69,62,460,14,92,76,134,20,30,94
"2011","Sandwell 035F","E01010042","Total",775,259,131,128,516,39,97,99,139,21,44,77
"2011","Sandwell 036A","E01009923","Total",574,137,66,71,437,28,98,68,91,20,42,90
"2011","Sandwell 036B","E01010024","Total",618,164,96,68,454,14,106,87,105,14,39,89
"2011","Sandwell 036C","E01010026","Total",704,197,136,61,507,31,128,83,103,17,55,90
"2011","Sandwell 036D","E01010027","Total",587,129,58,71,458,19,102,84,97,16,55,85
"2011","Sandwell 037A","E01010001","Total",705,228,136,92,477,42,98,80,83,20,59,95
"2011","Sandwell 037B","E01010022","Total",620,145,81,64,475,40,108,85,100,13,42,87
"2011","Sandwell 037C","E01010023","Total",767,254,145,109,513,28,104,82,136,13,44,106
"2011","Sandwell 037D","E01010025","Total",677,254,162,92,423,38,81,84,82,21,42,75
"2011","Sandwell 037E","E01010028","Total",606,211,83,128,395,53,53,62,106,19,41,61
"2011","Sandwell 038A","E01009953","Total",790,304,125,179,486,47,75,91,157,14,32,70
"2011","Sandwell 038B","E01009954","Total",718,218,128,90,500,32,119,91,102,20,45,91
"2011","Sandwell 038C","E01009957","Total",634,169,74,95,465,60,50,90,100,35,44,86
"2011","Sandwell 038D","E01009958","Total",641,150,75,75,491,12,107,88,121,17,47,99
"2011","Sandwell 039A","E01009946","Total",657,170,97,73,487,21,106,82,115,17,47,99
"2011","Sandwell 039B","E01009948","Total",585,120,59,61,465,15,117,71,109,7,38,108
"2011","Sandwell 039C","E01009949","Total",578,125,84,41,453,12,114,80,80,13,52,102
"2011","Sandwell 039D","E01009950","Total",639,148,74,74,491,20,105,84,96,13,46,127
"2011","Sandwell 039E","E01009951","Total",1004,482,113,369,522,109,58,123,141,8,31,52
"2011","Sandwell 039F","E01032592","Total",714,171,97,74,543,41,122,97,119,9,50,105
"2011","Solihull 001A","E01010118","Total",508,116,52,64,392,24,67,45,95,9,39,113
"2011","Solihull 001B","E01010120","Total",656,283,113,170,373,55,59,52,102,3,21,81
"2011","Solihull 001C","E01010121","Total",605,172,111,61,433,13,115,50,110,10,35,100
"2011","Solihull 001D","E01010122","Total",600,164,93,71,436,13,130,44,107,9,30,103
"2011","Solihull 002A","E01010235","Total",564,166,40,126,398,62,60,62,65,26,44,79
"2011","Solihull 002B","E01010236","Total",665,235,66,169,430,119,45,72,77,16,29,72
"2011","Solihull 002C","E01010239","Total",630,179,72,107,451,59,66,79,97,22,47,81
"2011","Solihull 002D","E01010240","Total",582,213,68,145,369,60,51,67,77,11,32,71
"2011","Solihull 003A","E01010117","Total",533,86,46,40,447,17,82,67,118,3,38,122
"2011","Solihull 003B","E01010119","Total",604,151,117,34,453,12,112,73,89,12,42,113
"2011","Solihull 003C","E01010123","Total",583,166,116,50,417,9,98,74,80,10,42,104
"2011","Solihull 003D","E01010124","Total",619,132,92,40,487,7,134,56,115,13,40,122
"2011","Solihull 004A","E01010146","Total",649,177,84,93,472,75,55,74,111,11,57,89
"2011","Solihull 004B","E01010234","Total",539,192,58,134,347,82,48,59,69,14,29,46
"2011","Solihull 004C","E01010237","Total",760,180,82,98,580,70,114,94,122,17,49,114
"2011","Solihull 004D","E01010238","Total",666,264,69,195,402,86,61,57,96,9,33,60
"2011","Solihull 005A","E01010145","Total",648,203,104,99,445,39,118,58,77,17,50,86
"2011","Solihull 005B","E01010147","Total",641,205,43,162,436,134,31,84,93,17,24,53
"2011","Solihull 005C","E01010148","Total",732,233,86,147,499,108,48,87,85,41,43,87
"2011","Solihull 005D","E01010149","Total",572,130,70,60,442,27,102,56,81,11,34,131
"2011","Solihull 006A","E01010125","Total",711,316,125,191,395,87,64,63,74,14,24,69
"2011","Solihull 006B","E01010129","Total",695,265,107,158,430,105,64,58,99,12,34,58
"2011","Solihull 006C","E01010139","Total",400,97,54,43,303,21,66,37,66,19,36,58
"2011","Solihull 006D","E01010141","Total",656,292,53,239,364,88,31,75,84,10,29,47
"2011","Solihull 007A","E01010140","Total",645,212,87,125,433,75,63,69,83,21,37,85
"2011","Solihull 007B","E01010142","Total",641,262,87,175,379,92,50,67,57,13,36,64
"2011","Solihull 007C","E01010143","Total",658,247,91,156,411,81,78,79,77,13,26,57
"2011","Solihull 007D","E01010144","Total",740,268,111,157,472,37,94,101,103,19,31,87
"2011","Solihull 008A","E01010111","Total",668,245,65,180,423,94,55,62,104,15,37,56
"2011","Solihull 008B","E01010126","Total",661,256,69,187,405,83,67,67,77,11,40,60
"2011","Solihull 008C","E01010127","Total",749,233,53,180,516,77,81,105,111,30,35,77
"2011","Solihull 008D","E01010128","Total",586,151,59,92,435,59,87,83,77,11,44,74
"2011","Solihull 008E","E01010130","Total",820,311,83,228,509,133,85,86,92,22,20,71
"2011","Solihull 008F","E01010131","Total",632,234,61,173,398,82,67,66,76,14,30,63
"2011","Solihull 009A","E01010109","Total",550,125,69,56,425,17,95,63,96,17,35,102
"2011","Solihull 009B","E01010110","Total",574,104,48,56,470,26,103,73,104,11,54,99
"2011","Solihull 009C","E01010112","Total",675,196,45,151,479,48,64,103,150,13,36,65
"2011","Solihull 009D","E01010113","Total",555,176,74,102,379,42,79,55,82,18,30,73
"2011","Solihull 009E","E01010114","Total",730,187,112,75,543,22,128,86,116,17,55,119
"2011","Solihull 010A","E01010157","Total",597,156,63,93,441,27,68,108,131,13,21,73
"2011","Solihull 010B","E01010159","Total",531,121,67,54,410,28,73,99,74,14,33,89
"2011","Solihull 010C","E01010162","Total",623,174,109,65,449,20,109,69,92,19,40,100
"2011","Solihull 010D","E01010163","Total",551,124,72,52,427,19,77,93,89,27,32,90
"2011","Solihull 011A","E01010132","Total",623,192,126,66,431,36,105,67,89,18,28,88
"2011","Solihull 011B","E01010133","Total",696,255,172,83,441,22,151,67,69,7,43,82
"2011","Solihull 011C","E01010134","Total",585,160,106,54,425,22,102,91,85,11,38,76
"2011","Solihull 011D","E01010135","Total",655,220,109,111,435,24,104,70,99,9,43,86
"2011","Solihull 011E","E01010138","Total",601,166,83,83,435,24,103,80,110,13,34,71
"2011","Solihull 012A","E01010136","Total",522,137,76,61,385,21,65,100,97,17,24,61
"2011","Solihull 012B","E01010137","Total",647,303,159,144,344,27,81,58,70,11,25,72
"2011","Solihull 012C","E01010158","Total",637,238,115,123,399,45,66,81,83,20,36,68
"2011","Solihull 012D","E01010160","Total",636,195,98,97,441,26,100,63,89,16,45,102
"2011","Solihull 012E","E01010161","Total",616,173,94,79,443,11,101,82,94,15,50,90
"2011","Solihull 013A","E01010174","Total",655,163,62,101,492,33,100,77,110,20,47,105
"2011","Solihull 013B","E01010175","Total",710,223,104,119,487,27,115,90,100,17,40,98
"2011","Solihull 013C","E01010177","Total",577,167,77,90,410,20,101,80,95,14,26,74
"2011","Solihull 013D","E01010178","Total",894,466,186,280,428,45,76,76,135,13,41,42
"2011","Solihull 014A","E01010172","Total",585,118,80,38,467,13,102,101,96,16,37,102
"2011","Solihull 014B","E01010173","Total",549,109,60,49,440,8,104,100,99,20,45,64
"2011","Solihull 014C","E01010176","Total",473,90,46,44,383,14,80,85,53,18,38,95
"2011","Solihull 014D","E01010179","Total",773,339,212,127,434,20,119,67,111,7,30,80
"2011","Solihull 015A","E01010115","Total",667,230,88,142,437,32,87,89,100,9,38,82
"2011","Solihull 015B","E01010116","Total",522,66,31,35,456,6,76,74,127,14,55,104
"2011","Solihull 015C","E01010227","Total",799,221,132,89,578,16,149,93,158,8,39,115
"2011","Solihull 015D","E01010228","Total",671,183,90,93,488,24,103,107,120,16,46,72
"2011","Solihull 015E","E01010232","Total",954,376,105,271,578,81,78,136,153,23,34,73
"2011","Solihull 016A","E01010195","Total",585,103,76,27,482,6,131,106,83,25,43,88
"2011","Solihull 016B","E01010226","Total",844,412,266,146,432,24,145,80,108,3,12,60
"2011","Solihull 016C","E01010229","Total",553,111,85,26,442,3,119,95,69,20,39,97
"2011","Solihull 016D","E01010230","Total",759,249,117,132,510,42,108,108,115,15,41,81
"2011","Solihull 016E","E01010231","Total",661,136,83,53,525,9,157,103,92,15,56,93
"2011","Solihull 016F","E01010233","Total",763,218,86,132,545,32,98,107,161,21,43,83
"2011","Solihull 017A","E01010108","Total",857,247,118,129,610,14,160,124,160,22,38,92
"2011","Solihull 017B","E01010164","Total",654,143,70,73,511,16,153,88,118,12,29,95
"2011","Solihull 017C","E01010165","Total",712,285,136,149,427,24,116,77,112,11,21,66
"2011","Solihull 017D","E01010167","Total",637,178,70,108,459,18,91,78,144,13,34,81
"2011","Solihull 018A","E01010199","Total",701,151,87,64,550,18,144,126,91,31,66,74
"2011","Solihull 018B","E01010200","Total",663,263,191,72,400,23,111,81,80,17,25,63
"2011","Solihull 018C","E01010201","Total",616,146,88,58,470,16,112,80,78,24,58,102
"2011","Solihull 018D","E01010204","Total",653,332,92,240,321,46,56,52,80,10,20,57
"2011","Solihull 018E","E01010205","Total",543,102,59,43,441,14,96,80,76,18,53,104
"2011","Solihull 018F","E01010206","Total",632,135,77,58,497,19,88,138,95,17,42,98
"2011","Solihull 019A","E01010192","Total",683,232,117,115,451,14,119,65,114,14,38,87
"2011","Solihull 019B","E01010196","Total",624,102,81,21,522,8,142,91,99,20,60,102
"2011","Solihull 019C","E01010197","Total",638,128,101,27,510,5,144,93,101,23,51,93
"2011","Solihull 019D","E01010198","Total",742,279,183,96,463,9,130,91,110,12,28,83
"2011","Solihull 021A","E01010218","Total",634,255,113,142,379,39,106,43,91,8,25,67
"2011","Solihull 021B","E01010219","Total",698,221,113,108,477,26,116,99,92,9,42,93
"2011","Solihull 021C","E01010221","Total",695,274,146,128,421,28,106,72,106,6,27,76
"2011","Solihull 021D","E01010222","Total",618,179,73,106,439,23,102,76,107,8,39,84
"2011","Solihull 022A","E01010191","Total",771,223,120,103,548,18,131,85,133,11,51,119
"2011","Solihull 022B","E01010202","Total",612,151,86,65,461,13,116,108,78,14,45,87
"2011","Solihull 022C","E01010203","Total",747,240,104,136,507,35,113,91,115,20,40,93
"2011","Solihull 022D","E01010209","Total",696,180,91,89,516,32,96,104,127,15,46,96
"2011","Solihull 022E","E01010213","Total",648,194,93,101,454,30,88,80,108,18,46,84
"2011","Solihull 023A","E01010208","Total",643,179,131,48,464,22,123,94,86,7,41,91
"2011","Solihull 023B","E01010210","Total",639,145,100,45,494,6,130,81,109,11,34,123
"2011","Solihull 023C","E01010211","Total",663,247,158,89,416,23,114,55,104,6,27,87
"2011","Solihull 023D","E01010217","Total",630,149,88,61,481,16,112,83,118,13,25,114
"2011","Solihull 024A","E01010190","Total",669,160,70,90,509,25,94,105,126,21,56,82
"2011","Solihull 024B","E01010193","Total",477,48,23,25,429,6,69,87,102,18,47,100
"2011","Solihull 024C","E01010194","Total",653,150,53,97,503,22,71,138,133,14,35,90
"2011","Solihull 024D","E01010207","Total",600,168,95,73,432,17,89,80,98,7,37,104
"2011","Solihull 025A","E01010166","Total",550,86,59,27,464,12,151,82,84,17,51,67
"2011","Solihull 025B","E01010168","Total",793,228,110,118,565,26,115,136,149,17,46,76
"2011","Solihull 025C","E01010169","Total",669,162,92,70,507,9,150,116,113,17,41,61
"2011","Solihull 025D","E01010170","Total",554,81,48,33,473,9,93,104,110,23,46,88
"2011","Solihull 025E","E01010171","Total",535,122,70,52,413,17,89,79,100,13,36,79
"2011","Solihull 026A","E01010151","Total",802,370,218,152,432,35,110,75,115,12,22,63
"2011","Solihull 026B","E01010152","Total",502,67,39,28,435,8,102,87,84,21,36,97
"2011","Solihull 026C","E01010153","Total",618,142,86,56,476,11,141,83,108,20,34,79
"2011","Solihull 026D","E01010154","Total",677,182,119,63,495,6,174,79,101,10,38,87
"2011","Solihull 026E","E01010155","Total",659,178,107,71,481,20,152,97,83,16,29,84
"2011","Solihull 026F","E01010156","Total",630,144,89,55,486,12,132,100,97,17,37,91
"2011","Solihull 027A","E01010212","Total",486,77,32,45,409,2,71,66,93,21,44,112
"2011","Solihull 027B","E01010214","Total",505,105,39,66,400,14,88,82,112,4,21,79
"2011","Solihull 027C","E01010215","Total",675,179,58,121,496,23,100,90,139,10,45,89
"2011","Solihull 027D","E01010216","Total",603,151,38,113,452,14,59,109,134,14,36,86
"2011","Solihull 028A","E01010150","Total",647,142,96,46,505,15,132,112,104,23,38,81
"2011","Solihull 028B","E01010184","Total",615,199,101,98,416,30,82,92,97,21,21,73
"2011","Solihull 028C","E01010185","Total",611,120,98,22,491,6,139,104,103,15,38,86
"2011","Solihull 028D","E01010186","Total",799,219,119,100,580,29,109,152,143,27,33,87
"2011","Solihull 028E","E01010187","Total",510,64,29,35,446,12,75,134,71,21,44,89
"2011","Solihull 028F","E01010188","Total",685,143,107,36,542,6,164,101,112,28,49,82
"2011","Solihull 029A","E01010180","Total",520,133,71,62,387,16,74,89,93,12,26,77
"2011","Solihull 029B","E01010181","Total",749,152,43,109,597,32,97,165,153,24,45,81
"2011","Solihull 029D","E01010183","Total",531,106,54,52,425,18,96,65,110,26,27,83
"2011","Solihull 029E","E01010189","Total",634,130,71,59,504,22,113,106,120,20,33,90
"2011","Solihull 029F","E01032885","Total",665,316,6,310,349,35,14,75,183,6,12,24
"2011","Solihull 029G","E01032886","Total",775,198,34,164,577,38,50,167,159,24,48,91
"2011","Solihull 030A","E01010220","Total",659,162,87,75,497,25,82,126,119,13,40,92
"2011","Solihull 030B","E01010223","Total",486,130,59,71,356,23,70,66,76,16,32,73
"2011","Solihull 030C","E01010225","Total",580,126,62,64,454,36,74,115,99,10,46,74
"2011","Solihull 030D","E01032590","Total",668,184,86,98,484,23,78,92,105,26,58,102
"2011","Walsall 001A","E01010301","Total",631,170,68,102,461,51,89,71,125,14,29,82
"2011","Walsall 001B","E01010303","Total",604,141,63,78,463,25,91,79,119,16,34,99
"2011","Walsall 001C","E01010306","Total",779,191,67,124,588,37,97,131,143,31,41,108
"2011","Walsall 001D","E01010307","Total",675,141,64,77,534,32,60,159,135,18,54,76
"2011","Walsall 002A","E01010302","Total",638,203,122,81,435,32,88,71,105,12,43,84
"2011","Walsall 002B","E01010304","Total",732,188,95,93,544,23,158,85,140,15,42,81
"2011","Walsall 002C","E01010305","Total",523,103,46,57,420,32,84,73,80,22,43,86
"2011","Walsall 002D","E01010308","Total",591,249,138,111,342,27,61,56,87,21,22,68
"2011","Walsall 003A","E01010345","Total",482,112,78,34,370,11,115,48,97,9,17,73
"2011","Walsall 003B","E01010346","Total",525,84,39,45,441,18,87,96,103,17,37,83
"2011","Walsall 003C","E01010347","Total",642,205,111,94,437,43,96,72,95,23,28,80
"2011","Walsall 003D","E01010350","Total",570,126,61,65,444,18,83,113,99,16,40,75
"2011","Walsall 004A","E01010249","Total",737,207,63,144,530,58,72,122,136,26,32,84
"2011","Walsall 004B","E01010250","Total",584,136,77,59,448,21,117,71,106,8,32,93
"2011","Walsall 004C","E01010252","Total",745,210,102,108,535,48,107,96,130,21,38,95
"2011","Walsall 004D","E01010254","Total",617,187,94,93,430,25,79,71,111,19,42,83
"2011","Walsall 005A","E01010348","Total",623,166,93,73,457,37,105,97,115,15,27,61
"2011","Walsall 005B","E01010349","Total",612,247,146,101,365,26,99,55,86,4,24,71
"2011","Walsall 005C","E01010351","Total",743,205,101,104,538,20,171,85,124,14,33,91
"2011","Walsall 005D","E01010352","Total",664,135,86,49,529,13,186,90,101,10,38,91
"2011","Walsall 006A","E01010284","Total",667,221,118,103,446,45,89,80,100,11,33,88
"2011","Walsall 006B","E01010285","Total",737,201,133,68,536,28,153,73,127,19,43,93
"2011","Walsall 006C","E01010286","Total",649,180,78,102,469,48,82,76,96,31,63,73
"2011","Walsall 006D","E01010290","Total",782,292,144,148,490,34,161,61,100,12,29,93
"2011","Walsall 007A","E01010251","Total",517,68,32,36,449,6,66,92,132,18,34,101
"2011","Walsall 007B","E01010253","Total",536,167,93,74,369,30,90,56,90,12,29,62
"2011","Walsall 007C","E01010255","Total",614,174,122,52,440,8,156,71,112,7,18,68
"2011","Walsall 007D","E01010256","Total",668,221,97,124,447,21,103,72,112,12,46,81
"2011","Walsall 007E","E01010257","Total",514,123,74,49,391,9,125,56,83,9,27,82
"2011","Walsall 008A","E01010292","Total",832,384,108,276,448,55,97,65,147,13,26,45
"2011","Walsall 008B","E01010294","Total",667,267,111,156,400,46,68,58,87,18,51,72
"2011","Walsall 008C","E01010296","Total",596,128,31,97,468,23,53,117,157,8,34,76
"2011","Walsall 008D","E01010297","Total",587,113,76,37,474,4,135,87,118,6,43,81
"2011","Walsall 009A","E01010291","Total",548,130,70,60,418,56,77,63,79,24,44,75
"2011","Walsall 009B","E01010293","Total",728,286,158,128,442,28,120,67,110,15,31,71
"2011","Walsall 009C","E01010298","Total",486,128,69,59,358,35,60,55,83,15,25,85
"2011","Walsall 009D","E01010299","Total",604,139,80,59,465,62,71,73,87,37,54,81
"2011","Walsall 009E","E01010300","Total",653,233,130,103,420,53,77,66,87,22,36,79
"2011","Walsall 010A","E01010319","Total",485,67,27,40,418,11,67,72,91,14,50,113
"2011","Walsall 010B","E01010321","Total",636,171,83,88,465,38,95,65,104,20,52,91
"2011","Walsall 010C","E01010353","Total",674,199,110,89,475,38,130,78,128,9,24,68
"2011","Walsall 010D","E01010354","Total",656,161,87,74,495,26,149,90,98,9,32,91
"2011","Walsall 011A","E01010395","Total",508,70,29,41,438,16,61,82,129,9,40,101
"2011","Walsall 011B","E01010397","Total",617,126,62,64,491,49,80,85,100,30,49,98
"2011","Walsall 011C","E01010398","Total",624,119,58,61,505,18,82,93,123,15,61,113
"2011","Walsall 011D","E01010399","Total",637,158,49,109,479,37,55,87,141,19,36,104
"2011","Walsall 012A","E01010282","Total",513,132,54,78,381,50,52,74,83,22,39,61
"2011","Walsall 012B","E01010287","Total",637,233,111,122,404,39,87,76,98,8,35,61
"2011","Walsall 012C","E01010288","Total",630,163,70,93,467,53,64,91,100,37,42,80
"2011","Walsall 012D","E01010289","Total",621,152,82,70,469,49,76,84,88,33,42,97
"2011","Walsall 013B","E01010277","Total",618,156,73,83,462,43,64,78,102,29,45,101
"2011","Walsall 013D","E01010283","Total",692,142,61,81,550,74,42,99,141,51,54,89
"2011","Walsall 013E","E01032889","Total",696,179,74,105,517,56,59,94,96,49,54,109
"2011","Walsall 014A","E01010393","Total",588,120,72,48,468,17,117,65,100,14,45,110
"2011","Walsall 014B","E01010394","Total",531,100,58,42,431,18,76,83,99,19,42,94
"2011","Walsall 014C","E01010396","Total",630,154,86,68,476,25,80,99,118,20,39,95
"2011","Walsall 014D","E01010400","Total",945,375,154,221,570,84,119,114,157,11,24,61
"2011","Walsall 015A","E01010241","Total",1039,379,178,201,660,34,185,119,178,12,36,96
"2011","Walsall 015B","E01010242","Total",801,340,180,160,461,41,112,97,106,12,25,68
"2011","Walsall 015C","E01010243","Total",688,227,171,56,461,23,144,78,96,14,22,84
"2011","Walsall 015D","E01010244","Total",633,188,94,94,445,77,77,96,86,17,36,56
"2011","Walsall 016A","E01010320","Total",594,181,81,100,413,36,98,60,95,16,29,79
"2011","Walsall 016B","E01010322","Total",676,208,101,107,468,34,94,97,125,15,26,77
"2011","Walsall 016C","E01010323","Total",623,162,89,73,461,29,119,77,109,13,36,78
"2011","Walsall 016D","E01010324","Total",659,223,93,130,436,31,62,92,115,13,32,91
"2011","Walsall 017A","E01010271","Total",687,181,59,122,506,79,47,116,102,24,37,101
"2011","Walsall 017B","E01010272","Total",727,290,96,194,437,81,63,68,122,20,20,63
"2011","Walsall 017C","E01010273","Total",627,185,101,84,442,75,59,86,77,29,32,84
"2011","Walsall 017D","E01010295","Total",615,196,86,110,419,44,74,62,90,22,43,84
"2011","Walsall 018B","E01010279","Total",708,233,85,148,475,60,68,103,126,33,38,47
"2011","Walsall 018D","E01010374","Total",631,181,42,139,450,63,43,77,87,44,62,74
"2011","Walsall 018E","E01010375","Total",735,206,38,168,529,68,26,101,94,71,87,82
"2011","Walsall 018F","E01032888","Total",1013,288,141,147,725,71,122,136,143,56,66,131
"2011","Walsall 019A","E01010378","Total",476,90,37,53,386,23,67,64,98,13,35,86
"2011","Walsall 019B","E01010379","Total",559,132,78,54,427,14,135,62,96,13,20,87
"2011","Walsall 019C","E01010382","Total",658,171,84,87,487,30,133,63,115,18,28,100
"2011","Walsall 019D","E01010383","Total",693,291,115,176,402,59,61,75,102,14,17,74
"2011","Walsall 020A","E01010376","Total",488,70,28,42,418,8,51,67,112,9,45,126
"2011","Walsall 020B","E01010377","Total",619,161,94,67,458,24,92,76,110,27,48,81
"2011","Walsall 020C","E01010380","Total",683,186,122,64,497,6,192,66,103,5,20,105
"2011","Walsall 020D","E01010381","Total",661,225,75,150,436,42,85,79,107,9,39,75
"2011","Walsall 021A","E01010267","Total",715,182,88,94,533,38,91,108,167,21,40,68
"2011","Walsall 021B","E01010268","Total",579,137,41,96,442,39,32,87,88,66,58,72
"2011","Walsall 021C","E01010274","Total",605,148,90,58,457,59,64,82,87,32,40,93
"2011","Walsall 021D","E01010275","Total",641,200,108,92,441,61,70,69,97,24,35,85
"2011","Walsall 022A","E01010245","Total",649,187,134,53,462,18,136,70,87,16,46,89
"2011","Walsall 022B","E01010246","Total",623,136,80,56,487,25,124,88,94,19,37,100
"2011","Walsall 022C","E01010247","Total",701,191,118,73,510,15,167,85,100,21,38,84
"2011","Walsall 022D","E01010248","Total",649,124,77,47,525,12,167,86,104,19,43,94
"2011","Walsall 022E","E01010388","Total",560,109,64,45,451,6,122,67,94,11,44,107
"2011","Walsall 023A","E01010258","Total",727,203,106,97,524,86,85,110,111,26,33,73
"2011","Walsall 023B","E01010259","Total",647,159,94,65,488,30,115,84,92,13,36,118
"2011","Walsall 023C","E01010260","Total",674,211,122,89,463,33,74,89,109,18,43,97
"2011","Walsall 023D","E01010266","Total",511,95,47,48,416,51,42,70,106,26,44,77
"2011","Walsall 024A","E01010317","Total",674,186,104,82,488,6,164,53,107,14,44,100
"2011","Walsall 024B","E01010318","Total",770,381,99,282,389,47,63,58,108,17,30,66
"2011","Walsall 024C","E01010325","Total",695,264,79,185,431,22,79,79,101,24,49,77
"2011","Walsall 024D","E01010369","Total",902,456,77,379,446,53,46,59,159,19,41,69
"2011","Walsall 025A","E01010401","Total",620,182,82,100,438,61,79,79,92,15,33,79
"2011","Walsall 025B","E01010403","Total",683,208,48,160,475,78,32,112,98,22,52,81
"2011","Walsall 025C","E01010404","Total",728,210,73,137,518,71,68,82,126,23,61,87
"2011","Walsall 025D","E01010407","Total",628,130,68,62,498,45,94,67,117,23,52,100
"2011","Walsall 025E","E01010408","Total",649,204,49,155,445,47,48,100,129,23,29,69
"2011","Walsall 026A","E01010269","Total",530,148,45,103,382,55,18,58,71,69,57,54
"2011","Walsall 026B","E01010270","Total",674,203,90,113,471,39,71,79,80,29,66,107
"2011","Walsall 026C","E01010362","Total",623,157,80,77,466,57,61,65,91,38,63,91
"2011","Walsall 026D","E01010363","Total",758,269,74,195,489,61,32,81,143,41,62,69
"2011","Walsall 027A","E01010402","Total",668,163,63,100,505,35,71,119,112,25,44,99
"2011","Walsall 027B","E01010405","Total",703,238,74,164,465,39,58,85,135,19,54,75
"2011","Walsall 027C","E01010406","Total",1090,375,105,270,715,96,53,167,204,31,60,104
"2011","Walsall 027D","E01010409","Total",632,156,50,106,476,51,70,89,113,19,41,93
"2011","Walsall 028A","E01010385","Total",642,174,104,70,468,11,131,66,86,18,42,114
"2011","Walsall 028B","E01010386","Total",725,235,177,58,490,18,172,75,95,11,30,89
"2011","Walsall 028C","E01010387","Total",629,129,88,41,500,15,140,84,110,11,38,102
"2011","Walsall 028D","E01010392","Total",656,171,87,84,485,16,145,79,112,9,43,81
"2011","Walsall 029A","E01010326","Total",583,129,61,68,454,13,89,70,88,17,74,103
"2011","Walsall 029B","E01010327","Total",561,130,37,93,431,47,40,96,74,44,74,56
"2011","Walsall 029C","E01010328","Total",534,113,88,25,421,9,122,59,65,17,53,96
"2011","Walsall 029D","E01010330","Total",635,280,116,164,355,36,51,60,86,18,53,51
"2011","Walsall 030A","E01010368","Total",1023,564,82,482,459,70,44,72,169,22,31,51
"2011","Walsall 030B","E01010370","Total",846,410,77,333,436,45,45,90,114,26,51,65
"2011","Walsall 030C","E01010371","Total",886,371,80,291,515,62,18,82,131,48,95,79
"2011","Walsall 030D","E01010372","Total",623,234,80,154,389,27,61,59,92,23,61,66
"2011","Walsall 030E","E01010373","Total",527,130,52,78,397,14,59,51,88,20,65,100
"2011","Walsall 031A","E01010361","Total",556,144,50,94,412,40,49,70,97,19,38,99
"2011","Walsall 031B","E01010364","Total",505,112,45,67,393,44,38,73,62,35,60,81
"2011","Walsall 031C","E01010365","Total",589,243,85,158,346,56,40,61,49,33,51,56
"2011","Walsall 031D","E01010366","Total",664,202,91,111,462,55,68,83,69,28,62,97
"2011","Walsall 031E","E01010367","Total",622,161,79,82,461,50,67,70,79,35,68,92
"2011","Walsall 032A","E01010384","Total",576,115,67,48,461,20,112,89,90,15,44,91
"2011","Walsall 032B","E01010389","Total",591,140,73,67,451,9,142,70,79,8,51,92
"2011","Walsall 032C","E01010390","Total",707,167,80,87,540,22,133,110,115,15,32,113
"2011","Walsall 032D","E01010391","Total",792,172,81,91,620,24,147,132,131,21,48,117
"2011","Walsall 033A","E01010261","Total",658,198,56,142,460,61,47,99,114,23,49,67
"2011","Walsall 033B","E01010263","Total",507,105,24,81,402,32,38,75,55,40,85,77
"2011","Walsall 033C","E01010264","Total",637,208,90,118,429,23,62,79,102,35,43,85
"2011","Walsall 033D","E01010265","Total",641,162,46,116,479,67,38,94,92,38,68,82
"2011","Walsall 034A","E01010336","Total",532,136,56,80,396,22,48,60,63,39,66,98
"2011","Walsall 034B","E01010340","Total",563,163,45,118,400,33,29,79,61,42,84,72
"2011","Walsall 034C","E01010341","Total",481,98,35,63,383,23,35,59,45,53,102,66
"2011","Walsall 034D","E01010342","Total",508,111,26,85,397,48,25,75,65,46,59,79
"2011","Walsall 034E","E01010343","Total",467,93,29,64,374,28,34,57,59,59,75,62
"2011","Walsall 034F","E01010344","Total",599,168,75,93,431,45,60,77,70,53,56,70
"2011","Walsall 035A","E01010331","Total",631,112,82,30,519,5,167,56,91,25,60,115
"2011","Walsall 035B","E01010332","Total",653,145,83,62,508,9,132,56,92,20,82,117
"2011","Walsall 035C","E01010333","Total",646,179,98,81,467,13,132,72,76,18,45,111
"2011","Walsall 035D","E01010334","Total",568,117,85,32,451,2,121,72,72,20,60,104
"2011","Walsall 036A","E01010262","Total",652,197,66,131,455,41,56,108,113,25,40,72
"2011","Walsall 036B","E01010309","Total",739,211,63,148,528,78,58,102,112,38,47,93
"2011","Walsall 036C","E01010311","Total",715,267,104,163,448,44,88,90,91,29,30,76
"2011","Walsall 036D","E01010316","Total",635,158,74,84,477,69,62,86,103,31,50,76
"2011","Walsall 037A","E01010335","Total",643,187,73,114,456,58,41,86,96,43,57,75
"2011","Walsall 037B","E01010337","Total",547,165,77,88,382,20,67,66,74,20,55,80
"2011","Walsall 037C","E01010338","Total",545,116,53,63,429,26,47,72,60,46,86,92
"2011","Walsall 037D","E01010339","Total",522,99,62,37,423,21,69,73,78,28,65,89
"2011","Walsall 038A","E01010310","Total",608,121,71,50,487,40,70,70,104,40,73,90
"2011","Walsall 038B","E01010312","Total",709,216,106,110,493,53,70,111,107,31,43,78
"2011","Walsall 038C","E01010313","Total",548,113,56,57,435,48,58,97,88,17,40,87
"2011","Walsall 038D","E01010314","Total",641,204,114,90,437,45,81,54,88,19,55,95
"2011","Walsall 038E","E01010315","Total",575,180,75,105,395,47,63,77,113,8,28,59
"2011","Walsall 039A","E01010329","Total",651,162,119,43,489,14,139,72,105,13,52,94
"2011","Walsall 039B","E01010355","Total",612,172,118,54,440,16,136,88,60,12,37,91
"2011","Walsall 039C","E01010356","Total",621,153,100,53,468,16,121,73,103,16,48,91
"2011","Walsall 039D","E01010357","Total",770,172,76,96,598,33,131,111,160,15,40,108
"2011","Walsall 039E","E01010358","Total",624,187,112,75,437,26,95,71,97,14,41,93
"2011","Walsall 039F","E01010359","Total",647,171,85,86,476,41,99,104,94,13,43,82
"2011","Walsall 039G","E01010360","Total",614,155,96,59,459,16,117,87,92,16,45,86
"2011","Wolverhampton 001A","E01010434","Total",733,222,75,147,511,57,89,92,134,15,37,87
"2011","Wolverhampton 001B","E01010436","Total",611,160,81,79,451,11,110,56,117,6,33,118
"2011","Wolverhampton 001C","E01010437","Total",487,87,27,60,400,7,67,88,115,7,21,95
"2011","Wolverhampton 001D","E01010438","Total",632,199,114,85,433,33,127,48,111,6,24,84
"2011","Wolverhampton 001E","E01010439","Total",538,152,85,67,386,35,87,49,75,17,48,75
"2011","Wolverhampton 001F","E01010440","Total",710,298,157,141,412,42,80,65,88,20,35,82
"2011","Wolverhampton 001G","E01010441","Total",557,138,73,65,419,62,64,65,100,14,32,82
"2011","Wolverhampton 002A","E01010495","Total",790,284,162,122,506,65,96,100,127,7,30,81
"2011","Wolverhampton 002B","E01010497","Total",468,117,44,73,351,12,41,64,95,8,39,92
"2011","Wolverhampton 002C","E01010499","Total",519,118,44,74,401,32,64,82,85,12,44,82
"2011","Wolverhampton 002D","E01010500","Total",482,93,39,54,389,75,37,64,57,27,50,79
"2011","Wolverhampton 003A","E01010496","Total",646,248,104,144,398,51,38,91,110,12,40,56
"2011","Wolverhampton 003B","E01010498","Total",648,197,38,159,451,23,64,70,172,13,29,80
"2011","Wolverhampton 003C","E01010541","Total",650,245,83,162,405,90,22,68,92,18,36,79
"2011","Wolverhampton 003D","E01010543","Total",604,207,43,164,397,80,31,83,82,18,38,65
"2011","Wolverhampton 004A","E01010456","Total",499,76,25,51,423,114,23,82,67,28,48,61
"2011","Wolverhampton 004B","E01010457","Total",660,192,108,84,468,24,93,105,108,14,41,83
"2011","Wolverhampton 004C","E01010462","Total",639,200,81,119,439,76,74,74,67,16,51,81
"2011","Wolverhampton 004D","E01010481","Total",539,107,45,62,432,78,58,56,59,36,50,95
"2011","Wolverhampton 005A","E01010555","Total",725,278,131,147,447,60,91,76,112,12,16,80
"2011","Wolverhampton 005B","E01010556","Total",607,160,69,91,447,32,90,89,96,15,45,80
"2011","Wolverhampton 005C","E01010557","Total",607,131,91,40,476,16,147,65,103,4,41,100
"2011","Wolverhampton 005D","E01010559","Total",670,241,115,126,429,30,127,80,94,3,30,65
"2011","Wolverhampton 005E","E01010560","Total",775,291,144,147,484,43,132,80,96,14,42,77
"2011","Wolverhampton 006A","E01010435","Total",548,165,57,108,383,75,40,83,60,15,36,74
"2011","Wolverhampton 006B","E01010501","Total",604,181,85,96,423,40,73,85,89,21,39,76
"2011","Wolverhampton 006C","E01010502","Total",512,130,59,71,382,18,65,71,81,16,47,84
"2011","Wolverhampton 006D","E01010503","Total",606,253,92,161,353,37,38,62,105,11,38,62
"2011","Wolverhampton 007A","E01010482","Total",503,117,58,59,386,55,68,53,65,32,39,74
"2011","Wolverhampton 007B","E01010483","Total",496,91,34,57,405,74,44,79,65,29,52,62
"2011","Wolverhampton 007C","E01010484","Total",506,115,51,64,391,57,34,70,74,29,43,84
"2011","Wolverhampton 007D","E01010485","Total",624,155,42,113,469,95,39,124,71,19,46,75
"2011","Wolverhampton 008A","E01010458","Total",785,305,169,136,480,44,73,94,114,20,34,101
"2011","Wolverhampton 008B","E01010459","Total",624,146,68,78,478,27,84,90,102,18,32,125
"2011","Wolverhampton 008C","E01010460","Total",641,169,81,88,472,22,90,92,96,11,63,98
"2011","Wolverhampton 008D","E01010461","Total",616,156,80,76,460,17,101,82,94,15,51,100
"2011","Wolverhampton 008E","E01010566","Total",743,238,146,92,505,39,105,91,105,21,64,80
"2011","Wolverhampton 009A","E01010539","Total",657,177,60,117,480,59,68,93,119,14,39,88
"2011","Wolverhampton 009B","E01010540","Total",618,210,106,104,408,11,132,68,85,10,27,75
"2011","Wolverhampton 009C","E01010542","Total",627,174,68,106,453,25,67,103,113,24,32,89
"2011","Wolverhampton 009D","E01010544","Total",609,163,106,57,446,15,128,70,87,9,50,87
"2011","Wolverhampton 009E","E01010545","Total",659,150,62,88,509,33,92,125,106,19,39,95
"2011","Wolverhampton 010A","E01010554","Total",630,200,119,81,430,14,134,69,94,7,34,78
"2011","Wolverhampton 010B","E01010558","Total",702,203,138,65,499,18,143,79,107,16,42,94
"2011","Wolverhampton 010C","E01010562","Total",740,285,104,181,455,43,121,74,107,9,34,67
"2011","Wolverhampton 010D","E01010563","Total",702,264,87,177,438,75,84,73,103,12,29,62
"2011","Wolverhampton 010E","E01010567","Total",663,226,107,119,437,43,73,77,103,12,35,94
"2011","Wolverhampton 011A","E01010478","Total",518,156,33,123,362,59,24,81,62,26,42,68
"2011","Wolverhampton 011B","E01010479","Total",576,137,70,67,439,44,59,76,79,11,66,104
"2011","Wolverhampton 011C","E01010480","Total",486,120,36,84,366,41,32,89,87,23,30,64
"2011","Wolverhampton 011D","E01010486","Total",635,144,48,96,491,107,30,102,85,44,52,71
"2011","Wolverhampton 012A","E01010474","Total",613,174,93,81,439,47,66,85,83,15,58,85
"2011","Wolverhampton 012B","E01010561","Total",620,132,87,45,488,16,119,82,104,16,49,102
"2011","Wolverhampton 012C","E01010564","Total",782,247,60,187,535,67,43,99,126,21,64,115
"2011","Wolverhampton 012D","E01010565","Total",747,183,93,90,564,28,117,93,141,12,59,114
"2011","Wolverhampton 013A","E01010522","Total",661,199,28,171,462,71,29,86,108,36,58,74
"2011","Wolverhampton 013B","E01010523","Total",611,175,63,112,436,37,42,81,101,19,52,104
"2011","Wolverhampton 013C","E01010524","Total",632,244,85,159,388,63,51,66,62,21,56,69
"2011","Wolverhampton 013D","E01010525","Total",522,129,31,98,393,60,33,87,74,26,43,70
"2011","Wolverhampton 014A","E01010546","Total",526,101,71,30,425,4,130,57,77,14,52,91
"2011","Wolverhampton 014B","E01010547","Total",744,291,176,115,453,22,146,62,131,6,17,69
"2011","Wolverhampton 014C","E01010548","Total",734,314,225,89,420,28,147,64,91,7,19,64
"2011","Wolverhampton 014D","E01010549","Total",616,156,93,63,460,22,103,95,95,6,48,91
"2011","Wolverhampton 014E","E01010553","Total",655,175,107,68,480,22,145,76,99,16,41,81
"2011","Wolverhampton 015A","E01010471","Total",858,434,109,325,424,79,46,99,89,10,42,59
"2011","Wolverhampton 015B","E01010472","Total",781,238,62,176,543,90,53,116,114,14,57,99
"2011","Wolverhampton 015C","E01010473","Total",1193,610,116,494,583,133,36,111,130,42,62,69
"2011","Wolverhampton 015D","E01010475","Total",654,202,81,121,452,44,72,64,98,18,53,103
"2011","Wolverhampton 015E","E01010476","Total",872,362,69,293,510,77,56,106,146,19,34,72
"2011","Wolverhampton 015F","E01010477","Total",701,211,59,152,490,82,53,95,104,17,47,92
"2011","Wolverhampton 016A","E01010526","Total",486,119,20,99,367,44,22,61,63,39,57,81
"2011","Wolverhampton 016B","E01010527","Total",769,311,78,233,458,54,41,91,80,29,57,106
"2011","Wolverhampton 016C","E01010528","Total",503,269,72,197,234,18,22,31,59,14,18,72
"2011","Wolverhampton 016D","E01010529","Total",603,201,45,156,402,29,29,40,74,20,42,168
"2011","Wolverhampton 017A","E01010506","Total",888,496,56,440,392,40,29,43,153,11,33,83
"2011","Wolverhampton 017B","E01010508","Total",708,383,51,332,325,27,26,40,131,5,29,67
"2011","Wolverhampton 017C","E01010510","Total",779,358,73,285,421,31,57,64,152,12,29,76
"2011","Wolverhampton 017D","E01010511","Total",604,175,42,133,429,38,59,67,90,23,49,103
"2011","Wolverhampton 017E","E01010512","Total",632,285,57,228,347,27,52,62,86,13,32,75
"2011","Wolverhampton 018A","E01010442","Total",512,150,52,98,362,50,66,54,64,11,40,77
"2011","Wolverhampton 018B","E01010443","Total",659,200,65,135,459,80,57,88,74,38,41,81
"2011","Wolverhampton 018C","E01010444","Total",594,218,82,136,376,22,97,37,82,14,34,90
"2011","Wolverhampton 018D","E01010445","Total",502,133,30,103,369,61,40,62,60,19,51,76
"2011","Wolverhampton 018E","E01010447","Total",863,374,145,229,489,41,81,87,130,21,45,84
"2011","Wolverhampton 018F","E01010448","Total",709,272,113,159,437,40,84,73,109,15,30,86
"2011","Wolverhampton 019A","E01010509","Total",742,325,159,166,417,37,91,84,109,6,28,62
"2011","Wolverhampton 019B","E01010550","Total",641,140,96,44,501,5,161,67,112,19,44,93
"2011","Wolverhampton 019C","E01010551","Total",785,285,130,155,500,22,146,69,144,11,22,86
"2011","Wolverhampton 019D","E01010552","Total",809,246,144,102,563,45,129,101,129,14,39,106
"2011","Wolverhampton 020A","E01010463","Total",728,322,55,267,406,47,36,63,109,21,51,79
"2011","Wolverhampton 020B","E01010464","Total",844,505,176,329,339,57,55,45,92,9,32,49
"2011","Wolverhampton 020C","E01010465","Total",600,172,44,128,428,51,52,79,83,25,55,83
"2011","Wolverhampton 020D","E01010466","Total",558,187,55,132,371,46,22,76,69,13,62,83
"2011","Wolverhampton 020E","E01010470","Total",624,284,81,203,340,34,51,60,64,19,48,64
"2011","Wolverhampton 020F","E01010521","Total",1068,562,68,494,506,80,27,74,231,11,18,65
"2011","Wolverhampton 021A","E01010487","Total",611,154,80,74,457,18,84,117,95,21,26,96
"2011","Wolverhampton 021B","E01010488","Total",631,220,130,90,411,19,105,74,83,11,30,89
"2011","Wolverhampton 021C","E01010493","Total",623,166,70,96,457,30,90,95,98,24,40,80
"2011","Wolverhampton 021D","E01010504","Total",517,159,89,70,358,7,105,45,74,7,35,85
"2011","Wolverhampton 021E","E01010505","Total",511,134,49,85,377,14,92,64,78,12,28,89
"2011","Wolverhampton 021F","E01010507","Total",638,216,129,87,422,12,131,54,99,11,33,82
"2011","Wolverhampton 022A","E01010418","Total",580,124,54,70,456,17,72,84,111,17,48,107
"2011","Wolverhampton 022B","E01010421","Total",605,160,77,83,445,49,72,75,83,23,61,82
"2011","Wolverhampton 022C","E01010423","Total",660,245,121,124,415,62,57,62,78,9,59,88
"2011","Wolverhampton 022D","E01010424","Total",616,141,71,70,475,22,92,79,107,18,55,102
"2011","Wolverhampton 023A","E01010417","Total",729,260,108,152,469,58,100,77,82,23,45,84
"2011","Wolverhampton 023B","E01010419","Total",576,162,82,80,414,40,72,64,93,19,40,86
"2011","Wolverhampton 023C","E01010420","Total",515,147,69,78,368,45,65,51,72,20,44,71
"2011","Wolverhampton 023D","E01010425","Total",530,136,71,65,394,28,67,62,84,18,45,90
"2011","Wolverhampton 023E","E01010446","Total",709,253,103,150,456,33,87,62,104,19,46,105
"2011","Wolverhampton 026A","E01010467","Total",628,223,71,152,405,25,69,54,94,16,43,104
"2011","Wolverhampton 026B","E01010468","Total",591,167,89,78,424,17,79,79,90,19,46,94
"2011","Wolverhampton 026C","E01010469","Total",598,180,60,120,418,26,62,75,116,12,38,89
"2011","Wolverhampton 026D","E01010516","Total",529,112,56,56,417,16,77,81,76,18,48,101
"2011","Wolverhampton 026E","E01010518","Total",629,182,121,61,447,16,93,70,87,16,52,113
"2011","Wolverhampton 027A","E01010414","Total",960,429,170,259,531,90,72,97,140,16,35,81
"2011","Wolverhampton 027B","E01010415","Total",596,107,44,63,489,86,47,94,80,33,55,94
"2011","Wolverhampton 027C","E01010416","Total",702,228,108,120,474,74,90,67,97,23,44,79
"2011","Wolverhampton 027D","E01010422","Total",643,194,94,100,449,21,88,62,86,20,47,125
"2011","Wolverhampton 028A","E01010489","Total",659,209,100,109,450,32,109,69,100,11,44,85
"2011","Wolverhampton 028B","E01010490","Total",941,491,174,317,450,102,61,85,117,9,18,58
"2011","Wolverhampton 028C","E01010491","Total",627,194,107,87,433,40,85,93,76,23,32,84
"2011","Wolverhampton 028D","E01010492","Total",510,95,49,46,415,13,65,80,105,15,36,101
"2011","Wolverhampton 028E","E01010494","Total",601,126,84,42,475,15,104,103,100,20,45,88
"2011","Wolverhampton 029A","E01010449","Total",921,267,67,200,654,120,58,123,144,16,79,114
"2011","Wolverhampton 029B","E01010450","Total",760,318,92,226,442,75,59,68,100,22,38,80
"2011","Wolverhampton 029C","E01010451","Total",594,170,43,127,424,35,42,81,88,14,58,106
"2011","Wolverhampton 029D","E01010452","Total",700,240,81,159,460,75,67,97,102,16,31,72
"2011","Wolverhampton 029E","E01010455","Total",846,363,120,243,483,106,59,74,84,25,46,89
"2011","Wolverhampton 030A","E01010427","Total",535,115,60,55,420,21,66,61,68,16,71,117
"2011","Wolverhampton 030B","E01010431","Total",477,76,49,27,401,11,61,51,41,9,91,137
"2011","Wolverhampton 030C","E01010432","Total",507,114,52,62,393,9,72,51,33,12,74,142
"2011","Wolverhampton 030D","E01010519","Total",539,124,36,88,415,14,61,75,90,10,62,103
"2011","Wolverhampton 030E","E01010520","Total",664,180,105,75,484,21,119,73,101,10,48,112
"2011","Wolverhampton 031A","E01010513","Total",638,204,150,54,434,13,140,69,93,9,40,70
"2011","Wolverhampton 031B","E01010514","Total",651,158,65,93,493,22,84,117,139,17,42,72
"2011","Wolverhampton 031C","E01010515","Total",669,180,90,90,489,22,94,102,118,18,39,96
"2011","Wolverhampton 031D","E01010517","Total",622,171,73,98,451,32,78,87,90,11,54,99
"2011","Wolverhampton 032A","E01010533","Total",729,259,95,164,470,82,61,79,95,22,56,75
"2011","Wolverhampton 032B","E01010535","Total",641,210,90,120,431,68,82,75,62,19,46,79
"2011","Wolverhampton 032C","E01010536","Total",639,129,93,36,510,19,143,69,98,15,46,120
"2011","Wolverhampton 032D","E01010537","Total",657,193,111,82,464,10,156,76,106,8,28,80
"2011","Wolverhampton 033A","E01010410","Total",793,317,112,205,476,76,81,71,129,20,35,64
"2011","Wolverhampton 033B","E01010411","Total",633,168,78,90,465,50,69,86,93,24,56,87
"2011","Wolverhampton 033C","E01010412","Total",826,241,83,158,585,61,82,111,153,30,57,91
"2011","Wolverhampton 033D","E01010413","Total",727,229,124,105,498,65,106,92,110,24,34,67
"2011","Wolverhampton 034A","E01010531","Total",744,250,141,109,494,55,108,72,97,22,57,83
"2011","Wolverhampton 034B","E01010532","Total",673,228,89,139,445,50,70,92,101,10,43,79
"2011","Wolverhampton 034C","E01010534","Total",475,66,27,39,409,12,38,74,59,18,89,119
"2011","Wolverhampton 034D","E01010538","Total",623,138,75,63,485,38,82,90,108,20,50,97
"2011","Wolverhampton 035A","E01010426","Total",530,182,67,115,348,14,63,47,65,12,55,92
"2011","Wolverhampton 035B","E01010428","Total",508,138,44,94,370,34,34,71,64,19,55,93
"2011","Wolverhampton 035C","E01010429","Total",453,115,38,77,338,23,53,41,63,20,63,75
"2011","Wolverhampton 035D","E01010430","Total",669,228,54,174,441,46,61,79,71,27,55,102
"2011","Wolverhampton 035E","E01010433","Total",430,153,81,72,277,24,45,54,37,17,30,70
"2011","Wolverhampton 035F","E01010453","Total",726,177,94,83,549,101,66,117,88,28,54,95
"2011","Wolverhampton 035G","E01010454","Total",623,184,75,109,439,63,50,75,82,23,55,91
"2011","Wolverhampton 035H","E01010530","Total",532,157,41,116,375,54,43,70,67,20,32,89
"2011","Bromsgrove 001A","E01032138","Total",549,116,84,32,433,10,137,94,79,19,22,72
"2011","Bromsgrove 001B","E01032139","Total",662,169,110,59,493,30,115,134,85,23,39,67
"2011","Bromsgrove 001C","E01032140","Total",705,200,119,81,505,34,139,99,88,33,39,73
"2011","Bromsgrove 001D","E01032141","Total",588,152,78,74,436,10,114,91,86,15,41,79
"2011","Bromsgrove 002A","E01032136","Total",506,128,61,67,378,3,84,83,95,12,27,74
"2011","Bromsgrove 002B","E01032137","Total",650,208,110,98,442,21,111,97,98,18,30,67
"2011","Bromsgrove 002C","E01032168","Total",477,141,79,62,336,16,91,70,69,7,19,64
"2011","Bromsgrove 002D","E01032169","Total",494,154,69,85,340,9,101,55,94,6,21,54
"2011","Bromsgrove 002E","E01032176","Total",903,204,107,97,699,17,173,109,208,18,40,134
"2011","Bromsgrove 003A","E01032126","Total",856,195,125,70,661,24,193,108,146,15,49,126
"2011","Bromsgrove 003B","E01032170","Total",556,112,33,79,444,30,71,96,104,13,41,89
"2011","Bromsgrove 003C","E01032171","Total",624,148,109,39,476,9,157,79,82,12,34,103
"2011","Bromsgrove 003D","E01032172","Total",638,178,76,102,460,33,95,79,122,9,35,87
"2011","Bromsgrove 004A","E01032133","Total",740,234,137,97,506,48,133,98,103,16,24,84
"2011","Bromsgrove 004B","E01032135","Total",638,112,41,71,526,20,109,99,135,13,48,102
"2011","Bromsgrove 004C","E01032145","Total",626,157,97,60,469,11,143,85,116,11,22,81
"2011","Bromsgrove 004D","E01032147","Total",565,177,142,35,388,12,150,46,85,6,22,67
"2011","Bromsgrove 005A","E01032134","Total",626,175,100,75,451,14,110,70,122,6,35,94
"2011","Bromsgrove 005B","E01032146","Total",670,138,84,54,532,13,155,78,121,20,38,107
"2011","Bromsgrove 005C","E01032177","Total",469,115,58,57,354,10,84,64,95,12,25,64
"2011","Bromsgrove 005D","E01032178","Total",543,118,75,43,425,8,160,68,79,6,26,78
"2011","Bromsgrove 006A","E01032142","Total",607,111,70,41,496,12,110,114,125,9,30,96
"2011","Bromsgrove 006B","E01032143","Total",534,98,55,43,436,9,121,79,103,11,24,89
"2011","Bromsgrove 006C","E01032144","Total",764,224,135,89,540,24,156,101,108,27,40,84
"2011","Bromsgrove 006D","E01032149","Total",478,82,37,45,396,8,86,84,99,15,32,72
"2011","Bromsgrove 007A","E01032127","Total",686,192,96,96,494,18,94,118,138,13,21,92
"2011","Bromsgrove 007B","E01032128","Total",616,159,64,95,457,40,85,79,137,10,31,75
"2011","Bromsgrove 007C","E01032129","Total",522,99,52,47,423,40,68,84,87,20,45,79
"2011","Bromsgrove 007D","E01032152","Total",603,197,105,92,406,47,90,75,102,10,26,56
"2011","Bromsgrove 008A","E01032148","Total",437,112,50,62,325,3,82,63,78,13,32,54
"2011","Bromsgrove 008B","E01032150","Total",621,130,65,65,491,11,138,91,125,11,29,86
"2011","Bromsgrove 008C","E01032151","Total",573,138,78,60,435,7,100,90,123,6,28,81
"2011","Bromsgrove 008D","E01032153","Total",609,154,77,77,455,25,91,90,138,15,23,73
"2011","Bromsgrove 008E","E01032155","Total",651,107,47,60,544,25,109,148,120,17,39,86
"2011","Bromsgrove 009A","E01032122","Total",771,174,87,87,597,15,125,121,155,20,43,118
"2011","Bromsgrove 009B","E01032123","Total",657,169,103,66,488,6,176,56,120,10,38,82
"2011","Bromsgrove 009C","E01032124","Total",674,215,114,101,459,38,94,90,134,15,28,60
"2011","Bromsgrove 009D","E01032125","Total",615,156,107,49,459,21,112,90,116,18,22,80
"2011","Bromsgrove 010A","E01032154","Total",663,114,25,89,549,29,49,155,162,20,41,93
"2011","Bromsgrove 010B","E01032159","Total",774,258,146,112,516,18,124,82,148,16,37,91
"2011","Bromsgrove 010C","E01032160","Total",762,234,110,124,528,25,121,92,157,11,23,99
"2011","Bromsgrove 010D","E01032161","Total",620,197,88,109,423,45,79,82,97,12,37,71
"2011","Bromsgrove 011A","E01032156","Total",722,325,94,231,397,45,72,64,149,6,13,48
"2011","Bromsgrove 011B","E01032157","Total",1033,619,397,222,414,39,122,57,138,9,14,35
"2011","Bromsgrove 011C","E01032173","Total",648,125,54,71,523,28,98,97,136,18,50,96
"2011","Bromsgrove 011D","E01032175","Total",659,143,89,54,516,18,106,85,151,10,43,103
"2011","Bromsgrove 012A","E01032158","Total",651,155,101,54,496,9,163,72,137,9,22,84
"2011","Bromsgrove 012B","E01032162","Total",752,140,91,49,612,33,162,137,128,26,30,96
"2011","Bromsgrove 012D","E01033059","Total",582,107,17,90,475,32,33,165,130,25,38,52
"2011","Bromsgrove 012E","E01033061","Total",653,81,38,43,572,20,79,185,129,30,48,81
"2011","Bromsgrove 013A","E01032130","Total",1148,322,89,233,826,85,87,210,277,30,49,88
"2011","Bromsgrove 013B","E01032131","Total",664,176,57,119,488,71,49,94,105,36,39,94
"2011","Bromsgrove 013C","E01032132","Total",960,347,196,151,613,74,121,112,125,25,52,104
"2011","Bromsgrove 013D","E01032174","Total",646,160,59,101,486,44,90,111,120,14,26,81
"2011","Bromsgrove 014C","E01032166","Total",955,304,131,173,651,27,169,112,185,19,27,112
"2011","Bromsgrove 014E","E01033060","Total",439,89,36,53,350,8,77,65,99,9,25,67
"2011","Bromsgrove 014F","E01033062","Total",914,147,50,97,767,33,124,144,219,15,67,165
"2011","Bromsgrove 014G","E01033243","Total",542,150,49,101,392,12,72,72,134,10,22,70
"2011","Malvern Hills 001A","E01032193","Total",912,195,108,87,717,24,183,95,225,28,43,119
"2011","Malvern Hills 001B","E01032212","Total",812,198,95,103,614,26,167,111,154,24,31,101
"2011","Malvern Hills 001C","E01032213","Total",660,156,90,66,504,10,172,61,138,10,32,81
"2011","Malvern Hills 001D","E01032214","Total",1018,374,224,150,644,47,174,115,161,25,32,90
"2011","Malvern Hills 002A","E01032181","Total",891,233,119,114,658,21,198,94,191,21,36,97
"2011","Malvern Hills 002B","E01032190","Total",783,208,121,87,575,20,159,106,129,19,38,104
"2011","Malvern Hills 002C","E01032199","Total",737,190,114,76,547,21,137,91,151,27,43,77
"2011","Malvern Hills 002D","E01032223","Total",824,160,109,51,664,20,185,110,179,23,50,97
"2011","Malvern Hills 003A","E01032179","Total",704,162,81,81,542,19,148,93,148,12,34,88
"2011","Malvern Hills 003B","E01032180","Total",767,163,80,83,604,12,169,97,178,11,44,93
"2011","Malvern Hills 003C","E01032182","Total",801,172,108,64,629,10,172,108,156,21,43,119
"2011","Malvern Hills 003D","E01032183","Total",570,109,69,40,461,19,134,91,104,10,30,73
"2011","Malvern Hills 004A","E01032194","Total",665,236,115,121,429,41,94,74,108,6,23,83
"2011","Malvern Hills 004B","E01032195","Total",752,258,142,116,494,29,129,93,132,15,29,67
"2011","Malvern Hills 004C","E01032196","Total",750,280,134,146,470,26,135,60,130,13,28,78
"2011","Malvern Hills 004D","E01032197","Total",714,288,141,147,426,29,101,70,114,12,32,68
"2011","Malvern Hills 005A","E01032205","Total",471,139,101,38,332,12,96,52,82,11,17,62
"2011","Malvern Hills 005B","E01032206","Total",556,168,107,61,388,11,138,59,100,6,19,55
"2011","Malvern Hills 005C","E01032207","Total",622,153,86,67,469,21,130,86,125,17,23,67
"2011","Malvern Hills 005D","E01032217","Total",644,177,94,83,467,18,153,58,106,28,26,78
"2011","Malvern Hills 006A","E01032188","Total",799,217,102,115,582,47,113,125,129,28,53,87
"2011","Malvern Hills 006B","E01032189","Total",837,201,110,91,636,29,174,108,158,28,35,104
"2011","Malvern Hills 006C","E01032220","Total",668,234,76,158,434,20,79,69,136,22,29,79
"2011","Malvern Hills 006D","E01032221","Total",548,159,55,104,389,13,93,66,128,4,22,63
"2011","Malvern Hills 006E","E01032222","Total",603,192,72,120,411,40,59,90,115,16,28,63
"2011","Malvern Hills 007A","E01032201","Total",648,172,91,81,476,50,108,99,95,22,39,63
"2011","Malvern Hills 007B","E01032202","Total",739,249,117,132,490,60,94,109,92,22,41,72
"2011","Malvern Hills 007C","E01032203","Total",698,267,121,146,431,20,99,82,116,17,28,69
"2011","Malvern Hills 007D","E01032204","Total",655,209,86,123,446,80,50,104,84,32,35,61
"2011","Malvern Hills 008A","E01032191","Total",946,189,118,71,757,20,203,114,208,24,42,146
"2011","Malvern Hills 008B","E01032192","Total",688,190,121,69,498,31,134,72,132,21,28,80
"2011","Malvern Hills 008C","E01032211","Total",792,203,127,76,589,13,214,75,168,13,28,78
"2011","Malvern Hills 009A","E01032184","Total",799,326,218,108,473,17,198,49,107,10,26,66
"2011","Malvern Hills 009B","E01032185","Total",620,140,91,49,480,12,195,61,96,14,34,68
"2011","Malvern Hills 009C","E01032186","Total",526,187,99,88,339,21,73,70,95,16,20,44
"2011","Malvern Hills 009D","E01032187","Total",785,300,154,146,485,48,102,99,128,12,35,61
"2011","Malvern Hills 010A","E01032208","Total",737,321,136,185,416,18,133,53,139,6,19,48
"2011","Malvern Hills 010B","E01032209","Total",571,280,118,162,291,8,90,35,108,10,7,33
"2011","Malvern Hills 010C","E01032210","Total",498,163,87,76,335,21,99,44,94,11,23,43
"2011","Malvern Hills 010D","E01032218","Total",654,179,79,100,475,19,125,77,137,14,25,78
"2011","Malvern Hills 010E","E01032219","Total",769,245,112,133,524,15,137,87,180,13,22,70
"2011","Malvern Hills 011A","E01032198","Total",821,193,110,83,628,12,173,94,176,18,47,108
"2011","Malvern Hills 011B","E01032200","Total",833,196,108,88,637,17,185,102,148,24,41,120
"2011","Malvern Hills 011C","E01032215","Total",556,220,124,96,336,21,103,53,83,9,17,50
"2011","Malvern Hills 011D","E01032216","Total",769,304,136,168,465,35,121,83,145,7,17,57
"2011","Redditch 001A","E01032226","Total",814,156,65,91,658,43,126,125,216,26,31,91
"2011","Redditch 001B","E01032227","Total",467,91,63,28,376,0,119,48,123,4,17,65
"2011","Redditch 001C","E01032243","Total",579,116,59,57,463,9,85,65,156,10,23,115
"2011","Redditch 001D","E01032244","Total",541,149,65,84,392,22,70,72,131,9,33,55
"2011","Redditch 002A","E01032240","Total",554,161,34,127,393,40,42,86,108,17,28,72
"2011","Redditch 002B","E01032241","Total",503,103,27,76,400,49,30,71,96,31,46,77
"2011","Redditch 002C","E01032242","Total",590,160,38,122,430,48,45,80,152,19,23,63
"2011","Redditch 002D","E01032245","Total",665,286,83,203,379,47,39,60,130,17,29,57
"2011","Redditch 003A","E01032232","Total",781,326,106,220,455,85,42,78,125,16,39,70
"2011","Redditch 003B","E01032233","Total",1171,216,26,190,955,58,75,296,349,38,61,78
"2011","Redditch 003C","E01032234","Total",734,234,80,154,500,76,72,80,146,23,42,61
"2011","Redditch 003D","E01032235","Total",755,213,100,113,542,89,102,108,99,21,44,79
"2011","Redditch 004A","E01032224","Total",689,224,47,177,465,44,38,78,128,28,66,83
"2011","Redditch 004B","E01032225","Total",503,161,73,88,342,54,52,68,85,12,27,44
"2011","Redditch 004C","E01032239","Total",690,217,81,136,473,53,22,89,121,22,64,102
"2011","Redditch 004D","E01032262","Total",860,262,87,175,598,62,64,132,158,32,59,91
"2011","Redditch 005A","E01032273","Total",565,116,55,61,449,13,69,68,163,14,29,93
"2011","Redditch 005B","E01032275","Total",606,169,56,113,437,30,70,85,160,11,21,60
"2011","Redditch 005C","E01032277","Total",514,129,31,98,385,30,35,76,107,18,33,86
"2011","Redditch 005D","E01032278","Total",726,261,48,213,465,85,37,111,122,10,33,67
"2011","Redditch 006A","E01032236","Total",807,322,99,223,485,42,67,83,158,18,46,71
"2011","Redditch 006B","E01032237","Total",635,181,54,127,454,17,79,74,146,16,36,86
"2011","Redditch 006C","E01032238","Total",511,113,41,72,398,17,72,60,98,10,45,96
"2011","Redditch 006D","E01032264","Total",641,118,46,72,523,40,74,104,126,30,61,88
"2011","Redditch 007A","E01032255","Total",557,125,83,42,432,21,96,90,103,14,41,67
"2011","Redditch 007B","E01032263","Total",725,166,89,77,559,30,128,72,157,30,40,102
"2011","Redditch 007C","E01032266","Total",675,161,51,110,514,32,96,87,171,8,25,95
"2011","Redditch 007D","E01032274","Total",518,102,40,62,416,16,70,83,120,13,23,91
"2011","Redditch 008A","E01032259","Total",621,196,122,74,425,28,85,79,117,11,28,77
"2011","Redditch 008B","E01032269","Total",758,262,129,133,496,21,104,97,151,13,22,88
"2011","Redditch 008C","E01032270","Total",525,115,44,71,410,12,92,92,99,9,36,70
"2011","Redditch 008D","E01032271","Total",522,98,34,64,424,10,76,95,120,7,36,80
"2011","Redditch 008E","E01032272","Total",535,158,76,82,377,8,89,72,102,14,24,68
"2011","Redditch 009A","E01032253","Total",476,70,29,41,406,16,79,67,114,17,42,71
"2011","Redditch 009B","E01032265","Total",643,202,84,118,441,43,76,96,88,22,48,68
"2011","Redditch 009C","E01032267","Total",637,131,53,78,506,51,56,94,138,30,47,90
"2011","Redditch 009D","E01032268","Total",480,76,35,41,404,16,74,71,119,8,25,91
"2011","Redditch 009E","E01032276","Total",595,122,40,82,473,23,69,96,152,16,21,96
"2011","Redditch 010A","E01032250","Total",514,111,29,82,403,51,43,79,97,32,33,68
"2011","Redditch 010B","E01032251","Total",702,154,33,121,548,66,44,113,178,20,41,86
"2011","Redditch 010C","E01032252","Total",569,185,60,125,384,67,37,67,77,29,41,66
"2011","Redditch 010D","E01032254","Total",606,129,79,50,477,30,94,89,101,21,53,89
"2011","Redditch 011A","E01032256","Total",644,181,81,100,463,41,84,91,115,13,29,90
"2011","Redditch 011B","E01032257","Total",573,98,38,60,475,32,75,90,143,17,37,81
"2011","Redditch 011C","E01032258","Total",705,245,112,133,460,28,105,89,140,9,18,71
"2011","Redditch 011D","E01032260","Total",675,290,118,172,385,66,63,66,100,9,25,56
"2011","Redditch 012A","E01032246","Total",558,116,52,64,442,19,106,83,103,14,30,87
"2011","Redditch 012B","E01032247","Total",637,198,99,99,439,36,80,81,143,13,25,61
"2011","Redditch 012C","E01032248","Total",543,79,32,47,464,11,63,115,130,15,36,94
"2011","Redditch 012D","E01032249","Total",686,214,48,166,472,35,60,102,155,19,28,73
"2011","Redditch 012E","E01032261","Total",583,130,87,43,453,15,132,75,100,16,29,86
"2011","Redditch 013A","E01032228","Total",566,140,52,88,426,9,90,88,128,13,29,69
"2011","Redditch 013B","E01032229","Total",634,178,56,122,456,44,63,89,130,19,18,93
"2011","Redditch 013C","E01032230","Total",596,137,77,60,459,17,85,95,131,15,33,83
"2011","Redditch 013D","E01032231","Total",763,229,108,121,534,42,133,84,148,18,26,83
"2011","Worcester 001A","E01032296","Total",724,258,91,167,466,28,78,100,159,8,27,66
"2011","Worcester 001B","E01032297","Total",663,157,97,60,506,15,96,108,155,23,31,78
"2011","Worcester 001C","E01032298","Total",777,201,147,54,576,10,172,111,154,14,30,85
"2011","Worcester 001D","E01032299","Total",675,199,72,127,476,25,97,99,138,14,25,78
"2011","Worcester 001E","E01032300","Total",655,151,96,55,504,12,141,106,119,16,21,89
"2011","Worcester 002A","E01032303","Total",478,123,57,66,355,51,67,74,69,19,21,54
"2011","Worcester 002B","E01032304","Total",627,211,101,110,416,75,75,76,68,18,34,70
"2011","Worcester 002C","E01032331","Total",663,250,74,176,413,49,85,73,112,12,18,64
"2011","Worcester 002D","E01032332","Total",611,302,75,227,309,69,30,66,84,5,14,41
"2011","Worcester 003A","E01032330","Total",602,248,68,180,354,26,44,73,130,15,11,55
"2011","Worcester 003B","E01032334","Total",1008,281,54,227,727,65,47,189,279,24,45,78
"2011","Worcester 003C","E01032335","Total",575,72,17,55,503,18,52,178,139,27,24,65
"2011","Worcester 003D","E01032336","Total",644,143,31,112,501,30,42,128,191,16,30,64
"2011","Worcester 004A","E01032279","Total",532,140,48,92,392,31,49,83,124,12,36,57
"2011","Worcester 004B","E01032312","Total",669,228,58,170,441,35,41,92,173,13,19,68
"2011","Worcester 004C","E01032327","Total",767,301,114,187,466,38,77,68,182,17,24,60
"2011","Worcester 004D","E01032328","Total",625,169,97,72,456,39,68,74,135,13,35,92
"2011","Worcester 004E","E01032329","Total",871,240,110,130,631,27,152,102,185,15,38,112
"2011","Worcester 005A","E01032301","Total",623,175,71,104,448,24,106,63,133,25,28,69
"2011","Worcester 005B","E01032302","Total",544,211,72,139,333,57,40,52,80,12,29,63
"2011","Worcester 005C","E01032310","Total",596,156,55,101,440,42,57,85,129,14,28,85
"2011","Worcester 005D","E01032311","Total",626,170,71,99,456,63,70,91,106,16,37,73
"2011","Worcester 005E","E01032313","Total",500,143,52,91,357,47,32,55,80,32,47,64
"2011","Worcester 005F","E01032333","Total",760,198,46,152,562,131,38,127,110,51,34,71
"2011","Worcester 006A","E01032314","Total",448,106,54,52,342,14,63,66,96,10,15,78
"2011","Worcester 006B","E01032315","Total",512,153,72,81,359,14,83,61,77,5,18,101
"2011","Worcester 006C","E01032316","Total",498,132,96,36,366,7,124,67,75,5,18,70
"2011","Worcester 006D","E01032317","Total",648,207,130,77,441,13,112,68,106,13,28,101
"2011","Worcester 007A","E01032280","Total",800,366,122,244,434,30,43,85,169,14,25,68
"2011","Worcester 007B","E01032281","Total",632,202,65,137,430,32,44,84,176,9,16,69
"2011","Worcester 007C","E01032282","Total",897,439,94,345,458,40,39,56,225,8,25,65
"2011","Worcester 007E","E01033246","Total",625,300,97,203,325,15,62,55,124,5,16,48
"2011","Worcester 007F","E01033247","Total",600,374,30,344,226,13,10,23,138,1,1,40
"2011","Worcester 008A","E01032337","Total",729,135,38,97,594,22,70,139,186,14,51,112
"2011","Worcester 008B","E01032338","Total",804,169,33,136,635,62,35,189,205,27,45,72
"2011","Worcester 008C","E01032339","Total",618,89,26,63,529,32,61,167,155,18,42,54
"2011","Worcester 009A","E01032318","Total",628,195,54,141,433,92,49,75,86,34,21,76
"2011","Worcester 009B","E01032319","Total",703,173,106,67,530,13,145,80,122,13,38,119
"2011","Worcester 009C","E01032320","Total",655,141,65,76,514,34,75,104,108,22,24,147
"2011","Worcester 009D","E01032321","Total",601,169,82,87,432,48,71,73,105,12,42,81
"2011","Worcester 009E","E01032322","Total",957,490,263,227,467,41,82,79,149,8,20,88
"2011","Worcester 010A","E01032305","Total",688,178,57,121,510,41,82,80,152,16,44,95
"2011","Worcester 010B","E01032306","Total",608,177,60,117,431,32,47,95,113,19,46,79
"2011","Worcester 010C","E01032307","Total",642,149,61,88,493,43,74,97,96,34,49,100
"2011","Worcester 010D","E01032309","Total",641,179,105,74,462,61,75,99,104,19,44,60
"2011","Worcester 011A","E01032285","Total",739,277,84,193,462,26,77,126,112,20,37,64
"2011","Worcester 011B","E01032292","Total",616,202,28,174,414,34,26,71,132,32,49,70
"2011","Worcester 011D","E01032294","Total",580,186,76,110,394,24,56,75,113,17,47,62
"2011","Worcester 011E","E01033248","Total",658,432,88,344,226,22,18,22,128,0,11,25
"2011","Worcester 011F","E01033249","Total",669,328,78,250,341,43,39,36,165,7,18,33
"2011","Worcester 012A","E01032286","Total",650,137,53,84,513,32,76,107,133,20,36,109
"2011","Worcester 012B","E01032287","Total",664,178,65,113,486,37,88,101,136,17,25,82
"2011","Worcester 012C","E01032288","Total",647,169,92,77,478,21,93,97,138,21,29,79
"2011","Worcester 012D","E01032289","Total",625,153,113,40,472,13,154,57,105,14,26,103
"2011","Worcester 012E","E01032290","Total",666,175,109,66,491,33,145,93,109,6,24,81
"2011","Worcester 013A","E01032283","Total",694,202,111,91,492,41,100,77,148,24,32,70
"2011","Worcester 013B","E01032284","Total",826,219,117,102,607,14,164,113,171,15,42,88
"2011","Worcester 013C","E01032295","Total",1157,420,75,345,737,49,92,134,323,21,33,85
"2011","Worcester 013D","E01032308","Total",620,143,72,71,477,29,94,90,140,9,39,76
"2011","Worcester 014A","E01032323","Total",606,123,68,55,483,28,100,109,134,9,40,63
"2011","Worcester 014B","E01032324","Total",613,204,51,153,409,20,45,108,153,12,29,42
"2011","Worcester 014C","E01032325","Total",659,177,34,143,482,41,39,145,151,15,32,59
"2011","Worcester 014D","E01032326","Total",604,160,78,82,444,33,98,88,112,6,37,70
"2011","Wychavon 001A","E01032354","Total",987,233,123,110,754,36,172,162,188,21,44,131
"2011","Wychavon 001B","E01032386","Total",533,99,52,47,434,13,112,66,121,10,41,71
"2011","Wychavon 001C","E01032387","Total",598,158,76,82,440,24,107,78,122,11,29,69
"2011","Wychavon 001D","E01032401","Total",647,144,94,50,503,11,168,72,139,15,31,67
"2011","Wychavon 002A","E01032368","Total",505,154,61,93,351,37,63,64,76,14,34,63
"2011","Wychavon 002B","E01032369","Total",601,140,52,88,461,66,49,111,113,23,36,63
"2011","Wychavon 002C","E01032370","Total",498,98,39,59,400,18,72,95,108,15,30,62
"2011","Wychavon 002D","E01032371","Total",581,175,114,61,406,25,62,78,133,12,33,63
"2011","Wychavon 003A","E01032359","Total",1034,581,332,249,453,36,138,58,146,6,16,53
"2011","Wychavon 003B","E01032360","Total",811,212,101,111,599,56,146,111,133,24,41,88
"2011","Wychavon 003C","E01032361","Total",742,188,71,117,554,17,153,98,159,14,24,89
"2011","Wychavon 004A","E01032357","Total",510,143,78,65,367,25,83,65,110,6,23,55
"2011","Wychavon 004B","E01032358","Total",650,225,87,138,425,29,93,74,102,12,35,80
"2011","Wychavon 004C","E01032365","Total",765,205,131,74,560,55,120,114,122,19,35,95
"2011","Wychavon 004D","E01032367","Total",636,201,131,70,435,17,124,86,99,10,33,66
"2011","Wychavon 005A","E01032362","Total",748,137,65,72,611,25,114,165,155,28,45,79
"2011","Wychavon 005B","E01032363","Total",606,108,52,56,498,10,124,86,124,11,30,113
"2011","Wychavon 005C","E01032364","Total",643,100,51,49,543,16,101,124,153,15,36,98
"2011","Wychavon 005D","E01032366","Total",733,232,114,118,501,30,153,87,123,9,25,74
"2011","Wychavon 006A","E01032399","Total",713,206,117,89,507,15,112,99,138,18,32,93
"2011","Wychavon 006B","E01032400","Total",879,151,80,71,728,31,172,167,182,28,34,114
"2011","Wychavon 006C","E01032404","Total",1003,226,136,90,777,14,213,130,215,21,46,138
"2011","Wychavon 007A","E01032345","Total",585,125,46,79,460,14,110,100,128,11,39,58
"2011","Wychavon 007B","E01032346","Total",539,90,40,50,449,18,112,97,125,12,26,59
"2011","Wychavon 007C","E01032395","Total",502,111,55,56,391,12,98,63,111,8,33,66
"2011","Wychavon 007D","E01032417","Total",617,127,79,48,490,8,144,90,123,15,30,80
"2011","Wychavon 008A","E01032392","Total",653,151,88,63,502,9,175,63,120,7,35,93
"2011","Wychavon 008B","E01032393","Total",639,133,84,49,506,13,157,93,113,13,29,88
"2011","Wychavon 008C","E01032394","Total",487,97,46,51,390,9,113,55,111,13,27,62
"2011","Wychavon 008D","E01032416","Total",433,68,38,30,365,7,108,62,93,9,25,61
"2011","Wychavon 009A","E01032355","Total",493,99,47,52,394,11,108,55,87,14,30,89
"2011","Wychavon 009B","E01032356","Total",459,97,55,42,362,17,76,79,99,12,20,59
"2011","Wychavon 009C","E01032402","Total",538,72,18,54,466,29,50,164,119,22,35,47
"2011","Wychavon 009D","E01032403","Total",595,143,65,78,452,23,92,92,135,12,27,71
"2011","Wychavon 010A","E01032375","Total",509,126,84,42,383,13,128,54,106,10,29,43
"2011","Wychavon 010B","E01032382","Total",532,128,66,62,404,16,107,63,110,14,23,71
"2011","Wychavon 010C","E01032383","Total",594,131,67,64,463,9,153,52,131,11,24,83
"2011","Wychavon 010D","E01032410","Total",570,98,62,36,472,7,149,77,130,8,28,73
"2011","Wychavon 010E","E01032411","Total",649,171,113,58,478,37,120,87,96,13,38,87
"2011","Wychavon 011A","E01032390","Total",538,103,47,56,435,19,105,84,114,12,33,68
"2011","Wychavon 011B","E01032391","Total",444,98,45,53,346,23,68,56,92,16,32,59
"2011","Wychavon 011C","E01032414","Total",647,167,103,64,480,13,137,86,123,16,31,74
"2011","Wychavon 011D","E01032415","Total",505,109,47,62,396,13,75,86,120,8,24,70
"2011","Wychavon 012A","E01032405","Total",600,156,91,65,444,23,148,68,118,10,20,57
"2011","Wychavon 012B","E01032406","Total",781,392,192,200,389,30,122,63,114,7,14,39
"2011","Wychavon 012C","E01032407","Total",618,196,116,80,422,11,107,59,105,14,34,92
"2011","Wychavon 012D","E01032408","Total",613,159,113,46,454,13,154,76,111,7,19,74
"2011","Wychavon 012E","E01032409","Total",673,219,122,97,454,25,100,74,128,18,33,76
"2011","Wychavon 013A","E01032340","Total",585,131,82,49,454,35,102,82,123,10,21,81
"2011","Wychavon 013B","E01032341","Total",522,92,54,38,430,10,110,62,121,11,30,86
"2011","Wychavon 013C","E01032349","Total",631,142,74,68,489,14,117,80,151,11,25,91
"2011","Wychavon 013D","E01032350","Total",465,125,66,59,340,16,78,54,112,12,19,49
"2011","Wychavon 013E","E01032388","Total",555,118,74,44,437,10,122,84,113,16,20,72
"2011","Wychavon 013F","E01032389","Total",535,138,72,66,397,24,112,72,94,13,25,57
"2011","Wychavon 014A","E01032343","Total",1139,442,135,307,697,69,92,137,251,12,38,98
"2011","Wychavon 014B","E01032377","Total",889,411,165,246,478,44,78,109,133,13,23,78
"2011","Wychavon 014C","E01032378","Total",748,243,136,107,505,40,77,105,146,17,38,82
"2011","Wychavon 015A","E01032376","Total",631,168,77,91,463,17,116,77,116,8,32,97
"2011","Wychavon 015B","E01032384","Total",546,155,69,86,391,22,68,70,104,18,32,77
"2011","Wychavon 015C","E01032385","Total",622,205,137,68,417,14,180,37,115,9,15,47
"2011","Wychavon 015D","E01032396","Total",623,105,31,74,518,27,73,159,129,15,42,73
"2011","Wychavon 016A","E01032342","Total",601,128,56,72,473,31,57,116,142,22,37,68
"2011","Wychavon 016B","E01032344","Total",606,124,73,51,482,15,139,80,134,11,42,61
"2011","Wychavon 016C","E01032379","Total",729,150,67,83,579,30,84,134,147,11,46,127
"2011","Wychavon 016D","E01032380","Total",683,201,126,75,482,12,133,93,108,8,27,101
"2011","Wychavon 017A","E01032381","Total",798,220,93,127,578,48,91,108,155,18,45,113
"2011","Wychavon 017B","E01032397","Total",748,217,116,101,531,34,112,92,149,17,39,88
"2011","Wychavon 017C","E01032398","Total",664,131,31,100,533,37,38,145,155,18,48,92
"2011","Wychavon 018A","E01032351","Total",748,276,204,72,472,6,199,55,125,6,17,64
"2011","Wychavon 018B","E01032352","Total",653,157,92,65,496,12,150,79,140,9,27,79
"2011","Wychavon 018C","E01032353","Total",763,266,149,117,497,35,158,78,139,12,22,53
"2011","Wychavon 018D","E01032374","Total",532,117,66,51,415,9,109,71,104,16,31,75
"2011","Wychavon 019A","E01032347","Total",547,135,91,44,412,14,108,89,106,13,21,61
"2011","Wychavon 019B","E01032348","Total",513,107,69,38,406,10,115,78,119,14,19,51
"2011","Wychavon 019C","E01032372","Total",610,131,70,61,479,17,131,91,132,16,23,69
"2011","Wychavon 019D","E01032373","Total",533,113,59,54,420,7,142,60,101,6,24,80
"2011","Wychavon 019E","E01032412","Total",557,161,91,70,396,14,117,68,116,12,20,49
"2011","Wychavon 019F","E01032413","Total",454,95,53,42,359,14,119,54,90,10,23,49
"2011","Wyre Forest 001A","E01032431","Total",656,194,92,102,462,13,150,66,113,13,20,87
"2011","Wyre Forest 001B","E01032432","Total",556,157,72,85,399,13,117,65,104,8,23,69
"2011","Wyre Forest 001C","E01032433","Total",526,126,65,61,400,14,104,91,93,12,27,59
"2011","Wyre Forest 001D","E01032439","Total",599,160,103,57,439,14,120,76,126,14,26,63
"2011","Wyre Forest 001E","E01032440","Total",532,180,111,69,352,33,87,63,84,8,33,44
"2011","Wyre Forest 001F","E01032479","Total",935,266,171,95,669,22,216,102,170,11,36,112
"2011","Wyre Forest 002A","E01032441","Total",527,105,52,53,422,13,119,68,114,6,33,69
"2011","Wyre Forest 002B","E01032442","Total",596,122,45,77,474,31,79,102,136,19,24,83
"2011","Wyre Forest 002C","E01032443","Total",619,190,132,58,429,8,157,65,101,5,23,70
"2011","Wyre Forest 002D","E01032444","Total",511,132,54,78,379,26,84,75,103,8,18,65
"2011","Wyre Forest 002E","E01032445","Total",657,206,101,105,451,37,114,83,85,17,27,88
"2011","Wyre Forest 003A","E01032436","Total",660,186,94,92,474,21,107,83,123,12,33,95
"2011","Wyre Forest 003B","E01032438","Total",657,171,82,89,486,20,104,76,153,8,32,93
"2011","Wyre Forest 003C","E01032446","Total",615,182,94,88,433,21,108,76,110,19,26,73
"2011","Wyre Forest 003D","E01032447","Total",639,234,53,181,405,33,36,87,129,10,37,73
"2011","Wyre Forest 003E","E01032448","Total",476,90,49,41,386,15,90,78,80,17,27,79
"2011","Wyre Forest 004A","E01032434","Total",711,247,46,201,464,93,45,100,109,20,33,64
"2011","Wyre Forest 004B","E01032435","Total",649,241,89,152,408,42,65,67,123,13,43,55
"2011","Wyre Forest 004C","E01032437","Total",735,180,68,112,555,70,80,97,163,25,43,77
"2011","Wyre Forest 004D","E01032450","Total",1101,502,191,311,599,67,55,143,205,15,28,86
"2011","Wyre Forest 005A","E01032430","Total",731,191,107,84,540,17,141,91,161,12,30,88
"2011","Wyre Forest 005B","E01032480","Total",780,203,104,99,577,20,156,99,158,16,32,96
"2011","Wyre Forest 005C","E01032481","Total",796,287,132,155,509,31,141,68,144,9,39,77
"2011","Wyre Forest 005D","E01032482","Total",626,171,92,79,455,25,112,82,131,4,25,76
"2011","Wyre Forest 006A","E01032451","Total",658,161,97,64,497,7,143,74,132,12,33,96
"2011","Wyre Forest 006B","E01032452","Total",636,130,88,42,506,13,153,80,122,17,31,90
"2011","Wyre Forest 006C","E01032453","Total",755,291,172,119,464,41,77,98,109,22,34,83
"2011","Wyre Forest 006D","E01032454","Total",766,287,130,157,479,28,102,82,154,8,19,86
"2011","Wyre Forest 007A","E01032449","Total",721,240,55,185,481,51,46,114,166,5,30,69
"2011","Wyre Forest 007B","E01032464","Total",762,318,165,153,444,57,115,63,109,11,22,67
"2011","Wyre Forest 007C","E01032465","Total",613,183,95,88,430,62,66,90,84,29,29,70
"2011","Wyre Forest 007D","E01032466","Total",661,254,124,130,407,16,133,35,114,5,27,77
"2011","Wyre Forest 007E","E01032467","Total",523,138,64,74,385,11,124,43,117,11,21,58
"2011","Wyre Forest 007F","E01032468","Total",510,119,63,56,391,7,132,51,103,9,13,76
"2011","Wyre Forest 008A","E01032474","Total",832,319,54,265,513,80,54,109,187,11,18,54
"2011","Wyre Forest 008B","E01032475","Total",729,197,55,142,532,57,59,112,200,10,23,71
"2011","Wyre Forest 008C","E01032476","Total",624,203,101,102,421,28,96,83,103,18,24,69
"2011","Wyre Forest 008D","E01032477","Total",519,124,87,37,395,8,133,54,104,9,26,61
"2011","Wyre Forest 008E","E01032478","Total",643,193,99,94,450,52,78,85,103,13,45,74
"2011","Wyre Forest 009A","E01032469","Total",652,182,100,82,470,40,73,80,83,35,57,102
"2011","Wyre Forest 009B","E01032470","Total",784,259,136,123,525,40,107,90,128,28,45,87
"2011","Wyre Forest 009C","E01032471","Total",634,198,45,153,436,79,37,77,93,28,47,75
"2011","Wyre Forest 010A","E01032418","Total",604,189,56,133,415,22,80,70,134,6,23,80
"2011","Wyre Forest 010B","E01032419","Total",576,148,91,57,428,9,159,64,96,4,20,76
"2011","Wyre Forest 010C","E01032420","Total",511,106,34,72,405,22,60,76,129,10,31,77
"2011","Wyre Forest 010D","E01032421","Total",482,78,34,44,404,9,71,78,115,10,36,85
"2011","Wyre Forest 010E","E01032422","Total",644,199,29,170,445,94,11,116,143,8,22,51
"2011","Wyre Forest 011A","E01032427","Total",676,186,117,69,490,26,145,81,113,13,31,81
"2011","Wyre Forest 011B","E01032428","Total",880,366,137,229,514,27,158,51,187,11,26,54
"2011","Wyre Forest 011C","E01032429","Total",679,175,105,70,504,28,171,70,125,9,22,79
"2011","Wyre Forest 011D","E01032472","Total",500,100,49,51,400,7,132,49,95,8,25,84
"2011","Wyre Forest 011E","E01032473","Total",513,122,75,47,391,20,101,72,90,12,17,79
"2011","Wyre Forest 012A","E01032455","Total",631,148,93,55,483,21,145,61,113,20,39,84
"2011","Wyre Forest 012B","E01032456","Total",514,140,61,79,374,38,65,73,101,13,23,61
"2011","Wyre Forest 012C","E01032457","Total",530,145,86,59,385,26,83,93,83,14,26,60
"2011","Wyre Forest 012D","E01032458","Total",611,179,119,60,432,15,150,61,100,12,29,65
"2011","Wyre Forest 012E","E01032459","Total",608,158,87,71,450,28,117,76,102,16,32,79
"2011","Wyre Forest 013A","E01032460","Total",885,352,161,191,533,43,123,113,154,8,28,64
"2011","Wyre Forest 013B","E01032461","Total",926,349,63,286,577,43,87,117,184,11,37,98
"2011","Wyre Forest 013C","E01032462","Total",942,238,102,136,704,48,134,173,203,20,36,90
"2011","Wyre Forest 013D","E01032463","Total",744,217,141,76,527,16,169,84,134,9,26,89
"2011","Wyre Forest 014A","E01032423","Total",669,186,91,95,483,22,162,66,114,7,29,83
"2011","Wyre Forest 014B","E01032424","Total",638,218,93,125,420,65,73,69,94,22,25,72
"2011","Wyre Forest 014C","E01032425","Total",644,176,117,59,468,22,157,75,101,6,24,83
"2011","Wyre Forest 014D","E01032426","Total",666,196,104,92,470,20,142,79,127,7,23,72
"2011","Bedford 001A","E01017540","Total",591,120,71,49,471,17,114,75,122,15,40,88
"2011","Bedford 001B","E01017541","Total",520,109,52,57,411,19,101,68,119,20,31,53
"2011","Bedford 001C","E01017544","Total",577,134,80,54,443,25,116,76,104,17,33,72
"2011","Bedford 001D","E01017545","Total",587,116,53,63,471,32,91,98,125,19,43,63
"2011","Bedford 002A","E01017464","Total",620,142,80,62,478,16,146,85,118,18,29,66
"2011","Bedford 002B","E01017465","Total",616,153,89,64,463,19,144,84,115,14,14,73
"2011","Bedford 002C","E01017503","Total",507,122,64,58,385,25,79,83,88,15,29,66
"2011","Bedford 002D","E01017504","Total",833,264,113,151,569,36,125,141,118,31,45,73
"2011","Bedford 002E","E01017546","Total",505,125,79,46,380,23,71,66,112,16,29,63
"2011","Bedford 002F","E01017547","Total",633,153,81,72,480,16,102,68,134,12,48,100
"2011","Bedford 003A","E01017478","Total",718,189,97,92,529,34,117,102,120,14,31,111
"2011","Bedford 003B","E01017479","Total",624,260,143,117,364,13,114,59,90,16,22,50
"2011","Bedford 003C","E01017480","Total",746,171,66,105,575,59,71,165,135,25,47,73
"2011","Bedford 003D","E01017481","Total",485,113,42,71,372,33,81,84,77,14,27,56
"2011","Bedford 003E","E01017528","Total",948,175,100,75,773,40,149,186,165,46,48,139
"2011","Bedford 004B","E01017495","Total",829,188,84,104,641,40,123,152,180,22,37,87
"2011","Bedford 004C","E01017496","Total",642,157,96,61,485,22,124,83,144,8,23,81
"2011","Bedford 004D","E01017542","Total",589,150,69,81,439,20,98,80,127,5,36,73
"2011","Bedford 004E","E01017543","Total",590,123,42,81,467,18,100,77,145,19,29,79
"2011","Bedford 004F","E01033431","Total",482,55,13,42,427,69,26,127,106,30,31,38
"2011","Bedford 004G","E01033432","Total",925,218,132,86,707,56,171,118,183,28,47,104
"2011","Bedford 005A","E01017453","Total",623,254,99,155,369,32,79,75,94,10,21,58
"2011","Bedford 005B","E01017454","Total",588,112,74,38,476,30,108,74,116,16,36,96
"2011","Bedford 005C","E01017455","Total",651,205,98,107,446,20,117,82,99,7,30,91
"2011","Bedford 005D","E01017456","Total",634,173,126,47,461,12,158,69,91,10,29,92
"2011","Bedford 005E","E01017457","Total",487,125,63,62,362,24,72,85,87,11,24,59
"2011","Bedford 005F","E01017458","Total",514,122,43,79,392,33,69,76,97,15,35,67
"2011","Bedford 006A","E01017529","Total",509,107,66,41,402,17,86,76,95,13,25,90
"2011","Bedford 006B","E01017530","Total",578,110,75,35,468,13,137,72,111,14,22,99
"2011","Bedford 006C","E01017531","Total",583,202,94,108,381,39,74,60,93,20,29,66
"2011","Bedford 006D","E01017532","Total",505,100,76,24,405,11,126,68,80,15,27,78
"2011","Bedford 006E","E01017533","Total",485,90,58,32,395,6,122,49,94,9,23,92
"2011","Bedford 006F","E01017534","Total",644,170,120,50,474,19,137,87,97,10,37,87
"2011","Bedford 007A","E01017488","Total",637,186,145,41,451,18,155,60,85,15,31,87
"2011","Bedford 007B","E01017489","Total",614,150,78,72,464,92,52,98,87,20,41,74
"2011","Bedford 007C","E01017490","Total",611,226,101,125,385,69,49,75,93,17,25,57
"2011","Bedford 007D","E01017491","Total",641,193,102,91,448,22,99,92,91,20,32,92
"2011","Bedford 007E","E01017492","Total",606,175,50,125,431,78,51,82,101,23,28,68
"2011","Bedford 007F","E01017493","Total",653,164,26,138,489,78,41,136,118,20,37,59
"2011","Bedford 008A","E01017459","Total",687,161,90,71,526,32,104,108,143,33,29,77
"2011","Bedford 008B","E01017460","Total",650,147,77,70,503,25,100,96,142,15,43,82
"2011","Bedford 008C","E01017461","Total",734,136,32,104,598,33,96,146,161,30,44,88
"2011","Bedford 008D","E01017462","Total",613,122,69,53,491,17,99,127,108,25,36,79
"2011","Bedford 008E","E01017463","Total",601,182,119,63,419,11,146,63,96,15,28,60
"2011","Bedford 009A","E01017482","Total",621,290,89,201,331,22,70,58,88,12,23,58
"2011","Bedford 009B","E01017483","Total",600,190,109,81,410,18,108,60,107,14,28,75
"2011","Bedford 009C","E01017484","Total",503,315,74,241,188,9,27,31,73,6,15,27
"2011","Bedford 009D","E01017485","Total",622,252,36,216,370,19,38,87,127,12,37,50
"2011","Bedford 010A","E01017497","Total",581,175,31,144,406,42,33,74,125,10,19,103
"2011","Bedford 010B","E01017498","Total",505,123,51,72,382,26,70,72,83,13,35,83
"2011","Bedford 010C","E01017499","Total",599,271,53,218,328,19,41,60,116,10,20,62
"2011","Bedford 010D","E01017500","Total",591,311,76,235,280,16,25,51,106,3,15,64
"2011","Bedford 010E","E01017501","Total",619,356,157,199,263,20,35,46,109,9,12,32
"2011","Bedford 010F","E01017502","Total",842,513,249,264,329,21,52,52,99,12,31,62
"2011","Bedford 011A","E01017524","Total",632,173,82,91,459,32,82,94,99,19,41,92
"2011","Bedford 011B","E01017525","Total",493,139,56,83,354,32,64,72,77,16,23,70
"2011","Bedford 011C","E01017526","Total",604,165,38,127,439,41,49,120,119,16,21,73
"2011","Bedford 011D","E01017527","Total",530,163,54,109,367,42,58,79,120,9,22,37
"2011","Bedford 012A","E01017466","Total",754,316,42,274,438,37,20,78,122,19,66,96
"2011","Bedford 012B","E01017467","Total",613,240,105,135,373,21,46,85,147,6,21,47
"2011","Bedford 012C","E01017468","Total",596,195,61,134,401,28,43,92,151,8,22,57
"2011","Bedford 012D","E01017469","Total",842,408,111,297,434,26,43,79,162,14,27,83
"2011","Bedford 012E","E01017470","Total",503,112,56,56,391,20,38,96,117,13,18,89
"2011","Bedford 012F","E01017471","Total",772,423,89,334,349,41,25,60,148,3,19,53
"2011","Bedford 013A","E01017535","Total",475,95,51,44,380,22,49,68,68,27,72,74
"2011","Bedford 013B","E01017536","Total",820,176,29,147,644,70,35,126,156,38,105,114
"2011","Bedford 013C","E01017537","Total",480,136,60,76,344,37,47,53,43,34,52,78
"2011","Bedford 013D","E01017538","Total",524,93,47,46,431,39,43,56,48,39,97,109
"2011","Bedford 013E","E01017539","Total",502,140,55,85,362,24,27,64,73,32,65,77
"2011","Bedford 014A","E01017518","Total",604,174,63,111,430,47,43,108,102,20,36,74
"2011","Bedford 014B","E01017519","Total",642,194,94,100,448,70,67,71,95,18,49,78
"2011","Bedford 014C","E01017520","Total",625,198,42,156,427,35,64,75,130,11,40,72
"2011","Bedford 014D","E01017521","Total",622,179,65,114,443,39,66,101,103,16,42,76
"2011","Bedford 014E","E01017522","Total",858,367,161,206,491,51,57,97,149,27,28,82
"2011","Bedford 014F","E01017523","Total",589,158,62,96,431,102,27,95,75,30,36,66
"2011","Bedford 015A","E01017472","Total",510,130,39,91,380,63,30,83,69,25,49,61
"2011","Bedford 015B","E01017473","Total",929,320,20,300,609,72,27,117,172,21,67,133
"2011","Bedford 015C","E01017474","Total",628,193,28,165,435,35,31,90,91,39,75,74
"2011","Bedford 015D","E01017475","Total",553,131,58,73,422,27,38,110,93,19,54,81
"2011","Bedford 015E","E01017476","Total",543,120,65,55,423,26,103,65,67,14,52,96
"2011","Bedford 015F","E01017477","Total",518,178,100,78,340,53,60,55,57,24,40,51
"2011","Bedford 016A","E01017509","Total",501,175,59,116,326,43,50,65,51,16,42,59
"2011","Bedford 016B","E01017510","Total",657,193,74,119,464,26,87,93,137,15,28,78
"2011","Bedford 016C","E01017511","Total",485,96,24,72,389,31,64,64,106,11,41,72
"2011","Bedford 016D","E01017512","Total",537,125,33,92,412,47,43,69,104,16,48,85
"2011","Bedford 017A","E01017505","Total",645,186,70,116,459,47,85,84,111,10,29,93
"2011","Bedford 017B","E01017506","Total",664,212,80,132,452,55,46,110,115,17,31,78
"2011","Bedford 017C","E01017507","Total",519,135,49,86,384,32,51,86,92,11,44,68
"2011","Bedford 017D","E01017508","Total",663,193,70,123,470,33,80,101,112,18,42,84
"2011","Bedford 018A","E01017513","Total",549,107,42,65,442,31,65,93,97,19,39,98
"2011","Bedford 018B","E01017514","Total",650,195,72,123,455,43,74,86,90,27,38,97
"2011","Bedford 018C","E01017515","Total",626,183,101,82,443,39,60,86,101,23,37,97
"2011","Bedford 018D","E01017516","Total",559,132,68,64,427,24,80,82,87,21,38,95
"2011","Bedford 018E","E01017517","Total",598,126,51,75,472,37,74,103,86,18,38,116
"2011","Bedford 019A","E01017486","Total",685,157,69,88,528,33,91,134,142,24,41,63
"2011","Bedford 019B","E01017487","Total",672,139,24,115,533,62,45,151,126,23,59,67
"2011","Bedford 019C","E01017548","Total",750,140,68,72,610,63,86,132,200,18,27,84
"2011","Bedford 019D","E01017549","Total",652,205,137,68,447,7,138,79,129,13,25,56
"2011","Bedford 019E","E01017550","Total",988,197,60,137,791,50,99,188,202,40,70,142
"2011","Bedford 020A","E01017551","Total",532,86,41,45,446,32,83,93,85,11,39,103
"2011","Bedford 020B","E01017552","Total",499,168,76,92,331,21,53,79,83,17,34,44
"2011","Bedford 020C","E01017553","Total",482,82,33,49,400,14,94,85,92,16,32,67
"2011","Bedford 020D","E01017554","Total",640,203,130,73,437,26,123,73,90,18,22,85
"2011","Central Bedfordshire 001A","E01017433","Total",648,225,113,112,423,46,42,80,95,38,43,79
"2011","Central Bedfordshire 001B","E01017434","Total",694,164,69,95,530,29,87,118,161,19,29,87
"2011","Central Bedfordshire 001C","E01017436","Total",894,153,48,105,741,34,93,201,246,34,57,76
"2011","Central Bedfordshire 002A","E01017430","Total",600,180,78,102,420,37,84,86,104,17,19,73
"2011","Central Bedfordshire 002B","E01017431","Total",678,228,76,152,450,31,68,96,147,11,24,73
"2011","Central Bedfordshire 002C","E01017432","Total",565,97,46,51,468,13,95,77,137,15,33,98
"2011","Central Bedfordshire 002D","E01017435","Total",713,213,93,120,500,38,75,111,148,24,33,71
"2011","Central Bedfordshire 003A","E01017425","Total",430,84,49,35,346,11,64,60,114,8,21,68
"2011","Central Bedfordshire 003B","E01017426","Total",574,132,62,70,442,8,98,82,142,10,35,67
"2011","Central Bedfordshire 003C","E01017427","Total",719,181,82,99,538,26,94,113,161,18,33,93
"2011","Central Bedfordshire 003D","E01017428","Total",681,190,102,88,491,22,89,118,135,19,32,76
"2011","Central Bedfordshire 003E","E01017429","Total",625,196,62,134,429,17,70,96,153,11,29,53
"2011","Central Bedfordshire 004A","E01017412","Total",611,161,62,99,450,12,95,85,123,18,38,79
"2011","Central Bedfordshire 004B","E01017422","Total",626,140,88,52,486,13,125,88,128,19,31,82
"2011","Central Bedfordshire 004C","E01017423","Total",639,144,83,61,495,14,137,90,136,21,28,69
"2011","Central Bedfordshire 004D","E01017424","Total",568,123,67,56,445,18,114,63,129,11,32,78
"2011","Central Bedfordshire 005A","E01017383","Total",848,300,59,241,548,34,76,142,166,12,42,76
"2011","Central Bedfordshire 005B","E01017384","Total",670,212,92,120,458,35,64,124,117,21,41,56
"2011","Central Bedfordshire 005C","E01017385","Total",849,383,136,247,466,36,82,88,183,11,16,50
"2011","Central Bedfordshire 005D","E01017386","Total",756,200,80,120,556,37,75,138,174,14,31,87
"2011","Central Bedfordshire 005E","E01017387","Total",508,92,45,47,416,25,61,88,109,19,33,81
"2011","Central Bedfordshire 005F","E01017388","Total",555,133,54,79,422,28,71,80,119,15,26,83
"2011","Central Bedfordshire 006A","E01017381","Total",616,136,75,61,480,15,130,91,117,13,25,89
"2011","Central Bedfordshire 006B","E01017382","Total",573,143,92,51,430,26,100,84,82,17,43,78
"2011","Central Bedfordshire 006C","E01017389","Total",739,145,44,101,594,29,84,173,155,19,52,82
"2011","Central Bedfordshire 006D","E01017390","Total",801,190,80,110,611,58,88,127,154,32,45,107
"2011","Central Bedfordshire 007A","E01017379","Total",520,157,91,66,363,16,86,68,97,15,26,55
"2011","Central Bedfordshire 007B","E01017380","Total",517,106,52,54,411,12,98,81,122,10,26,62
"2011","Central Bedfordshire 007C","E01017394","Total",584,123,57,66,461,12,74,114,115,20,33,93
"2011","Central Bedfordshire 007F","E01017397","Total",670,152,72,80,518,16,96,101,148,18,45,94
"2011","Central Bedfordshire 007G","E01033194","Total",775,163,73,90,612,16,106,138,132,34,58,128
"2011","Central Bedfordshire 008A","E01017410","Total",485,102,63,39,383,9,87,60,113,14,28,72
"2011","Central Bedfordshire 008B","E01017411","Total",624,144,68,76,480,22,106,99,132,10,33,78
"2011","Central Bedfordshire 008C","E01017419","Total",604,106,63,43,498,9,122,104,105,21,57,80
"2011","Central Bedfordshire 008D","E01017420","Total",649,182,102,80,467,24,82,100,132,13,28,88
"2011","Central Bedfordshire 008E","E01017421","Total",706,167,91,76,539,22,119,111,136,23,47,81
"2011","Central Bedfordshire 009A","E01017416","Total",781,165,71,94,616,33,88,149,171,21,36,118
"2011","Central Bedfordshire 009B","E01017417","Total",905,184,49,135,721,57,70,198,203,32,48,113
"2011","Central Bedfordshire 009C","E01017418","Total",650,186,101,85,464,48,78,85,124,10,30,89
"2011","Central Bedfordshire 009D","E01017451","Total",582,144,74,70,438,13,77,100,122,23,25,78
"2011","Central Bedfordshire 009E","E01017452","Total",581,230,138,92,351,8,99,60,102,10,19,53
"2011","Central Bedfordshire 010A","E01017376","Total",811,238,55,183,573,32,60,157,205,17,22,80
"2011","Central Bedfordshire 010B","E01017377","Total",760,158,45,113,602,37,80,135,174,20,46,110
"2011","Central Bedfordshire 010C","E01017378","Total",773,255,122,133,518,33,76,121,148,13,34,93
"2011","Central Bedfordshire 010D","E01017413","Total",722,146,75,71,576,16,145,108,163,19,31,94
"2011","Central Bedfordshire 010E","E01017414","Total",720,180,97,83,540,31,105,115,161,18,29,81
"2011","Central Bedfordshire 010F","E01017415","Total",776,195,90,105,581,47,112,130,166,14,39,73
"2011","Central Bedfordshire 011A","E01017437","Total",665,192,75,117,473,38,70,103,150,13,26,73
"2011","Central Bedfordshire 011B","E01017438","Total",670,174,74,100,496,19,87,129,119,21,39,82
"2011","Central Bedfordshire 011C","E01017439","Total",632,122,55,67,510,27,66,158,131,21,42,65
"2011","Central Bedfordshire 011D","E01017440","Total",622,216,79,137,406,35,70,102,126,11,20,42
"2011","Central Bedfordshire 011E","E01017441","Total",620,102,52,50,518,32,45,163,123,31,47,77
"2011","Central Bedfordshire 011F","E01017444","Total",792,223,107,116,569,26,119,112,167,19,45,81
"2011","Central Bedfordshire 012A","E01017371","Total",547,147,104,43,400,15,120,78,85,15,30,57
"2011","Central Bedfordshire 012B","E01017372","Total",647,201,98,103,446,31,93,108,101,11,27,75
"2011","Central Bedfordshire 012C","E01017373","Total",560,118,49,69,442,18,66,123,96,23,40,76
"2011","Central Bedfordshire 012D","E01017374","Total",573,129,48,81,444,21,83,117,119,13,30,61
"2011","Central Bedfordshire 012E","E01017375","Total",639,223,119,104,416,18,75,83,112,22,28,78
"2011","Central Bedfordshire 013A","E01017391","Total",538,138,59,79,400,28,64,93,83,21,26,85
"2011","Central Bedfordshire 013B","E01017392","Total",623,141,71,70,482,16,141,85,116,11,30,83
"2011","Central Bedfordshire 013C","E01017393","Total",680,157,78,79,523,16,79,127,149,17,36,99
"2011","Central Bedfordshire 013D","E01017442","Total",814,157,59,98,657,33,104,155,199,27,33,106
"2011","Central Bedfordshire 013E","E01017443","Total",698,191,68,123,507,28,45,159,174,30,24,47
"2011","Central Bedfordshire 014A","E01017446","Total",726,194,92,102,532,32,106,126,126,14,39,89
"2011","Central Bedfordshire 014B","E01017447","Total",843,195,98,97,648,27,115,161,180,16,46,103
"2011","Central Bedfordshire 014D","E01017449","Total",625,151,83,68,474,20,105,89,134,16,28,82
"2011","Central Bedfordshire 014E","E01033188","Total",577,122,59,63,455,24,94,103,121,19,22,72
"2011","Central Bedfordshire 014F","E01033189","Total",611,131,32,99,480,30,33,168,163,16,21,49
"2011","Central Bedfordshire 014G","E01033190","Total",596,152,16,136,444,39,22,144,185,13,13,28
"2011","Central Bedfordshire 015A","E01017399","Total",570,117,24,93,453,22,45,128,124,21,34,79
"2011","Central Bedfordshire 015B","E01017400","Total",641,232,107,125,409,39,66,92,82,20,33,77
"2011","Central Bedfordshire 015C","E01017401","Total",522,138,50,88,384,18,46,78,122,20,31,69
"2011","Central Bedfordshire 015D","E01017402","Total",654,150,82,68,504,16,153,98,102,14,32,89
"2011","Central Bedfordshire 016A","E01017403","Total",604,166,65,101,438,21,90,107,111,12,27,70
"2011","Central Bedfordshire 016B","E01017404","Total",493,56,27,29,437,4,68,82,127,14,33,109
"2011","Central Bedfordshire 016C","E01017405","Total",611,164,45,119,447,28,57,87,140,15,23,97
"2011","Central Bedfordshire 016D","E01017406","Total",631,155,40,115,476,34,52,111,155,16,38,70
"2011","Central Bedfordshire 016E","E01017407","Total",681,179,55,124,502,22,48,116,175,7,24,110
"2011","Central Bedfordshire 017A","E01017398","Total",932,158,77,81,774,16,159,168,221,27,54,129
"2011","Central Bedfordshire 017B","E01017408","Total",416,84,45,39,332,15,60,66,87,12,26,66
"2011","Central Bedfordshire 017C","E01017409","Total",505,125,83,42,380,12,93,65,88,11,27,84
"2011","Central Bedfordshire 017D","E01017445","Total",732,168,91,77,564,22,127,109,150,12,37,107
"2011","Central Bedfordshire 017E","E01017450","Total",866,154,73,81,712,36,125,132,179,30,58,152
"2011","Central Bedfordshire 018A","E01017558","Total",737,198,58,140,539,40,68,150,147,19,38,77
"2011","Central Bedfordshire 018B","E01017559","Total",666,137,93,44,529,27,124,111,111,10,46,100
"2011","Central Bedfordshire 018C","E01017560","Total",619,146,92,54,473,15,128,104,100,6,30,90
"2011","Central Bedfordshire 018D","E01017616","Total",952,242,68,174,710,62,95,188,194,25,44,102
"2011","Central Bedfordshire 019A","E01017577","Total",928,229,111,118,699,28,144,137,225,25,29,111
"2011","Central Bedfordshire 019B","E01017615","Total",878,218,121,97,660,12,155,114,199,14,36,130
"2011","Central Bedfordshire 019C","E01017620","Total",740,180,81,99,560,32,102,109,154,19,42,102
"2011","Central Bedfordshire 019D","E01017621","Total",651,140,82,58,511,18,146,112,86,22,35,92
"2011","Central Bedfordshire 019E","E01017622","Total",681,186,110,76,495,40,72,106,117,19,44,97
"2011","Central Bedfordshire 020A","E01017603","Total",641,171,70,101,470,21,82,93,144,12,23,95
"2011","Central Bedfordshire 020B","E01017604","Total",641,127,42,85,514,21,65,119,146,14,41,108
"2011","Central Bedfordshire 020C","E01017605","Total",500,91,29,62,409,60,39,78,82,32,37,81
"2011","Central Bedfordshire 020D","E01017606","Total",644,139,87,52,505,9,153,67,143,12,32,89
"2011","Central Bedfordshire 020E","E01017607","Total",507,71,41,30,436,6,115,82,109,9,25,90
"2011","Central Bedfordshire 021A","E01017555","Total",955,430,162,268,525,58,68,109,167,11,27,85
"2011","Central Bedfordshire 021B","E01017556","Total",672,189,48,141,483,22,46,128,163,16,23,85
"2011","Central Bedfordshire 021C","E01017557","Total",919,418,229,189,501,46,93,88,172,13,19,70
"2011","Central Bedfordshire 021D","E01017608","Total",719,230,91,139,489,26,76,94,140,23,44,86
"2011","Central Bedfordshire 021E","E01017609","Total",683,171,72,99,512,106,70,108,94,14,31,89
"2011","Central Bedfordshire 022A","E01017589","Total",787,310,85,225,477,30,53,100,189,14,22,69
"2011","Central Bedfordshire 022B","E01017590","Total",655,183,91,92,472,15,123,78,131,14,21,90
"2011","Central Bedfordshire 022C","E01017591","Total",733,185,73,112,548,26,105,111,180,10,32,84
"2011","Central Bedfordshire 022D","E01017610","Total",446,74,41,33,372,8,84,72,98,7,26,77
"2011","Central Bedfordshire 023A","E01017611","Total",510,111,28,83,399,11,61,88,121,16,17,85
"2011","Central Bedfordshire 023B","E01017612","Total",531,126,33,93,405,16,58,96,115,20,29,71
"2011","Central Bedfordshire 023C","E01017613","Total",604,170,78,92,434,21,83,85,132,16,25,72
"2011","Central Bedfordshire 023D","E01017614","Total",588,132,45,87,456,16,73,112,117,15,36,87
"2011","Central Bedfordshire 025A","E01017600","Total",817,250,32,218,567,50,36,146,187,24,42,82
"2011","Central Bedfordshire 025B","E01017601","Total",490,84,31,53,406,56,38,73,86,31,58,64
"2011","Central Bedfordshire 025C","E01017602","Total",620,189,76,113,431,46,56,77,86,25,54,87
"2011","Central Bedfordshire 025D","E01017618","Total",611,139,67,72,472,78,52,96,85,35,42,84
"2011","Central Bedfordshire 025E","E01017619","Total",787,166,78,88,621,103,70,114,136,31,63,104
"2011","Central Bedfordshire 024A","E01017573","Total",586,122,82,40,464,12,130,73,108,14,30,97
"2011","Central Bedfordshire 024C","E01017575","Total",1076,309,86,223,767,70,80,220,260,21,28,88
"2011","Central Bedfordshire 024D","E01017576","Total",547,104,56,48,443,25,80,91,118,17,27,85
"2011","Central Bedfordshire 024E","E01033191","Total",564,132,13,119,432,32,21,159,143,16,24,37
"2011","Central Bedfordshire 024F","E01033192","Total",571,90,4,86,481,41,11,189,162,16,21,41
"2011","Central Bedfordshire 024G","E01033193","Total",602,118,29,89,484,33,52,131,139,24,30,75
"2011","Central Bedfordshire 026A","E01017578","Total",684,161,63,98,523,37,76,102,158,12,47,91
"2011","Central Bedfordshire 026B","E01017579","Total",597,158,59,99,439,40,71,82,107,16,36,87
"2011","Central Bedfordshire 026C","E01017580","Total",885,244,35,209,641,120,23,174,187,22,42,73
"2011","Central Bedfordshire 026D","E01017581","Total",798,286,129,157,512,50,77,91,148,22,35,89
"2011","Central Bedfordshire 026E","E01017617","Total",509,105,68,37,404,31,89,66,87,13,36,82
"2011","Central Bedfordshire 027A","E01017582","Total",601,141,69,72,460,11,108,95,86,18,40,102
"2011","Central Bedfordshire 027B","E01017583","Total",720,160,76,84,560,29,94,122,132,20,55,108
"2011","Central Bedfordshire 027C","E01017584","Total",787,204,112,92,583,35,125,127,139,16,49,92
"2011","Central Bedfordshire 027D","E01017585","Total",540,106,64,42,434,4,109,68,87,13,50,103
"2011","Central Bedfordshire 028A","E01017566","Total",605,134,102,32,471,9,120,72,119,10,40,101
"2011","Central Bedfordshire 028B","E01017595","Total",464,113,61,52,351,35,64,54,67,17,35,79
"2011","Central Bedfordshire 028C","E01017596","Total",605,168,80,88,437,53,64,98,81,26,31,84
"2011","Central Bedfordshire 028D","E01017597","Total",612,182,98,84,430,44,70,73,106,22,29,86
"2011","Central Bedfordshire 028E","E01017598","Total",408,74,34,40,334,14,65,73,83,11,22,66
"2011","Central Bedfordshire 028F","E01017599","Total",863,255,73,182,608,74,55,144,163,32,43,97
"2011","Central Bedfordshire 029A","E01017565","Total",618,147,111,36,471,9,143,78,97,15,39,90
"2011","Central Bedfordshire 029B","E01017567","Total",695,205,63,142,490,66,75,88,114,19,38,90
"2011","Central Bedfordshire 029C","E01017568","Total",874,360,105,255,514,75,57,125,149,13,20,75
"2011","Central Bedfordshire 029D","E01017569","Total",750,301,107,194,449,47,56,99,132,14,28,73
"2011","Central Bedfordshire 029E","E01017570","Total",925,367,86,281,558,47,64,124,199,15,30,79
"2011","Central Bedfordshire 030A","E01017592","Total",699,263,129,134,436,30,70,102,112,13,27,82
"2011","Central Bedfordshire 030B","E01017593","Total",643,193,110,83,450,32,110,77,97,10,32,92
"2011","Central Bedfordshire 030C","E01017594","Total",864,218,84,134,646,177,56,158,106,20,43,86
"2011","Central Bedfordshire 031A","E01017623","Total",751,294,108,186,457,39,59,99,112,15,37,96
"2011","Central Bedfordshire 031B","E01017624","Total",723,143,52,91,580,44,90,118,139,24,38,127
"2011","Central Bedfordshire 031C","E01017625","Total",647,129,87,42,518,7,160,80,109,16,36,110
"2011","Central Bedfordshire 031D","E01017626","Total",665,121,46,75,544,10,138,91,117,14,41,133
"2011","Central Bedfordshire 032A","E01017571","Total",527,137,74,63,390,27,105,51,98,12,19,78
"2011","Central Bedfordshire 032B","E01017572","Total",569,143,49,94,426,20,92,85,122,8,28,71
"2011","Central Bedfordshire 032C","E01017586","Total",614,155,85,70,459,23,102,75,132,14,33,80
"2011","Central Bedfordshire 032D","E01017587","Total",666,145,89,56,521,10,163,70,158,12,21,87
"2011","Central Bedfordshire 032E","E01017588","Total",538,155,94,61,383,7,122,50,111,11,19,63
"2011","Central Bedfordshire 033A","E01017561","Total",591,110,58,52,481,13,102,87,123,9,41,106
"2011","Central Bedfordshire 033B","E01017562","Total",697,257,151,106,440,25,132,64,115,12,23,69
"2011","Central Bedfordshire 033C","E01017563","Total",672,173,108,65,499,14,127,102,125,16,24,91
"2011","Central Bedfordshire 033D","E01017564","Total",604,166,65,101,438,27,89,83,135,14,16,74
"2011","Luton 001A","E01015706","Total",604,197,105,92,407,16,85,76,108,12,40,70
"2011","Luton 001B","E01015707","Total",585,134,40,94,451,12,96,98,124,11,34,76
"2011","Luton 001C","E01015708","Total",510,104,44,60,406,9,61,90,92,18,45,91
"2011","Luton 001D","E01015709","Total",629,190,51,139,439,21,80,84,140,9,28,77
"2011","Luton 001E","E01015710","Total",643,200,61,139,443,33,50,101,132,14,33,80
"2011","Luton 001F","E01015770","Total",491,89,45,44,402,7,101,49,96,20,42,87
"2011","Luton 002A","E01015801","Total",746,216,51,165,530,93,80,117,114,21,35,70
"2011","Luton 002B","E01015803","Total",592,117,53,64,475,15,108,76,119,20,36,101
"2011","Luton 002C","E01015804","Total",713,178,65,113,535,79,80,105,110,37,36,88
"2011","Luton 002D","E01015805","Total",491,90,57,33,401,9,93,67,74,15,45,98
"2011","Luton 003A","E01015769","Total",496,158,52,106,338,37,52,52,85,22,30,60
"2011","Luton 003B","E01015771","Total",577,214,68,146,363,68,33,68,66,21,50,57
"2011","Luton 003C","E01015772","Total",534,158,41,117,376,49,39,60,80,27,64,57
"2011","Luton 003D","E01015773","Total",461,99,17,82,362,72,22,57,61,22,59,69
"2011","Luton 003E","E01015774","Total",518,152,25,127,366,55,22,77,73,35,52,52
"2011","Luton 003F","E01015802","Total",608,183,60,123,425,68,70,85,71,23,43,65
"2011","Luton 004A","E01015744","Total",643,261,89,172,382,43,53,82,94,20,33,57
"2011","Luton 004B","E01015746","Total",621,193,106,87,428,19,121,63,89,23,41,72
"2011","Luton 004C","E01015747","Total",486,67,41,26,419,6,104,65,66,12,58,108
"2011","Luton 004D","E01015748","Total",720,227,141,86,493,26,151,67,101,22,32,94
"2011","Luton 005A","E01015749","Total",700,202,51,151,498,78,51,99,93,39,71,67
"2011","Luton 005B","E01015751","Total",624,160,64,96,464,51,66,81,97,30,54,85
"2011","Luton 005C","E01015752","Total",478,90,42,48,388,22,71,57,81,27,38,92
"2011","Luton 005D","E01015753","Total",615,182,34,148,433,59,55,93,125,8,33,60
"2011","Luton 005E","E01015754","Total",768,288,129,159,480,65,83,88,93,26,48,77
"2011","Luton 005F","E01015755","Total",687,228,143,85,459,21,116,90,95,17,44,76
"2011","Luton 006A","E01015764","Total",593,141,84,57,452,16,123,66,86,15,38,108
"2011","Luton 006B","E01015765","Total",658,200,63,137,458,59,64,92,81,18,58,86
"2011","Luton 006C","E01015766","Total",555,101,41,60,454,36,67,79,75,43,65,89
"2011","Luton 006D","E01015767","Total",595,155,66,89,440,28,73,76,83,17,62,101
"2011","Luton 006E","E01015768","Total",580,137,80,57,443,20,114,77,94,20,38,80
"2011","Luton 006F","E01015783","Total",524,106,33,73,418,33,37,75,54,39,90,90
"2011","Luton 006G","E01015785","Total",820,274,88,186,546,50,57,123,127,41,62,86
"2011","Luton 007A","E01015693","Total",514,60,37,23,454,15,84,74,95,23,68,95
"2011","Luton 007B","E01015694","Total",497,94,56,38,403,11,97,59,63,33,53,87
"2011","Luton 007C","E01015695","Total",494,87,50,37,407,17,42,81,72,34,68,93
"2011","Luton 007D","E01015696","Total",505,97,17,80,408,40,25,131,114,14,28,56
"2011","Luton 007E","E01015697","Total",659,150,69,81,509,28,59,151,112,25,52,82
"2011","Luton 007F","E01015745","Total",557,98,67,31,459,7,133,59,64,20,65,111
"2011","Luton 008A","E01015797","Total",506,89,53,36,417,11,103,74,90,10,34,95
"2011","Luton 008B","E01015798","Total",539,141,72,69,398,29,68,83,89,16,34,79
"2011","Luton 008C","E01015799","Total",574,118,62,56,456,21,121,87,109,5,28,85
"2011","Luton 008D","E01015800","Total",627,157,68,89,470,41,71,104,129,9,26,90
"2011","Luton 008E","E01015812","Total",524,109,38,71,415,28,43,88,122,13,30,91
"2011","Luton 008F","E01015813","Total",688,339,148,191,349,25,76,55,92,6,23,72
"2011","Luton 009A","E01015756","Total",647,174,50,124,473,56,47,117,132,25,37,59
"2011","Luton 009B","E01015757","Total",613,202,98,104,411,50,69,68,77,19,54,74
"2011","Luton 009C","E01015758","Total",524,115,10,105,409,53,13,89,94,20,61,79
"2011","Luton 009D","E01015759","Total",617,230,115,115,387,49,62,57,64,28,53,74
"2011","Luton 009E","E01015760","Total",611,243,102,141,368,49,37,73,66,18,70,55
"2011","Luton 009F","E01015761","Total",606,144,75,69,462,57,70,86,80,35,53,81
"2011","Luton 010A","E01015700","Total",773,201,89,112,572,40,55,110,89,40,119,119
"2011","Luton 010B","E01015701","Total",509,63,20,43,446,20,27,51,38,68,147,95
"2011","Luton 010C","E01015704","Total",570,87,28,59,483,36,18,114,52,74,114,75
"2011","Luton 010D","E01015782","Total",636,124,61,63,512,21,73,78,69,61,93,117
"2011","Luton 010E","E01015784","Total",532,65,25,40,467,22,24,74,46,79,125,97
"2011","Luton 010F","E01015786","Total",564,90,41,49,474,19,33,70,59,63,119,111
"2011","Luton 011A","E01015711","Total",514,108,54,54,406,16,40,65,64,45,89,87
"2011","Luton 011B","E01015712","Total",631,173,78,95,458,16,100,61,70,47,70,94
"2011","Luton 011C","E01015715","Total",496,60,19,41,436,37,38,92,41,47,102,79
"2011","Luton 011D","E01015716","Total",616,160,20,140,456,58,23,119,89,28,65,74
"2011","Luton 011E","E01015717","Total",512,115,38,77,397,47,42,83,58,32,52,83
"2011","Luton 011F","E01015750","Total",718,148,42,106,570,44,54,120,107,41,95,109
"2011","Luton 012A","E01015740","Total",568,140,44,96,428,16,51,88,116,15,53,89
"2011","Luton 012B","E01015775","Total",704,247,86,161,457,30,82,101,115,18,34,77
"2011","Luton 012C","E01015776","Total",736,199,110,89,537,35,114,97,101,25,61,104
"2011","Luton 012D","E01015777","Total",683,182,52,130,501,38,70,109,114,18,53,99
"2011","Luton 012E","E01015778","Total",682,194,50,144,488,43,64,99,102,22,55,103
"2011","Luton 012F","E01015796","Total",667,242,137,105,425,10,121,58,99,12,33,92
"2011","Luton 013A","E01015713","Total",517,128,71,57,389,14,106,59,55,27,41,87
"2011","Luton 013B","E01015714","Total",631,155,85,70,476,21,105,84,73,29,57,107
"2011","Luton 013C","E01015718","Total",680,235,71,164,445,22,79,84,93,27,35,105
"2011","Luton 013D","E01015762","Total",670,193,98,95,477,28,95,86,99,22,57,90
"2011","Luton 013E","E01015763","Total",639,198,122,76,441,22,110,77,86,21,40,85
"2011","Luton 014A","E01015721","Total",656,207,100,107,449,21,87,100,114,14,37,76
"2011","Luton 014B","E01015722","Total",522,147,50,97,375,38,43,87,102,12,31,62
"2011","Luton 014C","E01015806","Total",554,153,27,126,401,39,33,89,136,7,35,62
"2011","Luton 014D","E01015808","Total",626,208,58,150,418,26,21,109,163,7,28,64
"2011","Luton 014E","E01015809","Total",502,68,22,46,434,6,51,99,119,7,41,111
"2011","Luton 014F","E01015810","Total",514,92,12,80,422,63,16,107,107,14,34,81
"2011","Luton 014G","E01015811","Total",580,131,24,107,449,18,43,104,164,15,29,76
"2011","Luton 015A","E01015703","Total",490,61,16,45,429,10,35,32,32,57,154,109
"2011","Luton 015B","E01015726","Total",574,88,28,60,486,34,21,65,40,51,147,128
"2011","Luton 015C","E01015731","Total",553,102,37,65,451,29,26,84,60,55,103,94
"2011","Luton 015D","E01015787","Total",570,113,30,83,457,19,36,75,67,57,92,111
"2011","Luton 015E","E01015788","Total",456,51,25,26,405,14,28,46,25,50,149,93
"2011","Luton 016A","E01015719","Total",552,133,63,70,419,21,79,72,97,16,38,96
"2011","Luton 016B","E01015720","Total",554,170,35,135,384,38,27,72,83,21,51,92
"2011","Luton 016C","E01015723","Total",494,102,36,66,392,37,37,73,103,27,32,83
"2011","Luton 016D","E01015779","Total",494,95,49,46,399,34,42,55,77,31,55,105
"2011","Luton 016E","E01015780","Total",630,154,61,93,476,25,49,97,129,29,37,110
"2011","Luton 016F","E01015781","Total",533,114,41,73,419,38,49,77,72,32,56,95
"2011","Luton 016G","E01015807","Total",532,118,62,56,414,40,67,75,99,18,28,87
"2011","Luton 017A","E01015698","Total",532,129,26,103,403,40,27,61,54,39,100,82
"2011","Luton 017B","E01015699","Total",617,203,31,172,414,45,19,80,64,27,90,89
"2011","Luton 017C","E01015702","Total",472,96,29,67,376,30,23,62,32,42,109,78
"2011","Luton 017D","E01015705","Total",561,124,6,118,437,64,8,92,98,21,56,98
"2011","Luton 017E","E01015725","Total",496,107,52,55,389,21,26,89,42,71,78,62
"2011","Luton 017F","E01015727","Total",450,71,18,53,379,15,19,48,35,46,122,94
"2011","Luton 018A","E01015739","Total",963,455,104,351,508,38,35,103,202,8,35,87
"2011","Luton 018B","E01015741","Total",1022,445,80,365,577,62,26,104,179,21,57,128
"2011","Luton 018C","E01015742","Total",739,235,43,192,504,47,34,108,148,6,34,127
"2011","Luton 018D","E01015743","Total",687,260,48,212,427,53,28,72,136,10,27,101
"2011","Luton 018E","E01015789","Total",832,416,181,235,416,63,49,66,93,13,41,91
"2011","Luton 018F","E01015794","Total",1054,488,55,433,566,31,19,85,256,4,12,159
"2011","Luton 019A","E01015724","Total",658,129,35,94,529,24,30,106,76,58,132,103
"2011","Luton 019B","E01015728","Total",515,89,46,43,426,22,50,87,42,57,90,78
"2011","Luton 019C","E01015729","Total",595,184,32,152,411,26,22,52,75,35,89,112
"2011","Luton 019D","E01015730","Total",743,183,54,129,560,44,22,128,100,62,70,134
"2011","Luton 020A","E01015732","Total",514,100,48,52,414,50,54,54,76,27,72,81
"2011","Luton 020B","E01015733","Total",608,160,108,52,448,44,78,68,50,38,82,88
"2011","Luton 020C","E01015734","Total",716,194,80,114,522,28,76,106,120,34,45,113
"2011","Luton 020D","E01015735","Total",690,218,31,187,472,46,17,106,136,23,34,110
"2011","Luton 020E","E01015736","Total",689,274,129,145,415,46,45,68,88,26,63,79
"2011","Luton 020F","E01015737","Total",503,103,50,53,400,39,43,59,62,26,74,97
"2011","Luton 021A","E01015738","Total",788,295,63,232,493,34,50,93,144,17,23,132
"2011","Luton 021B","E01015790","Total",613,163,70,93,450,20,57,95,103,19,44,112
"2011","Luton 021C","E01015791","Total",1115,432,119,313,683,87,21,116,244,13,32,170
"2011","Luton 021D","E01015792","Total",691,192,39,153,499,43,34,106,152,10,31,123
"2011","Luton 021E","E01015793","Total",644,179,40,139,465,25,53,95,124,16,43,109
"2011","Luton 021F","E01015795","Total",985,443,20,423,542,56,10,111,208,13,30,114
"2011","Peterborough 001A","E01015629","Total",671,136,77,59,535,25,124,106,125,24,48,83
"2011","Peterborough 001B","E01015635","Total",632,128,82,46,504,17,146,71,130,19,30,91
"2011","Peterborough 001C","E01015636","Total",474,98,54,44,376,19,95,58,106,10,29,59
"2011","Peterborough 001D","E01015679","Total",823,294,112,182,529,32,89,102,166,16,34,90
"2011","Peterborough 002A","E01015678","Total",568,139,30,109,429,30,38,95,128,20,29,89
"2011","Peterborough 002B","E01015680","Total",640,211,60,151,429,71,38,87,112,16,36,69
"2011","Peterborough 002C","E01015681","Total",594,128,53,75,466,12,50,127,126,20,25,106
"2011","Peterborough 002D","E01015682","Total",664,224,79,145,440,42,48,99,148,7,24,72
"2011","Peterborough 003A","E01015630","Total",612,132,52,80,480,21,89,83,138,19,32,98
"2011","Peterborough 003B","E01015631","Total",524,103,51,52,421,11,84,99,119,18,20,70
"2011","Peterborough 003C","E01015659","Total",839,233,49,184,606,59,57,143,195,12,50,90
"2011","Peterborough 003D","E01015684","Total",607,134,90,44,473,7,141,64,128,10,36,87
"2011","Peterborough 003E","E01015685","Total",693,158,93,65,535,18,141,83,156,12,35,90
"2011","Peterborough 004A","E01015589","Total",668,148,86,62,520,14,132,99,138,24,48,65
"2011","Peterborough 004B","E01015590","Total",531,152,88,64,379,13,123,60,92,16,28,47
"2011","Peterborough 004C","E01015626","Total",535,81,9,72,454,27,13,175,142,32,17,48
"2011","Peterborough 004D","E01015628","Total",746,166,35,131,580,34,68,142,205,18,28,85
"2011","Peterborough 005A","E01015617","Total",560,155,68,87,405,20,73,74,126,20,21,71
"2011","Peterborough 005B","E01015618","Total",451,109,56,53,342,19,80,61,90,14,30,48
"2011","Peterborough 005C","E01015619","Total",871,260,128,132,611,55,109,122,168,22,58,77
"2011","Peterborough 005D","E01015620","Total",685,153,71,82,532,25,119,115,123,23,32,95
"2011","Peterborough 006A","E01015674","Total",669,237,127,110,432,46,54,87,117,13,35,80
"2011","Peterborough 006B","E01015675","Total",665,178,72,106,487,39,103,87,121,20,37,80
"2011","Peterborough 006C","E01015676","Total",690,229,85,144,461,30,92,82,144,13,32,68
"2011","Peterborough 006D","E01015683","Total",849,254,172,82,595,24,201,84,140,10,32,104
"2011","Peterborough 006E","E01015686","Total",711,217,134,83,494,18,170,68,134,11,19,74
"2011","Peterborough 007A","E01015607","Total",633,235,88,147,398,71,59,76,100,12,28,52
"2011","Peterborough 007B","E01015609","Total",664,188,23,165,476,78,39,103,106,31,59,60
"2011","Peterborough 007C","E01015656","Total",666,227,99,128,439,49,63,78,116,21,36,76
"2011","Peterborough 007D","E01015657","Total",735,201,48,153,534,100,30,103,115,54,48,84
"2011","Peterborough 007E","E01015658","Total",633,224,85,139,409,69,37,76,92,31,44,60
"2011","Peterborough 007F","E01015660","Total",740,280,109,171,460,62,81,93,128,13,26,57
"2011","Peterborough 008A","E01015605","Total",641,203,126,77,438,32,84,78,71,25,73,75
"2011","Peterborough 008B","E01015608","Total",633,191,82,109,442,37,78,74,100,20,40,93
"2011","Peterborough 008C","E01015610","Total",664,212,80,132,452,64,74,81,95,25,37,76
"2011","Peterborough 008D","E01015633","Total",982,326,178,148,656,79,133,123,158,18,43,102
"2011","Peterborough 008E","E01015634","Total",765,291,168,123,474,37,75,79,93,39,50,101
"2011","Peterborough 009A","E01015593","Total",571,175,61,114,396,49,34,86,90,28,32,77
"2011","Peterborough 009B","E01015596","Total",594,139,46,93,455,57,52,82,96,31,64,73
"2011","Peterborough 009C","E01015662","Total",485,80,26,54,405,51,28,74,76,33,49,94
"2011","Peterborough 009D","E01015663","Total",649,257,82,175,392,56,51,81,102,11,38,53
"2011","Peterborough 009E","E01015664","Total",668,191,41,150,477,91,44,107,93,21,44,77
"2011","Peterborough 010A","E01015603","Total",772,215,62,153,557,41,46,95,117,45,113,100
"2011","Peterborough 010B","E01015604","Total",506,66,16,50,440,28,20,75,54,45,123,95
"2011","Peterborough 010C","E01015632","Total",731,203,58,145,528,42,59,88,104,52,66,117
"2011","Peterborough 010D","E01015661","Total",611,166,56,110,445,42,75,91,107,25,38,67
"2011","Peterborough 010E","E01015677","Total",474,158,41,117,316,31,34,80,99,12,16,44
"2011","Peterborough 011A","E01015591","Total",587,125,50,75,462,33,91,58,124,20,39,97
"2011","Peterborough 011B","E01015592","Total",644,189,74,115,455,59,58,84,133,18,35,68
"2011","Peterborough 011C","E01015594","Total",752,244,85,159,508,51,70,105,138,16,48,80
"2011","Peterborough 011D","E01015595","Total",677,272,92,180,405,47,72,77,106,16,33,54
"2011","Peterborough 011E","E01015597","Total",612,174,44,130,438,68,32,97,95,20,49,77
"2011","Peterborough 012A","E01015601","Total",514,92,27,65,422,17,27,53,45,48,158,74
"2011","Peterborough 012B","E01015651","Total",658,131,66,65,527,23,75,75,103,50,103,98
"2011","Peterborough 012C","E01015652","Total",596,116,51,65,480,25,34,64,80,47,116,114
"2011","Peterborough 012D","E01015653","Total",650,159,67,92,491,19,91,61,126,32,67,95
"2011","Peterborough 012E","E01015654","Total",866,293,133,160,573,46,51,117,141,46,86,86
"2011","Peterborough 013A","E01015606","Total",721,195,79,116,526,41,106,77,152,15,46,89
"2011","Peterborough 013B","E01015611","Total",914,349,153,196,565,51,87,97,154,27,67,82
"2011","Peterborough 013C","E01015613","Total",666,208,52,156,458,70,62,106,128,18,30,44
"2011","Peterborough 013D","E01015614","Total",737,189,33,156,548,58,47,144,175,18,39,67
"2011","Peterborough 013E","E01015615","Total",678,226,108,118,452,44,95,74,94,30,42,73
"2011","Peterborough 013F","E01015616","Total",652,216,84,132,436,47,39,92,74,36,76,72
"2011","Peterborough 014A","E01015599","Total",729,285,101,184,444,34,25,75,121,32,74,83
"2011","Peterborough 014B","E01015600","Total",547,153,90,63,394,16,24,52,47,42,104,109
"2011","Peterborough 014C","E01015602","Total",892,402,89,313,490,33,40,80,164,14,57,102
"2011","Peterborough 014D","E01015612","Total",859,283,100,183,576,53,71,100,149,24,80,99
"2011","Peterborough 014E","E01015655","Total",808,246,69,177,562,28,44,98,178,21,71,122
"2011","Peterborough 015A","E01015598","Total",633,150,71,79,483,14,112,74,151,11,32,89
"2011","Peterborough 015B","E01015687","Total",640,154,88,66,486,12,158,52,114,22,50,78
"2011","Peterborough 015C","E01015689","Total",617,146,82,64,471,7,145,63,133,11,43,69
"2011","Peterborough 015D","E01015690","Total",462,92,53,39,370,6,99,49,94,8,49,65
"2011","Peterborough 015E","E01015691","Total",500,128,82,46,372,14,111,42,78,5,52,70
"2011","Peterborough 016A","E01015622","Total",1093,388,116,272,705,62,49,148,283,12,32,119
"2011","Peterborough 016C","E01015665","Total",574,187,78,109,387,17,51,55,73,29,90,72
"2011","Peterborough 016D","E01015688","Total",658,243,81,162,415,22,85,75,151,10,25,47
"2011","Peterborough 016E","E01015692","Total",469,116,34,82,353,19,41,65,78,32,53,65
"2011","Peterborough 016F","E01033173","Total",733,176,17,159,557,38,22,195,166,22,43,71
"2011","Peterborough 016G","E01033182","Total",636,194,46,148,442,73,46,83,129,13,28,70
"2011","Peterborough 017A","E01015621","Total",929,338,84,254,591,50,70,128,229,16,26,72
"2011","Peterborough 017B","E01015623","Total",744,209,71,138,535,35,94,115,152,17,30,92
"2011","Peterborough 017C","E01015624","Total",729,233,51,182,496,39,58,106,182,15,20,76
"2011","Peterborough 017D","E01015666","Total",622,263,108,155,359,28,77,59,103,13,18,61
"2011","Peterborough 017E","E01015668","Total",817,288,91,197,529,65,68,123,163,13,28,69
"2011","Peterborough 018A","E01015627","Total",749,187,102,85,562,23,150,97,154,23,28,87
"2011","Peterborough 018B","E01015644","Total",787,178,34,144,609,47,57,142,208,25,39,91
"2011","Peterborough 018C","E01015645","Total",708,205,77,128,503,20,65,96,185,14,35,88
"2011","Peterborough 018D","E01015646","Total",881,231,119,112,650,14,226,85,183,9,27,106
"2011","Peterborough 018E","E01015648","Total",607,141,85,56,466,2,123,72,137,13,24,95
"2011","Peterborough 019A","E01015667","Total",550,143,69,74,407,20,49,94,124,12,32,76
"2011","Peterborough 019B","E01015669","Total",602,162,85,77,440,18,109,74,104,10,29,96
"2011","Peterborough 019C","E01015670","Total",601,154,89,65,447,16,120,74,101,16,31,89
"2011","Peterborough 019D","E01015671","Total",719,223,110,113,496,28,122,79,146,14,24,83
"2011","Peterborough 019E","E01015672","Total",657,166,80,86,491,21,101,123,123,15,40,68
"2011","Peterborough 019F","E01015673","Total",648,194,88,106,454,53,79,117,106,13,31,55
"2011","Peterborough 021A","E01015637","Total",562,147,34,113,415,51,34,88,106,26,35,75
"2011","Peterborough 021B","E01015639","Total",678,286,70,216,392,54,37,70,95,19,48,69
"2011","Peterborough 021C","E01015640","Total",590,154,40,114,436,32,53,85,139,28,34,65
"2011","Peterborough 021D","E01015641","Total",497,133,49,84,364,43,54,61,96,17,32,61
"2011","Peterborough 021E","E01015642","Total",576,155,37,118,421,66,32,89,100,31,40,63
"2011","Peterborough 021F","E01015647","Total",629,276,131,145,353,54,41,64,82,19,44,49
"2011","Peterborough 022A","E01015638","Total",609,159,108,51,450,19,116,60,124,19,34,78
"2011","Peterborough 022B","E01015650","Total",863,253,75,178,610,30,89,145,197,16,49,84
"2011","Peterborough 022C","E01033174","Total",549,197,70,127,352,74,24,83,101,15,24,31
"2011","Peterborough 022D","E01033179","Total",620,124,45,79,496,63,90,109,129,15,29,61
"2011","Peterborough 022E","E01033181","Total",564,92,11,81,472,47,17,145,143,29,35,56
"2011","Peterborough 023A","E01015643","Total",583,182,46,136,401,32,57,82,118,16,29,67
"2011","Peterborough 023B","E01033175","Total",529,101,17,84,428,37,19,150,108,29,44,41
"2011","Peterborough 023C","E01033176","Total",575,127,11,116,448,50,6,139,143,25,31,54
"2011","Peterborough 023D","E01033177","Total",546,120,10,110,426,46,12,148,140,20,29,31
"2011","Peterborough 023E","E01033178","Total",559,117,9,108,442,96,3,134,96,29,38,46
"2011","Peterborough 023F","E01033180","Total",581,108,4,104,473,76,4,138,134,39,38,44
"2011","Southend-on-Sea 001A","E01015833","Total",623,145,95,50,478,14,118,92,103,13,32,106
"2011","Southend-on-Sea 001B","E01015834","Total",622,160,88,72,462,22,120,86,102,6,30,96
"2011","Southend-on-Sea 001C","E01015835","Total",723,231,126,105,492,51,104,98,105,12,26,96
"2011","Southend-on-Sea 001D","E01015836","Total",635,148,97,51,487,19,138,90,113,12,36,79
"2011","Southend-on-Sea 001E","E01015837","Total",730,233,125,108,497,21,110,112,112,21,32,89
"2011","Southend-on-Sea 001F","E01015838","Total",649,152,104,48,497,9,179,77,101,16,31,84
"2011","Southend-on-Sea 002A","E01015863","Total",999,296,152,144,703,46,107,145,193,25,54,133
"2011","Southend-on-Sea 002B","E01015864","Total",596,176,119,57,420,20,116,66,104,7,32,75
"2011","Southend-on-Sea 002C","E01015865","Total",649,215,118,97,434,12,122,73,107,10,26,84
"2011","Southend-on-Sea 002D","E01015866","Total",669,187,103,84,482,19,130,88,118,13,23,91
"2011","Southend-on-Sea 002E","E01015867","Total",640,205,105,100,435,48,99,70,113,13,24,68
"2011","Southend-on-Sea 002F","E01015868","Total",652,197,83,114,455,32,74,85,114,31,39,80
"2011","Southend-on-Sea 003A","E01015814","Total",624,204,151,53,420,13,98,87,114,19,21,68
"2011","Southend-on-Sea 003B","E01015815","Total",625,140,81,59,485,19,108,104,108,16,38,92
"2011","Southend-on-Sea 003C","E01015816","Total",770,310,182,128,460,14,191,65,112,6,19,53
"2011","Southend-on-Sea 003D","E01015817","Total",730,217,151,66,513,19,193,63,130,15,26,67
"2011","Southend-on-Sea 003E","E01015818","Total",797,270,148,122,527,22,164,86,125,10,30,90
"2011","Southend-on-Sea 003F","E01015819","Total",627,205,94,111,422,40,85,87,98,15,28,69
"2011","Southend-on-Sea 004A","E01015857","Total",663,168,105,63,495,12,156,89,110,13,37,78
"2011","Southend-on-Sea 004B","E01015858","Total",714,178,96,82,536,17,146,106,126,16,43,82
"2011","Southend-on-Sea 004C","E01015859","Total",800,263,142,121,537,23,125,101,124,21,43,100
"2011","Southend-on-Sea 004D","E01015860","Total",626,160,88,72,466,12,113,101,104,17,36,83
"2011","Southend-on-Sea 004E","E01015861","Total",753,317,121,196,436,36,81,93,107,22,35,62
"2011","Southend-on-Sea 004F","E01015862","Total",652,215,71,144,437,45,53,90,113,23,45,68
"2011","Southend-on-Sea 005A","E01015820","Total",613,210,86,124,403,30,64,82,92,30,39,66
"2011","Southend-on-Sea 005B","E01015821","Total",720,251,136,115,469,27,112,82,131,10,34,73
"2011","Southend-on-Sea 005C","E01015822","Total",485,116,62,54,369,11,84,64,74,18,36,82
"2011","Southend-on-Sea 005D","E01015823","Total",673,179,83,96,494,20,90,105,125,26,38,90
"2011","Southend-on-Sea 005E","E01015824","Total",615,161,78,83,454,48,70,88,101,21,43,83
"2011","Southend-on-Sea 005F","E01015825","Total",600,149,85,64,451,8,88,89,100,26,46,94
"2011","Southend-on-Sea 005G","E01015826","Total",573,153,89,64,420,16,102,77,93,17,37,78
"2011","Southend-on-Sea 006A","E01015869","Total",634,158,66,92,476,49,69,95,110,26,45,82
"2011","Southend-on-Sea 006B","E01015870","Total",663,194,71,123,469,30,57,107,114,25,52,84
"2011","Southend-on-Sea 006C","E01015871","Total",657,170,108,62,487,17,111,83,123,17,40,96
"2011","Southend-on-Sea 006D","E01015872","Total",685,201,68,133,484,36,70,115,120,24,38,81
"2011","Southend-on-Sea 006E","E01015873","Total",540,162,60,102,378,35,45,91,97,12,33,65
"2011","Southend-on-Sea 006F","E01015874","Total",716,208,81,127,508,33,83,106,145,17,41,83
"2011","Southend-on-Sea 006G","E01015875","Total",751,298,97,201,453,64,66,92,108,23,24,76
"2011","Southend-on-Sea 007A","E01015901","Total",589,175,44,131,414,46,29,96,125,17,29,72
"2011","Southend-on-Sea 007B","E01015902","Total",647,200,45,155,447,32,37,90,120,41,64,63
"2011","Southend-on-Sea 007C","E01015903","Total",675,204,58,146,471,52,33,123,133,19,31,80
"2011","Southend-on-Sea 007D","E01015904","Total",695,223,60,163,472,39,59,113,126,20,41,74
"2011","Southend-on-Sea 007E","E01015905","Total",583,177,55,122,406,43,51,94,106,17,28,67
"2011","Southend-on-Sea 007F","E01015906","Total",605,158,43,115,447,32,43,92,123,35,33,89
"2011","Southend-on-Sea 007G","E01015907","Total",592,202,56,146,390,34,27,83,110,30,32,74
"2011","Southend-on-Sea 008A","E01015908","Total",647,140,90,50,507,8,111,140,136,25,22,65
"2011","Southend-on-Sea 008B","E01015909","Total",627,197,74,123,430,17,57,103,123,23,35,72
"2011","Southend-on-Sea 008C","E01015910","Total",623,149,85,64,474,14,123,112,112,15,27,71
"2011","Southend-on-Sea 008D","E01015911","Total",511,111,73,38,400,11,103,92,82,18,27,67
"2011","Southend-on-Sea 008E","E01015912","Total",639,185,132,53,454,12,109,100,110,19,34,70
"2011","Southend-on-Sea 008F","E01015913","Total",793,280,122,158,513,32,109,91,174,18,30,59
"2011","Southend-on-Sea 009A","E01015883","Total",566,115,81,34,451,11,150,86,91,18,29,66
"2011","Southend-on-Sea 009B","E01015884","Total",923,309,137,172,614,73,86,130,183,20,45,77
"2011","Southend-on-Sea 009C","E01015885","Total",711,171,124,47,540,15,195,101,111,14,35,69
"2011","Southend-on-Sea 009D","E01015886","Total",638,233,94,139,405,62,66,70,83,29,33,62
"2011","Southend-on-Sea 009E","E01015887","Total",583,144,75,69,439,45,74,82,75,21,56,86
"2011","Southend-on-Sea 009F","E01015888","Total",644,179,118,61,465,11,170,59,93,10,29,93
"2011","Southend-on-Sea 010A","E01015895","Total",1053,533,147,386,520,83,51,85,196,17,22,66
"2011","Southend-on-Sea 010B","E01015896","Total",853,386,113,273,467,60,53,114,116,27,48,49
"2011","Southend-on-Sea 010C","E01015897","Total",884,306,121,185,578,67,76,92,192,26,41,84
"2011","Southend-on-Sea 010D","E01015898","Total",757,300,133,167,457,58,74,95,109,22,44,55
"2011","Southend-on-Sea 010E","E01015899","Total",800,259,71,188,541,43,58,126,153,12,48,101
"2011","Southend-on-Sea 010F","E01015900","Total",618,205,47,158,413,54,25,84,123,15,38,74
"2011","Southend-on-Sea 011A","E01015845","Total",683,200,70,130,483,25,40,148,153,14,23,80
"2011","Southend-on-Sea 011B","E01015846","Total",797,325,120,205,472,20,55,139,152,23,25,58
"2011","Southend-on-Sea 011C","E01015847","Total",797,302,75,227,495,61,46,126,167,16,26,53
"2011","Southend-on-Sea 011D","E01015848","Total",902,439,184,255,463,21,121,74,161,11,17,58
"2011","Southend-on-Sea 011E","E01015849","Total",754,262,79,183,492,41,58,127,161,11,33,61
"2011","Southend-on-Sea 011F","E01015850","Total",675,191,58,133,484,26,69,147,122,22,26,72
"2011","Southend-on-Sea 012A","E01015827","Total",662,224,91,133,438,10,101,74,146,16,30,61
"2011","Southend-on-Sea 012B","E01015828","Total",826,440,70,370,386,27,32,58,180,6,11,72
"2011","Southend-on-Sea 012C","E01015829","Total",643,213,64,149,430,22,52,121,146,12,30,47
"2011","Southend-on-Sea 012D","E01015830","Total",625,145,84,61,480,9,112,113,125,16,40,65
"2011","Southend-on-Sea 012E","E01015831","Total",840,302,44,258,538,41,34,77,195,10,70,111
"2011","Southend-on-Sea 012F","E01015832","Total",773,385,202,183,388,21,99,61,110,13,16,68
"2011","Southend-on-Sea 013A","E01015876","Total",884,194,78,116,690,29,126,152,214,23,43,103
"2011","Southend-on-Sea 013B","E01015877","Total",819,309,118,191,510,46,70,107,167,24,29,67
"2011","Southend-on-Sea 013C","E01015878","Total",581,167,40,127,414,35,47,90,130,9,35,68
"2011","Southend-on-Sea 013D","E01015879","Total",587,181,72,109,406,55,39,94,114,23,31,50
"2011","Southend-on-Sea 013E","E01015880","Total",660,248,97,151,412,55,69,76,100,14,31,67
"2011","Southend-on-Sea 013F","E01015881","Total",566,148,96,52,418,19,94,72,84,17,30,102
"2011","Southend-on-Sea 013G","E01015882","Total",685,205,61,144,480,58,66,96,136,24,39,61
"2011","Southend-on-Sea 014A","E01015839","Total",761,307,93,214,454,58,42,93,126,19,24,92
"2011","Southend-on-Sea 014B","E01015840","Total",714,238,50,188,476,48,35,93,154,36,35,75
"2011","Southend-on-Sea 014C","E01015841","Total",1071,437,62,375,634,81,42,125,222,26,44,94
"2011","Southend-on-Sea 014D","E01015842","Total",905,382,91,291,523,115,49,107,136,18,32,66
"2011","Southend-on-Sea 014E","E01015843","Total",714,245,78,167,469,51,29,100,154,18,37,80
"2011","Southend-on-Sea 014F","E01015844","Total",922,458,180,278,464,35,48,92,175,12,27,75
"2011","Southend-on-Sea 015A","E01015851","Total",1016,591,245,346,425,14,117,49,186,2,7,50
"2011","Southend-on-Sea 015B","E01015852","Total",860,404,115,289,456,46,29,66,197,13,27,78
"2011","Southend-on-Sea 015C","E01015853","Total",907,419,160,259,488,21,80,93,203,7,14,70
"2011","Southend-on-Sea 015D","E01015854","Total",748,211,48,163,537,57,37,107,164,14,43,115
"2011","Southend-on-Sea 015E","E01015855","Total",888,330,77,253,558,56,72,100,177,25,49,79
"2011","Southend-on-Sea 015F","E01015856","Total",780,291,60,231,489,35,49,89,184,23,28,81
"2011","Southend-on-Sea 016A","E01015889","Total",610,166,120,46,444,7,174,54,73,19,42,75
"2011","Southend-on-Sea 016B","E01015890","Total",626,164,101,63,462,10,139,68,95,16,52,82
"2011","Southend-on-Sea 016C","E01015891","Total",658,246,103,143,412,31,76,73,131,11,30,60
"2011","Southend-on-Sea 016D","E01015892","Total",636,126,60,66,510,19,73,134,127,25,46,86
"2011","Southend-on-Sea 016E","E01015893","Total",793,279,238,41,514,5,243,54,111,4,22,75
"2011","Southend-on-Sea 016F","E01015894","Total",598,140,82,58,458,11,118,90,95,12,52,80
"2011","Southend-on-Sea 017A","E01015914","Total",502,55,34,21,447,9,123,75,91,17,38,94
"2011","Southend-on-Sea 017B","E01015915","Total",621,162,90,72,459,22,129,72,99,12,34,91
"2011","Southend-on-Sea 017C","E01015916","Total",544,134,47,87,410,67,50,72,71,43,43,64
"2011","Southend-on-Sea 017D","E01015917","Total",622,171,67,104,451,60,48,77,97,31,62,76
"2011","Southend-on-Sea 017E","E01015918","Total",531,134,56,78,397,34,51,88,93,15,51,65
"2011","Southend-on-Sea 017F","E01015919","Total",505,118,69,49,387,17,84,89,78,14,50,55
"2011","Southend-on-Sea 017G","E01015920","Total",638,155,109,46,483,13,161,76,98,12,27,96
"2011","Thurrock 001A","E01015943","Total",601,142,80,62,459,25,104,73,101,11,33,112
"2011","Thurrock 001B","E01015944","Total",525,129,99,30,396,8,135,73,66,8,17,89
"2011","Thurrock 001C","E01015946","Total",624,141,77,64,483,20,91,87,141,23,25,96
"2011","Thurrock 001D","E01015997","Total",503,59,28,31,444,9,72,73,125,14,35,116
"2011","Thurrock 001E","E01015999","Total",490,58,25,33,432,14,64,93,108,22,36,95
"2011","Thurrock 002A","E01015945","Total",490,113,82,31,377,17,98,56,84,13,23,86
"2011","Thurrock 002B","E01015983","Total",624,171,98,73,453,19,134,72,79,11,30,108
"2011","Thurrock 002C","E01015987","Total",576,123,77,46,453,45,82,94,97,12,41,82
"2011","Thurrock 002D","E01015988","Total",610,226,150,76,384,48,56,77,74,16,30,83
"2011","Thurrock 002E","E01015998","Total",595,105,51,54,490,14,101,118,89,12,41,115
"2011","Thurrock 003A","E01015984","Total",488,71,37,34,417,13,89,73,98,19,32,93
"2011","Thurrock 003B","E01015985","Total",636,190,137,53,446,11,175,79,88,9,23,61
"2011","Thurrock 003C","E01015986","Total",620,188,93,95,432,39,66,80,110,23,45,69
"2011","Thurrock 003D","E01015990","Total",581,158,89,69,423,16,65,64,103,20,50,105
"2011","Thurrock 003E","E01016001","Total",513,92,50,42,421,18,70,97,106,16,24,90
"2011","Thurrock 004A","E01015977","Total",728,156,80,76,572,26,123,139,149,19,39,77
"2011","Thurrock 004B","E01015978","Total",491,87,42,45,404,6,100,61,95,14,37,91
"2011","Thurrock 004C","E01015979","Total",528,99,23,76,429,14,50,118,134,12,35,66
"2011","Thurrock 004D","E01015980","Total",623,126,63,63,497,13,117,84,119,21,46,97
"2011","Thurrock 005A","E01015989","Total",672,228,68,160,444,28,51,111,135,18,35,66
"2011","Thurrock 005B","E01015991","Total",585,125,76,49,460,23,103,82,128,12,26,86
"2011","Thurrock 005C","E01015992","Total",784,212,87,125,572,56,79,117,145,22,45,108
"2011","Thurrock 005D","E01016000","Total",600,156,53,103,444,28,77,102,114,8,25,90
"2011","Thurrock 005E","E01016002","Total",521,72,33,39,449,12,87,77,124,11,30,108
"2011","Thurrock 006A","E01015932","Total",569,110,53,57,459,34,64,93,95,25,54,94
"2011","Thurrock 006B","E01015971","Total",681,267,105,162,414,31,60,103,119,10,26,65
"2011","Thurrock 006C","E01015972","Total",697,222,133,89,475,26,74,88,102,23,64,98
"2011","Thurrock 006D","E01015973","Total",696,212,87,125,484,46,58,124,106,32,44,74
"2011","Thurrock 006E","E01015974","Total",557,121,37,84,436,15,59,109,136,18,32,67
"2011","Thurrock 006F","E01015975","Total",627,167,53,114,460,21,74,105,123,22,39,76
"2011","Thurrock 007A","E01015927","Total",663,164,77,87,499,55,47,115,84,37,74,87
"2011","Thurrock 007B","E01015928","Total",653,163,77,86,490,35,71,103,94,25,49,113
"2011","Thurrock 007C","E01015929","Total",654,255,90,165,399,49,40,71,111,26,46,56
"2011","Thurrock 007D","E01015930","Total",664,160,59,101,504,35,57,121,106,27,55,103
"2011","Thurrock 007E","E01015931","Total",663,336,27,309,327,53,19,95,84,17,23,36
"2011","Thurrock 007F","E01015976","Total",785,294,67,227,491,72,49,117,117,17,28,91
"2011","Thurrock 008A","E01015922","Total",591,170,100,70,421,30,61,59,96,29,51,95
"2011","Thurrock 008B","E01015923","Total",653,215,67,148,438,35,44,94,125,20,42,78
"2011","Thurrock 008C","E01015924","Total",600,165,67,98,435,37,52,92,87,28,45,94
"2011","Thurrock 008D","E01015925","Total",624,157,78,79,467,19,92,84,113,19,48,92
"2011","Thurrock 008E","E01015926","Total",658,234,122,112,424,20,76,89,106,18,38,77
"2011","Thurrock 009A","E01015957","Total",593,177,128,49,416,22,56,88,86,31,43,90
"2011","Thurrock 009B","E01015958","Total",480,98,48,50,382,25,62,72,65,11,43,104
"2011","Thurrock 009C","E01015993","Total",646,200,150,50,446,27,93,82,77,18,43,106
"2011","Thurrock 009D","E01015994","Total",643,200,146,54,443,23,107,91,76,25,40,81
"2011","Thurrock 009E","E01015995","Total",615,98,62,36,517,8,121,80,104,19,49,136
"2011","Thurrock 009F","E01015996","Total",622,170,110,60,452,25,82,91,76,23,63,92
"2011","Thurrock 010A","E01015963","Total",494,146,60,86,348,54,48,100,67,14,22,43
"2011","Thurrock 010B","E01015964","Total",598,137,91,46,461,13,103,86,85,15,45,114
"2011","Thurrock 010C","E01015965","Total",597,150,97,53,447,6,117,76,105,14,27,102
"2011","Thurrock 010D","E01015966","Total",630,126,93,33,504,10,141,91,109,10,36,107
"2011","Thurrock 012A","E01015933","Total",635,202,108,94,433,17,75,95,108,15,36,87
"2011","Thurrock 012B","E01015934","Total",523,107,43,64,416,46,58,75,74,34,51,78
"2011","Thurrock 012C","E01015935","Total",607,159,79,80,448,37,75,64,80,29,58,105
"2011","Thurrock 012D","E01015936","Total",686,209,139,70,477,24,117,81,84,22,45,104
"2011","Thurrock 012E","E01015937","Total",688,189,109,80,499,14,149,68,108,13,33,114
"2011","Thurrock 012F","E01015938","Total",796,224,110,114,572,121,95,141,89,13,42,71
"2011","Thurrock 013A","E01015947","Total",548,126,23,103,422,42,37,102,123,17,34,67
"2011","Thurrock 013B","E01015948","Total",605,162,49,113,443,34,49,100,114,18,36,92
"2011","Thurrock 013C","E01015949","Total",612,99,26,73,513,33,45,130,125,24,45,111
"2011","Thurrock 013D","E01015950","Total",682,140,47,93,542,21,99,98,157,13,46,108
"2011","Thurrock 014A","E01015960","Total",544,128,92,36,416,7,87,72,69,18,44,119
"2011","Thurrock 014B","E01015967","Total",591,123,55,68,468,21,76,96,121,20,35,99
"2011","Thurrock 014C","E01015968","Total",607,212,99,113,395,20,59,82,111,8,30,85
"2011","Thurrock 014D","E01015969","Total",766,258,128,130,508,32,102,102,138,20,34,80
"2011","Thurrock 014E","E01015970","Total",491,99,49,50,392,16,59,100,86,17,28,86
"2011","Thurrock 015A","E01015921","Total",548,213,38,175,335,34,28,96,118,10,18,31
"2011","Thurrock 015B","E01016011","Total",677,225,27,198,452,54,23,106,163,19,27,60
"2011","Thurrock 015C","E01016012","Total",928,193,59,134,735,74,51,169,197,46,71,127
"2011","Thurrock 015D","E01016013","Total",1015,381,28,353,634,75,20,175,241,21,29,73
"2011","Thurrock 015E","E01016014","Total",1009,295,38,257,714,121,17,194,218,46,59,59
"2011","Thurrock 015F","E01016015","Total",606,101,32,69,505,26,56,107,113,27,59,117
"2011","Thurrock 016A","E01015955","Total",641,182,41,141,459,29,41,127,153,15,30,64
"2011","Thurrock 016B","E01015956","Total",807,230,51,179,577,45,40,134,183,16,49,110
"2011","Thurrock 016C","E01015959","Total",634,178,67,111,456,27,51,67,123,28,55,105
"2011","Thurrock 016D","E01015961","Total",617,192,69,123,425,25,65,91,111,22,40,71
"2011","Thurrock 016E","E01015962","Total",621,162,53,109,459,50,31,116,117,27,42,76
"2011","Thurrock 017A","E01015951","Total",657,139,20,119,518,78,40,138,138,14,42,68
"2011","Thurrock 017B","E01015952","Total",818,252,37,215,566,65,21,150,160,34,64,72
"2011","Thurrock 017C","E01015953","Total",1002,384,33,351,618,67,38,158,241,17,38,59
"2011","Thurrock 017D","E01015954","Total",989,331,74,257,658,118,36,154,185,32,51,82
"2011","Thurrock 018A","E01016003","Total",774,238,57,181,536,52,47,116,137,39,37,108
"2011","Thurrock 018B","E01016004","Total",677,219,116,103,458,80,59,80,90,28,35,86
"2011","Thurrock 018C","E01016005","Total",553,106,36,70,447,46,34,92,101,32,43,99
"2011","Thurrock 018D","E01016006","Total",648,194,54,140,454,127,25,114,58,39,31,60
"2011","Thurrock 018E","E01016007","Total",522,102,55,47,420,29,50,73,78,33,39,118
"2011","Thurrock 018F","E01016008","Total",592,157,28,129,435,42,38,95,113,26,38,83
"2011","Thurrock 018G","E01016009","Total",652,163,57,106,489,46,58,96,115,34,38,102
"2011","Thurrock 018H","E01016010","Total",503,111,55,56,392,52,40,71,71,29,56,73
"2011","Thurrock 019A","E01015982","Total",895,137,8,129,758,42,21,278,224,47,69,77
"2011","Thurrock 019B","E01033610","Total",563,93,0,93,470,34,9,177,135,33,42,40
"2011","Thurrock 019C","E01033611","Total",637,135,5,130,502,42,9,163,193,18,38,39
"2011","Thurrock 019D","E01033613","Total",585,129,14,115,456,31,17,162,141,19,38,48
"2011","Thurrock 020A","E01015939","Total",557,119,21,98,438,14,30,141,112,23,47,71
"2011","Thurrock 020B","E01015941","Total",513,92,9,83,421,21,27,151,108,27,38,49
"2011","Thurrock 020C","E01015942","Total",563,111,23,88,452,22,35,122,115,41,36,81
"2011","Thurrock 020D","E01033612","Total",595,139,17,122,456,28,14,137,145,20,53,59
"2011","Thurrock 020E","E01033614","Total",613,87,19,68,526,18,22,224,109,35,47,71
"2011","Cambridge 001A","E01017975","Total",687,259,86,173,428,40,71,89,97,18,39,74
"2011","Cambridge 001B","E01017976","Total",636,137,43,94,499,14,55,70,167,23,35,135
"2011","Cambridge 001C","E01017977","Total",769,302,57,245,467,51,49,98,157,11,27,74
"2011","Cambridge 001D","E01017978","Total",657,227,81,146,430,47,52,73,115,21,32,90
"2011","Cambridge 001E","E01017979","Total",671,259,58,201,412,49,29,75,123,13,35,88
"2011","Cambridge 001F","E01017980","Total",498,155,38,117,343,17,58,70,113,4,19,62
"2011","Cambridge 002A","E01017949","Total",683,228,46,182,455,19,39,77,169,7,23,121
"2011","Cambridge 002B","E01017950","Total",568,196,58,138,372,11,39,67,123,16,15,101
"2011","Cambridge 002C","E01017951","Total",660,233,67,166,427,16,73,88,122,12,25,91
"2011","Cambridge 002D","E01017952","Total",684,275,89,186,409,41,70,85,99,14,27,73
"2011","Cambridge 002E","E01017953","Total",690,254,99,155,436,18,90,61,97,19,37,114
"2011","Cambridge 002F","E01017954","Total",601,169,84,85,432,28,96,94,86,11,37,80
"2011","Cambridge 003B","E01017971","Total",666,204,58,146,462,41,54,78,134,23,43,89
"2011","Cambridge 003C","E01017972","Total",676,198,57,141,478,15,91,80,143,21,40,88
"2011","Cambridge 003D","E01017973","Total",729,241,83,158,488,27,81,81,161,18,35,85
"2011","Cambridge 003E","E01017974","Total",694,181,73,108,513,23,64,88,144,26,37,131
"2011","Cambridge 003F","E01032792","Total",617,225,42,183,392,21,39,94,158,12,12,56
"2011","Cambridge 003G","E01032802","Total",656,298,107,191,358,14,39,53,150,14,13,75
"2011","Cambridge 004A","E01018006","Total",773,286,117,169,487,7,54,73,220,16,17,100
"2011","Cambridge 004B","E01018007","Total",585,91,47,44,494,6,93,102,113,26,34,120
"2011","Cambridge 004C","E01018008","Total",654,192,70,122,462,10,65,97,135,30,22,103
"2011","Cambridge 004D","E01018009","Total",833,336,67,269,497,22,43,82,184,13,25,128
"2011","Cambridge 004E","E01018010","Total",884,423,68,355,461,7,76,94,184,11,19,70
"2011","Cambridge 005A","E01017955","Total",647,191,105,86,456,7,97,81,148,11,21,91
"2011","Cambridge 005B","E01017956","Total",536,176,58,118,360,4,75,81,87,15,20,78
"2011","Cambridge 005C","E01017957","Total",507,177,48,129,330,2,43,64,125,8,10,78
"2011","Cambridge 005D","E01017958","Total",392,223,81,142,169,9,17,36,72,6,6,23
"2011","Cambridge 006A","E01017943","Total",740,239,35,204,501,16,41,108,188,12,19,117
"2011","Cambridge 006B","E01017944","Total",575,159,49,110,416,36,44,92,118,13,26,87
"2011","Cambridge 006C","E01017945","Total",768,262,58,204,506,23,45,107,194,11,31,95
"2011","Cambridge 006D","E01017946","Total",643,199,80,119,444,44,50,68,117,30,40,95
"2011","Cambridge 006E","E01017947","Total",682,186,76,110,496,33,89,75,128,24,36,111
"2011","Cambridge 006F","E01017948","Total",698,224,77,147,474,57,31,116,138,16,40,76
"2011","Cambridge 007C","E01017983","Total",906,333,136,197,573,9,78,104,258,14,13,97
"2011","Cambridge 007D","E01017984","Total",701,218,85,133,483,4,97,98,153,16,29,86
"2011","Cambridge 007E","E01017985","Total",706,219,128,91,487,13,80,128,137,24,29,76
"2011","Cambridge 007F","E01017986","Total",304,123,52,71,181,12,51,28,51,5,10,24
"2011","Cambridge 007G","E01032797","Total",755,361,99,262,394,11,46,52,167,9,14,95
"2011","Cambridge 008A","E01017987","Total",678,251,44,207,427,12,45,71,132,22,19,126
"2011","Cambridge 008B","E01017988","Total",557,146,31,115,411,2,36,72,116,16,22,147
"2011","Cambridge 008C","E01017989","Total",933,327,69,258,606,26,23,114,266,16,27,134
"2011","Cambridge 008D","E01017990","Total",598,210,35,175,388,14,25,84,192,5,11,57
"2011","Cambridge 008E","E01017991","Total",600,298,105,193,302,18,35,50,122,7,11,59
"2011","Cambridge 009A","E01017997","Total",957,281,70,211,676,20,68,105,246,23,43,171
"2011","Cambridge 009B","E01017998","Total",720,206,60,146,514,11,21,85,218,9,18,152
"2011","Cambridge 009C","E01017999","Total",696,209,77,132,487,15,47,86,137,21,38,143
"2011","Cambridge 009D","E01018000","Total",725,227,36,191,498,9,30,100,178,8,14,159
"2011","Cambridge 009E","E01018001","Total",759,252,70,182,507,8,32,94,217,6,15,135
"2011","Cambridge 010A","E01017965","Total",745,301,132,169,444,24,66,90,124,17,16,107
"2011","Cambridge 010B","E01017966","Total",1107,387,87,300,720,27,60,108,311,23,44,147
"2011","Cambridge 010C","E01017967","Total",650,172,68,104,478,27,66,89,107,20,44,125
"2011","Cambridge 010D","E01017968","Total",668,228,125,103,440,3,77,91,103,11,33,122
"2011","Cambridge 010E","E01017969","Total",618,199,75,124,419,15,44,103,101,24,42,90
"2011","Cambridge 011A","E01017959","Total",686,188,84,104,498,16,75,101,121,13,37,135
"2011","Cambridge 011B","E01017960","Total",555,161,81,80,394,50,54,72,102,20,34,62
"2011","Cambridge 011C","E01017961","Total",583,241,111,130,342,34,36,74,118,5,24,51
"2011","Cambridge 011D","E01017962","Total",662,175,76,99,487,24,86,113,128,14,33,89
"2011","Cambridge 011E","E01017963","Total",678,212,90,122,466,35,82,90,122,20,37,80
"2011","Cambridge 011F","E01017964","Total",512,96,56,40,416,5,97,87,90,10,41,86
"2011","Cambridge 012A","E01018002","Total",754,302,114,188,452,11,64,105,159,17,20,76
"2011","Cambridge 012B","E01018003","Total",621,156,71,85,465,17,84,98,110,22,41,93
"2011","Cambridge 012D","E01018005","Total",772,361,80,281,411,26,68,70,136,10,17,84
"2011","Cambridge 012E","E01032794","Total",644,271,125,146,373,7,105,57,125,13,23,43
"2011","Cambridge 012F","E01032795","Total",681,258,40,218,423,27,27,96,169,17,23,64
"2011","Cambridge 013A","E01017992","Total",727,211,123,88,516,16,78,98,120,34,56,114
"2011","Cambridge 013B","E01017993","Total",967,460,71,389,507,7,113,79,140,22,51,95
"2011","Cambridge 013C","E01017994","Total",640,157,90,67,483,32,92,94,83,19,45,118
"2011","Cambridge 013D","E01017995","Total",563,109,76,33,454,1,140,79,91,21,46,76
"2011","Cambridge 013E","E01017996","Total",527,137,60,77,390,2,62,85,114,21,23,83
"2011","East Cambridgeshire 001A","E01018042","Total",643,193,124,69,450,21,114,88,122,13,26,66
"2011","East Cambridgeshire 001B","E01018043","Total",836,200,102,98,636,38,130,142,167,22,45,92
"2011","East Cambridgeshire 001C","E01018044","Total",744,217,89,128,527,28,102,95,165,14,39,84
"2011","East Cambridgeshire 001D","E01018045","Total",526,118,33,85,408,22,52,86,132,16,28,72
"2011","East Cambridgeshire 001E","E01018046","Total",835,220,108,112,615,42,84,179,147,34,40,89
"2011","East Cambridgeshire 002A","E01018020","Total",586,114,53,61,472,7,68,80,161,21,37,98
"2011","East Cambridgeshire 002B","E01018021","Total",595,131,73,58,464,13,88,97,133,20,38,75
"2011","East Cambridgeshire 002C","E01018022","Total",592,135,73,62,457,17,109,85,128,17,19,82
"2011","East Cambridgeshire 002D","E01018055","Total",849,184,84,100,665,16,144,136,204,18,37,110
"2011","East Cambridgeshire 002E","E01018056","Total",792,203,84,119,589,33,103,154,172,21,30,76
"2011","East Cambridgeshire 003A","E01018027","Total",736,206,110,96,530,16,136,129,140,21,26,62
"2011","East Cambridgeshire 003C","E01018029","Total",1105,313,89,224,792,29,92,218,296,30,31,96
"2011","East Cambridgeshire 003D","E01018032","Total",1034,265,130,135,769,25,159,182,210,28,51,114
"2011","East Cambridgeshire 003E","E01018033","Total",911,320,166,154,591,24,165,102,160,19,23,98
"2011","East Cambridgeshire 003F","E01033426","Total",514,63,27,36,451,19,48,169,114,33,29,39
"2011","East Cambridgeshire 003G","E01033430","Total",597,142,69,73,455,50,78,108,102,23,34,60
"2011","East Cambridgeshire 004A","E01018024","Total",515,177,96,81,338,4,94,57,111,11,23,38
"2011","East Cambridgeshire 004B","E01018025","Total",722,333,152,181,389,14,71,71,178,7,10,38
"2011","East Cambridgeshire 004C","E01018026","Total",662,208,93,115,454,15,125,70,157,8,11,68
"2011","East Cambridgeshire 004D","E01018030","Total",416,106,47,59,310,21,69,60,76,12,24,48
"2011","East Cambridgeshire 004F","E01033425","Total",700,104,20,84,596,34,47,224,164,44,34,49
"2011","East Cambridgeshire 004G","E01033428","Total",627,184,52,132,443,13,70,112,154,19,28,47
"2011","East Cambridgeshire 005A","E01018036","Total",714,216,110,106,498,21,104,117,137,17,35,67
"2011","East Cambridgeshire 005B","E01018037","Total",542,88,45,43,454,14,79,88,150,20,24,79
"2011","East Cambridgeshire 005C","E01018038","Total",616,117,58,59,499,13,110,125,135,18,41,57
"2011","East Cambridgeshire 005D","E01018039","Total",533,122,75,47,411,16,101,80,101,18,29,66
"2011","East Cambridgeshire 005E","E01018053","Total",697,177,87,90,520,11,101,100,147,23,36,102
"2011","East Cambridgeshire 005F","E01018054","Total",922,207,83,124,715,26,148,157,212,25,51,96
"2011","East Cambridgeshire 006A","E01018047","Total",768,187,92,95,581,34,94,126,159,19,46,103
"2011","East Cambridgeshire 006C","E01018049","Total",677,167,85,82,510,17,84,121,157,15,36,80
"2011","East Cambridgeshire 006D","E01018050","Total",549,124,47,77,425,18,57,98,121,19,32,80
"2011","East Cambridgeshire 006E","E01018051","Total",687,158,80,78,529,23,107,124,139,13,30,93
"2011","East Cambridgeshire 006F","E01018052","Total",808,264,122,142,544,21,95,107,189,17,24,91
"2011","East Cambridgeshire 006G","E01033427","Total",482,87,8,79,395,32,12,138,113,20,32,48
"2011","East Cambridgeshire 006H","E01033429","Total",811,203,60,143,608,25,88,143,196,17,36,103
"2011","East Cambridgeshire 007A","E01018034","Total",616,133,66,67,483,12,86,109,130,21,29,96
"2011","East Cambridgeshire 007B","E01018035","Total",965,280,121,159,685,33,141,138,205,26,36,106
"2011","East Cambridgeshire 007C","E01018040","Total",502,103,46,57,399,5,86,95,107,13,29,64
"2011","East Cambridgeshire 007D","E01018041","Total",451,121,57,64,330,14,67,69,83,17,29,51
"2011","East Cambridgeshire 008A","E01018013","Total",739,196,127,69,543,17,156,119,116,15,38,82
"2011","East Cambridgeshire 008B","E01018014","Total",747,203,79,124,544,22,105,154,141,23,31,68
"2011","East Cambridgeshire 008C","E01018015","Total",563,150,61,89,413,18,77,90,113,15,32,68
"2011","East Cambridgeshire 008D","E01018016","Total",582,177,95,82,405,24,72,91,90,26,28,74
"2011","East Cambridgeshire 009A","E01018011","Total",1003,216,99,117,787,17,188,167,198,30,53,134
"2011","East Cambridgeshire 009B","E01018012","Total",563,139,77,62,424,24,106,87,105,16,30,56
"2011","East Cambridgeshire 009C","E01018057","Total",827,208,110,98,619,19,137,135,163,23,33,109
"2011","East Cambridgeshire 011A","E01018017","Total",599,210,124,86,389,16,108,63,110,19,18,55
"2011","East Cambridgeshire 011B","E01018019","Total",444,118,64,54,326,6,84,62,98,14,17,45
"2011","East Cambridgeshire 011C","E01018023","Total",919,219,89,130,700,31,126,162,204,21,47,109
"2011","East Cambridgeshire 011D","E01032611","Total",751,167,76,91,584,14,125,120,181,20,27,97
"2011","Fenland 001A","E01018094","Total",778,225,131,94,553,41,178,72,127,21,26,88
"2011","Fenland 001B","E01018095","Total",656,135,79,56,521,27,159,83,136,10,22,84
"2011","Fenland 001C","E01018096","Total",730,221,119,102,509,12,164,75,154,11,30,63
"2011","Fenland 001D","E01018097","Total",611,149,81,68,462,18,121,58,151,5,32,77
"2011","Fenland 002A","E01018063","Total",950,290,108,182,660,62,102,125,176,25,57,113
"2011","Fenland 002B","E01018073","Total",926,248,133,115,678,25,149,99,180,23,70,132
"2011","Fenland 002C","E01018107","Total",641,160,80,80,481,48,72,86,94,25,58,98
"2011","Fenland 002D","E01018108","Total",776,196,78,118,580,56,102,131,106,30,62,93
"2011","Fenland 002E","E01018109","Total",773,215,87,128,558,54,117,95,151,24,40,77
"2011","Fenland 003A","E01018069","Total",744,177,106,71,567,27,131,108,150,15,38,98
"2011","Fenland 003B","E01018070","Total",748,259,82,177,489,57,57,96,127,15,45,92
"2011","Fenland 003C","E01018071","Total",787,286,159,127,501,32,134,85,112,16,33,89
"2011","Fenland 003E","E01018093","Total",1008,309,153,156,699,40,138,119,178,30,51,143
"2011","Fenland 003F","E01018103","Total",469,156,65,91,313,32,31,70,60,12,43,65
"2011","Fenland 003G","E01018104","Total",511,141,77,64,370,10,82,56,96,8,38,80
"2011","Fenland 003H","E01033111","Total",656,217,120,97,439,26,117,65,122,8,26,75
"2011","Fenland 003I","E01033112","Total",594,304,146,158,290,18,41,41,96,3,22,69
"2011","Fenland 004A","E01018066","Total",636,177,98,79,459,22,137,68,124,16,27,65
"2011","Fenland 004B","E01018067","Total",764,179,85,94,585,41,143,98,172,17,39,75
"2011","Fenland 004C","E01018068","Total",594,122,62,60,472,18,93,81,142,16,37,85
"2011","Fenland 004D","E01018090","Total",740,167,94,73,573,35,144,75,174,28,31,86
"2011","Fenland 004E","E01018091","Total",588,154,53,101,434,12,86,66,139,19,38,74
"2011","Fenland 004F","E01018092","Total",728,199,107,92,529,38,124,85,139,14,41,88
"2011","Fenland 005A","E01018081","Total",579,126,64,62,453,24,104,82,97,25,36,85
"2011","Fenland 005B","E01018082","Total",811,222,126,96,589,31,143,104,148,17,42,104
"2011","Fenland 005C","E01018083","Total",772,199,87,112,573,53,83,136,140,34,50,77
"2011","Fenland 005D","E01018084","Total",904,255,129,126,649,39,197,92,177,23,38,83
"2011","Fenland 006A","E01018064","Total",836,220,117,103,616,46,118,111,164,17,40,120
"2011","Fenland 006B","E01018072","Total",669,139,63,76,530,55,104,85,126,22,41,97
"2011","Fenland 006C","E01018074","Total",522,132,80,52,390,22,91,59,106,16,21,75
"2011","Fenland 006D","E01018075","Total",525,158,94,64,367,41,91,61,68,12,29,65
"2011","Fenland 006E","E01018098","Total",593,197,116,81,396,13,118,73,110,10,16,56
"2011","Fenland 006F","E01018099","Total",524,112,61,51,412,18,95,72,109,8,25,85
"2011","Fenland 006G","E01018100","Total",600,266,107,159,334,34,57,63,129,9,19,23
"2011","Fenland 006H","E01018101","Total",592,192,69,123,400,22,109,62,109,9,25,64
"2011","Fenland 007A","E01018077","Total",873,352,141,211,521,59,105,83,174,13,27,60
"2011","Fenland 007B","E01018078","Total",805,313,208,105,492,58,158,72,91,14,30,69
"2011","Fenland 007C","E01018079","Total",789,243,170,73,546,24,161,81,157,11,37,75
"2011","Fenland 007D","E01018080","Total",977,234,99,135,743,56,171,134,203,29,42,108
"2011","Fenland 008A","E01018058","Total",700,198,100,98,502,26,125,91,151,10,26,73
"2011","Fenland 008B","E01018059","Total",550,112,48,64,438,19,95,72,142,15,24,71
"2011","Fenland 008C","E01018060","Total",753,165,59,106,588,32,84,115,198,22,43,94
"2011","Fenland 008D","E01018061","Total",506,113,52,61,393,24,61,79,112,18,28,71
"2011","Fenland 009A","E01018085","Total",701,203,114,89,498,25,159,82,106,11,43,72
"2011","Fenland 009B","E01018086","Total",723,198,113,85,525,29,122,92,138,22,34,88
"2011","Fenland 009C","E01018087","Total",941,331,187,144,610,31,167,97,176,15,34,90
"2011","Fenland 009D","E01018088","Total",703,217,139,78,486,23,142,75,124,15,29,78
"2011","Fenland 010A","E01018065","Total",920,239,139,100,681,34,136,110,214,23,50,114
"2011","Fenland 010B","E01018076","Total",866,193,99,94,673,34,129,138,217,28,38,89
"2011","Fenland 010C","E01018111","Total",941,217,125,92,724,35,209,128,200,13,42,97
"2011","Fenland 011A","E01018062","Total",1056,279,142,137,777,44,179,146,217,32,53,106
"2011","Fenland 011B","E01018102","Total",1148,374,133,241,774,69,116,176,239,22,57,95
"2011","Fenland 011C","E01018105","Total",544,201,109,92,343,26,76,61,96,12,23,49
"2011","Fenland 011D","E01018106","Total",693,201,79,122,492,32,107,83,160,15,29,66
"2011","Fenland 011E","E01018110","Total",1096,289,137,152,807,41,187,154,198,31,58,138
"2011","Huntingdonshire 001A","E01018212","Total",679,154,70,84,525,32,106,110,136,22,36,83
"2011","Huntingdonshire 001B","E01018213","Total",741,150,34,116,591,46,76,123,190,20,47,89
"2011","Huntingdonshire 001C","E01018214","Total",798,205,73,132,593,47,77,133,153,24,50,109
"2011","Huntingdonshire 001D","E01018215","Total",559,119,44,75,440,24,81,100,132,14,20,69
"2011","Huntingdonshire 001E","E01018216","Total",934,169,60,109,765,31,104,212,212,35,47,124
"2011","Huntingdonshire 001F","E01018217","Total",737,211,116,95,526,22,127,97,165,11,25,79
"2011","Huntingdonshire 002A","E01018127","Total",633,145,61,84,488,17,107,66,160,25,35,78
"2011","Huntingdonshire 002B","E01018128","Total",511,130,61,69,381,20,107,65,109,8,17,55
"2011","Huntingdonshire 002C","E01018200","Total",637,102,53,49,535,20,112,99,139,16,45,104
"2011","Huntingdonshire 002D","E01018201","Total",600,167,50,117,433,25,57,118,121,20,25,67
"2011","Huntingdonshire 003A","E01018156","Total",678,137,73,64,541,17,137,82,140,15,52,98
"2011","Huntingdonshire 003B","E01018157","Total",795,166,72,94,629,25,104,128,185,29,52,106
"2011","Huntingdonshire 003C","E01018158","Total",844,373,164,209,471,33,88,86,141,15,20,88
"2011","Huntingdonshire 003D","E01018159","Total",553,89,37,52,464,18,74,89,163,11,40,69
"2011","Huntingdonshire 003E","E01018160","Total",689,206,105,101,483,35,95,95,111,17,40,90
"2011","Huntingdonshire 004A","E01018191","Total",473,102,55,47,371,29,78,69,84,17,29,65
"2011","Huntingdonshire 004B","E01018192","Total",556,125,63,62,431,12,93,72,121,11,38,84
"2011","Huntingdonshire 004C","E01018193","Total",492,122,34,88,370,14,76,64,106,11,23,76
"2011","Huntingdonshire 004D","E01018194","Total",581,134,65,69,447,22,87,91,136,9,25,77
"2011","Huntingdonshire 004E","E01018195","Total",539,150,74,76,389,26,59,93,103,20,26,62
"2011","Huntingdonshire 005A","E01018208","Total",674,152,73,79,522,26,109,102,155,19,29,82
"2011","Huntingdonshire 005B","E01018209","Total",598,132,59,73,466,11,94,100,131,20,29,81
"2011","Huntingdonshire 005C","E01018210","Total",592,179,92,87,413,21,63,91,114,13,33,78
"2011","Huntingdonshire 005D","E01018211","Total",689,108,47,61,581,22,146,121,139,21,42,90
"2011","Huntingdonshire 006A","E01018196","Total",510,114,58,56,396,9,97,75,116,8,25,66
"2011","Huntingdonshire 006B","E01018197","Total",656,225,95,130,431,28,62,110,120,12,32,67
"2011","Huntingdonshire 006C","E01018198","Total",674,151,53,98,523,14,99,107,183,28,28,64
"2011","Huntingdonshire 006D","E01018199","Total",604,116,58,58,488,13,94,94,154,9,46,78
"2011","Huntingdonshire 006E","E01018206","Total",714,147,25,122,567,37,35,174,179,36,45,61
"2011","Huntingdonshire 006F","E01018207","Total",617,123,44,79,494,25,99,91,159,16,30,74
"2011","Huntingdonshire 007A","E01018121","Total",513,86,38,48,427,11,93,83,106,17,31,86
"2011","Huntingdonshire 007B","E01018122","Total",494,135,78,57,359,8,98,79,87,11,24,52
"2011","Huntingdonshire 007C","E01018123","Total",641,140,62,78,501,14,82,96,160,14,39,96
"2011","Huntingdonshire 007D","E01018124","Total",766,131,67,64,635,19,127,132,183,31,42,101
"2011","Huntingdonshire 008A","E01018143","Total",692,226,102,124,466,32,95,88,91,26,40,94
"2011","Huntingdonshire 008B","E01018144","Total",565,144,75,69,421,55,42,96,96,31,43,58
"2011","Huntingdonshire 008C","E01018145","Total",481,113,36,77,368,40,36,66,85,22,46,73
"2011","Huntingdonshire 008D","E01018146","Total",764,178,43,135,586,57,38,131,128,30,84,118
"2011","Huntingdonshire 008E","E01018147","Total",579,97,31,66,482,37,36,115,108,35,53,98
"2011","Huntingdonshire 009A","E01018139","Total",571,124,44,80,447,23,55,84,130,20,46,89
"2011","Huntingdonshire 009B","E01018140","Total",507,109,57,52,398,12,93,66,96,11,35,85
"2011","Huntingdonshire 009C","E01018141","Total",682,167,57,110,515,12,116,106,158,16,24,83
"2011","Huntingdonshire 009D","E01018142","Total",626,172,102,70,454,32,143,54,100,22,35,68
"2011","Huntingdonshire 010B","E01018113","Total",583,113,43,70,470,16,109,102,130,22,29,62
"2011","Huntingdonshire 010D","E01018116","Total",492,98,56,42,394,8,84,104,105,17,27,49
"2011","Huntingdonshire 010E","E01018117","Total",761,255,168,87,506,15,164,83,131,14,26,73
"2011","Huntingdonshire 010F","E01018118","Total",787,174,64,110,613,33,88,151,176,29,35,101
"2011","Huntingdonshire 010G","E01033433","Total",808,206,107,99,602,16,165,109,173,21,30,88
"2011","Huntingdonshire 011A","E01018161","Total",578,142,52,90,436,23,61,100,134,10,21,87
"2011","Huntingdonshire 011B","E01018162","Total",619,96,25,71,523,32,70,110,169,17,34,91
"2011","Huntingdonshire 011C","E01018163","Total",597,172,19,153,425,47,23,101,157,21,30,46
"2011","Huntingdonshire 011D","E01018164","Total",534,141,42,99,393,18,56,83,121,14,31,70
"2011","Huntingdonshire 011E","E01018165","Total",557,153,32,121,404,21,65,72,154,17,24,51
"2011","Huntingdonshire 011F","E01018170","Total",601,176,95,81,425,13,114,68,112,17,37,64
"2011","Huntingdonshire 011G","E01018171","Total",586,114,46,68,472,16,106,83,128,13,32,94
"2011","Huntingdonshire 012A","E01018138","Total",924,351,84,267,573,28,88,107,218,18,31,83
"2011","Huntingdonshire 012B","E01018148","Total",896,134,19,115,762,57,57,252,201,33,66,96
"2011","Huntingdonshire 012C","E01018149","Total",539,78,17,61,461,18,39,150,139,15,33,67
"2011","Huntingdonshire 012D","E01018150","Total",665,176,17,159,489,30,34,134,150,25,41,75
"2011","Huntingdonshire 012E","E01018151","Total",905,399,113,286,506,29,55,93,238,14,26,51
"2011","Huntingdonshire 013A","E01018166","Total",652,186,109,77,466,16,122,97,110,22,28,71
"2011","Huntingdonshire 013B","E01018167","Total",584,116,64,52,468,13,119,87,119,15,35,80
"2011","Huntingdonshire 013C","E01018168","Total",1081,573,277,296,508,28,93,80,211,5,21,70
"2011","Huntingdonshire 013D","E01018169","Total",621,146,67,79,475,26,98,79,110,30,36,96
"2011","Huntingdonshire 014A","E01018131","Total",634,182,95,87,452,28,84,93,109,21,35,82
"2011","Huntingdonshire 014B","E01018132","Total",809,344,159,185,465,13,113,81,141,17,20,80
"2011","Huntingdonshire 014C","E01018133","Total",662,166,74,92,496,18,68,127,128,28,39,88
"2011","Huntingdonshire 014D","E01018134","Total",774,214,41,173,560,36,66,138,190,28,42,60
"2011","Huntingdonshire 015A","E01018125","Total",605,120,60,60,485,14,103,89,130,25,46,78
"2011","Huntingdonshire 015B","E01018126","Total",631,109,48,61,522,17,97,108,169,16,38,77
"2011","Huntingdonshire 015C","E01018152","Total",598,113,49,64,485,11,110,111,136,16,32,69
"2011","Huntingdonshire 015D","E01018153","Total",757,197,100,97,560,25,138,114,141,18,47,77
"2011","Huntingdonshire 016A","E01018129","Total",649,165,75,90,484,18,89,92,152,19,29,85
"2011","Huntingdonshire 016B","E01018130","Total",698,165,82,83,533,20,94,133,156,12,27,91
"2011","Huntingdonshire 016C","E01018202","Total",639,170,125,45,469,12,167,80,102,22,15,71
"2011","Huntingdonshire 016D","E01018203","Total",621,187,90,97,434,8,122,79,131,20,16,58
"2011","Huntingdonshire 016E","E01018204","Total",541,90,46,44,451,16,122,88,110,25,34,56
"2011","Huntingdonshire 016F","E01018205","Total",826,214,84,130,612,19,200,86,182,11,25,89
"2011","Huntingdonshire 017A","E01018115","Total",567,154,62,92,413,7,108,81,118,11,19,69
"2011","Huntingdonshire 017B","E01018119","Total",638,137,61,76,501,18,123,88,157,13,27,75
"2011","Huntingdonshire 017C","E01018120","Total",757,235,147,88,522,33,143,106,112,24,33,71
"2011","Huntingdonshire 017D","E01018137","Total",695,139,68,71,556,22,118,127,157,26,25,81
"2011","Huntingdonshire 018A","E01018135","Total",1151,227,55,172,924,85,89,236,320,46,54,94
"2011","Huntingdonshire 018B","E01018136","Total",690,112,58,54,578,14,147,120,161,27,31,78
"2011","Huntingdonshire 018C","E01018154","Total",720,151,73,78,569,25,127,113,161,13,38,92
"2011","Huntingdonshire 018D","E01018155","Total",641,172,69,103,469,12,118,79,149,11,30,70
"2011","Huntingdonshire 019A","E01018187","Total",1022,521,219,302,501,37,94,92,181,15,27,55
"2011","Huntingdonshire 019B","E01018188","Total",634,189,99,90,445,21,92,98,122,17,26,69
"2011","Huntingdonshire 019C","E01018189","Total",502,76,40,36,426,5,109,110,101,13,23,65
"2011","Huntingdonshire 019D","E01018190","Total",627,168,91,77,459,16,99,88,108,27,38,83
"2011","Huntingdonshire 020A","E01018172","Total",625,200,131,69,425,19,123,66,115,15,25,62
"2011","Huntingdonshire 020B","E01018173","Total",509,131,20,111,378,27,37,88,145,10,26,45
"2011","Huntingdonshire 020C","E01018174","Total",689,198,59,139,491,21,103,107,147,10,31,72
"2011","Huntingdonshire 020D","E01018175","Total",549,108,37,71,441,12,94,88,119,17,29,82
"2011","Huntingdonshire 020E","E01018176","Total",484,62,36,26,422,8,115,75,96,18,27,83
"2011","Huntingdonshire 021A","E01018181","Total",1167,323,90,233,844,31,78,226,318,33,60,98
"2011","Huntingdonshire 021B","E01018182","Total",583,122,31,91,461,17,52,102,155,20,37,78
"2011","Huntingdonshire 021C","E01018183","Total",618,154,45,109,464,43,73,87,130,10,35,86
"2011","Huntingdonshire 021D","E01018184","Total",508,129,47,82,379,36,54,74,82,26,48,59
"2011","Huntingdonshire 021E","E01018185","Total",724,215,100,115,509,27,130,85,148,12,29,78
"2011","Huntingdonshire 021F","E01018186","Total",734,201,65,136,533,28,100,120,140,16,34,95
"2011","Huntingdonshire 022A","E01018177","Total",647,156,64,92,491,11,150,81,130,15,25,79
"2011","Huntingdonshire 022B","E01018178","Total",629,186,93,93,443,16,106,91,119,6,31,74
"2011","Huntingdonshire 022C","E01018179","Total",598,180,67,113,418,33,60,87,126,19,27,66
"2011","Huntingdonshire 022D","E01018180","Total",573,185,58,127,388,50,33,83,109,11,30,72
"2011","South Cambridgeshire 001A","E01018304","Total",781,216,103,113,565,31,77,139,184,23,33,78
"2011","South Cambridgeshire 001B","E01018305","Total",539,131,77,54,408,8,94,89,103,16,29,69
"2011","South Cambridgeshire 001C","E01018306","Total",583,107,43,64,476,12,94,127,115,23,31,74
"2011","South Cambridgeshire 001D","E01018307","Total",847,174,76,98,673,13,115,152,188,26,40,139
"2011","South Cambridgeshire 002A","E01018233","Total",658,165,82,83,493,13,103,104,148,15,28,82
"2011","South Cambridgeshire 002B","E01018234","Total",655,145,62,83,510,18,107,104,141,13,39,88
"2011","South Cambridgeshire 002C","E01018235","Total",702,206,115,91,496,19,93,126,120,33,29,76
"2011","South Cambridgeshire 002D","E01018236","Total",643,173,97,76,470,27,89,101,120,23,41,69
"2011","South Cambridgeshire 003A","E01018237","Total",624,150,61,89,474,19,94,100,131,23,23,84
"2011","South Cambridgeshire 003B","E01018266","Total",1095,247,77,170,848,41,143,226,267,30,46,95
"2011","South Cambridgeshire 003C","E01018284","Total",522,133,54,79,389,10,81,84,111,20,26,57
"2011","South Cambridgeshire 003D","E01018285","Total",474,101,49,52,373,19,41,81,127,16,27,62
"2011","South Cambridgeshire 004A","E01018298","Total",493,70,15,55,423,15,30,159,126,26,25,42
"2011","South Cambridgeshire 004B","E01018299","Total",731,224,85,139,507,20,112,117,143,18,24,73
"2011","South Cambridgeshire 004C","E01018300","Total",501,144,74,70,357,9,88,64,104,8,21,63
"2011","South Cambridgeshire 004D","E01018301","Total",565,145,61,84,420,11,82,107,116,9,24,71
"2011","South Cambridgeshire 005A","E01018221","Total",749,235,74,161,514,20,60,105,201,16,38,74
"2011","South Cambridgeshire 005B","E01018222","Total",591,97,50,47,494,12,117,72,131,9,42,111
"2011","South Cambridgeshire 005C","E01018223","Total",799,205,95,110,594,29,110,135,183,17,35,85
"2011","South Cambridgeshire 006A","E01018257","Total",585,192,114,78,393,18,78,87,102,11,34,63
"2011","South Cambridgeshire 006B","E01018258","Total",683,185,118,67,498,13,115,125,129,22,24,70
"2011","South Cambridgeshire 006C","E01018259","Total",534,127,54,73,407,16,71,84,114,14,29,79
"2011","South Cambridgeshire 006D","E01018260","Total",772,269,147,122,503,10,112,93,148,25,23,92
"2011","South Cambridgeshire 006F","E01018262","Total",549,111,61,50,438,14,97,90,105,14,35,83
"2011","South Cambridgeshire 006G","E01033120","Total",530,114,30,84,416,30,27,63,122,22,51,101
"2011","South Cambridgeshire 006H","E01033121","Total",558,108,6,102,450,43,2,122,139,23,39,82
"2011","South Cambridgeshire 007A","E01018272","Total",503,92,37,55,411,9,78,112,106,17,34,55
"2011","South Cambridgeshire 007B","E01018273","Total",683,213,91,122,470,18,99,84,135,17,36,81
"2011","South Cambridgeshire 007C","E01018274","Total",703,166,24,142,537,13,41,155,207,16,28,77
"2011","South Cambridgeshire 007D","E01018297","Total",737,211,80,131,526,20,109,104,169,17,26,81
"2011","South Cambridgeshire 009A","E01018224","Total",591,165,84,81,426,15,98,98,102,23,28,62
"2011","South Cambridgeshire 009B","E01018225","Total",494,167,114,53,327,9,95,53,84,11,19,56
"2011","South Cambridgeshire 009C","E01018248","Total",712,139,52,87,573,16,115,139,157,20,43,83
"2011","South Cambridgeshire 009D","E01018249","Total",453,144,104,40,309,4,85,68,74,7,13,58
"2011","South Cambridgeshire 009E","E01018250","Total",522,163,97,66,359,6,92,74,90,16,33,48
"2011","South Cambridgeshire 010A","E01018231","Total",972,209,79,130,763,21,162,193,185,34,57,111
"2011","South Cambridgeshire 010B","E01018232","Total",948,235,121,114,713,26,182,154,159,34,54,104
"2011","South Cambridgeshire 010C","E01018251","Total",484,110,38,72,374,17,35,89,129,10,28,66
"2011","South Cambridgeshire 010D","E01018252","Total",533,86,35,51,447,18,62,89,124,25,48,81
"2011","South Cambridgeshire 010E","E01018255","Total",458,93,45,48,365,20,103,64,80,16,31,51
"2011","South Cambridgeshire 011A","E01018242","Total",564,177,111,66,387,16,94,75,98,11,27,66
"2011","South Cambridgeshire 011B","E01018243","Total",659,146,36,110,513,22,69,121,138,19,60,84
"2011","South Cambridgeshire 011C","E01018244","Total",662,174,107,67,488,9,145,84,120,17,41,72
"2011","South Cambridgeshire 011D","E01018286","Total",667,192,69,123,475,31,62,110,151,21,42,58
"2011","South Cambridgeshire 011E","E01018287","Total",586,198,34,164,388,14,25,115,150,8,25,51
"2011","South Cambridgeshire 011F","E01018296","Total",464,118,60,58,346,8,96,60,96,15,19,52
"2011","South Cambridgeshire 012A","E01018292","Total",556,127,74,53,429,13,98,94,111,23,24,66
"2011","South Cambridgeshire 012B","E01018293","Total",628,169,116,53,459,14,138,92,102,19,34,60
"2011","South Cambridgeshire 012C","E01018294","Total",844,360,151,209,484,26,116,99,152,15,13,63
"2011","South Cambridgeshire 012D","E01018295","Total",645,144,97,47,501,17,140,96,124,18,33,73
"2011","South Cambridgeshire 013A","E01018245","Total",694,150,87,63,544,13,138,98,151,28,29,87
"2011","South Cambridgeshire 013B","E01018246","Total",714,193,99,94,521,25,134,84,158,15,38,67
"2011","South Cambridgeshire 013C","E01018247","Total",637,135,70,65,502,13,88,97,165,14,34,91
"2011","South Cambridgeshire 013D","E01018275","Total",974,231,139,92,743,21,200,148,199,28,43,104
"2011","South Cambridgeshire 014A","E01018240","Total",483,91,57,34,392,12,106,87,74,15,26,72
"2011","South Cambridgeshire 014B","E01018253","Total",428,83,50,33,345,13,80,65,93,16,22,56
"2011","South Cambridgeshire 014C","E01018254","Total",563,156,83,73,407,11,97,81,111,18,22,67
"2011","South Cambridgeshire 014D","E01018256","Total",626,156,89,67,470,15,127,91,112,25,27,73
"2011","South Cambridgeshire 014E","E01018291","Total",492,114,64,50,378,9,102,90,84,14,28,51
"2011","South Cambridgeshire 015A","E01018279","Total",673,231,144,87,442,20,107,68,126,10,36,75
"2011","South Cambridgeshire 015B","E01018280","Total",611,130,74,56,481,14,101,78,132,13,22,121
"2011","South Cambridgeshire 015C","E01018281","Total",692,205,94,111,487,19,118,92,144,16,24,74
"2011","South Cambridgeshire 015D","E01018282","Total",522,105,47,58,417,13,72,98,124,12,28,70
"2011","South Cambridgeshire 015E","E01018283","Total",494,88,43,45,406,14,74,89,105,12,25,87
"2011","South Cambridgeshire 016A","E01018218","Total",718,145,84,61,573,11,150,114,170,21,36,71
"2011","South Cambridgeshire 016B","E01018219","Total",563,122,72,50,441,15,106,108,105,21,22,64
"2011","South Cambridgeshire 016C","E01018220","Total",596,114,64,50,482,12,106,86,144,18,32,84
"2011","South Cambridgeshire 016D","E01018263","Total",598,153,81,72,445,9,91,100,111,21,30,83
"2011","South Cambridgeshire 016E","E01018264","Total",653,196,105,91,457,26,102,86,103,27,24,89
"2011","South Cambridgeshire 016F","E01018265","Total",703,147,73,74,556,13,125,122,150,31,30,85
"2011","South Cambridgeshire 017A","E01018238","Total",578,136,72,64,442,15,97,98,111,23,24,74
"2011","South Cambridgeshire 017B","E01018239","Total",546,123,60,63,423,13,92,94,114,23,25,62
"2011","South Cambridgeshire 017C","E01018288","Total",494,136,80,56,358,12,94,64,88,13,29,58
"2011","South Cambridgeshire 017D","E01018289","Total",472,119,42,77,353,6,74,72,101,13,27,60
"2011","South Cambridgeshire 017E","E01018302","Total",614,150,43,107,464,8,69,115,142,22,28,80
"2011","South Cambridgeshire 017F","E01018303","Total",511,146,91,55,365,10,87,73,97,23,19,56
"2011","South Cambridgeshire 018A","E01018241","Total",485,120,63,57,365,8,67,82,100,23,18,67
"2011","South Cambridgeshire 018B","E01018267","Total",1003,284,170,114,719,17,182,155,183,27,40,115
"2011","South Cambridgeshire 018C","E01018268","Total",733,125,54,71,608,22,114,145,169,25,41,92
"2011","South Cambridgeshire 018D","E01018269","Total",597,180,103,77,417,26,88,68,129,18,23,65
"2011","South Cambridgeshire 018E","E01018270","Total",445,97,45,52,348,14,78,53,90,16,29,68
"2011","South Cambridgeshire 018F","E01018271","Total",566,178,83,95,388,17,87,79,94,19,28,64
"2011","South Cambridgeshire 019A","E01018226","Total",474,87,25,62,387,18,39,130,105,21,27,47
"2011","South Cambridgeshire 019B","E01018227","Total",747,171,80,91,576,36,96,141,136,23,37,107
"2011","South Cambridgeshire 019C","E01018228","Total",663,147,79,68,516,10,106,117,138,16,40,89
"2011","South Cambridgeshire 019D","E01018290","Total",987,203,99,104,784,28,187,166,215,27,42,119
"2011","South Cambridgeshire 020A","E01033113","Total",452,127,47,80,325,37,29,104,94,24,15,22
"2011","South Cambridgeshire 020B","E01033114","Total",561,119,12,107,442,28,25,148,124,41,42,34
"2011","South Cambridgeshire 020C","E01033115","Total",467,60,6,54,407,26,16,163,102,33,37,30
"2011","South Cambridgeshire 020D","E01033117","Total",468,100,15,85,368,24,10,141,105,30,30,28
"2011","South Cambridgeshire 020E","E01033119","Total",660,121,13,108,539,34,15,213,166,32,32,47
"2011","South Cambridgeshire 021A","E01018276","Total",583,156,66,90,427,18,59,112,122,24,25,67
"2011","South Cambridgeshire 021B","E01018277","Total",709,160,62,98,549,10,127,106,175,23,33,75
"2011","South Cambridgeshire 021C","E01018278","Total",664,152,36,116,512,16,67,146,157,30,41,55
"2011","South Cambridgeshire 021D","E01033116","Total",641,136,66,70,505,13,89,132,129,35,40,67
"2011","South Cambridgeshire 021E","E01033118","Total",575,122,32,90,453,16,60,129,150,19,30,49
"2011","Basildon 001A","E01021237","Total",518,96,54,42,422,5,99,100,80,21,30,87
"2011","Basildon 001B","E01021238","Total",520,67,38,29,453,19,105,104,92,10,35,88
"2011","Basildon 001C","E01021242","Total",482,92,41,51,390,13,66,79,110,11,26,85
"2011","Basildon 001D","E01021250","Total",632,166,84,82,466,8,96,115,115,17,24,91
"2011","Basildon 001E","E01021251","Total",603,114,50,64,489,14,98,117,113,20,32,95
"2011","Basildon 002A","E01021245","Total",638,238,101,137,400,37,61,82,117,19,23,61
"2011","Basildon 002B","E01021246","Total",652,208,129,79,444,7,107,95,118,18,21,78
"2011","Basildon 002C","E01021248","Total",620,186,66,120,434,33,67,110,123,12,20,69
"2011","Basildon 002D","E01021249","Total",622,135,57,78,487,13,104,113,129,24,30,74
"2011","Basildon 002E","E01021252","Total",637,209,86,123,428,21,60,96,146,12,28,65
"2011","Basildon 003A","E01021239","Total",522,61,44,17,461,9,117,100,94,22,38,81
"2011","Basildon 003B","E01021240","Total",787,324,131,193,463,16,83,119,140,14,26,65
"2011","Basildon 003C","E01021241","Total",650,182,98,84,468,40,85,90,114,22,48,69
"2011","Basildon 003D","E01021243","Total",668,149,80,69,519,17,94,123,136,12,37,100
"2011","Basildon 003E","E01021247","Total",657,210,127,83,447,9,132,100,95,13,22,76
"2011","Basildon 004A","E01021244","Total",633,168,104,64,465,15,139,106,117,12,22,54
"2011","Basildon 004B","E01021253","Total",675,129,76,53,546,14,161,121,107,18,36,89
"2011","Basildon 004C","E01021255","Total",632,219,152,67,413,15,127,72,92,8,31,68
"2011","Basildon 004D","E01021256","Total",608,155,116,39,453,5,111,109,106,9,22,91
"2011","Basildon 004E","E01021258","Total",785,346,185,161,439,27,84,102,116,8,23,79
"2011","Basildon 005A","E01021334","Total",690,189,109,80,501,25,137,89,119,12,38,81
"2011","Basildon 005B","E01021336","Total",740,252,154,98,488,18,123,95,125,12,25,90
"2011","Basildon 005C","E01021338","Total",615,159,85,74,456,38,102,98,104,13,25,76
"2011","Basildon 005D","E01021339","Total",649,252,83,169,397,39,82,69,124,14,20,49
"2011","Basildon 006A","E01021264","Total",519,70,42,28,449,8,110,60,96,24,46,105
"2011","Basildon 006B","E01021329","Total",691,272,164,108,419,18,108,68,106,11,26,82
"2011","Basildon 006C","E01021330","Total",656,166,98,68,490,22,123,84,110,14,27,110
"2011","Basildon 006D","E01021332","Total",608,159,97,62,449,10,132,69,112,13,29,84
"2011","Basildon 006E","E01021333","Total",637,132,96,36,505,7,145,77,123,9,32,112
"2011","Basildon 007A","E01021335","Total",515,86,26,60,429,24,53,100,100,12,42,98
"2011","Basildon 007B","E01021337","Total",615,181,118,63,434,8,128,70,99,13,30,86
"2011","Basildon 007C","E01021340","Total",659,164,74,90,495,23,98,95,134,16,35,94
"2011","Basildon 007D","E01021341","Total",653,159,84,75,494,20,115,100,117,19,37,86
"2011","Basildon 007E","E01021345","Total",764,147,28,119,617,31,44,253,188,21,32,48
"2011","Basildon 008A","E01021331","Total",639,180,81,99,459,18,90,86,120,16,33,96
"2011","Basildon 008B","E01021342","Total",714,286,140,146,428,30,68,105,89,19,31,86
"2011","Basildon 008C","E01021343","Total",746,220,32,188,526,59,24,176,173,22,19,53
"2011","Basildon 008D","E01021344","Total",859,179,40,139,680,48,68,193,214,29,53,75
"2011","Basildon 008E","E01021346","Total",856,245,74,171,611,29,76,184,208,14,24,76
"2011","Basildon 009A","E01021254","Total",550,111,73,38,439,4,109,82,86,16,46,96
"2011","Basildon 009B","E01021257","Total",615,152,92,60,463,15,121,83,97,18,39,90
"2011","Basildon 009C","E01021259","Total",636,160,60,100,476,19,101,99,139,13,30,75
"2011","Basildon 009D","E01021260","Total",803,191,79,112,612,14,110,115,152,46,67,108
"2011","Basildon 010A","E01021261","Total",687,179,61,118,508,28,90,101,140,23,48,78
"2011","Basildon 010B","E01021262","Total",747,282,115,167,465,39,68,90,175,11,25,57
"2011","Basildon 010C","E01021263","Total",789,229,41,188,560,56,64,147,180,11,39,63
"2011","Basildon 010D","E01021274","Total",806,286,116,170,520,38,100,91,149,22,38,82
"2011","Basildon 010E","E01021279","Total",662,194,52,142,468,59,50,106,120,19,44,70
"2011","Basildon 011A","E01021301","Total",618,200,71,129,418,64,37,82,95,22,40,78
"2011","Basildon 011B","E01021303","Total",592,209,88,121,383,37,47,73,113,15,23,75
"2011","Basildon 011C","E01021307","Total",586,188,38,150,398,52,32,83,134,10,23,64
"2011","Basildon 011D","E01021308","Total",489,121,19,102,368,14,23,86,103,10,42,90
"2011","Basildon 011E","E01021309","Total",610,218,54,164,392,49,39,79,134,8,24,59
"2011","Basildon 011F","E01021312","Total",559,101,45,56,458,20,96,55,114,13,51,109
"2011","Basildon 012A","E01021265","Total",630,166,73,93,464,42,101,75,90,16,45,95
"2011","Basildon 012B","E01021267","Total",766,280,153,127,486,38,90,82,136,23,34,83
"2011","Basildon 012C","E01021269","Total",653,162,75,87,491,42,76,84,129,33,48,79
"2011","Basildon 012D","E01021270","Total",625,204,66,138,421,36,62,82,99,31,40,71
"2011","Basildon 012E","E01021272","Total",650,172,91,81,478,60,79,96,110,24,39,70
"2011","Basildon 013A","E01021271","Total",685,203,41,162,482,87,42,95,94,36,45,83
"2011","Basildon 013B","E01021302","Total",623,221,62,159,402,78,30,71,94,42,33,54
"2011","Basildon 013C","E01021304","Total",612,202,90,112,410,51,51,69,116,19,26,78
"2011","Basildon 013D","E01021305","Total",613,185,82,103,428,38,72,66,109,20,39,84
"2011","Basildon 013E","E01021306","Total",609,176,69,107,433,43,56,71,114,17,37,95
"2011","Basildon 014A","E01021273","Total",763,276,120,156,487,44,96,80,125,20,30,92
"2011","Basildon 014B","E01021275","Total",676,160,94,66,516,24,96,71,153,9,50,113
"2011","Basildon 014C","E01021276","Total",690,280,99,181,410,29,72,73,131,10,34,61
"2011","Basildon 014D","E01021277","Total",664,254,98,156,410,29,83,86,116,8,20,68
"2011","Basildon 014E","E01021278","Total",790,340,148,192,450,57,56,103,117,19,27,71
"2011","Basildon 015A","E01021266","Total",735,248,131,117,487,43,108,98,111,20,31,76
"2011","Basildon 015B","E01021268","Total",651,291,137,154,360,48,54,76,83,17,18,64
"2011","Basildon 015C","E01021318","Total",925,315,106,209,610,81,97,122,161,13,46,90
"2011","Basildon 015D","E01021320","Total",652,193,55,138,459,46,67,79,109,29,41,88
"2011","Basildon 015E","E01021321","Total",697,246,94,152,451,54,83,86,96,23,44,65
"2011","Basildon 016A","E01021286","Total",706,209,55,154,497,70,42,110,125,22,36,92
"2011","Basildon 016B","E01021288","Total",606,118,29,89,488,128,26,117,65,60,40,52
"2011","Basildon 016C","E01021289","Total",707,174,63,111,533,67,62,120,125,18,45,96
"2011","Basildon 016D","E01021290","Total",669,163,40,123,506,131,44,85,85,28,48,85
"2011","Basildon 016E","E01021291","Total",784,320,113,207,464,48,86,94,118,17,37,64
"2011","Basildon 017A","E01021287","Total",613,161,66,95,452,39,77,104,102,12,41,77
"2011","Basildon 017B","E01021292","Total",632,180,78,102,452,47,103,74,94,18,33,83
"2011","Basildon 017C","E01021293","Total",736,248,97,151,488,34,105,111,117,17,40,64
"2011","Basildon 017D","E01021298","Total",656,182,105,77,474,53,84,78,110,16,40,93
"2011","Basildon 017E","E01021319","Total",717,257,114,143,460,50,65,99,121,12,30,83
"2011","Basildon 018A","E01021313","Total",588,129,61,68,459,14,105,54,117,11,32,126
"2011","Basildon 018B","E01021314","Total",572,184,68,116,388,48,47,78,93,25,25,72
"2011","Basildon 018C","E01021315","Total",679,267,102,165,412,42,80,58,99,26,35,72
"2011","Basildon 018D","E01021316","Total",702,281,137,144,421,54,74,63,114,14,35,67
"2011","Basildon 018E","E01021317","Total",668,202,85,117,466,49,72,77,124,32,38,74
"2011","Basildon 019A","E01021322","Total",627,199,62,137,428,48,55,75,111,24,38,77
"2011","Basildon 019B","E01021323","Total",673,185,76,109,488,84,48,93,101,37,50,75
"2011","Basildon 019C","E01021324","Total",667,205,67,138,462,73,43,88,101,31,46,80
"2011","Basildon 019D","E01021325","Total",642,216,68,148,426,76,49,82,91,30,40,58
"2011","Basildon 019E","E01021327","Total",741,273,125,148,468,53,80,79,106,19,44,87
"2011","Basildon 020A","E01021294","Total",645,151,82,69,494,31,108,83,101,13,48,110
"2011","Basildon 020B","E01021295","Total",705,215,102,113,490,43,99,99,103,24,43,79
"2011","Basildon 020C","E01021296","Total",772,264,105,159,508,47,110,97,111,17,37,89
"2011","Basildon 020D","E01021297","Total",693,218,72,146,475,46,69,105,126,13,30,86
"2011","Basildon 020E","E01021299","Total",600,115,74,41,485,5,135,67,107,7,48,116
"2011","Basildon 021A","E01021280","Total",627,162,30,132,465,25,32,146,159,15,29,59
"2011","Basildon 021B","E01021281","Total",598,137,43,94,461,8,98,79,145,13,25,93
"2011","Basildon 021C","E01021282","Total",619,122,49,73,497,12,126,79,139,14,32,95
"2011","Basildon 021D","E01021283","Total",647,174,47,127,473,45,59,86,130,22,33,98
"2011","Basildon 021E","E01021284","Total",579,119,21,98,460,17,34,146,137,18,39,69
"2011","Basildon 021F","E01021285","Total",532,131,39,92,401,14,39,114,122,14,38,60
"2011","Basildon 022A","E01021300","Total",852,256,88,168,596,62,77,121,153,28,38,117
"2011","Basildon 022B","E01021310","Total",700,315,82,233,385,21,67,68,143,5,16,65
"2011","Basildon 022C","E01021311","Total",613,241,69,172,372,27,74,38,107,15,40,71
"2011","Basildon 022D","E01021326","Total",720,188,62,126,532,53,67,106,152,16,49,89
"2011","Basildon 022E","E01021328","Total",635,172,73,99,463,46,65,93,112,20,34,93
"2011","Braintree 001A","E01021375","Total",473,103,45,58,370,18,75,66,118,17,24,52
"2011","Braintree 001B","E01021376","Total",556,111,65,46,445,8,93,85,130,15,35,79
"2011","Braintree 001C","E01021414","Total",884,190,87,103,694,29,170,102,201,18,48,126
"2011","Braintree 001D","E01021430","Total",836,171,87,84,665,34,136,143,165,30,59,98
"2011","Braintree 002A","E01021398","Total",627,143,73,70,484,19,135,78,123,10,28,91
"2011","Braintree 002B","E01021406","Total",952,233,112,121,719,26,203,121,218,14,34,103
"2011","Braintree 002C","E01021407","Total",921,215,116,99,706,26,198,136,202,27,37,80
"2011","Braintree 003A","E01021382","Total",524,119,69,50,405,15,123,63,92,11,30,71
"2011","Braintree 003B","E01021397","Total",742,209,85,124,533,43,92,90,159,15,37,97
"2011","Braintree 003C","E01021399","Total",675,166,94,72,509,28,125,96,121,13,37,89
"2011","Braintree 003D","E01021400","Total",747,217,106,111,530,36,131,84,159,16,33,71
"2011","Braintree 004A","E01021387","Total",1015,461,171,290,554,43,85,122,202,16,24,62
"2011","Braintree 004B","E01021388","Total",720,235,114,121,485,33,86,89,148,21,38,70
"2011","Braintree 004C","E01021391","Total",692,183,80,103,509,88,85,113,88,31,34,70
"2011","Braintree 004D","E01021392","Total",754,265,103,162,489,41,98,86,155,13,29,67
"2011","Braintree 004E","E01021393","Total",650,197,70,127,453,26,85,94,138,22,28,60
"2011","Braintree 005A","E01021404","Total",892,226,116,110,666,24,177,101,183,17,36,128
"2011","Braintree 005B","E01021411","Total",536,148,90,58,388,20,96,70,101,12,21,68
"2011","Braintree 005C","E01021412","Total",595,148,66,82,447,15,92,104,116,13,33,74
"2011","Braintree 005D","E01021413","Total",525,112,56,56,413,12,95,67,124,13,24,78
"2011","Braintree 006A","E01021389","Total",719,186,89,97,533,21,117,148,105,33,34,75
"2011","Braintree 006B","E01021390","Total",664,166,94,72,498,24,127,102,146,13,20,66
"2011","Braintree 006C","E01021408","Total",699,150,90,60,549,17,139,81,163,25,35,89
"2011","Braintree 006D","E01021409","Total",720,169,85,84,551,24,99,127,150,24,48,79
"2011","Braintree 006E","E01021410","Total",719,243,118,125,476,55,96,88,130,20,26,61
"2011","Braintree 007A","E01021349","Total",491,71,16,55,420,16,28,102,110,16,39,109
"2011","Braintree 007B","E01021351","Total",559,69,19,50,490,27,44,130,134,26,43,86
"2011","Braintree 007C","E01021352","Total",589,117,61,56,472,27,58,121,103,20,38,105
"2011","Braintree 007D","E01021355","Total",825,258,94,164,567,36,114,108,174,15,35,85
"2011","Braintree 007E","E01021356","Total",545,119,63,56,426,6,109,94,102,11,29,75
"2011","Braintree 007F","E01021381","Total",513,142,95,47,371,10,116,53,96,12,14,70
"2011","Braintree 008A","E01021354","Total",548,149,45,104,399,51,71,76,105,15,26,55
"2011","Braintree 008B","E01021357","Total",636,183,69,114,453,24,81,87,121,18,35,87
"2011","Braintree 008C","E01021358","Total",919,284,140,144,635,96,102,132,137,37,47,84
"2011","Braintree 008D","E01021359","Total",866,265,120,145,601,76,101,125,141,14,48,96
"2011","Braintree 009A","E01021350","Total",712,187,72,115,525,19,130,108,128,19,31,90
"2011","Braintree 009B","E01021353","Total",807,270,102,168,537,34,98,114,160,15,30,86
"2011","Braintree 009D","E01021365","Total",1133,482,157,325,651,68,84,110,253,17,28,91
"2011","Braintree 009E","E01033458","Total",691,297,73,224,394,49,21,87,178,4,8,47
"2011","Braintree 009F","E01033459","Total",876,342,144,198,534,56,66,109,182,14,27,80
"2011","Braintree 010A","E01021364","Total",677,162,57,105,515,30,96,127,147,11,29,75
"2011","Braintree 010B","E01021366","Total",597,102,60,42,495,18,114,89,115,19,40,100
"2011","Braintree 010C","E01021383","Total",712,81,30,51,631,33,106,191,106,41,64,90
"2011","Braintree 010D","E01021405","Total",898,177,79,98,721,37,147,148,180,21,50,138
"2011","Braintree 011A","E01021368","Total",682,241,82,159,441,33,70,90,127,16,26,79
"2011","Braintree 011B","E01021370","Total",717,275,119,156,442,66,50,99,110,29,24,64
"2011","Braintree 011C","E01021372","Total",769,209,54,155,560,36,85,128,165,25,32,89
"2011","Braintree 011D","E01021373","Total",1041,285,80,205,756,66,113,168,243,21,40,105
"2011","Braintree 011E","E01021374","Total",600,157,70,87,443,43,71,78,97,24,41,89
"2011","Braintree 012A","E01021360","Total",781,206,107,99,575,57,85,133,129,27,32,112
"2011","Braintree 012B","E01021361","Total",647,131,47,84,516,32,72,112,165,23,28,84
"2011","Braintree 012C","E01021367","Total",572,134,58,76,438,39,51,94,105,18,61,70
"2011","Braintree 012D","E01021369","Total",1078,224,72,152,854,86,78,272,214,45,62,97
"2011","Braintree 012E","E01021380","Total",963,236,124,112,727,39,179,128,200,25,38,118
"2011","Braintree 013A","E01021347","Total",918,188,93,95,730,33,126,184,172,39,58,118
"2011","Braintree 013B","E01021371","Total",698,154,64,90,544,27,112,144,148,13,20,80
"2011","Braintree 013C","E01021384","Total",845,155,64,91,690,43,87,207,148,35,57,113
"2011","Braintree 013D","E01021385","Total",515,118,32,86,397,50,33,122,95,19,24,54
"2011","Braintree 013E","E01021386","Total",564,63,31,32,501,28,66,118,121,36,48,84
"2011","Braintree 014A","E01021377","Total",729,202,102,100,527,25,119,110,133,25,34,81
"2011","Braintree 014B","E01021378","Total",792,319,195,124,473,29,113,110,133,13,15,60
"2011","Braintree 014C","E01021379","Total",707,139,74,65,568,23,105,129,138,28,31,114
"2011","Braintree 014D","E01021401","Total",661,214,118,96,447,36,99,82,108,15,31,76
"2011","Braintree 014E","E01021402","Total",824,197,85,112,627,37,88,156,185,29,34,98
"2011","Braintree 014F","E01021403","Total",626,133,63,70,493,16,100,108,151,16,34,68
"2011","Braintree 015A","E01021362","Total",577,128,57,71,449,21,87,87,105,10,40,99
"2011","Braintree 015B","E01021417","Total",657,196,81,115,461,29,86,87,132,16,38,73
"2011","Braintree 015C","E01021418","Total",549,124,49,75,425,60,33,88,99,20,47,78
"2011","Braintree 015D","E01021419","Total",712,207,106,101,505,27,97,97,145,22,34,83
"2011","Braintree 015E","E01021426","Total",588,179,46,133,409,45,55,83,143,12,19,52
"2011","Braintree 015F","E01021428","Total",623,162,109,53,461,8,135,69,128,7,25,89
"2011","Braintree 016A","E01021423","Total",596,139,41,98,457,58,55,105,108,25,48,58
"2011","Braintree 016B","E01021425","Total",596,127,47,80,469,52,45,123,125,19,39,66
"2011","Braintree 016C","E01021427","Total",538,147,51,96,391,29,49,75,97,25,31,85
"2011","Braintree 016D","E01021429","Total",528,130,53,77,398,30,55,67,107,27,33,79
"2011","Braintree 017A","E01021415","Total",743,374,215,159,369,29,84,68,95,7,17,69
"2011","Braintree 017B","E01021416","Total",769,320,132,188,449,23,78,82,155,8,21,82
"2011","Braintree 017C","E01021420","Total",730,227,59,168,503,36,83,96,147,14,40,87
"2011","Braintree 017E","E01021422","Total",787,297,154,143,490,40,123,84,128,12,22,81
"2011","Braintree 017F","E01033460","Total",567,202,71,131,365,20,62,67,124,10,22,60
"2011","Braintree 017G","E01033461","Total",580,123,8,115,457,30,17,142,170,21,26,51
"2011","Braintree 017H","E01033462","Total",479,168,35,133,311,28,30,79,124,11,18,21
"2011","Braintree 018A","E01021348","Total",640,117,62,55,523,18,134,94,143,17,34,83
"2011","Braintree 018B","E01021394","Total",664,222,118,104,442,28,93,79,133,11,19,79
"2011","Braintree 018C","E01021395","Total",614,158,100,58,456,20,121,79,102,21,33,80
"2011","Braintree 018D","E01021396","Total",535,99,50,49,436,12,99,61,119,15,33,97
"2011","Braintree 018E","E01021424","Total",811,188,69,119,623,40,81,159,183,24,37,99
"2011","Brentwood 001A","E01021441","Total",573,109,68,41,464,33,102,75,88,9,52,105
"2011","Brentwood 001B","E01021442","Total",514,105,75,30,409,2,90,81,86,14,40,96
"2011","Brentwood 001C","E01021443","Total",541,111,54,57,430,16,94,66,102,14,47,91
"2011","Brentwood 001D","E01021444","Total",633,143,81,62,490,15,120,80,107,20,51,97
"2011","Brentwood 001E","E01021469","Total",462,112,61,51,350,7,101,51,72,16,40,63
"2011","Brentwood 001F","E01021470","Total",406,72,44,28,334,20,75,50,76,11,31,71
"2011","Brentwood 001G","E01021471","Total",613,108,77,31,505,10,158,81,87,8,66,95
"2011","Brentwood 002A","E01021457","Total",611,186,98,88,425,11,108,63,114,17,32,80
"2011","Brentwood 002B","E01021458","Total",777,299,160,139,478,17,146,87,110,17,27,74
"2011","Brentwood 002C","E01021459","Total",525,108,78,30,417,6,138,80,69,9,28,87
"2011","Brentwood 002D","E01021460","Total",675,186,92,94,489,18,126,84,100,24,31,106
"2011","Brentwood 003A","E01021448","Total",640,249,136,113,391,32,80,80,70,10,37,82
"2011","Brentwood 003B","E01021449","Total",638,187,97,90,451,25,89,93,92,18,41,93
"2011","Brentwood 003C","E01021450","Total",793,167,101,66,626,31,135,136,102,19,52,151
"2011","Brentwood 003D","E01021451","Total",623,176,78,98,447,66,45,104,104,22,32,74
"2011","Brentwood 003E","E01021452","Total",620,154,103,51,466,19,132,80,100,16,23,96
"2011","Brentwood 004A","E01021431","Total",633,184,83,101,449,21,72,109,116,24,27,80
"2011","Brentwood 004B","E01021432","Total",698,196,79,117,502,70,67,102,127,24,23,89
"2011","Brentwood 004C","E01021434","Total",512,158,71,87,354,36,40,79,93,17,28,61
"2011","Brentwood 004D","E01021461","Total",620,183,82,101,437,58,70,76,101,11,33,88
"2011","Brentwood 004E","E01021464","Total",599,146,82,64,453,16,103,86,103,10,31,104
"2011","Brentwood 005A","E01021447","Total",966,204,128,76,762,17,214,139,146,39,57,150
"2011","Brentwood 005B","E01021453","Total",519,171,84,87,348,9,84,75,76,11,23,70
"2011","Brentwood 005C","E01021455","Total",519,80,55,25,439,7,146,65,76,23,31,91
"2011","Brentwood 005D","E01021465","Total",816,261,127,134,555,15,127,130,140,18,35,90
"2011","Brentwood 005E","E01021466","Total",656,93,59,34,563,4,158,114,89,29,49,120
"2011","Brentwood 005F","E01021467","Total",668,147,100,47,521,9,116,130,93,19,50,104
"2011","Brentwood 006A","E01021438","Total",784,167,84,83,617,14,119,146,160,23,46,109
"2011","Brentwood 006B","E01021462","Total",568,129,75,54,439,17,97,78,114,13,33,87
"2011","Brentwood 006C","E01021463","Total",629,154,102,52,475,17,134,79,94,17,38,96
"2011","Brentwood 006D","E01021468","Total",768,212,105,107,556,20,109,121,132,16,49,109
"2011","Brentwood 007A","E01021433","Total",919,373,169,204,546,32,65,115,186,21,33,94
"2011","Brentwood 007B","E01021436","Total",1138,574,209,365,564,34,78,113,229,12,12,86
"2011","Brentwood 007C","E01021439","Total",1149,454,88,366,695,70,52,158,295,14,17,89
"2011","Brentwood 007E","E01021475","Total",666,235,59,176,431,28,53,126,136,9,29,50
"2011","Brentwood 007F","E01033063","Total",569,168,20,148,401,41,25,102,145,23,20,45
"2011","Brentwood 007G","E01033064","Total",686,324,108,216,362,41,38,81,119,12,25,46
"2011","Brentwood 008A","E01021435","Total",777,255,119,136,522,44,92,104,96,25,54,107
"2011","Brentwood 008B","E01021437","Total",728,227,112,115,501,71,84,107,96,19,29,95
"2011","Brentwood 008C","E01021472","Total",725,322,96,226,403,40,54,79,151,9,19,51
"2011","Brentwood 008D","E01021473","Total",517,142,54,88,375,12,86,68,92,10,29,78
"2011","Brentwood 008E","E01021474","Total",613,136,104,32,477,6,100,118,101,20,31,101
"2011","Brentwood 009A","E01021445","Total",842,195,101,94,647,24,134,135,140,28,43,143
"2011","Brentwood 009B","E01021446","Total",671,194,119,75,477,10,129,82,129,8,34,85
"2011","Brentwood 009C","E01021454","Total",536,149,62,87,387,25,63,91,107,9,21,71
"2011","Brentwood 009D","E01021456","Total",511,148,40,108,363,6,63,62,104,21,27,80
"2011","Castle Point 001A","E01021513","Total",643,128,88,40,515,11,130,99,112,11,32,120
"2011","Castle Point 001B","E01021514","Total",610,143,81,62,467,24,95,94,112,15,32,95
"2011","Castle Point 001C","E01021515","Total",493,74,38,36,419,19,95,88,84,15,40,78
"2011","Castle Point 001D","E01021525","Total",668,190,63,127,478,51,99,88,120,8,28,84
"2011","Castle Point 001E","E01021527","Total",674,139,97,42,535,24,150,93,109,10,41,108
"2011","Castle Point 002A","E01021509","Total",649,218,123,95,431,19,143,68,106,9,24,62
"2011","Castle Point 002B","E01021510","Total",670,225,149,76,445,18,148,62,86,15,24,92
"2011","Castle Point 002C","E01021511","Total",533,132,74,58,401,20,104,64,80,10,39,84
"2011","Castle Point 002D","E01021528","Total",586,111,68,43,475,15,114,70,123,16,41,96
"2011","Castle Point 002E","E01021531","Total",556,124,66,58,432,21,96,68,108,14,37,88
"2011","Castle Point 003A","E01021476","Total",770,195,115,80,575,22,129,103,125,16,62,118
"2011","Castle Point 003B","E01021477","Total",629,130,83,47,499,13,142,84,125,15,33,87
"2011","Castle Point 003C","E01021478","Total",666,143,88,55,523,23,120,76,98,22,54,130
"2011","Castle Point 003D","E01021516","Total",542,103,55,48,439,22,115,70,98,12,32,90
"2011","Castle Point 004A","E01021479","Total",592,116,68,48,476,18,127,94,90,14,37,96
"2011","Castle Point 004B","E01021481","Total",562,85,52,33,477,13,108,92,112,14,44,94
"2011","Castle Point 004C","E01021483","Total",688,139,88,51,549,15,144,84,129,23,43,111
"2011","Castle Point 004D","E01021512","Total",648,161,104,57,487,20,122,85,110,16,29,105
"2011","Castle Point 004E","E01021526","Total",650,135,81,54,515,24,125,83,125,10,45,103
"2011","Castle Point 005A","E01021517","Total",711,194,126,68,517,16,165,84,132,6,31,83
"2011","Castle Point 005B","E01021519","Total",636,152,110,42,484,10,178,56,108,10,40,82
"2011","Castle Point 005C","E01021530","Total",614,169,101,68,445,13,144,78,85,11,37,77
"2011","Castle Point 005D","E01021532","Total",645,157,104,53,488,14,177,67,123,13,20,74
"2011","Castle Point 006A","E01021482","Total",607,140,95,45,467,17,130,85,87,10,41,97
"2011","Castle Point 006B","E01021518","Total",940,378,196,182,562,52,109,93,168,16,31,93
"2011","Castle Point 006C","E01021520","Total",671,210,131,79,461,27,109,77,108,10,52,78
"2011","Castle Point 006D","E01021529","Total",646,209,111,98,437,28,88,94,83,12,32,100
"2011","Castle Point 007A","E01021480","Total",706,147,72,75,559,21,109,109,141,23,46,110
"2011","Castle Point 007B","E01021521","Total",607,152,94,58,455,21,103,80,122,11,34,84
"2011","Castle Point 007C","E01021522","Total",711,196,83,113,515,41,93,94,147,22,35,83
"2011","Castle Point 007D","E01021523","Total",602,169,125,44,433,8,131,68,100,8,27,91
"2011","Castle Point 007E","E01021524","Total",644,172,96,76,472,15,125,76,101,14,41,100
"2011","Castle Point 008A","E01021487","Total",593,169,95,74,424,16,113,80,102,8,30,75
"2011","Castle Point 008B","E01021494","Total",598,138,75,63,460,22,85,91,112,10,35,105
"2011","Castle Point 008C","E01021504","Total",503,79,24,55,424,17,37,86,94,14,64,112
"2011","Castle Point 008D","E01021505","Total",496,54,26,28,442,20,60,71,117,16,44,114
"2011","Castle Point 008E","E01021506","Total",519,128,40,88,391,35,43,88,105,14,33,73
"2011","Castle Point 009A","E01021492","Total",761,212,115,97,549,34,133,91,154,18,40,79
"2011","Castle Point 009B","E01021493","Total",702,231,125,106,471,23,120,79,122,7,32,88
"2011","Castle Point 009C","E01021495","Total",1141,502,379,123,639,14,358,49,132,11,21,54
"2011","Castle Point 009D","E01021496","Total",590,161,68,93,429,31,112,74,81,14,38,79
"2011","Castle Point 010A","E01021485","Total",494,147,82,65,347,23,65,44,67,22,43,83
"2011","Castle Point 010B","E01021486","Total",462,117,64,53,345,53,45,56,61,21,44,65
"2011","Castle Point 010C","E01021488","Total",611,181,95,86,430,33,106,61,99,17,35,79
"2011","Castle Point 010D","E01021503","Total",519,82,42,40,437,39,79,73,94,16,42,94
"2011","Castle Point 010E","E01021507","Total",619,156,79,77,463,79,42,62,91,30,46,113
"2011","Castle Point 010F","E01021508","Total",442,50,11,39,392,37,23,99,70,29,41,93
"2011","Castle Point 011A","E01021484","Total",589,189,113,76,400,22,111,45,74,15,31,102
"2011","Castle Point 011B","E01021498","Total",596,151,79,72,445,11,119,46,106,12,35,116
"2011","Castle Point 011C","E01021499","Total",660,129,85,44,531,12,147,73,118,10,35,136
"2011","Castle Point 011D","E01021501","Total",630,193,119,74,437,12,127,69,97,12,24,96
"2011","Castle Point 011E","E01021502","Total",985,310,90,220,675,46,127,140,199,22,40,101
"2011","Castle Point 012A","E01021489","Total",623,186,89,97,437,18,117,63,117,14,32,76
"2011","Castle Point 012B","E01021490","Total",663,214,102,112,449,37,95,70,114,8,38,87
"2011","Castle Point 012C","E01021491","Total",662,154,80,74,508,33,114,77,119,15,48,102
"2011","Castle Point 012D","E01021497","Total",659,211,115,96,448,24,114,59,119,17,38,77
"2011","Castle Point 012E","E01021500","Total",754,244,132,112,510,32,113,87,146,15,40,77
"2011","Chelmsford 001A","E01021538","Total",998,172,63,109,826,38,124,222,204,43,66,129
"2011","Chelmsford 001B","E01021539","Total",534,117,70,47,417,11,101,79,121,18,35,52
"2011","Chelmsford 001C","E01021540","Total",636,139,68,71,497,11,117,83,150,20,33,83
"2011","Chelmsford 001D","E01021541","Total",637,199,120,79,438,16,127,76,99,22,19,79
"2011","Chelmsford 002A","E01021542","Total",839,243,96,147,596,23,125,134,161,22,36,95
"2011","Chelmsford 002B","E01021543","Total",650,139,74,65,511,14,127,111,131,20,27,81
"2011","Chelmsford 002C","E01021587","Total",616,143,99,44,473,14,145,78,107,17,21,91
"2011","Chelmsford 002D","E01021590","Total",588,118,44,74,470,14,95,86,142,22,29,82
"2011","Chelmsford 002E","E01021591","Total",643,181,76,105,462,14,91,87,142,18,22,88
"2011","Chelmsford 003A","E01021550","Total",570,119,46,73,451,12,95,71,148,22,27,76
"2011","Chelmsford 003B","E01021597","Total",590,158,79,79,432,34,73,82,109,21,31,82
"2011","Chelmsford 003C","E01021598","Total",660,210,114,96,450,60,88,88,103,13,20,78
"2011","Chelmsford 003D","E01021600","Total",441,71,33,38,370,8,80,62,89,8,34,89
"2011","Chelmsford 003E","E01021601","Total",685,252,136,116,433,46,76,80,114,17,32,68
"2011","Chelmsford 004A","E01021616","Total",553,92,32,60,461,18,62,88,138,19,28,108
"2011","Chelmsford 004B","E01021617","Total",599,198,89,109,401,25,54,84,114,17,23,84
"2011","Chelmsford 004C","E01021619","Total",634,183,77,106,451,28,56,119,116,13,22,97
"2011","Chelmsford 004D","E01021620","Total",643,229,39,190,414,32,52,86,149,14,20,61
"2011","Chelmsford 004E","E01021623","Total",514,115,50,65,399,19,76,81,116,11,28,68
"2011","Chelmsford 004F","E01021624","Total",503,104,78,26,399,2,137,66,82,14,27,71
"2011","Chelmsford 005A","E01021536","Total",700,211,94,117,489,34,98,91,147,13,27,79
"2011","Chelmsford 005B","E01021537","Total",787,219,75,144,568,27,126,113,145,12,39,106
"2011","Chelmsford 005D","E01021568","Total",627,107,71,36,520,16,165,75,120,18,39,87
"2011","Chelmsford 005E","E01033142","Total",747,116,23,93,631,31,41,225,157,36,63,78
"2011","Chelmsford 005F","E01033144","Total",619,92,9,83,527,33,24,166,129,41,61,73
"2011","Chelmsford 006A","E01021576","Total",611,137,52,85,474,95,43,110,90,27,35,74
"2011","Chelmsford 006B","E01021588","Total",623,225,125,100,398,37,95,59,77,28,28,74
"2011","Chelmsford 006C","E01021589","Total",665,225,75,150,440,48,62,89,119,15,38,69
"2011","Chelmsford 006D","E01021592","Total",678,253,114,139,425,58,67,76,90,23,26,85
"2011","Chelmsford 006E","E01021596","Total",698,292,132,160,406,50,55,87,86,25,40,63
"2011","Chelmsford 007A","E01021618","Total",572,133,20,113,439,20,46,103,125,18,46,81
"2011","Chelmsford 007B","E01021621","Total",616,151,23,128,465,27,26,132,157,22,34,67
"2011","Chelmsford 007C","E01021622","Total",632,161,103,58,471,8,152,75,110,6,37,83
"2011","Chelmsford 007D","E01021625","Total",615,160,95,65,455,23,125,83,101,12,23,88
"2011","Chelmsford 007E","E01021626","Total",554,112,52,60,442,15,98,80,113,17,31,88
"2011","Chelmsford 008A","E01021544","Total",617,226,32,194,391,26,46,114,141,8,14,42
"2011","Chelmsford 008B","E01021545","Total",641,157,63,94,484,19,55,169,142,22,24,53
"2011","Chelmsford 008C","E01021546","Total",608,199,71,128,409,21,35,103,117,20,28,85
"2011","Chelmsford 008D","E01021547","Total",702,240,30,210,462,22,25,106,194,11,26,78
"2011","Chelmsford 008E","E01021628","Total",665,155,49,106,510,31,60,124,149,19,34,93
"2011","Chelmsford 008F","E01021629","Total",677,192,83,109,485,30,58,112,145,19,38,83
"2011","Chelmsford 009A","E01021573","Total",700,205,65,140,495,13,75,107,133,26,41,100
"2011","Chelmsford 009B","E01021575","Total",717,247,63,184,470,33,45,93,191,15,19,74
"2011","Chelmsford 009C","E01021599","Total",728,153,67,86,575,19,104,119,175,26,39,93
"2011","Chelmsford 009E","E01021631","Total",787,239,118,121,548,63,86,106,132,33,40,88
"2011","Chelmsford 009F","E01033138","Total",638,181,70,111,457,31,64,96,145,15,29,77
"2011","Chelmsford 009G","E01033139","Total",639,200,20,180,439,44,20,89,174,16,22,74
"2011","Chelmsford 010A","E01021574","Total",1010,424,50,374,586,39,24,80,300,11,13,119
"2011","Chelmsford 010B","E01021578","Total",859,373,56,317,486,28,47,120,206,8,16,61
"2011","Chelmsford 010D","E01021582","Total",976,421,80,341,555,31,57,102,276,9,17,63
"2011","Chelmsford 010E","E01021627","Total",588,227,116,111,361,5,74,74,114,10,14,70
"2011","Chelmsford 010F","E01033140","Total",627,316,96,220,311,26,16,58,159,3,9,40
"2011","Chelmsford 010G","E01033141","Total",604,323,120,203,281,19,32,38,150,4,8,30
"2011","Chelmsford 011A","E01021551","Total",557,135,76,59,422,19,106,76,104,12,36,69
"2011","Chelmsford 011B","E01021632","Total",601,112,83,29,489,10,168,83,103,12,17,96
"2011","Chelmsford 011C","E01021633","Total",514,170,83,87,344,7,118,51,93,9,20,46
"2011","Chelmsford 011D","E01021634","Total",614,136,68,68,478,15,119,88,110,12,37,97
"2011","Chelmsford 011E","E01021635","Total",625,189,117,72,436,10,142,65,108,13,23,75
"2011","Chelmsford 011F","E01021636","Total",510,189,118,71,321,25,76,56,76,8,17,63
"2011","Chelmsford 012A","E01021556","Total",677,184,72,112,493,12,103,118,125,25,34,76
"2011","Chelmsford 012B","E01021577","Total",613,168,79,89,445,22,81,119,122,10,25,66
"2011","Chelmsford 012C","E01021579","Total",608,159,51,108,449,16,56,128,133,19,28,69
"2011","Chelmsford 012D","E01021580","Total",505,78,45,33,427,6,70,127,84,22,43,75
"2011","Chelmsford 012E","E01021584","Total",471,73,55,18,398,8,134,61,65,18,32,80
"2011","Chelmsford 013A","E01021548","Total",542,149,72,77,393,2,52,88,127,13,25,86
"2011","Chelmsford 013B","E01021560","Total",781,278,155,123,503,15,150,86,139,15,26,72
"2011","Chelmsford 013C","E01021561","Total",752,189,94,95,563,21,173,117,122,11,32,87
"2011","Chelmsford 013D","E01021564","Total",638,169,92,77,469,9,160,67,96,20,24,93
"2011","Chelmsford 013E","E01021571","Total",595,108,70,38,487,11,134,90,96,23,40,93
"2011","Chelmsford 014A","E01021562","Total",800,284,129,155,516,42,111,106,130,16,27,84
"2011","Chelmsford 014B","E01021563","Total",809,337,111,226,472,50,73,87,153,24,22,63
"2011","Chelmsford 014C","E01021565","Total",681,220,92,128,461,61,63,102,109,22,29,75
"2011","Chelmsford 014D","E01021566","Total",697,155,66,89,542,21,124,119,126,22,36,94
"2011","Chelmsford 014F","E01033137","Total",647,169,42,127,478,44,63,120,139,21,27,64
"2011","Chelmsford 014G","E01033145","Total",575,141,79,62,434,26,113,83,93,10,31,78
"2011","Chelmsford 015A","E01021557","Total",487,101,32,69,386,12,58,87,101,14,30,84
"2011","Chelmsford 015B","E01021558","Total",502,104,48,56,398,5,85,72,111,15,29,81
"2011","Chelmsford 015C","E01021583","Total",603,131,52,79,472,31,73,113,108,27,33,87
"2011","Chelmsford 015D","E01021585","Total",492,106,57,49,386,17,77,83,86,11,29,83
"2011","Chelmsford 015E","E01021586","Total",614,137,68,69,477,14,125,98,88,18,38,96
"2011","Chelmsford 016A","E01021533","Total",926,225,79,146,701,23,145,172,177,20,40,124
"2011","Chelmsford 016B","E01021535","Total",685,138,67,71,547,30,111,107,122,24,45,108
"2011","Chelmsford 016C","E01021569","Total",640,104,60,44,536,11,165,96,123,23,30,88
"2011","Chelmsford 016D","E01021570","Total",763,149,88,61,614,13,183,103,139,26,38,112
"2011","Chelmsford 016E","E01021572","Total",633,167,93,74,466,36,95,84,114,25,34,78
"2011","Chelmsford 017A","E01021552","Total",673,190,127,63,483,27,152,70,91,12,29,102
"2011","Chelmsford 017B","E01021553","Total",570,153,61,92,417,23,79,86,104,14,32,79
"2011","Chelmsford 017C","E01021554","Total",653,208,59,149,445,55,86,80,120,16,25,63
"2011","Chelmsford 017D","E01021555","Total",532,107,64,43,425,11,91,74,105,24,29,91
"2011","Chelmsford 017E","E01021559","Total",578,112,74,38,466,12,106,75,108,19,45,101
"2011","Chelmsford 018B","E01021602","Total",754,242,132,110,512,15,151,84,123,15,32,92
"2011","Chelmsford 018D","E01021604","Total",861,159,79,80,702,33,117,163,179,29,55,126
"2011","Chelmsford 018E","E01033143","Total",1176,373,201,172,803,6,295,115,170,27,50,140
"2011","Chelmsford 019A","E01021611","Total",528,70,30,40,458,15,64,123,92,18,32,114
"2011","Chelmsford 019B","E01021612","Total",608,131,71,60,477,18,110,97,120,12,40,80
"2011","Chelmsford 019C","E01021613","Total",853,325,108,217,528,38,68,103,183,19,33,84
"2011","Chelmsford 019D","E01021614","Total",646,109,55,54,537,18,106,101,107,22,48,135
"2011","Chelmsford 019E","E01021615","Total",622,153,72,81,469,31,87,93,145,18,25,70
"2011","Chelmsford 020A","E01021605","Total",469,73,29,44,396,20,55,76,104,10,27,104
"2011","Chelmsford 020B","E01021606","Total",593,109,19,90,484,35,41,94,113,21,50,130
"2011","Chelmsford 020C","E01021607","Total",648,201,59,142,447,34,27,121,153,14,27,71
"2011","Chelmsford 020D","E01021608","Total",547,219,75,144,328,29,32,78,108,9,18,54
"2011","Chelmsford 020E","E01021609","Total",515,92,35,57,423,13,57,82,105,19,47,100
"2011","Chelmsford 020F","E01021610","Total",571,186,51,135,385,29,37,78,126,13,28,74
"2011","Chelmsford 021A","E01021593","Total",666,179,125,54,487,12,148,83,104,18,34,88
"2011","Chelmsford 021B","E01021594","Total",679,166,67,99,513,12,138,78,130,13,39,103
"2011","Chelmsford 021C","E01021595","Total",708,173,110,63,535,10,156,94,127,9,31,108
"2011","Colchester 001A","E01021655","Total",529,96,46,50,433,9,100,70,113,17,29,95
"2011","Colchester 001B","E01021656","Total",682,204,118,86,478,19,140,78,115,14,34,78
"2011","Colchester 001C","E01021659","Total",826,173,84,89,653,18,151,134,171,34,39,106
"2011","Colchester 001D","E01021661","Total",659,112,59,53,547,22,107,122,142,22,37,95
"2011","Colchester 002A","E01021668","Total",801,340,39,301,461,45,39,109,172,19,24,53
"2011","Colchester 002B","E01021669","Total",716,286,60,226,430,58,41,113,139,15,29,35
"2011","Colchester 002C","E01021670","Total",630,162,44,118,468,63,65,111,106,23,34,66
"2011","Colchester 002D","E01021671","Total",596,164,79,85,432,19,75,89,124,14,22,89
"2011","Colchester 002F","E01033720","Total",775,173,15,158,602,59,19,181,204,31,45,63
"2011","Colchester 002G","E01033721","Total",654,124,14,110,530,40,15,237,142,25,32,39
"2011","Colchester 003A","E01021660","Total",574,107,59,48,467,9,111,96,123,24,32,72
"2011","Colchester 003B","E01021728","Total",656,121,91,30,535,7,146,111,129,15,31,96
"2011","Colchester 003C","E01021729","Total",708,179,79,100,529,34,107,117,137,13,45,76
"2011","Colchester 003D","E01021730","Total",682,163,78,85,519,33,125,87,112,18,35,109
"2011","Colchester 004A","E01021679","Total",991,272,53,219,719,52,45,213,268,18,37,86
"2011","Colchester 004B","E01021680","Total",1090,263,96,167,827,57,82,242,245,28,58,115
"2011","Colchester 004C","E01021681","Total",1184,312,71,241,872,54,108,210,348,26,43,83
"2011","Colchester 004D","E01021682","Total",1148,347,79,268,801,57,99,197,273,24,48,103
"2011","Colchester 007A","E01021646","Total",1019,441,148,293,578,41,85,98,236,13,24,81
"2011","Colchester 007B","E01021647","Total",811,282,100,182,529,35,93,101,163,15,25,97
"2011","Colchester 007C","E01021648","Total",1127,434,157,277,693,63,88,117,265,13,31,116
"2011","Colchester 007D","E01021649","Total",1050,562,134,428,488,50,45,86,218,5,18,66
"2011","Colchester 007E","E01021650","Total",954,381,48,333,573,51,45,107,259,11,32,68
"2011","Colchester 008A","E01021696","Total",747,320,128,192,427,77,63,83,87,14,19,84
"2011","Colchester 008B","E01021697","Total",705,227,105,122,478,55,91,80,107,14,36,95
"2011","Colchester 008C","E01021698","Total",457,81,23,58,376,41,41,54,78,16,33,113
"2011","Colchester 008D","E01021699","Total",647,228,87,141,419,54,72,57,99,10,24,103
"2011","Colchester 008E","E01021700","Total",582,153,33,120,429,85,30,78,89,26,21,100
"2011","Colchester 008G","E01033719","Total",544,200,3,197,344,16,4,56,166,4,6,92
"2011","Colchester 008H","E01033722","Total",586,149,34,115,437,43,43,59,90,16,19,167
"2011","Colchester 009A","E01021673","Total",623,200,132,68,423,7,156,69,85,8,34,64
"2011","Colchester 009B","E01021674","Total",519,121,40,81,398,35,45,101,89,18,37,73
"2011","Colchester 009C","E01021675","Total",526,126,59,67,400,16,90,82,101,19,27,65
"2011","Colchester 009D","E01021676","Total",643,208,99,109,435,19,133,82,101,12,26,62
"2011","Colchester 010A","E01021654","Total",733,166,77,89,567,19,105,136,147,25,30,105
"2011","Colchester 010B","E01021662","Total",636,133,68,65,503,11,124,83,137,27,40,81
"2011","Colchester 010C","E01021663","Total",458,110,55,55,348,10,97,44,97,18,29,53
"2011","Colchester 010D","E01021677","Total",494,109,55,54,385,6,89,69,112,10,26,73
"2011","Colchester 010E","E01021678","Total",559,143,37,106,416,28,73,83,127,15,23,67
"2011","Colchester 011A","E01021683","Total",558,237,63,174,321,52,20,68,143,5,6,27
"2011","Colchester 011B","E01021684","Total",703,248,97,151,455,39,72,102,155,14,21,52
"2011","Colchester 011C","E01021685","Total",838,282,44,238,556,80,18,111,192,18,44,93
"2011","Colchester 011D","E01021686","Total",981,482,89,393,499,80,20,98,209,14,24,54
"2011","Colchester 011E","E01021687","Total",757,266,47,219,491,60,36,114,182,11,18,70
"2011","Colchester 011F","E01021688","Total",600,176,45,131,424,43,47,93,135,17,20,69
"2011","Colchester 012A","E01021718","Total",665,193,42,151,472,31,69,100,159,18,28,67
"2011","Colchester 012B","E01021719","Total",663,184,103,81,479,21,143,86,104,14,30,81
"2011","Colchester 012C","E01021720","Total",704,299,152,147,405,36,74,78,100,19,22,76
"2011","Colchester 012D","E01021721","Total",773,156,82,74,617,34,145,125,131,15,48,119
"2011","Colchester 012E","E01021722","Total",701,199,102,97,502,30,116,98,123,15,42,78
"2011","Colchester 013A","E01021651","Total",731,276,85,191,455,49,23,128,147,21,18,69
"2011","Colchester 013B","E01021652","Total",647,202,72,130,445,19,100,82,115,28,27,74
"2011","Colchester 013C","E01021653","Total",486,93,29,64,393,6,59,112,80,12,48,76
"2011","Colchester 013D","E01021717","Total",719,179,70,109,540,31,77,137,176,16,35,68
"2011","Colchester 014A","E01021689","Total",614,183,123,60,431,18,119,79,85,11,44,75
"2011","Colchester 014B","E01021690","Total",500,87,35,52,413,24,56,83,113,19,31,87
"2011","Colchester 014C","E01021691","Total",641,182,125,57,459,15,140,63,113,11,28,89
"2011","Colchester 014D","E01021692","Total",603,141,86,55,462,9,132,71,98,12,44,96
"2011","Colchester 014E","E01021693","Total",718,202,145,57,516,19,189,71,89,17,45,86
"2011","Colchester 015A","E01021711","Total",577,209,99,110,368,50,71,59,87,25,25,51
"2011","Colchester 015C","E01021713","Total",474,155,89,66,319,20,65,43,50,14,45,82
"2011","Colchester 015D","E01021714","Total",671,122,24,98,549,69,38,162,149,22,48,61
"2011","Colchester 015E","E01021715","Total",578,138,61,77,440,47,57,88,113,16,42,77
"2011","Colchester 015G","E01033723","Total",863,124,13,111,739,65,10,357,141,80,50,36
"2011","Colchester 016A","E01021657","Total",720,238,89,149,482,53,78,106,139,10,23,73
"2011","Colchester 016B","E01021658","Total",442,130,62,68,312,25,52,59,72,14,21,69
"2011","Colchester 016C","E01021664","Total",884,276,96,180,608,49,85,123,211,15,35,90
"2011","Colchester 016D","E01021665","Total",612,226,71,155,386,42,59,75,100,17,37,56
"2011","Colchester 016E","E01021666","Total",627,241,74,167,386,20,62,79,134,3,23,65
"2011","Colchester 016F","E01021667","Total",619,193,72,121,426,46,76,89,108,17,25,65
"2011","Colchester 017A","E01021736","Total",516,152,41,111,364,16,48,64,113,14,26,83
"2011","Colchester 017B","E01021737","Total",582,205,91,114,377,34,88,72,102,10,9,62
"2011","Colchester 017C","E01021738","Total",967,332,107,225,635,23,137,119,209,30,34,83
"2011","Colchester 017D","E01021739","Total",648,153,87,66,495,14,114,88,145,18,19,97
"2011","Colchester 017E","E01021740","Total",744,217,114,103,527,30,128,96,122,19,21,111
"2011","Colchester 018A","E01021637","Total",471,103,39,64,368,25,70,62,90,8,34,79
"2011","Colchester 018B","E01021638","Total",506,133,62,71,373,43,57,72,90,10,26,75
"2011","Colchester 018C","E01021639","Total",750,234,54,180,516,50,49,121,176,18,42,60
"2011","Colchester 018D","E01021640","Total",481,99,33,66,382,32,49,71,119,13,24,74
"2011","Colchester 018E","E01021641","Total",590,158,71,87,432,31,82,76,124,14,34,71
"2011","Colchester 018F","E01021642","Total",836,273,110,163,563,53,65,116,150,17,69,93
"2011","Colchester 019A","E01021643","Total",927,154,70,84,773,22,143,175,205,40,59,129
"2011","Colchester 019B","E01021644","Total",670,148,77,71,522,13,118,98,148,26,35,84
"2011","Colchester 019C","E01021645","Total",583,102,60,42,481,11,113,92,125,17,27,96
"2011","Colchester 019D","E01021694","Total",592,126,61,65,466,10,121,68,144,20,39,64
"2011","Colchester 019E","E01021695","Total",459,89,51,38,370,8,107,75,97,10,15,58
"2011","Colchester 020A","E01021723","Total",720,205,120,85,515,28,151,79,124,8,24,101
"2011","Colchester 020B","E01021724","Total",739,229,141,88,510,16,156,83,119,18,36,82
"2011","Colchester 020C","E01021725","Total",528,105,58,47,423,9,127,52,99,13,29,94
"2011","Colchester 020D","E01021726","Total",679,221,104,117,458,39,108,80,116,16,24,75
"2011","Colchester 020E","E01021727","Total",627,152,95,57,475,13,128,86,136,6,30,76
"2011","Colchester 021A","E01021731","Total",638,173,116,57,465,12,157,70,120,18,20,68
"2011","Colchester 021B","E01021732","Total",705,267,143,124,438,37,108,83,97,17,33,63
"2011","Colchester 021C","E01021733","Total",657,141,84,57,516,27,178,77,141,13,20,60
"2011","Colchester 021D","E01021734","Total",631,189,133,56,442,11,164,53,111,7,25,71
"2011","Colchester 021E","E01021735","Total",669,244,179,65,425,14,175,49,92,15,20,60
"2011","Colchester 022D","E01021702","Total",591,181,96,85,410,24,71,68,134,17,22,74
"2011","Colchester 022E","E01021703","Total",491,133,58,75,358,67,34,61,70,31,29,66
"2011","Colchester 022F","E01021704","Total",661,236,81,155,425,50,67,84,109,13,37,65
"2011","Colchester 022G","E01021705","Total",765,121,53,68,644,24,124,96,180,21,54,145
"2011","Colchester 022H","E01021706","Total",598,236,52,184,362,25,34,63,142,12,20,66
"2011","Colchester 022I","E01021707","Total",591,180,97,83,411,21,110,79,87,8,28,78
"2011","Colchester 022A","E01021708","Total",629,162,85,77,467,21,129,59,134,7,30,87
"2011","Colchester 022B","E01021709","Total",632,158,99,59,474,17,178,65,94,14,19,87
"2011","Colchester 022C","E01021710","Total",771,147,81,66,624,15,178,101,134,17,48,131
"2011","Epping Forest 001A","E01021768","Total",865,210,114,96,655,26,141,124,165,27,48,124
"2011","Epping Forest 001B","E01021795","Total",935,330,65,265,605,20,95,129,227,17,35,82
"2011","Epping Forest 001C","E01021797","Total",523,121,62,59,402,12,77,82,96,12,28,95
"2011","Epping Forest 001D","E01021798","Total",638,155,105,50,483,24,126,75,114,20,38,86
"2011","Epping Forest 001E","E01021799","Total",706,247,127,120,459,38,79,86,128,18,36,74
"2011","Epping Forest 002A","E01021741","Total",784,172,88,84,612,20,132,114,153,16,48,129
"2011","Epping Forest 002B","E01021792","Total",482,107,61,46,375,8,111,41,77,15,39,84
"2011","Epping Forest 002C","E01021793","Total",616,120,77,43,496,7,156,73,110,12,26,112
"2011","Epping Forest 002D","E01021794","Total",484,144,88,56,340,16,77,62,76,6,33,70
"2011","Epping Forest 002E","E01021801","Total",876,216,126,90,660,15,146,115,162,18,60,144
"2011","Epping Forest 003A","E01021769","Total",852,159,87,72,693,21,154,124,164,28,57,145
"2011","Epping Forest 003B","E01021796","Total",868,208,117,91,660,25,181,106,154,25,57,112
"2011","Epping Forest 003C","E01021800","Total",862,201,82,119,661,21,130,112,146,29,62,161
"2011","Epping Forest 004A","E01021753","Total",629,223,107,116,406,20,75,83,112,11,30,75
"2011","Epping Forest 004B","E01021754","Total",615,125,84,41,490,13,160,85,90,20,40,82
"2011","Epping Forest 004C","E01021755","Total",479,133,81,52,346,10,99,65,75,7,17,73
"2011","Epping Forest 004D","E01021802","Total",903,238,135,103,665,62,120,150,147,21,41,124
"2011","Epping Forest 005A","E01021760","Total",655,194,101,93,461,17,102,89,111,13,33,96
"2011","Epping Forest 005B","E01021761","Total",744,183,85,98,561,53,103,117,147,19,24,98
"2011","Epping Forest 005C","E01021762","Total",611,191,125,66,420,19,112,87,97,12,29,64
"2011","Epping Forest 005D","E01021763","Total",653,194,120,74,459,22,87,116,132,16,18,68
"2011","Epping Forest 006A","E01021756","Total",612,144,63,81,468,26,77,103,125,18,34,85
"2011","Epping Forest 006B","E01021757","Total",795,286,141,145,509,16,143,77,181,6,20,66
"2011","Epping Forest 006C","E01021758","Total",749,288,133,155,461,18,112,78,156,7,27,63
"2011","Epping Forest 006D","E01021759","Total",608,158,67,91,450,25,74,109,115,18,37,72
"2011","Epping Forest 007A","E01021811","Total",602,188,90,98,414,55,63,69,107,13,27,80
"2011","Epping Forest 007B","E01021813","Total",581,156,92,64,425,19,105,57,94,12,34,104
"2011","Epping Forest 007C","E01021814","Total",604,179,84,95,425,28,85,88,88,11,34,91
"2011","Epping Forest 007D","E01021815","Total",603,182,56,126,421,29,51,87,91,21,46,96
"2011","Epping Forest 007E","E01021816","Total",609,282,132,150,327,23,56,73,76,10,27,62
"2011","Epping Forest 008A","E01021807","Total",591,137,58,79,454,34,78,105,101,22,31,83
"2011","Epping Forest 008B","E01021808","Total",617,171,72,99,446,50,77,95,95,13,34,82
"2011","Epping Forest 008C","E01021809","Total",616,216,98,118,400,20,80,67,104,18,37,74
"2011","Epping Forest 008D","E01021810","Total",788,257,51,206,531,60,38,157,171,9,28,68
"2011","Epping Forest 008E","E01021817","Total",1066,330,91,239,736,80,107,176,190,28,54,101
"2011","Epping Forest 009A","E01021806","Total",1002,379,185,194,623,26,166,83,179,29,48,92
"2011","Epping Forest 009B","E01021812","Total",579,220,105,115,359,13,81,53,109,11,24,68
"2011","Epping Forest 009C","E01021818","Total",912,445,145,300,467,46,66,100,152,14,26,63
"2011","Epping Forest 010A","E01021770","Total",907,315,143,172,592,43,149,105,132,20,38,105
"2011","Epping Forest 010B","E01021803","Total",536,144,96,48,392,12,79,73,91,18,31,88
"2011","Epping Forest 010C","E01021804","Total",586,186,77,109,400,9,86,85,105,9,38,68
"2011","Epping Forest 010D","E01021805","Total",491,98,73,25,393,9,97,81,83,20,37,66
"2011","Epping Forest 011A","E01021774","Total",617,229,72,157,388,45,37,95,97,11,31,72
"2011","Epping Forest 011B","E01021775","Total",631,243,84,159,388,45,55,85,82,22,34,65
"2011","Epping Forest 011C","E01021776","Total",717,350,210,140,367,24,67,73,116,10,20,57
"2011","Epping Forest 011D","E01021777","Total",567,175,82,93,392,22,66,92,81,13,28,90
"2011","Epping Forest 011E","E01021778","Total",571,143,49,94,428,31,53,92,93,19,32,108
"2011","Epping Forest 011F","E01021779","Total",702,276,97,179,426,43,56,102,127,7,20,71
"2011","Epping Forest 012A","E01021786","Total",520,164,45,119,356,14,68,91,87,12,20,64
"2011","Epping Forest 012B","E01021787","Total",629,174,74,100,455,12,85,103,99,13,33,110
"2011","Epping Forest 012C","E01021788","Total",624,140,65,75,484,22,116,94,101,10,34,107
"2011","Epping Forest 012D","E01021789","Total",526,70,52,18,456,15,96,85,74,25,42,119
"2011","Epping Forest 012E","E01021790","Total",556,126,63,63,430,45,48,101,105,23,36,72
"2011","Epping Forest 012F","E01021791","Total",660,192,86,106,468,28,72,107,136,12,23,90
"2011","Epping Forest 013A","E01021771","Total",713,289,93,196,424,62,59,119,94,13,24,53
"2011","Epping Forest 013B","E01021772","Total",599,159,90,69,440,30,91,73,84,16,35,111
"2011","Epping Forest 013C","E01021773","Total",595,149,75,74,446,39,58,98,97,15,39,100
"2011","Epping Forest 013D","E01021783","Total",639,165,78,87,474,30,88,107,107,15,27,100
"2011","Epping Forest 013E","E01021784","Total",642,176,80,96,466,31,84,112,117,14,30,78
"2011","Epping Forest 014A","E01021780","Total",523,79,37,42,444,16,93,96,86,18,49,86
"2011","Epping Forest 014B","E01021781","Total",633,182,74,108,451,18,92,97,125,11,26,82
"2011","Epping Forest 014C","E01021782","Total",639,230,127,103,409,16,81,80,112,14,29,77
"2011","Epping Forest 014D","E01021785","Total",662,188,68,120,474,55,54,113,115,19,35,83
"2011","Epping Forest 015A","E01021742","Total",513,118,52,66,395,20,50,113,81,16,47,68
"2011","Epping Forest 015B","E01021743","Total",824,368,190,178,456,38,83,96,146,9,25,59
"2011","Epping Forest 015C","E01021744","Total",648,168,64,104,480,27,80,122,121,10,32,88
"2011","Epping Forest 015D","E01021745","Total",655,206,73,133,449,19,79,105,118,17,32,79
"2011","Epping Forest 015E","E01021746","Total",859,346,143,203,513,39,97,121,151,15,30,60
"2011","Epping Forest 015F","E01021747","Total",643,151,68,83,492,26,108,99,108,11,40,100
"2011","Epping Forest 015G","E01021748","Total",752,225,84,141,527,43,80,125,156,15,27,81
"2011","Epping Forest 016A","E01021749","Total",912,232,107,125,680,22,168,107,164,15,50,154
"2011","Epping Forest 016B","E01021750","Total",476,136,65,71,340,7,81,41,59,12,53,87
"2011","Epping Forest 016C","E01021751","Total",444,56,39,17,388,4,75,61,59,12,54,123
"2011","Epping Forest 016D","E01021752","Total",564,114,47,67,450,38,57,79,108,17,52,99
"2011","Epping Forest 017A","E01021764","Total",720,199,60,139,521,130,24,140,104,20,41,62
"2011","Epping Forest 017B","E01021765","Total",646,184,64,120,462,33,82,84,101,15,56,91
"2011","Epping Forest 017C","E01021766","Total",498,94,47,47,404,16,86,59,62,17,57,107
"2011","Epping Forest 017D","E01021767","Total",638,157,96,61,481,14,108,72,91,12,61,123
"2011","Harlow 001A","E01021854","Total",732,221,99,122,511,28,115,84,153,13,35,83
"2011","Harlow 001B","E01021855","Total",601,200,108,92,401,30,83,71,95,27,22,73
"2011","Harlow 001C","E01021856","Total",610,179,101,78,431,23,74,84,124,11,33,82
"2011","Harlow 001D","E01021857","Total",1069,317,154,163,752,53,122,144,232,31,57,113
"2011","Harlow 002A","E01021844","Total",525,121,55,66,404,33,63,74,91,10,46,87
"2011","Harlow 002B","E01021845","Total",621,202,93,109,419,60,66,73,103,12,38,67
"2011","Harlow 002C","E01021846","Total",573,185,66,119,388,52,49,68,92,17,42,68
"2011","Harlow 002D","E01021847","Total",616,213,122,91,403,27,82,84,101,19,34,56
"2011","Harlow 002E","E01021848","Total",690,224,97,127,466,40,81,91,126,16,32,80
"2011","Harlow 003A","E01021849","Total",670,215,115,100,455,31,77,90,105,18,37,97
"2011","Harlow 003B","E01021850","Total",617,206,86,120,411,53,65,76,91,16,33,77
"2011","Harlow 003C","E01021851","Total",713,291,79,212,422,61,59,79,124,17,21,61
"2011","Harlow 003D","E01021852","Total",670,232,120,112,438,44,80,113,89,14,29,69
"2011","Harlow 003E","E01021853","Total",590,199,103,96,391,29,79,65,101,11,25,81
"2011","Harlow 004A","E01021839","Total",633,194,79,115,439,37,84,69,102,19,31,97
"2011","Harlow 004B","E01021840","Total",623,199,71,128,424,46,62,84,108,11,29,84
"2011","Harlow 004C","E01021841","Total",539,124,63,61,415,41,62,93,87,13,26,93
"2011","Harlow 004D","E01021842","Total",634,195,69,126,439,52,59,105,93,19,30,81
"2011","Harlow 004E","E01021843","Total",940,337,75,262,603,53,72,138,205,19,35,81
"2011","Harlow 005A","E01021824","Total",641,117,35,82,524,38,57,190,123,29,30,57
"2011","Harlow 005B","E01021825","Total",648,151,27,124,497,45,49,162,147,22,36,36
"2011","Harlow 005C","E01021826","Total",645,149,30,119,496,29,72,148,134,20,24,69
"2011","Harlow 005D","E01021827","Total",715,218,52,166,497,49,52,134,156,17,28,61
"2011","Harlow 005E","E01021828","Total",864,173,39,134,691,59,47,242,192,31,57,63
"2011","Harlow 006A","E01021819","Total",638,189,82,107,449,39,81,78,104,18,36,93
"2011","Harlow 006B","E01021820","Total",644,187,112,75,457,51,81,76,127,17,37,68
"2011","Harlow 006C","E01021822","Total",626,165,81,84,461,52,80,96,104,21,36,72
"2011","Harlow 006D","E01021823","Total",759,264,89,175,495,74,83,107,107,27,24,73
"2011","Harlow 006E","E01021870","Total",577,197,87,110,380,29,84,63,89,18,30,67
"2011","Harlow 007A","E01021831","Total",641,228,121,107,413,36,97,73,92,17,29,69
"2011","Harlow 007B","E01021868","Total",674,207,117,90,467,41,81,100,101,15,27,102
"2011","Harlow 007C","E01021869","Total",558,140,72,68,418,29,89,64,108,19,36,73
"2011","Harlow 007D","E01021871","Total",629,236,93,143,393,49,71,84,83,13,26,67
"2011","Harlow 007E","E01021872","Total",829,340,86,254,489,64,34,128,136,22,29,76
"2011","Harlow 008A","E01021821","Total",640,253,119,134,387,45,71,89,98,8,16,60
"2011","Harlow 008B","E01021834","Total",654,192,86,106,462,50,94,86,122,16,29,65
"2011","Harlow 008C","E01021835","Total",607,170,89,81,437,39,79,83,101,14,47,74
"2011","Harlow 008D","E01021836","Total",644,243,105,138,401,46,54,84,114,17,26,60
"2011","Harlow 008E","E01021837","Total",635,199,101,98,436,31,87,80,124,18,19,77
"2011","Harlow 009A","E01021829","Total",651,245,84,161,406,33,59,79,114,15,27,79
"2011","Harlow 009B","E01021830","Total",493,108,53,55,385,19,100,57,94,10,28,77
"2011","Harlow 009C","E01021832","Total",514,137,39,98,377,21,51,74,114,7,35,75
"2011","Harlow 009D","E01021833","Total",522,149,83,66,373,17,76,74,92,14,19,81
"2011","Harlow 009E","E01021865","Total",568,201,56,145,367,28,37,75,111,19,29,68
"2011","Harlow 010A","E01021838","Total",605,142,71,71,463,43,107,71,95,12,27,108
"2011","Harlow 010B","E01021858","Total",640,195,68,127,445,54,65,97,107,16,21,85
"2011","Harlow 010C","E01021859","Total",615,188,64,124,427,58,52,96,104,16,31,70
"2011","Harlow 010D","E01021860","Total",598,160,53,107,438,47,72,70,111,32,36,70
"2011","Harlow 010E","E01021861","Total",491,105,45,60,386,39,64,67,81,21,39,75
"2011","Harlow 011A","E01021862","Total",626,220,69,151,406,43,65,87,100,17,38,56
"2011","Harlow 011B","E01021863","Total",621,179,43,136,442,41,60,85,99,21,49,87
"2011","Harlow 011C","E01021864","Total",549,137,31,106,412,50,47,74,97,14,48,82
"2011","Harlow 011D","E01021866","Total",609,223,77,146,386,31,35,90,130,14,23,63
"2011","Harlow 011E","E01021867","Total",584,138,67,71,446,17,87,62,129,12,35,104
"2011","Maldon 001A","E01021908","Total",857,231,102,129,626,18,136,116,209,16,48,83
"2011","Maldon 001B","E01021909","Total",536,128,66,62,408,10,91,73,116,11,34,73
"2011","Maldon 001C","E01021910","Total",637,188,93,95,449,11,110,80,123,20,32,73
"2011","Maldon 001D","E01021911","Total",473,92,54,38,381,5,103,54,98,12,45,64
"2011","Maldon 002A","E01021882","Total",842,182,112,70,660,8,202,107,174,23,36,110
"2011","Maldon 002B","E01021883","Total",651,130,57,73,521,19,110,114,137,24,28,89
"2011","Maldon 002C","E01021912","Total",830,174,104,70,656,11,224,111,141,23,35,111
"2011","Maldon 002D","E01021913","Total",589,107,65,42,482,7,129,84,120,20,33,89
"2011","Maldon 003A","E01021884","Total",604,167,39,128,437,21,62,90,155,16,20,73
"2011","Maldon 003B","E01021885","Total",475,116,49,67,359,12,85,70,89,13,18,72
"2011","Maldon 003C","E01021886","Total",601,146,55,91,455,19,79,92,128,18,26,93
"2011","Maldon 003D","E01021887","Total",864,213,83,130,651,26,84,196,187,38,33,87
"2011","Maldon 003E","E01021888","Total",821,278,134,144,543,53,82,110,149,27,33,89
"2011","Maldon 004A","E01021889","Total",930,284,152,132,646,56,111,135,168,28,41,107
"2011","Maldon 004B","E01021890","Total",905,397,189,208,508,44,100,95,172,10,21,66
"2011","Maldon 004C","E01021891","Total",743,329,203,126,414,12,155,63,107,4,18,55
"2011","Maldon 004D","E01021892","Total",481,185,108,77,296,33,82,47,56,9,23,46
"2011","Maldon 005A","E01021893","Total",592,110,54,56,482,19,101,128,114,18,33,69
"2011","Maldon 005B","E01021894","Total",498,132,65,67,366,25,66,88,91,9,28,59
"2011","Maldon 005C","E01021895","Total",492,116,47,69,376,20,69,79,90,16,20,82
"2011","Maldon 005D","E01021896","Total",494,72,51,21,422,11,89,84,100,14,41,83
"2011","Maldon 005E","E01021897","Total",484,122,39,83,362,20,77,74,82,3,21,85
"2011","Maldon 005F","E01021898","Total",587,192,135,57,395,9,126,67,96,14,15,68
"2011","Maldon 006A","E01021901","Total",794,194,90,104,600,16,170,119,157,16,35,87
"2011","Maldon 006B","E01021904","Total",562,126,57,69,436,23,73,93,105,29,35,78
"2011","Maldon 006C","E01021905","Total",499,119,68,51,380,21,80,72,90,13,34,70
"2011","Maldon 006D","E01021906","Total",642,209,68,141,433,27,66,99,114,16,33,78
"2011","Maldon 006E","E01021907","Total",886,204,99,105,682,18,154,112,206,19,49,124
"2011","Maldon 007A","E01021873","Total",513,78,42,36,435,11,85,74,121,18,34,92
"2011","Maldon 007B","E01021874","Total",530,124,55,69,406,27,69,77,98,14,33,88
"2011","Maldon 007C","E01021875","Total",639,201,119,82,438,8,150,54,121,12,26,67
"2011","Maldon 007D","E01021899","Total",513,87,40,47,426,14,63,82,130,18,41,78
"2011","Maldon 007E","E01021900","Total",442,117,56,61,325,12,54,78,78,11,29,63
"2011","Maldon 007F","E01021902","Total",668,97,50,47,571,10,130,106,142,15,47,121
"2011","Maldon 007G","E01021903","Total",624,109,67,42,515,12,141,84,115,21,38,104
"2011","Maldon 008C","E01021878","Total",633,185,128,57,448,15,149,80,101,7,16,80
"2011","Maldon 008D","E01021879","Total",628,223,96,127,405,20,87,88,116,14,28,52
"2011","Maldon 008E","E01021880","Total",782,363,174,189,419,29,121,62,140,7,15,45
"2011","Maldon 008F","E01021881","Total",526,168,70,98,358,14,91,85,85,6,19,58
"2011","Maldon 008G","E01033057","Total",950,228,116,112,722,29,176,138,188,20,52,119
"2011","Rochford 001A","E01021942","Total",825,332,209,123,493,12,212,48,130,6,22,63
"2011","Rochford 001B","E01021943","Total",707,139,96,43,568,17,145,74,151,13,47,121
"2011","Rochford 001C","E01021944","Total",633,109,69,40,524,14,126,90,120,12,43,119
"2011","Rochford 001D","E01021945","Total",621,121,77,44,500,9,141,63,116,12,45,114
"2011","Rochford 002A","E01021914","Total",800,155,89,66,645,13,162,125,134,23,70,118
"2011","Rochford 002B","E01021927","Total",490,71,37,34,419,7,92,72,89,18,35,106
"2011","Rochford 002C","E01021928","Total",668,202,132,70,466,8,103,85,127,7,42,94
"2011","Rochford 002D","E01021929","Total",579,87,48,39,492,18,83,96,101,24,65,105
"2011","Rochford 002E","E01021931","Total",585,154,105,49,431,12,146,59,95,12,28,79
"2011","Rochford 003A","E01021933","Total",509,94,55,39,415,10,98,79,80,19,34,95
"2011","Rochford 003B","E01021934","Total",528,86,53,33,442,13,112,84,84,18,39,92
"2011","Rochford 003C","E01021935","Total",533,97,62,35,436,11,120,78,98,13,36,80
"2011","Rochford 003D","E01021936","Total",784,283,198,85,501,14,155,86,108,15,34,89
"2011","Rochford 003E","E01021937","Total",700,197,87,110,503,35,105,103,125,19,38,78
"2011","Rochford 003F","E01021938","Total",641,176,114,62,465,13,155,75,81,13,33,95
"2011","Rochford 003G","E01021939","Total",671,150,100,50,521,6,137,108,108,12,34,116
"2011","Rochford 003H","E01021940","Total",789,120,75,45,669,17,159,143,140,25,43,142
"2011","Rochford 003I","E01021941","Total",774,126,66,60,648,14,150,114,139,25,60,146
"2011","Rochford 004A","E01021915","Total",515,106,43,63,409,18,80,72,126,21,28,64
"2011","Rochford 004B","E01021916","Total",415,103,62,41,312,15,67,62,62,20,32,54
"2011","Rochford 004C","E01021953","Total",564,129,48,81,435,76,51,94,71,18,48,77
"2011","Rochford 004D","E01021955","Total",885,363,192,171,522,73,83,105,155,18,37,51
"2011","Rochford 005A","E01021918","Total",568,91,40,51,477,9,87,131,116,18,24,92
"2011","Rochford 005B","E01021919","Total",517,116,72,44,401,9,107,63,87,16,27,92
"2011","Rochford 005C","E01021925","Total",653,157,100,57,496,15,108,101,126,16,40,90
"2011","Rochford 005D","E01021960","Total",759,138,87,51,621,8,180,111,124,24,56,118
"2011","Rochford 005E","E01021961","Total",636,149,99,50,487,22,161,72,109,14,30,79
"2011","Rochford 006A","E01021920","Total",737,132,48,84,605,24,77,156,154,25,47,122
"2011","Rochford 006B","E01021926","Total",860,220,108,112,640,27,104,195,182,28,29,75
"2011","Rochford 006C","E01021957","Total",622,184,87,97,438,35,70,77,125,22,22,87
"2011","Rochford 006D","E01021958","Total",518,127,37,90,391,16,46,115,134,11,15,54
"2011","Rochford 006E","E01021959","Total",635,126,55,71,509,22,66,133,140,28,45,75
"2011","Rochford 007A","E01021930","Total",665,277,72,205,388,19,69,76,132,12,22,58
"2011","Rochford 007B","E01021932","Total",634,158,88,70,476,24,118,79,116,20,39,80
"2011","Rochford 007C","E01021952","Total",602,162,93,69,440,23,100,91,120,11,17,78
"2011","Rochford 007D","E01021954","Total",604,167,95,72,437,22,69,98,108,18,36,86
"2011","Rochford 007E","E01021956","Total",628,180,94,86,448,31,86,81,122,8,32,88
"2011","Rochford 008A","E01021950","Total",594,146,92,54,448,17,99,81,106,13,37,95
"2011","Rochford 008B","E01021951","Total",509,121,89,32,388,13,95,75,86,15,32,72
"2011","Rochford 008C","E01021962","Total",507,135,96,39,372,36,83,68,88,7,18,72
"2011","Rochford 008D","E01021963","Total",520,100,64,36,420,12,102,75,102,18,35,76
"2011","Rochford 008E","E01021964","Total",667,188,120,68,479,12,112,105,114,13,28,95
"2011","Rochford 008F","E01021966","Total",794,300,203,97,494,23,115,89,107,17,43,100
"2011","Rochford 009A","E01021946","Total",551,62,43,19,489,6,116,86,101,15,39,126
"2011","Rochford 009B","E01021947","Total",499,111,73,38,388,9,114,74,84,7,25,75
"2011","Rochford 009C","E01021948","Total",524,109,56,53,415,19,82,85,105,17,33,74
"2011","Rochford 009D","E01021949","Total",604,140,95,45,464,9,127,81,88,16,37,106
"2011","Rochford 009E","E01021965","Total",963,235,154,81,728,24,211,139,161,15,50,128
"2011","Rochford 010A","E01021917","Total",704,156,80,76,548,25,106,101,127,24,63,102
"2011","Rochford 010B","E01021921","Total",591,114,39,75,477,23,82,99,136,12,33,92
"2011","Rochford 010C","E01021922","Total",669,221,146,75,448,35,102,65,87,25,53,81
"2011","Rochford 010D","E01021923","Total",520,89,49,40,431,19,87,81,108,14,38,84
"2011","Rochford 010E","E01021924","Total",494,101,53,48,393,15,74,70,102,11,40,81
"2011","Tendring 001A","E01021997","Total",663,317,107,210,346,38,59,57,88,16,33,55
"2011","Tendring 001B","E01021998","Total",631,248,84,164,383,38,77,63,98,18,25,64
"2011","Tendring 001C","E01021999","Total",752,269,144,125,483,45,98,84,123,20,35,78
"2011","Tendring 001D","E01022001","Total",827,373,127,246,454,65,73,89,129,12,27,59
"2011","Tendring 002A","E01022000","Total",646,147,79,68,499,32,125,106,103,28,33,72
"2011","Tendring 002C","E01022006","Total",732,259,153,106,473,51,105,78,118,22,37,62
"2011","Tendring 002D","E01022007","Total",653,150,66,84,503,43,71,79,136,37,43,94
"2011","Tendring 002F","E01033051","Total",1096,383,211,172,713,69,182,110,166,31,38,117
"2011","Tendring 003A","E01021978","Total",906,196,124,72,710,21,173,122,199,25,40,130
"2011","Tendring 003B","E01022013","Total",650,152,75,77,498,18,133,74,130,12,41,90
"2011","Tendring 003C","E01022014","Total",584,165,94,71,419,25,113,64,91,12,28,86
"2011","Tendring 003D","E01022015","Total",608,197,79,118,411,31,63,99,124,3,21,70
"2011","Tendring 003E","E01022019","Total",560,141,64,77,419,13,109,69,103,10,30,85
"2011","Tendring 003F","E01022020","Total",901,390,182,208,511,27,105,92,200,19,15,53
"2011","Tendring 003G","E01022021","Total",603,198,75,123,405,25,84,73,111,21,23,68
"2011","Tendring 004A","E01021991","Total",418,90,47,43,328,12,98,46,73,11,18,70
"2011","Tendring 004B","E01021992","Total",476,111,56,55,365,18,77,76,90,10,23,71
"2011","Tendring 004C","E01022002","Total",791,172,108,64,619,36,178,119,140,21,44,81
"2011","Tendring 004D","E01022004","Total",748,217,131,86,531,33,172,84,128,11,28,75
"2011","Tendring 004E","E01022005","Total",757,211,135,76,546,37,161,83,130,18,30,87
"2011","Tendring 004F","E01022028","Total",546,121,62,59,425,27,100,57,116,20,34,71
"2011","Tendring 005A","E01021971","Total",416,88,40,48,328,9,76,48,85,9,29,72
"2011","Tendring 005B","E01021972","Total",491,111,52,59,380,10,70,75,100,17,31,77
"2011","Tendring 005C","E01022051","Total",575,123,72,51,452,19,114,66,127,17,28,81
"2011","Tendring 005D","E01022052","Total",600,157,87,70,443,19,118,77,106,17,32,74
"2011","Tendring 006A","E01021985","Total",660,240,169,71,420,14,176,50,107,10,22,41
"2011","Tendring 006B","E01021986","Total",726,319,228,91,407,21,173,43,83,6,27,54
"2011","Tendring 006C","E01022054","Total",629,192,119,73,437,37,156,48,96,9,34,57
"2011","Tendring 006D","E01022055","Total",642,247,180,67,395,16,171,45,98,12,16,37
"2011","Tendring 006E","E01022056","Total",766,319,155,164,447,45,106,65,117,9,41,64
"2011","Tendring 007A","E01021973","Total",471,101,66,35,370,16,106,59,90,14,24,61
"2011","Tendring 007B","E01021974","Total",483,113,47,66,370,17,81,59,114,10,30,59
"2011","Tendring 007C","E01022016","Total",839,308,178,130,531,18,219,55,114,14,38,73
"2011","Tendring 007D","E01022017","Total",575,137,62,75,438,22,122,71,92,14,28,89
"2011","Tendring 007E","E01022018","Total",624,193,119,74,431,24,134,55,102,18,32,66
"2011","Tendring 008A","E01021987","Total",593,202,149,53,391,21,170,37,78,9,25,51
"2011","Tendring 008B","E01021994","Total",606,253,205,48,353,10,171,32,75,6,9,50
"2011","Tendring 008C","E01021995","Total",634,195,157,38,439,16,187,58,78,10,19,71
"2011","Tendring 008D","E01021996","Total",615,211,153,58,404,28,149,66,85,6,31,39
"2011","Tendring 008E","E01022009","Total",640,203,121,82,437,13,166,49,114,10,21,64
"2011","Tendring 008F","E01022010","Total",704,195,117,78,509,27,196,65,112,14,23,72
"2011","Tendring 008G","E01022011","Total",742,201,122,79,541,28,145,74,129,24,49,92
"2011","Tendring 008H","E01022012","Total",1001,394,314,80,607,38,324,50,107,5,19,64
"2011","Tendring 009A","E01021967","Total",836,193,117,76,643,23,180,110,151,22,40,117
"2011","Tendring 009B","E01021983","Total",611,160,88,72,451,17,148,54,130,7,27,68
"2011","Tendring 009C","E01021993","Total",944,246,144,102,698,38,187,116,181,23,51,102
"2011","Tendring 009D","E01022053","Total",710,154,85,69,556,9,142,96,167,19,39,84
"2011","Tendring 010A","E01021984","Total",1004,327,239,88,677,26,287,68,166,14,28,88
"2011","Tendring 010B","E01022039","Total",657,216,119,97,441,43,113,78,92,13,28,74
"2011","Tendring 010C","E01022040","Total",816,251,181,70,565,31,226,66,120,13,27,82
"2011","Tendring 010D","E01022041","Total",711,243,163,80,468,29,182,48,105,5,27,72
"2011","Tendring 011A","E01021979","Total",624,170,106,64,454,27,128,91,86,11,38,73
"2011","Tendring 011B","E01021980","Total",770,237,150,87,533,23,159,75,138,20,28,90
"2011","Tendring 011C","E01021981","Total",793,307,160,147,486,28,129,84,119,15,37,74
"2011","Tendring 011D","E01021982","Total",830,296,96,200,534,75,81,91,159,26,24,78
"2011","Tendring 011E","E01022046","Total",686,210,124,86,476,31,168,40,90,9,52,86
"2011","Tendring 012A","E01022008","Total",1002,329,256,73,673,20,326,72,135,16,20,84
"2011","Tendring 012B","E01022033","Total",733,248,188,60,485,10,239,33,115,6,20,62
"2011","Tendring 012C","E01022034","Total",772,280,204,76,492,34,214,39,117,2,23,63
"2011","Tendring 012D","E01022035","Total",698,214,156,58,484,27,206,32,107,7,31,74
"2011","Tendring 013A","E01021975","Total",644,193,109,84,451,40,129,76,90,14,41,61
"2011","Tendring 013B","E01021976","Total",613,188,115,73,425,21,112,74,99,11,33,75
"2011","Tendring 013C","E01021977","Total",710,203,131,72,507,39,148,71,103,18,35,93
"2011","Tendring 013D","E01022022","Total",602,175,74,101,427,29,78,85,96,33,32,74
"2011","Tendring 013E","E01022044","Total",743,234,137,97,509,20,177,62,109,19,40,82
"2011","Tendring 014A","E01022042","Total",687,260,142,118,427,52,110,73,98,13,38,43
"2011","Tendring 014B","E01022043","Total",751,224,72,152,527,78,71,93,112,24,58,91
"2011","Tendring 014C","E01022048","Total",705,268,155,113,437,18,167,59,104,11,21,57
"2011","Tendring 014D","E01022049","Total",618,177,100,77,441,34,122,62,95,13,40,75
"2011","Tendring 014E","E01022050","Total",870,345,228,117,525,55,205,55,118,9,16,67
"2011","Tendring 015A","E01022023","Total",645,211,93,118,434,57,89,54,110,19,42,63
"2011","Tendring 015B","E01022024","Total",642,208,130,78,434,50,87,70,101,16,34,76
"2011","Tendring 015C","E01022030","Total",759,277,162,115,482,45,172,58,87,13,41,66
"2011","Tendring 015D","E01022031","Total",577,185,58,127,392,88,45,86,77,20,21,55
"2011","Tendring 015E","E01022032","Total",715,196,114,82,519,58,144,84,79,31,47,76
"2011","Tendring 016A","E01021970","Total",825,401,188,213,424,59,87,80,89,21,30,58
"2011","Tendring 016B","E01022025","Total",776,466,201,265,310,32,82,41,81,9,23,42
"2011","Tendring 016C","E01022026","Total",630,244,79,165,386,50,44,74,82,24,46,66
"2011","Tendring 016D","E01022027","Total",788,371,154,217,417,39,89,63,118,15,30,63
"2011","Tendring 017A","E01021968","Total",729,225,93,132,504,73,72,108,86,15,58,92
"2011","Tendring 017B","E01021969","Total",587,165,88,77,422,55,59,65,116,24,34,69
"2011","Tendring 017C","E01022036","Total",571,176,87,89,395,22,131,46,99,12,25,60
"2011","Tendring 017D","E01022037","Total",622,242,165,77,380,16,153,36,68,6,30,71
"2011","Tendring 017E","E01022038","Total",632,177,113,64,455,34,152,52,82,17,37,81
"2011","Tendring 018A","E01021988","Total",1029,589,187,402,440,64,95,48,147,18,19,49
"2011","Tendring 018B","E01021989","Total",757,262,188,74,495,9,263,30,113,8,19,53
"2011","Tendring 018C","E01021990","Total",842,344,216,128,498,26,207,43,139,7,14,62
"2011","Tendring 018D","E01022045","Total",681,262,155,107,419,32,144,51,92,20,28,52
"2011","Tendring 018E","E01022047","Total",578,187,115,72,391,23,116,55,93,12,20,72
"2011","Uttlesford 001A","E01022057","Total",674,136,70,66,538,17,119,112,127,29,44,90
"2011","Uttlesford 001B","E01022075","Total",715,184,88,96,531,10,131,117,113,29,52,79
"2011","Uttlesford 001C","E01022077","Total",637,147,73,74,490,24,93,97,134,16,39,87
"2011","Uttlesford 001D","E01022094","Total",679,172,89,83,507,5,104,126,125,37,38,72
"2011","Uttlesford 002A","E01022074","Total",584,129,64,65,455,21,101,88,90,33,44,78
"2011","Uttlesford 002B","E01022076","Total",939,474,294,180,465,17,137,76,158,15,14,48
"2011","Uttlesford 002C","E01022078","Total",622,166,83,83,456,38,73,90,120,24,34,77
"2011","Uttlesford 002D","E01022079","Total",750,246,114,132,504,25,94,107,145,17,33,83
"2011","Uttlesford 002E","E01022080","Total",633,163,35,128,470,31,34,99,144,15,33,114
"2011","Uttlesford 002F","E01022081","Total",963,290,182,108,673,45,130,158,181,30,38,91
"2011","Uttlesford 002G","E01022082","Total",667,126,54,72,541,21,81,122,164,13,35,105
"2011","Uttlesford 003A","E01022061","Total",568,96,61,35,472,11,131,86,108,19,39,78
"2011","Uttlesford 003B","E01022071","Total",652,131,63,68,521,8,112,107,126,39,43,86
"2011","Uttlesford 003C","E01022072","Total",733,146,69,77,587,14,134,125,146,32,50,86
"2011","Uttlesford 003D","E01022073","Total",628,142,88,54,486,17,92,106,119,13,43,96
"2011","Uttlesford 003E","E01022098","Total",609,123,63,60,486,4,112,96,137,22,35,80
"2011","Uttlesford 004A","E01022092","Total",716,186,77,109,530,12,137,102,130,27,42,80
"2011","Uttlesford 004B","E01022093","Total",719,196,137,59,523,33,112,98,133,28,38,81
"2011","Uttlesford 004C","E01022097","Total",713,131,75,56,582,12,150,105,108,44,50,113
"2011","Uttlesford 004D","E01022099","Total",785,115,58,57,670,14,114,187,181,48,47,79
"2011","Uttlesford 005A","E01022062","Total",786,135,61,74,651,20,129,128,165,37,52,120
"2011","Uttlesford 005B","E01022063","Total",622,123,68,55,499,22,89,86,147,21,37,97
"2011","Uttlesford 005C","E01022083","Total",684,163,75,88,521,11,125,94,149,17,38,87
"2011","Uttlesford 005D","E01022084","Total",610,102,66,36,508,11,113,98,114,27,37,108
"2011","Uttlesford 005E","E01022085","Total",691,208,67,141,483,18,58,110,179,15,26,77
"2011","Uttlesford 005F","E01022087","Total",715,147,52,95,568,23,73,153,182,15,29,93
"2011","Uttlesford 005G","E01022089","Total",603,107,49,58,496,15,103,103,138,30,30,77
"2011","Uttlesford 006A","E01022086","Total",524,134,55,79,390,28,52,73,100,27,25,85
"2011","Uttlesford 006B","E01022090","Total",923,215,84,131,708,31,91,182,196,37,51,120
"2011","Uttlesford 006C","E01022091","Total",910,165,61,104,745,44,156,154,191,24,60,116
"2011","Uttlesford 006D","E01022095","Total",602,101,48,53,501,13,112,108,137,14,39,78
"2011","Uttlesford 007B","E01022067","Total",926,442,188,254,484,28,71,109,185,9,21,61
"2011","Uttlesford 007C","E01022068","Total",618,132,66,66,486,22,96,123,108,18,44,75
"2011","Uttlesford 007D","E01033054","Total",468,144,50,94,324,40,44,80,86,18,18,38
"2011","Uttlesford 007E","E01033055","Total",542,96,33,63,446,17,72,134,103,16,42,62
"2011","Uttlesford 007F","E01033056","Total",521,124,68,56,397,17,97,78,70,20,36,79
"2011","Uttlesford 008A","E01022058","Total",636,98,54,44,538,9,110,113,135,22,52,97
"2011","Uttlesford 008B","E01022064","Total",676,130,82,48,546,13,146,100,120,24,41,102
"2011","Uttlesford 008D","E01022069","Total",661,192,115,77,469,11,143,85,123,13,35,59
"2011","Uttlesford 008E","E01022088","Total",609,113,70,43,496,12,115,82,133,20,36,98
"2011","Uttlesford 008F","E01033052","Total",621,143,80,63,478,17,113,112,98,23,40,75
"2011","Uttlesford 008G","E01033053","Total",622,81,12,69,541,32,21,229,119,46,38,56
"2011","Uttlesford 009A","E01022059","Total",622,149,78,71,473,14,104,94,98,31,38,94
"2011","Uttlesford 009B","E01022060","Total",696,110,73,37,586,8,130,110,126,31,60,121
"2011","Uttlesford 009C","E01022070","Total",712,163,98,65,549,17,124,125,92,37,53,101
"2011","Uttlesford 009D","E01022096","Total",730,156,83,73,574,17,110,127,166,22,43,89
"2011","Broxbourne 001A","E01023316","Total",512,76,43,33,436,10,96,93,66,18,37,116
"2011","Broxbourne 001B","E01023317","Total",906,157,59,98,749,62,110,179,149,45,58,146
"2011","Broxbourne 001C","E01023318","Total",597,85,40,45,512,23,113,101,95,16,37,127
"2011","Broxbourne 001D","E01023319","Total",633,133,92,41,500,7,150,74,104,18,35,112
"2011","Broxbourne 002A","E01023327","Total",551,129,48,81,422,37,80,91,79,23,42,70
"2011","Broxbourne 002B","E01023328","Total",509,127,54,73,382,23,51,93,71,12,46,86
"2011","Broxbourne 002C","E01023329","Total",502,110,63,47,392,20,77,81,75,19,30,90
"2011","Broxbourne 002D","E01023330","Total",607,161,45,116,446,54,51,113,113,16,31,68
"2011","Broxbourne 002E","E01023331","Total",598,136,64,72,462,29,83,106,108,14,46,76
"2011","Broxbourne 003A","E01023320","Total",982,434,177,257,548,52,110,107,170,16,24,69
"2011","Broxbourne 003B","E01023321","Total",842,242,160,82,600,21,150,116,141,21,32,119
"2011","Broxbourne 003C","E01023322","Total",745,228,73,155,517,48,69,125,131,16,39,89
"2011","Broxbourne 003D","E01023323","Total",798,375,128,247,423,37,70,85,116,16,27,72
"2011","Broxbourne 004A","E01023289","Total",525,66,49,17,459,4,86,111,83,27,40,108
"2011","Broxbourne 004B","E01023290","Total",632,128,76,52,504,9,147,107,86,24,36,95
"2011","Broxbourne 004C","E01023291","Total",612,146,86,60,466,9,121,76,100,17,36,107
"2011","Broxbourne 004D","E01023292","Total",629,185,98,87,444,20,89,87,109,9,32,98
"2011","Broxbourne 005A","E01023340","Total",722,219,61,158,503,50,71,105,119,20,41,97
"2011","Broxbourne 005B","E01023341","Total",719,186,96,90,533,16,110,103,125,22,45,112
"2011","Broxbourne 005C","E01023342","Total",1109,297,72,225,812,142,83,201,223,18,51,94
"2011","Broxbourne 005D","E01023343","Total",728,196,40,156,532,107,41,130,109,21,39,85
"2011","Broxbourne 005E","E01023344","Total",762,240,107,133,522,35,87,124,147,12,27,90
"2011","Broxbourne 006A","E01023307","Total",539,73,40,33,466,18,83,98,92,22,49,104
"2011","Broxbourne 006B","E01023308","Total",632,111,62,49,521,13,105,102,110,14,55,122
"2011","Broxbourne 006C","E01023309","Total",621,95,58,37,526,9,110,99,108,13,53,134
"2011","Broxbourne 006D","E01023310","Total",881,258,110,148,623,121,60,142,122,22,63,93
"2011","Broxbourne 007A","E01023311","Total",653,138,74,64,515,23,128,83,96,13,35,137
"2011","Broxbourne 007B","E01023312","Total",576,97,29,68,479,14,52,101,101,21,59,131
"2011","Broxbourne 007C","E01023313","Total",630,128,102,26,502,6,158,86,81,13,45,113
"2011","Broxbourne 007D","E01023315","Total",627,84,20,64,543,31,29,171,124,29,58,101
"2011","Broxbourne 008A","E01023302","Total",685,268,174,94,417,36,87,67,85,17,30,95
"2011","Broxbourne 008B","E01023303","Total",618,161,52,109,457,43,61,89,115,15,49,85
"2011","Broxbourne 008C","E01023304","Total",638,167,97,70,471,36,102,100,99,8,37,89
"2011","Broxbourne 008D","E01023305","Total",504,103,43,60,401,27,57,92,80,20,48,77
"2011","Broxbourne 008E","E01023306","Total",619,173,68,105,446,23,88,80,111,11,32,101
"2011","Broxbourne 009A","E01023314","Total",510,113,46,67,397,22,66,73,89,10,36,101
"2011","Broxbourne 009B","E01023324","Total",519,112,52,60,407,14,69,77,92,25,35,95
"2011","Broxbourne 009C","E01023325","Total",620,209,88,121,411,25,62,104,111,12,20,77
"2011","Broxbourne 009D","E01023326","Total",666,199,70,129,467,44,92,96,82,20,45,88
"2011","Broxbourne 010A","E01023297","Total",507,103,63,40,404,17,73,77,89,22,35,91
"2011","Broxbourne 010B","E01023298","Total",651,168,113,55,483,29,136,94,80,13,32,99
"2011","Broxbourne 010C","E01023299","Total",671,158,66,92,513,20,122,105,100,32,34,100
"2011","Broxbourne 010D","E01023300","Total",632,248,126,122,384,39,65,72,99,19,35,55
"2011","Broxbourne 010E","E01023301","Total",683,219,69,150,464,51,59,112,100,15,35,92
"2011","Broxbourne 011A","E01023293","Total",661,142,75,67,519,27,124,116,90,24,40,98
"2011","Broxbourne 011B","E01023294","Total",712,289,165,124,423,51,79,80,94,14,25,80
"2011","Broxbourne 011C","E01023295","Total",567,145,82,63,422,25,79,75,86,9,45,103
"2011","Broxbourne 011D","E01023296","Total",636,149,86,63,487,31,88,98,92,21,44,113
"2011","Broxbourne 012A","E01023332","Total",888,267,167,100,621,53,149,123,128,20,42,106
"2011","Broxbourne 012B","E01023333","Total",786,238,88,150,548,58,80,115,143,14,47,91
"2011","Broxbourne 012C","E01023334","Total",688,172,103,69,516,16,142,85,109,16,48,100
"2011","Broxbourne 012D","E01023335","Total",655,139,92,47,516,14,117,99,87,11,60,128
"2011","Broxbourne 013A","E01023336","Total",821,241,66,175,580,62,60,105,157,24,70,102
"2011","Broxbourne 013B","E01023337","Total",650,165,60,105,485,51,77,75,99,16,56,111
"2011","Broxbourne 013C","E01023338","Total",1098,514,167,347,584,112,62,130,159,20,40,61
"2011","Broxbourne 013D","E01023339","Total",594,168,80,88,426,57,46,83,84,11,47,98
"2011","Dacorum 001A","E01023430","Total",490,127,60,67,363,11,80,74,101,19,24,54
"2011","Dacorum 001B","E01023431","Total",502,112,49,63,390,10,78,71,119,20,22,70
"2011","Dacorum 001C","E01023432","Total",579,136,53,83,443,18,80,114,120,16,22,73
"2011","Dacorum 001D","E01023433","Total",676,240,83,157,436,36,49,109,155,9,21,57
"2011","Dacorum 002A","E01023423","Total",549,136,86,50,413,12,89,94,109,17,28,64
"2011","Dacorum 002B","E01023424","Total",564,153,55,98,411,11,71,108,112,15,39,55
"2011","Dacorum 002C","E01023425","Total",522,119,57,62,403,13,85,100,88,20,22,75
"2011","Dacorum 002D","E01023426","Total",715,324,103,221,391,33,54,81,154,5,19,45
"2011","Dacorum 003A","E01023418","Total",628,231,132,99,397,28,65,85,110,18,26,65
"2011","Dacorum 003B","E01023419","Total",830,222,62,160,608,25,65,154,176,41,47,100
"2011","Dacorum 003C","E01023420","Total",611,140,72,68,471,20,119,87,101,26,37,81
"2011","Dacorum 004A","E01023352","Total",1015,257,111,146,758,18,182,158,207,43,42,108
"2011","Dacorum 004B","E01023421","Total",642,194,75,119,448,18,95,104,118,14,32,67
"2011","Dacorum 004C","E01023422","Total",484,84,51,33,400,4,109,84,79,17,24,83
"2011","Dacorum 005A","E01023434","Total",663,198,33,165,465,33,53,101,162,16,34,66
"2011","Dacorum 005B","E01023435","Total",690,242,20,222,448,40,21,100,190,10,24,63
"2011","Dacorum 005C","E01023436","Total",483,103,26,77,380,12,56,70,122,16,24,80
"2011","Dacorum 005D","E01023437","Total",680,240,25,215,440,81,23,105,134,15,25,57
"2011","Dacorum 006A","E01023355","Total",620,134,74,60,486,7,127,93,128,23,36,72
"2011","Dacorum 006B","E01023356","Total",457,116,59,57,341,9,108,59,70,18,26,51
"2011","Dacorum 006C","E01023416","Total",652,200,116,84,452,10,132,91,120,19,16,64
"2011","Dacorum 006D","E01023417","Total",665,273,169,104,392,25,95,101,99,17,14,41
"2011","Dacorum 007A","E01023393","Total",884,444,151,293,440,42,69,87,142,15,20,65
"2011","Dacorum 007B","E01023394","Total",506,88,21,67,418,36,54,67,109,17,38,97
"2011","Dacorum 007C","E01023395","Total",628,162,40,122,466,54,45,79,127,32,42,87
"2011","Dacorum 007D","E01023396","Total",594,106,33,73,488,33,61,81,150,25,33,105
"2011","Dacorum 007E","E01023397","Total",518,134,45,89,384,50,29,73,88,17,33,94
"2011","Dacorum 008A","E01023401","Total",720,205,51,154,515,66,44,122,144,18,38,83
"2011","Dacorum 008B","E01023402","Total",654,192,79,113,462,26,84,99,99,18,48,88
"2011","Dacorum 008C","E01023403","Total",670,252,129,123,418,43,81,82,99,13,22,78
"2011","Dacorum 008D","E01023404","Total",529,160,62,98,369,69,24,66,88,20,31,71
"2011","Dacorum 008E","E01023405","Total",621,204,86,118,417,54,66,87,83,26,39,62
"2011","Dacorum 009A","E01023361","Total",924,435,135,300,489,31,63,100,245,11,7,32
"2011","Dacorum 009B","E01023362","Total",790,257,146,111,533,12,139,118,153,13,28,70
"2011","Dacorum 009C","E01023363","Total",629,153,45,108,476,20,77,149,120,23,21,66
"2011","Dacorum 009D","E01023364","Total",509,97,56,41,412,4,109,108,92,13,23,63
"2011","Dacorum 010A","E01023390","Total",874,276,106,170,598,52,101,139,149,23,38,96
"2011","Dacorum 010B","E01023391","Total",693,180,82,98,513,34,72,143,131,16,44,73
"2011","Dacorum 010C","E01023399","Total",848,402,145,257,446,33,86,90,162,9,22,44
"2011","Dacorum 011A","E01023392","Total",633,145,76,69,488,45,79,96,128,23,31,86
"2011","Dacorum 011B","E01023427","Total",649,161,77,84,488,48,69,115,100,12,47,97
"2011","Dacorum 011C","E01023428","Total",625,171,41,130,454,17,70,105,144,8,44,66
"2011","Dacorum 011D","E01023429","Total",800,287,177,110,513,38,108,97,113,21,38,98
"2011","Dacorum 012A","E01023369","Total",622,196,123,73,426,43,89,109,80,18,24,63
"2011","Dacorum 012B","E01023370","Total",726,245,76,169,481,37,46,153,142,14,25,64
"2011","Dacorum 012C","E01023371","Total",514,65,31,34,449,15,79,126,78,26,39,86
"2011","Dacorum 012D","E01023372","Total",539,84,57,27,455,4,119,110,99,20,36,67
"2011","Dacorum 013A","E01023345","Total",651,174,61,113,477,36,74,92,133,12,40,90
"2011","Dacorum 013B","E01023346","Total",534,147,69,78,387,39,75,80,81,22,20,70
"2011","Dacorum 013C","E01023347","Total",514,130,77,53,384,13,100,53,89,20,27,82
"2011","Dacorum 013D","E01023348","Total",688,265,135,130,423,55,62,86,92,26,34,68
"2011","Dacorum 014A","E01023365","Total",566,188,66,122,378,14,54,85,137,12,19,57
"2011","Dacorum 014B","E01023366","Total",645,194,58,136,451,37,60,114,129,16,21,74
"2011","Dacorum 014C","E01023367","Total",405,45,29,16,360,9,101,100,57,17,21,55
"2011","Dacorum 014D","E01023368","Total",677,157,82,75,520,30,72,145,147,33,34,59
"2011","Dacorum 015A","E01023349","Total",780,236,113,123,544,54,86,119,114,28,53,90
"2011","Dacorum 015B","E01023350","Total",661,180,113,67,481,39,78,98,125,20,32,89
"2011","Dacorum 015C","E01023351","Total",663,177,83,94,486,36,90,109,120,22,33,76
"2011","Dacorum 015D","E01023398","Total",1077,367,66,301,710,49,72,158,252,28,43,108
"2011","Dacorum 015E","E01023400","Total",878,408,153,255,470,38,83,72,171,16,29,61
"2011","Dacorum 016A","E01023383","Total",597,156,58,98,441,26,75,91,102,18,43,86
"2011","Dacorum 016B","E01023384","Total",780,217,100,117,563,48,84,129,134,23,38,107
"2011","Dacorum 016C","E01023385","Total",687,209,131,78,478,14,99,71,105,16,57,116
"2011","Dacorum 017A","E01023409","Total",633,212,101,111,421,18,91,87,89,14,42,80
"2011","Dacorum 017B","E01023410","Total",540,94,81,13,446,6,159,69,80,8,31,93
"2011","Dacorum 017C","E01023411","Total",594,136,70,66,458,44,85,99,100,22,29,79
"2011","Dacorum 017D","E01023412","Total",498,78,62,16,420,7,136,51,87,13,29,97
"2011","Dacorum 017E","E01023413","Total",536,121,30,91,415,46,52,91,117,15,24,70
"2011","Dacorum 018B","E01023354","Total",691,152,49,103,539,29,94,113,171,15,32,85
"2011","Dacorum 018C","E01023379","Total",675,183,92,91,492,17,96,123,134,11,34,77
"2011","Dacorum 018D","E01023380","Total",481,121,36,85,360,22,57,80,111,9,18,63
"2011","Dacorum 018E","E01023381","Total",516,96,70,26,420,8,102,79,90,15,33,93
"2011","Dacorum 018F","E01023382","Total",678,260,118,142,418,33,61,107,114,15,31,57
"2011","Dacorum 018G","E01033022","Total",663,253,19,234,410,28,18,81,228,6,18,31
"2011","Dacorum 018H","E01033023","Total",736,304,90,214,432,29,49,92,180,12,17,53
"2011","Dacorum 019A","E01023386","Total",608,160,65,95,448,34,60,84,124,16,38,92
"2011","Dacorum 019B","E01023387","Total",502,93,28,65,409,51,46,95,103,19,26,69
"2011","Dacorum 019C","E01023388","Total",652,178,59,119,474,28,75,99,131,20,40,81
"2011","Dacorum 019D","E01023389","Total",659,145,53,92,514,22,94,110,128,19,30,111
"2011","Dacorum 020A","E01023357","Total",675,210,123,87,465,57,63,83,109,22,48,83
"2011","Dacorum 020B","E01023358","Total",521,131,60,71,390,46,43,78,65,24,55,79
"2011","Dacorum 020C","E01023359","Total",670,152,68,84,518,49,69,137,93,23,54,93
"2011","Dacorum 020D","E01023360","Total",543,113,38,75,430,26,54,106,104,24,43,73
"2011","Dacorum 020E","E01023414","Total",595,184,63,121,411,26,44,108,112,11,35,75
"2011","Dacorum 020F","E01023415","Total",537,105,65,40,432,30,107,78,83,17,31,86
"2011","Dacorum 021A","E01023373","Total",505,171,82,89,334,15,55,88,88,14,29,45
"2011","Dacorum 021B","E01023374","Total",612,172,83,89,440,21,91,108,120,14,20,66
"2011","Dacorum 021C","E01023375","Total",641,183,98,85,458,17,112,95,93,20,47,74
"2011","Dacorum 021D","E01023376","Total",534,160,54,106,374,20,67,85,98,24,20,60
"2011","Dacorum 021E","E01023377","Total",499,118,66,52,381,12,110,75,83,15,22,64
"2011","Dacorum 021F","E01023378","Total",590,83,40,43,507,4,127,97,106,19,54,100
"2011","Dacorum 022A","E01023406","Total",872,317,163,154,555,39,97,131,153,13,31,91
"2011","Dacorum 022B","E01023407","Total",640,140,72,68,500,18,100,112,119,22,37,92
"2011","Dacorum 022C","E01023408","Total",623,118,74,44,505,19,119,111,98,21,42,95
"2011","East Hertfordshire 001A","E01023462","Total",524,113,56,57,411,19,74,75,117,22,37,67
"2011","East Hertfordshire 001B","E01023464","Total",806,142,61,81,664,17,147,150,137,32,53,128
"2011","East Hertfordshire 001C","E01023465","Total",559,113,55,58,446,17,97,78,106,22,43,83
"2011","East Hertfordshire 001D","E01023466","Total",764,270,153,117,494,32,111,100,102,16,36,97
"2011","East Hertfordshire 002A","E01023467","Total",975,219,109,110,756,20,196,138,183,31,53,135
"2011","East Hertfordshire 002B","E01023494","Total",481,102,60,42,379,8,97,71,90,16,30,67
"2011","East Hertfordshire 002C","E01023495","Total",498,118,40,78,380,15,73,77,95,25,25,70
"2011","East Hertfordshire 002D","E01023508","Total",578,119,43,76,459,16,96,94,115,25,29,84
"2011","East Hertfordshire 002E","E01023509","Total",552,133,60,73,419,35,69,94,110,13,36,62
"2011","East Hertfordshire 003A","E01023452","Total",482,72,22,50,410,23,32,129,95,17,43,71
"2011","East Hertfordshire 003B","E01023453","Total",538,121,47,74,417,10,86,113,93,23,32,60
"2011","East Hertfordshire 003C","E01023454","Total",504,104,33,71,400,13,61,106,104,18,31,67
"2011","East Hertfordshire 003D","E01023455","Total",538,157,76,81,381,19,58,93,103,10,34,64
"2011","East Hertfordshire 003E","E01023463","Total",497,129,73,56,368,11,92,65,92,21,29,58
"2011","East Hertfordshire 003F","E01023493","Total",933,181,78,103,752,29,130,176,186,47,56,128
"2011","East Hertfordshire 004A","E01023449","Total",669,188,92,96,481,14,97,119,127,22,31,71
"2011","East Hertfordshire 004B","E01023450","Total",989,440,145,295,549,31,78,109,222,17,21,71
"2011","East Hertfordshire 004C","E01023451","Total",929,260,129,131,669,17,151,143,187,22,37,112
"2011","East Hertfordshire 005A","E01023438","Total",583,150,62,88,433,32,64,101,108,22,29,77
"2011","East Hertfordshire 005B","E01023439","Total",504,77,50,27,427,30,83,80,95,9,39,91
"2011","East Hertfordshire 005C","E01023440","Total",647,131,84,47,516,10,139,101,105,17,33,111
"2011","East Hertfordshire 005D","E01023441","Total",491,145,35,110,346,19,37,76,103,21,26,64
"2011","East Hertfordshire 005E","E01023442","Total",798,186,51,135,612,38,69,172,148,23,39,123
"2011","East Hertfordshire 006A","E01023498","Total",1103,305,143,162,798,34,149,204,200,30,48,133
"2011","East Hertfordshire 006B","E01023506","Total",578,158,79,79,420,13,99,90,94,21,27,76
"2011","East Hertfordshire 006C","E01023507","Total",627,146,51,95,481,15,96,125,121,21,36,67
"2011","East Hertfordshire 007A","E01023443","Total",647,187,93,94,460,29,64,97,125,19,34,92
"2011","East Hertfordshire 007B","E01023444","Total",681,188,83,105,493,23,66,141,149,17,28,69
"2011","East Hertfordshire 007C","E01023445","Total",701,199,118,81,502,33,86,103,105,21,46,108
"2011","East Hertfordshire 007D","E01023446","Total",1135,499,151,348,636,47,61,141,301,9,15,62
"2011","East Hertfordshire 007E","E01023447","Total",484,127,50,77,357,51,50,66,65,22,32,71
"2011","East Hertfordshire 007F","E01023448","Total",585,143,40,103,442,32,34,120,113,24,30,89
"2011","East Hertfordshire 008A","E01023456","Total",511,103,33,70,408,15,35,119,84,16,44,95
"2011","East Hertfordshire 008B","E01023457","Total",610,145,56,89,465,24,62,127,130,14,32,76
"2011","East Hertfordshire 008C","E01023458","Total",520,124,49,75,396,13,63,82,108,19,36,75
"2011","East Hertfordshire 008D","E01023459","Total",518,119,47,72,399,13,63,89,91,14,36,93
"2011","East Hertfordshire 008E","E01023460","Total",548,109,58,51,439,10,74,119,86,30,44,76
"2011","East Hertfordshire 008F","E01023461","Total",515,58,17,41,457,15,42,149,91,41,64,55
"2011","East Hertfordshire 009A","E01023491","Total",528,128,47,81,400,20,83,77,113,20,26,61
"2011","East Hertfordshire 009B","E01023492","Total",586,117,54,63,469,21,94,95,124,12,30,93
"2011","East Hertfordshire 009C","E01023496","Total",442,98,50,48,344,20,68,72,83,13,27,61
"2011","East Hertfordshire 009D","E01023497","Total",648,179,110,69,469,16,116,95,100,22,46,74
"2011","East Hertfordshire 010A","E01023485","Total",954,240,114,126,714,16,182,137,192,27,50,110
"2011","East Hertfordshire 010B","E01023486","Total",989,206,105,101,783,25,161,153,204,38,52,150
"2011","East Hertfordshire 010E","E01033609","Total",971,266,110,156,705,36,125,185,190,24,40,105
"2011","East Hertfordshire 011A","E01023499","Total",755,237,114,123,518,42,111,90,122,22,42,89
"2011","East Hertfordshire 011B","E01023500","Total",615,100,65,35,515,11,121,98,137,20,33,95
"2011","East Hertfordshire 011C","E01023501","Total",679,219,97,122,460,24,99,93,128,16,24,76
"2011","East Hertfordshire 011D","E01023502","Total",799,285,97,188,514,37,89,120,158,21,18,71
"2011","East Hertfordshire 011E","E01023503","Total",739,202,87,115,537,15,139,107,129,11,43,93
"2011","East Hertfordshire 012A","E01023512","Total",834,281,85,196,553,26,75,121,195,22,34,80
"2011","East Hertfordshire 012B","E01023513","Total",590,147,87,60,443,14,94,104,84,22,29,96
"2011","East Hertfordshire 012C","E01023514","Total",907,439,152,287,468,32,76,95,187,8,23,47
"2011","East Hertfordshire 012D","E01023518","Total",705,141,63,78,564,40,89,120,99,42,52,122
"2011","East Hertfordshire 012E","E01023519","Total",668,156,67,89,512,33,69,128,131,25,47,79
"2011","East Hertfordshire 012F","E01023520","Total",664,182,83,99,482,15,124,123,87,16,41,76
"2011","East Hertfordshire 013A","E01023510","Total",605,149,59,90,456,3,103,107,115,14,31,83
"2011","East Hertfordshire 013B","E01023511","Total",815,378,115,263,437,26,48,89,197,9,10,58
"2011","East Hertfordshire 013C","E01023515","Total",670,198,44,154,472,18,45,117,172,20,24,76
"2011","East Hertfordshire 013D","E01023516","Total",874,232,65,167,642,24,92,155,200,16,43,112
"2011","East Hertfordshire 013E","E01023517","Total",679,195,66,129,484,41,93,93,130,19,33,75
"2011","East Hertfordshire 014A","E01023470","Total",906,393,125,268,513,21,59,128,242,6,17,40
"2011","East Hertfordshire 014B","E01023471","Total",536,127,69,58,409,8,86,95,110,14,30,66
"2011","East Hertfordshire 014C","E01023472","Total",606,215,110,105,391,35,71,82,107,24,18,54
"2011","East Hertfordshire 014D","E01023473","Total",598,146,98,48,452,6,144,85,85,22,28,82
"2011","East Hertfordshire 014E","E01023474","Total",624,140,56,84,484,15,89,142,135,19,27,57
"2011","East Hertfordshire 015A","E01023487","Total",624,234,105,129,390,43,72,69,96,17,32,61
"2011","East Hertfordshire 015B","E01023488","Total",706,258,82,176,448,93,46,95,111,23,27,53
"2011","East Hertfordshire 015C","E01023489","Total",641,253,85,168,388,12,80,89,139,14,15,39
"2011","East Hertfordshire 015D","E01023490","Total",478,86,37,49,392,23,55,108,91,21,24,70
"2011","East Hertfordshire 016A","E01023482","Total",751,172,35,137,579,37,34,209,180,29,49,41
"2011","East Hertfordshire 016B","E01023483","Total",740,154,63,91,586,28,81,142,147,33,51,104
"2011","East Hertfordshire 016C","E01023484","Total",638,193,63,130,445,32,44,128,125,20,26,70
"2011","East Hertfordshire 017A","E01023475","Total",623,196,75,121,427,41,54,92,113,12,37,78
"2011","East Hertfordshire 017B","E01023476","Total",599,125,69,56,474,17,134,97,104,25,22,75
"2011","East Hertfordshire 017C","E01023477","Total",922,283,64,219,639,33,67,170,225,16,34,94
"2011","East Hertfordshire 017D","E01023478","Total",961,484,144,340,477,35,43,91,240,16,12,40
"2011","East Hertfordshire 017E","E01023479","Total",705,236,69,167,469,12,58,110,171,17,23,78
"2011","East Hertfordshire 018A","E01023468","Total",532,124,35,89,408,7,62,85,108,24,37,85
"2011","East Hertfordshire 018B","E01023469","Total",606,144,71,73,462,26,85,99,118,19,36,79
"2011","East Hertfordshire 018C","E01023480","Total",675,192,103,89,483,16,121,96,124,16,32,78
"2011","East Hertfordshire 018D","E01023481","Total",480,115,43,72,365,13,63,87,89,12,27,74
"2011","East Hertfordshire 018E","E01023504","Total",574,178,89,89,396,19,71,90,109,21,24,62
"2011","East Hertfordshire 018F","E01023505","Total",734,219,71,148,515,21,57,125,206,16,23,67
"2011","Hertsmere 001A","E01023576","Total",599,151,99,52,448,8,157,54,91,9,32,97
"2011","Hertsmere 001B","E01023577","Total",719,192,129,63,527,13,178,80,94,13,36,113
"2011","Hertsmere 001C","E01023578","Total",651,165,121,44,486,7,146,74,100,8,39,112
"2011","Hertsmere 001D","E01023579","Total",586,207,102,105,379,35,39,65,103,11,33,93
"2011","Hertsmere 001E","E01023580","Total",708,222,134,88,486,29,101,105,107,14,37,93
"2011","Hertsmere 002A","E01023567","Total",743,142,88,54,601,24,88,137,121,35,56,140
"2011","Hertsmere 002B","E01023568","Total",634,174,133,41,460,11,127,77,97,17,35,96
"2011","Hertsmere 002C","E01023569","Total",601,130,73,57,471,29,82,95,98,26,44,97
"2011","Hertsmere 002D","E01023570","Total",610,203,97,106,407,22,54,80,108,11,41,91
"2011","Hertsmere 003A","E01023571","Total",597,161,101,60,436,13,131,71,88,15,34,84
"2011","Hertsmere 003B","E01023572","Total",618,166,81,85,452,26,94,76,126,9,30,91
"2011","Hertsmere 003C","E01023573","Total",524,179,90,89,345,41,53,60,71,7,22,91
"2011","Hertsmere 003D","E01023574","Total",654,177,80,97,477,68,75,88,110,19,36,81
"2011","Hertsmere 003E","E01023575","Total",647,206,87,119,441,17,90,79,110,16,33,96
"2011","Hertsmere 004A","E01023581","Total",488,77,20,57,411,12,46,140,118,23,23,49
"2011","Hertsmere 004B","E01023582","Total",617,143,36,107,474,49,44,141,109,24,35,72
"2011","Hertsmere 004C","E01023583","Total",563,163,70,93,400,30,61,88,97,21,31,72
"2011","Hertsmere 004D","E01023584","Total",433,123,57,66,310,22,58,60,86,6,28,50
"2011","Hertsmere 005A","E01023523","Total",613,94,50,44,519,4,114,103,111,30,66,91
"2011","Hertsmere 005B","E01023524","Total",516,64,43,21,452,10,123,86,49,32,56,96
"2011","Hertsmere 005C","E01023525","Total",748,261,109,152,487,27,96,109,132,19,25,79
"2011","Hertsmere 005D","E01023526","Total",665,115,53,62,550,7,153,118,95,24,52,101
"2011","Hertsmere 005E","E01023527","Total",601,188,85,103,413,28,86,92,81,25,29,72
"2011","Hertsmere 006A","E01023534","Total",613,146,55,91,467,35,58,98,78,24,56,118
"2011","Hertsmere 006B","E01023535","Total",667,211,76,135,456,51,50,101,97,13,41,103
"2011","Hertsmere 006C","E01023536","Total",786,382,128,254,404,79,56,92,90,19,27,41
"2011","Hertsmere 006D","E01023537","Total",645,141,73,68,504,29,83,83,94,27,62,126
"2011","Hertsmere 006E","E01023538","Total",774,313,155,158,461,49,79,97,107,11,38,80
"2011","Hertsmere 007A","E01023529","Total",559,137,61,76,422,34,47,110,84,19,36,92
"2011","Hertsmere 007B","E01023530","Total",557,192,68,124,365,67,45,69,104,7,25,48
"2011","Hertsmere 007C","E01023531","Total",779,217,93,124,562,47,80,133,126,25,53,98
"2011","Hertsmere 007D","E01023532","Total",661,194,76,118,467,23,72,123,101,22,35,91
"2011","Hertsmere 007E","E01023533","Total",617,180,87,93,437,51,58,89,83,23,46,87
"2011","Hertsmere 008A","E01023552","Total",599,111,56,55,488,26,85,101,89,27,34,126
"2011","Hertsmere 008B","E01023553","Total",584,158,54,104,426,11,48,112,99,14,44,98
"2011","Hertsmere 008C","E01023554","Total",695,200,61,139,495,41,50,112,148,15,42,87
"2011","Hertsmere 008D","E01023555","Total",713,254,95,159,459,52,81,87,100,15,37,87
"2011","Hertsmere 009A","E01023544","Total",489,148,47,101,341,30,46,86,81,11,28,59
"2011","Hertsmere 009B","E01023545","Total",580,235,28,207,345,27,35,96,108,3,21,55
"2011","Hertsmere 009C","E01023546","Total",722,212,70,142,510,52,54,131,112,23,37,101
"2011","Hertsmere 009D","E01023547","Total",695,225,64,161,470,50,58,108,105,17,46,86
"2011","Hertsmere 010A","E01023528","Total",629,166,41,125,463,25,88,77,137,18,40,78
"2011","Hertsmere 010B","E01023564","Total",641,188,64,124,453,32,57,111,100,23,44,86
"2011","Hertsmere 010C","E01023565","Total",621,121,69,52,500,20,95,105,98,34,51,97
"2011","Hertsmere 010D","E01023566","Total",514,54,34,20,460,8,107,91,52,30,66,106
"2011","Hertsmere 011A","E01023539","Total",1163,326,78,248,837,84,68,235,258,18,59,115
"2011","Hertsmere 011B","E01023540","Total",634,165,105,60,469,32,74,101,89,29,35,109
"2011","Hertsmere 011C","E01023541","Total",712,159,60,99,553,41,62,143,112,26,44,125
"2011","Hertsmere 011D","E01023542","Total",652,145,55,90,507,38,63,96,103,24,60,123
"2011","Hertsmere 011E","E01023543","Total",577,196,81,115,381,27,41,72,106,14,36,85
"2011","Hertsmere 012A","E01023558","Total",752,291,123,168,461,29,78,117,119,22,22,74
"2011","Hertsmere 012B","E01023559","Total",586,153,62,91,433,16,76,96,86,18,39,102
"2011","Hertsmere 012C","E01023560","Total",604,218,123,95,386,48,54,85,65,23,37,74
"2011","Hertsmere 012D","E01023561","Total",641,172,91,81,469,32,88,121,80,18,38,92
"2011","Hertsmere 012E","E01023562","Total",557,121,60,61,436,16,97,88,73,19,43,100
"2011","Hertsmere 012F","E01023563","Total",634,216,100,116,418,28,73,92,100,17,29,79
"2011","Hertsmere 013A","E01023548","Total",790,249,151,98,541,17,178,82,122,20,41,81
"2011","Hertsmere 013B","E01023549","Total",782,305,181,124,477,31,141,91,109,13,30,62
"2011","Hertsmere 013C","E01023550","Total",648,125,76,49,523,7,124,130,116,26,38,82
"2011","Hertsmere 013D","E01023551","Total",542,77,55,22,465,11,120,95,70,27,31,111
"2011","Hertsmere 013E","E01023556","Total",623,166,72,94,457,23,97,108,86,15,35,93
"2011","Hertsmere 013F","E01023557","Total",606,176,74,102,430,22,90,105,77,21,46,69
"2011","North Hertfordshire 001A","E01023660","Total",1047,396,186,210,651,33,127,133,218,13,29,98
"2011","North Hertfordshire 001B","E01023661","Total",521,111,56,55,410,23,74,84,90,25,36,78
"2011","North Hertfordshire 001C","E01023662","Total",607,144,28,116,463,25,42,137,130,15,40,74
"2011","North Hertfordshire 002A","E01023654","Total",647,125,52,73,522,11,89,112,192,19,19,80
"2011","North Hertfordshire 002B","E01023655","Total",623,136,72,64,487,20,116,68,141,20,27,95
"2011","North Hertfordshire 002C","E01023656","Total",999,352,127,225,647,33,80,124,250,17,39,104
"2011","North Hertfordshire 002D","E01023657","Total",1018,215,113,102,803,8,176,211,227,30,42,109
"2011","North Hertfordshire 002E","E01023658","Total",638,152,91,61,486,35,105,111,108,14,40,73
"2011","North Hertfordshire 002F","E01023659","Total",506,80,30,50,426,8,83,85,110,17,26,97
"2011","North Hertfordshire 003A","E01023635","Total",616,160,104,56,456,32,128,96,84,16,29,71
"2011","North Hertfordshire 003B","E01023636","Total",783,236,142,94,547,44,113,101,141,16,42,90
"2011","North Hertfordshire 003C","E01023637","Total",870,393,186,207,477,50,110,103,127,23,15,49
"2011","North Hertfordshire 003D","E01023638","Total",666,198,76,122,468,31,96,91,119,20,27,84
"2011","North Hertfordshire 004A","E01023587","Total",497,188,41,147,309,16,29,74,110,11,21,48
"2011","North Hertfordshire 004B","E01023588","Total",544,136,72,64,408,11,59,108,115,11,29,75
"2011","North Hertfordshire 004C","E01023589","Total",800,344,159,185,456,14,93,103,142,14,26,64
"2011","North Hertfordshire 004D","E01023590","Total",738,255,99,156,483,23,69,135,140,15,28,73
"2011","North Hertfordshire 004E","E01023591","Total",627,194,88,106,433,14,99,98,101,11,38,72
"2011","North Hertfordshire 004F","E01023592","Total",556,131,79,52,425,39,54,103,73,33,46,77
"2011","North Hertfordshire 004G","E01023593","Total",613,199,91,108,414,44,78,94,94,15,24,65
"2011","North Hertfordshire 005A","E01023585","Total",465,119,79,40,346,7,86,51,86,29,30,57
"2011","North Hertfordshire 005B","E01023586","Total",646,167,95,72,479,22,119,93,128,26,25,66
"2011","North Hertfordshire 005C","E01023597","Total",491,103,45,58,388,14,97,70,108,17,25,57
"2011","North Hertfordshire 005D","E01023598","Total",549,120,57,63,429,28,96,92,105,23,22,63
"2011","North Hertfordshire 005F","E01023600","Total",574,162,75,87,412,26,87,81,112,17,20,69
"2011","North Hertfordshire 005G","E01023663","Total",839,184,90,94,655,30,132,119,173,34,40,127
"2011","North Hertfordshire 005H","E01033024","Total",535,62,7,55,473,15,18,178,123,24,49,66
"2011","North Hertfordshire 005I","E01033025","Total",519,114,18,96,405,29,26,162,138,10,11,29
"2011","North Hertfordshire 005J","E01033026","Total",573,114,20,94,459,24,38,137,150,27,33,50
"2011","North Hertfordshire 005K","E01033027","Total",605,142,9,133,463,44,15,125,196,21,20,42
"2011","North Hertfordshire 006A","E01023630","Total",618,169,91,78,449,36,60,98,112,23,42,78
"2011","North Hertfordshire 006B","E01023631","Total",712,237,87,150,475,48,53,120,123,20,29,82
"2011","North Hertfordshire 006C","E01023632","Total",560,168,54,114,392,23,44,96,120,10,27,72
"2011","North Hertfordshire 006D","E01023633","Total",616,227,74,153,389,49,51,90,100,16,24,59
"2011","North Hertfordshire 006E","E01023634","Total",609,179,81,98,430,10,128,79,134,11,16,52
"2011","North Hertfordshire 007A","E01023649","Total",641,272,66,206,369,28,64,76,139,8,16,38
"2011","North Hertfordshire 007B","E01023650","Total",606,189,59,130,417,43,42,87,107,24,45,69
"2011","North Hertfordshire 007C","E01023651","Total",483,110,60,50,373,20,75,91,86,10,28,63
"2011","North Hertfordshire 007D","E01023652","Total",605,189,113,76,416,40,75,96,88,21,34,62
"2011","North Hertfordshire 008A","E01023644","Total",717,229,143,86,488,20,133,77,119,19,41,79
"2011","North Hertfordshire 008B","E01023645","Total",642,196,112,84,446,30,93,82,110,16,36,79
"2011","North Hertfordshire 008C","E01023646","Total",507,84,40,44,423,60,57,95,82,23,40,66
"2011","North Hertfordshire 008D","E01023647","Total",597,128,86,42,469,5,120,92,92,14,44,102
"2011","North Hertfordshire 008E","E01023648","Total",470,99,49,50,371,4,113,59,83,8,33,71
"2011","North Hertfordshire 009A","E01023639","Total",541,133,60,73,408,16,91,75,110,18,38,60
"2011","North Hertfordshire 009B","E01023640","Total",560,207,116,91,353,37,80,57,89,8,35,47
"2011","North Hertfordshire 009C","E01023641","Total",579,183,73,110,396,53,79,74,83,19,21,67
"2011","North Hertfordshire 009D","E01023642","Total",497,83,59,24,414,4,101,66,94,15,40,94
"2011","North Hertfordshire 009E","E01023643","Total",495,102,42,60,393,34,73,82,73,11,36,84
"2011","North Hertfordshire 010A","E01023601","Total",1103,515,118,397,588,48,47,109,267,11,26,80
"2011","North Hertfordshire 010B","E01023602","Total",637,167,43,124,470,21,39,135,166,16,31,62
"2011","North Hertfordshire 010C","E01023603","Total",611,133,51,82,478,23,71,128,114,21,27,94
"2011","North Hertfordshire 010D","E01023604","Total",536,133,57,76,403,14,61,99,106,12,40,71
"2011","North Hertfordshire 010E","E01023605","Total",728,309,44,265,419,44,38,79,181,11,29,37
"2011","North Hertfordshire 011A","E01023617","Total",622,146,96,50,476,16,126,98,123,9,29,75
"2011","North Hertfordshire 011B","E01023618","Total",602,154,72,82,448,30,67,91,116,23,35,86
"2011","North Hertfordshire 011C","E01023619","Total",730,250,48,202,480,18,46,96,182,14,27,97
"2011","North Hertfordshire 011D","E01023620","Total",528,143,68,75,385,36,68,79,79,12,36,75
"2011","North Hertfordshire 011E","E01023621","Total",591,184,56,128,407,30,53,93,128,9,26,68
"2011","North Hertfordshire 012A","E01023611","Total",664,182,98,84,482,58,91,83,100,19,49,82
"2011","North Hertfordshire 012B","E01023612","Total",739,207,70,137,532,38,83,129,143,22,30,87
"2011","North Hertfordshire 012C","E01023613","Total",763,310,117,193,453,73,59,89,100,23,33,76
"2011","North Hertfordshire 012D","E01023614","Total",806,187,80,107,619,15,143,128,164,24,39,106
"2011","North Hertfordshire 012E","E01023615","Total",652,172,96,76,480,16,137,90,124,18,29,66
"2011","North Hertfordshire 012F","E01023616","Total",1036,506,221,285,530,26,90,105,203,11,23,72
"2011","North Hertfordshire 013A","E01023606","Total",780,305,122,183,475,44,72,108,153,15,26,57
"2011","North Hertfordshire 013B","E01023607","Total",588,137,73,64,451,24,112,111,83,19,25,77
"2011","North Hertfordshire 013C","E01023608","Total",634,157,107,50,477,13,152,100,99,16,26,71
"2011","North Hertfordshire 013D","E01023609","Total",714,258,102,156,456,19,83,90,155,22,25,62
"2011","North Hertfordshire 013E","E01023610","Total",500,110,22,88,390,9,41,125,97,19,38,61
"2011","North Hertfordshire 014A","E01023594","Total",972,292,155,137,680,43,161,127,171,12,50,116
"2011","North Hertfordshire 014B","E01023622","Total",455,107,64,43,348,22,71,60,98,12,35,50
"2011","North Hertfordshire 014C","E01023623","Total",596,150,87,63,446,15,99,89,135,21,28,59
"2011","North Hertfordshire 014D","E01023624","Total",524,112,53,59,412,23,71,77,121,23,28,69
"2011","North Hertfordshire 014E","E01023625","Total",425,87,36,51,338,10,75,57,91,14,30,61
"2011","North Hertfordshire 014F","E01023653","Total",887,233,137,96,654,29,135,165,158,30,42,95
"2011","North Hertfordshire 015A","E01023595","Total",679,244,113,131,435,14,87,104,124,15,31,60
"2011","North Hertfordshire 015B","E01023596","Total",492,164,97,67,328,13,94,68,60,8,25,60
"2011","North Hertfordshire 015C","E01023626","Total",862,184,98,86,678,30,166,130,151,38,40,123
"2011","North Hertfordshire 015D","E01023627","Total",671,171,71,100,500,18,95,94,144,13,40,96
"2011","North Hertfordshire 015E","E01023628","Total",750,206,88,118,544,32,82,129,193,14,28,66
"2011","North Hertfordshire 015F","E01023629","Total",782,263,116,147,519,25,96,105,140,25,33,95
"2011","St Albans 001A","E01023690","Total",608,151,97,54,457,21,80,145,89,30,32,60
"2011","St Albans 001B","E01023691","Total",502,68,42,26,434,8,89,129,65,27,38,78
"2011","St Albans 001C","E01023692","Total",502,135,60,75,367,41,51,96,89,16,26,48
"2011","St Albans 001D","E01023693","Total",523,147,63,84,376,13,73,83,83,22,29,73
"2011","St Albans 001E","E01023694","Total",509,74,49,25,435,14,81,133,67,31,36,73
"2011","St Albans 002A","E01023685","Total",645,147,54,93,498,18,75,153,119,40,29,64
"2011","St Albans 002B","E01023686","Total",523,80,45,35,443,3,76,136,67,41,32,88
"2011","St Albans 002C","E01023687","Total",604,165,71,94,439,50,70,84,97,20,46,72
"2011","St Albans 002D","E01023688","Total",626,194,81,113,432,28,71,115,130,15,22,51
"2011","St Albans 002E","E01023689","Total",509,143,73,70,366,7,57,118,77,30,31,46
"2011","St Albans 003A","E01023699","Total",597,163,118,45,434,5,99,103,105,32,32,58
"2011","St Albans 003B","E01023700","Total",472,71,54,17,401,5,105,87,68,30,39,67
"2011","St Albans 003C","E01023701","Total",845,341,178,163,504,34,107,103,154,23,33,50
"2011","St Albans 003D","E01023702","Total",682,233,89,144,449,11,47,152,140,29,25,45
"2011","St Albans 003E","E01023703","Total",518,91,51,40,427,10,60,154,85,33,26,59
"2011","St Albans 004A","E01023746","Total",626,152,75,77,474,64,60,114,114,20,22,80
"2011","St Albans 004B","E01023747","Total",735,212,116,96,523,18,107,149,122,25,30,72
"2011","St Albans 004C","E01023748","Total",565,110,70,40,455,7,152,72,106,19,37,62
"2011","St Albans 004D","E01023749","Total",656,155,100,55,501,19,116,102,113,28,40,83
"2011","St Albans 005A","E01023695","Total",613,129,85,44,484,5,116,120,100,24,40,79
"2011","St Albans 005B","E01023696","Total",633,79,52,27,554,8,188,106,76,37,50,89
"2011","St Albans 005C","E01023697","Total",792,258,115,143,534,26,81,154,141,26,29,77
"2011","St Albans 005D","E01023698","Total",601,103,51,52,498,4,110,128,104,19,44,89
"2011","St Albans 006A","E01023722","Total",582,147,63,84,435,8,118,84,106,25,27,67
"2011","St Albans 006B","E01023723","Total",677,185,81,104,492,41,96,108,100,18,44,85
"2011","St Albans 006C","E01023724","Total",703,220,117,103,483,17,132,109,143,20,16,46
"2011","St Albans 006D","E01023725","Total",572,103,49,54,469,13,107,110,98,31,29,81
"2011","St Albans 007A","E01023713","Total",680,146,75,71,534,24,67,123,132,45,49,94
"2011","St Albans 007B","E01023734","Total",651,162,64,98,489,18,74,126,116,18,23,114
"2011","St Albans 007C","E01023735","Total",799,289,113,176,510,27,70,117,160,7,35,94
"2011","St Albans 007D","E01023736","Total",648,212,83,129,436,20,79,91,125,18,28,75
"2011","St Albans 008A","E01023709","Total",728,245,113,132,483,27,92,107,125,19,23,90
"2011","St Albans 008B","E01023710","Total",542,63,49,14,479,4,115,101,83,23,38,115
"2011","St Albans 008C","E01023711","Total",605,140,91,49,465,16,113,101,75,23,44,93
"2011","St Albans 008D","E01023712","Total",738,245,73,172,493,25,68,120,157,13,41,69
"2011","St Albans 009A","E01023669","Total",670,186,53,133,484,57,40,120,132,22,42,71
"2011","St Albans 009B","E01023670","Total",811,202,76,126,609,21,47,227,187,33,24,70
"2011","St Albans 009C","E01023671","Total",735,201,114,87,534,23,105,116,101,32,61,96
"2011","St Albans 009D","E01023672","Total",664,130,41,89,534,22,75,130,102,50,37,118
"2011","St Albans 010A","E01023673","Total",501,71,37,34,430,7,77,98,85,28,48,87
"2011","St Albans 010B","E01023714","Total",638,100,65,35,538,11,122,128,87,37,52,101
"2011","St Albans 010C","E01023715","Total",525,64,42,22,461,7,88,111,82,45,44,84
"2011","St Albans 010D","E01023716","Total",841,223,75,148,618,16,69,197,219,29,31,57
"2011","St Albans 011A","E01023666","Total",773,275,42,233,498,28,42,78,226,19,37,68
"2011","St Albans 011B","E01023674","Total",723,174,56,118,549,20,25,163,199,34,29,79
"2011","St Albans 011C","E01023675","Total",501,82,54,28,419,6,94,97,89,24,47,62
"2011","St Albans 011D","E01023676","Total",1000,343,85,258,657,52,75,136,286,29,28,51
"2011","St Albans 012A","E01023726","Total",827,284,57,227,543,19,30,135,292,5,11,51
"2011","St Albans 012B","E01023727","Total",1024,489,166,323,535,33,40,98,291,17,9,47
"2011","St Albans 012C","E01023728","Total",956,304,79,225,652,18,75,166,262,23,29,79
"2011","St Albans 012D","E01023729","Total",854,320,61,259,534,52,39,122,222,19,19,61
"2011","St Albans 013A","E01023664","Total",649,138,39,99,511,34,56,136,131,30,46,78
"2011","St Albans 013B","E01023665","Total",592,138,45,93,454,19,53,130,124,23,41,64
"2011","St Albans 013C","E01023667","Total",568,137,41,96,431,13,42,110,150,22,34,60
"2011","St Albans 013D","E01023668","Total",475,71,44,27,404,9,62,123,74,22,41,73
"2011","St Albans 014A","E01023742","Total",557,93,70,23,464,3,137,90,104,23,23,84
"2011","St Albans 014B","E01023743","Total",777,256,110,146,521,8,109,114,175,24,29,62
"2011","St Albans 014C","E01023744","Total",614,149,117,32,465,6,158,80,84,15,28,94
"2011","St Albans 014D","E01023745","Total",759,224,93,131,535,13,94,159,164,17,21,67
"2011","St Albans 015A","E01023677","Total",458,118,12,106,340,37,8,137,76,19,26,37
"2011","St Albans 015B","E01023678","Total",725,170,55,115,555,30,76,179,134,23,31,82
"2011","St Albans 015C","E01023679","Total",593,152,67,85,441,23,79,95,105,18,27,94
"2011","St Albans 015D","E01023680","Total",506,123,55,68,383,26,77,91,71,22,27,69
"2011","St Albans 016A","E01023681","Total",689,274,103,171,415,32,45,71,117,15,34,101
"2011","St Albans 016B","E01023682","Total",651,160,72,88,491,13,85,108,113,26,41,105
"2011","St Albans 016C","E01023683","Total",670,189,106,83,481,37,96,107,93,25,38,85
"2011","St Albans 016D","E01023684","Total",672,167,91,76,505,7,115,102,139,12,38,92
"2011","St Albans 017A","E01023737","Total",509,153,50,103,356,31,38,56,91,19,41,80
"2011","St Albans 017B","E01023738","Total",635,215,83,132,420,26,61,89,97,27,50,70
"2011","St Albans 017C","E01023739","Total",544,159,86,73,385,20,58,96,91,26,42,52
"2011","St Albans 017D","E01023740","Total",654,268,66,202,386,25,36,96,161,11,15,42
"2011","St Albans 017E","E01023741","Total",633,145,54,91,488,17,51,156,166,21,17,60
"2011","St Albans 018A","E01023704","Total",755,302,45,257,453,41,49,112,138,14,21,78
"2011","St Albans 018B","E01023705","Total",613,155,65,90,458,39,62,82,81,27,68,99
"2011","St Albans 018C","E01023706","Total",649,178,82,96,471,29,81,97,105,16,43,100
"2011","St Albans 018E","E01023708","Total",647,210,109,101,437,26,79,88,112,14,45,73
"2011","St Albans 018F","E01033028","Total",515,95,33,62,420,23,49,94,86,25,53,90
"2011","St Albans 018G","E01033029","Total",584,124,19,105,460,21,40,147,128,31,42,51
"2011","St Albans 019A","E01023718","Total",698,155,107,48,543,18,151,115,98,21,42,98
"2011","St Albans 019B","E01023719","Total",471,139,68,71,332,17,73,69,73,17,25,58
"2011","St Albans 019C","E01023720","Total",804,281,85,196,523,43,66,145,160,8,31,70
"2011","St Albans 019D","E01023721","Total",540,115,59,56,425,10,104,91,74,24,33,89
"2011","St Albans 020A","E01023717","Total",487,110,59,51,377,15,75,88,97,13,23,66
"2011","St Albans 020B","E01023730","Total",672,137,86,51,535,10,156,129,88,25,36,91
"2011","St Albans 020C","E01023731","Total",610,170,76,94,440,17,106,88,103,24,30,72
"2011","St Albans 020D","E01023732","Total",666,176,92,84,490,15,123,82,116,12,47,95
"2011","St Albans 020E","E01023733","Total",645,136,83,53,509,18,145,77,110,15,49,95
"2011","Stevenage 001A","E01023787","Total",546,119,35,84,427,24,54,90,130,23,39,67
"2011","Stevenage 001B","E01023788","Total",629,192,85,107,437,36,58,98,97,29,44,75
"2011","Stevenage 001C","E01023789","Total",751,179,53,126,572,61,50,137,147,31,65,81
"2011","Stevenage 001D","E01023790","Total",633,161,38,123,472,49,46,114,86,29,60,88
"2011","Stevenage 002A","E01023776","Total",1122,342,111,231,780,64,124,149,271,27,30,115
"2011","Stevenage 002B","E01023777","Total",759,221,86,135,538,27,107,114,141,25,37,87
"2011","Stevenage 002C","E01023778","Total",664,178,94,84,486,62,67,85,106,26,48,92
"2011","Stevenage 002D","E01023799","Total",504,80,38,42,424,25,60,63,109,20,45,102
"2011","Stevenage 002E","E01023800","Total",793,221,94,127,572,31,126,103,153,19,35,105
"2011","Stevenage 002F","E01023801","Total",914,185,36,149,729,101,47,189,206,29,54,103
"2011","Stevenage 003A","E01023771","Total",683,179,52,127,504,35,84,104,147,14,32,88
"2011","Stevenage 003B","E01023772","Total",755,292,75,217,463,23,71,101,124,15,31,98
"2011","Stevenage 003C","E01023773","Total",526,119,27,92,407,55,39,89,97,17,37,73
"2011","Stevenage 003D","E01023774","Total",668,239,72,167,429,38,65,108,84,18,41,75
"2011","Stevenage 004A","E01023767","Total",613,178,26,152,435,11,50,103,141,9,37,84
"2011","Stevenage 004B","E01023768","Total",679,173,47,126,506,14,51,143,162,9,40,87
"2011","Stevenage 004C","E01023769","Total",704,207,93,114,497,42,96,103,114,15,28,99
"2011","Stevenage 004D","E01023770","Total",636,160,41,119,476,18,82,92,155,8,29,92
"2011","Stevenage 005A","E01023795","Total",676,213,100,113,463,37,85,72,128,9,33,99
"2011","Stevenage 005B","E01023796","Total",724,306,125,181,418,41,74,82,129,13,20,59
"2011","Stevenage 005C","E01023797","Total",569,174,83,91,395,32,51,79,115,15,23,80
"2011","Stevenage 005D","E01023798","Total",642,177,34,143,465,37,72,97,149,13,19,78
"2011","Stevenage 006A","E01023775","Total",940,401,197,204,539,49,87,102,181,6,33,81
"2011","Stevenage 006B","E01023779","Total",678,225,92,133,453,53,50,84,114,17,43,92
"2011","Stevenage 006C","E01023780","Total",650,256,98,158,394,23,89,74,84,7,37,80
"2011","Stevenage 006D","E01023781","Total",782,320,104,216,462,33,82,104,120,14,43,66
"2011","Stevenage 006E","E01023782","Total",639,227,103,124,412,32,96,71,97,4,34,78
"2011","Stevenage 007A","E01023759","Total",591,159,70,89,432,40,72,90,95,25,45,65
"2011","Stevenage 007B","E01023760","Total",615,139,67,72,476,34,99,81,105,18,38,101
"2011","Stevenage 007C","E01023761","Total",866,221,73,148,645,63,80,157,163,30,38,114
"2011","Stevenage 007D","E01023762","Total",638,163,85,78,475,34,99,106,105,21,33,77
"2011","Stevenage 008A","E01023755","Total",630,162,68,94,468,40,85,87,92,16,54,94
"2011","Stevenage 008B","E01023756","Total",602,148,60,88,454,60,51,90,85,31,58,79
"2011","Stevenage 008C","E01023757","Total",753,217,108,109,536,57,79,122,95,27,38,118
"2011","Stevenage 008D","E01023758","Total",1056,584,213,371,472,82,80,87,135,12,19,57
"2011","Stevenage 009A","E01023750","Total",615,294,106,188,321,32,54,55,92,11,18,59
"2011","Stevenage 009B","E01023751","Total",467,116,47,69,351,25,65,76,72,20,26,67
"2011","Stevenage 009C","E01023752","Total",505,116,57,59,389,35,59,89,79,19,34,74
"2011","Stevenage 009D","E01023753","Total",636,200,56,144,436,19,41,106,141,9,39,81
"2011","Stevenage 009E","E01023754","Total",471,70,26,44,401,31,54,102,77,20,49,68
"2011","Stevenage 010A","E01023791","Total",620,158,94,64,462,30,85,83,104,18,42,100
"2011","Stevenage 010B","E01023792","Total",608,137,76,61,471,56,56,98,95,35,48,83
"2011","Stevenage 010C","E01023793","Total",616,194,83,111,422,55,62,88,105,19,26,67
"2011","Stevenage 010D","E01023794","Total",623,189,74,115,434,34,60,86,95,29,46,84
"2011","Stevenage 011A","E01023783","Total",694,228,72,156,466,33,55,107,131,18,30,92
"2011","Stevenage 011B","E01023784","Total",680,176,106,70,504,30,110,104,125,15,34,86
"2011","Stevenage 011C","E01023785","Total",675,210,76,134,465,64,59,101,121,13,30,77
"2011","Stevenage 011D","E01023786","Total",624,182,100,82,442,42,59,92,110,14,38,87
"2011","Stevenage 012A","E01023763","Total",594,126,47,79,468,27,69,88,150,20,23,91
"2011","Stevenage 012B","E01023764","Total",632,216,101,115,416,27,67,73,121,6,27,95
"2011","Stevenage 012C","E01023765","Total",596,169,110,59,427,24,100,86,76,19,34,88
"2011","Stevenage 012D","E01023766","Total",612,157,69,88,455,56,76,93,88,20,33,89
"2011","Three Rivers 001A","E01023802","Total",739,234,111,123,505,25,88,133,127,17,33,82
"2011","Three Rivers 001B","E01023803","Total",610,169,114,55,441,2,90,100,93,24,42,90
"2011","Three Rivers 001C","E01023804","Total",627,197,117,80,430,35,84,77,99,21,33,81
"2011","Three Rivers 001D","E01023807","Total",611,183,84,99,428,20,97,78,86,20,48,79
"2011","Three Rivers 001E","E01023808","Total",1151,395,100,295,756,57,113,159,267,29,41,90
"2011","Three Rivers 002A","E01023829","Total",620,136,71,65,484,46,63,91,100,24,67,93
"2011","Three Rivers 002B","E01023830","Total",748,375,129,246,373,27,60,83,125,9,20,49
"2011","Three Rivers 002C","E01023832","Total",683,212,46,166,471,38,39,120,128,21,47,78
"2011","Three Rivers 002D","E01023833","Total",912,211,56,155,701,43,68,203,214,26,49,98
"2011","Three Rivers 002E","E01023834","Total",573,114,48,66,459,17,85,95,93,26,45,98
"2011","Three Rivers 003A","E01023823","Total",586,192,107,85,394,18,75,79,99,12,35,76
"2011","Three Rivers 003B","E01023824","Total",738,134,101,33,604,16,140,126,137,24,60,101
"2011","Three Rivers 003C","E01023831","Total",749,158,60,98,591,38,80,142,137,34,51,109
"2011","Three Rivers 003D","E01023854","Total",788,201,114,87,587,16,153,107,154,20,31,106
"2011","Three Rivers 004A","E01023812","Total",486,62,35,27,424,6,101,67,62,29,51,108
"2011","Three Rivers 004B","E01023813","Total",489,64,39,25,425,11,79,74,67,27,64,103
"2011","Three Rivers 004C","E01023814","Total",500,206,160,46,294,6,78,65,56,9,22,58
"2011","Three Rivers 004D","E01023851","Total",762,314,112,202,448,20,70,88,181,11,18,60
"2011","Three Rivers 005A","E01023815","Total",590,114,53,61,476,14,121,128,88,27,21,77
"2011","Three Rivers 005B","E01023816","Total",496,117,67,50,379,13,98,84,68,30,29,57
"2011","Three Rivers 005C","E01023817","Total",592,196,90,106,396,13,77,99,105,13,27,62
"2011","Three Rivers 005D","E01023818","Total",506,95,69,26,411,3,104,90,63,25,44,82
"2011","Three Rivers 006A","E01023819","Total",678,216,93,123,462,37,58,115,130,14,31,77
"2011","Three Rivers 006B","E01023820","Total",537,154,103,51,383,11,97,74,75,14,33,79
"2011","Three Rivers 006C","E01023821","Total",493,105,68,37,388,10,74,89,84,17,31,83
"2011","Three Rivers 006D","E01023822","Total",528,117,75,42,411,10,80,133,74,7,25,82
"2011","Three Rivers 006E","E01023825","Total",898,202,69,133,696,29,102,187,190,20,45,123
"2011","Three Rivers 006F","E01023826","Total",547,128,68,60,419,14,71,115,80,22,26,91
"2011","Three Rivers 007A","E01023847","Total",783,224,58,166,559,43,55,169,163,23,28,78
"2011","Three Rivers 007B","E01023848","Total",624,150,65,85,474,28,73,124,83,32,44,90
"2011","Three Rivers 007C","E01023850","Total",775,387,137,250,388,21,68,85,166,6,8,34
"2011","Three Rivers 007D","E01023852","Total",591,168,98,70,423,19,87,100,109,18,32,58
"2011","Three Rivers 007E","E01023853","Total",744,110,71,39,634,9,165,131,113,32,61,123
"2011","Three Rivers 008A","E01023827","Total",860,251,98,153,609,77,62,154,121,28,51,116
"2011","Three Rivers 008B","E01023828","Total",612,191,98,93,421,49,48,113,84,16,31,80
"2011","Three Rivers 008C","E01023845","Total",695,144,53,91,551,59,86,117,130,22,38,99
"2011","Three Rivers 008D","E01023846","Total",569,105,50,55,464,17,102,81,95,19,39,111
"2011","Three Rivers 009A","E01023835","Total",534,118,60,58,416,19,89,82,91,22,26,87
"2011","Three Rivers 009B","E01023836","Total",629,217,102,115,412,30,48,93,141,13,25,62
"2011","Three Rivers 009C","E01023837","Total",649,177,59,118,472,29,69,117,140,18,31,68
"2011","Three Rivers 009D","E01023838","Total",502,114,50,64,388,48,63,84,90,17,21,65
"2011","Three Rivers 010A","E01023805","Total",638,184,83,101,454,50,51,91,85,29,53,95
"2011","Three Rivers 010B","E01023809","Total",761,267,165,102,494,27,144,78,116,7,35,87
"2011","Three Rivers 010C","E01023810","Total",731,198,126,72,533,13,152,87,96,6,44,135
"2011","Three Rivers 010D","E01023811","Total",624,162,87,75,462,10,140,78,105,7,29,93
"2011","Three Rivers 011A","E01023839","Total",764,94,70,24,670,8,161,122,97,17,79,186
"2011","Three Rivers 011B","E01023840","Total",560,132,51,81,428,9,99,87,97,18,42,76
"2011","Three Rivers 011C","E01023841","Total",541,76,38,38,465,4,107,65,76,20,53,140
"2011","Three Rivers 011D","E01023849","Total",600,158,93,65,442,9,121,74,115,18,25,80
"2011","Three Rivers 012A","E01023806","Total",861,260,85,175,601,54,67,129,132,33,68,118
"2011","Three Rivers 012B","E01023842","Total",618,196,64,132,422,60,49,92,77,18,49,77
"2011","Three Rivers 012C","E01023843","Total",829,302,134,168,527,64,50,130,121,17,54,91
"2011","Three Rivers 012D","E01023844","Total",777,352,79,273,425,83,24,111,115,16,31,45
"2011","Watford 001A","E01023904","Total",777,198,79,119,579,47,88,109,130,28,52,125
"2011","Watford 001B","E01023905","Total",842,314,115,199,528,41,63,137,158,16,48,65
"2011","Watford 001C","E01023906","Total",630,206,103,103,424,45,62,83,99,13,37,85
"2011","Watford 001D","E01023907","Total",753,270,86,184,483,24,100,106,127,15,39,72
"2011","Watford 002A","E01023890","Total",511,157,47,110,354,13,47,82,94,20,23,75
"2011","Watford 002B","E01023891","Total",513,105,39,66,408,51,52,73,72,27,54,79
"2011","Watford 002C","E01023892","Total",506,132,48,84,374,29,51,88,80,13,34,79
"2011","Watford 002D","E01023893","Total",728,229,114,115,499,28,113,89,110,19,41,99
"2011","Watford 002E","E01023894","Total",534,95,40,55,439,22,70,110,96,15,44,82
"2011","Watford 003A","E01023873","Total",539,178,67,111,361,44,50,72,75,25,29,66
"2011","Watford 003B","E01023874","Total",493,124,83,41,369,25,78,74,50,23,45,74
"2011","Watford 003C","E01023875","Total",813,259,126,133,554,23,108,114,154,14,30,111
"2011","Watford 003D","E01023876","Total",723,214,62,152,509,124,54,107,90,20,41,73
"2011","Watford 003E","E01023877","Total",661,200,88,112,461,31,74,97,102,21,51,85
"2011","Watford 004A","E01023868","Total",678,201,118,83,477,37,83,86,94,41,56,80
"2011","Watford 004B","E01023869","Total",481,129,50,79,352,20,29,63,90,19,54,77
"2011","Watford 004C","E01023870","Total",475,107,40,67,368,36,29,57,54,32,60,100
"2011","Watford 004D","E01023871","Total",507,178,35,143,329,29,36,75,111,8,25,45
"2011","Watford 004E","E01023872","Total",633,151,49,102,482,20,60,115,97,24,53,113
"2011","Watford 005A","E01023895","Total",753,262,40,222,491,19,41,117,220,11,22,61
"2011","Watford 005B","E01023896","Total",472,91,38,53,381,21,55,84,62,15,51,93
"2011","Watford 005C","E01023897","Total",673,220,131,89,453,22,121,72,81,17,43,97
"2011","Watford 005D","E01023898","Total",558,102,54,48,456,10,66,120,76,13,44,127
"2011","Watford 006A","E01023855","Total",808,261,51,210,547,45,18,135,221,11,21,96
"2011","Watford 006B","E01023856","Total",994,326,58,268,668,64,36,161,240,21,47,99
"2011","Watford 006C","E01023857","Total",578,134,44,90,444,46,43,70,102,23,73,87
"2011","Watford 006D","E01023858","Total",781,299,28,271,482,41,33,129,164,13,25,77
"2011","Watford 007A","E01023878","Total",764,185,111,74,579,19,144,103,108,18,55,132
"2011","Watford 007B","E01023879","Total",969,341,107,234,628,52,77,162,215,15,33,74
"2011","Watford 007C","E01023880","Total",855,342,122,220,513,30,51,97,227,13,23,72
"2011","Watford 007D","E01023881","Total",585,128,52,76,457,12,81,101,109,24,34,96
"2011","Watford 008A","E01023886","Total",1108,316,53,263,792,71,58,192,253,25,78,115
"2011","Watford 008B","E01023887","Total",621,100,77,23,521,12,148,105,87,24,38,107
"2011","Watford 008C","E01023888","Total",580,143,59,84,437,28,65,83,100,28,48,85
"2011","Watford 008D","E01023889","Total",629,116,82,34,513,8,120,120,72,30,57,106
"2011","Watford 009A","E01023859","Total",989,367,47,320,622,41,32,173,269,12,27,68
"2011","Watford 009B","E01023860","Total",889,406,40,366,483,53,25,95,178,14,29,89
"2011","Watford 009C","E01023861","Total",1117,576,116,460,541,37,40,86,220,10,49,99
"2011","Watford 009D","E01023862","Total",953,398,145,253,555,41,44,134,213,15,23,85
"2011","Watford 010A","E01023899","Total",532,154,24,130,378,22,26,89,84,27,59,71
"2011","Watford 010B","E01023900","Total",557,128,35,93,429,18,31,77,98,29,71,105
"2011","Watford 010C","E01023901","Total",720,190,32,158,530,48,34,136,140,36,55,81
"2011","Watford 010D","E01023902","Total",613,184,28,156,429,26,34,97,138,15,39,80
"2011","Watford 010E","E01023903","Total",549,161,54,107,388,25,29,101,69,21,81,62
"2011","Watford 011A","E01023863","Total",686,217,36,181,469,38,46,103,122,22,47,91
"2011","Watford 011B","E01023864","Total",649,260,64,196,389,35,36,82,126,26,33,51
"2011","Watford 011C","E01023865","Total",626,183,71,112,443,62,47,93,80,31,61,69
"2011","Watford 011D","E01023866","Total",618,189,73,116,429,88,53,94,69,31,44,50
"2011","Watford 011E","E01023867","Total",881,289,33,256,592,61,41,140,175,27,44,104
"2011","Watford 012A","E01023882","Total",649,189,79,110,460,13,76,104,126,17,30,94
"2011","Watford 012B","E01023883","Total",661,237,141,96,424,29,63,82,88,29,51,82
"2011","Watford 012C","E01023884","Total",789,288,84,204,501,44,42,139,175,9,25,67
"2011","Watford 012D","E01023885","Total",678,163,57,106,515,21,82,115,105,20,53,119
"2011","Welwyn Hatfield 001A","E01023965","Total",531,84,48,36,447,7,118,101,93,15,37,76
"2011","Welwyn Hatfield 001B","E01023966","Total",654,158,90,68,496,11,142,89,124,13,35,82
"2011","Welwyn Hatfield 001C","E01023967","Total",576,174,71,103,402,18,72,93,126,12,20,61
"2011","Welwyn Hatfield 001D","E01023971","Total",626,105,59,46,521,7,148,120,101,20,36,89
"2011","Welwyn Hatfield 002B","E01023968","Total",506,103,68,35,403,7,127,73,83,9,30,74
"2011","Welwyn Hatfield 002C","E01023969","Total",617,204,118,86,413,7,116,71,109,13,32,65
"2011","Welwyn Hatfield 002D","E01023970","Total",596,202,104,98,394,41,76,86,75,16,32,68
"2011","Welwyn Hatfield 002E","E01033310","Total",630,142,26,116,488,36,40,146,129,23,39,75
"2011","Welwyn Hatfield 002F","E01033313","Total",534,99,22,77,435,29,54,98,115,21,44,74
"2011","Welwyn Hatfield 003A","E01023959","Total",567,112,64,48,455,10,122,106,95,17,32,73
"2011","Welwyn Hatfield 003B","E01023960","Total",646,164,91,73,482,29,106,107,119,16,31,74
"2011","Welwyn Hatfield 003C","E01023961","Total",621,178,89,89,443,39,83,100,112,16,22,71
"2011","Welwyn Hatfield 003D","E01023962","Total",574,126,83,43,448,20,101,105,80,23,42,77
"2011","Welwyn Hatfield 004A","E01023912","Total",607,185,80,105,422,19,79,102,98,10,28,86
"2011","Welwyn Hatfield 004B","E01023913","Total",568,147,50,97,421,25,69,89,129,13,29,67
"2011","Welwyn Hatfield 004C","E01023914","Total",754,259,144,115,495,33,126,91,116,18,41,70
"2011","Welwyn Hatfield 004D","E01023915","Total",652,205,69,136,447,38,53,123,128,20,35,50
"2011","Welwyn Hatfield 005A","E01023950","Total",620,143,28,115,477,16,46,103,157,19,36,100
"2011","Welwyn Hatfield 005B","E01023951","Total",784,356,79,277,428,44,76,79,117,13,29,70
"2011","Welwyn Hatfield 005C","E01023952","Total",861,396,158,238,465,32,49,113,172,8,20,71
"2011","Welwyn Hatfield 005D","E01023953","Total",613,168,52,116,445,17,62,108,150,13,22,73
"2011","Welwyn Hatfield 006A","E01023916","Total",700,201,111,90,499,34,76,146,112,17,29,85
"2011","Welwyn Hatfield 006B","E01023917","Total",763,244,122,122,519,16,123,114,140,17,33,76
"2011","Welwyn Hatfield 006C","E01023918","Total",963,511,301,210,452,12,145,76,123,20,26,50
"2011","Welwyn Hatfield 006D","E01023919","Total",571,74,59,15,497,14,125,107,88,29,40,94
"2011","Welwyn Hatfield 007A","E01023954","Total",711,243,83,160,468,67,47,112,112,26,33,71
"2011","Welwyn Hatfield 007B","E01023955","Total",516,126,63,63,390,43,59,101,64,18,37,68
"2011","Welwyn Hatfield 007C","E01023956","Total",511,121,34,87,390,38,32,97,97,16,38,72
"2011","Welwyn Hatfield 007D","E01023957","Total",633,222,35,187,411,43,25,120,117,16,40,50
"2011","Welwyn Hatfield 007E","E01023958","Total",564,162,65,97,402,64,33,90,87,37,31,60
"2011","Welwyn Hatfield 008A","E01023943","Total",590,157,60,97,433,35,63,109,92,22,40,72
"2011","Welwyn Hatfield 008B","E01023944","Total",839,216,99,117,623,53,95,151,152,34,41,97
"2011","Welwyn Hatfield 008C","E01023945","Total",638,150,69,81,488,31,94,118,109,19,27,90
"2011","Welwyn Hatfield 008D","E01023946","Total",665,232,67,165,433,14,71,114,107,14,44,69
"2011","Welwyn Hatfield 009A","E01023939","Total",526,190,114,76,336,24,65,70,78,18,19,62
"2011","Welwyn Hatfield 009B","E01023940","Total",718,227,104,123,491,39,89,104,106,25,49,79
"2011","Welwyn Hatfield 009C","E01023941","Total",1168,331,90,241,837,68,62,246,266,27,56,112
"2011","Welwyn Hatfield 009D","E01023942","Total",606,135,72,63,471,35,61,116,97,24,58,80
"2011","Welwyn Hatfield 010A","E01023929","Total",642,173,90,83,469,46,69,77,111,20,29,117
"2011","Welwyn Hatfield 010B","E01023930","Total",678,220,95,125,458,47,48,105,115,15,39,89
"2011","Welwyn Hatfield 010D","E01023938","Total",603,116,52,64,487,16,101,83,131,10,37,109
"2011","Welwyn Hatfield 010E","E01033308","Total",649,204,3,201,445,37,9,64,174,4,11,146
"2011","Welwyn Hatfield 010F","E01033311","Total",614,189,87,102,425,32,48,95,99,16,29,106
"2011","Welwyn Hatfield 010G","E01033314","Total",645,112,5,107,533,46,8,124,81,25,31,218
"2011","Welwyn Hatfield 011A","E01023924","Total",639,246,112,134,393,31,35,55,86,7,29,150
"2011","Welwyn Hatfield 011B","E01023925","Total",549,159,62,97,390,18,94,68,113,7,19,71
"2011","Welwyn Hatfield 011C","E01023926","Total",740,201,104,97,539,17,119,89,140,8,41,125
"2011","Welwyn Hatfield 011D","E01023927","Total",685,191,75,116,494,60,55,130,113,17,34,85
"2011","Welwyn Hatfield 012A","E01023920","Total",762,359,98,261,403,56,33,69,113,13,28,91
"2011","Welwyn Hatfield 012B","E01023921","Total",881,320,87,233,561,60,57,101,150,6,30,157
"2011","Welwyn Hatfield 012C","E01023922","Total",635,156,64,92,479,49,60,92,80,15,43,140
"2011","Welwyn Hatfield 012D","E01023923","Total",687,171,78,93,516,31,90,61,112,12,40,170
"2011","Welwyn Hatfield 013A","E01023932","Total",587,131,55,76,456,39,51,45,78,15,40,188
"2011","Welwyn Hatfield 013B","E01023934","Total",485,99,26,73,386,21,25,62,73,17,20,168
"2011","Welwyn Hatfield 013C","E01023935","Total",449,105,65,40,344,14,57,39,40,9,25,160
"2011","Welwyn Hatfield 013D","E01023936","Total",783,192,82,110,591,54,82,90,100,19,51,195
"2011","Welwyn Hatfield 013E","E01023937","Total",491,169,91,78,322,14,41,33,59,11,24,140
"2011","Welwyn Hatfield 014A","E01023933","Total",635,221,104,117,414,34,53,62,105,16,22,122
"2011","Welwyn Hatfield 014B","E01023963","Total",1021,390,184,206,631,41,131,111,164,22,44,118
"2011","Welwyn Hatfield 014C","E01023964","Total",617,188,93,95,429,15,125,68,91,9,28,93
"2011","Welwyn Hatfield 015A","E01023908","Total",599,133,71,62,466,12,124,90,81,16,38,105
"2011","Welwyn Hatfield 015B","E01023909","Total",418,62,34,28,356,7,94,69,54,21,37,74
"2011","Welwyn Hatfield 015C","E01023910","Total",520,102,64,38,418,6,96,74,90,13,40,99
"2011","Welwyn Hatfield 015D","E01023911","Total",687,193,121,72,494,29,135,101,104,15,20,90
"2011","Welwyn Hatfield 016A","E01023947","Total",702,229,115,114,473,24,107,77,127,22,38,78
"2011","Welwyn Hatfield 016B","E01023948","Total",644,137,88,49,507,7,160,80,88,18,36,118
"2011","Welwyn Hatfield 016C","E01023949","Total",747,113,81,32,634,6,212,114,113,31,49,109
"2011","Breckland 001A","E01026436","Total",968,242,138,104,726,27,186,114,210,23,39,127
"2011","Breckland 001C","E01026461","Total",573,137,93,44,436,11,140,61,125,12,17,70
"2011","Breckland 001E","E01026483","Total",491,134,76,58,357,12,94,62,104,10,20,55
"2011","Breckland 001F","E01033042","Total",864,183,96,87,681,26,144,148,216,26,41,80
"2011","Breckland 002A","E01026442","Total",922,230,150,80,692,25,220,121,176,15,39,96
"2011","Breckland 002B","E01026443","Total",834,192,106,86,642,23,160,105,155,29,60,110
"2011","Breckland 002C","E01026445","Total",1001,257,147,110,744,34,255,108,197,15,42,93
"2011","Breckland 002D","E01026462","Total",937,198,113,85,739,33,222,114,206,21,35,108
"2011","Breckland 003A","E01026428","Total",1070,236,104,132,834,67,154,185,200,30,58,140
"2011","Breckland 003B","E01026429","Total",701,252,141,111,449,21,102,86,137,11,26,66
"2011","Breckland 003C","E01026430","Total",692,150,103,47,542,18,165,93,135,18,51,62
"2011","Breckland 003D","E01026431","Total",492,145,106,39,347,11,108,55,92,11,20,50
"2011","Breckland 004A","E01026446","Total",877,246,177,69,631,14,262,81,134,18,33,89
"2011","Breckland 004B","E01026452","Total",711,177,99,78,534,16,161,87,145,20,36,69
"2011","Breckland 004C","E01026453","Total",628,142,86,56,486,14,115,74,141,15,40,87
"2011","Breckland 004D","E01026454","Total",627,107,30,77,520,30,56,125,161,23,50,75
"2011","Breckland 005A","E01026425","Total",851,272,168,104,579,61,156,84,132,30,43,73
"2011","Breckland 005B","E01026426","Total",1179,488,183,305,691,73,116,135,235,15,48,69
"2011","Breckland 005C","E01026427","Total",939,237,138,99,702,43,218,115,170,29,36,91
"2011","Breckland 005D","E01026432","Total",633,160,96,64,473,19,143,88,118,11,24,70
"2011","Breckland 005E","E01026433","Total",613,167,47,120,446,38,44,115,156,20,28,45
"2011","Breckland 005F","E01026434","Total",915,255,140,115,660,39,185,106,212,15,25,78
"2011","Breckland 006A","E01026479","Total",640,177,99,78,463,10,127,66,118,15,40,87
"2011","Breckland 006B","E01026480","Total",658,185,100,85,473,17,143,80,128,11,20,74
"2011","Breckland 006C","E01026481","Total",481,104,45,59,377,19,81,66,112,15,28,56
"2011","Breckland 006D","E01026484","Total",583,157,84,73,426,7,113,85,110,17,29,65
"2011","Breckland 006E","E01026485","Total",452,96,44,52,356,12,102,59,98,8,25,52
"2011","Breckland 007A","E01026455","Total",825,274,169,105,551,50,154,99,121,16,28,83
"2011","Breckland 007B","E01026456","Total",493,134,88,46,359,11,117,52,97,6,21,55
"2011","Breckland 007C","E01026457","Total",605,171,137,34,434,5,196,40,107,5,15,66
"2011","Breckland 007D","E01026458","Total",673,211,121,90,462,46,106,90,123,12,28,57
"2011","Breckland 007E","E01026459","Total",662,223,145,78,439,26,152,60,109,13,23,56
"2011","Breckland 008A","E01026437","Total",540,138,88,50,402,5,161,53,108,12,22,41
"2011","Breckland 008B","E01026438","Total",432,93,51,42,339,18,97,42,95,12,23,52
"2011","Breckland 008C","E01026451","Total",891,231,137,94,660,23,208,93,174,22,50,90
"2011","Breckland 008D","E01026495","Total",572,155,102,53,417,16,129,63,119,14,26,50
"2011","Breckland 008E","E01026496","Total",496,150,101,49,346,7,141,43,77,13,16,49
"2011","Breckland 009A","E01026486","Total",705,197,119,78,508,36,208,60,103,12,24,65
"2011","Breckland 009B","E01026487","Total",618,116,54,62,502,39,80,115,146,16,33,73
"2011","Breckland 009C","E01026488","Total",548,257,125,132,291,24,68,50,78,4,18,49
"2011","Breckland 009D","E01026489","Total",625,191,137,54,434,14,187,55,79,9,19,71
"2011","Breckland 009E","E01026490","Total",730,213,150,63,517,15,199,80,113,5,27,78
"2011","Breckland 010A","E01026419","Total",481,102,63,39,379,6,82,60,108,11,38,74
"2011","Breckland 010B","E01026420","Total",470,95,47,48,375,11,95,68,106,11,22,62
"2011","Breckland 010D","E01026464","Total",499,84,37,47,415,16,109,70,115,12,33,60
"2011","Breckland 010E","E01026491","Total",907,217,103,114,690,14,172,107,216,18,45,118
"2011","Breckland 010F","E01033040","Total",398,72,9,63,326,48,16,96,84,28,23,31
"2011","Breckland 010G","E01033041","Total",400,105,20,85,295,19,24,67,92,17,25,51
"2011","Breckland 011A","E01026422","Total",911,266,168,98,645,17,239,99,157,10,29,94
"2011","Breckland 011B","E01026423","Total",751,205,82,123,546,43,90,106,163,23,42,79
"2011","Breckland 011C","E01026447","Total",716,271,136,135,445,44,76,91,143,12,34,45
"2011","Breckland 011D","E01026449","Total",793,200,101,99,593,38,97,113,184,20,42,99
"2011","Breckland 011E","E01026450","Total",722,187,89,98,535,20,120,130,132,15,33,85
"2011","Breckland 012A","E01026424","Total",884,220,134,86,664,22,183,110,189,24,50,86
"2011","Breckland 012B","E01026444","Total",894,236,110,126,658,30,177,105,196,17,37,96
"2011","Breckland 012C","E01026492","Total",563,148,68,80,415,13,104,88,118,23,12,57
"2011","Breckland 012D","E01026493","Total",499,125,58,67,374,21,124,49,99,7,18,56
"2011","Breckland 013A","E01026421","Total",738,204,116,88,534,23,146,85,135,20,36,89
"2011","Breckland 013B","E01026435","Total",866,193,82,111,673,18,143,121,189,37,50,115
"2011","Breckland 013C","E01026448","Total",867,157,80,77,710,38,135,175,176,26,48,112
"2011","Breckland 014A","E01026439","Total",692,178,89,89,514,18,155,79,151,9,28,74
"2011","Breckland 014B","E01026440","Total",463,101,37,64,362,16,64,67,102,20,35,58
"2011","Breckland 014C","E01026441","Total",651,165,99,66,486,22,158,73,108,13,36,76
"2011","Breckland 014D","E01026494","Total",936,218,104,114,718,28,198,109,206,22,50,105
"2011","Breckland 015A","E01026465","Total",771,245,110,135,526,52,107,93,121,18,43,92
"2011","Breckland 015B","E01026466","Total",719,179,70,109,540,46,62,105,116,23,70,118
"2011","Breckland 015C","E01026467","Total",765,155,41,114,610,133,43,111,110,56,71,86
"2011","Breckland 016A","E01026468","Total",1042,335,158,177,707,38,155,108,227,18,31,130
"2011","Breckland 016B","E01026469","Total",665,178,96,82,487,16,102,100,130,11,44,84
"2011","Breckland 016C","E01026470","Total",1062,182,47,135,880,35,79,242,301,26,68,129
"2011","Breckland 016D","E01026471","Total",507,127,28,99,380,19,59,78,114,14,31,65
"2011","Breckland 016E","E01026472","Total",489,84,32,52,405,18,83,80,127,10,18,69
"2011","Breckland 016F","E01026473","Total",564,96,37,59,468,25,81,122,122,18,34,66
"2011","Breckland 017A","E01026474","Total",673,150,75,75,523,43,102,102,131,26,37,82
"2011","Breckland 017B","E01026475","Total",628,163,83,80,465,34,103,78,130,10,38,72
"2011","Breckland 017C","E01026476","Total",566,122,50,72,444,48,67,71,100,23,48,87
"2011","Breckland 017D","E01026477","Total",579,146,86,60,433,58,67,87,91,14,41,75
"2011","Breckland 017E","E01026478","Total",641,159,87,72,482,64,67,72,109,39,53,78
"2011","Broadland 001A","E01026499","Total",764,329,198,131,435,34,120,63,119,15,14,70
"2011","Broadland 001B","E01026500","Total",736,188,114,74,548,19,165,113,135,14,28,74
"2011","Broadland 001C","E01026501","Total",680,181,95,86,499,16,150,56,146,17,30,84
"2011","Broadland 001D","E01026502","Total",518,143,68,75,375,16,105,55,120,18,13,48
"2011","Broadland 001E","E01026503","Total",649,191,123,68,458,14,159,67,117,8,18,75
"2011","Broadland 002A","E01026522","Total",595,161,91,70,434,27,92,84,115,18,37,61
"2011","Broadland 002B","E01026523","Total",769,194,94,100,575,43,119,111,137,21,38,106
"2011","Broadland 002C","E01026524","Total",616,142,73,69,474,16,117,76,157,14,29,65
"2011","Broadland 002D","E01026525","Total",451,83,30,53,368,12,98,45,122,12,23,56
"2011","Broadland 002E","E01026547","Total",636,214,105,109,422,22,103,80,114,16,26,61
"2011","Broadland 002F","E01026548","Total",533,128,75,53,405,35,88,76,97,15,27,67
"2011","Broadland 003A","E01026514","Total",630,139,62,77,491,28,113,93,153,13,34,57
"2011","Broadland 003B","E01026515","Total",451,105,65,40,346,9,86,63,98,11,19,60
"2011","Broadland 003C","E01026516","Total",563,182,101,81,381,17,93,53,109,16,27,66
"2011","Broadland 003D","E01026517","Total",602,168,101,67,434,17,112,75,127,18,24,61
"2011","Broadland 004A","E01026533","Total",521,134,62,72,387,8,117,51,104,13,21,73
"2011","Broadland 004B","E01026534","Total",628,119,49,70,509,29,103,98,131,29,36,83
"2011","Broadland 004C","E01026535","Total",663,131,56,75,532,30,109,96,146,20,29,102
"2011","Broadland 004D","E01026536","Total",653,133,72,61,520,18,102,112,143,24,35,86
"2011","Broadland 004E","E01026537","Total",573,109,26,83,464,27,40,143,155,16,29,54
"2011","Broadland 005A","E01026549","Total",797,257,128,129,540,25,144,85,158,17,32,79
"2011","Broadland 005B","E01026550","Total",437,96,33,63,341,16,52,70,93,13,33,64
"2011","Broadland 005C","E01026551","Total",496,131,59,72,365,10,85,73,114,7,22,54
"2011","Broadland 005D","E01026552","Total",606,144,96,48,462,4,145,74,121,9,26,83
"2011","Broadland 006A","E01026562","Total",453,73,29,44,380,14,81,104,92,11,28,50
"2011","Broadland 006B","E01026563","Total",556,136,21,115,420,39,30,111,120,17,32,71
"2011","Broadland 006C","E01026564","Total",564,105,40,65,459,24,86,130,98,10,41,70
"2011","Broadland 006D","E01026565","Total",511,164,20,144,347,36,20,92,126,11,24,38
"2011","Broadland 006E","E01026566","Total",634,173,74,99,461,39,104,85,139,10,27,57
"2011","Broadland 006F","E01026567","Total",758,207,152,55,551,17,220,69,129,10,26,80
"2011","Broadland 006G","E01026568","Total",625,122,71,51,503,16,97,110,138,12,38,92
"2011","Broadland 007A","E01026518","Total",535,118,40,78,417,37,40,134,107,19,32,48
"2011","Broadland 007B","E01026519","Total",735,210,61,149,525,41,62,129,176,18,35,64
"2011","Broadland 007C","E01026520","Total",503,140,104,36,363,16,133,46,90,1,19,58
"2011","Broadland 007D","E01026521","Total",505,101,68,33,404,11,151,63,88,4,24,63
"2011","Broadland 008A","E01026545","Total",644,143,57,86,501,29,99,137,137,21,29,49
"2011","Broadland 008B","E01026546","Total",584,86,46,40,498,15,124,89,124,17,27,102
"2011","Broadland 008C","E01026578","Total",762,143,65,78,619,40,125,153,155,32,29,85
"2011","Broadland 008D","E01026579","Total",638,116,60,56,522,21,156,68,156,7,20,94
"2011","Broadland 008E","E01026580","Total",708,204,144,60,504,23,205,54,114,14,28,66
"2011","Broadland 009A","E01026540","Total",644,169,117,52,475,6,140,67,144,16,28,74
"2011","Broadland 009B","E01026541","Total",1027,270,119,151,757,66,129,177,224,34,35,92
"2011","Broadland 009C","E01026542","Total",651,172,105,67,479,19,140,73,119,13,26,89
"2011","Broadland 009D","E01026543","Total",634,166,97,69,468,13,132,71,133,10,30,79
"2011","Broadland 009E","E01026544","Total",722,178,57,121,544,25,97,118,186,10,21,87
"2011","Broadland 010A","E01026526","Total",649,185,117,68,464,12,144,66,122,16,20,84
"2011","Broadland 010B","E01026527","Total",664,183,136,47,481,7,193,57,110,12,18,84
"2011","Broadland 010C","E01026528","Total",602,174,123,51,428,20,148,52,96,7,20,85
"2011","Broadland 010D","E01026529","Total",722,244,135,109,478,26,115,63,141,13,29,91
"2011","Broadland 011A","E01026530","Total",747,196,108,88,551,16,157,75,149,16,31,107
"2011","Broadland 011B","E01026531","Total",748,206,143,63,542,9,167,84,140,15,37,90
"2011","Broadland 011C","E01026532","Total",738,215,107,108,523,16,133,89,127,13,37,108
"2011","Broadland 012A","E01026553","Total",611,207,95,112,404,23,88,83,112,13,25,60
"2011","Broadland 012B","E01026554","Total",504,127,61,66,377,16,73,67,126,3,22,70
"2011","Broadland 012C","E01026555","Total",610,141,80,61,469,13,126,72,107,25,33,93
"2011","Broadland 012D","E01026556","Total",639,177,65,112,462,34,93,81,153,7,30,64
"2011","Broadland 013A","E01026557","Total",637,207,116,91,430,3,131,62,126,10,21,77
"2011","Broadland 013B","E01026558","Total",614,184,114,70,430,14,138,58,134,6,14,66
"2011","Broadland 013C","E01026559","Total",626,154,93,61,472,15,134,72,115,8,33,95
"2011","Broadland 013D","E01026560","Total",633,189,137,52,444,11,172,71,100,8,20,62
"2011","Broadland 013E","E01026561","Total",650,184,121,63,466,9,175,55,125,4,19,79
"2011","Broadland 014A","E01026504","Total",627,127,67,60,500,12,139,89,146,13,33,68
"2011","Broadland 014B","E01026505","Total",605,171,103,68,434,16,124,84,121,15,22,52
"2011","Broadland 014C","E01026506","Total",590,136,83,53,454,13,154,75,108,10,21,73
"2011","Broadland 014D","E01026507","Total",568,148,88,60,420,19,107,82,105,16,14,77
"2011","Broadland 014E","E01026512","Total",553,146,83,63,407,19,92,71,130,13,30,52
"2011","Broadland 014F","E01026513","Total",578,148,76,72,430,27,108,92,108,14,22,59
"2011","Broadland 015A","E01026569","Total",719,298,199,99,421,17,122,79,110,10,21,62
"2011","Broadland 015B","E01026570","Total",727,214,151,63,513,17,164,99,129,11,22,71
"2011","Broadland 015C","E01026571","Total",655,210,133,77,445,14,98,89,132,15,31,66
"2011","Broadland 015D","E01026572","Total",638,175,101,74,463,17,120,94,122,8,24,78
"2011","Broadland 015E","E01026573","Total",623,201,129,72,422,25,127,63,105,19,26,57
"2011","Broadland 016A","E01026574","Total",683,146,47,99,537,44,62,142,154,21,37,77
"2011","Broadland 016B","E01026575","Total",732,218,104,114,514,30,139,98,129,21,25,72
"2011","Broadland 016C","E01026576","Total",808,175,30,145,633,48,39,204,205,23,40,74
"2011","Broadland 016D","E01026577","Total",775,253,88,165,522,27,125,102,166,10,19,73
"2011","Broadland 017A","E01026508","Total",641,183,112,71,458,27,127,75,126,12,27,64
"2011","Broadland 017B","E01026509","Total",684,169,91,78,515,10,135,87,152,11,31,89
"2011","Broadland 017C","E01026510","Total",700,193,106,87,507,16,148,81,147,10,25,80
"2011","Broadland 017D","E01026511","Total",467,89,48,41,378,23,72,44,135,12,30,62
"2011","Broadland 018A","E01026497","Total",679,211,117,94,468,18,140,91,125,6,21,67
"2011","Broadland 018B","E01026498","Total",606,216,153,63,390,26,105,59,90,18,23,69
"2011","Broadland 018C","E01026538","Total",648,160,83,77,488,27,125,73,146,25,31,61
"2011","Broadland 018D","E01026539","Total",676,129,61,68,547,22,130,97,165,22,34,77
"2011","Great Yarmouth 001A","E01026605","Total",699,160,102,58,539,16,183,75,139,13,17,96
"2011","Great Yarmouth 001B","E01026606","Total",708,204,126,78,504,24,164,43,140,11,39,83
"2011","Great Yarmouth 001C","E01026607","Total",710,200,110,90,510,28,144,87,124,14,29,84
"2011","Great Yarmouth 001D","E01026627","Total",617,158,112,46,459,17,149,67,116,10,19,81
"2011","Great Yarmouth 001E","E01026628","Total",595,145,88,57,450,16,122,58,124,10,29,91
"2011","Great Yarmouth 001F","E01026629","Total",630,175,98,77,455,24,109,85,107,8,40,82
"2011","Great Yarmouth 002A","E01026608","Total",522,119,69,50,403,14,103,69,99,11,26,81
"2011","Great Yarmouth 002B","E01026609","Total",496,111,47,64,385,15,72,60,131,12,24,71
"2011","Great Yarmouth 002C","E01026636","Total",674,180,116,64,494,14,156,66,136,11,30,81
"2011","Great Yarmouth 002D","E01026637","Total",822,174,104,70,648,17,208,78,170,22,44,109
"2011","Great Yarmouth 002E","E01026638","Total",639,169,93,76,470,41,101,88,98,18,48,76
"2011","Great Yarmouth 003A","E01026589","Total",614,175,86,89,439,30,102,81,102,10,29,85
"2011","Great Yarmouth 003B","E01026590","Total",670,201,112,89,469,23,163,57,136,5,22,63
"2011","Great Yarmouth 003C","E01026591","Total",803,233,154,79,570,25,178,83,151,11,26,96
"2011","Great Yarmouth 003D","E01026592","Total",700,228,160,68,472,20,195,36,101,3,29,88
"2011","Great Yarmouth 003E","E01026593","Total",590,157,102,55,433,11,157,56,95,7,28,79
"2011","Great Yarmouth 003F","E01026594","Total",761,248,136,112,513,45,128,89,112,14,51,74
"2011","Great Yarmouth 004A","E01026599","Total",574,176,55,121,398,31,69,61,98,24,44,71
"2011","Great Yarmouth 004B","E01026639","Total",598,132,59,73,466,20,106,63,112,17,47,101
"2011","Great Yarmouth 004C","E01026640","Total",756,276,212,64,480,24,184,51,95,17,34,75
"2011","Great Yarmouth 004D","E01026641","Total",625,191,124,67,434,65,80,79,80,20,37,73
"2011","Great Yarmouth 005A","E01026595","Total",789,292,116,176,497,68,94,101,137,11,23,63
"2011","Great Yarmouth 005B","E01026596","Total",683,192,103,89,491,29,97,96,119,26,41,83
"2011","Great Yarmouth 005C","E01026597","Total",888,382,101,281,506,74,60,103,142,23,46,58
"2011","Great Yarmouth 005D","E01026598","Total",707,275,65,210,432,61,47,68,134,6,38,78
"2011","Great Yarmouth 006A","E01026622","Total",632,171,96,75,461,76,61,86,91,50,36,61
"2011","Great Yarmouth 006B","E01026623","Total",663,255,73,182,408,40,51,60,115,15,27,100
"2011","Great Yarmouth 006C","E01026624","Total",829,366,129,237,463,73,58,77,140,17,39,59
"2011","Great Yarmouth 006D","E01026625","Total",773,291,101,190,482,97,59,92,96,41,43,54
"2011","Great Yarmouth 006E","E01026626","Total",866,327,88,239,539,72,80,92,170,21,33,71
"2011","Great Yarmouth 007A","E01026600","Total",628,202,101,101,426,45,63,79,105,24,38,72
"2011","Great Yarmouth 007B","E01026633","Total",729,194,50,144,535,56,62,117,130,30,44,96
"2011","Great Yarmouth 007C","E01026634","Total",612,167,54,113,445,57,52,89,107,32,39,69
"2011","Great Yarmouth 007D","E01026635","Total",958,283,86,197,675,97,71,160,191,23,48,85
"2011","Great Yarmouth 008A","E01026581","Total",656,132,52,80,524,28,94,119,128,17,51,87
"2011","Great Yarmouth 008B","E01026582","Total",842,224,114,110,618,26,166,127,164,15,32,88
"2011","Great Yarmouth 008C","E01026583","Total",565,162,80,82,403,27,94,62,99,10,28,83
"2011","Great Yarmouth 008D","E01026584","Total",669,164,122,42,505,22,193,68,105,13,22,82
"2011","Great Yarmouth 009A","E01026601","Total",664,185,78,107,479,56,74,91,149,15,25,69
"2011","Great Yarmouth 009B","E01026602","Total",702,240,157,83,462,39,131,61,118,9,27,77
"2011","Great Yarmouth 009C","E01026603","Total",742,224,86,138,518,114,73,104,110,15,27,75
"2011","Great Yarmouth 009D","E01026604","Total",726,266,107,159,460,75,96,76,94,13,42,64
"2011","Great Yarmouth 009E","E01026632","Total",786,287,147,140,499,62,97,71,153,15,33,68
"2011","Great Yarmouth 010A","E01026610","Total",666,227,63,164,439,48,66,94,103,17,32,79
"2011","Great Yarmouth 010B","E01026611","Total",648,220,134,86,428,9,136,50,112,10,28,83
"2011","Great Yarmouth 010C","E01026612","Total",1065,306,203,103,759,48,205,138,160,26,61,121
"2011","Great Yarmouth 010D","E01026630","Total",670,159,74,85,511,66,62,92,115,32,47,97
"2011","Great Yarmouth 010E","E01026631","Total",777,247,76,171,530,71,100,106,137,19,26,71
"2011","Great Yarmouth 011A","E01026617","Total",581,176,124,52,405,28,127,59,90,12,24,65
"2011","Great Yarmouth 011B","E01026618","Total",685,201,95,106,484,24,121,93,104,14,32,96
"2011","Great Yarmouth 011C","E01026619","Total",596,149,86,63,447,59,86,85,87,31,37,62
"2011","Great Yarmouth 011D","E01026620","Total",641,259,186,73,382,39,86,51,79,26,36,65
"2011","Great Yarmouth 011E","E01026621","Total",553,124,83,41,429,28,86,71,77,20,46,101
"2011","Great Yarmouth 012A","E01026613","Total",561,142,72,70,419,8,102,62,132,14,23,78
"2011","Great Yarmouth 012B","E01026614","Total",713,215,89,126,498,11,141,55,149,8,35,99
"2011","Great Yarmouth 012C","E01026615","Total",558,106,60,46,452,17,116,54,136,17,30,82
"2011","Great Yarmouth 012D","E01026616","Total",491,112,46,66,379,21,59,84,108,12,30,65
"2011","Great Yarmouth 013A","E01026585","Total",589,179,120,59,410,18,134,67,95,7,23,66
"2011","Great Yarmouth 013B","E01026586","Total",499,171,119,52,328,28,107,46,71,7,18,51
"2011","Great Yarmouth 013C","E01026587","Total",729,164,88,76,565,21,140,128,131,13,34,98
"2011","Great Yarmouth 013D","E01026588","Total",1145,321,155,166,824,41,228,150,206,31,44,124
"2011","King's Lynn and West Norfolk 001A","E01026680","Total",769,307,217,90,462,12,247,33,101,7,22,40
"2011","King's Lynn and West Norfolk 001B","E01026681","Total",686,213,129,84,473,12,211,52,114,11,19,54
"2011","King's Lynn and West Norfolk 001C","E01026682","Total",552,198,142,56,354,14,136,38,92,5,21,48
"2011","King's Lynn and West Norfolk 001D","E01026683","Total",654,257,117,140,397,23,118,44,130,10,16,56
"2011","King's Lynn and West Norfolk 002A","E01026645","Total",665,221,137,84,444,8,196,36,133,5,13,53
"2011","King's Lynn and West Norfolk 002B","E01026646","Total",844,298,180,118,546,21,227,66,123,20,20,69
"2011","King's Lynn and West Norfolk 002C","E01026656","Total",837,224,126,98,613,25,192,94,165,18,28,91
"2011","King's Lynn and West Norfolk 002D","E01026695","Total",984,275,157,118,709,21,239,110,195,15,31,98
"2011","King's Lynn and West Norfolk 003A","E01026676","Total",818,249,159,90,569,24,258,46,139,12,18,72
"2011","King's Lynn and West Norfolk 003B","E01026677","Total",727,290,184,106,437,23,136,68,111,8,35,56
"2011","King's Lynn and West Norfolk 003C","E01026678","Total",755,258,176,82,497,16,222,48,119,13,22,57
"2011","King's Lynn and West Norfolk 003D","E01026701","Total",779,231,159,72,548,20,239,48,155,7,22,57
"2011","King's Lynn and West Norfolk 003E","E01026702","Total",617,236,137,99,381,22,129,49,109,6,23,43
"2011","King's Lynn and West Norfolk 003F","E01026703","Total",532,142,79,63,390,18,117,58,118,13,19,47
"2011","King's Lynn and West Norfolk 004A","E01026653","Total",840,240,162,78,600,19,249,80,150,9,16,77
"2011","King's Lynn and West Norfolk 004B","E01026654","Total",741,257,150,107,484,27,177,73,113,15,34,45
"2011","King's Lynn and West Norfolk 004C","E01026655","Total",659,220,130,90,439,16,182,50,109,13,19,50
"2011","King's Lynn and West Norfolk 004D","E01026718","Total",1008,263,148,115,745,23,241,91,218,28,36,108
"2011","King's Lynn and West Norfolk 005A","E01026691","Total",457,79,46,33,378,13,91,80,92,13,20,69
"2011","King's Lynn and West Norfolk 005B","E01026692","Total",519,115,43,72,404,23,80,85,113,13,31,59
"2011","King's Lynn and West Norfolk 005C","E01026708","Total",551,103,72,31,448,18,147,72,103,9,31,68
"2011","King's Lynn and West Norfolk 005D","E01026709","Total",765,149,100,49,616,31,162,128,161,21,28,85
"2011","King's Lynn and West Norfolk 005E","E01026710","Total",485,90,52,38,395,9,115,61,106,9,18,77
"2011","King's Lynn and West Norfolk 006A","E01026669","Total",746,206,129,77,540,21,180,74,144,6,27,88
"2011","King's Lynn and West Norfolk 006B","E01026670","Total",586,133,39,94,453,35,64,112,103,18,38,83
"2011","King's Lynn and West Norfolk 006C","E01026671","Total",532,86,46,40,446,18,91,82,113,19,27,96
"2011","King's Lynn and West Norfolk 006D","E01026672","Total",625,163,95,68,462,13,112,67,113,15,37,105
"2011","King's Lynn and West Norfolk 006E","E01026673","Total",633,144,52,92,489,31,74,114,154,17,21,78
"2011","King's Lynn and West Norfolk 007A","E01026687","Total",661,219,125,94,442,54,66,104,90,10,42,76
"2011","King's Lynn and West Norfolk 007B","E01026688","Total",526,89,45,44,437,58,35,95,87,27,48,87
"2011","King's Lynn and West Norfolk 007C","E01026689","Total",640,188,68,120,452,38,42,67,157,13,38,97
"2011","King's Lynn and West Norfolk 007D","E01026690","Total",586,163,57,106,423,53,62,85,74,31,38,80
"2011","King's Lynn and West Norfolk 008A","E01026647","Total",925,210,123,87,715,22,243,84,176,18,59,113
"2011","King's Lynn and West Norfolk 008B","E01026711","Total",602,139,60,79,463,33,87,85,117,25,34,82
"2011","King's Lynn and West Norfolk 008C","E01026712","Total",690,159,92,67,531,22,140,90,144,14,35,86
"2011","King's Lynn and West Norfolk 008D","E01026713","Total",629,129,70,59,500,10,135,63,159,15,34,84
"2011","King's Lynn and West Norfolk 009A","E01026666","Total",726,216,102,114,510,33,84,102,94,29,68,100
"2011","King's Lynn and West Norfolk 009B","E01026667","Total",673,200,78,122,473,26,90,87,131,7,31,101
"2011","King's Lynn and West Norfolk 009C","E01026668","Total",634,176,64,112,458,20,90,78,118,20,42,90
"2011","King's Lynn and West Norfolk 009D","E01026693","Total",814,244,122,122,570,27,133,101,151,18,45,95
"2011","King's Lynn and West Norfolk 010A","E01026662","Total",923,192,37,155,731,93,74,182,183,40,69,90
"2011","King's Lynn and West Norfolk 010B","E01026663","Total",714,223,130,93,491,49,70,107,98,36,51,80
"2011","King's Lynn and West Norfolk 010C","E01026664","Total",949,249,63,186,700,48,80,168,240,16,46,102
"2011","King's Lynn and West Norfolk 010D","E01026714","Total",793,184,85,99,609,27,127,125,159,15,43,113
"2011","King's Lynn and West Norfolk 011A","E01026698","Total",1024,491,216,275,533,27,119,65,202,11,26,83
"2011","King's Lynn and West Norfolk 011B","E01026699","Total",848,477,167,310,371,24,48,80,130,11,20,58
"2011","King's Lynn and West Norfolk 011C","E01026700","Total",689,309,89,220,380,25,40,57,137,12,22,87
"2011","King's Lynn and West Norfolk 011D","E01026704","Total",686,159,51,108,527,43,73,95,124,48,40,104
"2011","King's Lynn and West Norfolk 011E","E01026705","Total",638,154,67,87,484,22,104,113,118,30,25,72
"2011","King's Lynn and West Norfolk 011F","E01026706","Total",633,142,49,93,491,25,98,90,128,19,34,97
"2011","King's Lynn and West Norfolk 012A","E01026665","Total",984,275,147,128,709,20,197,143,196,17,37,99
"2011","King's Lynn and West Norfolk 012B","E01026674","Total",482,105,63,42,377,12,121,42,100,9,21,72
"2011","King's Lynn and West Norfolk 012C","E01026675","Total",508,107,62,45,401,14,101,83,109,7,21,66
"2011","King's Lynn and West Norfolk 012D","E01026694","Total",1078,303,170,133,775,23,224,132,215,19,42,120
"2011","King's Lynn and West Norfolk 013A","E01026684","Total",461,92,39,53,369,10,80,47,115,16,35,66
"2011","King's Lynn and West Norfolk 013B","E01026685","Total",554,147,88,59,407,20,123,60,99,6,25,74
"2011","King's Lynn and West Norfolk 013C","E01026719","Total",907,175,86,89,732,25,172,116,199,41,50,129
"2011","King's Lynn and West Norfolk 013D","E01026720","Total",526,112,65,47,414,12,98,65,98,12,35,94
"2011","King's Lynn and West Norfolk 013E","E01026721","Total",513,116,71,45,397,18,108,59,84,18,35,75
"2011","King's Lynn and West Norfolk 014A","E01026642","Total",561,130,76,54,431,13,147,65,114,13,23,56
"2011","King's Lynn and West Norfolk 014B","E01026643","Total",596,132,68,64,464,12,130,66,130,11,23,92
"2011","King's Lynn and West Norfolk 014C","E01026644","Total",644,14,3,11,630,13,12,301,199,47,21,37
"2011","King's Lynn and West Norfolk 014D","E01026723","Total",661,115,66,49,546,12,171,95,134,14,25,95
"2011","King's Lynn and West Norfolk 014E","E01026724","Total",724,193,122,71,531,26,185,84,115,15,19,87
"2011","King's Lynn and West Norfolk 014F","E01026725","Total",615,130,71,59,485,23,141,61,128,8,34,90
"2011","King's Lynn and West Norfolk 015A","E01026696","Total",449,94,55,39,355,16,62,62,90,16,41,68
"2011","King's Lynn and West Norfolk 015B","E01026697","Total",550,140,79,61,410,12,110,66,117,5,31,69
"2011","King's Lynn and West Norfolk 015C","E01026722","Total",1021,251,107,144,770,44,158,158,217,30,44,119
"2011","King's Lynn and West Norfolk 015D","E01026726","Total",858,196,105,91,662,26,169,89,184,23,61,110
"2011","King's Lynn and West Norfolk 016A","E01026659","Total",675,199,94,105,476,22,102,95,131,22,36,68
"2011","King's Lynn and West Norfolk 016B","E01026660","Total",697,156,108,48,541,20,167,79,130,20,39,86
"2011","King's Lynn and West Norfolk 016C","E01026661","Total",606,135,87,48,471,13,133,70,122,17,43,73
"2011","King's Lynn and West Norfolk 016D","E01026715","Total",595,130,67,63,465,15,122,71,134,13,34,76
"2011","King's Lynn and West Norfolk 016E","E01026716","Total",793,194,123,71,599,25,158,87,187,24,37,81
"2011","King's Lynn and West Norfolk 016F","E01026717","Total",603,120,45,75,483,13,112,83,136,17,44,78
"2011","King's Lynn and West Norfolk 017C","E01026686","Total",1014,379,248,131,635,32,242,103,157,13,17,71
"2011","King's Lynn and West Norfolk 017D","E01026707","Total",1148,428,352,76,720,8,437,44,141,0,13,77
"2011","King's Lynn and West Norfolk 017E","E01033036","Total",621,125,56,69,496,33,109,117,107,25,34,71
"2011","King's Lynn and West Norfolk 017F","E01033037","Total",608,160,30,130,448,49,50,117,121,17,33,61
"2011","King's Lynn and West Norfolk 017G","E01033038","Total",779,270,128,142,509,41,102,97,173,24,17,55
"2011","King's Lynn and West Norfolk 017H","E01033039","Total",467,165,104,61,302,12,98,39,85,12,17,39
"2011","King's Lynn and West Norfolk 018A","E01026679","Total",996,236,134,102,760,18,196,113,207,29,50,147
"2011","King's Lynn and West Norfolk 018B","E01026727","Total",1096,273,146,127,823,24,237,125,244,31,38,124
"2011","King's Lynn and West Norfolk 018C","E01026728","Total",967,215,115,100,752,20,220,109,219,24,42,118
"2011","King's Lynn and West Norfolk 019A","E01026648","Total",655,168,77,91,487,24,127,92,141,12,32,59
"2011","King's Lynn and West Norfolk 019B","E01026649","Total",661,185,83,102,476,23,114,86,133,22,34,64
"2011","King's Lynn and West Norfolk 019C","E01026650","Total",439,62,29,33,377,12,44,100,119,22,31,49
"2011","King's Lynn and West Norfolk 019D","E01026651","Total",971,220,117,103,751,24,192,129,223,30,45,108
"2011","King's Lynn and West Norfolk 019E","E01026652","Total",525,110,50,60,415,18,106,76,107,15,36,57
"2011","North Norfolk 001A","E01026770","Total",1003,497,297,200,506,19,162,57,168,16,28,56
"2011","North Norfolk 001B","E01026771","Total",748,254,177,77,494,32,168,73,126,11,21,63
"2011","North Norfolk 001C","E01026772","Total",786,202,150,52,584,18,276,66,111,19,42,52
"2011","North Norfolk 001D","E01026773","Total",950,259,176,83,691,24,292,100,153,15,27,80
"2011","North Norfolk 002A","E01026739","Total",964,330,194,136,634,19,245,74,159,24,28,85
"2011","North Norfolk 002B","E01026763","Total",628,206,124,82,422,35,133,70,94,8,31,51
"2011","North Norfolk 002C","E01026764","Total",648,293,181,112,355,10,142,28,98,3,15,59
"2011","North Norfolk 002D","E01026765","Total",618,177,99,78,441,14,166,49,107,14,17,74
"2011","North Norfolk 003A","E01026734","Total",619,305,90,215,314,16,67,49,137,3,8,34
"2011","North Norfolk 003B","E01026735","Total",675,358,150,208,317,21,119,36,89,2,15,35
"2011","North Norfolk 003C","E01026736","Total",603,194,142,52,409,22,143,59,94,15,14,62
"2011","North Norfolk 003D","E01026777","Total",532,155,103,52,377,15,152,35,91,6,16,62
"2011","North Norfolk 003E","E01026778","Total",726,308,215,93,418,15,199,32,94,10,11,57
"2011","North Norfolk 003F","E01026779","Total",568,145,65,80,423,38,79,82,89,26,36,73
"2011","North Norfolk 004A","E01026741","Total",927,305,207,98,622,18,274,66,175,14,21,54
"2011","North Norfolk 004B","E01026742","Total",693,272,206,66,421,14,240,42,83,7,6,29
"2011","North Norfolk 004C","E01026743","Total",1114,424,286,138,690,35,263,96,161,25,29,81
"2011","North Norfolk 005A","E01026762","Total",1054,280,173,107,774,21,291,90,200,18,38,116
"2011","North Norfolk 005B","E01026766","Total",975,231,123,108,744,22,221,92,234,20,42,113
"2011","North Norfolk 005C","E01026781","Total",984,293,180,113,691,10,268,78,173,13,34,115
"2011","North Norfolk 006A","E01026731","Total",493,175,136,39,318,6,160,32,72,5,13,30
"2011","North Norfolk 006B","E01026732","Total",566,153,80,73,413,19,127,53,114,12,24,64
"2011","North Norfolk 006C","E01026733","Total",1033,305,175,130,728,33,204,114,200,26,48,103
"2011","North Norfolk 006D","E01026737","Total",1011,245,126,119,766,24,210,108,211,25,54,134
"2011","North Norfolk 007A","E01026738","Total",1082,274,175,99,808,30,268,103,218,19,54,116
"2011","North Norfolk 007B","E01026750","Total",639,217,120,97,422,25,164,46,105,11,25,46
"2011","North Norfolk 007C","E01026751","Total",674,242,159,83,432,22,169,60,101,14,25,41
"2011","North Norfolk 007D","E01026752","Total",625,170,81,89,455,14,150,63,117,11,30,70
"2011","North Norfolk 008A","E01026729","Total",934,241,102,139,693,36,186,114,184,28,35,110
"2011","North Norfolk 008B","E01026730","Total",1067,295,153,142,772,30,212,142,199,22,49,118
"2011","North Norfolk 008C","E01026788","Total",569,141,77,64,428,17,146,57,119,17,13,59
"2011","North Norfolk 009A","E01026780","Total",1123,321,146,175,802,41,185,133,261,34,37,111
"2011","North Norfolk 009B","E01026782","Total",1008,326,181,145,682,29,212,95,193,14,45,94
"2011","North Norfolk 009C","E01026787","Total",442,116,61,55,326,25,79,59,75,10,23,55
"2011","North Norfolk 010A","E01026753","Total",732,272,144,128,460,44,134,72,87,29,24,70
"2011","North Norfolk 010B","E01026754","Total",616,173,84,89,443,42,84,97,115,12,26,67
"2011","North Norfolk 010C","E01026755","Total",555,151,111,40,404,4,197,48,76,6,19,54
"2011","North Norfolk 010D","E01026756","Total",529,166,80,86,363,47,82,67,74,14,22,57
"2011","North Norfolk 010E","E01026757","Total",677,180,84,96,497,25,120,104,143,11,24,70
"2011","North Norfolk 010F","E01026758","Total",648,211,94,117,437,18,116,81,128,16,10,68
"2011","North Norfolk 010G","E01026759","Total",551,166,107,59,385,30,117,59,73,15,29,62
"2011","North Norfolk 010H","E01026760","Total",584,210,114,96,374,15,103,61,96,8,25,66
"2011","North Norfolk 010I","E01026761","Total",705,213,127,86,492,28,154,77,118,21,20,74
"2011","North Norfolk 011A","E01026745","Total",760,243,147,96,517,18,143,81,143,15,34,83
"2011","North Norfolk 011B","E01026746","Total",747,221,125,96,526,12,128,94,164,8,33,87
"2011","North Norfolk 011C","E01026747","Total",628,232,112,120,396,32,109,66,94,10,24,61
"2011","North Norfolk 011D","E01026748","Total",667,189,123,66,478,14,191,66,116,11,16,64
"2011","North Norfolk 011E","E01026749","Total",682,262,141,121,420,42,102,83,87,19,34,53
"2011","North Norfolk 012A","E01026740","Total",1085,286,158,128,799,28,247,102,269,23,32,98
"2011","North Norfolk 012B","E01026767","Total",528,119,68,51,409,9,117,66,127,13,17,60
"2011","North Norfolk 012C","E01026768","Total",508,101,26,75,407,30,46,90,170,11,15,45
"2011","North Norfolk 012D","E01026789","Total",495,102,45,57,393,14,87,61,116,11,33,71
"2011","North Norfolk 012E","E01026790","Total",479,105,56,49,374,16,93,63,107,12,24,59
"2011","North Norfolk 013A","E01026774","Total",640,159,81,78,481,22,134,77,141,10,24,73
"2011","North Norfolk 013B","E01026775","Total",575,198,121,77,377,31,96,74,82,17,21,56
"2011","North Norfolk 013C","E01026776","Total",776,305,138,167,471,27,160,71,121,9,25,58
"2011","North Norfolk 013D","E01026786","Total",957,241,120,121,716,32,217,94,210,21,38,104
"2011","North Norfolk 014A","E01026744","Total",952,301,204,97,651,11,293,67,153,17,25,85
"2011","North Norfolk 014B","E01026769","Total",982,268,181,87,714,15,256,89,206,14,32,102
"2011","North Norfolk 014C","E01026783","Total",836,242,145,97,594,9,237,67,163,11,17,90
"2011","North Norfolk 014D","E01026784","Total",464,138,90,48,326,21,99,58,68,7,20,53
"2011","North Norfolk 014E","E01026785","Total",607,157,90,67,450,12,180,48,128,9,20,53
"2011","Norwich 001A","E01026797","Total",1070,341,73,268,729,57,64,170,277,28,29,104
"2011","Norwich 001B","E01026798","Total",670,250,68,182,420,50,64,79,102,25,41,59
"2011","Norwich 001C","E01026799","Total",626,181,42,139,445,53,55,92,128,17,25,75
"2011","Norwich 001D","E01026800","Total",901,364,93,271,537,80,50,105,159,30,41,72
"2011","Norwich 001E","E01026801","Total",684,180,94,86,504,14,134,85,139,11,24,97
"2011","Norwich 001F","E01026802","Total",785,329,88,241,456,47,84,90,143,14,15,63
"2011","Norwich 002A","E01026828","Total",664,162,59,103,502,66,67,103,105,38,34,89
"2011","Norwich 002B","E01026829","Total",857,266,63,203,591,72,47,122,175,35,31,109
"2011","Norwich 002C","E01026830","Total",682,312,112,200,370,48,80,63,123,5,9,42
"2011","Norwich 002D","E01026831","Total",632,257,33,224,375,21,28,65,190,10,4,57
"2011","Norwich 002E","E01026832","Total",498,99,51,48,399,48,66,71,69,27,49,69
"2011","Norwich 002F","E01026833","Total",696,321,95,226,375,56,54,96,100,16,19,34
"2011","Norwich 002G","E01026834","Total",644,206,98,108,438,61,70,92,100,17,30,68
"2011","Norwich 003A","E01026841","Total",726,272,39,233,454,33,34,86,235,6,10,50
"2011","Norwich 003B","E01026842","Total",818,324,61,263,494,23,55,95,227,9,12,73
"2011","Norwich 003C","E01026843","Total",902,338,113,225,564,56,80,101,218,9,35,65
"2011","Norwich 003D","E01026844","Total",823,314,65,249,509,72,68,90,179,24,22,54
"2011","Norwich 003E","E01026845","Total",786,286,36,250,500,39,34,97,257,8,13,52
"2011","Norwich 003F","E01026846","Total",811,320,64,256,491,41,33,92,234,7,12,72
"2011","Norwich 004A","E01026803","Total",638,212,113,99,426,48,118,69,92,16,20,63
"2011","Norwich 004B","E01026804","Total",633,187,111,76,446,30,131,64,114,14,33,60
"2011","Norwich 004C","E01026805","Total",639,207,120,87,432,52,128,66,81,19,24,62
"2011","Norwich 004D","E01026806","Total",508,131,67,64,377,10,111,59,113,9,14,61
"2011","Norwich 004E","E01026807","Total",523,152,69,83,371,30,40,63,123,33,19,63
"2011","Norwich 004F","E01026808","Total",516,154,68,86,362,62,38,57,82,30,35,58
"2011","Norwich 004G","E01026809","Total",762,335,120,215,427,47,112,71,106,18,18,55
"2011","Norwich 005A","E01026791","Total",661,262,71,191,399,60,35,73,107,17,22,85
"2011","Norwich 005B","E01026792","Total",627,180,80,100,447,33,83,91,134,20,18,68
"2011","Norwich 005C","E01026793","Total",625,102,46,56,523,67,76,96,93,50,44,97
"2011","Norwich 005D","E01026794","Total",844,210,56,154,634,41,77,127,222,24,41,102
"2011","Norwich 005F","E01026796","Total",650,196,88,108,454,52,81,51,80,25,32,133
"2011","Norwich 005G","E01033435","Total",705,144,21,123,561,50,25,145,198,22,29,92
"2011","Norwich 005H","E01033436","Total",596,187,89,98,409,41,65,67,118,22,28,68
"2011","Norwich 006A","E01026863","Total",771,215,80,135,556,37,73,90,186,8,22,140
"2011","Norwich 006B","E01026864","Total",657,169,75,94,488,56,80,86,148,12,31,75
"2011","Norwich 006C","E01026865","Total",805,236,79,157,569,81,52,109,158,31,35,103
"2011","Norwich 006D","E01026866","Total",767,293,68,225,474,43,73,58,181,13,15,91
"2011","Norwich 006E","E01026867","Total",562,136,51,85,426,44,52,71,76,31,65,87
"2011","Norwich 006F","E01026868","Total",565,119,41,78,446,66,35,81,94,34,43,93
"2011","Norwich 006G","E01026869","Total",657,264,63,201,393,60,66,91,89,19,19,49
"2011","Norwich 007A","E01026822","Total",1228,694,219,475,534,46,88,55,275,1,6,63
"2011","Norwich 007B","E01026823","Total",1099,597,116,481,502,28,61,42,287,3,4,77
"2011","Norwich 007C","E01026824","Total",868,476,146,330,392,40,58,54,176,8,6,50
"2011","Norwich 007D","E01026825","Total",718,359,78,281,359,26,35,59,176,3,6,54
"2011","Norwich 007E","E01026826","Total",864,515,174,341,349,47,35,49,160,10,9,39
"2011","Norwich 007F","E01026827","Total",931,547,225,322,384,67,75,55,138,8,6,35
"2011","Norwich 009A","E01026835","Total",643,236,51,185,407,36,39,58,126,11,14,123
"2011","Norwich 009B","E01026836","Total",646,181,40,141,465,32,46,85,140,17,20,125
"2011","Norwich 009C","E01026837","Total",735,338,89,249,397,18,48,63,164,18,13,73
"2011","Norwich 009D","E01026838","Total",645,171,53,118,474,26,61,104,150,14,15,104
"2011","Norwich 009E","E01026839","Total",668,204,31,173,464,26,24,78,154,6,8,168
"2011","Norwich 009F","E01026840","Total",759,233,42,191,526,41,44,77,258,4,12,90
"2011","Norwich 010A","E01026858","Total",745,323,161,162,422,46,99,66,94,13,17,87
"2011","Norwich 010B","E01026859","Total",640,154,76,78,486,73,66,105,97,27,25,93
"2011","Norwich 010C","E01026860","Total",470,152,85,67,318,11,87,36,68,13,13,90
"2011","Norwich 010D","E01026861","Total",549,105,59,46,444,43,69,69,72,11,28,152
"2011","Norwich 010E","E01026862","Total",497,122,86,36,375,22,68,57,69,15,35,109
"2011","Norwich 011A","E01026852","Total",598,228,100,128,370,9,70,78,136,8,21,48
"2011","Norwich 011B","E01026853","Total",1011,534,208,326,477,53,80,67,195,7,9,66
"2011","Norwich 011D","E01026855","Total",773,332,102,230,441,19,59,66,167,10,12,108
"2011","Norwich 011E","E01026856","Total",847,306,59,247,541,38,36,68,230,7,9,153
"2011","Norwich 011F","E01026857","Total",751,327,192,135,424,19,95,59,123,9,21,98
"2011","Norwich 011G","E01033434","Total",615,311,62,249,304,16,24,47,165,2,8,42
"2011","Norwich 011H","E01033437","Total",786,460,136,324,326,43,50,51,113,9,19,41
"2011","Norwich 012A","E01026810","Total",635,205,127,78,430,18,138,65,104,12,20,73
"2011","Norwich 012B","E01026811","Total",723,243,170,73,480,5,171,83,112,8,28,73
"2011","Norwich 012C","E01026812","Total",639,178,81,97,461,12,117,84,142,11,32,63
"2011","Norwich 012D","E01026813","Total",635,172,125,47,463,4,176,76,96,9,25,77
"2011","Norwich 012E","E01026814","Total",653,203,116,87,450,28,105,68,109,20,21,99
"2011","Norwich 012F","E01026815","Total",648,206,92,114,442,19,85,98,129,9,23,79
"2011","Norwich 013A","E01026816","Total",934,446,134,312,488,48,57,80,232,9,15,47
"2011","Norwich 013B","E01026817","Total",706,297,180,117,409,38,87,71,127,14,15,57
"2011","Norwich 013C","E01026818","Total",626,173,69,104,453,62,71,80,127,13,36,64
"2011","Norwich 013D","E01026819","Total",625,214,54,160,411,61,48,76,114,23,27,62
"2011","Norwich 013E","E01026820","Total",755,272,167,105,483,55,89,83,110,27,47,72
"2011","Norwich 013F","E01026821","Total",712,254,134,120,458,42,109,82,110,21,15,79
"2011","Norwich 014A","E01033438","Total",878,557,276,281,321,12,78,36,137,5,10,43
"2011","Norwich 014B","E01033439","Total",763,366,42,324,397,18,26,48,235,6,8,56
"2011","Norwich 014C","E01033440","Total",662,377,30,347,285,19,16,43,170,6,5,26
"2011","Norwich 014D","E01033441","Total",773,428,31,397,345,21,32,39,215,0,4,34
"2011","Norwich 015A","E01026848","Total",1015,512,182,330,503,95,69,96,152,8,14,69
"2011","Norwich 015B","E01026849","Total",913,409,66,343,504,16,67,88,258,6,13,56
"2011","Norwich 015C","E01026850","Total",952,390,80,310,562,44,67,104,268,12,15,52
"2011","South Norfolk 001A","E01026916","Total",896,226,146,80,670,14,205,107,185,18,31,110
"2011","South Norfolk 001B","E01026917","Total",668,188,144,44,480,17,164,55,117,12,28,87
"2011","South Norfolk 001C","E01026918","Total",770,218,103,115,552,17,159,86,170,13,23,84
"2011","South Norfolk 001E","E01026924","Total",674,174,76,98,500,23,162,81,126,13,24,71
"2011","South Norfolk 001F","E01026925","Total",923,297,89,208,626,74,74,143,183,23,37,92
"2011","South Norfolk 001G","E01033538","Total",860,157,7,150,703,62,19,208,298,35,27,54
"2011","South Norfolk 001H","E01033540","Total",666,165,80,85,501,21,135,89,161,15,16,64
"2011","South Norfolk 002A","E01026881","Total",626,238,65,173,388,22,79,93,103,14,16,61
"2011","South Norfolk 002B","E01026882","Total",855,162,99,63,693,27,203,139,187,27,26,84
"2011","South Norfolk 002C","E01026883","Total",680,163,85,78,517,13,142,105,141,12,37,67
"2011","South Norfolk 002D","E01026895","Total",598,128,42,86,470,24,101,106,140,14,20,65
"2011","South Norfolk 002E","E01026896","Total",486,80,40,40,406,14,112,72,113,13,23,59
"2011","South Norfolk 003A","E01026905","Total",521,213,166,47,308,13,116,44,65,5,16,49
"2011","South Norfolk 003B","E01026906","Total",593,134,89,45,459,10,147,67,131,6,24,74
"2011","South Norfolk 003C","E01026907","Total",795,209,116,93,586,31,137,130,175,23,21,69
"2011","South Norfolk 003D","E01026908","Total",598,171,43,128,427,33,37,136,137,9,23,52
"2011","South Norfolk 004A","E01026909","Total",650,216,125,91,434,28,130,68,120,12,24,52
"2011","South Norfolk 004B","E01026910","Total",649,165,91,74,484,14,143,91,131,18,26,61
"2011","South Norfolk 004C","E01026947","Total",509,109,54,55,400,10,81,90,110,20,27,62
"2011","South Norfolk 004D","E01026948","Total",486,80,41,39,406,16,94,95,94,26,24,57
"2011","South Norfolk 005A","E01026870","Total",873,454,231,223,419,33,94,86,149,7,16,34
"2011","South Norfolk 005B","E01026871","Total",570,140,81,59,430,13,122,70,121,11,24,69
"2011","South Norfolk 005C","E01026921","Total",631,199,100,99,432,19,124,60,124,14,20,71
"2011","South Norfolk 005D","E01026922","Total",689,229,135,94,460,38,130,79,122,15,22,54
"2011","South Norfolk 006A","E01026875","Total",448,84,47,37,364,8,94,65,91,15,29,62
"2011","South Norfolk 006B","E01026876","Total",652,169,97,72,483,16,159,81,112,13,33,69
"2011","South Norfolk 006C","E01026926","Total",662,152,95,57,510,21,165,78,120,15,36,75
"2011","South Norfolk 006D","E01026927","Total",788,195,97,98,593,16,155,139,153,12,28,90
"2011","South Norfolk 006E","E01026928","Total",629,186,119,67,443,23,133,78,98,10,25,76
"2011","South Norfolk 006F","E01026936","Total",625,163,86,77,462,22,147,80,122,8,21,62
"2011","South Norfolk 006G","E01026937","Total",629,162,79,83,467,33,88,103,137,16,28,62
"2011","South Norfolk 007A","E01026884","Total",486,127,49,78,359,27,77,58,109,19,27,42
"2011","South Norfolk 007B","E01026885","Total",555,107,46,61,448,23,89,96,116,21,36,67
"2011","South Norfolk 007C","E01026933","Total",1113,271,106,165,842,63,142,197,232,44,51,113
"2011","South Norfolk 007D","E01026945","Total",870,190,60,130,680,54,88,206,174,32,46,80
"2011","South Norfolk 007E","E01026946","Total",496,157,118,39,339,8,117,47,79,8,18,62
"2011","South Norfolk 008A","E01026879","Total",499,138,74,64,361,22,100,68,75,15,24,57
"2011","South Norfolk 008B","E01026880","Total",605,140,94,46,465,13,146,73,111,15,29,78
"2011","South Norfolk 008C","E01026911","Total",529,208,122,86,321,24,81,63,82,10,18,43
"2011","South Norfolk 008D","E01026912","Total",650,165,91,74,485,30,116,87,122,13,38,79
"2011","South Norfolk 008E","E01026929","Total",553,135,63,72,418,14,125,65,111,16,21,66
"2011","South Norfolk 008F","E01026930","Total",615,123,71,52,492,14,127,91,130,27,27,76
"2011","South Norfolk 009A","E01026913","Total",714,191,102,89,523,26,93,115,185,11,29,64
"2011","South Norfolk 009B","E01026914","Total",614,121,61,60,493,19,152,77,125,16,30,74
"2011","South Norfolk 009C","E01026915","Total",796,166,78,88,630,29,127,135,188,36,28,87
"2011","South Norfolk 009D","E01026919","Total",625,135,59,76,490,38,108,121,146,15,21,41
"2011","South Norfolk 009E","E01026920","Total",469,98,46,52,371,10,104,64,95,14,22,62
"2011","South Norfolk 009F","E01026941","Total",506,108,55,53,398,10,113,61,110,13,29,62
"2011","South Norfolk 009G","E01026942","Total",449,76,42,34,373,17,84,57,102,20,29,64
"2011","South Norfolk 010A","E01026898","Total",601,166,90,76,435,15,125,75,102,14,27,77
"2011","South Norfolk 010B","E01026899","Total",602,140,80,60,462,13,113,83,126,20,37,70
"2011","South Norfolk 010C","E01026943","Total",654,139,66,73,515,12,143,63,165,21,30,81
"2011","South Norfolk 010D","E01026944","Total",461,86,53,33,375,10,81,75,98,18,31,62
"2011","South Norfolk 011A","E01026877","Total",638,131,76,55,507,14,143,94,142,16,38,60
"2011","South Norfolk 011B","E01026878","Total",473,96,44,52,377,23,66,72,106,19,22,69
"2011","South Norfolk 011C","E01026897","Total",1099,206,102,104,893,19,242,166,240,25,48,153
"2011","South Norfolk 011D","E01026938","Total",852,229,104,125,623,40,114,123,201,22,31,92
"2011","South Norfolk 011E","E01026939","Total",703,163,64,99,540,27,110,111,152,19,39,82
"2011","South Norfolk 011F","E01026940","Total",719,177,89,88,542,43,86,130,143,26,45,69
"2011","South Norfolk 012A","E01026892","Total",557,163,83,80,394,23,93,71,105,17,33,52
"2011","South Norfolk 012B","E01026893","Total",460,130,93,37,330,7,106,42,91,2,15,67
"2011","South Norfolk 012C","E01026894","Total",1033,247,135,112,786,30,225,122,218,27,41,123
"2011","South Norfolk 012D","E01026903","Total",480,101,55,46,379,4,76,61,125,18,30,65
"2011","South Norfolk 012E","E01026904","Total",562,122,70,52,440,16,116,82,113,16,22,75
"2011","South Norfolk 013A","E01026872","Total",980,267,128,139,713,43,204,112,206,20,39,89
"2011","South Norfolk 013B","E01026900","Total",692,235,147,88,457,20,150,70,124,16,17,60
"2011","South Norfolk 013C","E01026901","Total",606,180,97,83,426,22,120,84,107,11,16,66
"2011","South Norfolk 013D","E01026902","Total",878,315,132,183,563,32,151,89,168,21,24,78
"2011","South Norfolk 014A","E01026873","Total",511,100,39,61,411,12,116,70,115,9,24,65
"2011","South Norfolk 014B","E01026874","Total",610,127,61,66,483,14,112,73,145,14,37,88
"2011","South Norfolk 014C","E01026886","Total",564,116,61,55,448,9,116,71,145,8,26,73
"2011","South Norfolk 014D","E01026887","Total",607,140,67,73,467,16,100,83,156,29,26,57
"2011","South Norfolk 014E","E01026934","Total",463,130,63,67,333,16,106,46,95,11,16,43
"2011","South Norfolk 014F","E01026935","Total",566,135,71,64,431,10,134,67,131,17,23,49
"2011","South Norfolk 015A","E01026888","Total",778,324,225,99,454,29,143,58,112,23,31,58
"2011","South Norfolk 015B","E01026889","Total",719,223,130,93,496,13,162,69,154,9,25,64
"2011","South Norfolk 015D","E01026891","Total",815,348,177,171,467,43,114,81,119,12,27,71
"2011","South Norfolk 015E","E01026931","Total",471,88,47,41,383,10,108,72,93,19,25,56
"2011","South Norfolk 015F","E01026932","Total",535,146,75,71,389,24,90,61,108,18,30,58
"2011","South Norfolk 015G","E01033539","Total",620,193,65,128,427,38,81,101,119,14,18,56
"2011","South Norfolk 015H","E01033541","Total",657,225,113,112,432,30,81,74,150,16,24,57
"2011","Babergh 001A","E01029876","Total",899,244,127,117,655,27,171,112,179,29,35,102
"2011","Babergh 001B","E01029898","Total",884,346,221,125,538,24,192,67,164,10,21,60
"2011","Babergh 001C","E01029907","Total",955,249,135,114,706,20,209,106,217,20,35,99
"2011","Babergh 002A","E01029881","Total",833,196,107,89,637,26,153,114,174,29,46,95
"2011","Babergh 002B","E01029884","Total",666,204,72,132,462,35,72,93,134,21,41,66
"2011","Babergh 002C","E01029885","Total",939,243,123,120,696,28,191,113,208,21,33,102
"2011","Babergh 003A","E01029900","Total",734,234,149,85,500,8,159,85,117,14,32,85
"2011","Babergh 003B","E01029901","Total",1025,377,180,197,648,31,163,85,226,24,24,95
"2011","Babergh 003C","E01029917","Total",812,194,108,86,618,34,174,132,159,14,34,71
"2011","Babergh 004A","E01029892","Total",848,328,151,177,520,58,102,98,145,17,33,67
"2011","Babergh 004B","E01029893","Total",1018,193,102,91,825,32,187,203,199,55,61,88
"2011","Babergh 004C","E01029894","Total",517,151,66,85,366,21,92,71,99,7,23,53
"2011","Babergh 004D","E01029895","Total",476,99,64,35,377,14,92,80,84,12,20,75
"2011","Babergh 004E","E01029896","Total",615,205,157,48,410,22,123,71,72,18,31,73
"2011","Babergh 004F","E01029911","Total",918,231,122,109,687,12,191,129,176,34,36,109
"2011","Babergh 005A","E01029877","Total",513,120,58,62,393,10,98,69,103,13,32,68
"2011","Babergh 005B","E01029878","Total",514,149,67,82,365,10,118,58,96,8,23,52
"2011","Babergh 005C","E01029879","Total",624,152,73,79,472,13,120,87,127,21,23,81
"2011","Babergh 005D","E01029908","Total",686,179,40,139,507,23,39,154,195,16,21,59
"2011","Babergh 005E","E01029909","Total",733,256,49,207,477,39,48,99,187,14,21,69
"2011","Babergh 005F","E01029910","Total",504,157,44,113,347,46,43,53,108,17,28,52
"2011","Babergh 006A","E01029880","Total",743,189,110,79,554,25,173,73,152,22,29,80
"2011","Babergh 006B","E01029921","Total",537,110,75,35,427,18,129,59,117,13,24,67
"2011","Babergh 006C","E01029922","Total",544,126,64,62,418,20,126,58,103,16,22,73
"2011","Babergh 006D","E01029923","Total",582,139,54,85,443,22,84,92,131,11,28,75
"2011","Babergh 007A","E01029912","Total",726,267,132,135,459,45,78,95,125,15,28,73
"2011","Babergh 007B","E01029913","Total",546,192,149,43,354,8,172,35,75,9,14,41
"2011","Babergh 007C","E01029914","Total",666,170,45,125,496,58,60,118,142,27,30,61
"2011","Babergh 007D","E01029915","Total",514,168,72,96,346,11,70,73,98,14,21,59
"2011","Babergh 007E","E01029916","Total",506,122,48,74,384,44,51,66,84,20,46,73
"2011","Babergh 007F","E01029918","Total",544,244,88,156,300,25,55,46,105,13,12,44
"2011","Babergh 007G","E01029919","Total",668,233,97,136,435,17,122,79,121,17,19,60
"2011","Babergh 007H","E01029920","Total",1004,542,290,252,462,46,120,80,155,7,16,38
"2011","Babergh 008A","E01029886","Total",507,156,86,70,351,18,95,67,81,21,20,49
"2011","Babergh 008B","E01029887","Total",792,212,89,123,580,42,148,101,151,16,27,95
"2011","Babergh 008C","E01029888","Total",495,115,53,62,380,30,76,72,103,12,31,56
"2011","Babergh 008D","E01029889","Total",503,108,55,53,395,34,66,73,92,33,36,61
"2011","Babergh 008E","E01029890","Total",485,73,26,47,412,19,45,105,104,19,36,84
"2011","Babergh 008F","E01029891","Total",782,197,74,123,585,30,93,161,160,14,36,91
"2011","Babergh 009A","E01029875","Total",901,215,113,102,686,15,190,129,173,33,50,96
"2011","Babergh 009B","E01029899","Total",764,175,96,79,589,17,169,111,177,17,28,70
"2011","Babergh 009C","E01029902","Total",896,214,118,96,682,16,177,114,199,23,45,108
"2011","Babergh 009D","E01029906","Total",819,259,146,113,560,28,164,107,150,23,20,68
"2011","Babergh 010A","E01029870","Total",479,119,56,63,360,30,69,72,101,19,23,46
"2011","Babergh 010B","E01029872","Total",585,136,82,54,449,7,117,74,125,22,29,75
"2011","Babergh 010C","E01029882","Total",621,167,110,57,454,14,124,80,98,31,29,78
"2011","Babergh 010D","E01029883","Total",850,191,104,87,659,29,220,93,169,22,37,89
"2011","Babergh 010E","E01029903","Total",561,87,59,28,474,9,133,93,137,11,25,66
"2011","Babergh 010F","E01029904","Total",608,144,83,61,464,18,148,76,97,13,31,81
"2011","Babergh 010G","E01029905","Total",464,111,68,43,353,9,111,64,88,10,19,52
"2011","Babergh 011A","E01029871","Total",622,202,124,78,420,8,124,64,119,17,23,65
"2011","Babergh 011B","E01029873","Total",965,299,151,148,666,31,201,111,169,22,42,90
"2011","Babergh 011C","E01029874","Total",727,168,66,102,559,33,107,118,163,14,41,83
"2011","Babergh 011D","E01029897","Total",803,213,108,105,590,26,143,121,147,20,32,101
"2011","Forest Heath 001A","E01029926","Total",796,221,150,71,575,11,229,72,163,16,20,64
"2011","Forest Heath 001B","E01029927","Total",1015,317,145,172,698,78,131,119,167,27,59,117
"2011","Forest Heath 001C","E01029928","Total",804,230,84,146,574,47,111,111,176,22,35,72
"2011","Forest Heath 001D","E01029929","Total",1019,312,154,158,707,51,169,119,204,18,46,100
"2011","Forest Heath 001E","E01029930","Total",644,165,84,81,479,17,111,101,138,15,31,66
"2011","Forest Heath 002C","E01029942","Total",660,181,62,119,479,23,137,74,138,15,29,63
"2011","Forest Heath 002E","E01029944","Total",752,198,109,89,554,34,169,93,145,15,23,75
"2011","Forest Heath 002F","E01033453","Total",938,234,77,157,704,44,65,223,212,51,36,73
"2011","Forest Heath 003E","E01029945","Total",796,197,92,105,599,19,135,117,169,22,35,102
"2011","Forest Heath 003F","E01032523","Total",426,82,9,73,344,8,17,128,106,21,26,38
"2011","Forest Heath 003G","E01032524","Total",411,104,32,72,307,11,62,66,93,14,19,42
"2011","Forest Heath 003H","E01032525","Total",1003,174,46,128,829,36,100,252,202,76,73,90
"2011","Forest Heath 003I","E01032526","Total",701,180,58,122,521,17,113,108,155,16,23,89
"2011","Forest Heath 004A","E01029938","Total",528,114,37,77,414,55,32,86,101,24,34,82
"2011","Forest Heath 004B","E01029939","Total",640,153,64,89,487,17,85,115,147,14,28,81
"2011","Forest Heath 004C","E01029940","Total",617,165,82,83,452,48,94,89,111,20,18,72
"2011","Forest Heath 004D","E01029946","Total",906,263,108,155,643,78,108,127,175,28,51,76
"2011","Forest Heath 004E","E01029947","Total",1064,403,183,220,661,25,191,108,197,12,31,97
"2011","Forest Heath 005A","E01029941","Total",775,202,87,115,573,20,131,123,170,24,33,72
"2011","Forest Heath 005C","E01029957","Total",728,191,101,90,537,17,140,98,174,17,21,70
"2011","Forest Heath 005D","E01033451","Total",622,156,7,149,466,44,6,153,202,27,13,21
"2011","Forest Heath 005E","E01033452","Total",583,158,34,124,425,31,56,118,135,17,21,47
"2011","Forest Heath 005F","E01033454","Total",543,152,24,128,391,27,38,99,152,13,17,45
"2011","Forest Heath 006A","E01029937","Total",871,271,132,139,600,26,136,114,179,20,21,104
"2011","Forest Heath 006B","E01029953","Total",613,182,86,96,431,36,46,92,136,15,27,79
"2011","Forest Heath 006C","E01029954","Total",1122,409,151,258,713,96,104,148,218,20,40,87
"2011","Forest Heath 006D","E01029955","Total",874,309,86,223,565,38,100,96,197,18,25,91
"2011","Forest Heath 006E","E01029956","Total",544,119,40,79,425,25,23,98,167,18,27,67
"2011","Forest Heath 008A","E01029925","Total",870,347,145,202,523,27,105,78,208,9,18,78
"2011","Forest Heath 008B","E01029949","Total",637,206,91,115,431,28,91,64,139,15,29,65
"2011","Forest Heath 008C","E01029950","Total",795,243,107,136,552,68,70,118,149,12,25,110
"2011","Forest Heath 008D","E01029951","Total",616,157,99,58,459,25,115,63,132,7,22,95
"2011","Forest Heath 008E","E01029952","Total",524,149,72,77,375,20,82,66,116,10,15,66
"2011","Forest Heath 008F","E01032612","Total",939,294,71,223,645,40,76,121,267,8,24,109
"2011","Ipswich 001A","E01030032","Total",511,98,48,50,413,42,53,75,73,39,58,73
"2011","Ipswich 001B","E01030033","Total",654,172,100,72,482,11,154,75,95,9,33,105
"2011","Ipswich 001C","E01030034","Total",630,151,93,58,479,9,165,70,115,11,16,93
"2011","Ipswich 001D","E01030035","Total",647,126,70,56,521,48,82,98,101,36,69,87
"2011","Ipswich 001E","E01030036","Total",776,304,190,114,472,33,125,71,71,19,47,106
"2011","Ipswich 002A","E01029973","Total",631,151,114,37,480,5,155,66,105,21,27,101
"2011","Ipswich 002B","E01029974","Total",613,142,68,74,471,21,72,95,141,18,34,90
"2011","Ipswich 002C","E01029975","Total",518,128,88,40,390,11,92,79,89,14,40,65
"2011","Ipswich 002D","E01029976","Total",639,149,90,59,490,23,104,76,140,26,28,93
"2011","Ipswich 002E","E01029977","Total",633,154,93,61,479,17,119,97,117,18,27,84
"2011","Ipswich 003A","E01030027","Total",906,272,46,226,634,58,50,142,231,20,34,99
"2011","Ipswich 003B","E01030028","Total",668,168,62,106,500,35,84,94,137,19,38,93
"2011","Ipswich 003C","E01030029","Total",658,178,74,104,480,54,97,72,104,23,40,90
"2011","Ipswich 003D","E01030030","Total",898,278,70,208,620,75,69,142,216,22,29,67
"2011","Ipswich 003E","E01030031","Total",647,208,93,115,439,38,81,102,96,19,34,69
"2011","Ipswich 004A","E01029997","Total",630,170,96,74,460,30,87,118,89,33,38,65
"2011","Ipswich 004B","E01029998","Total",758,220,117,103,538,56,109,93,112,44,49,75
"2011","Ipswich 004C","E01029999","Total",624,127,55,72,497,16,91,126,91,36,48,89
"2011","Ipswich 004D","E01030000","Total",637,161,50,111,476,24,68,134,135,21,35,59
"2011","Ipswich 004E","E01030001","Total",647,189,121,68,458,16,119,65,123,20,38,77
"2011","Ipswich 005A","E01030007","Total",662,194,53,141,468,31,58,130,129,27,32,61
"2011","Ipswich 005B","E01030008","Total",520,151,74,77,369,7,94,74,84,14,35,61
"2011","Ipswich 005C","E01030009","Total",591,208,123,85,383,16,81,74,107,15,30,60
"2011","Ipswich 005D","E01030010","Total",955,447,155,292,508,60,66,117,171,18,27,49
"2011","Ipswich 005E","E01030011","Total",675,163,122,41,512,12,139,90,135,20,30,86
"2011","Ipswich 006A","E01030022","Total",930,287,55,232,643,49,43,158,214,29,48,102
"2011","Ipswich 006B","E01030023","Total",835,289,44,245,546,70,32,133,181,20,39,71
"2011","Ipswich 006C","E01030024","Total",1057,582,134,448,475,45,41,123,147,10,24,85
"2011","Ipswich 006D","E01030025","Total",834,361,77,284,473,39,55,83,190,15,29,62
"2011","Ipswich 006E","E01030026","Total",707,190,48,142,517,68,40,130,161,20,30,68
"2011","Ipswich 007A","E01029958","Total",645,237,61,176,408,37,54,97,131,17,22,50
"2011","Ipswich 007C","E01029960","Total",839,319,90,229,520,44,50,128,186,12,31,69
"2011","Ipswich 007D","E01029961","Total",603,153,48,105,450,63,42,113,121,15,37,59
"2011","Ipswich 007E","E01029962","Total",696,241,49,192,455,48,24,104,158,9,36,76
"2011","Ipswich 007F","E01033124","Total",440,279,49,230,161,8,9,15,120,0,0,9
"2011","Ipswich 007G","E01033125","Total",632,379,72,307,253,21,12,41,142,3,6,28
"2011","Ipswich 007H","E01033129","Total",646,362,32,330,284,21,22,62,115,9,17,38
"2011","Ipswich 008A","E01030002","Total",937,416,177,239,521,39,82,115,176,20,26,63
"2011","Ipswich 008B","E01030003","Total",713,203,82,121,510,34,71,134,145,19,29,78
"2011","Ipswich 008C","E01030004","Total",498,104,50,54,394,18,72,83,87,13,39,82
"2011","Ipswich 008D","E01030005","Total",930,249,61,188,681,91,47,185,193,37,39,89
"2011","Ipswich 008E","E01030006","Total",843,324,146,178,519,58,87,118,132,28,34,62
"2011","Ipswich 009A","E01029963","Total",640,136,103,33,504,15,157,81,123,19,28,81
"2011","Ipswich 009B","E01029964","Total",522,123,44,79,399,25,56,90,108,18,21,81
"2011","Ipswich 009C","E01029965","Total",621,161,107,54,460,20,125,88,105,14,30,78
"2011","Ipswich 009D","E01029966","Total",621,211,104,107,410,11,109,75,103,10,35,67
"2011","Ipswich 009E","E01029967","Total",613,189,146,43,424,10,187,56,88,7,18,58
"2011","Ipswich 010A","E01029984","Total",613,163,51,112,450,59,52,93,124,19,43,60
"2011","Ipswich 010B","E01029985","Total",1078,399,44,355,679,53,72,100,289,23,48,94
"2011","Ipswich 010C","E01029986","Total",665,238,89,149,427,60,63,72,98,40,28,66
"2011","Ipswich 010D","E01029987","Total",622,184,87,97,438,17,96,81,99,30,51,64
"2011","Ipswich 010E","E01029988","Total",920,439,111,328,481,63,29,107,177,7,27,71
"2011","Ipswich 011B","E01029990","Total",713,226,45,181,487,72,43,92,165,17,37,61
"2011","Ipswich 011C","E01029991","Total",675,141,73,68,534,9,121,101,147,13,31,112
"2011","Ipswich 011D","E01029992","Total",608,211,92,119,397,23,62,84,136,15,15,62
"2011","Ipswich 011E","E01033123","Total",809,262,61,201,547,54,42,117,222,11,31,70
"2011","Ipswich 011F","E01033126","Total",768,310,17,293,458,29,11,109,276,0,4,29
"2011","Ipswich 012A","E01029968","Total",674,242,54,188,432,51,36,74,157,15,31,68
"2011","Ipswich 012B","E01029969","Total",555,172,57,115,383,30,54,73,110,14,36,66
"2011","Ipswich 012C","E01029970","Total",757,234,90,144,523,27,85,97,169,10,44,91
"2011","Ipswich 012D","E01029971","Total",637,222,90,132,415,50,79,72,104,11,34,65
"2011","Ipswich 012F","E01033122","Total",664,254,42,212,410,89,10,88,154,17,15,37
"2011","Ipswich 012G","E01033130","Total",633,387,62,325,246,32,19,47,107,3,14,24
"2011","Ipswich 013A","E01030012","Total",624,330,141,189,294,19,96,41,74,8,22,34
"2011","Ipswich 013B","E01030013","Total",604,176,113,63,428,22,111,71,108,16,27,73
"2011","Ipswich 013C","E01030014","Total",602,184,139,45,418,26,113,68,74,17,29,91
"2011","Ipswich 013D","E01030015","Total",530,101,56,45,429,12,109,65,112,15,32,84
"2011","Ipswich 013E","E01030016","Total",633,180,70,110,453,28,93,68,139,9,17,99
"2011","Ipswich 014B","E01029994","Total",636,209,98,111,427,46,62,75,77,41,49,77
"2011","Ipswich 014C","E01029995","Total",654,157,69,88,497,17,78,106,168,13,28,87
"2011","Ipswich 014D","E01029996","Total",637,143,72,71,494,35,85,70,111,34,53,106
"2011","Ipswich 014E","E01033127","Total",604,157,13,144,447,64,17,109,153,17,42,45
"2011","Ipswich 014F","E01033128","Total",485,143,38,105,342,25,32,79,123,10,15,58
"2011","Ipswich 014G","E01033131","Total",554,140,40,100,414,51,43,83,108,20,38,71
"2011","Ipswich 015A","E01030017","Total",633,219,87,132,414,35,89,79,118,10,19,64
"2011","Ipswich 015B","E01030018","Total",667,236,53,183,431,72,46,100,115,12,20,66
"2011","Ipswich 015C","E01030019","Total",644,177,94,83,467,30,94,90,128,15,38,72
"2011","Ipswich 015D","E01030020","Total",609,122,65,57,487,18,106,75,141,15,31,101
"2011","Ipswich 015E","E01030021","Total",673,267,70,197,406,70,49,90,120,15,18,44
"2011","Ipswich 016A","E01029978","Total",547,131,58,73,416,28,84,86,98,14,17,89
"2011","Ipswich 016B","E01029979","Total",645,189,110,79,456,70,79,81,80,34,40,72
"2011","Ipswich 016C","E01029980","Total",701,226,77,149,475,95,48,123,105,22,19,63
"2011","Ipswich 016D","E01029981","Total",513,141,59,82,372,17,78,63,120,15,20,59
"2011","Ipswich 016E","E01029982","Total",526,106,55,51,420,51,51,81,89,33,38,77
"2011","Ipswich 016F","E01029983","Total",656,185,77,108,471,16,77,102,137,20,43,76
"2011","Mid Suffolk 001A","E01030052","Total",969,310,172,138,659,36,193,116,164,22,48,80
"2011","Mid Suffolk 001B","E01030058","Total",868,210,115,95,658,34,196,85,175,29,43,96
"2011","Mid Suffolk 001C","E01030064","Total",922,205,105,100,717,15,185,137,203,31,43,103
"2011","Mid Suffolk 001D","E01030088","Total",475,90,42,48,385,9,98,66,113,10,34,55
"2011","Mid Suffolk 002A","E01030039","Total",557,92,52,40,465,17,113,76,110,19,39,91
"2011","Mid Suffolk 002B","E01030054","Total",508,90,33,57,418,10,132,61,115,22,27,51
"2011","Mid Suffolk 002C","E01030055","Total",577,143,52,91,434,14,83,86,146,18,23,64
"2011","Mid Suffolk 002D","E01030066","Total",680,184,119,65,496,15,144,82,131,14,39,71
"2011","Mid Suffolk 002E","E01030067","Total",566,159,80,79,407,23,105,75,125,11,18,50
"2011","Mid Suffolk 002F","E01030068","Total",717,193,96,97,524,26,121,89,139,18,38,93
"2011","Mid Suffolk 003A","E01030053","Total",985,230,129,101,755,32,230,125,203,24,47,94
"2011","Mid Suffolk 003B","E01030082","Total",1136,313,191,122,823,36,265,119,213,29,58,103
"2011","Mid Suffolk 003C","E01030090","Total",969,185,97,88,784,28,197,129,224,39,49,118
"2011","Mid Suffolk 004A","E01030040","Total",489,110,49,61,379,14,90,60,106,12,27,70
"2011","Mid Suffolk 004B","E01030049","Total",673,138,74,64,535,15,147,104,117,23,38,91
"2011","Mid Suffolk 004C","E01030050","Total",836,201,80,121,635,25,105,162,193,21,49,80
"2011","Mid Suffolk 004D","E01030084","Total",646,119,80,39,527,13,144,83,143,17,39,88
"2011","Mid Suffolk 004E","E01030085","Total",681,177,90,87,504,21,98,123,144,21,28,69
"2011","Mid Suffolk 005A","E01030037","Total",512,121,62,59,391,22,90,81,113,10,17,58
"2011","Mid Suffolk 005B","E01030038","Total",499,110,68,42,389,12,110,69,91,7,36,64
"2011","Mid Suffolk 005C","E01030059","Total",961,254,123,131,707,24,161,123,211,25,49,114
"2011","Mid Suffolk 005D","E01030081","Total",1008,272,152,120,736,32,223,101,201,27,39,113
"2011","Mid Suffolk 006A","E01030051","Total",726,189,116,73,537,29,141,87,142,25,34,79
"2011","Mid Suffolk 006B","E01030056","Total",949,277,163,114,672,22,196,103,166,27,46,112
"2011","Mid Suffolk 006C","E01030065","Total",866,192,106,86,674,21,174,105,210,39,38,87
"2011","Mid Suffolk 006D","E01030086","Total",472,84,43,41,388,24,94,80,104,14,20,52
"2011","Mid Suffolk 006E","E01030089","Total",835,196,130,66,639,22,183,95,165,20,44,110
"2011","Mid Suffolk 007A","E01030048","Total",1029,305,183,122,724,51,175,142,178,33,44,101
"2011","Mid Suffolk 007B","E01030057","Total",910,178,92,86,732,28,138,134,225,32,59,116
"2011","Mid Suffolk 007C","E01030083","Total",918,173,89,84,745,17,170,122,213,34,56,133
"2011","Mid Suffolk 007D","E01030087","Total",514,112,61,51,402,7,88,68,105,34,37,63
"2011","Mid Suffolk 008A","E01030073","Total",747,280,210,70,467,54,149,59,107,13,25,60
"2011","Mid Suffolk 008B","E01030077","Total",680,275,158,117,405,44,100,72,94,12,35,48
"2011","Mid Suffolk 008C","E01030079","Total",642,194,89,105,448,54,64,86,106,33,40,65
"2011","Mid Suffolk 008D","E01030080","Total",667,159,99,60,508,33,130,92,107,19,38,89
"2011","Mid Suffolk 009A","E01030063","Total",903,189,98,91,714,31,168,144,203,26,47,95
"2011","Mid Suffolk 009B","E01030069","Total",543,111,50,61,432,9,103,63,136,12,33,76
"2011","Mid Suffolk 009C","E01030072","Total",747,253,121,132,494,33,125,90,153,13,17,63
"2011","Mid Suffolk 009D","E01030075","Total",618,112,35,77,506,35,48,136,135,21,46,85
"2011","Mid Suffolk 010A","E01030060","Total",738,257,122,135,481,21,86,120,134,20,29,71
"2011","Mid Suffolk 010B","E01030071","Total",684,222,86,136,462,23,108,77,169,11,20,54
"2011","Mid Suffolk 010D","E01030076","Total",640,187,63,124,453,40,69,81,138,20,21,84
"2011","Mid Suffolk 010E","E01030078","Total",724,182,56,126,542,29,85,117,174,20,30,87
"2011","Mid Suffolk 010F","E01033316","Total",624,142,16,126,482,33,26,157,176,20,32,38
"2011","Mid Suffolk 010G","E01033317","Total",651,173,41,132,478,44,43,132,161,19,25,54
"2011","Mid Suffolk 010H","E01033319","Total",726,123,23,100,603,31,64,195,199,24,34,56
"2011","Mid Suffolk 011A","E01030041","Total",921,210,97,113,711,17,199,113,219,14,40,109
"2011","Mid Suffolk 011B","E01030043","Total",536,137,42,95,399,19,75,100,132,10,13,50
"2011","Mid Suffolk 011C","E01030061","Total",761,318,205,113,443,21,125,83,116,17,20,61
"2011","Mid Suffolk 011D","E01030062","Total",624,215,106,109,409,15,108,57,114,15,23,77
"2011","Mid Suffolk 011E","E01030070","Total",539,60,31,29,479,16,53,157,161,25,25,42
"2011","Mid Suffolk 012A","E01030042","Total",667,150,70,80,517,20,159,71,135,15,32,85
"2011","Mid Suffolk 012B","E01030044","Total",563,210,129,81,353,13,111,44,104,13,12,56
"2011","Mid Suffolk 012C","E01030045","Total",706,156,86,70,550,26,135,102,146,26,43,72
"2011","Mid Suffolk 012D","E01030046","Total",647,126,67,59,521,20,134,95,150,12,42,68
"2011","Mid Suffolk 012E","E01030047","Total",555,166,75,91,389,26,71,69,122,8,32,61
"2011","St Edmundsbury 001A","E01030095","Total",485,106,51,55,379,19,91,53,113,20,24,59
"2011","St Edmundsbury 001B","E01030096","Total",608,137,75,62,471,10,122,72,141,15,38,73
"2011","St Edmundsbury 001C","E01030097","Total",504,132,79,53,372,15,103,44,95,22,32,61
"2011","St Edmundsbury 001D","E01030145","Total",598,156,81,75,442,26,109,82,111,14,27,73
"2011","St Edmundsbury 001E","E01030146","Total",500,139,113,26,361,11,151,68,75,4,13,39
"2011","St Edmundsbury 002A","E01030094","Total",594,150,88,62,444,26,95,74,129,16,31,73
"2011","St Edmundsbury 002B","E01030121","Total",889,178,113,65,711,34,160,145,169,34,59,110
"2011","St Edmundsbury 002C","E01030132","Total",438,45,20,25,393,16,42,154,108,24,18,31
"2011","St Edmundsbury 002D","E01030133","Total",606,136,68,68,470,13,108,105,126,19,23,76
"2011","St Edmundsbury 003A","E01030130","Total",543,135,79,56,408,40,97,65,97,16,17,76
"2011","St Edmundsbury 003B","E01030131","Total",507,133,75,58,374,64,66,51,63,28,32,70
"2011","St Edmundsbury 003C","E01030139","Total",765,261,136,125,504,69,89,93,116,22,34,81
"2011","St Edmundsbury 003D","E01030140","Total",503,98,44,54,405,37,80,66,95,14,33,80
"2011","St Edmundsbury 003E","E01030141","Total",638,168,66,102,470,47,81,90,103,22,49,78
"2011","St Edmundsbury 004A","E01030103","Total",861,205,129,76,656,14,210,99,184,16,25,108
"2011","St Edmundsbury 004B","E01030104","Total",894,179,123,56,715,12,245,117,155,21,45,120
"2011","St Edmundsbury 004C","E01030138","Total",975,225,120,105,750,41,199,116,180,35,43,136
"2011","St Edmundsbury 005B","E01030127","Total",514,126,30,96,388,9,44,101,140,11,27,56
"2011","St Edmundsbury 005C","E01030128","Total",610,145,28,117,465,27,38,113,175,14,28,70
"2011","St Edmundsbury 005D","E01030129","Total",581,128,62,66,453,18,77,82,136,17,25,98
"2011","St Edmundsbury 005E","E01033044","Total",520,86,4,82,434,46,10,138,133,33,30,44
"2011","St Edmundsbury 005F","E01033045","Total",402,80,12,68,322,27,26,107,87,17,21,37
"2011","St Edmundsbury 005G","E01033050","Total",521,123,26,97,398,21,46,125,126,14,20,46
"2011","St Edmundsbury 006A","E01030091","Total",950,429,152,277,521,26,135,54,207,7,12,80
"2011","St Edmundsbury 006B","E01030093","Total",776,312,128,184,464,30,106,62,180,12,22,52
"2011","St Edmundsbury 006D","E01030137","Total",737,231,73,158,506,35,77,87,198,13,25,71
"2011","St Edmundsbury 006E","E01033043","Total",616,265,116,149,351,29,56,64,124,14,14,50
"2011","St Edmundsbury 006F","E01033046","Total",605,305,109,196,300,25,27,43,135,9,12,49
"2011","St Edmundsbury 006G","E01033047","Total",500,157,63,94,343,19,52,70,114,15,21,52
"2011","St Edmundsbury 007A","E01030092","Total",813,290,126,164,523,41,105,93,182,13,22,67
"2011","St Edmundsbury 007B","E01030123","Total",646,170,80,90,476,45,95,92,92,22,36,94
"2011","St Edmundsbury 007C","E01030124","Total",731,238,142,96,493,14,171,74,141,12,18,63
"2011","St Edmundsbury 007D","E01030125","Total",635,169,108,61,466,27,111,66,111,17,39,95
"2011","St Edmundsbury 007E","E01030148","Total",515,112,62,50,403,19,114,78,98,7,19,68
"2011","St Edmundsbury 007F","E01030149","Total",625,147,90,57,478,16,133,94,129,16,23,67
"2011","St Edmundsbury 008A","E01030098","Total",966,219,127,92,747,33,233,146,166,31,39,99
"2011","St Edmundsbury 008B","E01030100","Total",868,174,91,83,694,26,203,101,194,23,44,103
"2011","St Edmundsbury 008C","E01030119","Total",934,209,129,80,725,27,187,143,192,24,32,120
"2011","St Edmundsbury 008D","E01030134","Total",470,120,61,59,350,16,89,67,92,17,20,49
"2011","St Edmundsbury 008E","E01030135","Total",538,109,62,47,429,6,127,78,117,16,29,56
"2011","St Edmundsbury 009B","E01030142","Total",736,177,111,66,559,12,194,84,129,10,26,104
"2011","St Edmundsbury 009C","E01030143","Total",661,192,84,108,469,31,75,116,107,16,28,96
"2011","St Edmundsbury 009D","E01030144","Total",535,141,88,53,394,15,120,73,93,10,29,54
"2011","St Edmundsbury 009E","E01030147","Total",681,213,131,82,468,7,205,62,104,16,14,60
"2011","St Edmundsbury 009F","E01033048","Total",650,298,138,160,352,35,63,59,137,7,13,38
"2011","St Edmundsbury 009G","E01033049","Total",653,355,179,176,298,11,79,45,108,3,11,41
"2011","St Edmundsbury 010A","E01030099","Total",863,223,135,88,640,18,204,82,173,28,39,96
"2011","St Edmundsbury 010B","E01030101","Total",950,324,196,128,626,25,209,105,150,21,34,82
"2011","St Edmundsbury 010C","E01030150","Total",909,170,94,76,739,19,202,106,232,33,42,105
"2011","St Edmundsbury 011A","E01030120","Total",923,243,135,108,680,21,169,119,204,27,33,107
"2011","St Edmundsbury 011B","E01030122","Total",798,163,85,78,635,18,182,132,149,25,34,95
"2011","St Edmundsbury 011C","E01030151","Total",822,182,96,86,640,23,169,107,185,19,45,92
"2011","St Edmundsbury 012A","E01030109","Total",753,196,103,93,557,65,114,120,110,36,39,73
"2011","St Edmundsbury 012B","E01030110","Total",1152,303,124,179,849,66,133,215,222,42,56,115
"2011","St Edmundsbury 012C","E01030111","Total",530,97,62,35,433,11,83,77,119,20,38,85
"2011","St Edmundsbury 012D","E01030112","Total",741,201,58,143,540,24,106,90,175,11,30,104
"2011","St Edmundsbury 013A","E01030115","Total",877,173,65,108,704,70,86,171,178,44,65,90
"2011","St Edmundsbury 013B","E01030116","Total",828,148,52,96,680,44,94,187,172,33,62,88
"2011","St Edmundsbury 013C","E01030117","Total",652,133,41,92,519,32,57,143,165,17,29,76
"2011","St Edmundsbury 013D","E01030118","Total",654,161,60,101,493,43,62,115,123,25,46,79
"2011","St Edmundsbury 014A","E01030105","Total",713,173,54,119,540,33,73,112,143,18,47,114
"2011","St Edmundsbury 014B","E01030106","Total",1018,281,106,175,737,71,84,159,222,32,64,105
"2011","St Edmundsbury 014C","E01030107","Total",638,121,62,59,517,12,111,83,147,21,38,105
"2011","St Edmundsbury 014D","E01030108","Total",710,145,71,74,565,37,81,101,140,26,49,131
"2011","St Edmundsbury 014E","E01030113","Total",828,252,131,121,576,33,119,112,164,23,38,87
"2011","St Edmundsbury 014F","E01030114","Total",546,97,39,58,449,34,53,110,74,30,62,86
"2011","Suffolk Coastal 001A","E01030201","Total",913,223,113,110,690,27,188,83,206,22,50,114
"2011","Suffolk Coastal 001B","E01030219","Total",903,278,174,104,625,24,225,70,171,22,29,84
"2011","Suffolk Coastal 001C","E01030222","Total",905,287,157,130,618,19,237,71,186,11,28,66
"2011","Suffolk Coastal 002A","E01030154","Total",877,183,94,89,694,27,184,97,205,36,48,97
"2011","Suffolk Coastal 002B","E01030172","Total",713,210,119,91,503,22,135,94,119,33,32,68
"2011","Suffolk Coastal 002C","E01030173","Total",686,263,172,91,423,15,130,72,99,18,23,66
"2011","Suffolk Coastal 002D","E01030174","Total",545,125,53,72,420,20,98,71,108,18,32,73
"2011","Suffolk Coastal 002E","E01030176","Total",852,213,111,102,639,22,175,91,195,28,34,94
"2011","Suffolk Coastal 003A","E01030186","Total",598,141,80,61,457,16,152,56,113,15,32,73
"2011","Suffolk Coastal 003B","E01030208","Total",586,179,108,71,407,25,150,44,101,10,28,49
"2011","Suffolk Coastal 003C","E01030209","Total",763,308,154,154,455,34,159,75,106,11,15,55
"2011","Suffolk Coastal 003D","E01030210","Total",860,221,108,113,639,44,147,138,138,41,49,82
"2011","Suffolk Coastal 003E","E01030212","Total",863,233,128,105,630,20,210,80,178,18,40,84
"2011","Suffolk Coastal 004A","E01030152","Total",1043,426,300,126,617,10,322,59,139,17,17,53
"2011","Suffolk Coastal 004B","E01030153","Total",665,314,195,119,351,14,120,34,117,12,14,40
"2011","Suffolk Coastal 004C","E01030187","Total",656,169,98,71,487,37,130,74,105,18,43,80
"2011","Suffolk Coastal 004D","E01030188","Total",783,319,121,198,464,39,83,89,147,18,24,64
"2011","Suffolk Coastal 004E","E01030189","Total",712,212,96,116,500,49,113,79,132,20,31,76
"2011","Suffolk Coastal 005A","E01030193","Total",677,159,82,77,518,19,138,81,129,26,38,87
"2011","Suffolk Coastal 005B","E01030194","Total",812,365,185,180,447,25,114,82,123,19,28,56
"2011","Suffolk Coastal 005C","E01030195","Total",670,149,69,80,521,10,139,89,143,15,40,85
"2011","Suffolk Coastal 005D","E01030220","Total",959,310,199,111,649,26,209,90,159,23,51,91
"2011","Suffolk Coastal 006A","E01030175","Total",967,240,150,90,727,27,206,126,180,34,49,105
"2011","Suffolk Coastal 006B","E01030200","Total",894,163,94,69,731,17,194,126,167,29,57,141
"2011","Suffolk Coastal 006C","E01030221","Total",833,191,96,95,642,12,177,92,194,22,36,109
"2011","Suffolk Coastal 007C","E01030199","Total",836,260,146,114,576,15,173,82,163,24,38,81
"2011","Suffolk Coastal 007F","E01033443","Total",527,87,26,61,440,20,78,121,128,29,24,40
"2011","Suffolk Coastal 007G","E01033445","Total",649,131,35,96,518,44,76,127,148,23,37,63
"2011","Suffolk Coastal 007H","E01033446","Total",871,214,109,105,657,14,183,97,191,15,41,116
"2011","Suffolk Coastal 007I","E01033448","Total",544,157,77,80,387,19,117,56,93,24,27,51
"2011","Suffolk Coastal 007J","E01033449","Total",662,145,48,97,517,40,73,122,163,18,37,64
"2011","Suffolk Coastal 008A","E01030155","Total",855,227,98,129,628,50,149,111,157,24,45,92
"2011","Suffolk Coastal 008B","E01030185","Total",886,238,148,90,648,67,181,114,121,23,41,101
"2011","Suffolk Coastal 008C","E01030203","Total",948,383,285,98,565,12,232,75,128,26,43,49
"2011","Suffolk Coastal 008D","E01030211","Total",1103,560,312,248,543,51,187,78,160,9,19,39
"2011","Suffolk Coastal 009A","E01030179","Total",1015,245,83,162,770,51,85,254,197,48,65,70
"2011","Suffolk Coastal 009B","E01030180","Total",553,127,61,66,426,21,82,97,102,21,35,68
"2011","Suffolk Coastal 009C","E01030183","Total",883,227,150,77,656,20,263,86,132,15,25,115
"2011","Suffolk Coastal 009D","E01030184","Total",818,258,187,71,560,32,196,73,109,18,36,96
"2011","Suffolk Coastal 009E","E01030207","Total",673,181,111,70,492,16,184,72,119,8,22,71
"2011","Suffolk Coastal 010A","E01030181","Total",724,151,32,119,573,27,56,175,160,23,57,75
"2011","Suffolk Coastal 010C","E01030190","Total",806,207,128,79,599,19,241,77,140,16,31,75
"2011","Suffolk Coastal 010D","E01030191","Total",783,316,129,187,467,32,103,96,129,9,30,68
"2011","Suffolk Coastal 010E","E01030192","Total",609,134,55,79,475,11,106,78,137,15,32,96
"2011","Suffolk Coastal 010F","E01030198","Total",570,143,78,65,427,10,129,58,122,14,18,76
"2011","Suffolk Coastal 010G","E01033442","Total",546,69,11,58,477,40,11,184,123,37,37,45
"2011","Suffolk Coastal 010H","E01033444","Total",512,81,12,69,431,37,9,162,110,32,40,41
"2011","Suffolk Coastal 010I","E01033447","Total",585,146,85,61,439,18,108,123,88,16,28,58
"2011","Suffolk Coastal 011A","E01030196","Total",677,160,43,117,517,14,81,122,153,22,43,82
"2011","Suffolk Coastal 011B","E01030197","Total",691,162,91,71,529,5,201,62,142,16,28,75
"2011","Suffolk Coastal 011C","E01030204","Total",728,134,71,63,594,19,163,125,132,25,38,92
"2011","Suffolk Coastal 011D","E01030205","Total",463,64,25,39,399,9,53,116,98,25,32,66
"2011","Suffolk Coastal 011E","E01030206","Total",634,142,112,30,492,6,170,74,100,16,37,89
"2011","Suffolk Coastal 012A","E01030171","Total",784,179,71,108,605,28,120,118,170,22,43,104
"2011","Suffolk Coastal 012B","E01030214","Total",531,129,45,84,402,26,53,85,102,11,37,88
"2011","Suffolk Coastal 012C","E01030215","Total",633,233,76,157,400,25,92,72,137,10,21,43
"2011","Suffolk Coastal 012D","E01030216","Total",627,154,94,60,473,12,127,80,134,12,30,78
"2011","Suffolk Coastal 012E","E01030217","Total",564,131,74,57,433,19,100,70,137,11,24,72
"2011","Suffolk Coastal 012F","E01030218","Total",625,160,66,94,465,29,89,85,147,13,36,66
"2011","Suffolk Coastal 013C","E01030158","Total",679,162,116,46,517,7,253,39,127,3,23,65
"2011","Suffolk Coastal 013D","E01030159","Total",648,168,95,73,480,36,140,82,110,13,39,60
"2011","Suffolk Coastal 013E","E01030164","Total",650,188,131,57,462,17,145,50,124,15,35,76
"2011","Suffolk Coastal 013F","E01030166","Total",674,193,139,54,481,9,195,59,107,18,24,69
"2011","Suffolk Coastal 013G","E01033450","Total",1119,335,235,100,784,13,317,103,187,19,39,106
"2011","Suffolk Coastal 014A","E01030160","Total",699,304,167,137,395,26,105,75,95,15,28,51
"2011","Suffolk Coastal 014B","E01030161","Total",611,188,83,105,423,66,73,93,100,11,24,56
"2011","Suffolk Coastal 014C","E01030168","Total",662,270,133,137,392,42,67,64,96,20,33,70
"2011","Suffolk Coastal 014D","E01030169","Total",746,294,65,229,452,73,43,106,146,12,16,56
"2011","Suffolk Coastal 014E","E01030170","Total",759,255,161,94,504,45,134,69,111,26,41,78
"2011","Suffolk Coastal 015A","E01030162","Total",634,286,125,161,348,24,77,55,116,12,22,42
"2011","Suffolk Coastal 015B","E01030163","Total",656,214,94,120,442,56,71,77,122,13,24,79
"2011","Suffolk Coastal 015C","E01030165","Total",762,354,149,205,408,28,81,76,113,8,36,66
"2011","Suffolk Coastal 015D","E01030167","Total",609,218,138,80,391,18,116,72,89,14,25,57
"2011","Waveney 001A","E01030240","Total",745,245,134,111,500,4,204,62,119,7,35,69
"2011","Waveney 001B","E01030241","Total",659,180,113,67,479,13,181,61,114,10,23,77
"2011","Waveney 001C","E01030242","Total",594,119,82,37,475,9,175,56,112,8,35,80
"2011","Waveney 001D","E01030259","Total",470,124,66,58,346,8,83,64,93,10,28,60
"2011","Waveney 001E","E01030260","Total",427,102,46,56,325,12,67,53,118,10,25,40
"2011","Waveney 002A","E01030261","Total",606,213,75,138,393,46,70,64,91,25,34,63
"2011","Waveney 002B","E01030262","Total",566,196,108,88,370,28,94,64,98,17,22,47
"2011","Waveney 002C","E01030277","Total",480,144,92,52,336,33,68,44,61,17,44,69
"2011","Waveney 002D","E01030279","Total",591,199,77,122,392,53,78,61,80,24,34,62
"2011","Waveney 002E","E01030281","Total",948,204,84,120,744,56,151,162,181,31,53,110
"2011","Waveney 003A","E01030266","Total",711,217,141,76,494,31,117,105,134,16,32,59
"2011","Waveney 003B","E01030267","Total",570,166,95,71,404,28,85,76,95,15,30,75
"2011","Waveney 003C","E01030271","Total",687,180,128,52,507,12,228,54,115,11,22,65
"2011","Waveney 003D","E01030278","Total",714,186,132,54,528,21,231,57,100,13,34,72
"2011","Waveney 003E","E01030280","Total",624,158,105,53,466,12,165,76,106,9,29,69
"2011","Waveney 004A","E01030246","Total",609,199,59,140,410,53,53,89,106,22,32,55
"2011","Waveney 004B","E01030248","Total",618,194,78,116,424,45,50,71,119,27,36,76
"2011","Waveney 004C","E01030249","Total",747,291,98,193,456,61,45,104,121,16,40,69
"2011","Waveney 004D","E01030250","Total",881,415,103,312,466,86,47,83,128,23,42,57
"2011","Waveney 004E","E01030264","Total",612,196,70,126,416,45,66,100,115,25,19,46
"2011","Waveney 004F","E01030265","Total",612,184,56,128,428,53,64,74,119,21,28,69
"2011","Waveney 005A","E01030255","Total",503,89,37,52,414,27,64,76,106,28,39,74
"2011","Waveney 005B","E01030263","Total",666,223,132,91,443,17,167,43,116,12,22,66
"2011","Waveney 005C","E01030270","Total",683,223,129,94,460,51,111,75,109,16,29,69
"2011","Waveney 005D","E01030289","Total",674,259,120,139,415,28,95,71,108,24,24,65
"2011","Waveney 005E","E01030290","Total",677,204,130,74,473,19,170,71,96,18,26,73
"2011","Waveney 006A","E01030233","Total",641,128,85,43,513,11,153,77,151,15,31,75
"2011","Waveney 006B","E01030235","Total",631,156,106,50,475,8,163,70,130,17,33,54
"2011","Waveney 006C","E01030268","Total",529,101,62,39,428,13,99,73,112,21,43,67
"2011","Waveney 006D","E01030269","Total",752,250,150,100,502,15,165,74,146,7,24,71
"2011","Waveney 006E","E01030288","Total",619,140,104,36,479,11,203,54,94,7,35,75
"2011","Waveney 007A","E01030247","Total",859,512,180,332,347,41,63,55,129,14,15,30
"2011","Waveney 007B","E01030254","Total",615,158,53,105,457,59,59,102,121,18,24,74
"2011","Waveney 007C","E01030256","Total",623,265,101,164,358,27,70,56,96,14,33,62
"2011","Waveney 007D","E01030258","Total",809,461,147,314,348,34,48,52,120,15,27,52
"2011","Waveney 007E","E01030276","Total",590,218,89,129,372,46,88,53,101,10,17,57
"2011","Waveney 008A","E01030257","Total",637,189,117,72,448,28,107,81,103,15,31,83
"2011","Waveney 008B","E01030274","Total",619,298,192,106,321,24,116,42,65,9,20,45
"2011","Waveney 008C","E01030275","Total",487,120,66,54,367,9,99,45,117,13,34,50
"2011","Waveney 008D","E01030287","Total",657,210,139,71,447,28,176,44,83,15,37,64
"2011","Waveney 008E","E01030291","Total",589,148,85,63,441,59,90,57,111,22,43,59
"2011","Waveney 009A","E01030234","Total",662,176,49,127,486,87,41,122,141,18,29,48
"2011","Waveney 009B","E01030236","Total",793,232,129,103,561,41,156,94,150,19,25,76
"2011","Waveney 009C","E01030237","Total",1118,220,93,127,898,47,190,216,224,37,62,122
"2011","Waveney 009D","E01030238","Total",717,138,73,65,579,34,95,124,146,21,57,102
"2011","Waveney 010A","E01030223","Total",816,297,159,138,519,32,160,85,124,22,29,67
"2011","Waveney 010B","E01030224","Total",770,268,182,86,502,25,178,73,129,8,30,59
"2011","Waveney 010C","E01030225","Total",846,364,157,207,482,52,123,67,156,11,20,53
"2011","Waveney 010D","E01030227","Total",620,195,116,79,425,39,103,73,95,26,29,60
"2011","Waveney 010E","E01030228","Total",776,187,131,56,589,20,209,86,150,19,30,75
"2011","Waveney 011A","E01030226","Total",774,192,101,91,582,62,109,119,128,21,41,102
"2011","Waveney 011B","E01030286","Total",896,193,88,105,703,25,187,92,194,24,55,126
"2011","Waveney 011C","E01030292","Total",645,155,100,55,490,18,167,89,112,7,30,67
"2011","Waveney 011D","E01030293","Total",693,132,83,49,561,13,166,110,140,15,40,77
"2011","Waveney 011E","E01030294","Total",641,173,109,64,468,30,117,101,119,13,28,60
"2011","Waveney 012A","E01030239","Total",727,126,37,89,601,42,58,144,165,41,59,92
"2011","Waveney 012B","E01030251","Total",700,190,84,106,510,39,157,70,126,18,26,74
"2011","Waveney 012C","E01030252","Total",815,237,137,100,578,25,226,61,149,19,19,79
"2011","Waveney 012D","E01030253","Total",787,234,131,103,553,39,131,95,154,12,40,82
"2011","Waveney 012E","E01030272","Total",752,264,173,91,488,27,189,65,128,7,15,57
"2011","Waveney 012F","E01030273","Total",739,212,151,61,527,14,248,55,113,5,22,70
"2011","Waveney 013A","E01030230","Total",926,429,214,215,497,32,124,76,168,15,31,51
"2011","Waveney 013B","E01030231","Total",657,181,99,82,476,40,106,92,115,21,32,70
"2011","Waveney 013C","E01030232","Total",682,162,103,59,520,37,132,90,124,25,40,72
"2011","Waveney 013D","E01030285","Total",925,220,123,97,705,18,187,98,195,30,58,119
"2011","Waveney 014A","E01030282","Total",661,332,231,101,329,9,166,27,92,2,7,26
"2011","Waveney 014B","E01030283","Total",577,195,129,66,382,27,103,69,87,11,28,57
"2011","Waveney 014C","E01030284","Total",609,195,143,52,414,9,198,53,96,6,18,34
"2011","Waveney 014D","E01030295","Total",981,260,121,139,721,43,187,103,218,15,43,112
"2011","Waveney 015A","E01030229","Total",949,245,149,96,704,37,233,85,173,18,42,116
"2011","Waveney 015B","E01030243","Total",656,192,114,78,464,33,141,70,111,17,26,66
"2011","Waveney 015C","E01030244","Total",879,410,225,185,469,13,170,47,152,6,31,50
"2011","Waveney 015D","E01030245","Total",763,275,200,75,488,14,184,61,112,19,26,72
"2011","Camden 001A","E01000907","Total",627,207,57,150,420,68,44,69,123,12,24,80
"2011","Camden 001B","E01000908","Total",827,420,103,317,407,61,55,76,114,14,19,68
"2011","Camden 001C","E01000909","Total",661,199,82,117,462,13,78,68,113,15,39,136
"2011","Camden 001D","E01000912","Total",700,270,111,159,430,40,42,71,106,8,43,120
"2011","Camden 001E","E01000913","Total",722,210,85,125,512,8,118,101,146,21,30,88
"2011","Camden 002A","E01000893","Total",715,281,82,199,434,20,69,96,120,15,34,80
"2011","Camden 002B","E01000894","Total",619,209,74,135,410,8,70,94,138,19,20,61
"2011","Camden 002C","E01000895","Total",841,403,172,231,438,19,53,103,168,10,19,66
"2011","Camden 002D","E01000896","Total",756,258,89,169,498,7,95,112,153,25,27,79
"2011","Camden 002E","E01000899","Total",698,229,65,164,469,14,103,110,116,27,36,63
"2011","Camden 003A","E01000910","Total",588,173,53,120,415,7,62,67,108,21,39,111
"2011","Camden 003B","E01000911","Total",663,220,75,145,443,40,57,81,132,14,38,81
"2011","Camden 003C","E01000921","Total",946,381,50,331,565,41,24,89,253,8,42,108
"2011","Camden 003D","E01000923","Total",656,266,53,213,390,28,30,72,122,15,25,98
"2011","Camden 003E","E01000928","Total",682,234,59,175,448,46,52,81,120,10,36,103
"2011","Camden 004A","E01000878","Total",550,188,72,116,362,8,75,76,101,10,24,68
"2011","Camden 004B","E01000879","Total",602,237,64,173,365,12,62,84,109,19,12,67
"2011","Camden 004C","E01000880","Total",621,191,57,134,430,16,38,111,126,39,37,63
"2011","Camden 004D","E01000884","Total",577,181,61,120,396,12,51,97,94,30,39,73
"2011","Camden 004E","E01000885","Total",592,172,78,94,420,15,112,93,91,25,20,64
"2011","Camden 005A","E01000871","Total",632,183,51,132,449,17,48,67,116,19,65,117
"2011","Camden 005B","E01000872","Total",913,382,51,331,531,31,27,75,232,8,35,123
"2011","Camden 005C","E01000873","Total",710,235,61,174,475,27,38,91,147,10,26,136
"2011","Camden 005D","E01000874","Total",704,227,61,166,477,11,67,103,171,10,17,98
"2011","Camden 005E","E01000877","Total",726,274,45,229,452,13,43,91,176,11,15,103
"2011","Camden 006A","E01000886","Total",606,187,41,146,419,37,48,81,112,19,25,97
"2011","Camden 006B","E01000887","Total",690,262,60,202,428,25,35,78,174,14,21,81
"2011","Camden 006C","E01000888","Total",697,252,56,196,445,32,45,89,143,19,37,80
"2011","Camden 006D","E01000892","Total",823,308,95,213,515,38,65,97,163,20,34,98
"2011","Camden 006E","E01000903","Total",686,301,117,184,385,14,34,77,151,6,24,79
"2011","Camden 007A","E01000889","Total",657,224,69,155,433,61,43,70,79,20,56,104
"2011","Camden 007B","E01000890","Total",767,357,118,239,410,59,69,49,82,25,49,77
"2011","Camden 007C","E01000891","Total",672,279,77,202,393,76,30,50,100,20,41,76
"2011","Camden 007D","E01000901","Total",703,228,51,177,475,91,27,80,83,35,63,96
"2011","Camden 007E","E01000922","Total",653,266,57,209,387,30,27,45,127,11,36,111
"2011","Camden 007F","E01000927","Total",734,205,63,142,529,29,52,85,177,12,19,155
"2011","Camden 008A","E01000881","Total",632,247,57,190,385,10,39,69,145,34,23,65
"2011","Camden 008B","E01000882","Total",728,281,67,214,447,12,59,91,192,20,16,57
"2011","Camden 008C","E01000883","Total",638,258,69,189,380,12,43,72,160,10,17,66
"2011","Camden 008D","E01000897","Total",721,243,82,161,478,4,88,125,170,23,21,47
"2011","Camden 008E","E01000898","Total",850,418,88,330,432,25,44,76,163,18,22,84
"2011","Camden 009A","E01000866","Total",926,364,97,267,562,40,67,83,185,21,33,133
"2011","Camden 009B","E01000870","Total",774,316,86,230,458,36,32,74,163,12,35,106
"2011","Camden 009C","E01000924","Total",795,307,55,252,488,24,45,64,231,6,33,85
"2011","Camden 009D","E01000925","Total",629,246,107,139,383,60,30,55,77,24,47,90
"2011","Camden 009E","E01000926","Total",698,204,49,155,494,42,27,52,134,15,29,195
"2011","Camden 010A","E01000969","Total",954,341,79,262,613,26,38,98,266,11,20,154
"2011","Camden 010B","E01000970","Total",831,406,39,367,425,12,30,39,250,2,6,86
"2011","Camden 010C","E01000971","Total",649,222,50,172,427,10,36,104,155,12,13,97
"2011","Camden 010D","E01000972","Total",949,414,88,326,535,60,45,81,176,16,48,109
"2011","Camden 010E","E01000973","Total",894,341,53,288,553,38,24,61,259,15,21,135
"2011","Camden 011A","E01000842","Total",724,340,106,234,384,12,46,77,175,9,16,49
"2011","Camden 011B","E01000844","Total",870,362,81,281,508,14,39,126,220,13,28,68
"2011","Camden 011C","E01000848","Total",805,348,90,258,457,6,66,90,212,15,27,41
"2011","Camden 011D","E01000849","Total",862,466,118,348,396,20,33,71,168,8,23,73
"2011","Camden 012A","E01000900","Total",757,256,72,184,501,43,50,74,156,15,50,113
"2011","Camden 012B","E01000902","Total",590,216,83,133,374,56,27,68,92,19,38,74
"2011","Camden 012C","E01000904","Total",918,309,80,229,609,68,62,75,198,26,38,142
"2011","Camden 012D","E01000905","Total",812,300,125,175,512,95,51,65,113,34,46,108
"2011","Camden 012E","E01000906","Total",788,319,95,224,469,12,67,56,229,12,13,80
"2011","Camden 013A","E01000875","Total",839,369,75,294,470,41,32,57,220,8,18,94
"2011","Camden 013B","E01000876","Total",800,342,78,264,458,46,39,57,152,21,42,101
"2011","Camden 013C","E01000931","Total",873,357,83,274,516,59,44,75,170,17,42,109
"2011","Camden 013D","E01000932","Total",947,402,85,317,545,43,28,54,276,6,15,123
"2011","Camden 013E","E01000974","Total",821,358,72,286,463,36,30,52,184,10,30,121
"2011","Camden 014A","E01000843","Total",846,354,90,264,492,65,49,114,188,10,20,46
"2011","Camden 014B","E01000845","Total",731,340,75,265,391,17,39,68,164,13,21,69
"2011","Camden 014C","E01000846","Total",616,220,86,134,396,61,60,70,64,23,43,75
"2011","Camden 014D","E01000847","Total",677,233,72,161,444,48,55,93,97,32,46,73
"2011","Camden 015A","E01000864","Total",717,265,42,223,452,36,38,59,188,6,27,98
"2011","Camden 015B","E01000865","Total",451,182,31,151,269,11,33,33,94,12,27,59
"2011","Camden 015C","E01000867","Total",675,239,74,165,436,43,32,41,164,19,29,108
"2011","Camden 015D","E01000868","Total",584,219,39,180,365,55,19,75,92,23,48,53
"2011","Camden 015E","E01000869","Total",967,364,104,260,603,41,32,86,257,16,25,146
"2011","Camden 016A","E01000962","Total",745,236,37,199,509,17,29,114,252,2,13,82
"2011","Camden 016B","E01000964","Total",713,260,70,190,453,30,47,90,153,10,26,97
"2011","Camden 016C","E01000965","Total",764,313,69,244,451,27,39,66,214,10,19,76
"2011","Camden 016D","E01000966","Total",675,222,55,167,453,7,43,104,185,6,20,88
"2011","Camden 016E","E01000968","Total",760,314,88,226,446,19,25,72,222,4,12,92
"2011","Camden 017A","E01000960","Total",841,321,72,249,520,30,57,91,217,19,32,74
"2011","Camden 017B","E01000961","Total",652,197,59,138,455,49,68,78,110,29,40,81
"2011","Camden 017C","E01000963","Total",851,311,117,194,540,21,69,123,179,14,28,106
"2011","Camden 017D","E01000967","Total",619,225,84,141,394,14,66,76,104,25,31,78
"2011","Camden 018A","E01000857","Total",686,301,101,200,385,15,45,64,130,25,24,82
"2011","Camden 018B","E01000858","Total",775,287,55,232,488,55,30,70,132,17,62,122
"2011","Camden 018C","E01000859","Total",807,380,80,300,427,7,46,92,172,16,23,71
"2011","Camden 018D","E01000860","Total",797,515,195,320,282,15,55,55,99,9,15,34
"2011","Camden 018E","E01000862","Total",816,293,76,217,523,15,83,88,218,16,26,77
"2011","Camden 019A","E01000856","Total",628,205,38,167,423,30,23,52,114,41,48,115
"2011","Camden 019B","E01000861","Total",729,315,41,274,414,32,28,41,155,7,32,119
"2011","Camden 019C","E01000957","Total",765,263,58,205,502,51,29,62,205,14,42,99
"2011","Camden 019D","E01000958","Total",835,237,34,203,598,73,33,64,166,20,76,166
"2011","Camden 019E","E01000959","Total",698,264,83,181,434,50,49,45,88,24,45,133
"2011","Camden 020A","E01000929","Total",685,245,69,176,440,53,45,78,105,28,49,82
"2011","Camden 020B","E01000930","Total",1076,628,235,393,448,62,39,78,165,19,18,67
"2011","Camden 020C","E01000933","Total",821,340,95,245,481,20,37,58,213,11,22,120
"2011","Camden 020D","E01000934","Total",732,338,106,232,394,43,29,73,126,22,29,72
"2011","Camden 020E","E01000935","Total",624,241,50,191,383,68,21,81,107,26,28,52
"2011","Camden 021A","E01000863","Total",667,255,30,225,412,25,29,41,197,7,16,97
"2011","Camden 021B","E01000946","Total",715,312,84,228,403,35,49,51,131,11,28,98
"2011","Camden 021C","E01000947","Total",871,344,44,300,527,18,26,42,212,11,36,182
"2011","Camden 021D","E01000948","Total",846,362,103,259,484,42,65,76,175,8,27,91
"2011","Camden 022A","E01000952","Total",675,206,56,150,469,56,46,52,108,21,46,140
"2011","Camden 022B","E01000953","Total",708,299,132,167,409,37,45,55,108,14,51,99
"2011","Camden 022C","E01000954","Total",642,202,61,141,440,87,40,57,76,41,50,89
"2011","Camden 022D","E01000955","Total",657,293,83,210,364,46,31,82,63,18,38,86
"2011","Camden 022E","E01000956","Total",608,221,28,193,387,42,17,51,113,23,47,94
"2011","Camden 023A","E01000944","Total",667,188,54,134,479,35,35,41,91,17,45,215
"2011","Camden 023B","E01000945","Total",611,223,36,187,388,41,27,37,118,17,29,119
"2011","Camden 023C","E01000949","Total",739,331,103,228,408,50,49,74,105,23,29,78
"2011","Camden 023D","E01000950","Total",550,192,48,144,358,40,26,61,68,31,37,95
"2011","Camden 023E","E01000951","Total",603,230,97,133,373,36,34,52,59,25,51,116
"2011","Camden 024A","E01000936","Total",536,194,50,144,342,50,21,40,91,9,51,80
"2011","Camden 024B","E01000938","Total",737,305,38,267,432,95,20,27,128,11,28,123
"2011","Camden 024C","E01000939","Total",446,156,49,107,290,31,25,31,51,24,39,89
"2011","Camden 024D","E01000940","Total",534,253,61,192,281,23,31,48,89,14,20,56
"2011","Camden 025A","E01000853","Total",840,469,197,272,371,57,58,33,107,15,19,82
"2011","Camden 025B","E01000937","Total",502,296,40,256,206,22,13,17,77,5,15,57
"2011","Camden 025C","E01000941","Total",557,242,56,186,315,51,35,44,73,10,28,74
"2011","Camden 025D","E01000942","Total",686,381,73,308,305,19,19,26,150,6,8,77
"2011","Camden 025E","E01000943","Total",596,359,54,305,237,19,11,29,123,3,10,42
"2011","Camden 026A","E01000850","Total",664,324,77,247,340,9,33,29,155,5,12,97
"2011","Camden 026B","E01000851","Total",861,423,55,368,438,20,24,24,219,7,15,129
"2011","Camden 026C","E01000852","Total",625,388,79,309,237,7,42,18,109,0,5,56
"2011","Camden 026D","E01000854","Total",718,310,64,246,408,38,27,25,121,12,24,161
"2011","Camden 027A","E01000915","Total",635,247,69,178,388,36,42,50,107,21,36,96
"2011","Camden 027B","E01000916","Total",881,392,64,328,489,45,44,44,236,16,27,77
"2011","Camden 027C","E01000917","Total",913,458,99,359,455,65,24,91,142,25,37,71
"2011","Camden 027D","E01000920","Total",946,409,87,322,537,33,43,69,229,12,25,126
"2011","Camden 028A","E01000855","Total",1111,750,134,616,361,1,41,26,169,1,8,115
"2011","Camden 028B","E01000914","Total",970,483,109,374,487,19,45,36,257,4,20,106
"2011","Camden 028C","E01000918","Total",935,482,122,360,453,23,47,37,166,14,37,129
"2011","Camden 028D","E01000919","Total",834,434,73,361,400,17,34,25,163,5,51,105
"2011","City of London 001A","E01000001","Total",876,453,120,333,423,9,86,59,218,4,6,41
"2011","City of London 001B","E01000002","Total",830,418,122,296,412,11,78,75,198,3,7,40
"2011","City of London 001C","E01000003","Total",817,507,164,343,310,26,45,51,150,2,2,34
"2011","City of London 001E","E01000005","Total",467,228,61,167,239,24,21,35,67,6,32,54
"2011","City of London 001F","E01032739","Total",676,409,17,392,267,6,13,17,206,2,2,21
"2011","City of London 001G","E01032740","Total",719,457,42,415,262,0,22,19,191,1,1,28
"2011","Hackney 001A","E01001808","Total",558,150,29,121,408,13,24,97,89,75,53,57
"2011","Hackney 001B","E01001809","Total",610,185,72,113,425,26,36,55,94,59,83,72
"2011","Hackney 001C","E01001814","Total",559,152,28,124,407,27,23,87,99,45,55,71
"2011","Hackney 001D","E01001823","Total",538,147,38,109,391,36,25,63,54,76,71,66
"2011","Hackney 001E","E01001825","Total",428,94,28,66,334,7,30,57,66,70,77,27
"2011","Hackney 002A","E01001714","Total",632,227,57,170,405,61,28,52,109,14,38,103
"2011","Hackney 002D","E01001811","Total",646,252,92,160,394,52,35,76,91,18,44,78
"2011","Hackney 002E","E01001813","Total",525,188,33,155,337,62,30,45,82,14,26,78
"2011","Hackney 002F","E01033701","Total",760,278,73,205,482,59,38,62,111,15,70,127
"2011","Hackney 003A","E01001799","Total",485,119,32,87,366,9,28,75,99,60,51,44
"2011","Hackney 003B","E01001802","Total",471,164,47,117,307,35,22,47,80,35,34,54
"2011","Hackney 003C","E01001804","Total",464,102,35,67,362,18,36,67,75,55,48,63
"2011","Hackney 003D","E01001807","Total",693,248,55,193,445,36,19,70,144,42,49,85
"2011","Hackney 003E","E01001812","Total",614,205,59,146,409,39,29,87,90,49,49,66
"2011","Hackney 004A","E01001725","Total",573,154,34,120,419,29,24,55,86,66,80,79
"2011","Hackney 004B","E01001726","Total",464,110,26,84,354,57,9,63,69,22,54,80
"2011","Hackney 004C","E01001800","Total",643,267,65,202,376,53,24,89,82,55,31,42
"2011","Hackney 004D","E01001824","Total",539,167,42,125,372,52,35,73,70,44,52,46
"2011","Hackney 004E","E01001826","Total",585,183,46,137,402,49,33,64,77,60,56,63
"2011","Hackney 006A","E01001723","Total",671,182,39,143,489,28,23,74,149,21,78,116
"2011","Hackney 006B","E01001724","Total",980,386,41,345,594,52,18,99,241,16,50,118
"2011","Hackney 006C","E01001727","Total",573,140,29,111,433,21,29,72,99,53,76,83
"2011","Hackney 006D","E01001768","Total",719,193,34,159,526,44,18,64,191,12,47,150
"2011","Hackney 006E","E01001769","Total",662,228,35,193,434,28,24,67,157,11,39,108
"2011","Hackney 007A","E01001715","Total",673,274,25,249,399,23,2,50,221,2,8,93
"2011","Hackney 007B","E01001716","Total",633,290,42,248,343,41,16,41,147,6,19,73
"2011","Hackney 007C","E01001717","Total",427,98,15,83,329,24,12,42,102,22,40,87
"2011","Hackney 007D","E01001718","Total",824,284,17,267,540,12,22,51,278,7,30,140
"2011","Hackney 007E","E01001719","Total",484,166,60,106,318,20,43,42,84,12,25,92
"2011","Hackney 007F","E01001720","Total",785,256,35,221,529,20,22,68,248,5,26,140
"2011","Hackney 008A","E01001742","Total",789,275,69,206,514,63,23,94,163,10,41,120
"2011","Hackney 008B","E01001801","Total",588,223,100,123,365,30,25,63,82,35,64,66
"2011","Hackney 008C","E01001803","Total",719,217,61,156,502,43,32,95,160,37,36,99
"2011","Hackney 008D","E01001806","Total",714,265,65,200,449,52,37,72,157,15,21,95
"2011","Hackney 009A","E01001741","Total",599,171,32,139,428,22,26,117,140,14,25,84
"2011","Hackney 009B","E01001805","Total",510,160,23,137,350,26,14,59,131,9,22,89
"2011","Hackney 009C","E01001829","Total",696,187,36,151,509,18,24,129,163,26,31,118
"2011","Hackney 009D","E01001831","Total",745,246,62,184,499,28,38,64,194,12,29,134
"2011","Hackney 009E","E01001832","Total",642,204,39,165,438,29,18,64,128,10,37,152
"2011","Hackney 010A","E01001764","Total",696,253,53,200,443,32,27,63,139,24,47,111
"2011","Hackney 010B","E01001765","Total",722,325,97,228,397,60,31,61,78,34,63,70
"2011","Hackney 010D","E01001767","Total",628,177,39,138,451,61,11,70,131,19,41,118
"2011","Hackney 010E","E01001770","Total",784,332,73,259,452,71,22,84,116,16,43,100
"2011","Hackney 010F","E01033703","Total",625,259,56,203,366,45,23,40,116,11,36,95
"2011","Hackney 010G","E01033713","Total",601,237,26,211,364,53,14,58,127,13,24,75
"2011","Hackney 011A","E01001792","Total",620,180,43,137,440,40,41,68,84,14,57,136
"2011","Hackney 011B","E01001793","Total",656,200,33,167,456,44,33,76,121,14,36,132
"2011","Hackney 011C","E01001794","Total",656,182,38,144,474,23,37,56,141,20,68,129
"2011","Hackney 011D","E01001795","Total",571,181,23,158,390,33,24,59,117,15,33,109
"2011","Hackney 011E","E01001796","Total",737,312,35,277,425,51,13,59,132,15,39,116
"2011","Hackney 012A","E01001736","Total",707,231,25,206,476,33,29,100,166,15,34,99
"2011","Hackney 012B","E01001737","Total",754,212,33,179,542,36,25,122,184,14,30,131
"2011","Hackney 012C","E01001738","Total",785,280,48,232,505,38,21,100,206,18,28,94
"2011","Hackney 012D","E01001739","Total",898,299,67,232,599,42,32,123,228,21,26,127
"2011","Hackney 013A","E01001786","Total",717,251,66,185,466,104,18,96,77,29,63,79
"2011","Hackney 013B","E01001787","Total",628,228,120,108,400,71,49,50,69,29,57,75
"2011","Hackney 013C","E01001788","Total",670,282,107,175,388,71,32,67,83,27,62,46
"2011","Hackney 013D","E01001790","Total",492,148,35,113,344,72,23,60,49,29,54,57
"2011","Hackney 014A","E01001740","Total",624,198,61,137,426,75,28,60,91,24,38,110
"2011","Hackney 014B","E01001747","Total",943,308,85,223,635,49,35,71,249,11,35,185
"2011","Hackney 014C","E01001830","Total",932,415,93,322,517,50,48,64,185,11,31,128
"2011","Hackney 014D","E01001833","Total",931,323,42,281,608,81,22,104,211,13,51,126
"2011","Hackney 014E","E01001834","Total",862,258,34,224,604,57,16,83,226,22,40,160
"2011","Hackney 014F","E01001835","Total",483,123,16,107,360,10,23,67,125,11,28,96
"2011","Hackney 015A","E01001733","Total",701,221,41,180,480,35,32,92,120,20,47,134
"2011","Hackney 015B","E01001785","Total",569,157,55,102,412,40,48,59,100,18,41,106
"2011","Hackney 015C","E01001789","Total",646,188,40,148,458,45,29,87,104,17,45,131
"2011","Hackney 015D","E01001791","Total",500,112,37,75,388,42,21,56,72,25,67,105
"2011","Hackney 016A","E01001745","Total",958,346,45,301,612,101,25,78,182,21,77,128
"2011","Hackney 016B","E01001746","Total",632,176,40,136,456,110,12,94,85,32,53,70
"2011","Hackney 016C","E01001757","Total",654,175,36,139,479,83,26,84,105,21,63,97
"2011","Hackney 016D","E01001758","Total",884,321,72,249,563,91,30,95,157,31,54,105
"2011","Hackney 016E","E01001759","Total",750,268,70,198,482,39,28,49,144,18,60,144
"2011","Hackney 016F","E01001761","Total",869,403,107,296,466,53,25,66,165,8,28,121
"2011","Hackney 017A","E01001731","Total",1033,437,47,390,596,95,26,93,182,26,42,132
"2011","Hackney 017B","E01001734","Total",849,340,57,283,509,63,29,58,189,17,32,121
"2011","Hackney 017C","E01001760","Total",765,248,55,193,517,54,36,57,183,12,36,139
"2011","Hackney 017D","E01001762","Total",820,303,48,255,517,41,18,68,211,4,25,150
"2011","Hackney 018A","E01001846","Total",535,213,78,135,322,50,40,34,79,13,39,67
"2011","Hackney 018B","E01001847","Total",467,160,45,115,307,44,19,46,83,17,28,70
"2011","Hackney 018C","E01001848","Total",655,251,95,156,404,50,29,54,100,20,59,92
"2011","Hackney 018D","E01001849","Total",977,327,35,292,650,118,16,87,216,30,40,143
"2011","Hackney 019A","E01001729","Total",863,335,49,286,528,112,20,120,110,22,50,94
"2011","Hackney 019B","E01001730","Total",801,304,52,252,497,98,46,89,104,30,53,77
"2011","Hackney 019C","E01001732","Total",696,231,53,178,465,106,29,73,99,25,48,85
"2011","Hackney 019D","E01001735","Total",661,209,74,135,452,42,49,68,125,21,45,102
"2011","Hackney 019E","E01001838","Total",705,248,74,174,457,111,32,78,81,26,53,76
"2011","Hackney 019F","E01001850","Total",676,204,56,148,472,114,23,68,88,37,57,85
"2011","Hackney 020A","E01001748","Total",1090,445,46,399,645,60,32,59,281,11,36,166
"2011","Hackney 020B","E01001749","Total",743,244,45,199,499,39,24,94,189,7,27,119
"2011","Hackney 020C","E01001763","Total",742,281,69,212,461,53,36,57,158,15,42,100
"2011","Hackney 020D","E01001816","Total",640,182,48,134,458,44,35,74,125,23,46,111
"2011","Hackney 020E","E01001819","Total",684,231,77,154,453,39,45,67,143,15,30,114
"2011","Hackney 021B","E01001744","Total",786,263,78,185,523,47,48,66,153,15,56,138
"2011","Hackney 021C","E01001750","Total",782,238,50,188,544,40,42,71,198,12,41,140
"2011","Hackney 021D","E01001751","Total",676,196,42,154,480,16,46,68,201,12,11,126
"2011","Hackney 021E","E01001756","Total",987,341,69,272,646,33,40,63,289,9,26,186
"2011","Hackney 021F","E01033698","Total",613,293,132,161,320,47,21,40,114,8,32,58
"2011","Hackney 021G","E01033699","Total",585,229,21,208,356,16,4,42,192,2,20,80
"2011","Hackney 021H","E01033700","Total",697,244,41,203,453,22,14,38,224,14,16,125
"2011","Hackney 021I","E01033707","Total",614,252,27,225,362,19,19,37,162,4,28,93
"2011","Hackney 022A","E01001836","Total",857,336,81,255,521,69,31,98,191,22,36,74
"2011","Hackney 022B","E01001840","Total",715,287,96,191,428,75,23,68,95,31,45,91
"2011","Hackney 022C","E01001841","Total",626,256,72,184,370,26,31,79,103,17,34,80
"2011","Hackney 022D","E01001844","Total",812,321,50,271,491,39,20,78,172,30,37,115
"2011","Hackney 022E","E01001845","Total",680,276,67,209,404,72,31,52,91,25,52,81
"2011","Hackney 023B","E01001837","Total",665,219,45,174,446,30,33,81,198,11,20,73
"2011","Hackney 023C","E01001839","Total",941,290,33,257,651,84,16,75,283,12,31,150
"2011","Hackney 023D","E01001842","Total",631,193,29,164,438,70,20,71,123,20,50,84
"2011","Hackney 023E","E01001843","Total",502,153,41,112,349,45,23,61,96,13,37,74
"2011","Hackney 023F","E01033704","Total",763,256,9,247,507,37,5,75,264,8,23,95
"2011","Hackney 023G","E01033712","Total",661,204,23,181,457,66,13,61,157,15,31,114
"2011","Hackney 024A","E01001772","Total",459,192,34,158,267,51,18,38,61,11,33,55
"2011","Hackney 024B","E01001774","Total",875,248,43,205,627,75,17,82,252,24,51,126
"2011","Hackney 024C","E01001775","Total",759,300,86,214,459,65,24,56,125,26,47,116
"2011","Hackney 024D","E01001815","Total",692,260,81,179,432,46,28,64,94,18,59,123
"2011","Hackney 024E","E01001820","Total",599,206,61,145,393,41,33,47,97,20,39,116
"2011","Hackney 024F","E01001821","Total",644,263,71,192,381,49,37,63,89,16,36,91
"2011","Hackney 025A","E01001752","Total",1060,345,48,297,715,57,35,82,333,17,39,152
"2011","Hackney 025B","E01001753","Total",687,240,45,195,447,83,22,87,111,26,37,81
"2011","Hackney 025C","E01001754","Total",1135,464,72,392,671,79,39,85,269,24,53,122
"2011","Hackney 025D","E01001755","Total",724,242,45,197,482,73,29,94,120,19,52,95
"2011","Hackney 025E","E01001773","Total",860,278,60,218,582,54,48,70,220,20,55,115
"2011","Hackney 025F","E01001776","Total",634,259,73,186,375,34,34,52,91,14,31,119
"2011","Hackney 026A","E01001779","Total",1121,476,66,410,645,85,35,83,247,27,55,113
"2011","Hackney 026B","E01001781","Total",731,277,79,198,454,77,32,61,111,7,39,127
"2011","Hackney 026C","E01001782","Total",1053,379,57,322,674,55,32,92,292,12,46,145
"2011","Hackney 026D","E01001783","Total",863,329,78,251,534,112,24,73,135,16,37,137
"2011","Hackney 027B","E01001777","Total",1043,366,35,331,677,84,41,80,241,28,33,170
"2011","Hackney 027D","E01001780","Total",916,413,92,321,503,78,26,63,187,13,24,112
"2011","Hackney 027E","E01001784","Total",797,265,65,200,532,67,31,65,170,19,39,141
"2011","Hackney 027F","E01033706","Total",764,288,9,279,476,39,8,36,247,4,6,136
"2011","Hackney 027G","E01033708","Total",862,415,11,404,447,6,3,32,304,2,9,91
"2011","Hackney 027H","E01033709","Total",789,349,30,319,440,55,21,44,173,15,23,109
"2011","Hackney 027I","E01033711","Total",501,221,21,200,280,19,7,15,151,3,7,78
"2011","Hackney 028A","E01001798","Total",694,251,68,183,443,84,33,65,82,19,76,84
"2011","Hackney 028B","E01001828","Total",831,298,55,243,533,121,22,100,103,28,59,100
"2011","Hackney 028C","E01033702","Total",480,162,12,150,318,47,9,54,110,31,27,40
"2011","Hackney 028D","E01033705","Total",576,195,20,175,381,72,14,47,117,30,44,57
"2011","Hackney 028E","E01033710","Total",532,197,14,183,335,73,7,75,114,15,15,36
"2011","Hackney 029A","E01001722","Total",860,345,62,283,515,82,34,88,131,38,38,104
"2011","Hackney 029B","E01001728","Total",627,117,42,75,510,60,25,141,94,85,54,51
"2011","Hackney 029C","E01001822","Total",706,272,67,205,434,79,26,82,80,37,47,83
"2011","Hackney 029D","E01001827","Total",716,285,69,216,431,74,38,63,73,40,75,68
"2011","Hammersmith and Fulham 001A","E01001874","Total",966,457,109,348,509,53,32,75,175,9,32,133
"2011","Hammersmith and Fulham 001B","E01001875","Total",666,172,62,110,494,69,58,58,85,27,55,142
"2011","Hammersmith and Fulham 001C","E01001876","Total",834,357,42,315,477,79,37,83,112,35,51,80
"2011","Hammersmith and Fulham 001D","E01001877","Total",603,263,40,223,340,43,24,55,97,11,25,85
"2011","Hammersmith and Fulham 001E","E01001878","Total",605,122,54,68,483,71,51,80,101,28,39,113
"2011","Hammersmith and Fulham 002A","E01001955","Total",674,175,55,120,499,81,56,68,92,27,54,121
"2011","Hammersmith and Fulham 002B","E01001957","Total",605,162,48,114,443,87,20,63,86,19,58,110
"2011","Hammersmith and Fulham 002C","E01001958","Total",614,178,49,129,436,99,20,66,73,23,54,101
"2011","Hammersmith and Fulham 002D","E01001961","Total",540,130,41,89,410,69,24,64,68,33,58,94
"2011","Hammersmith and Fulham 003A","E01001954","Total",649,224,93,131,425,48,31,75,125,14,27,105
"2011","Hammersmith and Fulham 003B","E01001956","Total",603,162,65,97,441,49,43,60,110,17,47,115
"2011","Hammersmith and Fulham 003C","E01001959","Total",588,144,56,88,444,47,53,48,65,17,74,140
"2011","Hammersmith and Fulham 003D","E01001960","Total",750,209,37,172,541,45,28,74,173,16,24,181
"2011","Hammersmith and Fulham 004A","E01001943","Total",905,384,45,339,521,49,33,68,192,10,25,144
"2011","Hammersmith and Fulham 004B","E01001944","Total",869,462,104,358,407,75,38,55,114,18,33,74
"2011","Hammersmith and Fulham 004C","E01001945","Total",754,268,60,208,486,48,43,80,156,12,31,116
"2011","Hammersmith and Fulham 004D","E01001946","Total",702,247,54,193,455,42,27,58,157,19,28,124
"2011","Hammersmith and Fulham 005A","E01001862","Total",830,346,62,284,484,58,30,81,175,12,30,98
"2011","Hammersmith and Fulham 005B","E01001940","Total",740,295,64,231,445,47,30,68,183,9,26,82
"2011","Hammersmith and Fulham 005C","E01001941","Total",717,240,24,216,477,20,13,51,204,9,22,158
"2011","Hammersmith and Fulham 005D","E01001942","Total",865,355,50,305,510,41,26,74,192,10,34,133
"2011","Hammersmith and Fulham 006A","E01001858","Total",732,304,76,228,428,47,25,61,146,10,36,103
"2011","Hammersmith and Fulham 006B","E01001860","Total",795,333,56,277,462,64,22,74,153,14,28,107
"2011","Hammersmith and Fulham 006C","E01001861","Total",654,245,48,197,409,45,32,75,128,11,31,87
"2011","Hammersmith and Fulham 006D","E01001863","Total",671,233,46,187,438,32,28,75,181,21,17,84
"2011","Hammersmith and Fulham 006E","E01001864","Total",761,333,90,243,428,33,30,86,165,8,21,85
"2011","Hammersmith and Fulham 007A","E01001852","Total",956,425,61,364,531,26,26,56,300,3,15,105
"2011","Hammersmith and Fulham 007B","E01001853","Total",695,257,43,214,438,19,18,71,196,22,22,90
"2011","Hammersmith and Fulham 007C","E01001854","Total",887,398,73,325,489,30,28,64,239,13,22,93
"2011","Hammersmith and Fulham 007D","E01001857","Total",733,327,75,252,406,50,41,56,147,9,19,84
"2011","Hammersmith and Fulham 008A","E01001859","Total",1140,403,67,336,737,95,21,159,290,23,35,114
"2011","Hammersmith and Fulham 008B","E01001865","Total",651,204,47,157,447,32,38,98,132,9,32,106
"2011","Hammersmith and Fulham 008C","E01001927","Total",557,159,52,107,398,12,65,81,79,36,26,99
"2011","Hammersmith and Fulham 008D","E01001930","Total",842,401,152,249,441,32,39,68,149,18,37,98
"2011","Hammersmith and Fulham 009A","E01001895","Total",674,219,53,166,455,31,34,90,163,10,30,97
"2011","Hammersmith and Fulham 009B","E01001896","Total",669,264,79,185,405,30,31,58,156,14,16,100
"2011","Hammersmith and Fulham 009C","E01001897","Total",619,204,51,153,415,27,33,101,133,29,18,74
"2011","Hammersmith and Fulham 009D","E01001929","Total",597,241,69,172,356,18,25,104,135,8,13,53
"2011","Hammersmith and Fulham 010A","E01001851","Total",696,236,46,190,460,18,32,101,176,24,35,74
"2011","Hammersmith and Fulham 010B","E01001855","Total",894,397,50,347,497,32,22,76,281,5,22,59
"2011","Hammersmith and Fulham 010C","E01001856","Total",730,267,48,219,463,40,19,93,170,24,28,89
"2011","Hammersmith and Fulham 010D","E01001869","Total",574,211,69,142,363,10,45,71,129,23,30,55
"2011","Hammersmith and Fulham 010E","E01001873","Total",689,263,58,205,426,43,29,76,167,9,24,78
"2011","Hammersmith and Fulham 011A","E01001928","Total",722,247,80,167,475,33,42,111,143,24,38,84
"2011","Hammersmith and Fulham 011B","E01001931","Total",709,298,45,253,411,56,22,67,157,17,25,67
"2011","Hammersmith and Fulham 011C","E01001932","Total",757,291,49,242,466,30,33,67,190,10,23,113
"2011","Hammersmith and Fulham 011D","E01001933","Total",635,265,71,194,370,18,63,72,122,8,24,63
"2011","Hammersmith and Fulham 012A","E01001866","Total",704,265,60,205,439,14,46,61,151,9,30,128
"2011","Hammersmith and Fulham 012B","E01001867","Total",612,265,91,174,347,12,46,32,125,14,10,108
"2011","Hammersmith and Fulham 012C","E01001868","Total",603,239,49,190,364,50,29,51,100,13,31,90
"2011","Hammersmith and Fulham 012D","E01001870","Total",1009,454,54,400,555,39,20,55,276,5,12,148
"2011","Hammersmith and Fulham 012E","E01001871","Total",769,319,96,223,450,14,54,47,184,8,17,126
"2011","Hammersmith and Fulham 012F","E01001872","Total",759,325,47,278,434,20,28,44,203,8,33,98
"2011","Hammersmith and Fulham 013A","E01001893","Total",504,157,48,109,347,47,32,42,91,14,33,88
"2011","Hammersmith and Fulham 013B","E01001894","Total",602,275,67,208,327,33,32,43,105,7,21,86
"2011","Hammersmith and Fulham 013C","E01001898","Total",736,285,47,238,451,21,36,66,197,12,24,95
"2011","Hammersmith and Fulham 013D","E01001899","Total",691,308,91,217,383,58,52,42,125,11,12,83
"2011","Hammersmith and Fulham 013E","E01001900","Total",723,264,61,203,459,43,44,65,131,14,31,131
"2011","Hammersmith and Fulham 014A","E01001889","Total",593,197,48,149,396,17,30,60,138,7,15,129
"2011","Hammersmith and Fulham 014B","E01001910","Total",840,418,54,364,422,20,23,40,243,0,12,84
"2011","Hammersmith and Fulham 014C","E01001913","Total",774,304,53,251,470,11,19,48,235,3,7,147
"2011","Hammersmith and Fulham 014D","E01001914","Total",887,391,29,362,496,20,21,53,257,4,13,128
"2011","Hammersmith and Fulham 015A","E01001885","Total",538,182,51,131,356,62,42,61,65,19,30,77
"2011","Hammersmith and Fulham 015B","E01001908","Total",875,395,35,360,480,26,16,53,275,4,10,96
"2011","Hammersmith and Fulham 015C","E01001909","Total",821,295,83,212,526,38,38,72,212,13,30,123
"2011","Hammersmith and Fulham 015D","E01001911","Total",751,274,57,217,477,84,43,68,107,24,39,112
"2011","Hammersmith and Fulham 015E","E01001912","Total",600,194,31,163,406,55,36,44,82,22,44,123
"2011","Hammersmith and Fulham 016A","E01001886","Total",628,200,46,154,428,40,29,66,108,10,39,136
"2011","Hammersmith and Fulham 016B","E01001887","Total",658,252,100,152,406,27,38,59,106,6,26,144
"2011","Hammersmith and Fulham 016C","E01001890","Total",950,536,29,507,414,26,18,83,142,5,10,130
"2011","Hammersmith and Fulham 016D","E01001892","Total",605,227,56,171,378,54,32,52,109,8,25,98
"2011","Hammersmith and Fulham 017A","E01001880","Total",757,333,97,236,424,29,37,60,193,11,18,76
"2011","Hammersmith and Fulham 017B","E01001881","Total",681,200,44,156,481,18,34,80,199,8,17,125
"2011","Hammersmith and Fulham 017C","E01001882","Total",702,206,34,172,496,14,25,71,182,7,23,174
"2011","Hammersmith and Fulham 017D","E01001883","Total",734,316,105,211,418,28,39,43,183,7,17,101
"2011","Hammersmith and Fulham 017E","E01001884","Total",931,450,164,286,481,46,34,50,185,16,27,123
"2011","Hammersmith and Fulham 018A","E01001888","Total",644,184,53,131,460,11,55,84,140,12,19,139
"2011","Hammersmith and Fulham 018B","E01001891","Total",863,297,54,243,566,14,38,72,197,10,20,215
"2011","Hammersmith and Fulham 018C","E01001917","Total",684,274,120,154,410,17,62,65,130,15,23,98
"2011","Hammersmith and Fulham 018D","E01001918","Total",622,176,55,121,446,17,40,118,139,10,26,96
"2011","Hammersmith and Fulham 018E","E01001919","Total",639,203,97,106,436,11,51,113,106,28,46,81
"2011","Hammersmith and Fulham 019A","E01001879","Total",633,245,61,184,388,20,33,49,111,12,28,135
"2011","Hammersmith and Fulham 019B","E01001901","Total",695,238,35,203,457,21,34,107,156,24,20,95
"2011","Hammersmith and Fulham 019C","E01001902","Total",814,294,90,204,520,21,23,68,249,4,15,140
"2011","Hammersmith and Fulham 019D","E01001903","Total",681,224,72,152,457,42,35,62,132,17,42,127
"2011","Hammersmith and Fulham 020A","E01001920","Total",828,455,145,310,373,27,45,40,140,10,18,93
"2011","Hammersmith and Fulham 020B","E01001921","Total",663,240,45,195,423,17,41,81,140,13,37,94
"2011","Hammersmith and Fulham 020C","E01001922","Total",671,221,64,157,450,15,43,94,142,25,34,97
"2011","Hammersmith and Fulham 020D","E01001923","Total",653,224,69,155,429,17,42,76,159,11,30,94
"2011","Hammersmith and Fulham 020E","E01001924","Total",604,171,56,115,433,10,29,82,135,42,36,99
"2011","Hammersmith and Fulham 021A","E01001947","Total",591,190,39,151,401,87,28,74,79,14,32,87
"2011","Hammersmith and Fulham 021B","E01001948","Total",922,349,58,291,573,43,35,104,247,26,27,91
"2011","Hammersmith and Fulham 021C","E01001949","Total",658,193,30,163,465,18,28,86,182,23,26,102
"2011","Hammersmith and Fulham 021D","E01001950","Total",636,167,34,133,469,11,31,103,179,28,28,89
"2011","Hammersmith and Fulham 021E","E01001951","Total",705,259,62,197,446,19,28,79,156,15,22,127
"2011","Hammersmith and Fulham 021F","E01001953","Total",610,216,73,143,394,31,28,38,157,16,17,107
"2011","Hammersmith and Fulham 022A","E01001904","Total",681,207,41,166,474,13,32,99,187,12,18,113
"2011","Hammersmith and Fulham 022B","E01001905","Total",750,238,80,158,512,16,44,109,205,15,13,110
"2011","Hammersmith and Fulham 022C","E01001906","Total",656,204,47,157,452,11,26,72,214,3,13,113
"2011","Hammersmith and Fulham 022D","E01001907","Total",563,188,39,149,375,14,34,83,141,22,16,65
"2011","Hammersmith and Fulham 023A","E01001935","Total",927,293,67,226,634,45,43,95,251,15,39,146
"2011","Hammersmith and Fulham 023C","E01001939","Total",985,406,107,299,579,78,70,87,210,17,25,92
"2011","Hammersmith and Fulham 023D","E01032788","Total",496,158,27,131,338,56,18,50,125,6,18,65
"2011","Hammersmith and Fulham 023E","E01032789","Total",586,259,9,250,327,49,14,56,143,8,14,43
"2011","Hammersmith and Fulham 023F","E01032790","Total",557,238,55,183,319,54,22,73,126,6,14,24
"2011","Hammersmith and Fulham 024A","E01001915","Total",608,208,95,113,400,16,49,85,99,35,30,86
"2011","Hammersmith and Fulham 024B","E01001916","Total",689,294,144,150,395,10,92,53,123,19,19,79
"2011","Hammersmith and Fulham 024C","E01001926","Total",613,189,55,134,424,5,30,92,165,21,19,92
"2011","Hammersmith and Fulham 024D","E01001952","Total",809,316,66,250,493,18,26,56,256,9,10,118
"2011","Hammersmith and Fulham 025A","E01001925","Total",624,182,40,142,442,9,49,104,111,29,58,82
"2011","Hammersmith and Fulham 025B","E01001934","Total",699,241,82,159,458,55,35,82,140,7,37,102
"2011","Hammersmith and Fulham 025C","E01001937","Total",760,228,53,175,532,18,50,96,186,27,25,130
"2011","Hammersmith and Fulham 025D","E01001938","Total",616,176,44,132,440,58,37,88,115,17,34,91
"2011","Haringey 001A","E01001969","Total",857,321,94,227,536,66,43,98,163,14,30,122
"2011","Haringey 001B","E01001971","Total",784,252,89,163,532,97,39,85,109,32,50,120
"2011","Haringey 001C","E01001974","Total",959,335,66,269,624,33,54,130,203,12,45,147
"2011","Haringey 001D","E01001975","Total",776,283,43,240,493,39,20,113,191,7,25,98
"2011","Haringey 002A","E01002036","Total",637,219,56,163,418,82,38,67,69,21,64,77
"2011","Haringey 002B","E01002037","Total",697,275,49,226,422,81,29,56,90,24,62,80
"2011","Haringey 002C","E01002039","Total",639,198,46,152,441,117,25,86,75,20,58,60
"2011","Haringey 002D","E01002040","Total",740,199,51,148,541,90,48,96,99,29,70,109
"2011","Haringey 004A","E01001962","Total",641,147,48,99,494,31,51,140,98,37,41,96
"2011","Haringey 004B","E01001970","Total",728,185,44,141,543,84,29,88,147,22,48,125
"2011","Haringey 004C","E01001972","Total",749,288,78,210,461,47,47,82,132,18,36,99
"2011","Haringey 004D","E01001973","Total",943,284,108,176,659,68,72,138,195,16,51,119
"2011","Haringey 005A","E01002090","Total",531,102,35,67,429,46,42,64,72,20,83,102
"2011","Haringey 005B","E01002093","Total",645,169,65,104,476,67,39,76,78,38,74,104
"2011","Haringey 005C","E01002096","Total",583,162,88,74,421,57,39,81,66,28,68,82
"2011","Haringey 005D","E01002097","Total",592,113,32,81,479,103,25,96,93,30,57,75
"2011","Haringey 006A","E01002091","Total",635,181,106,75,454,70,54,65,50,28,76,111
"2011","Haringey 006B","E01002092","Total",689,230,31,199,459,106,19,79,104,23,48,80
"2011","Haringey 006C","E01002094","Total",541,103,32,71,438,95,29,61,82,22,53,96
"2011","Haringey 006D","E01002095","Total",604,150,30,120,454,103,26,78,74,29,50,94
"2011","Haringey 007A","E01002098","Total",604,219,57,162,385,31,20,75,145,4,20,90
"2011","Haringey 007B","E01002101","Total",698,186,35,151,512,39,41,97,120,21,45,149
"2011","Haringey 007C","E01002102","Total",752,227,44,183,525,63,34,69,155,8,54,142
"2011","Haringey 007D","E01002105","Total",861,277,59,218,584,60,45,77,210,17,38,137
"2011","Haringey 008A","E01002099","Total",813,269,89,180,544,91,32,85,109,38,59,130
"2011","Haringey 008B","E01002100","Total",680,162,38,124,518,60,47,102,98,22,58,131
"2011","Haringey 008C","E01002103","Total",646,159,50,109,487,39,46,68,100,30,60,144
"2011","Haringey 008D","E01002104","Total",501,107,34,73,394,34,44,45,84,25,46,116
"2011","Haringey 009A","E01001963","Total",691,169,54,115,522,26,60,127,134,42,46,87
"2011","Haringey 009B","E01001964","Total",667,192,35,157,475,29,28,100,183,12,37,86
"2011","Haringey 009C","E01001965","Total",657,167,29,138,490,18,40,162,158,23,20,69
"2011","Haringey 009D","E01001966","Total",535,114,34,80,421,16,64,80,74,30,49,108
"2011","Haringey 010A","E01002027","Total",552,134,48,86,418,33,47,55,89,13,48,133
"2011","Haringey 010B","E01002028","Total",645,146,38,108,499,51,38,67,117,18,48,160
"2011","Haringey 010C","E01002032","Total",759,272,62,210,487,100,20,79,106,19,49,114
"2011","Haringey 010D","E01002033","Total",709,178,55,123,531,93,33,76,115,19,56,139
"2011","Haringey 011A","E01001976","Total",635,196,50,146,439,85,35,87,76,23,46,87
"2011","Haringey 011B","E01001977","Total",605,183,45,138,422,72,32,68,90,32,47,81
"2011","Haringey 011C","E01001978","Total",819,326,105,221,493,107,42,94,103,6,57,84
"2011","Haringey 011D","E01001979","Total",846,258,39,219,588,102,22,104,138,30,69,123
"2011","Haringey 012A","E01002074","Total",849,276,84,192,573,146,49,95,91,33,58,101
"2011","Haringey 012B","E01002077","Total",686,162,41,121,524,132,31,102,88,23,52,96
"2011","Haringey 012C","E01002079","Total",539,91,35,56,448,47,33,76,101,32,53,106
"2011","Haringey 012D","E01002081","Total",615,224,71,153,391,56,42,55,48,15,70,105
"2011","Haringey 013A","E01002082","Total",568,163,42,121,405,82,27,64,70,20,64,78
"2011","Haringey 013B","E01002086","Total",605,194,38,156,411,47,32,56,83,22,52,119
"2011","Haringey 013C","E01002088","Total",688,198,64,134,490,50,59,83,85,14,44,155
"2011","Haringey 013D","E01002089","Total",644,265,63,202,379,95,17,66,65,26,53,57
"2011","Haringey 014A","E01001967","Total",633,173,49,124,460,16,46,104,140,27,39,88
"2011","Haringey 014B","E01001968","Total",778,264,66,198,514,22,51,114,175,19,31,102
"2011","Haringey 014C","E01001996","Total",698,232,70,162,466,27,36,93,171,37,29,73
"2011","Haringey 014D","E01001997","Total",730,284,41,243,446,22,21,86,189,14,20,94
"2011","Haringey 015A","E01002075","Total",595,161,46,115,434,108,31,75,71,24,42,83
"2011","Haringey 015B","E01002076","Total",639,150,48,102,489,83,47,87,76,25,67,104
"2011","Haringey 015C","E01002078","Total",951,364,68,296,587,88,31,106,166,22,69,105
"2011","Haringey 015D","E01002080","Total",510,117,38,79,393,32,39,34,73,21,52,142
"2011","Haringey 016A","E01002026","Total",711,301,62,239,410,78,34,68,77,22,42,89
"2011","Haringey 016B","E01002029","Total",740,300,61,239,440,79,23,83,125,13,32,85
"2011","Haringey 016C","E01002030","Total",658,204,38,166,454,44,33,71,130,10,43,123
"2011","Haringey 016D","E01002031","Total",764,243,43,200,521,49,45,76,141,12,39,159
"2011","Haringey 017A","E01001991","Total",766,321,50,271,445,49,20,121,164,14,17,60
"2011","Haringey 017B","E01001992","Total",672,197,78,119,475,7,77,104,102,37,35,113
"2011","Haringey 017C","E01001993","Total",609,157,84,73,452,9,64,128,68,46,43,94
"2011","Haringey 017D","E01001995","Total",898,206,67,139,692,85,48,167,170,44,61,117
"2011","Haringey 018A","E01001980","Total",673,195,49,146,478,65,32,82,89,25,78,107
"2011","Haringey 018B","E01001981","Total",601,159,45,114,442,54,33,58,84,19,65,129
"2011","Haringey 018C","E01001982","Total",676,214,48,166,462,60,36,73,108,17,51,117
"2011","Haringey 018D","E01001983","Total",612,153,37,116,459,48,30,96,116,16,50,103
"2011","Haringey 019A","E01002083","Total",543,152,56,96,391,19,45,40,85,12,38,152
"2011","Haringey 019B","E01002084","Total",619,198,49,149,421,34,31,57,111,16,48,124
"2011","Haringey 019C","E01002085","Total",821,211,50,161,610,57,37,98,197,23,52,146
"2011","Haringey 019D","E01002087","Total",714,293,70,223,421,52,33,56,128,13,43,96
"2011","Haringey 020B","E01002014","Total",797,303,55,248,494,46,31,76,211,16,24,90
"2011","Haringey 020C","E01002015","Total",668,236,74,162,432,40,52,63,140,14,24,99
"2011","Haringey 020D","E01002018","Total",602,184,78,106,418,48,38,111,121,9,29,62
"2011","Haringey 020E","E01033085","Total",908,402,33,369,506,62,14,63,261,7,38,61
"2011","Haringey 020F","E01033086","Total",488,177,46,131,311,69,28,51,79,12,21,51
"2011","Haringey 021A","E01002020","Total",706,250,60,190,456,38,40,106,154,7,26,85
"2011","Haringey 021B","E01002022","Total",867,324,39,285,543,21,36,84,257,13,19,113
"2011","Haringey 021C","E01002023","Total",609,196,83,113,413,23,52,91,95,21,37,94
"2011","Haringey 021D","E01002025","Total",670,164,47,117,506,22,58,121,146,29,43,87
"2011","Haringey 022A","E01002013","Total",595,165,48,117,430,30,32,121,149,9,22,67
"2011","Haringey 022B","E01002019","Total",503,103,57,46,400,11,50,84,117,14,24,100
"2011","Haringey 022C","E01002021","Total",603,189,79,110,414,17,46,85,114,19,32,101
"2011","Haringey 022D","E01002024","Total",534,162,61,101,372,21,42,86,92,12,36,83
"2011","Haringey 023A","E01001998","Total",865,266,56,210,599,28,45,94,225,7,36,164
"2011","Haringey 023B","E01001999","Total",819,246,40,206,573,40,46,88,186,10,37,166
"2011","Haringey 023C","E01002003","Total",929,351,44,307,578,85,25,104,173,22,36,133
"2011","Haringey 023D","E01002004","Total",710,190,41,149,520,30,45,90,143,12,32,168
"2011","Haringey 024A","E01002067","Total",700,263,73,190,437,53,32,76,87,22,50,117
"2011","Haringey 024B","E01002069","Total",880,388,98,290,492,53,43,71,137,12,48,128
"2011","Haringey 024C","E01002070","Total",789,229,52,177,560,75,34,78,166,25,60,122
"2011","Haringey 024D","E01002073","Total",681,224,53,171,457,58,26,79,101,40,43,110
"2011","Haringey 025A","E01002066","Total",781,297,47,250,484,109,25,88,98,27,54,83
"2011","Haringey 025B","E01002068","Total",739,236,50,186,503,43,38,75,141,15,43,148
"2011","Haringey 025C","E01002071","Total",675,245,66,179,430,102,32,78,83,15,38,82
"2011","Haringey 025D","E01002072","Total",680,226,58,168,454,58,30,71,113,23,43,116
"2011","Haringey 026A","E01002043","Total",742,202,35,167,540,53,35,99,129,29,56,139
"2011","Haringey 026B","E01002045","Total",803,243,45,198,560,66,35,105,116,29,65,144
"2011","Haringey 026C","E01002046","Total",676,248,85,163,428,57,29,68,82,22,63,107
"2011","Haringey 026D","E01002049","Total",705,219,54,165,486,53,36,75,94,20,72,136
"2011","Haringey 027A","E01002042","Total",541,152,51,101,389,13,34,65,96,11,40,130
"2011","Haringey 027B","E01002044","Total",693,207,39,168,486,28,44,57,164,11,41,141
"2011","Haringey 027C","E01002047","Total",592,145,40,105,447,27,41,40,116,14,27,182
"2011","Haringey 027D","E01002048","Total",690,181,41,140,509,40,38,86,115,17,49,164
"2011","Haringey 028A","E01002016","Total",864,273,68,205,591,60,25,112,236,18,39,101
"2011","Haringey 028B","E01002017","Total",751,277,46,231,474,42,22,90,200,11,32,77
"2011","Haringey 028C","E01002059","Total",710,237,73,164,473,38,34,114,140,23,30,94
"2011","Haringey 028D","E01002060","Total",763,233,41,192,530,29,28,124,220,16,33,80
"2011","Haringey 029A","E01002050","Total",467,80,27,53,387,18,31,39,37,99,78,85
"2011","Haringey 029B","E01002051","Total",667,235,52,183,432,52,27,78,99,26,38,112
"2011","Haringey 029C","E01002052","Total",526,100,35,65,426,20,38,54,67,115,67,65
"2011","Haringey 029D","E01002055","Total",456,99,28,71,357,18,25,43,59,84,52,76
"2011","Haringey 030A","E01001994","Total",760,231,81,150,529,22,73,76,189,26,34,109
"2011","Haringey 030B","E01002008","Total",643,217,79,138,426,15,82,102,95,16,34,82
"2011","Haringey 030C","E01002010","Total",718,219,88,131,499,47,70,98,172,14,26,72
"2011","Haringey 030D","E01002011","Total",761,263,61,202,498,22,47,100,191,17,19,102
"2011","Haringey 031A","E01002000","Total",690,221,35,186,469,43,27,86,155,10,40,108
"2011","Haringey 031B","E01002001","Total",677,224,25,199,453,19,35,66,159,8,33,133
"2011","Haringey 031C","E01002002","Total",781,274,34,240,507,46,31,68,195,13,32,122
"2011","Haringey 031D","E01002058","Total",681,200,42,158,481,34,31,77,154,12,27,146
"2011","Haringey 032A","E01002053","Total",663,220,67,153,443,47,42,72,84,24,62,112
"2011","Haringey 032B","E01002054","Total",697,239,51,188,458,92,23,103,73,22,44,101
"2011","Haringey 032C","E01002056","Total",841,342,76,266,499,66,32,76,129,25,44,127
"2011","Haringey 032D","E01002057","Total",557,124,26,98,433,44,38,52,111,12,55,121
"2011","Haringey 033A","E01001984","Total",867,413,95,318,454,24,42,97,222,10,9,50
"2011","Haringey 033B","E01001985","Total",769,311,67,244,458,19,34,100,179,27,29,70
"2011","Haringey 033C","E01001987","Total",805,233,60,173,572,12,55,141,241,14,24,85
"2011","Haringey 033D","E01001989","Total",766,262,83,179,504,21,39,125,190,13,32,84
"2011","Haringey 034A","E01001986","Total",744,275,61,214,469,17,35,113,180,23,17,84
"2011","Haringey 034B","E01001988","Total",881,378,76,302,503,25,32,100,239,22,22,63
"2011","Haringey 034C","E01001990","Total",982,350,41,309,632,32,29,85,286,13,23,164
"2011","Haringey 034D","E01002062","Total",855,288,40,248,567,30,22,96,293,11,29,86
"2011","Haringey 035A","E01002005","Total",818,289,27,262,529,25,17,101,277,8,13,88
"2011","Haringey 035B","E01002006","Total",808,310,57,253,498,28,20,89,268,6,12,75
"2011","Haringey 035C","E01002007","Total",799,298,103,195,501,18,80,84,204,20,19,76
"2011","Haringey 035D","E01002009","Total",708,249,56,193,459,21,71,104,141,12,23,87
"2011","Haringey 036A","E01002061","Total",703,182,29,153,521,29,31,85,224,17,20,115
"2011","Haringey 036B","E01002063","Total",713,255,31,224,458,41,25,85,171,18,19,99
"2011","Haringey 036C","E01002064","Total",648,214,39,175,434,56,29,47,155,15,29,103
"2011","Haringey 036D","E01002065","Total",815,323,40,283,492,21,22,52,275,8,22,92
"2011","Haringey 037A","E01002034","Total",811,321,74,247,490,122,26,110,95,27,34,76
"2011","Haringey 037B","E01002038","Total",692,258,73,185,434,106,25,87,76,17,44,79
"2011","Haringey 037C","E01002041","Total",736,242,82,160,494,85,48,84,93,30,55,99
"2011","Haringey 037D","E01032575","Total",672,193,35,158,479,96,27,67,88,33,81,87
"2011","Islington 001A","E01002755","Total",635,289,76,213,346,56,18,66,103,13,23,67
"2011","Islington 001B","E01002756","Total",610,231,38,193,379,24,22,73,145,11,17,87
"2011","Islington 001C","E01002758","Total",709,278,45,233,431,87,23,74,133,19,32,63
"2011","Islington 001D","E01002804","Total",754,297,41,256,457,86,27,59,144,19,35,87
"2011","Islington 001E","E01002807","Total",824,325,68,257,499,85,30,74,170,13,27,100
"2011","Islington 001F","E01002811","Total",694,272,76,196,422,65,26,86,126,22,28,69
"2011","Islington 002A","E01002753","Total",626,255,50,205,371,34,26,39,117,18,32,105
"2011","Islington 002B","E01002754","Total",614,169,48,121,445,21,37,91,149,17,34,96
"2011","Islington 002C","E01002757","Total",590,160,47,113,430,71,25,90,127,13,26,78
"2011","Islington 002D","E01002759","Total",659,194,54,140,465,29,39,79,160,9,37,112
"2011","Islington 002E","E01002760","Total",626,214,64,150,412,73,30,63,81,15,38,112
"2011","Islington 002F","E01002772","Total",871,356,85,271,515,58,29,75,190,12,23,128
"2011","Islington 003A","E01002735","Total",777,315,50,265,462,59,29,67,170,7,24,106
"2011","Islington 003B","E01002805","Total",758,269,36,233,489,57,32,46,231,6,9,108
"2011","Islington 003C","E01002806","Total",721,260,65,195,461,35,34,82,168,10,30,102
"2011","Islington 003D","E01002808","Total",857,294,59,235,563,65,41,74,217,11,34,121
"2011","Islington 003E","E01002809","Total",700,258,41,217,442,51,21,79,145,16,34,96
"2011","Islington 003F","E01002810","Total",748,296,59,237,452,60,32,74,151,17,33,85
"2011","Islington 004A","E01002768","Total",851,415,112,303,436,57,51,57,169,8,26,68
"2011","Islington 004B","E01002770","Total",718,270,75,195,448,50,42,55,191,11,17,82
"2011","Islington 004C","E01002771","Total",659,235,49,186,424,49,26,75,146,11,36,81
"2011","Islington 004D","E01002773","Total",696,342,125,217,354,48,46,49,93,13,25,80
"2011","Islington 004E","E01002774","Total",1005,393,87,306,612,70,43,96,233,12,22,136
"2011","Islington 005A","E01002732","Total",821,342,55,287,479,68,31,62,143,17,47,111
"2011","Islington 005B","E01002734","Total",696,245,37,208,451,113,23,75,91,28,35,86
"2011","Islington 005C","E01002736","Total",595,240,64,176,355,51,33,68,71,30,35,67
"2011","Islington 005D","E01002737","Total",788,263,66,197,525,116,36,73,114,37,44,105
"2011","Islington 005E","E01002751","Total",880,393,59,334,487,88,33,67,164,18,32,85
"2011","Islington 006A","E01002742","Total",675,186,41,145,489,20,45,89,198,20,15,102
"2011","Islington 006B","E01002747","Total",675,200,40,160,475,25,38,88,161,15,24,124
"2011","Islington 006C","E01002748","Total",667,271,32,239,396,48,28,70,131,12,30,77
"2011","Islington 006D","E01002749","Total",534,145,33,112,389,68,27,67,116,12,29,70
"2011","Islington 006F","E01033493","Total",701,223,5,218,478,8,6,33,378,2,5,46
"2011","Islington 006G","E01033494","Total",630,189,45,144,441,13,36,63,172,14,25,118
"2011","Islington 007A","E01002730","Total",812,312,68,244,500,47,29,44,194,8,23,155
"2011","Islington 007B","E01002731","Total",1164,443,55,388,721,47,38,71,338,14,44,169
"2011","Islington 007C","E01002733","Total",598,161,21,140,437,28,32,51,185,9,17,115
"2011","Islington 007D","E01002763","Total",603,261,49,212,342,18,38,39,132,12,16,87
"2011","Islington 008A","E01002769","Total",847,336,84,252,511,26,37,90,163,16,28,151
"2011","Islington 008B","E01002785","Total",840,289,69,220,551,49,50,98,172,26,42,114
"2011","Islington 008C","E01002788","Total",916,374,62,312,542,45,31,76,254,9,28,99
"2011","Islington 008D","E01002789","Total",810,243,52,191,567,20,56,112,203,14,36,126
"2011","Islington 009A","E01002738","Total",839,348,97,251,491,49,46,86,189,15,24,82
"2011","Islington 009B","E01002741","Total",656,257,78,179,399,60,30,64,89,20,31,105
"2011","Islington 009C","E01002743","Total",726,246,53,193,480,52,38,80,198,22,29,61
"2011","Islington 009D","E01002744","Total",722,311,45,266,411,19,27,74,182,12,12,85
"2011","Islington 009E","E01002752","Total",651,206,50,156,445,52,39,48,175,24,34,73
"2011","Islington 010A","E01002764","Total",796,285,94,191,511,55,51,65,176,18,39,107
"2011","Islington 010B","E01002783","Total",718,340,73,267,378,65,27,37,138,6,17,88
"2011","Islington 010C","E01002784","Total",732,257,50,207,475,56,39,73,138,17,46,106
"2011","Islington 010D","E01002786","Total",828,320,79,241,508,70,31,65,198,17,28,99
"2011","Islington 010E","E01002787","Total",578,203,39,164,375,44,26,27,143,10,29,96
"2011","Islington 011C","E01002762","Total",889,304,61,243,585,40,34,67,255,6,25,158
"2011","Islington 011D","E01002767","Total",982,395,85,310,587,106,54,72,168,9,30,148
"2011","Islington 011E","E01033486","Total",425,137,28,109,288,30,16,27,113,9,30,63
"2011","Islington 011F","E01033487","Total",595,180,8,172,415,28,1,45,266,9,7,59
"2011","Islington 011G","E01033488","Total",557,197,58,139,360,41,27,33,148,7,22,82
"2011","Islington 011H","E01033491","Total",869,387,54,333,482,40,25,59,240,8,17,93
"2011","Islington 011I","E01033492","Total",687,251,13,238,436,35,12,38,255,6,5,85
"2011","Islington 012A","E01002777","Total",833,359,80,279,474,32,35,61,221,6,21,98
"2011","Islington 012B","E01002778","Total",743,267,83,184,476,111,27,58,123,24,51,82
"2011","Islington 012C","E01002779","Total",820,319,45,274,501,51,34,78,231,13,26,68
"2011","Islington 012D","E01002781","Total",598,234,55,179,364,35,23,58,124,14,35,75
"2011","Islington 012E","E01002782","Total",616,199,54,145,417,91,33,54,96,23,51,69
"2011","Islington 013A","E01002739","Total",816,290,82,208,526,29,43,103,187,23,21,120
"2011","Islington 013B","E01002740","Total",806,279,57,222,527,22,30,104,221,18,32,100
"2011","Islington 013C","E01002745","Total",681,259,62,197,422,19,34,61,180,15,26,87
"2011","Islington 013D","E01002795","Total",863,253,35,218,610,49,25,75,264,17,42,138
"2011","Islington 013E","E01002796","Total",496,199,40,159,297,10,30,35,121,4,24,73
"2011","Islington 014A","E01002716","Total",1079,399,114,285,680,126,51,82,251,16,46,108
"2011","Islington 014B","E01002718","Total",799,306,43,263,493,20,36,57,233,9,24,114
"2011","Islington 014C","E01002721","Total",839,324,72,252,515,66,35,57,254,10,17,76
"2011","Islington 014D","E01002775","Total",683,251,44,207,432,25,17,55,220,6,22,87
"2011","Islington 014E","E01002776","Total",774,288,84,204,486,87,28,71,171,13,23,93
"2011","Islington 014F","E01002780","Total",763,297,53,244,466,52,20,68,195,16,25,90
"2011","Islington 015A","E01002708","Total",917,373,63,310,544,74,51,59,214,12,24,110
"2011","Islington 015B","E01002712","Total",535,208,32,176,327,31,24,55,108,6,17,86
"2011","Islington 015C","E01002713","Total",820,424,175,249,396,58,61,52,105,16,27,77
"2011","Islington 015D","E01002765","Total",980,375,67,308,605,103,49,79,173,21,62,118
"2011","Islington 015E","E01002766","Total",811,363,91,272,448,60,35,58,121,14,50,110
"2011","Islington 016A","E01002717","Total",590,202,52,150,388,32,42,67,128,13,18,88
"2011","Islington 016B","E01002719","Total",737,290,92,198,447,35,55,68,196,12,15,66
"2011","Islington 016C","E01002720","Total",993,338,66,272,655,157,36,98,169,21,63,111
"2011","Islington 016D","E01002790","Total",706,316,76,240,390,53,48,50,119,6,24,90
"2011","Islington 016E","E01002791","Total",762,299,82,217,463,40,48,60,199,7,17,92
"2011","Islington 016F","E01002793","Total",957,407,88,319,550,73,42,66,231,8,27,103
"2011","Islington 017A","E01002698","Total",1056,433,52,381,623,56,34,77,330,15,18,93
"2011","Islington 017B","E01002699","Total",775,332,64,268,443,29,32,62,213,6,17,84
"2011","Islington 017C","E01002700","Total",640,193,41,152,447,13,66,79,169,12,30,78
"2011","Islington 017D","E01002714","Total",771,243,32,211,528,29,35,66,259,18,24,97
"2011","Islington 017E","E01002792","Total",877,295,56,239,582,32,43,79,288,18,29,93
"2011","Islington 018A","E01002722","Total",668,299,61,238,369,57,38,46,145,6,19,58
"2011","Islington 018B","E01002797","Total",872,322,69,253,550,53,53,57,211,7,36,133
"2011","Islington 018C","E01002798","Total",922,323,90,233,599,21,67,110,263,10,23,105
"2011","Islington 018D","E01002799","Total",880,346,84,262,534,99,56,67,176,12,34,90
"2011","Islington 018E","E01002800","Total",435,160,36,124,275,49,32,39,59,10,40,46
"2011","Islington 019A","E01002694","Total",669,252,71,181,417,97,29,42,100,17,43,89
"2011","Islington 019B","E01002697","Total",709,285,102,183,424,71,46,42,99,19,47,100
"2011","Islington 019C","E01002709","Total",751,237,96,141,514,55,43,41,190,8,42,135
"2011","Islington 019D","E01002710","Total",679,212,45,167,467,59,47,68,121,19,35,118
"2011","Islington 019E","E01002715","Total",682,298,86,212,384,70,23,64,97,18,32,80
"2011","Islington 020A","E01002696","Total",895,325,67,258,570,38,49,67,283,12,20,101
"2011","Islington 020B","E01002794","Total",862,357,78,279,505,34,34,52,231,11,21,122
"2011","Islington 020C","E01002801","Total",806,335,76,259,471,27,40,60,234,9,18,83
"2011","Islington 020D","E01002802","Total",706,263,64,199,443,28,41,66,202,8,18,80
"2011","Islington 020E","E01002803","Total",935,386,70,316,549,37,50,77,230,12,27,116
"2011","Islington 021A","E01002695","Total",795,308,67,241,487,40,28,51,256,4,20,88
"2011","Islington 021B","E01002711","Total",963,387,37,350,576,47,23,59,287,8,19,133
"2011","Islington 021C","E01002727","Total",871,389,60,329,482,55,44,52,222,4,15,90
"2011","Islington 021D","E01002728","Total",509,236,49,187,273,25,23,40,108,3,17,57
"2011","Islington 021E","E01002729","Total",702,265,58,207,437,26,59,58,167,12,21,94
"2011","Islington 022B","E01002707","Total",901,429,50,379,472,39,51,38,203,5,23,113
"2011","Islington 022C","E01002723","Total",781,386,77,309,395,39,38,63,131,16,31,77
"2011","Islington 022D","E01002724","Total",1025,518,55,463,507,17,26,51,337,2,15,59
"2011","Islington 022E","E01002725","Total",572,237,61,176,335,49,39,44,86,10,25,82
"2011","Islington 022F","E01002726","Total",825,348,60,288,477,56,20,65,216,13,20,87
"2011","Islington 022G","E01033489","Total",776,385,11,374,391,17,17,37,273,3,4,40
"2011","Islington 022H","E01033490","Total",703,381,26,355,322,52,13,34,155,5,13,50
"2011","Islington 023A","E01002701","Total",718,305,100,205,413,50,44,51,147,11,24,86
"2011","Islington 023B","E01002702","Total",870,349,52,297,521,96,35,61,183,12,35,99
"2011","Islington 023C","E01002703","Total",774,286,61,225,488,70,31,57,206,12,21,91
"2011","Islington 023D","E01002704","Total",1035,538,123,415,497,71,49,84,200,18,22,53
"2011","Islington 023E","E01002706","Total",925,352,71,281,573,96,56,76,197,18,19,111
"2011","Kensington and Chelsea 001A","E01002852","Total",861,342,77,265,519,79,39,80,162,28,48,83
"2011","Kensington and Chelsea 001B","E01002853","Total",470,174,43,131,296,41,32,40,78,8,32,65
"2011","Kensington and Chelsea 001C","E01002854","Total",488,181,60,121,307,42,49,49,75,16,26,50
"2011","Kensington and Chelsea 001D","E01002855","Total",764,298,79,219,466,63,26,48,157,10,56,106
"2011","Kensington and Chelsea 001E","E01002857","Total",580,216,51,165,364,54,34,65,87,20,29,75
"2011","Kensington and Chelsea 002A","E01002904","Total",524,226,60,166,298,57,21,55,62,7,35,61
"2011","Kensington and Chelsea 002B","E01002905","Total",672,270,63,207,402,44,36,66,112,23,42,79
"2011","Kensington and Chelsea 002C","E01002906","Total",707,274,100,174,433,47,41,66,114,13,50,102
"2011","Kensington and Chelsea 002D","E01002907","Total",551,171,65,106,380,89,39,69,65,20,37,61
"2011","Kensington and Chelsea 003A","E01002876","Total",744,279,97,182,465,29,62,92,117,24,31,110
"2011","Kensington and Chelsea 003B","E01002877","Total",647,174,56,118,473,89,46,73,78,21,54,112
"2011","Kensington and Chelsea 003C","E01002878","Total",868,430,98,332,438,41,41,75,180,8,18,75
"2011","Kensington and Chelsea 003D","E01002908","Total",602,226,83,143,376,35,39,73,113,12,29,75
"2011","Kensington and Chelsea 003E","E01002909","Total",1152,578,106,472,574,42,55,87,249,12,37,92
"2011","Kensington and Chelsea 004A","E01002829","Total",788,400,70,330,388,36,25,42,182,7,25,71
"2011","Kensington and Chelsea 004B","E01002830","Total",917,449,136,313,468,52,29,58,195,8,36,90
"2011","Kensington and Chelsea 004C","E01002831","Total",961,445,90,355,516,35,37,84,202,12,45,101
"2011","Kensington and Chelsea 004D","E01002832","Total",910,456,75,381,454,76,41,56,177,5,24,75
"2011","Kensington and Chelsea 004E","E01002856","Total",941,477,72,405,464,51,25,56,223,9,29,71
"2011","Kensington and Chelsea 005A","E01002870","Total",693,362,117,245,331,51,36,47,77,6,28,86
"2011","Kensington and Chelsea 005B","E01002872","Total",726,357,195,162,369,39,74,62,81,18,33,62
"2011","Kensington and Chelsea 005C","E01002879","Total",695,296,90,206,399,58,23,56,116,13,45,88
"2011","Kensington and Chelsea 005D","E01002880","Total",653,249,51,198,404,63,35,75,74,19,41,97
"2011","Kensington and Chelsea 005E","E01002881","Total",544,169,46,123,375,46,36,49,89,19,44,92
"2011","Kensington and Chelsea 006A","E01002882","Total",703,375,107,268,328,30,29,57,123,11,27,51
"2011","Kensington and Chelsea 006B","E01002883","Total",802,306,96,210,496,22,78,89,181,24,22,80
"2011","Kensington and Chelsea 006C","E01002884","Total",710,417,59,358,293,3,19,55,153,11,13,39
"2011","Kensington and Chelsea 006D","E01002885","Total",950,547,66,481,403,28,23,43,252,11,3,43
"2011","Kensington and Chelsea 006E","E01002886","Total",781,369,85,284,412,8,53,82,165,23,21,60
"2011","Kensington and Chelsea 007A","E01002833","Total",793,386,55,331,407,24,33,75,211,8,16,40
"2011","Kensington and Chelsea 007B","E01002871","Total",742,265,71,194,477,17,61,98,166,22,35,78
"2011","Kensington and Chelsea 007C","E01002873","Total",632,260,62,198,372,18,55,67,135,18,23,56
"2011","Kensington and Chelsea 007D","E01002874","Total",648,245,46,199,403,25,32,71,157,19,33,66
"2011","Kensington and Chelsea 007E","E01002875","Total",681,318,112,206,363,14,54,55,121,14,37,68
"2011","Kensington and Chelsea 008A","E01002824","Total",684,289,69,220,395,4,36,75,167,22,41,50
"2011","Kensington and Chelsea 008B","E01002825","Total",827,310,87,223,517,18,85,113,167,28,34,72
"2011","Kensington and Chelsea 008C","E01002826","Total",798,380,89,291,418,13,62,81,191,7,14,50
"2011","Kensington and Chelsea 008D","E01002827","Total",903,400,86,314,503,8,56,127,209,15,21,67
"2011","Kensington and Chelsea 008E","E01002828","Total",710,352,98,254,358,9,56,64,154,11,20,44
"2011","Kensington and Chelsea 009A","E01002864","Total",580,163,60,103,417,13,90,84,76,30,46,78
"2011","Kensington and Chelsea 009B","E01002866","Total",848,358,44,314,490,53,35,84,197,11,33,77
"2011","Kensington and Chelsea 009C","E01002867","Total",998,452,74,378,546,45,35,92,243,20,47,64
"2011","Kensington and Chelsea 009D","E01002868","Total",725,267,81,186,458,5,81,101,142,19,28,82
"2011","Kensington and Chelsea 009E","E01002869","Total",768,340,70,270,428,31,43,69,194,10,19,62
"2011","Kensington and Chelsea 010A","E01002887","Total",807,448,69,379,359,6,35,56,188,10,17,47
"2011","Kensington and Chelsea 010B","E01002889","Total",579,273,72,201,306,2,33,70,132,12,15,42
"2011","Kensington and Chelsea 010C","E01002890","Total",705,193,77,116,512,5,78,124,145,35,53,72
"2011","Kensington and Chelsea 010D","E01002891","Total",718,320,48,272,398,17,34,76,174,16,19,62
"2011","Kensington and Chelsea 010E","E01002892","Total",920,436,43,393,484,14,31,109,220,12,26,72
"2011","Kensington and Chelsea 011A","E01002813","Total",835,344,89,255,491,4,67,87,197,26,35,75
"2011","Kensington and Chelsea 011B","E01002815","Total",755,368,96,272,387,22,27,70,173,12,12,71
"2011","Kensington and Chelsea 011C","E01002816","Total",693,327,54,273,366,5,56,70,154,12,12,57
"2011","Kensington and Chelsea 011D","E01002817","Total",709,248,68,180,461,20,79,87,141,16,28,90
"2011","Kensington and Chelsea 011E","E01002865","Total",544,159,48,111,385,11,42,92,111,25,37,67
"2011","Kensington and Chelsea 012A","E01002818","Total",1170,671,132,539,499,15,58,76,248,17,19,66
"2011","Kensington and Chelsea 012B","E01002819","Total",853,449,87,362,404,6,53,58,178,9,33,67
"2011","Kensington and Chelsea 012C","E01002859","Total",866,412,65,347,454,16,62,78,209,16,27,46
"2011","Kensington and Chelsea 012D","E01002860","Total",777,346,79,267,431,7,65,68,204,19,20,48
"2011","Kensington and Chelsea 012E","E01002863","Total",792,401,91,310,391,5,74,75,156,13,15,53
"2011","Kensington and Chelsea 013A","E01002812","Total",895,403,63,340,492,27,54,108,207,17,25,54
"2011","Kensington and Chelsea 013B","E01002834","Total",718,356,57,299,362,7,30,78,152,20,20,55
"2011","Kensington and Chelsea 013C","E01002839","Total",978,618,81,537,360,18,30,53,184,9,11,55
"2011","Kensington and Chelsea 013D","E01002850","Total",682,308,46,262,374,23,16,54,172,7,20,82
"2011","Kensington and Chelsea 013E","E01002888","Total",1149,605,80,525,544,9,36,86,303,12,9,89
"2011","Kensington and Chelsea 014A","E01002821","Total",692,279,65,214,413,10,53,66,179,18,19,68
"2011","Kensington and Chelsea 014B","E01002823","Total",701,350,100,250,351,22,65,55,112,21,29,47
"2011","Kensington and Chelsea 014C","E01002858","Total",749,488,105,383,261,23,33,27,85,6,23,64
"2011","Kensington and Chelsea 014D","E01002861","Total",771,376,105,271,395,15,85,68,148,10,18,51
"2011","Kensington and Chelsea 014E","E01002862","Total",977,630,137,493,347,54,49,49,127,4,12,52
"2011","Kensington and Chelsea 015A","E01002814","Total",905,358,71,287,547,48,52,86,190,21,37,113
"2011","Kensington and Chelsea 015B","E01002847","Total",872,431,49,382,441,18,35,63,254,10,10,51
"2011","Kensington and Chelsea 015C","E01002848","Total",894,476,78,398,418,22,24,47,242,17,15,51
"2011","Kensington and Chelsea 015D","E01002851","Total",918,514,118,396,404,28,33,40,202,13,15,73
"2011","Kensington and Chelsea 016A","E01002820","Total",666,340,57,283,326,7,29,61,153,17,13,46
"2011","Kensington and Chelsea 016B","E01002822","Total",621,321,74,247,300,6,53,59,107,19,25,31
"2011","Kensington and Chelsea 016C","E01002835","Total",784,342,71,271,442,9,45,89,207,17,16,59
"2011","Kensington and Chelsea 016D","E01002836","Total",795,428,71,357,367,10,25,70,199,10,11,42
"2011","Kensington and Chelsea 016E","E01002837","Total",717,365,39,326,352,8,41,63,169,13,23,35
"2011","Kensington and Chelsea 017A","E01002846","Total",781,432,50,382,349,29,21,44,186,5,11,53
"2011","Kensington and Chelsea 017B","E01002849","Total",787,350,68,282,437,24,40,59,217,18,18,61
"2011","Kensington and Chelsea 017C","E01002893","Total",987,494,100,394,493,30,45,73,246,10,15,74
"2011","Kensington and Chelsea 017D","E01002894","Total",773,381,61,320,392,25,22,52,217,13,12,51
"2011","Kensington and Chelsea 017E","E01002898","Total",739,303,105,198,436,16,57,87,155,29,36,56
"2011","Kensington and Chelsea 018A","E01002899","Total",768,414,143,271,354,18,60,62,142,8,12,52
"2011","Kensington and Chelsea 018B","E01002900","Total",682,286,67,219,396,9,64,64,155,14,33,57
"2011","Kensington and Chelsea 018C","E01002901","Total",560,342,152,190,218,9,38,35,78,11,15,32
"2011","Kensington and Chelsea 018D","E01002902","Total",1009,550,114,436,459,22,71,60,236,11,16,43
"2011","Kensington and Chelsea 018E","E01002903","Total",691,251,68,183,440,7,80,87,148,19,25,74
"2011","Kensington and Chelsea 019A","E01002844","Total",745,377,101,276,368,10,68,56,147,9,25,53
"2011","Kensington and Chelsea 019B","E01002845","Total",738,405,108,297,333,15,52,59,120,8,20,59
"2011","Kensington and Chelsea 019C","E01002910","Total",756,428,145,283,328,15,62,65,108,10,16,52
"2011","Kensington and Chelsea 019D","E01002911","Total",767,312,54,258,455,14,43,84,175,23,38,78
"2011","Kensington and Chelsea 019E","E01002914","Total",741,344,106,238,397,19,84,77,132,12,20,53
"2011","Kensington and Chelsea 020A","E01002838","Total",579,290,40,250,289,9,51,66,114,9,7,33
"2011","Kensington and Chelsea 020B","E01002895","Total",610,225,40,185,385,15,52,73,127,32,31,55
"2011","Kensington and Chelsea 020C","E01002896","Total",875,387,64,323,488,10,39,95,233,16,31,64
"2011","Kensington and Chelsea 020D","E01002897","Total",732,358,64,294,374,25,30,59,189,6,9,56
"2011","Kensington and Chelsea 020E","E01002912","Total",809,367,86,281,442,21,72,73,149,13,14,100
"2011","Kensington and Chelsea 021A","E01002840","Total",691,308,141,167,383,44,80,56,103,11,25,64
"2011","Kensington and Chelsea 021B","E01002841","Total",712,353,68,285,359,27,26,67,147,9,17,66
"2011","Kensington and Chelsea 021C","E01002842","Total",514,187,67,120,327,33,43,59,63,21,31,77
"2011","Kensington and Chelsea 021D","E01002843","Total",610,279,74,205,331,43,46,48,99,18,21,56
"2011","Kensington and Chelsea 021E","E01002913","Total",932,420,72,348,512,32,43,89,214,19,29,86
"2011","Lambeth 002A","E01003015","Total",730,289,64,225,441,58,36,55,146,14,43,89
"2011","Lambeth 002B","E01003108","Total",755,347,97,250,408,67,22,67,144,16,30,62
"2011","Lambeth 002C","E01003110","Total",849,325,86,239,524,44,36,61,213,13,34,123
"2011","Lambeth 002D","E01003111","Total",638,242,84,158,396,62,36,58,73,12,50,105
"2011","Lambeth 002E","E01003112","Total",771,390,91,299,381,51,23,46,139,8,32,82
"2011","Lambeth 003A","E01003101","Total",685,219,36,183,466,66,16,61,166,15,31,111
"2011","Lambeth 003B","E01003105","Total",780,328,80,248,452,73,42,67,129,10,34,97
"2011","Lambeth 003C","E01003106","Total",911,324,76,248,587,94,55,78,200,14,36,110
"2011","Lambeth 003D","E01003107","Total",929,358,71,287,571,61,38,55,248,8,26,135
"2011","Lambeth 003E","E01003109","Total",1093,459,69,390,634,99,44,71,243,23,35,119
"2011","Lambeth 004A","E01003102","Total",844,383,59,324,461,36,15,45,208,5,15,137
"2011","Lambeth 004C","E01003104","Total",777,307,41,266,470,42,25,42,216,7,32,106
"2011","Lambeth 004D","E01003122","Total",870,352,64,288,518,61,19,50,234,16,25,113
"2011","Lambeth 004E","E01003129","Total",808,260,33,227,548,47,30,56,234,14,27,140
"2011","Lambeth 004F","E01033207","Total",766,332,107,225,434,45,42,59,131,16,32,109
"2011","Lambeth 004G","E01033208","Total",1018,553,3,550,465,49,10,49,292,15,16,34
"2011","Lambeth 005A","E01003098","Total",645,219,66,153,426,38,29,63,140,13,43,100
"2011","Lambeth 005B","E01003099","Total",666,203,33,170,463,56,22,50,175,18,27,115
"2011","Lambeth 005C","E01003100","Total",878,248,31,217,630,27,14,43,338,4,17,187
"2011","Lambeth 005D","E01003180","Total",662,261,46,215,401,49,26,57,126,12,21,110
"2011","Lambeth 005E","E01003183","Total",631,237,53,184,394,47,34,46,96,9,43,119
"2011","Lambeth 006A","E01003097","Total",724,256,96,160,468,52,47,60,129,11,34,135
"2011","Lambeth 006B","E01003121","Total",691,241,48,193,450,87,32,77,111,20,41,82
"2011","Lambeth 006C","E01003123","Total",683,215,28,187,468,35,34,66,210,10,20,93
"2011","Lambeth 006D","E01003124","Total",619,211,43,168,408,47,30,46,133,12,36,104
"2011","Lambeth 006E","E01003125","Total",692,200,52,148,492,110,31,85,106,22,47,91
"2011","Lambeth 007A","E01003181","Total",644,218,54,164,426,59,33,38,149,13,28,106
"2011","Lambeth 007B","E01003184","Total",586,211,38,173,375,94,12,75,79,19,36,60
"2011","Lambeth 007C","E01003185","Total",768,273,62,211,495,59,23,62,195,12,18,126
"2011","Lambeth 007D","E01003186","Total",876,282,28,254,594,56,32,79,265,14,33,115
"2011","Lambeth 007E","E01003187","Total",626,251,56,195,375,32,18,48,89,7,57,124
"2011","Lambeth 008A","E01003089","Total",689,196,16,180,493,72,26,58,113,23,72,129
"2011","Lambeth 008B","E01003091","Total",668,182,31,151,486,63,21,66,163,19,41,113
"2011","Lambeth 008C","E01003092","Total",717,228,53,175,489,87,28,62,130,18,52,112
"2011","Lambeth 008D","E01003126","Total",645,201,42,159,444,68,28,70,130,13,46,89
"2011","Lambeth 008E","E01003128","Total",664,259,46,213,405,72,24,52,119,16,34,88
"2011","Lambeth 009A","E01003046","Total",743,279,31,248,464,105,27,85,106,22,50,69
"2011","Lambeth 009B","E01003048","Total",741,286,52,234,455,122,25,65,76,32,54,81
"2011","Lambeth 009C","E01003075","Total",685,258,53,205,427,94,31,65,81,21,50,85
"2011","Lambeth 009D","E01003182","Total",720,239,44,195,481,57,29,55,137,18,60,125
"2011","Lambeth 009E","E01003188","Total",554,192,27,165,362,63,23,49,83,6,46,92
"2011","Lambeth 010A","E01003088","Total",737,208,37,171,529,65,25,63,166,15,41,154
"2011","Lambeth 010B","E01003093","Total",949,269,64,205,680,175,40,108,165,31,41,120
"2011","Lambeth 010C","E01003094","Total",675,230,50,180,445,34,45,52,144,6,25,139
"2011","Lambeth 010D","E01003096","Total",926,298,50,248,628,19,24,36,308,8,19,214
"2011","Lambeth 010E","E01003127","Total",755,262,44,218,493,43,34,76,172,14,37,117
"2011","Lambeth 011A","E01003045","Total",728,246,63,183,482,79,26,75,82,28,78,114
"2011","Lambeth 011B","E01003047","Total",751,266,54,212,485,64,28,55,194,16,20,108
"2011","Lambeth 011C","E01003049","Total",668,218,50,168,450,81,24,66,113,22,57,87
"2011","Lambeth 011D","E01003059","Total",625,207,61,146,418,59,17,58,108,19,53,104
"2011","Lambeth 011E","E01003060","Total",632,239,66,173,393,54,22,66,79,21,50,101
"2011","Lambeth 011F","E01003061","Total",568,215,25,190,353,28,15,53,151,10,22,74
"2011","Lambeth 012A","E01003034","Total",723,223,45,178,500,46,24,84,178,23,30,115
"2011","Lambeth 012B","E01003035","Total",710,230,40,190,480,27,19,40,222,6,16,150
"2011","Lambeth 012C","E01003036","Total",737,271,57,214,466,48,20,73,191,8,24,102
"2011","Lambeth 012D","E01003090","Total",1043,343,41,302,700,26,19,52,362,10,41,190
"2011","Lambeth 012E","E01003095","Total",760,220,37,183,540,40,29,62,210,25,37,137
"2011","Lambeth 013A","E01003037","Total",606,210,59,151,396,44,26,55,133,13,22,103
"2011","Lambeth 013B","E01003038","Total",689,242,52,190,447,11,18,68,211,14,18,107
"2011","Lambeth 013C","E01003039","Total",945,303,40,263,642,31,25,81,333,21,25,126
"2011","Lambeth 013D","E01003040","Total",594,210,37,173,384,27,30,53,167,10,24,73
"2011","Lambeth 013E","E01003042","Total",502,212,61,151,290,34,17,28,94,4,15,98
"2011","Lambeth 014A","E01003072","Total",769,246,103,143,523,38,61,99,154,34,37,100
"2011","Lambeth 014B","E01003073","Total",698,236,52,184,462,54,22,85,148,21,46,86
"2011","Lambeth 014C","E01003076","Total",836,272,30,242,564,60,19,87,228,7,45,118
"2011","Lambeth 014D","E01003077","Total",786,262,32,230,524,30,31,86,208,15,36,118
"2011","Lambeth 014E","E01003078","Total",634,164,60,104,470,19,50,90,157,20,29,105
"2011","Lambeth 015A","E01003019","Total",914,282,57,225,632,33,36,69,286,14,25,169
"2011","Lambeth 015B","E01003053","Total",757,221,30,191,536,22,22,50,262,7,12,161
"2011","Lambeth 015C","E01003054","Total",819,242,20,222,577,28,12,29,291,3,11,203
"2011","Lambeth 015D","E01003056","Total",838,256,44,212,582,54,10,39,244,8,20,207
"2011","Lambeth 015E","E01003058","Total",820,245,38,207,575,45,25,43,223,9,13,217
"2011","Lambeth 016A","E01003020","Total",771,263,40,223,508,51,27,72,185,8,35,130
"2011","Lambeth 016B","E01003050","Total",773,307,57,250,466,44,18,53,196,10,13,132
"2011","Lambeth 016C","E01003052","Total",758,299,44,255,459,87,18,71,106,23,55,99
"2011","Lambeth 016D","E01003055","Total",790,381,83,298,409,23,22,38,202,0,16,108
"2011","Lambeth 016E","E01003176","Total",780,257,75,182,523,125,31,81,115,28,40,103
"2011","Lambeth 017A","E01003029","Total",860,319,50,269,541,35,37,58,261,17,15,118
"2011","Lambeth 017B","E01003032","Total",759,263,75,188,496,45,43,52,171,16,32,137
"2011","Lambeth 017C","E01003041","Total",678,231,51,180,447,63,32,42,152,18,33,107
"2011","Lambeth 017D","E01003057","Total",724,262,39,223,462,77,23,44,131,9,31,147
"2011","Lambeth 018A","E01003043","Total",685,221,60,161,464,40,40,48,158,4,31,143
"2011","Lambeth 018B","E01003044","Total",606,303,31,272,303,61,10,53,79,11,30,59
"2011","Lambeth 018C","E01003051","Total",675,209,21,188,466,72,11,60,168,15,46,94
"2011","Lambeth 018D","E01003071","Total",1004,289,25,264,715,53,33,111,334,9,36,139
"2011","Lambeth 018E","E01003074","Total",1096,417,52,365,679,76,32,122,272,22,42,113
"2011","Lambeth 019A","E01003026","Total",656,213,41,172,443,12,13,63,221,15,12,107
"2011","Lambeth 019B","E01003027","Total",480,92,21,71,388,8,23,85,110,26,26,110
"2011","Lambeth 019C","E01003028","Total",563,123,27,96,440,35,27,103,125,15,18,117
"2011","Lambeth 019D","E01003030","Total",783,210,40,170,573,25,21,84,284,16,20,123
"2011","Lambeth 019E","E01003033","Total",594,152,37,115,442,18,23,86,158,25,35,97
"2011","Lambeth 020A","E01003018","Total",999,352,45,307,647,40,24,89,335,5,21,133
"2011","Lambeth 020B","E01003171","Total",827,351,54,297,476,64,26,57,182,17,14,116
"2011","Lambeth 020C","E01003173","Total",694,233,52,181,461,20,34,81,166,12,36,112
"2011","Lambeth 020D","E01003177","Total",703,207,36,171,496,54,22,77,193,11,26,113
"2011","Lambeth 020E","E01003178","Total",712,252,48,204,460,26,25,65,191,7,15,131
"2011","Lambeth 021A","E01003021","Total",663,252,62,190,411,55,42,67,100,8,32,107
"2011","Lambeth 021B","E01003022","Total",770,262,53,209,508,42,30,70,188,11,36,131
"2011","Lambeth 021C","E01003023","Total",1063,370,70,300,693,80,29,86,252,17,36,193
"2011","Lambeth 021D","E01003024","Total",766,274,53,221,492,114,18,86,110,18,29,117
"2011","Lambeth 021E","E01003025","Total",842,264,60,204,578,79,41,97,152,23,56,130
"2011","Lambeth 022A","E01003136","Total",735,298,40,258,437,48,21,76,163,20,25,84
"2011","Lambeth 022B","E01003137","Total",676,262,45,217,414,87,33,62,133,13,25,61
"2011","Lambeth 022C","E01003159","Total",599,204,39,165,395,45,25,65,107,16,41,96
"2011","Lambeth 022D","E01003160","Total",558,159,29,130,399,75,21,62,81,18,51,91
"2011","Lambeth 022E","E01003162","Total",830,245,70,175,585,137,27,98,112,20,71,120
"2011","Lambeth 023A","E01003031","Total",720,239,40,199,481,53,18,52,173,10,24,151
"2011","Lambeth 023B","E01003156","Total",665,204,59,145,461,30,39,94,161,11,27,99
"2011","Lambeth 023C","E01003157","Total",577,124,24,100,453,20,26,125,134,15,23,110
"2011","Lambeth 023D","E01003158","Total",737,232,56,176,505,14,28,93,241,13,10,106
"2011","Lambeth 023E","E01003161","Total",498,135,56,79,363,42,26,68,107,12,20,88
"2011","Lambeth 023F","E01003163","Total",588,146,54,92,442,39,59,84,97,12,25,126
"2011","Lambeth 024A","E01003132","Total",536,141,51,90,395,56,36,61,97,13,48,84
"2011","Lambeth 024B","E01003172","Total",815,286,54,232,529,84,34,88,147,25,44,107
"2011","Lambeth 024C","E01003174","Total",829,271,37,234,558,154,19,84,113,24,51,113
"2011","Lambeth 024D","E01003175","Total",608,187,38,149,421,89,23,60,69,26,47,107
"2011","Lambeth 024E","E01003179","Total",654,206,40,166,448,98,14,84,89,14,61,88
"2011","Lambeth 025A","E01003164","Total",935,305,40,265,630,98,35,122,211,16,43,105
"2011","Lambeth 025B","E01003165","Total",712,246,85,161,466,66,55,93,134,15,33,70
"2011","Lambeth 025C","E01003168","Total",647,210,62,148,437,59,40,74,108,18,48,90
"2011","Lambeth 025D","E01003169","Total",1071,380,63,317,691,83,35,146,238,19,41,129
"2011","Lambeth 025E","E01003170","Total",797,263,124,139,534,25,78,143,148,28,31,81
"2011","Lambeth 026A","E01003130","Total",739,240,57,183,499,38,35,88,179,9,36,114
"2011","Lambeth 026B","E01003131","Total",617,200,44,156,417,34,23,71,141,18,30,100
"2011","Lambeth 026C","E01003135","Total",724,268,45,223,456,41,38,84,136,12,37,108
"2011","Lambeth 026D","E01003138","Total",689,212,45,167,477,21,24,100,218,6,14,94
"2011","Lambeth 026E","E01003151","Total",820,309,102,207,511,125,27,95,117,23,42,82
"2011","Lambeth 027A","E01003079","Total",757,285,50,235,472,103,27,87,124,22,29,80
"2011","Lambeth 027B","E01003080","Total",663,208,37,171,455,42,29,114,132,12,34,92
"2011","Lambeth 027C","E01003133","Total",765,290,43,247,475,58,18,89,153,19,34,104
"2011","Lambeth 027D","E01003134","Total",619,173,46,127,446,35,40,91,128,14,33,105
"2011","Lambeth 027E","E01003152","Total",761,208,43,165,553,63,48,101,147,12,57,125
"2011","Lambeth 028A","E01003064","Total",660,193,27,166,467,38,32,111,181,14,32,59
"2011","Lambeth 028B","E01003066","Total",741,266,86,180,475,72,31,81,139,18,52,82
"2011","Lambeth 028C","E01003081","Total",768,299,39,260,469,69,22,89,128,23,42,96
"2011","Lambeth 028D","E01003166","Total",1020,344,50,294,676,106,37,144,233,14,45,97
"2011","Lambeth 028E","E01003167","Total",681,170,68,102,511,29,56,135,147,24,40,80
"2011","Lambeth 029A","E01003116","Total",634,192,50,142,442,36,61,69,108,17,41,110
"2011","Lambeth 029B","E01003117","Total",841,302,67,235,539,54,50,70,195,9,35,126
"2011","Lambeth 029C","E01003118","Total",688,218,90,128,470,28,37,78,156,10,57,104
"2011","Lambeth 029D","E01003153","Total",929,291,62,229,638,38,28,72,296,4,31,169
"2011","Lambeth 029E","E01003155","Total",750,252,50,202,498,20,40,105,173,15,36,109
"2011","Lambeth 030A","E01003083","Total",594,185,56,129,409,23,50,88,110,22,33,83
"2011","Lambeth 030B","E01003084","Total",673,219,39,180,454,39,27,125,144,17,34,68
"2011","Lambeth 030C","E01003085","Total",697,218,91,127,479,44,51,92,121,21,48,102
"2011","Lambeth 030D","E01003149","Total",694,204,50,154,490,41,43,97,136,24,28,121
"2011","Lambeth 030E","E01003154","Total",786,282,73,209,504,65,34,105,129,16,48,107
"2011","Lambeth 031A","E01003065","Total",666,269,70,199,397,95,33,78,96,9,35,51
"2011","Lambeth 031B","E01003068","Total",657,191,58,133,466,101,34,102,113,16,49,51
"2011","Lambeth 031C","E01003082","Total",651,247,81,166,404,61,47,83,108,16,32,57
"2011","Lambeth 031D","E01003086","Total",647,211,39,172,436,97,35,74,92,20,61,57
"2011","Lambeth 031E","E01003087","Total",611,196,57,139,415,110,25,103,60,32,35,50
"2011","Lambeth 032A","E01003113","Total",817,260,30,230,557,57,26,80,225,13,55,101
"2011","Lambeth 032B","E01003114","Total",765,238,40,198,527,57,24,79,201,13,44,109
"2011","Lambeth 032C","E01003119","Total",813,304,38,266,509,48,22,88,198,10,48,95
"2011","Lambeth 032D","E01003120","Total",961,424,61,363,537,64,16,110,212,9,38,88
"2011","Lambeth 032E","E01003148","Total",762,279,45,234,483,37,20,125,166,13,46,76
"2011","Lambeth 032F","E01003150","Total",769,306,94,212,463,92,20,86,147,11,35,72
"2011","Lambeth 033A","E01003062","Total",795,291,51,240,504,52,28,92,233,12,22,65
"2011","Lambeth 033B","E01003063","Total",664,277,48,229,387,68,32,71,109,16,31,60
"2011","Lambeth 033C","E01003067","Total",599,166,47,119,433,42,39,98,118,13,38,85
"2011","Lambeth 033D","E01003069","Total",520,122,26,96,398,61,38,84,95,12,34,74
"2011","Lambeth 033E","E01003070","Total",655,234,38,196,421,85,22,74,117,12,35,76
"2011","Lambeth 034A","E01003115","Total",669,195,23,172,474,56,27,106,166,10,32,77
"2011","Lambeth 034B","E01003141","Total",723,242,72,170,481,57,58,108,118,17,40,83
"2011","Lambeth 034C","E01003144","Total",520,115,37,78,405,15,52,90,73,20,47,108
"2011","Lambeth 034D","E01003145","Total",783,323,54,269,460,47,30,71,184,8,37,83
"2011","Lambeth 034E","E01003147","Total",797,253,53,200,544,57,47,116,146,14,65,99
"2011","Lambeth 035A","E01003139","Total",542,136,45,91,406,37,43,67,68,22,51,118
"2011","Lambeth 035B","E01003140","Total",492,89,45,44,403,34,51,59,71,26,49,113
"2011","Lambeth 035C","E01003142","Total",453,91,45,46,362,28,61,50,48,16,70,89
"2011","Lambeth 035D","E01003143","Total",516,144,72,72,372,24,39,70,83,15,54,87
"2011","Lambeth 035E","E01003146","Total",524,116,32,84,408,52,30,61,79,19,57,110
"2011","Lambeth 036A","E01003013","Total",854,414,25,389,440,15,28,44,224,9,18,102
"2011","Lambeth 036B","E01003014","Total",678,272,76,196,406,29,51,42,143,5,28,108
"2011","Lambeth 036C","E01003016","Total",526,244,26,218,282,13,23,23,121,1,18,83
"2011","Lambeth 036D","E01003017","Total",862,407,94,313,455,40,46,65,177,4,28,95
"2011","Lambeth 036E","E01032582","Total",920,374,79,295,546,44,40,44,241,17,21,139
"2011","Lewisham 001A","E01003244","Total",618,208,34,174,410,100,11,92,62,32,56,57
"2011","Lewisham 001B","E01003245","Total",584,157,23,134,427,107,13,68,102,32,55,50
"2011","Lewisham 001C","E01003247","Total",685,237,18,219,448,14,21,45,176,9,35,148
"2011","Lewisham 001D","E01003249","Total",897,368,56,312,529,71,25,76,211,11,47,88
"2011","Lewisham 001E","E01003250","Total",763,245,56,189,518,69,28,54,205,16,45,101
"2011","Lewisham 002A","E01003246","Total",559,179,30,149,380,54,24,57,91,6,55,93
"2011","Lewisham 002B","E01003248","Total",718,287,42,245,431,88,19,70,128,20,40,66
"2011","Lewisham 002C","E01003251","Total",777,220,44,176,557,129,28,102,103,26,58,111
"2011","Lewisham 002D","E01003252","Total",613,200,52,148,413,118,23,67,70,17,56,62
"2011","Lewisham 002E","E01003253","Total",669,269,69,200,400,66,33,55,123,17,31,75
"2011","Lewisham 003A","E01003297","Total",767,337,10,327,430,94,4,86,180,6,21,39
"2011","Lewisham 003B","E01003299","Total",609,150,34,116,459,79,29,56,125,10,47,113
"2011","Lewisham 003C","E01003301","Total",767,203,18,185,564,45,15,97,228,19,59,101
"2011","Lewisham 003D","E01003302","Total",710,316,70,246,394,76,21,69,109,15,42,62
"2011","Lewisham 003E","E01003305","Total",513,178,35,143,335,52,29,55,73,10,39,77
"2011","Lewisham 005A","E01003207","Total",615,258,47,211,357,47,31,54,73,13,41,98
"2011","Lewisham 005B","E01003209","Total",778,276,62,214,502,75,22,71,160,19,30,125
"2011","Lewisham 005C","E01003210","Total",850,363,30,333,487,50,24,70,208,12,25,98
"2011","Lewisham 005D","E01003212","Total",867,297,88,209,570,53,55,71,180,11,30,170
"2011","Lewisham 005E","E01003215","Total",666,216,37,179,450,39,16,80,177,9,22,107
"2011","Lewisham 006A","E01003338","Total",771,320,76,244,451,74,45,66,101,22,46,97
"2011","Lewisham 006B","E01003339","Total",763,267,70,197,496,44,38,74,183,19,62,76
"2011","Lewisham 006C","E01003340","Total",797,249,28,221,548,37,25,70,205,9,29,173
"2011","Lewisham 006D","E01003341","Total",581,135,25,110,446,45,33,78,142,12,31,105
"2011","Lewisham 006E","E01003343","Total",626,239,43,196,387,43,29,89,133,5,18,70
"2011","Lewisham 007A","E01003199","Total",801,275,66,209,526,37,39,119,232,15,19,65
"2011","Lewisham 007B","E01003201","Total",680,232,55,177,448,70,29,87,118,10,41,93
"2011","Lewisham 007C","E01003204","Total",603,191,50,141,412,36,28,81,178,15,26,48
"2011","Lewisham 007D","E01003205","Total",502,157,63,94,345,62,28,46,53,15,80,61
"2011","Lewisham 007E","E01003206","Total",698,217,43,174,481,28,49,119,190,13,23,59
"2011","Lewisham 008B","E01003211","Total",753,306,46,260,447,38,21,77,191,12,28,80
"2011","Lewisham 008C","E01003213","Total",813,276,34,242,537,41,26,116,217,9,28,100
"2011","Lewisham 008D","E01003214","Total",745,249,42,207,496,77,26,86,146,14,42,105
"2011","Lewisham 008E","E01033324","Total",642,193,68,125,449,28,56,73,123,14,47,108
"2011","Lewisham 008F","E01033325","Total",706,297,5,292,409,4,1,52,326,0,3,23
"2011","Lewisham 009A","E01003198","Total",639,211,76,135,428,39,46,93,160,13,23,54
"2011","Lewisham 009B","E01003200","Total",756,292,74,218,464,14,52,94,203,15,17,69
"2011","Lewisham 009C","E01003202","Total",764,288,108,180,476,8,82,95,197,12,15,67
"2011","Lewisham 009D","E01003203","Total",980,529,105,424,451,54,30,93,181,10,21,62
"2011","Lewisham 010A","E01003336","Total",577,204,67,137,373,86,29,60,77,22,40,59
"2011","Lewisham 010B","E01003337","Total",600,173,22,151,427,94,28,119,56,22,51,57
"2011","Lewisham 010C","E01003342","Total",702,188,32,156,514,55,20,100,221,10,30,78
"2011","Lewisham 010D","E01003344","Total",719,220,35,185,499,36,36,83,172,16,31,125
"2011","Lewisham 010E","E01003345","Total",719,210,29,181,509,35,18,83,207,15,34,117
"2011","Lewisham 011A","E01003273","Total",666,153,53,100,513,36,34,90,110,12,43,188
"2011","Lewisham 011B","E01003277","Total",778,277,32,245,501,66,31,91,191,9,29,84
"2011","Lewisham 011C","E01003278","Total",805,284,56,228,521,42,45,77,168,15,37,137
"2011","Lewisham 011D","E01003279","Total",654,179,59,120,475,29,36,76,166,15,33,120
"2011","Lewisham 012A","E01003288","Total",794,340,131,209,454,80,46,64,110,12,48,94
"2011","Lewisham 012C","E01003290","Total",725,277,80,197,448,56,19,68,142,8,46,109
"2011","Lewisham 012D","E01003291","Total",682,262,83,179,420,109,27,76,107,17,19,65
"2011","Lewisham 012E","E01003296","Total",1021,460,54,406,561,70,35,102,212,15,31,96
"2011","Lewisham 012F","E01033327","Total",679,255,52,203,424,33,31,78,156,7,21,98
"2011","Lewisham 012G","E01033341","Total",551,173,24,149,378,88,19,65,109,11,30,56
"2011","Lewisham 013A","E01003282","Total",1047,374,62,312,673,57,46,108,234,21,48,159
"2011","Lewisham 013B","E01003283","Total",923,335,74,261,588,23,54,166,194,32,38,81
"2011","Lewisham 013C","E01003284","Total",748,221,61,160,527,34,53,124,185,9,38,84
"2011","Lewisham 013D","E01003286","Total",786,343,138,205,443,82,55,81,105,16,39,65
"2011","Lewisham 014A","E01003272","Total",798,245,46,199,553,44,41,102,170,15,36,145
"2011","Lewisham 014B","E01003274","Total",721,232,46,186,489,47,34,119,150,11,42,86
"2011","Lewisham 014C","E01003275","Total",640,211,64,147,429,48,39,80,94,21,69,78
"2011","Lewisham 014D","E01003276","Total",700,160,39,121,540,56,53,137,111,14,62,107
"2011","Lewisham 015A","E01003225","Total",590,115,36,79,475,22,50,117,147,7,35,97
"2011","Lewisham 015B","E01003231","Total",687,238,49,189,449,40,35,109,140,12,34,79
"2011","Lewisham 015C","E01003232","Total",649,153,40,113,496,23,50,139,119,13,44,108
"2011","Lewisham 015D","E01003233","Total",669,171,44,127,498,30,52,107,154,14,40,101
"2011","Lewisham 016A","E01003280","Total",651,181,63,118,470,88,55,77,104,17,46,83
"2011","Lewisham 016B","E01003281","Total",601,177,62,115,424,19,57,104,91,19,46,88
"2011","Lewisham 016C","E01003285","Total",767,307,84,223,460,36,51,97,166,9,31,70
"2011","Lewisham 016D","E01003287","Total",797,231,61,170,566,23,60,146,177,18,38,104
"2011","Lewisham 017A","E01003292","Total",702,234,52,182,468,45,41,83,178,8,33,80
"2011","Lewisham 017B","E01003293","Total",676,241,40,201,435,69,33,84,137,10,32,70
"2011","Lewisham 017D","E01003295","Total",653,211,30,181,442,55,32,87,108,14,54,92
"2011","Lewisham 017E","E01033320","Total",645,244,49,195,401,39,29,77,126,21,35,74
"2011","Lewisham 017F","E01033322","Total",594,216,14,202,378,40,9,52,183,10,14,70
"2011","Lewisham 018A","E01003319","Total",752,283,88,195,469,72,42,92,86,20,67,90
"2011","Lewisham 018B","E01003320","Total",650,241,42,199,409,70,31,79,100,21,38,70
"2011","Lewisham 018C","E01003323","Total",624,222,51,171,402,53,28,67,106,16,48,84
"2011","Lewisham 018D","E01003325","Total",722,238,45,193,484,106,39,91,103,25,48,72
"2011","Lewisham 019A","E01003226","Total",709,191,47,144,518,23,34,122,191,13,31,104
"2011","Lewisham 019B","E01003227","Total",678,206,60,146,472,21,46,116,127,14,41,107
"2011","Lewisham 019C","E01003228","Total",673,204,52,152,469,31,46,128,182,10,16,56
"2011","Lewisham 019D","E01003229","Total",742,323,77,246,419,64,50,75,115,13,36,66
"2011","Lewisham 019E","E01003230","Total",866,312,61,251,554,83,29,109,182,18,45,88
"2011","Lewisham 020A","E01003317","Total",688,181,51,130,507,37,49,82,96,70,42,131
"2011","Lewisham 020B","E01003318","Total",705,308,33,275,397,74,20,66,115,8,51,63
"2011","Lewisham 020C","E01003321","Total",810,307,55,252,503,58,43,138,122,12,51,79
"2011","Lewisham 020D","E01003322","Total",593,215,48,167,378,40,36,79,85,13,31,94
"2011","Lewisham 020E","E01003324","Total",713,341,65,276,372,62,29,91,91,14,20,65
"2011","Lewisham 021A","E01003254","Total",602,180,62,118,422,17,66,96,132,11,28,72
"2011","Lewisham 021B","E01003255","Total",964,423,40,383,541,42,27,98,270,15,21,68
"2011","Lewisham 021C","E01003260","Total",681,154,40,114,527,90,56,103,128,19,35,96
"2011","Lewisham 021D","E01003261","Total",619,181,39,142,438,47,40,103,133,13,34,68
"2011","Lewisham 021E","E01003262","Total",624,220,38,182,404,59,31,89,143,17,21,44
"2011","Lewisham 022A","E01003217","Total",622,158,60,98,464,45,58,87,101,22,66,85
"2011","Lewisham 022B","E01003218","Total",539,128,43,85,411,25,49,85,79,31,44,98
"2011","Lewisham 022C","E01003220","Total",604,197,31,166,407,41,48,71,89,21,45,92
"2011","Lewisham 022D","E01003222","Total",629,194,48,146,435,56,60,85,72,14,60,88
"2011","Lewisham 022E","E01003224","Total",626,164,46,118,462,42,48,78,101,24,62,107
"2011","Lewisham 023A","E01003263","Total",739,282,112,170,457,90,49,90,111,20,35,62
"2011","Lewisham 023B","E01003268","Total",718,253,78,175,465,39,47,95,135,12,43,94
"2011","Lewisham 023C","E01003269","Total",647,192,55,137,455,61,53,81,121,13,36,90
"2011","Lewisham 023D","E01003270","Total",678,214,46,168,464,25,55,104,114,15,37,114
"2011","Lewisham 023E","E01003271","Total",637,117,50,67,520,22,100,93,124,17,45,119
"2011","Lewisham 024A","E01003307","Total",627,180,59,121,447,41,42,106,123,12,35,88
"2011","Lewisham 024B","E01003308","Total",734,235,54,181,499,59,30,108,134,18,72,78
"2011","Lewisham 024C","E01003314","Total",683,203,34,169,480,50,34,89,172,17,39,79
"2011","Lewisham 024D","E01003315","Total",599,222,46,176,377,39,21,77,154,11,19,56
"2011","Lewisham 024E","E01003316","Total",609,172,49,123,437,35,36,94,137,14,41,80
"2011","Lewisham 025A","E01003216","Total",689,231,37,194,458,33,40,78,95,33,77,102
"2011","Lewisham 025B","E01003219","Total",631,196,71,125,435,28,58,73,81,20,72,103
"2011","Lewisham 025C","E01003221","Total",769,251,60,191,518,73,53,78,119,35,51,109
"2011","Lewisham 025D","E01003223","Total",603,142,58,84,461,23,78,63,77,27,71,122
"2011","Lewisham 026A","E01003346","Total",598,180,81,99,418,67,46,87,74,13,51,80
"2011","Lewisham 026B","E01003349","Total",541,156,55,101,385,73,32,94,56,20,52,58
"2011","Lewisham 026C","E01003351","Total",592,187,98,89,405,84,53,80,61,17,51,59
"2011","Lewisham 026D","E01003354","Total",701,264,50,214,437,54,39,102,99,17,59,67
"2011","Lewisham 027A","E01003309","Total",645,259,92,167,386,82,39,68,64,13,44,76
"2011","Lewisham 027B","E01003310","Total",756,312,48,264,444,72,20,68,183,11,33,57
"2011","Lewisham 027C","E01003311","Total",605,149,55,94,456,19,65,99,116,12,40,105
"2011","Lewisham 027D","E01003312","Total",779,290,55,235,489,63,50,107,131,17,21,100
"2011","Lewisham 027E","E01003313","Total",670,228,49,179,442,114,24,88,112,17,27,60
"2011","Lewisham 028A","E01003256","Total",931,337,81,256,594,101,61,103,181,15,35,98
"2011","Lewisham 028B","E01003257","Total",735,286,111,175,449,63,64,100,113,22,18,69
"2011","Lewisham 028C","E01003258","Total",594,195,36,159,399,91,25,87,76,21,51,48
"2011","Lewisham 028D","E01003259","Total",756,270,67,203,486,52,50,104,187,6,31,56
"2011","Lewisham 029A","E01003193","Total",666,240,78,162,426,46,57,88,93,17,41,84
"2011","Lewisham 029B","E01003194","Total",716,269,97,172,447,72,50,69,78,20,61,97
"2011","Lewisham 029C","E01003195","Total",637,206,62,144,431,52,50,82,102,28,38,79
"2011","Lewisham 029D","E01003196","Total",624,182,86,96,442,65,38,82,70,34,54,99
"2011","Lewisham 029E","E01003197","Total",625,191,80,111,434,64,33,87,86,20,55,89
"2011","Lewisham 030A","E01003347","Total",638,148,39,109,490,161,28,95,58,23,63,62
"2011","Lewisham 030B","E01003348","Total",571,171,72,99,400,38,65,75,73,20,50,79
"2011","Lewisham 030C","E01003350","Total",519,122,52,70,397,70,47,78,69,21,50,62
"2011","Lewisham 030D","E01003352","Total",735,246,97,149,489,66,69,73,92,29,62,98
"2011","Lewisham 030E","E01003353","Total",632,161,71,90,471,17,63,97,79,30,56,129
"2011","Lewisham 031A","E01003264","Total",728,284,136,148,444,49,60,94,123,14,33,71
"2011","Lewisham 031B","E01003265","Total",680,233,51,182,447,99,32,85,127,10,46,48
"2011","Lewisham 031C","E01003266","Total",757,302,120,182,455,60,69,77,91,23,59,76
"2011","Lewisham 031D","E01003267","Total",598,166,74,92,432,60,49,69,72,27,60,95
"2011","Lewisham 033A","E01003329","Total",666,201,54,147,465,62,39,97,134,17,33,83
"2011","Lewisham 033B","E01003330","Total",662,212,98,114,450,117,55,77,95,14,37,55
"2011","Lewisham 033C","E01003331","Total",572,198,91,107,374,48,52,55,77,20,38,84
"2011","Lewisham 033D","E01003332","Total",679,261,75,186,418,39,41,92,140,14,33,59
"2011","Lewisham 033E","E01003334","Total",778,335,75,260,443,61,32,84,148,11,29,78
"2011","Lewisham 034A","E01003189","Total",624,185,70,115,439,76,44,91,62,30,61,75
"2011","Lewisham 034B","E01003190","Total",809,265,53,212,544,143,23,136,131,19,36,56
"2011","Lewisham 034C","E01003191","Total",665,250,67,183,415,117,28,63,102,11,34,60
"2011","Lewisham 034D","E01003192","Total",741,321,77,244,420,93,44,70,78,22,51,62
"2011","Lewisham 035A","E01003326","Total",638,248,86,162,390,50,45,86,112,13,34,50
"2011","Lewisham 035B","E01003327","Total",714,222,68,154,492,49,53,89,127,15,33,126
"2011","Lewisham 035C","E01003328","Total",833,356,102,254,477,56,49,98,159,13,29,73
"2011","Lewisham 035D","E01003333","Total",657,253,63,190,404,49,31,88,98,19,33,86
"2011","Lewisham 035E","E01003335","Total",594,211,58,153,383,70,32,69,87,16,39,70
"2011","Lewisham 037A","E01003236","Total",648,188,72,116,460,98,56,83,90,26,46,61
"2011","Lewisham 037B","E01003237","Total",608,179,70,109,429,88,56,72,87,13,47,66
"2011","Lewisham 037C","E01003238","Total",565,160,56,104,405,80,43,100,76,14,35,57
"2011","Lewisham 037D","E01003239","Total",564,172,70,102,392,70,45,74,69,18,53,63
"2011","Lewisham 037E","E01032564","Total",508,147,63,84,361,71,33,69,64,29,43,52
"2011","Lewisham 038A","E01003235","Total",523,189,71,118,334,32,42,69,60,10,43,78
"2011","Lewisham 038B","E01003240","Total",725,199,74,125,526,91,69,104,103,24,39,96
"2011","Lewisham 038C","E01003241","Total",695,305,131,174,390,37,68,69,72,18,40,86
"2011","Lewisham 038D","E01003243","Total",581,214,88,126,367,52,62,72,64,16,37,64
"2011","Lewisham 038E","E01032565","Total",644,292,130,162,352,52,49,63,83,19,51,35
"2011","Lewisham 039A","E01003298","Total",475,136,40,96,339,40,15,73,79,14,42,76
"2011","Lewisham 039B","E01003300","Total",561,188,43,145,373,69,22,57,88,7,44,86
"2011","Lewisham 039C","E01003303","Total",560,195,47,148,365,57,24,41,90,17,47,89
"2011","Lewisham 039D","E01003304","Total",903,394,45,349,509,53,23,77,206,15,45,90
"2011","Lewisham 039E","E01032579","Total",711,327,38,289,384,72,12,56,129,14,34,67
"2011","Newham 001A","E01003543","Total",850,228,41,187,622,49,37,141,111,28,92,164
"2011","Newham 001B","E01003544","Total",664,169,46,123,495,56,39,88,89,16,75,132
"2011","Newham 001C","E01003546","Total",588,129,35,94,459,51,19,80,54,39,98,118
"2011","Newham 001D","E01003550","Total",631,173,59,114,458,38,30,83,93,26,62,126
"2011","Newham 002A","E01003576","Total",710,263,84,179,447,70,23,90,67,48,65,84
"2011","Newham 002B","E01003581","Total",486,64,21,43,422,37,23,57,52,24,113,116
"2011","Newham 002C","E01003582","Total",499,105,32,73,394,46,34,53,55,36,74,96
"2011","Newham 002D","E01003583","Total",539,102,39,63,437,36,25,72,42,43,95,124
"2011","Newham 003A","E01003578","Total",601,140,20,120,461,57,10,89,64,38,85,118
"2011","Newham 003B","E01003584","Total",638,154,40,114,484,44,36,83,79,21,89,132
"2011","Newham 003C","E01003586","Total",509,98,24,74,411,31,24,41,53,22,93,147
"2011","Newham 003D","E01003590","Total",572,223,56,167,349,46,18,62,70,29,54,70
"2011","Newham 004A","E01003579","Total",499,95,34,61,404,23,27,58,42,35,117,102
"2011","Newham 004B","E01003585","Total",407,54,23,31,353,17,28,38,39,26,110,95
"2011","Newham 004C","E01003587","Total",823,190,57,133,633,56,33,129,124,34,87,170
"2011","Newham 004D","E01003591","Total",671,156,47,109,515,60,28,76,84,33,101,133
"2011","Newham 005A","E01003528","Total",431,112,44,68,319,34,21,60,32,33,65,74
"2011","Newham 005B","E01003575","Total",491,98,26,72,393,37,20,68,52,34,91,91
"2011","Newham 005C","E01003577","Total",673,210,80,130,463,77,33,97,60,55,69,72
"2011","Newham 005D","E01003580","Total",615,165,49,116,450,55,34,100,62,51,69,79
"2011","Newham 006A","E01003545","Total",644,221,46,175,423,64,23,55,86,26,63,106
"2011","Newham 006B","E01003548","Total",852,249,105,144,603,50,41,93,128,17,84,190
"2011","Newham 006C","E01003549","Total",790,231,57,174,559,48,39,82,150,17,70,153
"2011","Newham 006D","E01003557","Total",651,213,28,185,438,34,22,68,86,22,94,112
"2011","Newham 007A","E01003547","Total",699,197,47,150,502,38,39,85,119,28,59,134
"2011","Newham 007B","E01003555","Total",500,114,28,86,386,11,39,34,61,19,100,122
"2011","Newham 007C","E01003561","Total",481,76,24,52,405,21,24,49,31,37,95,148
"2011","Newham 007D","E01003567","Total",540,117,32,85,423,35,24,70,51,21,85,137
"2011","Newham 008A","E01003556","Total",629,218,51,167,411,42,17,56,91,22,60,123
"2011","Newham 008B","E01003558","Total",491,134,18,116,357,21,24,42,53,30,81,106
"2011","Newham 008C","E01003570","Total",585,143,29,114,442,19,33,61,45,26,118,140
"2011","Newham 008D","E01003571","Total",586,90,27,63,496,16,34,61,47,31,145,162
"2011","Newham 008E","E01003572","Total",446,63,23,40,383,27,21,58,42,19,99,117
"2011","Newham 009A","E01003551","Total",586,138,20,118,448,44,25,85,106,13,61,114
"2011","Newham 009B","E01003553","Total",733,233,40,193,500,71,27,66,111,28,59,138
"2011","Newham 009C","E01003554","Total",623,163,41,122,460,32,28,55,91,12,63,179
"2011","Newham 009D","E01003559","Total",1001,271,41,230,730,58,31,118,234,22,70,197
"2011","Newham 010A","E01003529","Total",597,71,25,46,526,23,34,45,37,35,122,230
"2011","Newham 010B","E01003530","Total",468,63,19,44,405,13,33,48,32,20,110,149
"2011","Newham 010C","E01003531","Total",516,80,33,47,436,9,30,55,49,18,123,152
"2011","Newham 010D","E01003532","Total",513,79,41,38,434,15,36,42,36,19,126,160
"2011","Newham 010E","E01003534","Total",643,106,29,77,537,25,39,73,62,56,128,154
"2011","Newham 011A","E01003533","Total",482,101,40,61,381,21,25,37,25,30,104,139
"2011","Newham 011B","E01003560","Total",448,54,19,35,394,14,32,35,34,38,107,134
"2011","Newham 011C","E01003563","Total",538,80,13,67,458,15,25,64,65,40,115,134
"2011","Newham 011D","E01003588","Total",454,74,24,50,380,24,30,36,37,32,111,110
"2011","Newham 011E","E01003589","Total",512,98,21,77,414,13,22,62,51,34,105,127
"2011","Newham 012A","E01003616","Total",658,219,42,177,439,42,21,58,131,5,49,133
"2011","Newham 012B","E01003617","Total",1103,351,97,254,752,51,44,86,247,27,70,227
"2011","Newham 012C","E01003618","Total",823,222,54,168,601,39,20,74,204,13,71,180
"2011","Newham 012D","E01003619","Total",1087,500,88,412,587,55,18,87,239,17,39,132
"2011","Newham 013C","E01003615","Total",643,193,65,128,450,27,33,62,94,23,72,139
"2011","Newham 013E","E01033578","Total",603,197,17,180,406,50,0,58,212,5,13,68
"2011","Newham 013F","E01033579","Total",618,210,13,197,408,23,2,46,231,7,17,82
"2011","Newham 013G","E01033583","Total",1205,366,45,321,839,67,52,92,266,30,85,247
"2011","Newham 013H","E01033586","Total",597,212,24,188,385,41,21,67,133,15,40,68
"2011","Newham 014A","E01003562","Total",576,86,25,61,490,9,33,47,64,32,108,197
"2011","Newham 014B","E01003564","Total",672,120,31,89,552,28,16,78,74,47,123,186
"2011","Newham 014C","E01003565","Total",496,88,25,63,408,12,19,78,51,32,81,135
"2011","Newham 014D","E01003566","Total",507,116,36,80,391,27,30,51,40,35,83,125
"2011","Newham 015A","E01003625","Total",484,94,22,72,390,35,15,66,51,25,92,106
"2011","Newham 015B","E01003626","Total",420,57,15,42,363,12,22,39,49,21,109,111
"2011","Newham 015C","E01003627","Total",432,73,20,53,359,11,26,48,38,12,108,116
"2011","Newham 015D","E01003628","Total",420,36,15,21,384,14,25,49,44,32,96,124
"2011","Newham 015E","E01003629","Total",481,93,37,56,388,16,24,79,39,36,88,106
"2011","Newham 016A","E01003552","Total",544,129,27,102,415,44,28,47,87,26,80,103
"2011","Newham 016B","E01003596","Total",577,156,59,97,421,41,26,77,68,19,77,113
"2011","Newham 016C","E01003597","Total",475,124,30,94,351,15,17,51,41,24,97,106
"2011","Newham 016D","E01003635","Total",611,128,23,105,483,29,34,56,82,20,69,193
"2011","Newham 017A","E01003568","Total",594,92,18,74,502,17,34,44,63,31,129,184
"2011","Newham 017B","E01003569","Total",509,78,24,54,431,15,40,42,51,18,105,160
"2011","Newham 017C","E01003573","Total",542,87,33,54,455,20,25,50,42,32,133,153
"2011","Newham 017D","E01003574","Total",798,204,76,128,594,34,43,68,73,37,123,216
"2011","Newham 018A","E01003520","Total",583,133,65,68,450,21,28,58,47,30,94,172
"2011","Newham 018B","E01003521","Total",623,100,31,69,523,19,21,77,68,29,103,206
"2011","Newham 018C","E01003522","Total",550,96,34,62,454,24,32,94,50,45,86,123
"2011","Newham 018D","E01003525","Total",519,86,23,63,433,11,25,44,46,33,116,158
"2011","Newham 018E","E01003526","Total",550,135,51,84,415,22,23,59,50,22,122,117
"2011","Newham 019A","E01003488","Total",669,237,83,154,432,47,35,87,53,27,85,98
"2011","Newham 019B","E01003489","Total",520,98,32,66,422,43,38,67,29,43,90,112
"2011","Newham 019C","E01003490","Total",539,117,23,94,422,33,22,73,44,40,93,117
"2011","Newham 019D","E01003524","Total",598,142,49,93,456,18,26,64,51,31,123,143
"2011","Newham 020A","E01003631","Total",727,227,34,193,500,46,29,96,150,15,56,108
"2011","Newham 020B","E01003632","Total",749,175,49,126,574,49,33,83,108,39,85,177
"2011","Newham 020C","E01003633","Total",685,248,52,196,437,60,31,70,66,30,77,103
"2011","Newham 020D","E01003634","Total",602,152,49,103,450,53,30,40,87,28,67,145
"2011","Newham 020E","E01003636","Total",702,207,48,159,495,60,41,69,107,36,74,108
"2011","Newham 021A","E01003598","Total",658,208,37,171,450,73,21,86,86,37,68,79
"2011","Newham 021B","E01003600","Total",690,241,69,172,449,52,26,91,73,37,77,93
"2011","Newham 021C","E01003630","Total",731,238,61,177,493,44,40,64,114,35,87,109
"2011","Newham 021D","E01003637","Total",593,146,53,93,447,25,29,68,81,14,88,142
"2011","Newham 022A","E01003491","Total",637,196,104,92,441,20,43,54,50,14,98,162
"2011","Newham 022B","E01003592","Total",555,133,42,91,422,31,29,81,56,20,96,109
"2011","Newham 022C","E01003599","Total",488,125,55,70,363,25,20,49,47,27,77,118
"2011","Newham 022D","E01003606","Total",675,158,53,105,517,42,37,101,82,35,91,129
"2011","Newham 023A","E01003535","Total",548,150,45,105,398,45,25,60,50,33,86,99
"2011","Newham 023B","E01003536","Total",598,130,46,84,468,64,29,91,72,33,91,88
"2011","Newham 023C","E01003621","Total",442,56,17,39,386,18,27,71,33,32,118,87
"2011","Newham 023D","E01003622","Total",496,123,38,85,373,29,30,68,44,33,78,91
"2011","Newham 023E","E01003623","Total",490,78,38,40,412,36,29,74,49,43,92,89
"2011","Newham 024A","E01003523","Total",669,193,78,115,476,30,44,80,66,34,98,124
"2011","Newham 024B","E01003527","Total",570,129,48,81,441,27,44,88,71,42,73,96
"2011","Newham 024C","E01003537","Total",668,156,56,100,512,42,37,108,74,34,95,122
"2011","Newham 024D","E01003542","Total",668,173,75,98,495,64,35,98,91,46,84,77
"2011","Newham 024E","E01003624","Total",493,99,35,64,394,42,27,57,62,30,86,90
"2011","Newham 025A","E01003492","Total",536,97,33,64,439,17,30,51,46,39,130,126
"2011","Newham 025B","E01003493","Total",732,198,64,134,534,19,29,84,91,38,107,166
"2011","Newham 025C","E01003494","Total",645,122,37,85,523,43,38,134,79,43,80,106
"2011","Newham 025D","E01003495","Total",650,126,45,81,524,34,34,99,89,47,95,126
"2011","Newham 026A","E01003594","Total",540,112,21,91,428,42,18,67,72,23,79,127
"2011","Newham 026B","E01003595","Total",581,229,89,140,352,38,28,54,60,19,63,90
"2011","Newham 026C","E01003602","Total",605,122,48,74,483,42,31,72,71,21,92,154
"2011","Newham 026D","E01003607","Total",560,115,23,92,445,58,17,84,92,19,74,101
"2011","Newham 027A","E01003496","Total",591,224,28,196,367,49,13,50,98,7,59,91
"2011","Newham 027B","E01003498","Total",674,218,41,177,456,57,33,72,101,31,56,106
"2011","Newham 027C","E01003500","Total",732,194,49,145,538,81,24,94,107,28,64,140
"2011","Newham 027D","E01003593","Total",559,183,36,147,376,44,16,70,58,20,59,109
"2011","Newham 028A","E01003601","Total",705,178,46,132,527,68,40,88,79,35,95,122
"2011","Newham 028B","E01003603","Total",624,114,38,76,510,71,24,105,80,36,79,115
"2011","Newham 028C","E01003605","Total",724,227,72,155,497,43,34,82,63,46,93,136
"2011","Newham 028D","E01003608","Total",714,164,38,126,550,52,35,104,117,33,88,121
"2011","Newham 029A","E01003538","Total",652,171,55,116,481,51,35,86,53,46,95,115
"2011","Newham 029B","E01003539","Total",681,133,42,91,548,48,44,117,61,34,115,129
"2011","Newham 029C","E01003540","Total",595,131,48,83,464,49,40,91,70,37,87,90
"2011","Newham 029D","E01003541","Total",570,105,40,65,465,47,35,79,55,46,108,95
"2011","Newham 030A","E01003499","Total",862,308,146,162,554,88,53,96,73,39,81,124
"2011","Newham 030B","E01003501","Total",715,183,40,143,532,65,40,91,89,29,75,143
"2011","Newham 030C","E01003502","Total",669,217,59,158,452,49,34,68,81,16,82,122
"2011","Newham 030D","E01003503","Total",647,242,80,162,405,55,26,66,77,26,69,86
"2011","Newham 031A","E01003507","Total",807,294,101,193,513,61,31,68,101,31,87,134
"2011","Newham 031B","E01003508","Total",555,151,50,101,404,59,37,64,63,27,65,89
"2011","Newham 031C","E01003509","Total",795,268,84,184,527,112,35,90,101,19,56,114
"2011","Newham 031D","E01003604","Total",785,169,35,134,616,73,28,145,102,50,86,132
"2011","Newham 032A","E01003483","Total",492,122,44,78,370,41,12,71,69,21,57,99
"2011","Newham 032B","E01003484","Total",566,122,8,114,444,48,12,95,116,19,71,83
"2011","Newham 032C","E01003516","Total",652,194,43,151,458,72,33,62,71,27,97,96
"2011","Newham 032D","E01003518","Total",588,163,28,135,425,32,29,93,87,18,73,93
"2011","Newham 032E","E01003519","Total",484,109,26,83,375,33,14,47,65,15,83,118
"2011","Newham 033A","E01003480","Total",662,221,42,179,441,43,19,92,98,13,76,100
"2011","Newham 033B","E01003482","Total",1033,301,22,279,732,85,11,158,246,16,80,136
"2011","Newham 033C","E01003486","Total",455,162,83,79,293,50,14,43,51,10,48,77
"2011","Newham 033D","E01003487","Total",424,125,10,115,299,30,7,50,48,26,73,65
"2011","Newham 034A","E01003497","Total",622,173,76,97,449,52,42,62,81,21,77,114
"2011","Newham 034D","E01003506","Total",489,125,39,86,364,31,35,39,58,31,68,102
"2011","Newham 034F","E01033574","Total",579,241,3,238,338,1,4,35,217,7,12,62
"2011","Newham 034G","E01033575","Total",545,213,0,213,332,5,2,27,222,3,3,70
"2011","Newham 034H","E01033576","Total",618,236,25,211,382,24,18,39,192,11,21,77
"2011","Newham 034I","E01033584","Total",564,149,51,98,415,61,26,81,94,24,54,75
"2011","Newham 034J","E01033585","Total",954,324,103,221,630,55,44,80,161,24,100,166
"2011","Newham 035A","E01003479","Total",612,181,23,158,431,54,23,127,116,13,43,55
"2011","Newham 035B","E01003481","Total",500,159,48,111,341,46,29,61,79,12,47,67
"2011","Newham 035C","E01003485","Total",560,139,37,102,421,53,24,92,82,20,63,87
"2011","Newham 035D","E01003513","Total",558,126,15,111,432,39,18,111,104,17,76,67
"2011","Newham 036A","E01003511","Total",452,83,26,57,369,79,31,51,58,27,56,67
"2011","Newham 036B","E01003512","Total",678,204,86,118,474,77,37,76,81,24,57,122
"2011","Newham 036C","E01003514","Total",532,141,36,105,391,51,24,76,73,21,57,89
"2011","Newham 036D","E01003515","Total",755,307,99,208,448,74,32,83,107,26,53,73
"2011","Newham 036E","E01003517","Total",605,161,36,125,444,58,21,83,93,25,78,86
"2011","Newham 037A","E01003609","Total",1058,289,62,227,769,112,33,137,228,39,60,160
"2011","Newham 037C","E01003611","Total",700,247,61,186,453,107,16,84,84,33,56,73
"2011","Newham 037E","E01033577","Total",608,167,9,158,441,41,17,61,176,15,35,96
"2011","Newham 037F","E01033580","Total",659,174,3,171,485,12,6,96,237,6,11,117
"2011","Newham 037G","E01033581","Total",714,247,51,196,467,73,26,86,111,18,63,90
"2011","Newham 037H","E01033582","Total",631,215,6,209,416,33,5,90,181,7,23,77
"2011","Southwark 001A","E01004029","Total",819,249,20,229,570,42,15,91,252,8,11,151
"2011","Southwark 001B","E01004032","Total",714,173,16,157,541,10,13,99,246,4,18,151
"2011","Southwark 001C","E01004053","Total",877,307,35,272,570,23,24,99,277,4,17,126
"2011","Southwark 001D","E01004054","Total",782,242,22,220,540,15,25,89,294,7,17,93
"2011","Southwark 001E","E01004055","Total",513,146,61,85,367,46,34,49,91,15,39,93
"2011","Southwark 002A","E01003927","Total",995,384,93,291,611,56,38,50,315,3,20,129
"2011","Southwark 002B","E01003929","Total",1074,424,72,352,650,34,27,65,357,5,19,143
"2011","Southwark 002C","E01003934","Total",811,420,114,306,391,30,48,41,191,7,11,63
"2011","Southwark 002D","E01003935","Total",451,194,39,155,257,22,17,28,106,4,22,58
"2011","Southwark 002E","E01003939","Total",836,299,31,268,537,32,14,56,233,15,22,165
"2011","Southwark 003A","E01003976","Total",916,327,74,253,589,74,21,81,261,11,30,111
"2011","Southwark 003E","E01004027","Total",993,358,31,327,635,62,28,68,306,14,28,129
"2011","Southwark 003F","E01032637","Total",641,278,5,273,363,7,8,31,288,1,2,26
"2011","Southwark 003G","E01032638","Total",653,272,14,258,381,1,19,45,259,2,1,54
"2011","Southwark 003H","E01032640","Total",672,253,7,246,419,0,12,49,280,1,3,74
"2011","Southwark 003I","E01032646","Total",737,227,18,209,510,11,14,51,285,10,19,120
"2011","Southwark 003J","E01032803","Total",658,194,8,186,464,24,5,45,290,6,4,90
"2011","Southwark 003K","E01032834","Total",666,313,11,302,353,2,16,38,257,0,2,38
"2011","Southwark 004A","E01003975","Total",667,216,40,176,451,85,22,70,120,22,46,86
"2011","Southwark 004B","E01003978","Total",908,352,49,303,556,59,16,77,276,12,28,88
"2011","Southwark 004C","E01004022","Total",1146,405,92,313,741,83,60,107,263,11,29,188
"2011","Southwark 004D","E01004023","Total",703,286,98,188,417,51,41,73,100,11,30,111
"2011","Southwark 004E","E01004028","Total",713,268,52,216,445,54,25,68,135,16,32,115
"2011","Southwark 006A","E01003938","Total",790,274,35,239,516,56,17,81,189,11,48,114
"2011","Southwark 006B","E01003940","Total",620,228,52,176,392,60,15,63,91,22,39,102
"2011","Southwark 006C","E01003941","Total",912,303,54,249,609,34,27,66,321,7,24,130
"2011","Southwark 006D","E01003942","Total",561,176,55,121,385,55,30,62,82,16,38,102
"2011","Southwark 006E","E01003979","Total",809,326,39,287,483,50,21,61,205,9,29,108
"2011","Southwark 006F","E01003981","Total",693,283,61,222,410,34,29,35,170,9,24,109
"2011","Southwark 007A","E01004030","Total",726,311,60,251,415,32,26,48,168,4,24,113
"2011","Southwark 007B","E01004031","Total",880,280,49,231,600,53,43,80,235,21,47,121
"2011","Southwark 007C","E01004033","Total",699,283,89,194,416,61,27,52,138,6,39,93
"2011","Southwark 007D","E01004034","Total",635,198,55,143,437,80,33,72,101,11,35,105
"2011","Southwark 007E","E01004036","Total",806,240,61,179,566,112,39,98,128,31,53,105
"2011","Southwark 008A","E01004056","Total",906,286,62,224,620,39,30,102,251,5,31,162
"2011","Southwark 008B","E01004057","Total",668,214,35,179,454,48,21,75,179,4,27,100
"2011","Southwark 008C","E01004058","Total",855,298,12,286,557,10,17,71,339,3,7,110
"2011","Southwark 008D","E01004059","Total",662,192,13,179,470,6,10,41,242,2,8,161
"2011","Southwark 008E","E01004060","Total",785,247,55,192,538,71,27,68,194,19,40,119
"2011","Southwark 009A","E01003936","Total",552,155,16,139,397,6,13,38,226,7,11,96
"2011","Southwark 009B","E01003937","Total",734,251,19,232,483,22,13,29,265,11,26,117
"2011","Southwark 009C","E01003943","Total",549,180,50,130,369,60,11,51,84,17,46,100
"2011","Southwark 009F","E01032720","Total",681,219,32,187,462,51,15,60,144,17,64,111
"2011","Southwark 010A","E01003977","Total",800,348,72,276,452,58,43,57,142,11,38,103
"2011","Southwark 010B","E01004037","Total",878,309,39,270,569,68,17,103,221,22,41,97
"2011","Southwark 010C","E01004038","Total",920,242,19,223,678,118,14,148,185,23,61,129
"2011","Southwark 010D","E01004042","Total",762,289,92,197,473,57,65,57,109,15,33,137
"2011","Southwark 010E","E01004043","Total",599,212,58,154,387,30,56,41,110,12,31,107
"2011","Southwark 011A","E01003986","Total",549,222,85,137,327,69,41,52,59,15,27,64
"2011","Southwark 011B","E01003987","Total",754,262,104,158,492,62,56,91,115,14,44,110
"2011","Southwark 011C","E01004024","Total",819,358,83,275,461,74,31,73,105,17,41,120
"2011","Southwark 011D","E01004035","Total",687,243,90,153,444,88,50,82,79,16,24,105
"2011","Southwark 012A","E01003960","Total",766,230,50,180,536,61,41,71,171,13,31,148
"2011","Southwark 012B","E01003961","Total",897,370,127,243,527,63,54,85,122,25,44,134
"2011","Southwark 012E","E01003994","Total",622,220,58,162,402,27,29,50,122,11,41,122
"2011","Southwark 012F","E01032722","Total",932,319,90,229,613,64,55,80,182,11,43,178
"2011","Southwark 013A","E01003980","Total",847,381,97,284,466,51,28,47,129,8,46,157
"2011","Southwark 013B","E01004039","Total",633,192,22,170,441,37,15,66,165,13,50,95
"2011","Southwark 013C","E01004040","Total",680,230,71,159,450,75,22,85,75,29,63,101
"2011","Southwark 013D","E01004041","Total",699,252,49,203,447,56,29,85,118,24,53,82
"2011","Southwark 013E","E01004044","Total",556,185,47,138,371,58,26,55,89,19,45,79
"2011","Southwark 014A","E01003992","Total",590,176,65,111,414,68,27,77,85,19,43,95
"2011","Southwark 014B","E01003995","Total",738,368,76,292,370,67,23,49,137,14,12,68
"2011","Southwark 014D","E01003998","Total",632,250,63,187,382,17,30,45,169,6,27,88
"2011","Southwark 014E","E01003999","Total",602,186,40,146,416,55,22,56,133,22,28,100
"2011","Southwark 014F","E01032639","Total",688,194,28,166,494,42,19,48,237,4,21,123
"2011","Southwark 014G","E01032719","Total",623,291,62,229,332,28,20,61,136,8,18,61
"2011","Southwark 015A","E01003964","Total",730,218,33,185,512,48,25,81,117,21,69,151
"2011","Southwark 015B","E01003966","Total",745,201,60,141,544,73,48,83,116,13,56,155
"2011","Southwark 015C","E01003968","Total",525,172,34,138,353,44,20,59,57,27,60,86
"2011","Southwark 015D","E01003971","Total",608,130,26,104,478,87,33,101,67,30,76,84
"2011","Southwark 015E","E01003974","Total",489,172,44,128,317,49,25,51,53,17,47,75
"2011","Southwark 016A","E01003963","Total",662,217,34,183,445,78,27,78,94,20,47,101
"2011","Southwark 016B","E01003967","Total",600,140,38,102,460,72,32,82,83,18,50,123
"2011","Southwark 016C","E01003970","Total",579,202,52,150,377,54,35,61,66,21,56,84
"2011","Southwark 016D","E01003972","Total",714,257,37,220,457,66,23,73,139,24,35,97
"2011","Southwark 016E","E01003973","Total",739,273,77,196,466,84,23,80,131,17,32,99
"2011","Southwark 017A","E01003923","Total",730,240,46,194,490,44,23,89,159,16,34,125
"2011","Southwark 017B","E01003969","Total",764,234,39,195,530,56,25,68,180,8,57,136
"2011","Southwark 017C","E01003991","Total",559,238,113,125,321,43,44,36,71,10,24,93
"2011","Southwark 017D","E01003993","Total",630,178,54,124,452,71,17,80,82,32,49,121
"2011","Southwark 017E","E01003997","Total",472,138,30,108,334,21,21,56,91,16,33,96
"2011","Southwark 018A","E01003983","Total",730,194,46,148,536,78,47,85,101,41,67,117
"2011","Southwark 018B","E01003988","Total",898,342,108,234,556,71,50,88,121,35,61,130
"2011","Southwark 018C","E01003989","Total",720,214,27,187,506,111,14,88,74,35,80,104
"2011","Southwark 018D","E01003990","Total",769,208,68,140,561,82,32,103,107,32,84,121
"2011","Southwark 018E","E01004007","Total",436,112,34,78,324,49,19,47,53,20,60,76
"2011","Southwark 019A","E01003912","Total",571,148,36,112,423,85,19,85,67,25,60,82
"2011","Southwark 019B","E01004011","Total",724,156,27,129,568,101,25,122,97,27,91,105
"2011","Southwark 019C","E01004012","Total",934,257,31,226,677,98,27,115,178,40,83,136
"2011","Southwark 019D","E01004013","Total",606,148,29,119,458,74,25,84,87,19,68,101
"2011","Southwark 019E","E01004014","Total",710,240,62,178,470,82,23,99,105,14,61,86
"2011","Southwark 020A","E01003911","Total",742,188,30,158,554,71,18,105,157,32,66,105
"2011","Southwark 020B","E01003916","Total",830,253,33,220,577,65,26,87,157,16,60,166
"2011","Southwark 020C","E01003917","Total",787,336,99,237,451,30,34,97,128,12,38,112
"2011","Southwark 020D","E01003918","Total",653,244,79,165,409,58,31,71,87,23,43,96
"2011","Southwark 020E","E01003925","Total",527,178,43,135,349,37,29,68,96,21,40,58
"2011","Southwark 021A","E01003919","Total",702,235,49,186,467,54,20,66,147,22,43,115
"2011","Southwark 021B","E01003920","Total",766,283,45,238,483,83,26,103,108,31,43,89
"2011","Southwark 021C","E01003921","Total",673,318,41,277,355,47,19,67,111,11,25,75
"2011","Southwark 021D","E01003922","Total",821,289,60,229,532,90,27,80,154,21,58,102
"2011","Southwark 021E","E01003924","Total",802,274,55,219,528,82,40,109,117,27,37,116
"2011","Southwark 021F","E01003926","Total",540,161,51,110,379,44,31,55,74,19,45,111
"2011","Southwark 022B","E01004008","Total",808,240,48,192,568,93,39,92,111,24,64,145
"2011","Southwark 022D","E01004010","Total",601,179,35,144,422,64,18,79,96,19,56,90
"2011","Southwark 022E","E01004067","Total",831,263,63,200,568,66,28,104,138,23,77,132
"2011","Southwark 022F","E01032805","Total",940,288,58,230,652,82,41,96,131,38,100,164
"2011","Southwark 023A","E01003984","Total",856,329,99,230,527,49,36,78,151,17,49,147
"2011","Southwark 023B","E01004003","Total",755,302,62,240,453,66,38,87,106,10,44,102
"2011","Southwark 023C","E01004004","Total",1069,387,89,298,682,86,43,88,230,20,54,161
"2011","Southwark 023D","E01004005","Total",882,330,67,263,552,107,24,102,144,24,56,95
"2011","Southwark 023E","E01004006","Total",772,235,59,176,537,69,41,90,147,8,40,142
"2011","Southwark 024A","E01003913","Total",800,285,55,230,515,34,44,103,171,13,31,119
"2011","Southwark 024B","E01003914","Total",722,211,51,160,511,32,37,81,158,21,44,138
"2011","Southwark 024C","E01003915","Total",811,288,50,238,523,58,43,82,139,18,55,128
"2011","Southwark 024D","E01004050","Total",652,219,31,188,433,21,33,68,191,9,30,81
"2011","Southwark 024E","E01004052","Total",798,281,75,206,517,28,38,85,220,20,27,99
"2011","Southwark 025A","E01004061","Total",772,284,47,237,488,27,32,96,173,12,29,119
"2011","Southwark 025B","E01004062","Total",830,289,79,210,541,74,29,114,162,21,52,89
"2011","Southwark 025C","E01004063","Total",847,294,103,191,553,42,36,107,185,15,27,141
"2011","Southwark 025D","E01004065","Total",625,168,30,138,457,25,35,102,158,13,39,85
"2011","Southwark 025E","E01004066","Total",844,249,31,218,595,82,35,129,141,21,46,141
"2011","Southwark 026A","E01004000","Total",839,320,72,248,519,51,36,106,163,18,31,114
"2011","Southwark 026B","E01004001","Total",718,277,98,179,441,63,39,73,98,29,48,91
"2011","Southwark 026C","E01004019","Total",912,265,32,233,647,80,32,127,187,24,76,121
"2011","Southwark 026D","E01004064","Total",808,269,85,184,539,76,41,119,128,19,56,100
"2011","Southwark 026E","E01004068","Total",829,328,130,198,501,66,43,85,115,24,68,100
"2011","Southwark 027A","E01004045","Total",601,175,27,148,426,88,15,96,90,22,46,69
"2011","Southwark 027B","E01004047","Total",607,172,49,123,435,66,28,89,98,24,49,81
"2011","Southwark 027C","E01004048","Total",645,178,47,131,467,36,22,112,159,10,41,87
"2011","Southwark 027D","E01004049","Total",507,119,29,90,388,79,22,83,84,11,37,72
"2011","Southwark 027E","E01004051","Total",613,212,52,160,401,23,39,71,167,12,13,76
"2011","Southwark 028A","E01003953","Total",980,377,54,323,603,37,33,102,263,17,21,130
"2011","Southwark 028B","E01003955","Total",822,298,83,215,524,23,43,105,199,11,30,113
"2011","Southwark 028C","E01004015","Total",690,250,73,177,440,31,27,103,161,18,30,70
"2011","Southwark 028D","E01004021","Total",1032,382,62,320,650,36,40,118,327,8,31,90
"2011","Southwark 028E","E01004046","Total",674,191,44,147,483,28,35,109,182,12,37,80
"2011","Southwark 029A","E01004002","Total",639,174,49,125,465,28,32,116,142,12,28,107
"2011","Southwark 029B","E01004016","Total",934,244,69,175,690,72,53,172,197,27,53,116
"2011","Southwark 029C","E01004017","Total",627,161,49,112,466,44,56,96,143,14,31,82
"2011","Southwark 029D","E01004020","Total",730,241,61,180,489,98,31,104,120,21,39,76
"2011","Southwark 030A","E01003952","Total",692,184,40,144,508,19,37,117,197,14,19,105
"2011","Southwark 030B","E01003954","Total",670,191,47,144,479,18,42,111,189,20,32,67
"2011","Southwark 030C","E01003956","Total",720,198,44,154,522,27,35,135,202,15,24,84
"2011","Southwark 030D","E01004071","Total",663,202,69,133,461,31,41,117,145,17,26,84
"2011","Southwark 030E","E01004072","Total",617,119,41,78,498,12,39,139,132,27,50,99
"2011","Southwark 031A","E01004069","Total",497,89,46,43,408,11,66,106,83,19,48,75
"2011","Southwark 031B","E01004070","Total",779,209,76,133,570,32,68,135,156,30,42,107
"2011","Southwark 031C","E01004073","Total",736,166,53,113,570,31,53,159,166,25,51,85
"2011","Southwark 031D","E01004074","Total",631,117,65,52,514,13,62,114,105,45,66,109
"2011","Southwark 031E","E01004075","Total",657,135,69,66,522,17,73,151,101,44,55,81
"2011","Southwark 032A","E01003949","Total",871,310,59,251,561,48,41,113,234,16,38,71
"2011","Southwark 032B","E01003950","Total",798,260,69,191,538,88,57,74,146,16,62,95
"2011","Southwark 032C","E01003957","Total",714,186,44,142,528,37,42,120,180,20,26,103
"2011","Southwark 032D","E01003958","Total",699,208,58,150,491,24,45,124,150,23,34,91
"2011","Southwark 032E","E01004018","Total",780,188,62,126,592,28,50,169,207,19,23,96
"2011","Southwark 033A","E01003945","Total",730,216,82,134,514,37,74,109,174,14,25,81
"2011","Southwark 033B","E01003946","Total",726,212,93,119,514,37,92,105,139,20,44,77
"2011","Southwark 033C","E01003947","Total",612,178,63,115,434,101,40,75,87,19,53,59
"2011","Southwark 033D","E01003948","Total",742,284,69,215,458,36,31,117,202,6,19,47
"2011","Southwark 033E","E01003951","Total",571,160,66,94,411,34,66,80,98,15,31,87
"2011","Southwark 034A","E01003930","Total",458,185,45,140,273,16,20,39,115,13,11,59
"2011","Southwark 034B","E01003932","Total",651,270,49,221,381,44,25,47,124,9,31,101
"2011","Southwark 034C","E01003933","Total",537,164,41,123,373,12,28,48,131,6,44,104
"2011","Southwark 034D","E01032583","Total",644,265,51,214,379,27,28,51,151,7,26,89
"2011","Southwark 034E","E01032584","Total",577,209,47,162,368,40,24,39,139,9,21,96
"2011","Tower Hamlets 001A","E01004222","Total",1048,402,143,259,646,69,53,90,204,42,74,114
"2011","Tower Hamlets 001B","E01004223","Total",938,355,125,230,583,100,53,76,173,20,43,118
"2011","Tower Hamlets 001C","E01004224","Total",806,250,67,183,556,44,43,57,206,33,44,129
"2011","Tower Hamlets 001D","E01004226","Total",676,203,44,159,473,66,27,64,139,34,41,102
"2011","Tower Hamlets 002A","E01004197","Total",964,338,31,307,626,48,31,88,245,36,52,126
"2011","Tower Hamlets 002B","E01004198","Total",606,243,84,159,363,26,29,42,103,25,49,89
"2011","Tower Hamlets 002C","E01004199","Total",574,187,47,140,387,61,23,49,69,43,66,76
"2011","Tower Hamlets 002D","E01004201","Total",619,216,51,165,403,37,21,58,123,25,42,97
"2011","Tower Hamlets 003A","E01004228","Total",769,246,56,190,523,37,37,85,179,17,28,140
"2011","Tower Hamlets 003B","E01004230","Total",803,230,78,152,573,59,41,78,157,39,40,159
"2011","Tower Hamlets 003C","E01004232","Total",603,159,26,133,444,20,30,51,145,18,26,154
"2011","Tower Hamlets 003D","E01004233","Total",751,306,102,204,445,41,44,55,125,45,52,83
"2011","Tower Hamlets 003E","E01004234","Total",903,251,47,204,652,48,46,103,242,21,26,166
"2011","Tower Hamlets 004A","E01004225","Total",1147,436,23,413,711,42,25,72,459,9,12,92
"2011","Tower Hamlets 004C","E01004229","Total",551,163,41,122,388,37,23,50,114,24,44,96
"2011","Tower Hamlets 004D","E01004231","Total",629,172,56,116,457,78,32,62,90,45,49,101
"2011","Tower Hamlets 004E","E01032764","Total",643,243,36,207,400,37,15,42,218,4,18,66
"2011","Tower Hamlets 004F","E01032765","Total",645,215,27,188,430,52,18,36,188,12,40,84
"2011","Tower Hamlets 004G","E01032784","Total",692,214,44,170,478,43,14,37,275,9,32,68
"2011","Tower Hamlets 005A","E01004200","Total",585,177,13,164,408,9,13,26,197,19,25,119
"2011","Tower Hamlets 005B","E01004202","Total",713,230,17,213,483,32,19,44,230,22,45,91
"2011","Tower Hamlets 005C","E01004203","Total",689,194,39,155,495,28,25,42,182,36,39,143
"2011","Tower Hamlets 005D","E01004204","Total",631,249,85,164,382,25,37,44,99,27,49,101
"2011","Tower Hamlets 006A","E01004311","Total",644,244,63,181,400,30,36,60,123,26,33,92
"2011","Tower Hamlets 006B","E01004314","Total",493,165,61,104,328,15,25,46,147,12,13,70
"2011","Tower Hamlets 006C","E01004315","Total",718,281,64,217,437,16,30,33,178,12,43,125
"2011","Tower Hamlets 006D","E01004318","Total",630,254,34,220,376,60,19,53,109,28,27,80
"2011","Tower Hamlets 007A","E01004259","Total",812,334,48,286,478,49,13,41,223,19,25,108
"2011","Tower Hamlets 007B","E01004260","Total",636,168,52,116,468,43,32,73,116,40,50,114
"2011","Tower Hamlets 007C","E01004263","Total",529,165,64,101,364,39,27,42,97,25,49,85
"2011","Tower Hamlets 007D","E01004266","Total",583,176,54,122,407,30,29,56,101,20,43,128
"2011","Tower Hamlets 008A","E01004235","Total",513,172,38,134,341,54,17,65,76,38,48,43
"2011","Tower Hamlets 008B","E01004236","Total",497,116,35,81,381,36,18,51,63,38,94,81
"2011","Tower Hamlets 008C","E01004237","Total",506,200,38,162,306,41,17,51,108,15,25,49
"2011","Tower Hamlets 008D","E01004238","Total",1058,345,26,319,713,84,23,123,255,37,92,99
"2011","Tower Hamlets 008E","E01004239","Total",533,139,35,104,394,39,39,49,70,36,69,92
"2011","Tower Hamlets 009A","E01004312","Total",628,236,75,161,392,28,40,42,105,28,53,96
"2011","Tower Hamlets 009B","E01004313","Total",812,247,55,192,565,65,31,54,189,47,48,131
"2011","Tower Hamlets 009C","E01004316","Total",455,159,10,149,296,34,12,35,83,13,29,90
"2011","Tower Hamlets 009D","E01004317","Total",1193,407,18,389,786,36,19,55,422,19,58,177
"2011","Tower Hamlets 010A","E01004261","Total",550,175,35,140,375,22,26,41,59,28,58,141
"2011","Tower Hamlets 010B","E01004262","Total",495,170,46,124,325,17,27,40,66,12,45,118
"2011","Tower Hamlets 010C","E01004264","Total",457,96,42,54,361,30,23,54,55,37,61,101
"2011","Tower Hamlets 010E","E01032785","Total",616,181,17,164,435,33,7,60,248,14,16,57
"2011","Tower Hamlets 010F","E01032786","Total",674,269,60,209,405,44,28,62,128,44,27,72
"2011","Tower Hamlets 011A","E01004207","Total",515,189,49,140,326,28,18,40,93,13,48,86
"2011","Tower Hamlets 011B","E01004209","Total",466,154,24,130,312,33,13,44,44,41,58,79
"2011","Tower Hamlets 011D","E01004212","Total",720,318,41,277,402,29,18,49,156,27,39,84
"2011","Tower Hamlets 011F","E01032787","Total",793,208,48,160,585,32,21,92,96,54,126,164
"2011","Tower Hamlets 012A","E01004240","Total",574,136,29,107,438,54,36,58,67,47,86,90
"2011","Tower Hamlets 012B","E01004241","Total",570,185,45,140,385,38,30,69,73,40,69,66
"2011","Tower Hamlets 012C","E01004242","Total",898,264,18,246,634,67,16,113,217,44,83,94
"2011","Tower Hamlets 012D","E01004267","Total",707,246,21,225,461,30,13,54,194,22,47,101
"2011","Tower Hamlets 012E","E01004268","Total",688,248,52,196,440,44,21,70,138,41,59,67
"2011","Tower Hamlets 013A","E01004205","Total",688,201,30,171,487,53,20,77,91,39,91,116
"2011","Tower Hamlets 013B","E01004206","Total",554,222,47,175,332,31,26,44,57,16,65,93
"2011","Tower Hamlets 013C","E01004208","Total",788,280,23,257,508,7,9,44,253,12,53,130
"2011","Tower Hamlets 013D","E01004211","Total",720,315,34,281,405,11,5,33,226,3,32,95
"2011","Tower Hamlets 014A","E01004269","Total",726,249,80,169,477,37,31,65,114,41,51,138
"2011","Tower Hamlets 014B","E01004270","Total",745,155,26,129,590,26,16,64,176,28,55,225
"2011","Tower Hamlets 014C","E01004271","Total",548,158,35,123,390,40,23,89,70,55,44,69
"2011","Tower Hamlets 014D","E01004272","Total",639,166,33,133,473,52,23,67,70,68,110,83
"2011","Tower Hamlets 014E","E01004273","Total",594,150,30,120,444,46,19,69,78,54,86,92
"2011","Tower Hamlets 015A","E01004306","Total",687,205,34,171,482,11,21,45,204,14,62,125
"2011","Tower Hamlets 015B","E01004307","Total",1014,471,19,452,543,14,18,49,338,8,20,96
"2011","Tower Hamlets 015C","E01004308","Total",504,148,31,117,356,13,21,36,86,25,53,122
"2011","Tower Hamlets 015D","E01004309","Total",902,323,48,275,579,30,26,59,187,33,95,149
"2011","Tower Hamlets 015E","E01004310","Total",793,320,60,260,473,10,22,36,205,17,72,111
"2011","Tower Hamlets 016A","E01004283","Total",756,258,61,197,498,32,28,59,122,38,111,108
"2011","Tower Hamlets 016B","E01004287","Total",854,306,107,199,548,46,54,93,143,45,66,101
"2011","Tower Hamlets 016C","E01004289","Total",670,236,74,162,434,22,38,49,94,35,61,135
"2011","Tower Hamlets 016D","E01004290","Total",575,230,67,163,345,17,27,29,135,18,18,101
"2011","Tower Hamlets 017A","E01004322","Total",502,207,56,151,295,21,25,49,90,21,32,57
"2011","Tower Hamlets 017B","E01004323","Total",480,142,36,106,338,14,12,48,88,13,58,105
"2011","Tower Hamlets 017C","E01004324","Total",485,133,30,103,352,20,25,44,53,33,75,102
"2011","Tower Hamlets 017D","E01004326","Total",623,240,51,189,383,26,23,54,146,20,37,77
"2011","Tower Hamlets 018A","E01004245","Total",433,92,13,79,341,46,8,65,39,38,98,47
"2011","Tower Hamlets 018B","E01004246","Total",747,236,49,187,511,51,36,66,151,23,73,111
"2011","Tower Hamlets 018C","E01004248","Total",441,134,58,76,307,50,12,43,45,50,51,56
"2011","Tower Hamlets 018D","E01004249","Total",758,261,52,209,497,70,25,73,115,50,72,92
"2011","Tower Hamlets 019A","E01004284","Total",884,316,68,248,568,34,20,121,200,30,84,79
"2011","Tower Hamlets 019B","E01004285","Total",658,162,43,119,496,39,22,70,66,73,126,100
"2011","Tower Hamlets 019C","E01004286","Total",817,259,61,198,558,58,41,69,146,53,105,86
"2011","Tower Hamlets 019D","E01004288","Total",525,149,48,101,376,39,23,62,69,44,69,70
"2011","Tower Hamlets 020A","E01004243","Total",614,168,36,132,446,62,34,54,85,53,59,99
"2011","Tower Hamlets 020B","E01004244","Total",686,257,74,183,429,51,40,70,94,35,69,70
"2011","Tower Hamlets 020C","E01004247","Total",714,230,62,168,484,57,31,82,110,33,73,98
"2011","Tower Hamlets 020D","E01004250","Total",866,269,72,197,597,83,36,103,139,63,79,94
"2011","Tower Hamlets 021A","E01004319","Total",595,160,30,130,435,25,21,45,88,30,96,130
"2011","Tower Hamlets 021C","E01004321","Total",711,315,49,266,396,22,20,53,117,19,66,99
"2011","Tower Hamlets 021D","E01004325","Total",1033,284,17,267,749,29,16,52,378,18,49,207
"2011","Tower Hamlets 021E","E01032766","Total",601,222,7,215,379,22,4,31,220,14,23,65
"2011","Tower Hamlets 021F","E01032767","Total",767,292,4,288,475,6,3,25,276,3,11,151
"2011","Tower Hamlets 022A","E01004298","Total",635,239,57,182,396,39,25,51,119,16,65,81
"2011","Tower Hamlets 022B","E01004300","Total",522,205,54,151,317,28,28,34,87,27,56,57
"2011","Tower Hamlets 022C","E01004304","Total",653,196,53,143,457,38,26,57,112,38,91,95
"2011","Tower Hamlets 022D","E01004305","Total",699,218,70,148,481,55,39,42,119,41,83,102
"2011","Tower Hamlets 023A","E01004251","Total",779,262,86,176,517,54,38,82,115,44,69,115
"2011","Tower Hamlets 023B","E01004254","Total",1046,357,13,344,689,20,13,85,451,9,28,83
"2011","Tower Hamlets 023C","E01004255","Total",647,250,19,231,397,33,14,66,120,32,55,77
"2011","Tower Hamlets 023D","E01004258","Total",713,273,44,229,440,17,32,74,207,11,31,68
"2011","Tower Hamlets 024A","E01004252","Total",1107,389,48,341,718,78,31,117,260,55,68,109
"2011","Tower Hamlets 024B","E01004253","Total",829,244,77,167,585,100,45,98,109,37,82,114
"2011","Tower Hamlets 024C","E01004256","Total",611,170,49,121,441,59,32,69,76,34,65,106
"2011","Tower Hamlets 024D","E01004257","Total",618,145,35,110,473,77,26,75,76,54,67,98
"2011","Tower Hamlets 025B","E01004301","Total",413,114,27,87,299,16,12,39,62,23,69,78
"2011","Tower Hamlets 025C","E01004302","Total",637,174,29,145,463,41,9,90,108,47,93,75
"2011","Tower Hamlets 025D","E01004303","Total",967,358,65,293,609,58,37,103,192,47,55,117
"2011","Tower Hamlets 025E","E01032768","Total",696,276,7,269,420,12,8,60,283,5,8,44
"2011","Tower Hamlets 025F","E01032769","Total",593,218,11,207,375,23,13,51,210,16,12,50
"2011","Tower Hamlets 026A","E01004292","Total",818,309,24,285,509,12,24,71,242,6,23,131
"2011","Tower Hamlets 026B","E01004294","Total",877,401,42,359,476,16,21,56,267,12,27,77
"2011","Tower Hamlets 026C","E01004295","Total",500,134,31,103,366,25,23,80,73,43,53,69
"2011","Tower Hamlets 026D","E01004296","Total",684,268,52,216,416,28,18,60,154,25,46,85
"2011","Tower Hamlets 027A","E01004291","Total",1051,533,55,478,518,25,34,52,320,12,13,62
"2011","Tower Hamlets 027B","E01004293","Total",1133,522,82,440,611,9,31,89,357,5,28,92
"2011","Tower Hamlets 027C","E01004297","Total",909,364,45,319,545,16,33,90,289,8,17,92
"2011","Tower Hamlets 028A","E01004215","Total",1168,408,62,346,760,88,40,83,286,38,68,157
"2011","Tower Hamlets 028B","E01004219","Total",851,258,24,234,593,60,14,82,207,47,79,104
"2011","Tower Hamlets 028D","E01004221","Total",802,250,22,228,552,35,21,75,269,18,40,94
"2011","Tower Hamlets 028E","E01032776","Total",631,317,2,315,314,14,6,43,213,4,8,26
"2011","Tower Hamlets 028F","E01032777","Total",514,178,7,171,336,29,2,46,172,12,30,45
"2011","Tower Hamlets 028G","E01032778","Total",564,205,5,200,359,34,2,56,207,2,6,52
"2011","Tower Hamlets 028H","E01032779","Total",565,220,2,218,345,47,4,53,204,11,2,24
"2011","Tower Hamlets 028I","E01032780","Total",647,194,2,192,453,5,13,71,277,3,5,79
"2011","Tower Hamlets 030A","E01004214","Total",665,252,56,196,413,71,24,84,87,25,53,69
"2011","Tower Hamlets 030B","E01004216","Total",737,235,52,183,502,31,23,92,232,14,24,86
"2011","Tower Hamlets 030C","E01004217","Total",779,303,77,226,476,42,38,88,151,20,30,107
"2011","Tower Hamlets 030D","E01004218","Total",731,215,40,175,516,33,31,95,206,13,32,106
"2011","Tower Hamlets 031A","E01004274","Total",654,159,16,143,495,51,17,83,131,30,80,103
"2011","Tower Hamlets 031B","E01004275","Total",768,218,33,185,550,38,32,102,216,19,47,96
"2011","Tower Hamlets 031C","E01004276","Total",996,342,12,330,654,13,13,101,396,2,10,119
"2011","Tower Hamlets 031D","E01004281","Total",831,307,9,298,524,23,7,103,265,7,20,99
"2011","Tower Hamlets 031F","E01032775","Total",600,245,6,239,355,15,10,60,231,4,6,29
"2011","Tower Hamlets 031G","E01032783","Total",661,275,42,233,386,22,15,53,185,5,20,86
"2011","Tower Hamlets 032A","E01004280","Total",769,252,36,216,517,42,28,105,199,25,47,71
"2011","Tower Hamlets 032B","E01032770","Total",572,212,43,169,360,25,16,48,194,10,15,52
"2011","Tower Hamlets 032C","E01032772","Total",544,281,26,255,263,8,13,23,119,10,38,52
"2011","Tower Hamlets 032D","E01032773","Total",852,407,3,404,445,61,2,55,272,21,15,19
"2011","Tower Hamlets 032E","E01032774","Total",583,211,13,198,372,61,8,58,160,11,33,41
"2011","Tower Hamlets 033A","E01004277","Total",898,363,14,349,535,7,17,105,359,1,6,40
"2011","Tower Hamlets 033B","E01032771","Total",546,239,5,234,307,20,6,29,184,21,22,25
"2011","Tower Hamlets 033C","E01032781","Total",771,271,11,260,500,12,11,65,327,8,19,58
"2011","Tower Hamlets 033D","E01032782","Total",776,364,9,355,412,45,3,38,224,28,38,36
"2011","Wandsworth 001A","E01004560","Total",959,365,58,307,594,32,43,87,283,12,18,119
"2011","Wandsworth 001B","E01004566","Total",821,376,105,271,445,14,41,85,206,6,11,82
"2011","Wandsworth 001C","E01004582","Total",976,331,77,254,645,36,72,105,246,16,35,135
"2011","Wandsworth 001D","E01004583","Total",876,376,118,258,500,37,73,68,216,8,11,87
"2011","Wandsworth 002B","E01004562","Total",754,284,100,184,470,44,56,55,118,8,51,138
"2011","Wandsworth 002C","E01004563","Total",879,343,48,295,536,81,34,71,166,20,41,123
"2011","Wandsworth 002D","E01004564","Total",820,260,57,203,560,24,41,57,259,3,26,150
"2011","Wandsworth 002E","E01004567","Total",982,319,38,281,663,130,39,79,199,27,72,117
"2011","Wandsworth 002F","E01033098","Total",629,352,16,336,277,11,11,41,193,0,1,20
"2011","Wandsworth 002G","E01033100","Total",612,265,90,175,347,30,19,31,142,12,6,107
"2011","Wandsworth 002H","E01033132","Total",619,344,20,324,275,38,7,40,142,2,10,36
"2011","Wandsworth 003A","E01004539","Total",800,246,49,197,554,122,37,89,91,26,69,120
"2011","Wandsworth 003B","E01004540","Total",1002,416,97,319,586,62,39,84,239,21,36,105
"2011","Wandsworth 003C","E01004577","Total",907,343,116,227,564,27,50,84,242,16,29,116
"2011","Wandsworth 003D","E01004584","Total",703,227,45,182,476,110,42,72,92,23,36,101
"2011","Wandsworth 004B","E01004579","Total",744,275,67,208,469,35,48,84,160,19,26,97
"2011","Wandsworth 004C","E01004580","Total",892,287,44,243,605,41,43,75,240,15,38,153
"2011","Wandsworth 004D","E01004581","Total",892,355,83,272,537,20,57,60,229,10,32,129
"2011","Wandsworth 004E","E01033099","Total",456,163,28,135,293,27,16,31,109,7,16,87
"2011","Wandsworth 004F","E01033101","Total",663,275,26,249,388,3,22,38,271,1,6,47
"2011","Wandsworth 004G","E01033133","Total",636,251,20,231,385,26,14,46,243,6,8,42
"2011","Wandsworth 005A","E01004565","Total",815,258,59,199,557,45,27,65,293,6,18,103
"2011","Wandsworth 005B","E01004590","Total",807,298,89,209,509,50,64,74,161,13,28,119
"2011","Wandsworth 005C","E01004591","Total",811,283,49,234,528,24,26,54,261,8,25,130
"2011","Wandsworth 005D","E01004592","Total",795,299,91,208,496,41,56,81,208,6,22,82
"2011","Wandsworth 006A","E01004604","Total",593,97,32,65,496,5,56,136,134,45,33,87
"2011","Wandsworth 006B","E01004605","Total",785,268,103,165,517,26,55,111,191,21,20,93
"2011","Wandsworth 006C","E01004606","Total",754,224,50,174,530,12,34,99,275,10,5,95
"2011","Wandsworth 006D","E01004607","Total",718,203,51,152,515,5,57,122,186,26,29,90
"2011","Wandsworth 006E","E01004608","Total",785,269,91,178,516,20,43,81,236,5,22,109
"2011","Wandsworth 007A","E01004535","Total",731,243,41,202,488,131,31,84,95,24,38,85
"2011","Wandsworth 007B","E01004537","Total",799,276,82,194,523,87,35,60,147,15,42,137
"2011","Wandsworth 007C","E01004538","Total",909,352,97,255,557,86,36,70,190,17,40,118
"2011","Wandsworth 007D","E01004541","Total",762,321,121,200,441,59,47,48,127,14,35,111
"2011","Wandsworth 008A","E01004534","Total",825,251,52,199,574,21,44,91,224,7,18,169
"2011","Wandsworth 008B","E01004536","Total",928,324,49,275,604,73,26,75,234,16,29,151
"2011","Wandsworth 008C","E01004552","Total",913,252,28,224,661,8,12,70,383,6,16,166
"2011","Wandsworth 008D","E01004585","Total",858,261,52,209,597,20,48,88,278,5,17,141
"2011","Wandsworth 008E","E01004588","Total",858,243,37,206,615,19,20,103,305,17,12,139
"2011","Wandsworth 009A","E01004554","Total",653,171,37,134,482,13,30,120,186,22,19,92
"2011","Wandsworth 009B","E01004556","Total",590,123,26,97,467,8,36,174,130,30,31,58
"2011","Wandsworth 009C","E01004586","Total",848,289,35,254,559,12,23,74,278,8,16,148
"2011","Wandsworth 009D","E01004587","Total",735,223,46,177,512,9,33,109,187,18,14,142
"2011","Wandsworth 009E","E01004589","Total",706,164,30,134,542,7,31,86,256,23,20,119
"2011","Wandsworth 010A","E01004509","Total",1122,403,63,340,719,25,26,67,458,8,7,128
"2011","Wandsworth 010B","E01004511","Total",712,171,31,140,541,14,29,98,236,12,15,137
"2011","Wandsworth 010C","E01004602","Total",706,212,49,163,494,6,28,81,235,16,24,104
"2011","Wandsworth 010E","E01004609","Total",996,335,73,262,661,9,39,94,330,12,19,158
"2011","Wandsworth 010F","E01033093","Total",766,282,35,247,484,11,36,90,268,7,14,58
"2011","Wandsworth 010G","E01033135","Total",475,131,29,102,344,5,24,71,164,11,10,59
"2011","Wandsworth 011A","E01004506","Total",955,355,99,256,600,9,50,78,329,15,17,102
"2011","Wandsworth 011B","E01004638","Total",519,102,45,57,417,5,61,92,89,40,25,105
"2011","Wandsworth 011C","E01004639","Total",783,274,89,185,509,13,45,95,199,16,22,119
"2011","Wandsworth 011D","E01004640","Total",797,257,72,185,540,12,45,103,238,17,32,93
"2011","Wandsworth 011E","E01004641","Total",818,279,137,142,539,25,81,93,141,19,36,144
"2011","Wandsworth 012A","E01004508","Total",986,343,58,285,643,23,38,70,359,10,20,123
"2011","Wandsworth 012B","E01004510","Total",917,316,37,279,601,23,43,80,301,12,18,124
"2011","Wandsworth 012C","E01004514","Total",799,250,39,211,549,17,49,102,274,6,12,89
"2011","Wandsworth 012D","E01004515","Total",739,227,27,200,512,22,25,64,245,10,26,120
"2011","Wandsworth 012E","E01004551","Total",884,325,51,274,559,48,26,65,285,2,21,112
"2011","Wandsworth 013A","E01004568","Total",458,171,44,127,287,73,15,46,67,15,23,48
"2011","Wandsworth 013B","E01004574","Total",727,228,69,159,499,137,22,88,102,26,39,85
"2011","Wandsworth 013C","E01004575","Total",691,290,165,125,401,62,71,28,78,14,31,117
"2011","Wandsworth 013D","E01004576","Total",592,170,50,120,422,45,53,85,72,18,41,108
"2011","Wandsworth 014A","E01004500","Total",807,322,123,199,485,14,41,49,248,5,15,113
"2011","Wandsworth 014B","E01004501","Total",712,251,87,164,461,34,38,73,183,10,31,92
"2011","Wandsworth 014C","E01004503","Total",738,252,52,200,486,14,36,60,233,16,34,93
"2011","Wandsworth 014D","E01004505","Total",838,346,136,210,492,16,58,62,237,11,9,99
"2011","Wandsworth 014E","E01004507","Total",962,379,113,266,583,17,44,58,348,9,11,96
"2011","Wandsworth 015A","E01004553","Total",766,259,45,214,507,20,22,89,253,12,10,101
"2011","Wandsworth 015B","E01004557","Total",650,199,54,145,451,11,33,116,174,28,18,71
"2011","Wandsworth 015C","E01004558","Total",675,175,34,141,500,15,31,154,165,29,27,79
"2011","Wandsworth 015D","E01004559","Total",503,103,24,79,400,16,27,111,121,35,36,54
"2011","Wandsworth 015E","E01004619","Total",536,136,29,107,400,14,21,85,139,38,40,63
"2011","Wandsworth 016A","E01004572","Total",706,234,83,151,472,58,56,78,120,19,25,116
"2011","Wandsworth 016B","E01004642","Total",761,273,99,174,488,44,59,103,142,14,36,90
"2011","Wandsworth 016C","E01004643","Total",851,290,106,184,561,65,62,89,165,17,42,121
"2011","Wandsworth 016D","E01004644","Total",870,326,119,207,544,32,80,92,164,19,52,105
"2011","Wandsworth 016E","E01004645","Total",844,308,118,190,536,89,56,82,115,22,51,121
"2011","Wandsworth 017A","E01004477","Total",607,127,47,80,480,15,54,121,132,39,31,88
"2011","Wandsworth 017B","E01004478","Total",538,108,34,74,430,5,36,150,102,25,33,79
"2011","Wandsworth 017C","E01004479","Total",613,177,42,135,436,16,38,95,131,32,40,84
"2011","Wandsworth 017D","E01004550","Total",570,157,41,116,413,63,34,80,133,18,24,61
"2011","Wandsworth 017E","E01004555","Total",587,102,33,69,485,12,38,159,132,37,36,71
"2011","Wandsworth 018A","E01004494","Total",762,250,50,200,512,34,29,94,242,10,21,82
"2011","Wandsworth 018B","E01004513","Total",833,263,89,174,570,53,39,67,258,15,36,102
"2011","Wandsworth 018C","E01004600","Total",893,296,41,255,597,99,23,90,216,25,56,88
"2011","Wandsworth 018D","E01004601","Total",1006,350,91,259,656,40,51,111,271,22,46,115
"2011","Wandsworth 019A","E01004493","Total",803,274,44,230,529,21,20,88,268,15,21,96
"2011","Wandsworth 019B","E01004512","Total",618,184,36,148,434,16,31,93,176,26,30,62
"2011","Wandsworth 019C","E01004620","Total",702,206,48,158,496,21,36,120,206,20,19,74
"2011","Wandsworth 019D","E01004621","Total",659,184,38,146,475,9,33,75,201,23,49,85
"2011","Wandsworth 019E","E01004623","Total",712,189,52,137,523,18,34,136,208,25,24,78
"2011","Wandsworth 019F","E01004627","Total",631,159,39,120,472,13,55,116,130,32,30,96
"2011","Wandsworth 020A","E01004499","Total",713,222,41,181,491,26,30,63,236,16,20,100
"2011","Wandsworth 020B","E01004502","Total",670,184,40,144,486,5,53,98,177,30,36,87
"2011","Wandsworth 020C","E01004504","Total",566,121,46,75,445,3,57,106,132,23,44,80
"2011","Wandsworth 020D","E01004594","Total",590,133,42,91,457,7,33,122,110,37,35,113
"2011","Wandsworth 020E","E01004596","Total",646,169,55,114,477,13,40,127,162,16,33,86
"2011","Wandsworth 020F","E01004629","Total",609,148,55,93,461,22,66,84,125,19,40,105
"2011","Wandsworth 021A","E01004472","Total",742,213,60,153,529,13,41,94,219,16,24,122
"2011","Wandsworth 021B","E01004474","Total",918,329,40,289,589,20,20,58,351,11,18,111
"2011","Wandsworth 021C","E01004476","Total",824,333,58,275,491,16,34,43,254,13,16,115
"2011","Wandsworth 021D","E01004542","Total",618,147,38,109,471,16,33,116,155,25,26,100
"2011","Wandsworth 021E","E01004544","Total",606,171,35,136,435,15,26,102,143,31,26,92
"2011","Wandsworth 022A","E01004628","Total",911,289,49,240,622,38,31,101,266,20,49,117
"2011","Wandsworth 022B","E01004630","Total",679,187,63,124,492,85,40,86,103,26,45,107
"2011","Wandsworth 022C","E01004631","Total",643,245,64,181,398,43,21,73,133,19,29,80
"2011","Wandsworth 022D","E01004633","Total",623,166,55,111,457,73,21,68,114,23,43,115
"2011","Wandsworth 023A","E01004569","Total",737,210,65,145,527,53,50,86,114,28,48,148
"2011","Wandsworth 023B","E01004570","Total",745,267,121,146,478,65,39,57,90,36,33,158
"2011","Wandsworth 023C","E01004571","Total",651,217,106,111,434,46,43,60,89,12,38,146
"2011","Wandsworth 023D","E01004573","Total",631,213,67,146,418,30,47,74,110,7,34,116
"2011","Wandsworth 024A","E01004495","Total",523,120,29,91,403,21,23,40,125,23,67,104
"2011","Wandsworth 024B","E01004496","Total",951,305,42,263,646,13,20,84,396,4,16,113
"2011","Wandsworth 024C","E01004497","Total",541,123,47,76,418,16,39,101,106,12,46,98
"2011","Wandsworth 024D","E01004622","Total",533,206,47,159,327,23,21,41,170,15,16,41
"2011","Wandsworth 024E","E01004624","Total",624,140,44,96,484,14,43,97,158,13,35,124
"2011","Wandsworth 025A","E01004593","Total",852,301,57,244,551,24,38,113,250,10,23,93
"2011","Wandsworth 025B","E01004595","Total",796,252,57,195,544,26,35,124,242,6,26,85
"2011","Wandsworth 025C","E01004597","Total",779,245,65,180,534,25,47,158,174,18,27,85
"2011","Wandsworth 025D","E01004598","Total",818,249,31,218,569,12,19,116,314,3,13,92
"2011","Wandsworth 025E","E01004599","Total",575,127,46,81,448,8,35,156,126,25,24,74
"2011","Wandsworth 026A","E01004473","Total",746,218,53,165,528,16,34,96,235,9,18,120
"2011","Wandsworth 026B","E01004475","Total",622,181,34,147,441,18,31,56,222,11,21,82
"2011","Wandsworth 026C","E01004480","Total",678,165,36,129,513,11,22,73,237,10,17,143
"2011","Wandsworth 026D","E01004483","Total",1011,333,49,284,678,40,22,117,383,8,27,81
"2011","Wandsworth 026E","E01004484","Total",652,191,40,151,461,25,25,55,214,7,19,116
"2011","Wandsworth 026F","E01004486","Total",784,331,79,252,453,22,24,48,278,9,15,57
"2011","Wandsworth 027A","E01004543","Total",717,186,33,153,531,25,32,121,197,28,37,91
"2011","Wandsworth 027B","E01004545","Total",850,386,73,313,464,10,20,45,275,4,7,103
"2011","Wandsworth 027C","E01004546","Total",640,167,33,134,473,14,28,91,198,15,14,113
"2011","Wandsworth 027D","E01004549","Total",672,232,61,171,440,10,33,80,154,26,37,100
"2011","Wandsworth 027E","E01004625","Total",469,85,48,37,384,2,51,95,74,48,31,83
"2011","Wandsworth 027F","E01004626","Total",724,227,56,171,497,16,30,122,221,22,28,58
"2011","Wandsworth 028A","E01004632","Total",593,150,62,88,443,22,41,107,116,20,30,107
"2011","Wandsworth 028B","E01004634","Total",697,265,66,199,432,28,55,69,171,15,18,76
"2011","Wandsworth 028C","E01004635","Total",691,220,59,161,471,27,31,82,177,22,34,98
"2011","Wandsworth 028D","E01004636","Total",650,207,34,173,443,42,38,80,166,19,21,77
"2011","Wandsworth 028E","E01004637","Total",602,179,65,114,423,23,48,76,122,15,28,111
"2011","Wandsworth 029A","E01004481","Total",716,169,31,138,547,30,27,64,260,9,12,145
"2011","Wandsworth 029B","E01004488","Total",625,208,31,177,417,23,26,79,157,20,37,75
"2011","Wandsworth 029C","E01004547","Total",551,189,51,138,362,13,26,73,121,14,31,84
"2011","Wandsworth 029D","E01004548","Total",1054,454,99,355,600,35,36,50,331,12,29,107
"2011","Wandsworth 030A","E01004482","Total",626,171,42,129,455,29,32,51,142,20,45,136
"2011","Wandsworth 030B","E01004485","Total",691,199,67,132,492,17,37,74,185,13,38,128
"2011","Wandsworth 030C","E01004487","Total",715,268,27,241,447,25,24,67,210,25,24,72
"2011","Wandsworth 030D","E01004489","Total",612,231,25,206,381,26,24,57,141,27,41,65
"2011","Wandsworth 031A","E01004490","Total",614,144,42,102,470,5,29,120,185,10,30,91
"2011","Wandsworth 031B","E01004491","Total",971,537,45,492,434,48,24,75,167,19,37,64
"2011","Wandsworth 031C","E01004492","Total",744,233,46,187,511,28,26,89,205,13,27,123
"2011","Wandsworth 031D","E01004498","Total",784,237,43,194,547,7,24,114,293,10,11,88
"2011","Wandsworth 032A","E01004532","Total",644,193,36,157,451,33,30,88,178,15,27,80
"2011","Wandsworth 032B","E01004611","Total",570,130,40,90,440,25,48,63,99,16,43,146
"2011","Wandsworth 032C","E01004612","Total",558,101,31,70,457,23,40,64,87,32,64,147
"2011","Wandsworth 032D","E01004618","Total",527,109,37,72,418,10,41,70,82,17,50,148
"2011","Wandsworth 033A","E01004531","Total",649,152,63,89,497,51,40,88,128,23,54,113
"2011","Wandsworth 033B","E01004533","Total",569,142,41,101,427,68,28,71,134,12,25,89
"2011","Wandsworth 033C","E01004610","Total",632,108,44,64,524,16,52,73,108,16,85,174
"2011","Wandsworth 033D","E01004613","Total",677,251,103,148,426,52,41,61,102,16,49,105
"2011","Wandsworth 034A","E01004614","Total",855,269,74,195,586,40,29,84,206,13,33,181
"2011","Wandsworth 034B","E01004615","Total",757,257,80,177,500,95,47,74,128,21,44,91
"2011","Wandsworth 034C","E01004616","Total",816,207,34,173,609,32,34,76,221,18,46,182
"2011","Wandsworth 034D","E01004617","Total",638,199,44,155,439,26,23,51,124,20,41,154
"2011","Wandsworth 035A","E01004525","Total",659,134,32,102,525,28,33,70,163,17,54,160
"2011","Wandsworth 035B","E01004526","Total",655,208,52,156,447,25,28,65,171,10,35,113
"2011","Wandsworth 035C","E01004527","Total",578,131,41,90,447,18,47,75,100,23,45,139
"2011","Wandsworth 035D","E01004528","Total",655,214,58,156,441,69,36,79,136,12,34,75
"2011","Wandsworth 035E","E01004529","Total",902,265,66,199,637,48,25,119,280,16,43,106
"2011","Wandsworth 035F","E01004530","Total",789,241,60,181,548,29,36,94,213,19,32,125
"2011","Wandsworth 036A","E01004516","Total",510,91,42,49,419,21,35,104,68,25,66,100
"2011","Wandsworth 036B","E01004518","Total",650,175,46,129,475,38,43,108,106,22,54,104
"2011","Wandsworth 036C","E01004519","Total",632,159,70,89,473,42,43,91,110,23,46,118
"2011","Wandsworth 036D","E01004520","Total",459,96,41,55,363,26,42,77,70,19,50,79
"2011","Wandsworth 036E","E01004523","Total",722,326,137,189,396,31,40,73,109,13,46,84
"2011","Wandsworth 037A","E01004517","Total",810,268,54,214,542,53,23,107,207,18,48,86
"2011","Wandsworth 037B","E01004521","Total",768,215,47,168,553,49,36,128,157,31,54,98
"2011","Wandsworth 037C","E01004522","Total",628,170,41,129,458,55,29,106,121,23,39,85
"2011","Wandsworth 037D","E01004524","Total",774,355,117,238,419,70,32,70,119,17,38,73
"2011","Westminster 001A","E01004647","Total",685,277,130,147,408,19,70,80,128,15,27,69
"2011","Westminster 001B","E01004649","Total",716,261,83,178,455,21,79,103,124,10,44,74
"2011","Westminster 001C","E01004724","Total",850,384,101,283,466,24,52,82,166,18,31,93
"2011","Westminster 001D","E01004730","Total",804,324,125,199,480,22,101,100,144,18,25,70
"2011","Westminster 002A","E01004646","Total",616,164,72,92,452,24,57,100,104,39,52,76
"2011","Westminster 002B","E01004648","Total",1122,450,128,322,672,40,82,107,256,37,46,104
"2011","Westminster 002C","E01004650","Total",932,365,93,272,567,15,61,132,216,16,39,88
"2011","Westminster 002D","E01004710","Total",635,195,63,132,440,61,49,64,106,37,45,78
"2011","Westminster 002E","E01004711","Total",759,265,82,183,494,79,40,75,136,27,37,100
"2011","Westminster 003A","E01004651","Total",1137,618,131,487,519,16,56,104,241,13,23,66
"2011","Westminster 003B","E01004725","Total",799,429,200,229,370,41,49,76,99,15,37,53
"2011","Westminster 003C","E01004726","Total",824,337,100,237,487,19,73,88,156,15,41,95
"2011","Westminster 003D","E01004728","Total",808,379,157,222,429,24,68,71,160,12,20,74
"2011","Westminster 003E","E01004729","Total",856,467,206,261,389,34,57,60,110,19,34,75
"2011","Westminster 004A","E01004718","Total",850,309,57,252,541,73,41,77,163,16,47,124
"2011","Westminster 004B","E01004719","Total",786,243,64,179,543,75,44,108,160,30,36,90
"2011","Westminster 004C","E01004720","Total",777,231,90,141,546,55,61,90,126,34,52,128
"2011","Westminster 004D","E01004721","Total",879,353,123,230,526,68,66,90,126,22,56,98
"2011","Westminster 004E","E01004722","Total",849,245,61,184,604,80,46,85,108,54,110,121
"2011","Westminster 005A","E01004674","Total",843,307,106,201,536,62,49,60,138,35,57,135
"2011","Westminster 005B","E01004675","Total",1098,490,142,348,608,73,38,106,224,24,34,109
"2011","Westminster 005C","E01004677","Total",876,352,71,281,524,51,26,82,237,6,29,93
"2011","Westminster 005D","E01004678","Total",889,341,51,290,548,59,40,97,189,26,37,100
"2011","Westminster 005E","E01004679","Total",935,328,63,265,607,111,37,90,211,30,40,88
"2011","Westminster 005F","E01004723","Total",997,403,61,342,594,86,32,70,226,18,48,114
"2011","Westminster 006A","E01004676","Total",794,318,37,281,476,52,16,73,205,15,33,82
"2011","Westminster 006B","E01004706","Total",735,219,62,157,516,29,30,94,235,8,9,111
"2011","Westminster 006C","E01004707","Total",798,199,52,147,599,21,46,140,209,26,28,129
"2011","Westminster 006D","E01004708","Total",788,324,54,270,464,32,36,73,206,7,19,91
"2011","Westminster 006E","E01004756","Total",866,366,33,333,500,46,17,82,219,22,26,88
"2011","Westminster 007A","E01004701","Total",843,399,91,308,444,7,48,110,200,11,17,51
"2011","Westminster 007B","E01004703","Total",1027,368,103,265,659,22,87,140,216,33,45,116
"2011","Westminster 007D","E01004705","Total",700,264,48,216,436,13,38,98,193,17,19,58
"2011","Westminster 007E","E01004709","Total",765,284,65,219,481,37,46,75,182,18,37,86
"2011","Westminster 007F","E01033600","Total",644,282,55,227,362,13,35,57,181,10,17,49
"2011","Westminster 007G","E01033608","Total",735,349,32,317,386,19,24,53,204,13,12,61
"2011","Westminster 008A","E01004659","Total",961,466,78,388,495,12,48,47,250,10,16,112
"2011","Westminster 008B","E01004660","Total",873,352,87,265,521,13,65,87,210,14,24,108
"2011","Westminster 008C","E01004712","Total",842,394,84,310,448,13,67,55,223,1,16,73
"2011","Westminster 008D","E01004727","Total",977,377,67,310,600,18,75,94,263,7,19,124
"2011","Westminster 009A","E01004670","Total",948,325,154,171,623,97,63,72,91,50,135,115
"2011","Westminster 009E","E01004702","Total",994,330,114,216,664,73,65,107,128,44,78,169
"2011","Westminster 009F","E01033598","Total",502,190,74,116,312,43,40,34,69,27,37,62
"2011","Westminster 009G","E01033601","Total",589,198,102,96,391,43,35,54,91,25,56,87
"2011","Westminster 009H","E01033602","Total",645,226,72,154,419,77,37,71,80,25,48,81
"2011","Westminster 009I","E01033603","Total",600,267,46,221,333,38,19,44,126,10,23,73
"2011","Westminster 009J","E01033604","Total",620,314,33,281,306,36,11,54,106,9,24,66
"2011","Westminster 009K","E01033605","Total",815,301,106,195,514,67,61,78,99,35,60,114
"2011","Westminster 010A","E01004754","Total",600,219,95,124,381,58,42,56,49,29,46,101
"2011","Westminster 010B","E01004755","Total",963,387,34,353,576,68,29,96,194,29,48,112
"2011","Westminster 010C","E01004757","Total",600,172,53,119,428,56,27,67,86,32,44,116
"2011","Westminster 010F","E01032512","Total",989,307,66,241,682,123,54,133,170,56,50,96
"2011","Westminster 010G","E01032513","Total",567,234,84,150,333,48,33,45,76,25,36,70
"2011","Westminster 011A","E01004713","Total",939,415,89,326,524,9,64,87,247,7,13,97
"2011","Westminster 011B","E01004714","Total",1177,575,83,492,602,20,53,90,322,3,22,92
"2011","Westminster 011C","E01004716","Total",724,295,80,215,429,5,73,61,194,7,16,73
"2011","Westminster 011D","E01004717","Total",898,473,94,379,425,12,43,48,247,7,5,63
"2011","Westminster 011E","E01004762","Total",1136,603,141,462,533,20,85,66,222,12,36,92
"2011","Westminster 012A","E01004657","Total",827,431,72,359,396,8,48,63,194,9,11,63
"2011","Westminster 012B","E01004658","Total",744,390,60,330,354,29,28,52,144,6,17,78
"2011","Westminster 012C","E01004661","Total",892,424,71,353,468,26,47,46,172,15,23,139
"2011","Westminster 012D","E01004662","Total",1040,541,81,460,499,11,34,79,255,6,19,95
"2011","Westminster 012E","E01004663","Total",851,381,114,267,470,20,78,65,203,13,22,69
"2011","Westminster 013A","E01004715","Total",824,424,107,317,400,15,41,34,181,9,19,101
"2011","Westminster 013B","E01004763","Total",1076,612,66,546,464,7,15,25,317,3,7,90
"2011","Westminster 013D","E01004765","Total",1103,549,90,459,554,22,53,64,294,12,15,94
"2011","Westminster 013E","E01033595","Total",755,474,88,386,281,11,22,23,172,2,10,41
"2011","Westminster 013F","E01033596","Total",745,443,103,340,302,20,31,31,162,16,11,31
"2011","Westminster 014A","E01004653","Total",929,450,97,353,479,18,47,89,201,23,19,82
"2011","Westminster 014B","E01004654","Total",1204,570,91,479,634,27,52,96,341,15,22,81
"2011","Westminster 014D","E01004656","Total",1178,613,106,507,565,26,57,77,285,21,21,78
"2011","Westminster 014E","E01004760","Total",771,321,62,259,450,52,35,51,178,12,30,92
"2011","Westminster 014F","E01033606","Total",614,321,30,291,293,17,14,31,183,1,8,39
"2011","Westminster 014G","E01033607","Total",616,295,69,226,321,15,29,58,130,10,17,62
"2011","Westminster 015A","E01004680","Total",708,306,84,222,402,15,60,74,136,13,25,79
"2011","Westminster 015B","E01004683","Total",767,300,72,228,467,9,75,77,162,9,28,107
"2011","Westminster 015C","E01004684","Total",701,354,75,279,347,35,49,56,101,21,21,64
"2011","Westminster 015E","E01004686","Total",848,508,61,447,340,31,33,56,114,17,24,65
"2011","Westminster 015F","E01033593","Total",645,372,18,354,273,58,12,34,111,14,13,31
"2011","Westminster 015G","E01033594","Total",711,381,85,296,330,30,40,33,127,10,10,80
"2011","Westminster 016A","E01004681","Total",1150,544,72,472,606,28,33,78,328,11,15,113
"2011","Westminster 016B","E01004682","Total",765,407,50,357,358,10,27,46,195,5,5,70
"2011","Westminster 016C","E01004694","Total",949,469,61,408,480,14,22,74,271,12,17,70
"2011","Westminster 016D","E01004697","Total",816,384,72,312,432,19,30,60,230,8,12,73
"2011","Westminster 016E","E01004700","Total",941,484,62,422,457,21,25,88,230,12,13,68
"2011","Westminster 017A","E01004652","Total",958,451,81,370,507,19,30,57,252,16,13,120
"2011","Westminster 017B","E01004693","Total",735,359,64,295,376,5,43,63,175,19,16,55
"2011","Westminster 017C","E01004695","Total",669,305,53,252,364,13,15,30,197,11,8,90
"2011","Westminster 017D","E01004696","Total",760,346,121,225,414,44,44,79,114,16,26,91
"2011","Westminster 017E","E01004698","Total",754,377,53,324,377,23,15,45,181,8,13,92
"2011","Westminster 017F","E01004699","Total",1165,540,66,474,625,29,35,76,308,15,17,145
"2011","Westminster 018A","E01004734","Total",1104,611,155,456,493,23,46,30,236,4,22,132
"2011","Westminster 018B","E01004735","Total",977,581,120,461,396,15,40,31,213,4,12,81
"2011","Westminster 018C","E01004736","Total",729,379,65,314,350,3,56,30,193,7,9,52
"2011","Westminster 018D","E01004761","Total",1085,594,111,483,491,20,66,59,215,6,23,102
"2011","Westminster 019A","E01004687","Total",799,353,94,259,446,14,80,79,147,16,33,77
"2011","Westminster 019B","E01004688","Total",486,240,62,178,246,9,48,36,107,4,10,32
"2011","Westminster 019C","E01004689","Total",510,239,33,206,271,9,44,44,103,15,11,45
"2011","Westminster 019D","E01004690","Total",627,235,54,181,392,19,61,59,128,16,40,69
"2011","Westminster 019E","E01004691","Total",816,427,106,321,389,14,72,48,157,8,23,67
"2011","Westminster 019F","E01004692","Total",644,255,77,178,389,10,77,64,125,14,16,83
"2011","Westminster 020A","E01004731","Total",910,437,68,369,473,12,41,60,260,9,14,77
"2011","Westminster 020B","E01004732","Total",697,372,119,253,325,37,45,48,97,11,21,66
"2011","Westminster 020C","E01004733","Total",926,394,56,338,532,20,61,74,262,11,23,81
"2011","Westminster 020D","E01004744","Total",744,413,139,274,331,19,27,73,148,15,8,41
"2011","Westminster 020E","E01004748","Total",615,253,76,177,362,10,71,45,147,13,11,65
"2011","Westminster 021A","E01004740","Total",776,393,172,221,383,27,53,53,145,9,24,72
"2011","Westminster 021B","E01004743","Total",713,335,44,291,378,48,27,53,160,22,21,47
"2011","Westminster 021C","E01004745","Total",1125,508,125,383,617,41,82,92,276,14,23,89
"2011","Westminster 021D","E01004746","Total",757,377,130,247,380,42,50,64,133,13,19,59
"2011","Westminster 021E","E01004747","Total",1127,509,109,400,618,52,61,79,273,16,33,104
"2011","Westminster 022A","E01004742","Total",779,369,62,307,410,13,24,46,255,10,5,57
"2011","Westminster 022B","E01004749","Total",1185,518,96,422,667,47,45,100,308,21,14,132
"2011","Westminster 022C","E01004751","Total",943,436,98,338,507,16,53,57,269,14,28,70
"2011","Westminster 022D","E01004752","Total",905,463,86,377,442,24,43,32,242,9,8,84
"2011","Westminster 022E","E01004753","Total",1041,543,94,449,498,17,48,54,277,11,18,73
"2011","Westminster 023B","E01004666","Total",553,255,96,159,298,19,50,41,104,16,14,54
"2011","Westminster 023C","E01004667","Total",743,397,98,299,346,35,46,49,132,8,18,58
"2011","Westminster 023D","E01004668","Total",645,228,99,129,417,42,59,80,126,19,20,71
"2011","Westminster 023E","E01004750","Total",951,526,179,347,425,30,57,47,169,14,28,80
"2011","Westminster 023F","E01033597","Total",621,386,58,328,235,22,21,37,116,11,3,25
"2011","Westminster 023G","E01033599","Total",630,206,24,182,424,96,23,83,85,31,37,69
"2011","Westminster 024A","E01004665","Total",611,226,98,128,385,54,51,55,85,31,42,67
"2011","Westminster 024B","E01004669","Total",758,328,119,209,430,52,52,63,106,22,40,95
"2011","Westminster 024C","E01004737","Total",683,313,112,201,370,34,79,52,123,11,17,54
"2011","Westminster 024D","E01004738","Total",722,363,69,294,359,18,35,43,188,11,9,55
"2011","Westminster 024E","E01004739","Total",950,629,164,465,321,6,48,23,212,2,4,26
"2011","Westminster 024F","E01004741","Total",698,367,83,284,331,35,40,42,132,8,22,52
"2011","Barking and Dagenham 001A","E01000027","Total",641,175,96,79,466,84,52,96,69,30,38,97
"2011","Barking and Dagenham 001B","E01000028","Total",612,197,86,111,415,87,44,72,74,22,49,67
"2011","Barking and Dagenham 001C","E01000029","Total",690,224,152,72,466,27,145,68,76,22,43,85
"2011","Barking and Dagenham 001D","E01000030","Total",770,218,75,143,552,152,59,114,84,28,38,77
"2011","Barking and Dagenham 002A","E01000031","Total",598,159,97,62,439,39,58,76,78,25,55,108
"2011","Barking and Dagenham 002B","E01000032","Total",631,181,78,103,450,46,63,77,81,20,53,110
"2011","Barking and Dagenham 002C","E01000110","Total",501,92,44,48,409,26,64,74,81,17,50,97
"2011","Barking and Dagenham 002D","E01000111","Total",732,225,110,115,507,66,62,105,106,20,59,89
"2011","Barking and Dagenham 002E","E01000112","Total",739,213,79,134,526,70,60,92,124,24,54,102
"2011","Barking and Dagenham 002F","E01000113","Total",633,169,58,111,464,46,46,99,102,24,53,94
"2011","Barking and Dagenham 003A","E01000034","Total",517,142,77,65,375,40,52,64,79,16,51,73
"2011","Barking and Dagenham 003B","E01000037","Total",579,129,61,68,450,18,72,81,95,11,51,122
"2011","Barking and Dagenham 003C","E01000038","Total",563,153,95,58,410,29,84,74,66,14,48,95
"2011","Barking and Dagenham 003D","E01000039","Total",659,185,90,95,474,42,78,103,116,15,26,94
"2011","Barking and Dagenham 004A","E01000063","Total",635,185,81,104,450,81,54,89,72,24,53,77
"2011","Barking and Dagenham 004B","E01000100","Total",615,155,72,83,460,64,55,98,84,28,59,72
"2011","Barking and Dagenham 004C","E01000101","Total",567,144,73,71,423,53,47,90,72,11,60,90
"2011","Barking and Dagenham 004D","E01000109","Total",608,149,70,79,459,51,47,83,82,29,58,109
"2011","Barking and Dagenham 004E","E01000114","Total",758,175,75,100,583,79,76,102,115,32,73,106
"2011","Barking and Dagenham 006A","E01000033","Total",533,158,61,97,375,65,45,75,63,21,35,71
"2011","Barking and Dagenham 006B","E01000060","Total",770,286,105,181,484,90,70,99,90,30,51,54
"2011","Barking and Dagenham 006C","E01000061","Total",668,192,37,155,476,142,11,100,97,33,47,46
"2011","Barking and Dagenham 006D","E01000062","Total",761,230,122,108,531,75,66,97,98,31,58,106
"2011","Barking and Dagenham 006E","E01000064","Total",709,198,104,94,511,85,52,77,107,30,56,104
"2011","Barking and Dagenham 007A","E01000065","Total",774,321,177,144,453,72,60,88,89,17,58,69
"2011","Barking and Dagenham 007B","E01000078","Total",649,186,75,111,463,90,51,80,81,26,65,70
"2011","Barking and Dagenham 007C","E01000080","Total",594,171,74,97,423,65,46,80,75,22,55,80
"2011","Barking and Dagenham 007D","E01000081","Total",648,170,62,108,478,66,62,96,86,28,53,87
"2011","Barking and Dagenham 007E","E01000082","Total",672,223,73,150,449,64,40,104,92,27,55,67
"2011","Barking and Dagenham 007F","E01000083","Total",629,143,71,72,486,76,55,99,96,26,52,82
"2011","Barking and Dagenham 007G","E01000102","Total",625,184,83,101,441,75,53,107,75,15,45,71
"2011","Barking and Dagenham 008A","E01000021","Total",593,189,54,135,404,63,26,75,75,17,59,89
"2011","Barking and Dagenham 008B","E01000022","Total",474,103,45,58,371,61,30,77,69,16,47,71
"2011","Barking and Dagenham 008C","E01000023","Total",500,199,56,143,301,45,25,54,84,13,22,58
"2011","Barking and Dagenham 008D","E01000024","Total",456,98,48,50,358,56,26,59,69,15,61,72
"2011","Barking and Dagenham 008E","E01000025","Total",629,159,63,96,470,74,46,102,94,19,43,92
"2011","Barking and Dagenham 008F","E01000077","Total",560,149,59,90,411,63,44,82,86,16,47,73
"2011","Barking and Dagenham 009A","E01000015","Total",836,195,58,137,641,149,35,137,116,41,70,93
"2011","Barking and Dagenham 009B","E01000016","Total",626,176,67,109,450,63,58,91,78,23,53,84
"2011","Barking and Dagenham 009C","E01000017","Total",609,178,68,110,431,54,51,62,98,30,57,79
"2011","Barking and Dagenham 009D","E01000018","Total",612,158,68,90,454,74,51,102,75,24,44,84
"2011","Barking and Dagenham 009E","E01000079","Total",609,194,100,94,415,52,52,92,77,27,53,62
"2011","Barking and Dagenham 010A","E01000035","Total",567,151,59,92,416,46,58,71,70,27,55,89
"2011","Barking and Dagenham 010B","E01000036","Total",469,98,41,57,371,23,48,57,82,13,67,81
"2011","Barking and Dagenham 010C","E01000107","Total",601,131,63,68,470,56,86,78,80,21,63,86
"2011","Barking and Dagenham 010D","E01000108","Total",652,195,48,147,457,73,67,68,103,18,41,87
"2011","Barking and Dagenham 011A","E01000066","Total",683,208,90,118,475,43,51,74,82,39,96,90
"2011","Barking and Dagenham 011B","E01000067","Total",679,172,86,86,507,44,67,76,85,27,96,112
"2011","Barking and Dagenham 011C","E01000069","Total",513,82,46,36,431,13,48,54,63,32,107,114
"2011","Barking and Dagenham 011D","E01000070","Total",598,107,59,48,491,14,80,69,62,20,108,138
"2011","Barking and Dagenham 011E","E01000071","Total",785,222,122,100,563,49,65,107,95,25,105,117
"2011","Barking and Dagenham 012A","E01000057","Total",537,121,53,68,416,77,38,79,70,30,48,74
"2011","Barking and Dagenham 012B","E01000073","Total",627,175,70,105,452,70,49,99,87,32,43,72
"2011","Barking and Dagenham 012C","E01000074","Total",629,200,80,120,429,79,36,99,76,30,38,71
"2011","Barking and Dagenham 012D","E01000075","Total",622,159,68,91,463,45,75,75,77,31,59,101
"2011","Barking and Dagenham 012E","E01000076","Total",710,203,81,122,507,69,46,103,93,49,57,90
"2011","Barking and Dagenham 013A","E01000013","Total",650,164,73,91,486,76,72,92,100,21,46,79
"2011","Barking and Dagenham 013B","E01000014","Total",638,180,68,112,458,67,55,100,82,27,43,84
"2011","Barking and Dagenham 013C","E01000059","Total",578,153,69,84,425,72,34,81,79,23,49,87
"2011","Barking and Dagenham 013D","E01000084","Total",517,138,47,91,379,48,38,71,88,25,46,63
"2011","Barking and Dagenham 013E","E01000085","Total",640,171,56,115,469,71,54,89,89,33,53,80
"2011","Barking and Dagenham 013F","E01000086","Total",508,121,55,66,387,49,43,81,55,19,61,79
"2011","Barking and Dagenham 014A","E01000103","Total",600,137,42,95,463,65,39,90,91,23,71,84
"2011","Barking and Dagenham 014B","E01000104","Total",739,281,67,214,458,91,34,84,84,37,61,67
"2011","Barking and Dagenham 014C","E01000105","Total",915,329,130,199,586,114,59,119,128,32,55,79
"2011","Barking and Dagenham 014D","E01000106","Total",916,393,118,275,523,121,51,107,114,23,53,54
"2011","Barking and Dagenham 015A","E01000007","Total",612,253,40,213,359,53,8,94,110,16,43,35
"2011","Barking and Dagenham 015B","E01000008","Total",521,129,12,117,392,68,5,59,92,44,60,64
"2011","Barking and Dagenham 015C","E01000010","Total",1103,258,32,226,845,86,20,198,297,40,70,134
"2011","Barking and Dagenham 015D","E01000012","Total",698,165,18,147,533,109,12,136,106,29,58,83
"2011","Barking and Dagenham 016A","E01000006","Total",543,97,24,73,446,33,39,83,84,23,77,107
"2011","Barking and Dagenham 016B","E01000009","Total",638,191,64,127,447,32,36,79,94,5,70,131
"2011","Barking and Dagenham 016C","E01000011","Total",457,70,19,51,387,24,20,60,59,21,82,121
"2011","Barking and Dagenham 016D","E01000044","Total",629,152,50,102,477,51,46,91,89,28,75,97
"2011","Barking and Dagenham 016E","E01000068","Total",462,84,38,46,378,12,39,42,58,17,89,121
"2011","Barking and Dagenham 017A","E01000041","Total",607,149,56,93,458,61,43,101,84,26,56,87
"2011","Barking and Dagenham 017B","E01000042","Total",679,214,71,143,465,94,41,80,84,40,58,68
"2011","Barking and Dagenham 017C","E01000045","Total",602,135,50,85,467,81,38,98,90,22,60,78
"2011","Barking and Dagenham 017D","E01000046","Total",654,145,58,87,509,81,50,110,105,23,58,82
"2011","Barking and Dagenham 017E","E01000072","Total",784,242,115,127,542,112,50,114,94,28,61,83
"2011","Barking and Dagenham 018A","E01000054","Total",638,149,56,93,489,66,61,93,93,27,59,90
"2011","Barking and Dagenham 018B","E01000055","Total",560,129,50,79,431,48,38,80,86,26,71,82
"2011","Barking and Dagenham 018C","E01000056","Total",573,133,39,94,440,80,42,104,82,28,40,64
"2011","Barking and Dagenham 018D","E01000058","Total",690,188,71,117,502,88,42,88,88,24,72,100
"2011","Barking and Dagenham 018E","E01000095","Total",549,123,37,86,426,61,36,111,72,25,63,58
"2011","Barking and Dagenham 019A","E01000040","Total",640,188,70,118,452,77,49,79,108,20,44,75
"2011","Barking and Dagenham 019B","E01000043","Total",461,117,59,58,344,27,48,57,47,27,59,79
"2011","Barking and Dagenham 019C","E01000050","Total",615,192,90,102,423,58,46,78,80,23,56,82
"2011","Barking and Dagenham 019D","E01000052","Total",769,228,89,139,541,81,55,107,105,29,65,99
"2011","Barking and Dagenham 019E","E01000092","Total",975,256,116,140,719,104,57,171,115,49,103,120
"2011","Barking and Dagenham 020A","E01000053","Total",645,241,89,152,404,64,35,87,102,19,40,57
"2011","Barking and Dagenham 020B","E01000087","Total",503,132,52,80,371,59,32,73,65,12,53,77
"2011","Barking and Dagenham 020C","E01000088","Total",640,168,57,111,472,64,50,104,85,35,50,84
"2011","Barking and Dagenham 020D","E01000089","Total",612,132,40,92,480,80,50,100,87,24,45,94
"2011","Barking and Dagenham 020E","E01000090","Total",549,110,39,71,439,62,52,74,75,40,54,82
"2011","Barking and Dagenham 021B","E01000048","Total",644,192,43,149,452,119,15,94,65,55,62,42
"2011","Barking and Dagenham 021C","E01000049","Total",643,167,51,116,476,116,32,103,64,51,47,63
"2011","Barking and Dagenham 021D","E01000051","Total",725,235,19,216,490,130,16,91,82,51,64,56
"2011","Barking and Dagenham 021E","E01033587","Total",631,170,20,150,461,102,15,109,119,23,39,54
"2011","Barking and Dagenham 021F","E01033588","Total",618,155,35,120,463,124,22,119,92,26,40,40
"2011","Barking and Dagenham 022A","E01000091","Total",633,195,55,140,438,101,40,71,68,37,57,64
"2011","Barking and Dagenham 022B","E01000093","Total",642,246,46,200,396,83,30,83,75,26,47,52
"2011","Barking and Dagenham 022C","E01000094","Total",517,144,10,134,373,86,7,107,68,15,38,52
"2011","Barking and Dagenham 022D","E01000096","Total",639,146,31,115,493,119,32,92,54,53,64,79
"2011","Barking and Dagenham 023A","E01000019","Total",504,113,48,65,391,68,37,62,82,22,42,78
"2011","Barking and Dagenham 023B","E01000020","Total",650,191,78,113,459,64,32,101,71,23,83,85
"2011","Barking and Dagenham 023C","E01000097","Total",708,255,166,89,453,68,66,115,64,20,38,82
"2011","Barking and Dagenham 023D","E01000098","Total",625,147,45,102,478,73,53,78,84,34,70,86
"2011","Barking and Dagenham 023E","E01000099","Total",666,164,75,89,502,68,56,121,105,29,34,89
"2011","Barking and Dagenham 023F","E01032580","Total",471,104,34,70,367,66,23,70,54,23,47,84
"2011","Barnet 001A","E01000248","Total",666,209,84,125,457,20,59,129,109,16,48,76
"2011","Barnet 001B","E01000249","Total",572,123,60,63,449,17,85,91,90,19,42,105
"2011","Barnet 001C","E01000250","Total",979,373,140,233,606,46,74,131,171,25,50,109
"2011","Barnet 001D","E01000254","Total",622,182,93,89,440,17,84,115,107,19,24,74
"2011","Barnet 001E","E01000292","Total",629,195,118,77,434,25,97,77,97,11,34,93
"2011","Barnet 001F","E01000293","Total",642,143,67,76,499,13,95,113,106,14,41,117
"2011","Barnet 002A","E01000167","Total",522,137,52,85,385,41,46,73,87,11,35,92
"2011","Barnet 002B","E01000246","Total",654,217,109,108,437,18,94,104,103,9,24,85
"2011","Barnet 002C","E01000247","Total",746,269,63,206,477,39,39,122,148,11,32,86
"2011","Barnet 002D","E01000251","Total",947,425,134,291,522,52,71,87,200,11,30,71
"2011","Barnet 002E","E01000252","Total",753,299,131,168,454,41,59,87,134,12,38,83
"2011","Barnet 003A","E01000166","Total",648,209,94,115,439,33,69,107,91,17,36,86
"2011","Barnet 003B","E01000168","Total",576,103,55,48,473,7,119,96,70,16,45,120
"2011","Barnet 003C","E01000169","Total",670,235,65,170,435,33,61,100,131,16,25,69
"2011","Barnet 003D","E01000172","Total",602,139,83,56,463,12,77,122,74,26,39,113
"2011","Barnet 004A","E01000285","Total",610,194,74,120,416,30,64,92,100,8,32,90
"2011","Barnet 004B","E01000287","Total",622,154,71,83,468,52,68,98,102,13,50,85
"2011","Barnet 004C","E01000288","Total",568,138,75,63,430,23,62,95,74,15,57,104
"2011","Barnet 004D","E01000289","Total",631,134,51,83,497,73,51,75,76,40,67,115
"2011","Barnet 004E","E01000291","Total",602,157,54,103,445,76,59,80,85,24,37,84
"2011","Barnet 004F","E01000294","Total",672,235,122,113,437,26,81,97,111,10,40,72
"2011","Barnet 005A","E01000267","Total",567,129,51,78,438,15,74,81,84,20,44,120
"2011","Barnet 005B","E01000268","Total",745,219,67,152,526,79,54,93,176,22,26,76
"2011","Barnet 005C","E01000269","Total",535,101,53,48,434,19,86,76,91,15,45,102
"2011","Barnet 005D","E01000270","Total",626,182,77,105,444,25,93,97,107,10,29,83
"2011","Barnet 006A","E01000170","Total",656,201,82,119,455,41,64,98,93,16,49,94
"2011","Barnet 006B","E01000171","Total",856,301,55,246,555,104,31,131,185,17,24,63
"2011","Barnet 006C","E01000173","Total",617,117,55,62,500,24,73,114,95,21,61,112
"2011","Barnet 006D","E01000174","Total",766,283,107,176,483,50,53,125,133,10,37,75
"2011","Barnet 006E","E01000175","Total",618,152,64,88,466,20,81,108,98,23,37,99
"2011","Barnet 007A","E01000228","Total",475,66,30,36,409,27,56,95,56,24,56,95
"2011","Barnet 007B","E01000253","Total",597,118,73,45,479,9,130,83,75,24,52,106
"2011","Barnet 007C","E01000279","Total",513,80,42,38,433,11,114,76,66,19,46,101
"2011","Barnet 007D","E01000280","Total",497,83,51,32,414,5,96,75,71,18,40,109
"2011","Barnet 007E","E01000286","Total",654,213,104,109,441,55,62,87,104,15,34,84
"2011","Barnet 007F","E01000290","Total",674,230,143,87,444,25,102,76,87,17,44,93
"2011","Barnet 008A","E01000271","Total",582,159,98,61,423,9,100,80,81,18,40,95
"2011","Barnet 008B","E01000272","Total",468,83,41,42,385,4,92,51,77,19,43,99
"2011","Barnet 008C","E01000273","Total",648,225,102,123,423,24,89,75,92,14,37,92
"2011","Barnet 008D","E01000281","Total",480,142,63,79,338,36,26,100,77,14,31,54
"2011","Barnet 008E","E01000282","Total",639,151,68,83,488,12,92,123,93,18,52,98
"2011","Barnet 009A","E01000115","Total",485,70,40,30,415,10,86,87,44,14,50,124
"2011","Barnet 009B","E01000116","Total",623,130,69,61,493,18,76,134,85,25,35,120
"2011","Barnet 009C","E01000119","Total",607,123,63,60,484,19,96,111,77,12,42,127
"2011","Barnet 009D","E01000120","Total",505,87,56,31,418,14,71,82,47,20,58,126
"2011","Barnet 009E","E01000122","Total",522,123,63,60,399,10,59,92,72,16,48,102
"2011","Barnet 010A","E01000117","Total",762,215,95,120,547,27,121,116,123,13,43,104
"2011","Barnet 010B","E01000118","Total",709,165,83,82,544,33,75,112,94,28,69,133
"2011","Barnet 010C","E01000121","Total",501,123,31,92,378,53,32,75,60,21,58,79
"2011","Barnet 010D","E01000123","Total",685,215,54,161,470,38,51,97,122,13,44,105
"2011","Barnet 010E","E01000124","Total",660,216,62,154,444,46,44,90,114,18,45,87
"2011","Barnet 011A","E01000265","Total",791,229,80,149,562,66,57,139,144,20,36,100
"2011","Barnet 011B","E01000266","Total",511,80,46,34,431,14,88,83,55,17,47,127
"2011","Barnet 011C","E01000274","Total",699,177,65,112,522,51,62,115,102,23,53,116
"2011","Barnet 011D","E01000320","Total",628,204,101,103,424,19,86,93,87,13,40,86
"2011","Barnet 011E","E01000322","Total",774,269,92,177,505,59,63,95,164,7,27,90
"2011","Barnet 012A","E01000275","Total",644,193,69,124,451,18,71,94,114,12,37,105
"2011","Barnet 012B","E01000277","Total",777,343,135,208,434,28,59,113,153,9,24,48
"2011","Barnet 012C","E01000283","Total",480,73,54,19,407,6,83,86,49,23,57,103
"2011","Barnet 012D","E01000284","Total",780,292,107,185,488,55,59,94,164,9,33,74
"2011","Barnet 012E","E01000321","Total",700,251,72,179,449,26,37,100,148,6,25,107
"2011","Barnet 013A","E01000195","Total",697,223,56,167,474,72,42,97,101,21,60,81
"2011","Barnet 013B","E01000229","Total",600,136,54,82,464,42,49,98,90,26,54,105
"2011","Barnet 013C","E01000230","Total",650,149,101,48,501,15,111,81,92,36,51,115
"2011","Barnet 013D","E01000231","Total",654,140,49,91,514,47,60,117,88,28,69,105
"2011","Barnet 013E","E01000232","Total",706,196,82,114,510,15,99,110,99,29,53,105
"2011","Barnet 013F","E01000233","Total",635,122,40,82,513,32,67,118,96,24,59,117
"2011","Barnet 014A","E01000186","Total",501,60,36,24,441,9,86,87,52,50,43,114
"2011","Barnet 014B","E01000187","Total",593,135,94,41,458,34,77,81,70,42,54,100
"2011","Barnet 014C","E01000188","Total",516,70,48,22,446,9,82,64,74,32,49,136
"2011","Barnet 014D","E01000189","Total",711,197,35,162,514,133,27,109,89,21,51,84
"2011","Barnet 014E","E01000190","Total",546,117,76,41,429,19,78,52,84,37,67,92
"2011","Barnet 014F","E01000191","Total",530,110,74,36,420,8,88,67,63,33,48,113
"2011","Barnet 015A","E01000158","Total",564,168,47,121,396,47,36,81,70,11,44,107
"2011","Barnet 015B","E01000159","Total",645,131,62,69,514,38,81,109,90,20,54,122
"2011","Barnet 015C","E01000160","Total",923,319,51,268,604,51,47,131,223,16,29,107
"2011","Barnet 015D","E01000161","Total",710,210,53,157,500,31,48,95,132,9,34,151
"2011","Barnet 015E","E01000162","Total",552,142,53,89,410,24,46,81,73,23,43,120
"2011","Barnet 015F","E01000324","Total",655,182,70,112,473,26,68,106,81,22,57,113
"2011","Barnet 016A","E01000256","Total",656,137,51,86,519,31,89,117,101,15,56,110
"2011","Barnet 016B","E01000258","Total",696,224,90,134,472,32,81,102,111,18,41,87
"2011","Barnet 016C","E01000263","Total",499,61,39,22,438,7,80,101,54,33,68,95
"2011","Barnet 016D","E01000264","Total",634,169,53,116,465,39,52,97,107,20,49,101
"2011","Barnet 017A","E01000255","Total",527,123,66,57,404,20,70,65,73,20,50,106
"2011","Barnet 017B","E01000257","Total",724,192,93,99,532,85,49,104,120,27,38,109
"2011","Barnet 017C","E01000261","Total",646,232,164,68,414,13,89,91,89,28,37,67
"2011","Barnet 017D","E01000262","Total",752,146,55,91,606,46,76,105,119,56,74,130
"2011","Barnet 018A","E01000192","Total",683,184,85,99,499,21,94,78,90,32,69,115
"2011","Barnet 018B","E01000193","Total",594,148,76,72,446,22,74,62,71,29,63,125
"2011","Barnet 018C","E01000194","Total",610,148,58,90,462,39,68,75,90,25,45,120
"2011","Barnet 018D","E01000226","Total",630,184,93,91,446,61,44,79,61,28,64,109
"2011","Barnet 018E","E01000227","Total",603,103,56,47,500,25,78,88,82,42,56,129
"2011","Barnet 019A","E01000299","Total",782,255,101,154,527,37,42,101,197,15,30,105
"2011","Barnet 019B","E01000300","Total",667,215,79,136,452,14,55,113,115,15,42,98
"2011","Barnet 019C","E01000302","Total",840,359,86,273,481,35,50,114,174,10,23,75
"2011","Barnet 019D","E01000317","Total",657,212,75,137,445,23,59,105,108,12,34,104
"2011","Barnet 019E","E01000318","Total",610,109,52,57,501,27,79,84,70,23,67,151
"2011","Barnet 019F","E01000323","Total",865,331,105,226,534,32,59,101,189,17,39,97
"2011","Barnet 020A","E01000276","Total",506,79,58,21,427,5,67,137,49,16,41,112
"2011","Barnet 020B","E01000278","Total",498,67,49,18,431,4,72,133,51,28,45,98
"2011","Barnet 020C","E01000301","Total",528,102,42,60,426,11,62,127,72,20,41,93
"2011","Barnet 020D","E01000303","Total",540,102,40,62,438,12,58,121,83,30,36,98
"2011","Barnet 020E","E01000304","Total",621,155,42,113,466,33,40,87,155,9,26,116
"2011","Barnet 021A","E01000130","Total",570,124,32,92,446,71,27,71,96,16,61,104
"2011","Barnet 021B","E01000132","Total",495,94,36,58,401,66,36,76,60,20,63,80
"2011","Barnet 021C","E01000133","Total",565,133,57,76,432,54,49,67,71,25,54,112
"2011","Barnet 021D","E01000234","Total",650,153,59,94,497,34,68,128,105,17,36,109
"2011","Barnet 021E","E01000235","Total",582,115,45,70,467,57,44,88,79,21,69,109
"2011","Barnet 022A","E01000156","Total",751,203,67,136,548,45,64,151,121,10,37,120
"2011","Barnet 022B","E01000157","Total",689,254,48,206,435,49,43,96,131,15,26,75
"2011","Barnet 022C","E01000163","Total",759,318,47,271,441,85,35,98,120,12,16,75
"2011","Barnet 022D","E01000164","Total",648,180,52,128,468,58,34,106,91,19,43,117
"2011","Barnet 022E","E01000165","Total",707,194,44,150,513,38,40,138,107,17,45,128
"2011","Barnet 022F","E01000315","Total",614,144,58,86,470,76,39,86,64,14,73,118
"2011","Barnet 023A","E01000197","Total",707,203,48,155,504,32,50,82,133,26,43,138
"2011","Barnet 023B","E01000295","Total",686,205,72,133,481,16,66,107,120,11,40,121
"2011","Barnet 023C","E01000296","Total",734,210,47,163,524,43,52,101,180,13,19,116
"2011","Barnet 023D","E01000298","Total",733,208,71,137,525,28,55,104,164,7,37,130
"2011","Barnet 024A","E01000125","Total",1015,310,100,210,705,102,41,135,158,47,84,138
"2011","Barnet 024B","E01000127","Total",514,102,45,57,412,57,36,65,66,23,56,109
"2011","Barnet 024C","E01000128","Total",624,120,58,62,504,65,60,82,79,32,79,107
"2011","Barnet 024D","E01000129","Total",624,178,84,94,446,71,33,79,76,20,57,110
"2011","Barnet 024E","E01000131","Total",634,154,54,100,480,30,58,87,89,17,77,122
"2011","Barnet 024F","E01000134","Total",625,184,66,118,441,50,37,93,96,22,52,91
"2011","Barnet 025A","E01000198","Total",685,186,75,111,499,19,73,113,90,50,47,107
"2011","Barnet 025B","E01000199","Total",671,225,121,104,446,11,121,82,80,28,47,77
"2011","Barnet 025C","E01000204","Total",687,201,76,125,486,14,74,84,124,23,49,118
"2011","Barnet 025D","E01000259","Total",980,249,86,163,731,46,85,176,168,29,83,144
"2011","Barnet 025E","E01000260","Total",761,193,50,143,568,54,62,137,136,20,55,104
"2011","Barnet 026A","E01000126","Total",726,173,42,131,553,73,30,113,101,38,88,110
"2011","Barnet 026B","E01000151","Total",617,199,34,165,418,91,26,89,48,41,58,65
"2011","Barnet 026C","E01000152","Total",564,89,16,73,475,109,27,90,74,39,68,68
"2011","Barnet 026D","E01000153","Total",620,205,56,149,415,65,46,69,87,25,50,73
"2011","Barnet 026E","E01000154","Total",501,152,41,111,349,46,32,56,57,19,50,89
"2011","Barnet 027A","E01000176","Total",698,271,135,136,427,42,51,70,114,16,47,87
"2011","Barnet 027B","E01000178","Total",695,198,86,112,497,22,79,106,102,27,59,102
"2011","Barnet 027C","E01000184","Total",503,138,36,102,365,43,49,53,61,15,53,91
"2011","Barnet 027D","E01000297","Total",554,166,46,120,388,15,33,75,115,10,39,101
"2011","Barnet 027E","E01000316","Total",874,194,49,145,680,69,56,140,172,15,78,150
"2011","Barnet 027F","E01000319","Total",529,96,45,51,433,15,64,108,89,19,41,97
"2011","Barnet 028A","E01000196","Total",896,346,126,220,550,38,85,80,217,2,22,106
"2011","Barnet 028B","E01000200","Total",863,341,180,161,522,17,122,68,146,27,34,108
"2011","Barnet 028C","E01000201","Total",517,105,66,39,412,4,88,50,60,30,62,118
"2011","Barnet 028D","E01000202","Total",648,160,56,104,488,18,78,88,108,31,55,110
"2011","Barnet 028E","E01000203","Total",613,170,75,95,443,39,69,85,69,27,49,105
"2011","Barnet 029A","E01000177","Total",690,183,66,117,507,17,64,120,171,11,21,103
"2011","Barnet 029B","E01000179","Total",763,286,57,229,477,20,32,138,185,12,17,73
"2011","Barnet 029C","E01000180","Total",689,239,153,86,450,27,51,83,125,18,23,123
"2011","Barnet 029D","E01000181","Total",669,162,58,104,507,12,55,122,143,19,28,128
"2011","Barnet 029E","E01000182","Total",746,253,104,149,493,13,57,95,167,19,16,126
"2011","Barnet 029F","E01000185","Total",606,212,67,145,394,52,34,59,93,19,37,100
"2011","Barnet 030A","E01000147","Total",544,108,47,61,436,4,76,55,58,19,75,149
"2011","Barnet 030B","E01000148","Total",725,247,92,155,478,44,39,67,112,31,59,126
"2011","Barnet 030D","E01000155","Total",797,286,39,247,511,56,20,117,157,24,40,97
"2011","Barnet 030E","E01033572","Total",571,123,38,85,448,29,54,77,100,14,53,121
"2011","Barnet 030F","E01033573","Total",607,260,4,256,347,45,9,59,169,13,10,42
"2011","Barnet 031A","E01000239","Total",877,325,44,281,552,37,27,114,195,24,33,122
"2011","Barnet 031B","E01000240","Total",582,130,52,78,452,19,70,85,69,18,66,125
"2011","Barnet 031C","E01000241","Total",696,225,65,160,471,20,53,88,111,21,45,133
"2011","Barnet 031D","E01000309","Total",619,141,53,88,478,19,59,83,86,21,63,147
"2011","Barnet 032A","E01000237","Total",740,181,75,106,559,15,47,77,165,35,55,165
"2011","Barnet 032B","E01000242","Total",597,161,77,84,436,16,106,74,67,35,45,93
"2011","Barnet 032C","E01000243","Total",791,278,115,163,513,25,70,91,144,19,32,132
"2011","Barnet 032D","E01000244","Total",582,173,53,120,409,23,48,58,94,20,40,126
"2011","Barnet 032E","E01000245","Total",811,271,92,179,540,57,60,84,146,32,48,113
"2011","Barnet 032F","E01000314","Total",658,137,51,86,521,16,65,79,122,24,58,157
"2011","Barnet 033A","E01000183","Total",584,187,92,95,397,10,50,98,116,23,21,79
"2011","Barnet 033B","E01000206","Total",514,99,44,55,415,9,85,53,80,23,72,93
"2011","Barnet 033C","E01000207","Total",608,149,68,81,459,20,100,70,96,32,51,90
"2011","Barnet 033D","E01000208","Total",619,159,62,97,460,7,98,87,94,32,32,110
"2011","Barnet 033E","E01000210","Total",600,157,68,89,443,27,64,128,87,26,34,77
"2011","Barnet 033F","E01000213","Total",465,82,42,40,383,12,77,67,38,39,64,86
"2011","Barnet 034A","E01000236","Total",674,187,72,115,487,17,72,109,104,62,47,76
"2011","Barnet 034B","E01000238","Total",615,127,47,80,488,27,51,96,74,71,49,120
"2011","Barnet 034C","E01000310","Total",701,131,60,71,570,19,64,69,165,23,57,173
"2011","Barnet 034D","E01000311","Total",470,73,43,30,397,4,77,52,45,77,58,84
"2011","Barnet 035A","E01000205","Total",619,178,77,101,441,20,85,145,83,22,26,60
"2011","Barnet 035B","E01000209","Total",747,309,179,130,438,17,123,105,92,21,14,66
"2011","Barnet 035C","E01000211","Total",861,311,120,191,550,44,53,107,152,11,24,159
"2011","Barnet 035D","E01000212","Total",529,118,69,49,411,12,86,61,85,36,32,99
"2011","Barnet 035E","E01000216","Total",684,182,85,97,502,12,62,102,111,55,62,98
"2011","Barnet 035F","E01000217","Total",521,101,27,74,420,9,61,50,71,65,66,98
"2011","Barnet 036A","E01000150","Total",744,178,60,118,566,33,76,98,121,25,59,154
"2011","Barnet 036B","E01000305","Total",637,222,66,156,415,35,49,54,73,22,62,120
"2011","Barnet 036C","E01000306","Total",558,109,25,84,449,18,49,59,91,17,66,149
"2011","Barnet 036D","E01000308","Total",669,257,80,177,412,76,46,69,87,16,31,87
"2011","Barnet 036E","E01000312","Total",710,258,53,205,452,49,23,107,122,22,44,85
"2011","Barnet 036F","E01000313","Total",672,198,55,143,474,24,43,71,120,21,72,123
"2011","Barnet 037A","E01000145","Total",444,91,44,47,353,15,48,53,39,42,45,111
"2011","Barnet 037B","E01000215","Total",680,206,122,84,474,15,69,62,81,79,59,109
"2011","Barnet 037C","E01000218","Total",573,147,59,88,426,9,57,51,84,64,56,105
"2011","Barnet 037D","E01000219","Total",581,128,43,85,453,21,45,71,95,61,56,104
"2011","Barnet 037E","E01000220","Total",593,193,75,118,400,6,38,71,75,49,48,113
"2011","Barnet 037F","E01000225","Total",529,132,88,44,397,19,71,44,29,89,65,80
"2011","Barnet 038A","E01000135","Total",541,128,47,81,413,9,78,58,83,15,62,108
"2011","Barnet 038B","E01000136","Total",563,142,52,90,421,13,92,76,82,20,49,89
"2011","Barnet 038C","E01000144","Total",607,198,57,141,409,13,38,61,124,21,34,118
"2011","Barnet 038D","E01000146","Total",744,269,74,195,475,30,48,55,164,21,30,127
"2011","Barnet 038E","E01000214","Total",717,226,61,165,491,21,62,100,158,19,26,105
"2011","Barnet 039A","E01000141","Total",864,290,42,248,574,79,27,99,170,18,48,133
"2011","Barnet 039B","E01000221","Total",485,159,56,103,326,57,30,48,53,28,43,67
"2011","Barnet 039C","E01000223","Total",478,144,51,93,334,33,37,59,58,23,40,84
"2011","Barnet 039D","E01000307","Total",530,116,66,50,414,21,48,59,50,19,82,135
"2011","Barnet 040A","E01000138","Total",523,149,62,87,374,27,49,60,61,17,61,99
"2011","Barnet 040B","E01000142","Total",950,313,43,270,637,71,36,131,184,28,55,132
"2011","Barnet 040C","E01000222","Total",506,107,45,62,399,29,43,64,56,30,59,118
"2011","Barnet 040D","E01000224","Total",524,117,49,68,407,17,50,59,69,29,69,114
"2011","Barnet 041A","E01000137","Total",669,216,77,139,453,75,44,105,95,17,44,73
"2011","Barnet 041B","E01000139","Total",560,151,55,96,409,14,60,69,102,17,32,115
"2011","Barnet 041C","E01000140","Total",683,237,68,169,446,24,48,71,118,15,31,139
"2011","Barnet 041D","E01000143","Total",538,175,41,134,363,48,46,67,75,28,31,68
"2011","Bexley 001A","E01000466","Total",602,188,39,149,414,61,36,79,75,27,67,69
"2011","Bexley 001B","E01000467","Total",591,154,29,125,437,59,23,102,98,26,60,69
"2011","Bexley 001C","E01000468","Total",890,173,20,153,717,114,23,171,127,56,125,101
"2011","Bexley 001D","E01000469","Total",645,188,36,152,457,51,41,102,101,25,50,87
"2011","Bexley 002A","E01000416","Total",517,108,45,63,409,49,37,75,77,24,60,87
"2011","Bexley 002B","E01000418","Total",754,214,67,147,540,52,68,107,119,30,62,102
"2011","Bexley 002C","E01000422","Total",681,235,41,194,446,101,22,99,75,19,58,72
"2011","Bexley 002D","E01000464","Total",546,178,52,126,368,45,42,54,59,19,56,93
"2011","Bexley 002E","E01000465","Total",707,306,88,218,401,68,47,72,91,22,31,70
"2011","Bexley 002F","E01000470","Total",590,205,34,171,385,90,30,59,79,22,49,56
"2011","Bexley 003A","E01000333","Total",793,342,149,193,451,65,57,90,118,19,30,72
"2011","Bexley 003B","E01000335","Total",638,149,45,104,489,82,38,100,92,22,63,92
"2011","Bexley 003C","E01000336","Total",793,298,91,207,495,93,32,111,109,17,53,80
"2011","Bexley 003D","E01000337","Total",663,176,54,122,487,62,48,103,120,15,50,89
"2011","Bexley 003E","E01000338","Total",693,209,65,144,484,54,37,101,122,14,59,97
"2011","Bexley 004A","E01000403","Total",990,402,198,204,588,105,88,107,142,18,44,84
"2011","Bexley 004B","E01000404","Total",959,332,28,304,627,136,15,150,189,31,46,60
"2011","Bexley 004C","E01000405","Total",522,143,24,119,379,51,19,85,82,29,43,70
"2011","Bexley 004D","E01000408","Total",570,116,36,80,454,50,34,88,98,24,60,100
"2011","Bexley 005A","E01000332","Total",611,162,85,77,449,26,114,61,87,16,52,93
"2011","Bexley 005B","E01000402","Total",660,225,83,142,435,57,56,76,107,23,30,86
"2011","Bexley 005C","E01000406","Total",594,145,40,105,449,43,43,94,98,26,53,92
"2011","Bexley 005D","E01000407","Total",630,214,130,84,416,26,118,47,84,17,29,95
"2011","Bexley 006A","E01000334","Total",640,175,96,79,465,31,80,81,110,24,43,96
"2011","Bexley 006B","E01000417","Total",713,216,73,143,497,33,95,88,134,18,30,99
"2011","Bexley 006C","E01000419","Total",594,153,111,42,441,20,107,84,84,15,35,96
"2011","Bexley 006D","E01000420","Total",604,137,73,64,467,32,107,59,93,14,57,105
"2011","Bexley 006E","E01000442","Total",626,157,109,48,469,24,105,91,84,18,51,96
"2011","Bexley 007A","E01000437","Total",498,123,69,54,375,23,65,75,75,12,36,89
"2011","Bexley 007B","E01000438","Total",599,128,62,66,471,39,64,94,109,17,47,101
"2011","Bexley 007C","E01000439","Total",496,105,38,67,391,39,46,78,76,24,40,88
"2011","Bexley 007D","E01000440","Total",517,96,58,38,421,12,106,69,64,17,42,111
"2011","Bexley 007E","E01000441","Total",672,196,68,128,476,85,63,92,100,15,40,81
"2011","Bexley 008A","E01000373","Total",688,248,48,200,440,142,22,116,80,22,24,34
"2011","Bexley 008B","E01000429","Total",719,274,38,236,445,99,25,111,111,19,32,48
"2011","Bexley 008C","E01000430","Total",678,160,57,103,518,70,46,134,116,24,48,80
"2011","Bexley 008D","E01000431","Total",681,211,28,183,470,105,43,87,99,23,54,59
"2011","Bexley 008E","E01000432","Total",640,174,98,76,466,51,76,93,84,28,55,79
"2011","Bexley 008F","E01000433","Total",720,210,75,135,510,107,59,94,99,24,51,76
"2011","Bexley 008G","E01000434","Total",596,164,79,85,432,81,42,85,77,31,46,70
"2011","Bexley 009A","E01000356","Total",628,142,100,42,486,18,151,70,82,18,31,116
"2011","Bexley 009B","E01000357","Total",488,68,49,19,420,9,67,95,75,21,56,97
"2011","Bexley 009C","E01000359","Total",488,96,59,37,392,15,93,85,72,10,32,85
"2011","Bexley 009D","E01000421","Total",603,158,114,44,445,14,125,87,84,7,41,87
"2011","Bexley 009E","E01000450","Total",645,143,72,71,502,29,81,101,78,40,73,100
"2011","Bexley 009F","E01000451","Total",621,121,58,63,500,32,78,100,107,23,48,112
"2011","Bexley 009G","E01000452","Total",495,87,46,41,408,25,54,92,84,23,45,85
"2011","Bexley 010A","E01000367","Total",605,175,63,112,430,42,67,85,80,13,49,94
"2011","Bexley 010B","E01000368","Total",632,172,71,101,460,84,65,103,89,9,41,69
"2011","Bexley 010C","E01000372","Total",593,139,58,81,454,37,72,69,81,34,55,106
"2011","Bexley 010D","E01000380","Total",758,369,164,205,389,51,56,72,121,13,16,60
"2011","Bexley 010E","E01000435","Total",597,188,89,99,409,66,64,76,82,15,39,67
"2011","Bexley 011A","E01000353","Total",662,139,95,44,523,4,139,80,107,20,49,124
"2011","Bexley 011B","E01000354","Total",623,182,97,85,441,32,77,96,93,10,45,88
"2011","Bexley 011C","E01000355","Total",613,164,116,48,449,11,126,74,101,8,33,96
"2011","Bexley 011D","E01000358","Total",659,163,92,71,496,26,100,99,109,8,35,119
"2011","Bexley 011E","E01000436","Total",615,97,65,32,518,9,113,108,104,19,48,117
"2011","Bexley 013A","E01000401","Total",637,192,99,93,445,47,63,65,102,22,46,100
"2011","Bexley 013B","E01000453","Total",513,88,44,44,425,18,72,91,83,19,54,88
"2011","Bexley 013C","E01000454","Total",628,180,96,84,448,25,84,84,98,14,47,96
"2011","Bexley 013D","E01000455","Total",605,113,69,44,492,18,80,106,94,19,59,116
"2011","Bexley 013E","E01000456","Total",487,69,41,28,418,22,61,98,69,21,50,97
"2011","Bexley 014A","E01000325","Total",583,105,67,38,478,18,85,105,89,17,39,125
"2011","Bexley 014B","E01000326","Total",544,130,39,91,414,43,58,102,126,12,23,50
"2011","Bexley 014C","E01000369","Total",626,134,60,74,492,30,84,82,124,19,39,114
"2011","Bexley 014D","E01000370","Total",649,164,97,67,485,13,121,99,102,18,37,95
"2011","Bexley 014E","E01000371","Total",634,165,73,92,469,22,86,100,117,12,39,93
"2011","Bexley 015A","E01000360","Total",662,200,60,140,462,48,52,93,124,24,34,87
"2011","Bexley 015B","E01000362","Total",626,199,136,63,427,20,92,68,97,17,35,98
"2011","Bexley 015C","E01000365","Total",700,229,131,98,471,38,100,79,118,17,42,77
"2011","Bexley 015D","E01000366","Total",655,169,75,94,486,24,75,102,140,23,23,99
"2011","Bexley 015E","E01000394","Total",624,196,105,91,428,14,101,98,92,14,35,74
"2011","Bexley 016A","E01000388","Total",621,155,97,58,466,13,136,73,95,15,44,90
"2011","Bexley 016B","E01000392","Total",695,227,68,159,468,87,45,99,98,21,32,86
"2011","Bexley 016C","E01000409","Total",649,135,77,58,514,14,106,117,123,12,46,96
"2011","Bexley 016D","E01000411","Total",551,129,82,47,422,19,72,86,100,14,35,96
"2011","Bexley 016E","E01000414","Total",674,206,121,85,468,26,75,95,86,20,47,119
"2011","Bexley 016F","E01000415","Total",512,83,50,33,429,11,80,61,72,16,59,130
"2011","Bexley 017A","E01000327","Total",604,140,97,43,464,16,114,80,92,18,38,106
"2011","Bexley 017B","E01000328","Total",596,154,87,67,442,20,89,98,98,10,35,92
"2011","Bexley 017C","E01000329","Total",517,145,79,66,372,23,65,66,76,14,40,88
"2011","Bexley 017D","E01000330","Total",772,354,197,157,418,37,78,71,113,10,30,79
"2011","Bexley 017E","E01000331","Total",617,146,83,63,471,36,101,85,87,23,47,92
"2011","Bexley 018A","E01000340","Total",619,165,93,72,454,23,100,94,108,13,35,81
"2011","Bexley 018B","E01000395","Total",499,86,60,26,413,10,93,73,64,11,49,113
"2011","Bexley 018C","E01000396","Total",507,101,61,40,406,16,74,78,69,16,49,104
"2011","Bexley 018D","E01000410","Total",594,131,67,64,463,27,82,91,90,19,46,108
"2011","Bexley 018E","E01000412","Total",632,146,73,73,486,26,66,118,107,16,53,100
"2011","Bexley 018F","E01000413","Total",505,116,56,60,389,29,61,74,94,7,49,75
"2011","Bexley 019A","E01000374","Total",534,124,61,63,410,61,58,92,51,22,58,68
"2011","Bexley 019B","E01000375","Total",565,137,56,81,428,30,54,85,106,20,52,81
"2011","Bexley 019C","E01000376","Total",606,154,81,73,452,35,60,114,111,23,35,74
"2011","Bexley 019D","E01000377","Total",649,222,101,121,427,27,97,80,105,12,22,84
"2011","Bexley 019E","E01000378","Total",968,398,148,250,570,42,84,124,170,24,40,86
"2011","Bexley 019F","E01000379","Total",663,194,72,122,469,39,75,106,91,23,55,80
"2011","Bexley 020A","E01000348","Total",523,76,49,27,447,9,94,89,81,18,46,110
"2011","Bexley 020B","E01000349","Total",650,151,104,47,499,14,127,108,96,22,39,93
"2011","Bexley 020C","E01000361","Total",602,158,67,91,444,27,54,104,100,12,40,107
"2011","Bexley 020D","E01000363","Total",565,137,79,58,428,18,76,65,105,10,49,105
"2011","Bexley 020E","E01000389","Total",714,215,95,120,499,40,114,70,126,14,35,100
"2011","Bexley 020F","E01000390","Total",515,141,88,53,374,14,92,63,73,11,38,83
"2011","Bexley 020G","E01000393","Total",640,175,83,92,465,26,62,103,114,10,40,110
"2011","Bexley 021A","E01000346","Total",625,146,76,70,479,26,80,112,98,17,43,103
"2011","Bexley 021B","E01000347","Total",618,188,115,73,430,42,68,87,96,13,34,90
"2011","Bexley 021C","E01000350","Total",521,88,44,44,433,32,82,72,64,11,56,116
"2011","Bexley 021D","E01000352","Total",676,218,100,118,458,41,88,92,94,17,36,90
"2011","Bexley 021E","E01000391","Total",644,141,74,67,503,35,83,113,103,13,49,107
"2011","Bexley 022A","E01000341","Total",610,164,104,60,446,21,125,95,69,16,28,92
"2011","Bexley 022B","E01000342","Total",644,158,67,91,486,24,75,129,117,11,31,99
"2011","Bexley 022C","E01000343","Total",550,99,52,47,451,15,84,108,78,23,45,98
"2011","Bexley 022D","E01000345","Total",487,86,47,39,401,26,61,85,65,11,42,111
"2011","Bexley 022E","E01000460","Total",498,82,24,58,416,11,66,72,105,11,44,107
"2011","Bexley 023A","E01000364","Total",651,182,86,96,469,20,120,81,90,21,32,105
"2011","Bexley 023B","E01000444","Total",626,122,72,50,504,15,144,84,103,12,52,94
"2011","Bexley 023C","E01000447","Total",713,272,120,152,441,33,68,110,126,14,26,64
"2011","Bexley 023D","E01000448","Total",504,80,58,22,424,4,120,86,80,17,29,88
"2011","Bexley 023E","E01000449","Total",648,210,149,61,438,15,119,79,95,17,24,89
"2011","Bexley 024A","E01000351","Total",616,128,75,53,488,20,117,93,98,14,50,96
"2011","Bexley 024B","E01000443","Total",510,142,71,71,368,10,81,90,67,18,31,71
"2011","Bexley 024C","E01000445","Total",687,182,110,72,505,15,155,96,85,15,38,101
"2011","Bexley 024D","E01000446","Total",602,121,44,77,481,20,74,109,126,24,30,98
"2011","Bexley 024E","E01000461","Total",569,76,55,21,493,15,103,76,75,25,47,152
"2011","Bexley 025A","E01000339","Total",602,145,88,57,457,29,96,93,90,11,39,99
"2011","Bexley 025B","E01000344","Total",646,169,95,74,477,25,103,113,95,19,33,89
"2011","Bexley 025C","E01000423","Total",609,121,87,34,488,10,108,119,96,13,43,99
"2011","Bexley 025D","E01000425","Total",590,99,64,35,491,12,110,101,92,20,48,108
"2011","Bexley 025E","E01000463","Total",452,72,39,33,380,12,68,89,71,11,37,92
"2011","Bexley 026A","E01000424","Total",765,282,111,171,483,10,101,73,158,15,34,92
"2011","Bexley 026B","E01000426","Total",712,215,96,119,497,36,72,110,138,17,35,89
"2011","Bexley 026C","E01000427","Total",922,372,226,146,550,42,115,98,141,14,37,103
"2011","Bexley 026D","E01000457","Total",825,347,153,194,478,42,65,89,164,9,19,90
"2011","Bexley 026E","E01000462","Total",738,299,143,156,439,30,83,82,121,5,24,94
"2011","Bexley 027A","E01000382","Total",587,128,84,44,459,16,116,79,91,21,42,94
"2011","Bexley 027B","E01000384","Total",780,282,155,127,498,36,82,109,132,16,30,93
"2011","Bexley 027C","E01000387","Total",618,149,90,59,469,23,109,83,109,16,41,88
"2011","Bexley 027D","E01000428","Total",882,467,167,300,415,39,67,59,134,10,23,83
"2011","Bexley 027E","E01000458","Total",631,209,140,69,422,8,112,73,87,9,38,95
"2011","Bexley 027F","E01000459","Total",781,336,200,136,445,25,107,74,99,12,41,87
"2011","Bexley 028A","E01000381","Total",660,207,86,121,453,44,82,106,97,16,39,69
"2011","Bexley 028B","E01000383","Total",633,176,92,84,457,23,120,60,113,19,41,81
"2011","Bexley 028C","E01000385","Total",770,217,60,157,553,103,75,105,126,34,36,74
"2011","Bexley 028D","E01000386","Total",659,270,118,152,389,64,56,75,72,24,25,73
"2011","Bexley 029A","E01000398","Total",611,142,64,78,469,35,94,77,93,14,58,98
"2011","Bexley 029B","E01000399","Total",619,170,113,57,449,22,97,70,87,7,56,110
"2011","Bexley 029C","E01000400","Total",590,146,75,71,444,20,76,88,97,18,48,97
"2011","Bexley 029D","E01032566","Total",747,258,112,146,489,56,95,79,111,16,41,91
"2011","Brent 001A","E01000587","Total",458,56,29,27,402,13,55,42,37,12,97,146
"2011","Brent 001B","E01000589","Total",592,98,36,62,494,12,64,91,56,24,77,170
"2011","Brent 001C","E01000590","Total",626,166,76,90,460,24,69,79,65,16,75,132
"2011","Brent 001D","E01000592","Total",525,116,39,77,409,22,53,50,47,11,74,152
"2011","Brent 001E","E01000593","Total",680,110,36,74,570,48,56,101,78,29,82,176
"2011","Brent 001F","E01000594","Total",527,110,53,57,417,22,47,75,39,20,69,145
"2011","Brent 002A","E01000513","Total",471,68,39,29,403,6,49,63,49,27,88,121
"2011","Brent 002B","E01000514","Total",495,108,36,72,387,25,30,80,57,15,66,114
"2011","Brent 002C","E01000516","Total",517,93,33,60,424,15,57,59,45,20,74,154
"2011","Brent 002D","E01000520","Total",586,160,80,80,426,28,61,84,64,17,61,111
"2011","Brent 002E","E01000588","Total",669,118,34,84,551,60,40,79,62,33,108,169
"2011","Brent 003A","E01000515","Total",628,193,65,128,435,35,37,93,78,12,76,104
"2011","Brent 003B","E01000517","Total",491,82,45,37,409,9,67,54,48,11,82,138
"2011","Brent 003E","E01000543","Total",500,86,39,47,414,14,59,59,52,16,76,138
"2011","Brent 003F","E01000591","Total",650,133,45,88,517,22,70,68,55,18,97,187
"2011","Brent 003G","E01033463","Total",848,128,68,60,720,17,114,75,60,26,135,293
"2011","Brent 004A","E01000536","Total",522,112,66,46,410,18,67,49,59,12,62,143
"2011","Brent 004B","E01000538","Total",478,66,43,23,412,5,74,57,56,21,74,125
"2011","Brent 004C","E01000539","Total",548,136,90,46,412,9,67,61,61,9,53,152
"2011","Brent 004D","E01000540","Total",471,68,47,21,403,8,79,53,51,11,55,146
"2011","Brent 004E","E01000541","Total",499,122,73,49,377,20,50,71,68,10,52,106
"2011","Brent 005A","E01000518","Total",557,119,55,64,438,25,52,66,68,32,67,128
"2011","Brent 005B","E01000519","Total",629,157,85,72,472,19,50,79,70,35,95,124
"2011","Brent 005C","E01000623","Total",541,90,42,48,451,17,53,76,56,22,72,155
"2011","Brent 005D","E01000624","Total",594,150,71,79,444,20,84,72,72,17,75,104
"2011","Brent 005E","E01000629","Total",605,119,54,65,486,17,58,59,78,23,87,164
"2011","Brent 006A","E01000480","Total",535,91,43,48,444,14,66,62,53,20,79,150
"2011","Brent 006B","E01000484","Total",423,111,39,72,312,32,29,52,53,19,51,76
"2011","Brent 006C","E01000485","Total",488,139,76,63,349,12,50,63,52,11,51,110
"2011","Brent 006D","E01000486","Total",532,99,42,57,433,10,60,61,57,28,84,133
"2011","Brent 006E","E01000487","Total",674,204,98,106,470,20,60,65,85,25,71,144
"2011","Brent 007A","E01000572","Total",462,84,51,33,378,20,42,68,41,11,65,131
"2011","Brent 007B","E01000573","Total",474,89,54,35,385,5,54,52,38,28,78,130
"2011","Brent 007C","E01000574","Total",428,79,45,34,349,23,39,60,36,16,60,115
"2011","Brent 007D","E01000575","Total",625,141,33,108,484,28,48,73,98,26,73,138
"2011","Brent 007E","E01000577","Total",793,161,25,136,632,74,26,160,139,37,88,108
"2011","Brent 008A","E01000562","Total",480,75,34,41,405,10,60,47,54,16,69,149
"2011","Brent 008B","E01000563","Total",474,67,41,26,407,7,78,41,57,10,68,146
"2011","Brent 008C","E01000566","Total",475,78,41,37,397,13,68,51,47,15,65,138
"2011","Brent 008D","E01000568","Total",787,439,30,409,348,11,37,63,85,10,42,100
"2011","Brent 008E","E01000569","Total",480,51,26,25,429,6,69,58,54,18,70,154
"2011","Brent 009A","E01000479","Total",510,102,50,52,408,11,69,46,52,22,79,129
"2011","Brent 009B","E01000481","Total",610,185,55,130,425,53,38,78,94,14,52,96
"2011","Brent 009C","E01000482","Total",992,290,78,212,702,92,34,142,140,42,98,154
"2011","Brent 009D","E01000483","Total",643,191,58,133,452,55,32,105,79,32,55,94
"2011","Brent 009E","E01000625","Total",557,173,81,92,384,20,60,68,74,17,54,91
"2011","Brent 010B","E01000498","Total",457,77,25,52,380,23,45,43,28,40,97,104
"2011","Brent 010D","E01000622","Total",636,215,60,155,421,40,31,99,104,21,44,82
"2011","Brent 010E","E01000626","Total",590,193,65,128,397,61,24,79,82,29,56,66
"2011","Brent 010F","E01033464","Total",813,139,74,65,674,36,81,53,44,80,148,232
"2011","Brent 011A","E01000497","Total",586,146,41,105,440,29,49,58,81,23,62,138
"2011","Brent 011B","E01000499","Total",500,69,37,32,431,37,55,47,56,40,90,106
"2011","Brent 011C","E01000501","Total",734,230,68,162,504,80,53,101,94,28,59,89
"2011","Brent 011D","E01000502","Total",453,115,45,70,338,31,36,74,37,20,55,85
"2011","Brent 011E","E01000503","Total",721,196,65,131,525,47,77,73,93,21,70,144
"2011","Brent 012A","E01000570","Total",513,103,41,62,410,33,43,60,61,16,75,122
"2011","Brent 012B","E01000571","Total",477,69,31,38,408,13,54,45,52,19,85,140
"2011","Brent 012C","E01000576","Total",534,121,67,54,413,13,57,42,59,14,82,146
"2011","Brent 012D","E01000578","Total",689,233,132,101,456,30,72,67,82,13,57,135
"2011","Brent 013A","E01000564","Total",460,82,29,53,378,18,30,76,49,18,81,106
"2011","Brent 013B","E01000565","Total",497,127,33,94,370,22,42,62,44,13,57,130
"2011","Brent 013C","E01000607","Total",667,141,60,81,526,28,57,77,52,35,115,162
"2011","Brent 013D","E01000608","Total",734,164,67,97,570,41,56,111,69,28,101,164
"2011","Brent 013E","E01000613","Total",639,188,46,142,451,44,30,92,108,18,64,95
"2011","Brent 014A","E01000506","Total",657,219,39,180,438,64,24,88,96,21,37,108
"2011","Brent 014B","E01000509","Total",430,87,35,52,343,17,55,24,36,25,67,119
"2011","Brent 014C","E01000510","Total",533,105,31,74,428,52,49,71,54,21,73,108
"2011","Brent 014D","E01000511","Total",543,129,36,93,414,62,31,71,57,24,63,106
"2011","Brent 014E","E01000627","Total",653,177,43,134,476,55,38,62,76,46,69,130
"2011","Brent 014F","E01000628","Total",633,186,47,139,447,43,31,67,61,30,69,146
"2011","Brent 015A","E01000553","Total",696,168,30,138,528,43,23,87,109,15,71,180
"2011","Brent 015B","E01000554","Total",683,172,41,131,511,53,33,93,120,18,56,138
"2011","Brent 015C","E01000555","Total",512,124,32,92,388,20,55,52,68,20,51,122
"2011","Brent 015D","E01000556","Total",800,312,28,284,488,53,14,64,172,16,40,129
"2011","Brent 015E","E01000557","Total",751,241,43,198,510,28,38,80,154,8,53,149
"2011","Brent 015F","E01000558","Total",665,259,49,210,406,27,35,62,145,7,26,104
"2011","Brent 016A","E01000567","Total",486,125,65,60,361,19,49,74,58,15,48,98
"2011","Brent 016B","E01000606","Total",567,154,81,73,413,29,41,58,70,29,61,125
"2011","Brent 016C","E01000609","Total",640,113,36,77,527,37,52,90,60,28,107,153
"2011","Brent 016D","E01000611","Total",454,111,39,72,343,16,39,49,39,12,63,125
"2011","Brent 017B","E01000615","Total",563,107,23,84,456,28,46,85,108,19,55,115
"2011","Brent 017C","E01000617","Total",528,118,69,49,410,6,40,45,55,21,80,163
"2011","Brent 017D","E01000618","Total",500,107,74,33,393,15,63,28,44,32,79,132
"2011","Brent 017E","E01000619","Total",473,58,34,24,415,16,59,40,42,29,69,160
"2011","Brent 017F","E01033424","Total",638,262,26,236,376,47,6,76,149,19,23,56
"2011","Brent 017G","E01033457","Total",562,120,33,87,442,19,41,102,78,13,57,132
"2011","Brent 018A","E01000504","Total",676,222,42,180,454,25,38,75,138,14,32,132
"2011","Brent 018B","E01000505","Total",525,124,37,87,401,28,49,45,48,27,63,141
"2011","Brent 018C","E01000507","Total",508,81,41,40,427,21,59,45,63,22,64,153
"2011","Brent 018D","E01000512","Total",610,157,32,125,453,23,32,73,108,14,41,162
"2011","Brent 018E","E01000559","Total",650,234,71,163,416,21,20,64,182,5,16,108
"2011","Brent 019A","E01000610","Total",621,159,52,107,462,29,44,89,62,23,82,133
"2011","Brent 019B","E01000612","Total",521,113,44,69,408,15,49,57,57,27,75,128
"2011","Brent 019C","E01000631","Total",522,78,33,45,444,15,51,56,41,9,97,175
"2011","Brent 019D","E01000633","Total",554,93,37,56,461,8,49,61,62,10,103,168
"2011","Brent 019E","E01000634","Total",696,123,29,94,573,41,30,100,84,35,123,160
"2011","Brent 020A","E01000616","Total",586,146,45,101,440,18,37,66,83,12,69,155
"2011","Brent 020B","E01000620","Total",500,90,38,52,410,17,55,42,48,17,82,149
"2011","Brent 020C","E01000621","Total",514,88,32,56,426,24,43,53,37,18,94,157
"2011","Brent 020D","E01000635","Total",774,174,28,146,600,45,47,86,101,17,107,197
"2011","Brent 020E","E01000636","Total",518,88,32,56,430,10,47,58,40,7,72,196
"2011","Brent 021A","E01000596","Total",640,213,79,134,427,105,36,57,53,29,57,90
"2011","Brent 021B","E01000601","Total",477,105,29,76,372,70,23,55,48,35,67,74
"2011","Brent 021C","E01000602","Total",512,143,40,103,369,47,27,45,43,30,75,102
"2011","Brent 021D","E01000603","Total",576,162,31,131,414,87,26,91,77,20,37,76
"2011","Brent 021E","E01000604","Total",548,122,32,90,426,40,37,52,57,39,86,115
"2011","Brent 021F","E01000605","Total",553,131,42,89,422,68,37,54,50,31,76,106
"2011","Brent 022A","E01000488","Total",533,125,31,94,408,33,34,81,80,22,46,112
"2011","Brent 022B","E01000637","Total",636,200,48,152,436,39,35,71,102,15,42,132
"2011","Brent 022C","E01000639","Total",716,228,39,189,488,26,30,76,172,16,25,143
"2011","Brent 022D","E01000642","Total",915,342,55,287,573,30,30,84,234,11,39,145
"2011","Brent 022E","E01000644","Total",728,208,67,141,520,46,32,92,137,17,62,134
"2011","Brent 023A","E01000490","Total",787,316,36,280,471,30,24,91,218,6,14,88
"2011","Brent 023B","E01000494","Total",724,281,100,181,443,30,33,59,132,16,40,133
"2011","Brent 023C","E01000495","Total",850,455,155,300,395,32,34,52,161,10,16,90
"2011","Brent 023D","E01000560","Total",727,258,50,208,469,25,33,67,169,15,17,143
"2011","Brent 023E","E01000561","Total",823,320,70,250,503,38,34,88,186,21,20,116
"2011","Brent 024A","E01000638","Total",715,219,35,184,496,77,29,92,84,16,55,143
"2011","Brent 024B","E01000640","Total",802,250,38,212,552,62,35,88,142,21,75,129
"2011","Brent 024C","E01000641","Total",715,203,50,153,512,77,22,86,102,23,57,145
"2011","Brent 024D","E01000643","Total",840,306,115,191,534,83,37,96,100,31,77,110
"2011","Brent 025A","E01000508","Total",716,227,73,154,489,55,43,78,81,35,81,116
"2011","Brent 025B","E01000521","Total",905,351,47,304,554,104,37,102,122,31,58,100
"2011","Brent 025C","E01000522","Total",710,184,53,131,526,85,44,108,79,31,65,114
"2011","Brent 025D","E01000526","Total",813,260,67,193,553,98,40,75,87,37,87,129
"2011","Brent 025E","E01000527","Total",813,264,60,204,549,109,44,105,83,33,63,112
"2011","Brent 025F","E01000528","Total",600,244,54,190,356,56,30,63,53,22,59,73
"2011","Brent 026A","E01000471","Total",469,66,24,42,403,15,47,60,51,13,99,118
"2011","Brent 026B","E01000474","Total",501,65,34,31,436,10,31,45,44,22,141,143
"2011","Brent 026C","E01000476","Total",455,56,33,23,399,7,53,43,43,10,90,153
"2011","Brent 026D","E01000477","Total",656,171,42,129,485,44,32,110,88,21,78,112
"2011","Brent 026E","E01000630","Total",768,219,41,178,549,51,60,78,87,22,93,158
"2011","Brent 027A","E01000595","Total",582,177,38,139,405,80,27,62,52,25,75,84
"2011","Brent 027D","E01000599","Total",489,146,57,89,343,36,29,65,75,16,53,69
"2011","Brent 027E","E01000600","Total",783,286,75,211,497,73,27,114,91,27,75,90
"2011","Brent 027F","E01033456","Total",743,230,87,143,513,78,35,70,58,45,104,123
"2011","Brent 028A","E01000545","Total",856,338,62,276,518,36,31,68,222,8,20,133
"2011","Brent 028B","E01000546","Total",756,285,65,220,471,40,40,79,181,8,22,101
"2011","Brent 028C","E01000547","Total",768,271,43,228,497,43,41,97,161,6,38,111
"2011","Brent 028D","E01000548","Total",1014,442,77,365,572,32,45,63,258,17,26,131
"2011","Brent 028E","E01000549","Total",883,305,55,250,578,41,38,113,243,16,26,101
"2011","Brent 029A","E01000472","Total",512,146,29,117,366,22,23,82,102,11,36,90
"2011","Brent 029B","E01000473","Total",520,98,46,52,422,17,36,41,42,9,111,166
"2011","Brent 029C","E01000475","Total",596,102,39,63,494,30,45,80,59,18,93,169
"2011","Brent 029D","E01000478","Total",447,64,24,40,383,15,47,29,36,17,101,138
"2011","Brent 029E","E01000632","Total",548,73,32,41,475,8,58,47,37,15,121,189
"2011","Brent 030A","E01000489","Total",593,180,96,84,413,22,47,60,83,20,49,132
"2011","Brent 030B","E01000491","Total",806,297,85,212,509,39,47,86,138,34,51,114
"2011","Brent 030C","E01000492","Total",467,116,38,78,351,12,52,59,60,14,39,115
"2011","Brent 030D","E01000493","Total",578,129,52,77,449,26,63,70,93,19,47,131
"2011","Brent 030E","E01000581","Total",603,164,42,122,439,31,28,100,121,26,25,108
"2011","Brent 031A","E01000523","Total",993,313,60,253,680,99,39,127,159,46,63,147
"2011","Brent 031B","E01000524","Total",1035,391,60,331,644,143,39,112,138,24,72,116
"2011","Brent 031C","E01000525","Total",785,276,60,216,509,92,26,89,107,24,73,98
"2011","Brent 031E","E01000533","Total",952,355,70,285,597,97,33,125,147,22,58,115
"2011","Brent 031F","E01000535","Total",829,243,43,200,586,50,35,118,149,15,67,152
"2011","Brent 031G","E01033455","Total",501,203,27,176,298,44,20,55,78,18,28,55
"2011","Brent 031H","E01033485","Total",789,288,52,236,501,86,43,84,90,19,61,118
"2011","Brent 032A","E01000579","Total",683,204,43,161,479,47,42,74,142,8,36,130
"2011","Brent 032B","E01000580","Total",821,269,69,200,552,41,56,121,156,24,32,122
"2011","Brent 032C","E01000582","Total",720,198,43,155,522,40,47,126,129,20,33,127
"2011","Brent 032D","E01000583","Total",1017,365,57,308,652,39,47,114,261,18,33,140
"2011","Brent 032E","E01000586","Total",1093,378,52,326,715,77,24,87,306,19,45,157
"2011","Brent 033A","E01000530","Total",700,181,42,139,519,41,64,76,121,14,46,157
"2011","Brent 033B","E01000531","Total",908,323,72,251,585,64,44,110,172,22,39,134
"2011","Brent 033C","E01000532","Total",733,304,39,265,429,29,47,66,118,12,39,118
"2011","Brent 033D","E01000534","Total",651,187,51,136,464,39,39,87,89,23,65,122
"2011","Brent 033E","E01000584","Total",619,149,51,98,470,33,53,88,103,14,42,137
"2011","Brent 033F","E01000585","Total",718,200,23,177,518,37,45,106,146,24,35,125
"2011","Brent 034A","E01000544","Total",742,295,41,254,447,51,17,70,133,28,61,87
"2011","Brent 034B","E01000550","Total",906,363,86,277,543,71,38,89,193,15,37,100
"2011","Brent 034C","E01000551","Total",940,394,75,319,546,103,48,92,104,48,55,96
"2011","Brent 034D","E01000552","Total",793,349,88,261,444,73,39,91,84,37,46,74
"2011","Bromley 001A","E01000779","Total",551,189,67,122,362,17,72,67,112,8,23,63
"2011","Bromley 001B","E01000780","Total",628,188,83,105,440,62,71,69,115,19,32,72
"2011","Bromley 001C","E01000781","Total",614,190,71,119,424,79,52,89,95,20,33,56
"2011","Bromley 001D","E01000782","Total",647,262,82,180,385,81,55,66,68,14,43,58
"2011","Bromley 001E","E01000783","Total",626,188,83,105,438,82,58,97,90,14,37,60
"2011","Bromley 001F","E01000785","Total",609,216,84,132,393,60,58,77,92,13,33,60
"2011","Bromley 002A","E01000689","Total",612,232,98,134,380,41,59,69,107,9,35,60
"2011","Bromley 002B","E01000690","Total",534,117,73,44,417,19,78,104,80,13,35,88
"2011","Bromley 002C","E01000691","Total",619,209,103,106,410,32,75,103,89,9,29,73
"2011","Bromley 002D","E01000692","Total",659,184,77,107,475,39,79,111,123,12,28,83
"2011","Bromley 002E","E01000784","Total",582,130,49,81,452,30,59,120,107,21,30,85
"2011","Bromley 004A","E01000799","Total",719,254,48,206,465,61,49,89,128,14,40,84
"2011","Bromley 004B","E01000802","Total",750,277,55,222,473,35,39,102,144,19,51,83
"2011","Bromley 004C","E01000803","Total",730,273,72,201,457,45,48,96,152,13,32,71
"2011","Bromley 004D","E01000804","Total",548,128,58,70,420,15,82,78,92,20,41,92
"2011","Bromley 004E","E01000805","Total",717,280,83,197,437,49,55,86,137,12,28,70
"2011","Bromley 005A","E01000740","Total",871,424,43,381,447,61,17,109,153,23,30,54
"2011","Bromley 005B","E01000741","Total",842,427,47,380,415,60,25,73,169,6,31,51
"2011","Bromley 005C","E01000742","Total",1044,505,40,465,539,98,16,94,223,10,29,69
"2011","Bromley 005D","E01000745","Total",883,380,59,321,503,73,34,97,223,10,24,42
"2011","Bromley 005E","E01000746","Total",949,424,76,348,525,67,41,106,209,11,26,65
"2011","Bromley 006A","E01000709","Total",787,463,195,268,324,20,55,63,131,4,10,41
"2011","Bromley 006B","E01000710","Total",862,391,109,282,471,33,56,87,219,5,12,59
"2011","Bromley 006C","E01000711","Total",1012,531,145,386,481,17,62,72,275,6,7,42
"2011","Bromley 006D","E01000714","Total",1036,491,125,366,545,45,60,90,269,6,17,58
"2011","Bromley 006E","E01000718","Total",971,386,99,287,585,104,62,101,179,25,41,73
"2011","Bromley 007A","E01000645","Total",536,100,48,52,436,8,118,88,86,14,40,82
"2011","Bromley 007B","E01000649","Total",774,212,104,108,562,23,107,121,133,19,60,99
"2011","Bromley 007C","E01000694","Total",635,138,93,45,497,9,136,121,91,14,30,96
"2011","Bromley 007D","E01000695","Total",614,154,81,73,460,20,101,93,119,22,22,83
"2011","Bromley 007E","E01000696","Total",637,196,99,97,441,18,130,89,91,16,33,64
"2011","Bromley 007F","E01000697","Total",765,288,100,188,477,11,96,106,158,12,27,67
"2011","Bromley 008A","E01000674","Total",802,377,167,210,425,29,50,102,155,10,22,57
"2011","Bromley 008B","E01000676","Total",866,367,122,245,499,67,51,101,181,6,31,62
"2011","Bromley 008C","E01000820","Total",643,262,86,176,381,34,54,93,111,13,16,60
"2011","Bromley 008D","E01000822","Total",727,267,80,187,460,44,48,109,157,11,24,67
"2011","Bromley 008E","E01000823","Total",747,257,59,198,490,36,52,112,164,19,28,79
"2011","Bromley 008F","E01000824","Total",514,166,35,131,348,28,31,95,104,6,30,54
"2011","Bromley 008G","E01000825","Total",807,360,119,241,447,47,62,99,165,10,21,43
"2011","Bromley 009A","E01000743","Total",841,378,85,293,463,107,41,96,120,9,22,68
"2011","Bromley 009B","E01000744","Total",682,296,72,224,386,97,23,63,88,11,33,71
"2011","Bromley 009C","E01000796","Total",638,184,39,145,454,88,36,82,95,25,55,73
"2011","Bromley 009D","E01000798","Total",693,314,72,242,379,91,25,49,88,14,40,72
"2011","Bromley 009E","E01000800","Total",780,356,40,316,424,67,22,94,144,12,34,51
"2011","Bromley 009F","E01000806","Total",768,301,48,253,467,91,16,92,139,18,45,66
"2011","Bromley 010A","E01000693","Total",570,199,125,74,371,10,100,77,91,9,26,58
"2011","Bromley 010B","E01000698","Total",439,71,51,20,368,10,105,51,54,8,33,107
"2011","Bromley 010C","E01000736","Total",618,179,76,103,439,43,73,95,73,20,47,88
"2011","Bromley 010D","E01000737","Total",580,203,89,114,377,51,71,64,82,15,39,55
"2011","Bromley 011A","E01000672","Total",650,208,72,136,442,24,89,95,123,22,23,66
"2011","Bromley 011B","E01000673","Total",630,174,63,111,456,21,70,124,116,19,37,69
"2011","Bromley 011C","E01000716","Total",702,280,105,175,422,16,107,75,109,10,29,76
"2011","Bromley 011D","E01000717","Total",889,427,116,311,462,29,76,74,195,5,19,64
"2011","Bromley 011E","E01000828","Total",766,305,145,160,461,19,96,93,139,17,31,66
"2011","Bromley 012A","E01000712","Total",862,370,121,249,492,20,94,84,214,6,23,51
"2011","Bromley 012B","E01000713","Total",885,383,100,283,502,30,85,92,195,10,17,73
"2011","Bromley 012C","E01000715","Total",885,408,159,249,477,14,100,91,184,13,9,66
"2011","Bromley 012D","E01000770","Total",691,275,152,123,416,8,135,66,103,14,23,67
"2011","Bromley 012E","E01000772","Total",734,293,176,117,441,11,134,90,103,16,19,68
"2011","Bromley 013A","E01000700","Total",666,208,51,157,458,53,37,113,146,11,23,75
"2011","Bromley 013B","E01000702","Total",572,181,52,129,391,16,40,99,131,7,21,77
"2011","Bromley 013C","E01000703","Total",694,237,64,173,457,37,44,113,151,19,27,66
"2011","Bromley 013D","E01000706","Total",591,224,76,148,367,26,53,100,99,7,26,56
"2011","Bromley 013E","E01000797","Total",679,229,58,171,450,18,58,98,150,19,31,76
"2011","Bromley 014A","E01000729","Total",824,361,94,267,463,95,57,94,90,19,49,59
"2011","Bromley 014B","E01000730","Total",649,171,56,115,478,95,45,90,93,26,58,71
"2011","Bromley 014C","E01000735","Total",562,162,69,93,400,36,63,78,66,29,50,78
"2011","Bromley 014D","E01000738","Total",632,182,102,80,450,46,95,88,92,13,31,85
"2011","Bromley 014E","E01000739","Total",634,231,106,125,403,72,62,75,61,28,40,65
"2011","Bromley 015A","E01000699","Total",648,254,45,209,394,57,24,91,119,11,35,57
"2011","Bromley 015B","E01000701","Total",599,214,52,162,385,27,35,106,127,10,18,62
"2011","Bromley 015C","E01000704","Total",593,192,82,110,401,29,47,97,98,13,45,72
"2011","Bromley 015D","E01000705","Total",565,206,56,150,359,42,25,78,99,16,32,67
"2011","Bromley 015E","E01000801","Total",650,263,67,196,387,49,58,66,93,15,36,70
"2011","Bromley 016A","E01000646","Total",728,275,110,165,453,25,72,98,149,15,26,68
"2011","Bromley 016B","E01000647","Total",635,142,53,89,493,38,57,127,142,23,35,71
"2011","Bromley 016C","E01000648","Total",646,149,45,104,497,27,66,142,105,26,43,88
"2011","Bromley 016D","E01000653","Total",608,164,96,68,444,11,118,79,90,25,28,93
"2011","Bromley 016E","E01000678","Total",666,174,70,104,492,27,59,117,118,25,47,99
"2011","Bromley 018A","E01000670","Total",864,301,69,232,563,36,97,122,154,11,36,107
"2011","Bromley 018B","E01000675","Total",690,218,81,137,472,25,59,107,145,19,27,90
"2011","Bromley 018C","E01000677","Total",800,263,50,213,537,57,45,158,192,14,19,52
"2011","Bromley 018D","E01000762","Total",743,271,132,139,472,23,119,90,103,12,35,90
"2011","Bromley 018E","E01000829","Total",734,227,76,151,507,27,67,150,130,19,28,86
"2011","Bromley 019A","E01000719","Total",853,294,88,206,559,103,64,133,141,21,32,65
"2011","Bromley 019B","E01000720","Total",668,210,44,166,458,83,46,95,118,25,40,51
"2011","Bromley 019C","E01000721","Total",524,165,78,87,359,72,42,71,49,23,36,66
"2011","Bromley 019D","E01000724","Total",674,187,77,110,487,96,64,88,72,35,54,78
"2011","Bromley 019E","E01000728","Total",657,215,88,127,442,55,108,65,97,17,23,77
"2011","Bromley 020A","E01000651","Total",631,221,112,109,410,17,65,110,87,15,28,88
"2011","Bromley 020B","E01000668","Total",691,218,78,140,473,26,54,134,134,17,31,77
"2011","Bromley 020C","E01000669","Total",740,251,74,177,489,49,59,133,132,19,27,70
"2011","Bromley 020D","E01000671","Total",784,301,163,138,483,26,63,118,136,16,31,93
"2011","Bromley 020E","E01000679","Total",662,166,53,113,496,43,61,141,121,21,28,81
"2011","Bromley 021A","E01000826","Total",563,89,48,41,474,8,116,88,58,28,55,121
"2011","Bromley 021B","E01000827","Total",790,293,137,156,497,25,125,105,120,17,27,78
"2011","Bromley 021C","E01000830","Total",544,76,53,23,468,9,113,83,83,23,60,97
"2011","Bromley 021D","E01000831","Total",789,334,156,178,455,13,110,85,118,21,32,76
"2011","Bromley 021E","E01000833","Total",497,74,50,24,423,17,81,85,66,33,47,94
"2011","Bromley 022A","E01000650","Total",750,203,107,96,547,26,126,118,105,23,51,98
"2011","Bromley 022B","E01000652","Total",659,158,101,57,501,21,125,99,105,18,37,96
"2011","Bromley 022C","E01000807","Total",595,115,61,54,480,30,96,117,99,17,33,88
"2011","Bromley 022D","E01000809","Total",629,171,106,65,458,15,105,101,107,16,32,82
"2011","Bromley 023A","E01000722","Total",704,208,81,127,496,59,73,101,141,10,42,70
"2011","Bromley 023B","E01000725","Total",775,314,106,208,461,77,51,99,131,17,28,58
"2011","Bromley 023C","E01000731","Total",532,127,58,69,405,64,56,63,91,11,36,84
"2011","Bromley 023D","E01000732","Total",587,147,79,68,440,24,93,85,93,11,52,82
"2011","Bromley 023E","E01000733","Total",651,177,82,95,474,43,79,103,99,15,35,100
"2011","Bromley 024A","E01000769","Total",454,86,46,40,368,13,52,61,63,23,46,110
"2011","Bromley 024B","E01000773","Total",605,163,121,42,442,19,95,97,90,21,40,80
"2011","Bromley 024C","E01000775","Total",867,207,91,116,660,34,112,190,121,27,69,107
"2011","Bromley 024D","E01000777","Total",565,101,49,52,464,22,83,117,72,15,51,104
"2011","Bromley 024E","E01000778","Total",618,170,88,82,448,26,65,117,81,21,44,94
"2011","Bromley 025A","E01000808","Total",625,126,78,48,499,19,124,118,110,18,33,77
"2011","Bromley 025B","E01000810","Total",599,112,73,39,487,12,140,111,103,13,27,81
"2011","Bromley 025C","E01000811","Total",571,163,83,80,408,23,71,100,113,8,22,71
"2011","Bromley 025D","E01000813","Total",637,142,104,38,495,12,131,102,100,15,41,94
"2011","Bromley 025E","E01000815","Total",562,79,55,24,483,5,135,104,90,18,37,94
"2011","Bromley 026A","E01000661","Total",671,201,67,134,470,107,59,73,95,19,32,85
"2011","Bromley 026B","E01000662","Total",680,185,97,88,495,26,80,100,109,22,58,100
"2011","Bromley 026C","E01000663","Total",660,197,113,84,463,39,80,103,87,24,43,87
"2011","Bromley 026D","E01000664","Total",612,151,96,55,461,39,73,91,90,20,50,98
"2011","Bromley 027A","E01000763","Total",523,95,54,41,428,17,84,97,67,18,39,106
"2011","Bromley 027B","E01000764","Total",633,169,108,61,464,22,94,105,86,18,47,92
"2011","Bromley 027C","E01000766","Total",645,131,85,46,514,10,106,115,106,25,46,106
"2011","Bromley 027D","E01000767","Total",598,108,78,30,490,13,94,122,90,25,46,100
"2011","Bromley 027E","E01000834","Total",461,68,37,31,393,25,63,105,48,8,43,101
"2011","Bromley 028A","E01000727","Total",687,227,133,94,460,27,93,86,127,17,32,78
"2011","Bromley 028B","E01000734","Total",507,95,48,47,412,50,71,87,75,15,44,70
"2011","Bromley 028C","E01000790","Total",872,297,99,198,575,52,71,115,176,16,50,95
"2011","Bromley 028D","E01000812","Total",663,211,103,108,452,18,106,77,112,12,23,104
"2011","Bromley 028E","E01000814","Total",564,85,59,26,479,0,123,76,95,14,55,116
"2011","Bromley 029A","E01000723","Total",561,153,96,57,408,18,130,49,100,11,20,80
"2011","Bromley 029B","E01000726","Total",590,204,89,115,386,22,103,57,102,13,29,60
"2011","Bromley 029C","E01000787","Total",667,265,124,141,402,23,122,69,76,11,26,75
"2011","Bromley 029D","E01000788","Total",618,167,84,83,451,29,87,81,96,10,42,106
"2011","Bromley 029E","E01000791","Total",621,179,125,54,442,22,132,71,87,12,35,83
"2011","Bromley 030A","E01000832","Total",572,152,109,43,420,10,91,85,67,23,44,100
"2011","Bromley 030B","E01000835","Total",648,192,90,102,456,41,77,96,82,19,52,89
"2011","Bromley 030C","E01000836","Total",500,83,41,42,417,23,77,108,56,17,38,98
"2011","Bromley 030D","E01000837","Total",647,224,125,99,423,27,98,83,75,22,38,80
"2011","Bromley 030E","E01000838","Total",548,126,81,45,422,8,115,89,55,14,45,96
"2011","Bromley 030F","E01000839","Total",550,86,52,34,464,10,94,104,101,14,42,99
"2011","Bromley 030G","E01000840","Total",685,204,173,31,481,9,160,70,96,11,29,106
"2011","Bromley 030H","E01000841","Total",606,140,97,43,466,14,103,110,80,14,38,107
"2011","Bromley 031A","E01000753","Total",750,192,127,65,558,20,191,96,93,22,45,91
"2011","Bromley 031B","E01000754","Total",743,261,145,116,482,38,99,121,99,14,35,76
"2011","Bromley 031C","E01000755","Total",615,174,114,60,441,15,118,90,75,20,37,86
"2011","Bromley 031D","E01000757","Total",601,120,88,32,481,6,125,90,115,15,29,101
"2011","Bromley 031E","E01000758","Total",591,137,97,40,454,15,111,84,96,17,30,101
"2011","Bromley 032A","E01000786","Total",627,160,111,49,467,11,162,58,107,14,24,91
"2011","Bromley 032B","E01000789","Total",657,168,48,120,489,137,29,94,82,39,42,66
"2011","Bromley 032C","E01000792","Total",483,134,80,54,349,31,101,50,63,14,23,67
"2011","Bromley 032D","E01000793","Total",643,135,101,34,508,8,166,86,95,19,29,105
"2011","Bromley 032E","E01000795","Total",542,123,62,61,419,26,84,91,79,20,45,74
"2011","Bromley 033A","E01000665","Total",757,205,97,108,552,39,93,127,149,19,39,86
"2011","Bromley 033B","E01000666","Total",776,201,116,85,575,20,181,91,126,9,49,99
"2011","Bromley 033C","E01000667","Total",622,124,88,36,498,16,140,88,93,23,42,96
"2011","Bromley 033D","E01000756","Total",594,132,86,46,462,15,113,70,84,25,59,96
"2011","Bromley 034A","E01000759","Total",549,94,63,31,455,12,81,95,87,21,59,100
"2011","Bromley 034B","E01000760","Total",550,140,84,56,410,23,67,86,80,13,43,98
"2011","Bromley 034C","E01000761","Total",577,110,55,55,467,20,95,90,103,24,48,87
"2011","Bromley 034D","E01000765","Total",679,188,88,100,491,23,97,99,106,31,35,100
"2011","Bromley 034E","E01000768","Total",613,160,112,48,453,19,98,88,91,18,41,98
"2011","Bromley 035A","E01000681","Total",654,148,85,63,506,14,93,128,98,21,46,106
"2011","Bromley 035B","E01000682","Total",642,195,131,64,447,17,107,101,80,14,40,88
"2011","Bromley 035C","E01000683","Total",705,255,89,166,450,25,73,118,120,13,36,65
"2011","Bromley 035D","E01000684","Total",757,138,65,73,619,17,117,162,134,35,46,108
"2011","Bromley 035E","E01000794","Total",611,120,76,44,491,7,139,82,94,18,39,112
"2011","Bromley 036A","E01000749","Total",639,139,92,47,500,18,146,85,103,20,27,101
"2011","Bromley 036B","E01000750","Total",665,240,115,125,425,51,73,63,94,13,41,90
"2011","Bromley 036C","E01000751","Total",807,236,130,106,571,31,122,150,111,23,55,79
"2011","Bromley 036D","E01000752","Total",778,301,173,128,477,36,154,75,101,15,35,61
"2011","Bromley 037A","E01000680","Total",646,134,68,66,512,10,150,89,114,18,37,94
"2011","Bromley 037B","E01000685","Total",618,162,88,74,456,20,84,113,89,22,40,88
"2011","Bromley 037C","E01000686","Total",648,195,117,78,453,19,115,81,101,13,37,87
"2011","Bromley 037D","E01000687","Total",656,157,88,69,499,27,121,94,117,11,39,90
"2011","Bromley 037E","E01000688","Total",504,80,56,24,424,4,101,87,84,20,38,90
"2011","Bromley 039A","E01000654","Total",486,89,29,60,397,20,58,90,101,22,23,83
"2011","Bromley 039B","E01000655","Total",494,91,30,61,403,26,59,83,97,29,27,82
"2011","Bromley 039C","E01000656","Total",517,90,45,45,427,14,81,80,104,15,39,94
"2011","Bromley 039D","E01000657","Total",674,191,90,101,483,45,79,97,131,13,32,86
"2011","Bromley 039E","E01000659","Total",520,89,38,51,431,21,59,86,99,17,58,91
"2011","Bromley 040A","E01000816","Total",592,140,69,71,452,34,77,87,106,12,37,99
"2011","Bromley 040B","E01000818","Total",568,116,61,55,452,27,94,84,102,14,39,92
"2011","Bromley 040C","E01000819","Total",740,260,101,159,480,73,60,103,109,21,37,77
"2011","Bromley 040D","E01032562","Total",623,197,71,126,426,92,55,64,73,18,47,77
"2011","Bromley 040E","E01032563","Total",568,155,81,74,413,10,111,78,83,15,36,80
"2011","Bromley 041A","E01000707","Total",536,115,41,74,421,18,30,147,109,27,28,62
"2011","Bromley 041B","E01000708","Total",650,201,92,109,449,29,55,116,122,16,29,82
"2011","Bromley 041C","E01000771","Total",620,126,63,63,494,19,99,119,104,20,35,98
"2011","Bromley 041D","E01000774","Total",581,141,62,79,440,29,76,105,90,17,33,90
"2011","Bromley 041E","E01032568","Total",647,229,97,132,418,55,43,93,103,11,30,83
"2011","Bromley 042A","E01000658","Total",550,118,82,36,432,17,130,57,89,9,35,95
"2011","Bromley 042B","E01000747","Total",773,196,85,111,577,38,109,126,143,35,36,90
"2011","Bromley 042C","E01000748","Total",670,174,96,78,496,20,152,60,100,16,35,113
"2011","Bromley 042D","E01032570","Total",669,195,122,73,474,34,118,67,114,19,32,90
"2011","Croydon 001A","E01001137","Total",875,388,113,275,487,75,54,85,170,13,28,62
"2011","Croydon 001B","E01001138","Total",774,319,74,245,455,72,38,95,164,14,23,49
"2011","Croydon 001C","E01001156","Total",721,288,96,192,433,73,26,78,125,21,37,73
"2011","Croydon 001D","E01001162","Total",767,262,59,203,505,107,39,95,140,18,40,66
"2011","Croydon 001E","E01001164","Total",962,404,47,357,558,83,20,108,253,9,18,67
"2011","Croydon 002A","E01001084","Total",665,153,70,83,512,31,96,83,93,19,60,130
"2011","Croydon 002B","E01001157","Total",615,142,53,89,473,33,65,96,84,22,55,118
"2011","Croydon 002C","E01001159","Total",741,221,88,133,520,48,74,108,111,20,48,111
"2011","Croydon 002D","E01001160","Total",627,122,46,76,505,21,78,61,89,24,86,146
"2011","Croydon 002E","E01001163","Total",798,245,69,176,553,52,71,132,133,19,53,93
"2011","Croydon 003A","E01001083","Total",536,100,51,49,436,14,95,58,56,23,69,121
"2011","Croydon 003B","E01001086","Total",603,123,56,67,480,32,65,75,66,17,62,163
"2011","Croydon 003C","E01001087","Total",848,285,72,213,563,63,59,79,119,18,65,160
"2011","Croydon 003D","E01001161","Total",566,106,36,70,460,60,44,47,47,29,91,142
"2011","Croydon 004A","E01001085","Total",612,204,97,107,408,31,58,83,57,17,50,112
"2011","Croydon 004B","E01001088","Total",592,109,38,71,483,57,59,90,84,33,58,102
"2011","Croydon 004C","E01001089","Total",715,223,87,136,492,86,47,91,76,25,61,106
"2011","Croydon 004D","E01001090","Total",922,270,77,193,652,127,56,104,162,30,56,117
"2011","Croydon 004E","E01001091","Total",562,130,53,77,432,19,69,68,83,19,53,121
"2011","Croydon 005A","E01001147","Total",620,183,38,145,437,99,24,89,68,30,50,77
"2011","Croydon 005B","E01001148","Total",673,235,53,182,438,73,31,90,89,25,46,84
"2011","Croydon 005C","E01001151","Total",671,269,94,175,402,71,27,77,85,29,49,64
"2011","Croydon 005D","E01001152","Total",674,242,52,190,432,98,21,78,85,19,54,77
"2011","Croydon 005E","E01001158","Total",700,251,46,205,449,91,37,88,122,16,25,70
"2011","Croydon 006A","E01001146","Total",607,152,41,111,455,61,46,69,94,17,47,121
"2011","Croydon 006B","E01001149","Total",619,174,27,147,445,73,42,94,99,26,42,69
"2011","Croydon 006C","E01001150","Total",620,158,39,119,462,65,46,98,82,18,64,89
"2011","Croydon 006D","E01001153","Total",591,165,56,109,426,57,41,70,62,21,67,108
"2011","Croydon 006E","E01001154","Total",735,199,49,150,536,110,31,104,93,28,72,98
"2011","Croydon 007A","E01001136","Total",927,445,67,378,482,106,25,96,144,11,31,69
"2011","Croydon 007B","E01001139","Total",694,243,59,184,451,58,39,76,132,17,45,84
"2011","Croydon 007C","E01001140","Total",773,317,61,256,456,80,30,81,173,13,24,55
"2011","Croydon 007D","E01001142","Total",620,178,50,128,442,61,57,76,103,18,49,78
"2011","Croydon 007E","E01001144","Total",797,367,56,311,430,106,24,73,103,19,36,69
"2011","Croydon 008A","E01001141","Total",568,227,49,178,341,75,24,67,85,14,25,51
"2011","Croydon 008B","E01001143","Total",848,322,99,223,526,106,60,84,106,20,61,89
"2011","Croydon 008C","E01001145","Total",848,384,64,320,464,155,25,101,95,11,23,54
"2011","Croydon 008D","E01001191","Total",823,347,47,300,476,102,29,77,127,20,44,77
"2011","Croydon 008E","E01001192","Total",727,269,69,200,458,118,26,94,105,17,31,67
"2011","Croydon 009A","E01000994","Total",536,118,35,83,418,40,50,63,59,30,64,112
"2011","Croydon 009B","E01000995","Total",597,167,58,109,430,54,59,78,71,24,45,99
"2011","Croydon 009C","E01000996","Total",443,109,34,75,334,28,30,44,60,12,56,104
"2011","Croydon 009D","E01000997","Total",471,122,51,71,349,35,34,60,43,18,59,100
"2011","Croydon 009E","E01000999","Total",436,92,42,50,344,26,36,35,50,18,60,119
"2011","Croydon 009F","E01001002","Total",498,148,57,91,350,40,31,68,63,15,52,81
"2011","Croydon 010A","E01000998","Total",629,214,35,179,415,75,23,64,82,12,48,111
"2011","Croydon 010B","E01001000","Total",454,124,29,95,330,38,33,57,56,14,41,91
"2011","Croydon 010C","E01001003","Total",608,211,48,163,397,80,35,60,74,24,47,77
"2011","Croydon 010D","E01001111","Total",610,160,37,123,450,75,31,75,93,16,58,102
"2011","Croydon 010E","E01001155","Total",761,355,128,227,406,79,49,63,86,11,47,71
"2011","Croydon 011A","E01001174","Total",523,109,49,60,414,35,47,58,52,32,75,115
"2011","Croydon 011B","E01001175","Total",527,140,59,81,387,65,33,56,65,13,58,97
"2011","Croydon 011C","E01001176","Total",628,133,38,95,495,81,36,96,71,29,73,109
"2011","Croydon 011D","E01001182","Total",462,112,33,79,350,38,36,46,41,13,79,97
"2011","Croydon 011E","E01001183","Total",550,128,31,97,422,58,40,54,69,17,61,123
"2011","Croydon 011F","E01001184","Total",456,96,45,51,360,29,55,45,50,13,61,107
"2011","Croydon 013A","E01001001","Total",493,180,35,145,313,53,26,67,54,14,32,67
"2011","Croydon 013B","E01001109","Total",845,329,106,223,516,119,37,117,93,17,53,80
"2011","Croydon 013C","E01001112","Total",763,301,65,236,462,112,41,82,91,21,41,74
"2011","Croydon 013D","E01001113","Total",795,290,37,253,505,118,36,70,128,29,50,74
"2011","Croydon 013E","E01001114","Total",585,163,28,135,422,128,25,76,87,16,25,65
"2011","Croydon 013F","E01001116","Total",528,139,35,104,389,62,33,78,89,14,47,66
"2011","Croydon 014A","E01000992","Total",723,211,52,159,512,75,35,107,80,37,76,102
"2011","Croydon 014B","E01001185","Total",717,257,62,195,460,71,40,96,111,19,35,88
"2011","Croydon 014C","E01001186","Total",841,363,102,261,478,106,42,91,115,12,34,78
"2011","Croydon 014D","E01001188","Total",728,221,46,175,507,101,40,109,92,25,53,87
"2011","Croydon 014E","E01001193","Total",583,98,21,77,485,105,25,70,73,28,84,100
"2011","Croydon 015A","E01001004","Total",787,195,48,147,592,108,23,139,125,30,76,91
"2011","Croydon 015B","E01001115","Total",657,193,75,118,464,85,46,82,80,22,64,85
"2011","Croydon 015C","E01001117","Total",1113,398,43,355,715,142,37,144,159,34,72,127
"2011","Croydon 015D","E01001178","Total",505,157,34,123,348,80,15,70,54,25,32,72
"2011","Croydon 015E","E01001181","Total",759,244,64,180,515,137,23,127,92,10,46,80
"2011","Croydon 016A","E01001006","Total",616,181,20,161,435,113,23,103,79,24,31,62
"2011","Croydon 016B","E01001007","Total",605,111,49,62,494,33,38,92,70,37,91,133
"2011","Croydon 016C","E01001177","Total",551,128,33,95,423,63,37,75,57,23,71,97
"2011","Croydon 016D","E01001179","Total",538,122,41,81,416,36,49,95,58,26,64,88
"2011","Croydon 016E","E01001180","Total",609,125,36,89,484,96,35,95,88,21,67,82
"2011","Croydon 017A","E01000980","Total",566,168,41,127,398,37,37,95,105,17,42,65
"2011","Croydon 017B","E01000981","Total",647,168,49,119,479,47,41,113,130,30,37,81
"2011","Croydon 017C","E01000982","Total",684,205,48,157,479,57,38,106,157,12,37,72
"2011","Croydon 017D","E01000983","Total",665,170,51,119,495,28,53,107,131,16,50,110
"2011","Croydon 017E","E01001187","Total",809,272,47,225,537,79,44,116,127,18,49,104
"2011","Croydon 018A","E01000989","Total",628,132,72,60,496,36,67,115,99,21,48,110
"2011","Croydon 018B","E01000991","Total",662,156,96,60,506,16,140,81,96,12,42,119
"2011","Croydon 018C","E01001131","Total",685,234,127,107,451,48,73,109,91,12,30,88
"2011","Croydon 018D","E01001132","Total",607,162,106,56,445,8,129,47,97,5,47,112
"2011","Croydon 018E","E01001134","Total",697,222,84,138,475,20,81,98,130,14,33,99
"2011","Croydon 019A","E01001005","Total",536,98,28,70,438,47,28,91,72,28,79,93
"2011","Croydon 019B","E01001008","Total",538,107,50,57,431,67,35,66,55,26,77,105
"2011","Croydon 019C","E01001009","Total",609,133,32,101,476,59,41,102,58,30,102,84
"2011","Croydon 019D","E01001010","Total",539,118,46,72,421,84,37,87,64,13,52,84
"2011","Croydon 019E","E01001011","Total",755,251,36,215,504,77,27,107,121,18,73,81
"2011","Croydon 020A","E01001012","Total",746,267,35,232,479,84,33,81,96,19,65,101
"2011","Croydon 020B","E01001013","Total",899,355,98,257,544,128,45,93,108,26,58,86
"2011","Croydon 020C","E01001048","Total",949,370,60,310,579,121,24,127,211,12,31,53
"2011","Croydon 020D","E01001110","Total",771,284,29,255,487,104,16,96,121,20,47,83
"2011","Croydon 020E","E01001118","Total",795,259,78,181,536,115,45,89,122,15,55,95
"2011","Croydon 021A","E01000985","Total",515,92,44,48,423,20,84,58,80,14,55,112
"2011","Croydon 021B","E01000986","Total",677,186,83,103,491,34,73,79,125,18,55,107
"2011","Croydon 021C","E01000987","Total",513,94,57,37,419,16,77,70,72,12,49,123
"2011","Croydon 021D","E01000993","Total",616,145,59,86,471,36,66,106,86,19,43,115
"2011","Croydon 022A","E01000975","Total",710,234,49,185,476,51,35,75,179,16,28,92
"2011","Croydon 022B","E01000976","Total",824,290,78,212,534,66,44,92,174,13,55,90
"2011","Croydon 022C","E01000977","Total",918,475,143,332,443,58,45,106,145,7,20,62
"2011","Croydon 022D","E01000978","Total",927,439,85,354,488,51,31,106,195,5,18,82
"2011","Croydon 022E","E01000979","Total",790,305,59,246,485,32,35,112,178,9,29,90
"2011","Croydon 022F","E01000984","Total",822,348,122,226,474,65,30,100,143,12,46,78
"2011","Croydon 023A","E01001044","Total",871,322,120,202,549,26,92,135,165,13,41,77
"2011","Croydon 023B","E01001046","Total",850,365,112,253,485,16,73,164,147,10,29,46
"2011","Croydon 023C","E01001049","Total",505,100,55,45,405,12,98,56,65,13,43,118
"2011","Croydon 023D","E01001050","Total",802,362,208,154,440,31,62,134,129,8,22,54
"2011","Croydon 024A","E01001014","Total",1186,373,66,307,813,193,45,162,247,23,36,107
"2011","Croydon 024B","E01001042","Total",836,312,48,264,524,91,16,102,175,14,34,92
"2011","Croydon 024C","E01001165","Total",676,208,47,161,468,41,41,104,127,15,45,95
"2011","Croydon 024D","E01001166","Total",835,313,79,234,522,112,42,109,142,12,28,77
"2011","Croydon 024E","E01001168","Total",740,242,70,172,498,42,52,104,153,18,41,88
"2011","Croydon 025A","E01001127","Total",574,100,57,43,474,14,85,66,103,18,50,138
"2011","Croydon 025B","E01001128","Total",566,107,49,58,459,88,38,95,79,29,52,78
"2011","Croydon 025C","E01001130","Total",598,85,34,51,513,181,21,96,65,39,50,61
"2011","Croydon 025D","E01001135","Total",631,151,85,66,480,16,112,82,90,15,47,118
"2011","Croydon 026A","E01001062","Total",571,113,56,57,458,15,121,54,84,12,53,119
"2011","Croydon 026B","E01001063","Total",587,139,68,71,448,22,78,81,71,7,54,135
"2011","Croydon 026C","E01001064","Total",613,133,73,60,480,17,124,71,94,15,41,118
"2011","Croydon 026D","E01001129","Total",502,74,51,23,428,6,81,70,74,18,49,130
"2011","Croydon 026E","E01001133","Total",726,295,215,80,431,12,120,78,85,8,35,93
"2011","Croydon 027A","E01001035","Total",834,369,62,307,465,46,28,84,209,6,24,68
"2011","Croydon 027B","E01001043","Total",1202,423,46,377,779,137,24,150,295,15,36,122
"2011","Croydon 027C","E01001045","Total",953,491,104,387,462,55,39,95,207,4,16,46
"2011","Croydon 027D","E01001047","Total",869,413,96,317,456,47,26,87,187,8,21,80
"2011","Croydon 027E","E01001170","Total",989,437,160,277,552,125,37,85,192,8,37,68
"2011","Croydon 028A","E01001167","Total",829,203,69,134,626,62,63,130,149,29,72,121
"2011","Croydon 028B","E01001169","Total",651,200,82,118,451,83,41,85,77,21,46,98
"2011","Croydon 028C","E01001171","Total",681,238,62,176,443,113,41,71,111,15,27,65
"2011","Croydon 028D","E01001172","Total",616,166,65,101,450,77,27,73,75,39,63,96
"2011","Croydon 028E","E01001173","Total",1089,344,96,248,745,107,75,153,216,26,65,103
"2011","Croydon 029A","E01001036","Total",628,204,71,133,424,11,99,70,110,15,41,78
"2011","Croydon 029B","E01001037","Total",624,184,41,143,440,72,29,100,172,14,15,38
"2011","Croydon 029C","E01001038","Total",941,431,43,388,510,45,35,88,250,8,23,61
"2011","Croydon 029D","E01001039","Total",583,145,60,85,438,12,81,96,111,10,46,82
"2011","Croydon 029E","E01001040","Total",763,240,55,185,523,70,32,123,185,15,29,69
"2011","Croydon 030A","E01001051","Total",581,168,101,67,413,90,58,63,45,33,53,71
"2011","Croydon 030B","E01001052","Total",470,73,39,34,397,84,40,72,50,31,58,62
"2011","Croydon 030C","E01001054","Total",594,114,53,61,480,61,73,72,72,29,68,105
"2011","Croydon 030D","E01001056","Total",593,81,25,56,512,142,39,95,58,47,70,61
"2011","Croydon 030E","E01001057","Total",637,90,21,69,547,208,23,114,55,41,46,60
"2011","Croydon 031A","E01001033","Total",694,228,79,149,466,43,51,102,145,15,38,72
"2011","Croydon 031B","E01001034","Total",660,215,46,169,445,46,38,86,152,14,22,87
"2011","Croydon 031C","E01001041","Total",752,294,62,232,458,80,25,108,153,11,30,51
"2011","Croydon 031D","E01001095","Total",584,154,45,109,430,43,32,103,128,10,37,77
"2011","Croydon 031E","E01001100","Total",619,198,75,123,421,22,57,104,107,19,33,79
"2011","Croydon 032A","E01001053","Total",527,103,49,54,424,48,64,75,78,24,52,83
"2011","Croydon 032B","E01001055","Total",585,160,83,77,425,41,69,45,66,28,67,109
"2011","Croydon 032C","E01001077","Total",523,110,39,71,413,33,70,73,84,16,41,96
"2011","Croydon 032D","E01001078","Total",513,97,45,52,416,74,51,61,83,22,48,77
"2011","Croydon 032E","E01001082","Total",560,95,50,45,465,81,52,79,82,20,61,90
"2011","Croydon 033A","E01001120","Total",480,95,55,40,385,20,74,85,74,8,37,87
"2011","Croydon 033B","E01001122","Total",507,86,42,44,421,13,73,71,94,9,41,120
"2011","Croydon 033C","E01001123","Total",598,134,94,40,464,18,135,88,68,10,40,105
"2011","Croydon 033D","E01001124","Total",609,124,87,37,485,5,137,78,100,11,45,109
"2011","Croydon 033E","E01001125","Total",602,129,64,65,473,23,89,66,90,12,65,128
"2011","Croydon 034A","E01001058","Total",521,117,58,59,404,32,69,92,93,12,37,69
"2011","Croydon 034B","E01001059","Total",692,296,78,218,396,33,52,95,133,9,24,50
"2011","Croydon 034C","E01001060","Total",657,207,87,120,450,40,58,101,113,18,34,86
"2011","Croydon 034D","E01001061","Total",642,237,68,169,405,48,39,77,90,18,48,85
"2011","Croydon 034E","E01001065","Total",672,306,94,212,366,11,86,64,100,9,17,79
"2011","Croydon 034F","E01001066","Total",493,117,57,60,376,86,42,64,43,21,54,66
"2011","Croydon 034G","E01001119","Total",576,132,59,73,444,13,80,89,113,12,37,100
"2011","Croydon 034H","E01001126","Total",598,158,74,84,440,25,97,81,106,9,33,89
"2011","Croydon 035A","E01001032","Total",520,93,51,42,427,5,136,67,87,20,34,78
"2011","Croydon 035B","E01001101","Total",509,87,55,32,422,2,90,92,73,17,53,95
"2011","Croydon 035C","E01001102","Total",605,190,138,52,415,13,113,69,63,12,40,105
"2011","Croydon 035D","E01001107","Total",662,178,65,113,484,14,111,72,127,21,42,97
"2011","Croydon 035E","E01001108","Total",628,100,65,35,528,10,129,114,102,20,47,106
"2011","Croydon 036A","E01001076","Total",581,128,55,73,453,78,62,90,65,24,56,78
"2011","Croydon 036B","E01001079","Total",639,141,80,61,498,93,72,82,95,23,46,87
"2011","Croydon 036C","E01001080","Total",687,256,123,133,431,106,40,65,79,30,47,64
"2011","Croydon 036D","E01001081","Total",506,113,64,49,393,45,55,69,63,27,41,93
"2011","Croydon 037A","E01001073","Total",618,207,66,141,411,18,58,85,124,15,30,81
"2011","Croydon 037B","E01001092","Total",588,150,74,76,438,21,74,84,103,16,56,84
"2011","Croydon 037C","E01001093","Total",694,191,65,126,503,61,72,111,108,17,36,98
"2011","Croydon 037D","E01001096","Total",530,66,38,28,464,17,99,82,86,23,45,112
"2011","Croydon 037E","E01001097","Total",1059,467,175,292,592,74,58,93,251,13,36,67
"2011","Croydon 037F","E01001098","Total",515,66,40,26,449,15,94,97,94,14,36,99
"2011","Croydon 038A","E01001028","Total",528,82,52,30,446,5,93,80,56,19,56,137
"2011","Croydon 038B","E01001029","Total",541,105,37,68,436,18,64,80,102,11,47,114
"2011","Croydon 038C","E01001030","Total",462,61,34,27,401,7,73,94,64,13,48,102
"2011","Croydon 038D","E01001031","Total",491,63,36,27,428,11,73,70,78,18,60,118
"2011","Croydon 038E","E01001094","Total",521,89,47,42,432,8,99,71,69,21,57,107
"2011","Croydon 039A","E01001103","Total",651,162,111,51,489,13,135,101,69,23,53,95
"2011","Croydon 039B","E01001105","Total",632,150,89,61,482,33,76,102,76,28,61,106
"2011","Croydon 039C","E01001106","Total",540,102,53,49,438,27,74,95,86,18,43,95
"2011","Croydon 039D","E01001121","Total",501,82,58,24,419,6,116,52,101,9,30,105
"2011","Croydon 040A","E01001069","Total",500,106,46,60,394,17,67,105,88,17,30,70
"2011","Croydon 040B","E01001070","Total",659,151,68,83,508,40,101,90,112,24,46,95
"2011","Croydon 040C","E01001075","Total",646,210,58,152,436,35,49,131,125,20,18,58
"2011","Croydon 040D","E01001099","Total",586,138,32,106,448,50,52,90,123,23,37,73
"2011","Croydon 041A","E01001015","Total",515,106,46,60,409,43,52,68,81,24,48,93
"2011","Croydon 041B","E01001016","Total",665,161,86,75,504,27,108,99,97,18,51,104
"2011","Croydon 041C","E01001023","Total",575,224,84,140,351,34,49,68,87,14,30,69
"2011","Croydon 041D","E01001067","Total",578,74,42,32,504,9,108,116,107,17,50,97
"2011","Croydon 041E","E01001074","Total",828,280,79,201,548,72,53,122,146,16,43,96
"2011","Croydon 042A","E01001068","Total",784,194,64,130,590,70,88,120,147,20,49,96
"2011","Croydon 042B","E01001071","Total",735,176,65,111,559,37,67,137,147,27,52,92
"2011","Croydon 042C","E01001072","Total",533,87,57,30,446,11,107,80,98,17,37,96
"2011","Croydon 042D","E01001104","Total",642,131,58,73,511,20,87,124,113,15,50,102
"2011","Croydon 043A","E01001017","Total",642,144,82,62,498,20,94,104,129,17,27,107
"2011","Croydon 043B","E01001024","Total",532,113,54,59,419,24,57,92,103,12,47,84
"2011","Croydon 043C","E01001025","Total",489,102,60,42,387,19,82,85,72,17,31,81
"2011","Croydon 043D","E01001026","Total",641,132,69,63,509,32,77,114,100,23,49,114
"2011","Croydon 043E","E01001027","Total",534,89,40,49,445,24,75,94,74,24,51,103
"2011","Croydon 044A","E01001018","Total",639,155,72,83,484,18,115,116,108,11,28,88
"2011","Croydon 044B","E01001019","Total",593,147,105,42,446,3,108,100,84,8,44,99
"2011","Croydon 044C","E01001020","Total",657,164,105,59,493,33,102,92,109,20,35,102
"2011","Croydon 044D","E01001021","Total",590,211,141,70,379,58,78,65,67,18,25,68
"2011","Croydon 044E","E01001022","Total",611,152,99,53,459,11,149,86,99,10,30,74
"2011","Croydon 045A","E01000990","Total",538,165,72,93,373,65,40,51,62,21,47,87
"2011","Croydon 045B","E01001189","Total",465,119,42,77,346,39,31,69,82,12,43,70
"2011","Croydon 045C","E01001190","Total",616,181,56,125,435,74,28,95,88,21,51,78
"2011","Croydon 045D","E01001194","Total",624,157,36,121,467,68,40,99,120,16,41,83
"2011","Croydon 045E","E01032569","Total",660,141,53,88,519,136,30,91,108,16,54,84
"2011","Ealing 001A","E01001269","Total",646,126,48,78,520,25,46,122,70,22,92,143
"2011","Ealing 001B","E01001271","Total",593,122,47,75,471,22,53,90,61,25,70,150
"2011","Ealing 001C","E01001309","Total",614,130,45,85,484,15,57,108,75,27,72,130
"2011","Ealing 001D","E01001310","Total",663,182,55,127,481,51,48,98,88,24,50,122
"2011","Ealing 001E","E01001311","Total",663,168,56,112,495,56,42,84,70,24,89,130
"2011","Ealing 002A","E01001307","Total",633,130,52,78,503,18,60,88,94,20,64,159
"2011","Ealing 002B","E01001308","Total",679,147,65,82,532,11,90,70,78,14,98,171
"2011","Ealing 002C","E01001312","Total",590,111,56,55,479,16,63,79,76,30,74,141
"2011","Ealing 002D","E01001313","Total",516,78,40,38,438,9,58,62,47,25,77,160
"2011","Ealing 002E","E01001314","Total",506,88,40,48,418,27,54,69,50,17,63,138
"2011","Ealing 003A","E01001315","Total",495,92,29,63,403,28,47,91,71,16,55,95
"2011","Ealing 003B","E01001316","Total",620,191,60,131,429,83,42,79,77,27,39,82
"2011","Ealing 003C","E01001317","Total",686,182,64,118,504,61,54,119,90,22,60,98
"2011","Ealing 003D","E01001318","Total",677,196,89,107,481,76,47,103,90,22,52,91
"2011","Ealing 003E","E01001320","Total",534,118,25,93,416,86,32,78,73,26,51,70
"2011","Ealing 003F","E01001321","Total",758,200,95,105,558,59,92,96,99,25,56,131
"2011","Ealing 004A","E01001270","Total",565,101,47,54,464,26,57,92,73,13,76,127
"2011","Ealing 004B","E01001319","Total",490,83,39,44,407,29,59,71,57,15,64,112
"2011","Ealing 004C","E01001322","Total",627,162,43,119,465,38,54,76,96,19,58,124
"2011","Ealing 004D","E01001323","Total",684,204,72,132,480,39,61,95,96,14,49,126
"2011","Ealing 005A","E01001341","Total",529,89,31,58,440,7,45,86,58,23,84,137
"2011","Ealing 005B","E01001342","Total",638,152,35,117,486,25,40,112,93,16,77,123
"2011","Ealing 005C","E01001343","Total",483,86,34,52,397,18,59,50,51,24,56,139
"2011","Ealing 005D","E01001345","Total",501,86,44,42,415,19,46,68,44,20,90,128
"2011","Ealing 006A","E01001265","Total",627,176,37,139,451,38,37,115,88,23,50,100
"2011","Ealing 006B","E01001266","Total",578,88,40,48,490,15,74,73,72,15,88,153
"2011","Ealing 006C","E01001267","Total",814,309,140,169,505,51,70,94,111,32,55,92
"2011","Ealing 006D","E01001272","Total",542,115,43,72,427,22,46,89,70,15,65,120
"2011","Ealing 006E","E01001349","Total",507,142,51,91,365,25,46,59,54,13,58,110
"2011","Ealing 007A","E01001344","Total",880,270,74,196,610,57,59,143,152,15,54,130
"2011","Ealing 007B","E01001346","Total",634,128,49,79,506,14,75,91,90,34,78,124
"2011","Ealing 007C","E01001347","Total",518,110,48,62,408,15,52,59,74,21,63,124
"2011","Ealing 007D","E01001348","Total",626,185,59,126,441,32,46,113,91,10,41,108
"2011","Ealing 008A","E01001257","Total",659,203,72,131,456,94,25,87,82,30,61,77
"2011","Ealing 008B","E01001324","Total",662,238,38,200,424,72,26,99,107,13,45,62
"2011","Ealing 008C","E01001326","Total",674,224,110,114,450,78,36,95,81,24,56,80
"2011","Ealing 008D","E01001330","Total",636,231,84,147,405,60,36,81,63,26,53,86
"2011","Ealing 008E","E01001332","Total",579,174,43,131,405,69,34,80,73,18,45,86
"2011","Ealing 009A","E01001325","Total",602,147,72,75,455,44,47,68,69,33,82,112
"2011","Ealing 009B","E01001327","Total",600,173,81,92,427,22,43,70,52,27,95,118
"2011","Ealing 009C","E01001328","Total",620,164,66,98,456,73,49,90,53,30,62,99
"2011","Ealing 009D","E01001329","Total",631,156,77,79,475,64,51,86,84,25,64,101
"2011","Ealing 009E","E01001331","Total",618,176,32,144,442,98,35,93,64,32,53,67
"2011","Ealing 010B","E01001258","Total",634,182,86,96,452,31,55,90,83,18,66,109
"2011","Ealing 010C","E01001262","Total",558,165,70,95,393,26,36,80,72,27,58,94
"2011","Ealing 010D","E01001263","Total",647,211,72,139,436,54,40,78,93,19,63,89
"2011","Ealing 010E","E01001264","Total",612,160,75,85,452,45,64,90,77,21,56,99
"2011","Ealing 010F","E01032743","Total",818,218,13,205,600,128,13,177,124,35,63,60
"2011","Ealing 010G","E01032744","Total",486,140,40,100,346,47,29,72,38,22,55,83
"2011","Ealing 011A","E01001276","Total",651,193,47,146,458,30,44,67,101,23,71,122
"2011","Ealing 011B","E01001277","Total",668,172,48,124,496,30,61,84,99,17,45,160
"2011","Ealing 011C","E01001278","Total",801,257,74,183,544,39,76,112,130,22,52,113
"2011","Ealing 011D","E01001280","Total",782,266,91,175,516,37,66,118,167,14,28,86
"2011","Ealing 012A","E01001218","Total",692,201,85,116,491,55,53,76,83,29,75,120
"2011","Ealing 012B","E01001260","Total",660,177,87,90,483,21,68,85,64,24,78,143
"2011","Ealing 012C","E01001261","Total",758,203,57,146,555,42,59,92,90,18,78,176
"2011","Ealing 012D","E01001268","Total",629,162,76,86,467,22,82,99,78,26,63,97
"2011","Ealing 013A","E01001209","Total",647,158,64,94,489,25,57,142,98,29,21,117
"2011","Ealing 013B","E01001211","Total",705,242,94,148,463,22,54,112,139,17,36,83
"2011","Ealing 013C","E01001279","Total",564,133,62,71,431,8,89,101,80,14,40,99
"2011","Ealing 013D","E01001281","Total",625,181,75,106,444,16,70,131,102,22,28,75
"2011","Ealing 014A","E01001217","Total",455,66,34,32,389,17,44,63,49,17,73,126
"2011","Ealing 014B","E01001259","Total",510,134,51,83,376,36,47,63,54,12,53,111
"2011","Ealing 014C","E01001291","Total",495,71,20,51,424,22,49,52,58,29,70,144
"2011","Ealing 014D","E01001292","Total",504,82,38,44,422,11,49,53,50,19,88,152
"2011","Ealing 014E","E01001293","Total",478,88,31,57,390,19,37,56,36,23,80,139
"2011","Ealing 015A","E01001196","Total",762,315,101,214,447,88,47,72,93,17,44,86
"2011","Ealing 015B","E01001238","Total",1236,453,48,405,783,96,25,122,285,19,44,192
"2011","Ealing 015C","E01001239","Total",553,152,25,127,401,48,29,53,94,19,46,112
"2011","Ealing 015D","E01001246","Total",492,133,33,100,359,37,31,67,62,20,48,94
"2011","Ealing 015E","E01001247","Total",674,134,59,75,540,58,55,74,72,20,47,214
"2011","Ealing 016A","E01001210","Total",740,323,149,174,417,65,42,68,87,23,51,81
"2011","Ealing 016B","E01001282","Total",627,215,117,98,412,48,58,85,73,17,50,81
"2011","Ealing 016C","E01001283","Total",712,294,151,143,418,56,67,83,72,20,32,88
"2011","Ealing 016D","E01001285","Total",562,130,45,85,432,30,47,113,64,17,66,95
"2011","Ealing 016E","E01001286","Total",620,151,61,90,469,52,54,114,85,24,46,94
"2011","Ealing 016F","E01001287","Total",483,100,34,66,383,44,32,65,61,31,60,90
"2011","Ealing 017A","E01001294","Total",538,85,37,48,453,22,34,60,42,15,101,179
"2011","Ealing 017B","E01001295","Total",521,74,33,41,447,10,42,70,35,28,93,169
"2011","Ealing 017C","E01001296","Total",404,55,27,28,349,11,30,47,29,16,85,131
"2011","Ealing 017D","E01001297","Total",495,80,48,32,415,13,35,67,30,22,92,156
"2011","Ealing 017E","E01001298","Total",529,98,49,49,431,21,50,50,39,16,90,165
"2011","Ealing 018A","E01001204","Total",585,130,47,83,455,20,58,95,105,16,42,119
"2011","Ealing 018B","E01001205","Total",598,175,34,141,423,43,29,82,128,18,51,72
"2011","Ealing 018C","E01001206","Total",582,142,42,100,440,84,16,92,66,31,67,84
"2011","Ealing 018D","E01001207","Total",668,210,44,166,458,29,38,92,155,12,27,105
"2011","Ealing 018E","E01001208","Total",498,112,58,54,386,14,69,98,66,25,39,75
"2011","Ealing 018F","E01001212","Total",691,258,98,160,433,11,85,89,126,13,38,71
"2011","Ealing 019A","E01001222","Total",1150,457,40,417,693,72,35,113,300,21,29,123
"2011","Ealing 019B","E01001224","Total",570,114,34,80,456,8,60,98,96,29,46,119
"2011","Ealing 019C","E01001226","Total",668,236,83,153,432,24,62,76,151,13,18,88
"2011","Ealing 019D","E01001227","Total",602,172,48,124,430,9,58,109,110,22,25,97
"2011","Ealing 019E","E01001228","Total",792,309,90,219,483,17,49,74,189,12,19,123
"2011","Ealing 020A","E01001221","Total",952,416,88,328,536,21,34,59,284,5,10,123
"2011","Ealing 020B","E01001223","Total",643,233,60,173,410,12,57,73,151,10,32,75
"2011","Ealing 020C","E01001225","Total",807,317,118,199,490,17,57,103,158,14,31,110
"2011","Ealing 020D","E01001235","Total",691,230,56,174,461,21,23,91,210,8,9,99
"2011","Ealing 020E","E01001236","Total",741,295,103,192,446,20,39,92,176,10,20,89
"2011","Ealing 020F","E01001273","Total",597,148,60,88,449,9,62,88,100,22,43,125
"2011","Ealing 020G","E01001274","Total",585,141,56,85,444,16,45,135,95,35,42,76
"2011","Ealing 020H","E01001275","Total",857,364,95,269,493,24,57,56,220,10,29,97
"2011","Ealing 021A","E01001195","Total",598,127,60,67,471,13,48,98,68,30,50,164
"2011","Ealing 021B","E01001197","Total",668,227,66,161,441,32,41,109,95,24,50,90
"2011","Ealing 021C","E01001198","Total",584,193,47,146,391,29,40,74,105,13,33,97
"2011","Ealing 021D","E01001199","Total",694,233,34,199,461,67,26,75,128,24,38,103
"2011","Ealing 022A","E01001284","Total",538,99,51,48,439,19,67,80,76,15,51,131
"2011","Ealing 022B","E01001288","Total",531,112,24,88,419,34,47,113,64,22,46,93
"2011","Ealing 022C","E01001289","Total",476,99,23,76,377,24,26,100,71,21,47,88
"2011","Ealing 022D","E01001290","Total",738,215,63,152,523,29,49,106,138,25,48,128
"2011","Ealing 023A","E01001213","Total",503,86,47,39,417,18,30,42,44,22,95,166
"2011","Ealing 023B","E01001214","Total",477,73,40,33,404,11,44,50,31,15,82,171
"2011","Ealing 023C","E01001215","Total",552,148,85,63,404,23,43,51,41,23,94,129
"2011","Ealing 023D","E01001216","Total",476,98,36,62,378,17,52,67,29,15,68,130
"2011","Ealing 023E","E01001361","Total",460,73,24,49,387,26,28,53,48,22,87,123
"2011","Ealing 024A","E01001240","Total",512,125,58,67,387,19,45,29,44,23,63,164
"2011","Ealing 024B","E01001241","Total",503,129,49,80,374,23,47,43,53,15,53,140
"2011","Ealing 024C","E01001242","Total",524,169,47,122,355,31,41,44,82,24,51,82
"2011","Ealing 024D","E01001243","Total",649,231,63,168,418,59,29,70,74,30,51,105
"2011","Ealing 024E","E01001244","Total",1099,411,89,322,688,76,55,95,224,35,58,145
"2011","Ealing 024F","E01001245","Total",823,246,49,197,577,52,37,119,201,12,31,125
"2011","Ealing 025A","E01001200","Total",586,182,36,146,404,26,32,73,115,17,34,107
"2011","Ealing 025B","E01001201","Total",642,208,49,159,434,35,44,83,128,16,36,92
"2011","Ealing 025C","E01001202","Total",871,315,80,235,556,73,39,99,152,33,50,110
"2011","Ealing 025D","E01001203","Total",861,417,85,332,444,60,15,79,144,8,29,109
"2011","Ealing 025E","E01001351","Total",811,319,97,222,492,44,35,85,159,21,36,112
"2011","Ealing 026A","E01001359","Total",562,84,40,44,478,19,39,56,38,27,133,166
"2011","Ealing 026B","E01001360","Total",505,66,33,33,439,8,51,54,29,15,112,170
"2011","Ealing 026C","E01001362","Total",511,110,32,78,401,11,25,37,32,22,118,156
"2011","Ealing 026D","E01001363","Total",471,69,36,33,402,24,34,70,29,26,97,122
"2011","Ealing 026E","E01001364","Total",516,136,66,70,380,27,41,38,37,18,89,130
"2011","Ealing 026F","E01001365","Total",590,94,50,44,496,25,42,57,45,27,133,167
"2011","Ealing 027A","E01001231","Total",696,177,48,129,519,18,92,67,110,22,51,159
"2011","Ealing 027B","E01001234","Total",640,248,37,211,392,25,42,53,149,12,19,92
"2011","Ealing 027C","E01001350","Total",621,222,67,155,399,18,43,74,114,14,43,93
"2011","Ealing 027D","E01001352","Total",571,166,50,116,405,16,35,70,111,18,41,114
"2011","Ealing 027E","E01001354","Total",677,188,66,122,489,13,45,92,150,18,34,137
"2011","Ealing 028A","E01001249","Total",1025,385,63,322,640,105,29,105,205,32,50,114
"2011","Ealing 028B","E01001250","Total",983,453,82,371,530,76,45,81,172,19,31,106
"2011","Ealing 028C","E01001255","Total",608,168,44,124,440,16,46,110,111,20,50,87
"2011","Ealing 028D","E01001383","Total",662,162,54,108,500,19,39,100,144,13,39,146
"2011","Ealing 028E","E01001388","Total",743,310,109,201,433,52,29,88,129,15,36,84
"2011","Ealing 028F","E01001389","Total",726,266,88,178,460,21,35,103,152,12,16,121
"2011","Ealing 029A","E01001219","Total",674,183,56,127,491,64,37,89,63,40,89,109
"2011","Ealing 029B","E01001220","Total",471,93,37,56,378,45,27,66,47,35,61,97
"2011","Ealing 029C","E01001334","Total",522,150,51,99,372,36,31,55,35,26,86,103
"2011","Ealing 029D","E01001337","Total",452,126,31,95,326,24,27,40,50,21,65,99
"2011","Ealing 029E","E01001338","Total",518,94,37,57,424,24,45,40,38,23,99,155
"2011","Ealing 029F","E01001339","Total",568,111,17,94,457,60,28,72,59,31,89,118
"2011","Ealing 029G","E01001340","Total",506,137,12,125,369,42,15,81,85,22,44,80
"2011","Ealing 030A","E01001251","Total",659,189,43,146,470,30,45,122,129,13,25,106
"2011","Ealing 030B","E01001252","Total",768,246,47,199,522,47,40,131,131,18,44,111
"2011","Ealing 030C","E01001253","Total",670,204,50,154,466,36,48,110,130,17,37,88
"2011","Ealing 030D","E01001254","Total",750,293,103,190,457,27,36,142,132,12,34,74
"2011","Ealing 031A","E01001229","Total",597,159,60,99,438,55,48,76,106,12,40,101
"2011","Ealing 031B","E01001230","Total",629,221,49,172,408,20,31,77,170,7,26,77
"2011","Ealing 031C","E01001232","Total",612,176,71,105,436,35,51,82,112,9,43,104
"2011","Ealing 031D","E01001233","Total",599,206,74,132,393,19,44,69,113,8,26,114
"2011","Ealing 031E","E01001237","Total",652,216,58,158,436,17,32,75,181,13,19,99
"2011","Ealing 031F","E01001386","Total",735,221,73,148,514,16,50,128,166,22,29,103
"2011","Ealing 032A","E01001303","Total",624,141,49,92,483,21,44,108,141,25,34,110
"2011","Ealing 032B","E01001382","Total",564,117,47,70,447,10,68,117,78,32,39,103
"2011","Ealing 032C","E01001384","Total",677,213,56,157,464,17,32,114,149,11,21,120
"2011","Ealing 032D","E01001385","Total",667,191,72,119,476,12,37,136,131,16,25,119
"2011","Ealing 032E","E01001387","Total",713,294,56,238,419,27,26,76,183,15,19,73
"2011","Ealing 033A","E01001353","Total",718,275,87,188,443,42,31,86,127,23,24,110
"2011","Ealing 033B","E01001355","Total",760,297,86,211,463,36,44,83,150,8,33,109
"2011","Ealing 033C","E01001356","Total",841,362,128,234,479,86,40,101,91,39,39,83
"2011","Ealing 033D","E01001357","Total",426,127,21,106,299,50,25,41,71,26,39,47
"2011","Ealing 033E","E01001358","Total",586,170,37,133,416,75,37,73,73,33,48,77
"2011","Ealing 034A","E01001375","Total",706,198,43,155,508,17,45,151,168,18,15,94
"2011","Ealing 034B","E01001377","Total",718,225,92,133,493,17,74,109,122,26,47,98
"2011","Ealing 034C","E01001379","Total",709,206,66,140,503,19,51,152,164,11,22,84
"2011","Ealing 034D","E01001381","Total",738,271,66,205,467,21,39,96,162,9,21,119
"2011","Ealing 035A","E01001248","Total",581,149,58,91,432,21,58,81,94,16,50,112
"2011","Ealing 035B","E01001299","Total",651,129,65,64,522,14,85,111,92,31,41,148
"2011","Ealing 035C","E01001305","Total",634,139,62,77,495,14,59,132,110,21,41,118
"2011","Ealing 035D","E01001306","Total",713,242,82,160,471,13,54,136,154,11,24,79
"2011","Ealing 037A","E01001366","Total",543,83,24,59,460,37,29,74,51,19,99,151
"2011","Ealing 037B","E01001367","Total",527,118,28,90,409,19,29,62,46,26,84,143
"2011","Ealing 037C","E01001368","Total",456,50,23,27,406,23,36,50,22,29,102,144
"2011","Ealing 037D","E01001370","Total",532,71,28,43,461,18,44,42,50,22,122,163
"2011","Ealing 037E","E01001371","Total",594,90,38,52,504,62,39,67,49,26,113,148
"2011","Ealing 037F","E01001372","Total",493,83,31,52,410,25,21,63,38,27,88,148
"2011","Ealing 037G","E01001373","Total",412,70,23,47,342,14,29,49,33,23,80,114
"2011","Ealing 038A","E01001333","Total",563,151,58,93,412,37,29,62,56,22,78,128
"2011","Ealing 038B","E01001335","Total",524,125,57,68,399,11,45,53,42,14,85,149
"2011","Ealing 038C","E01001336","Total",519,130,52,78,389,17,52,58,58,13,79,112
"2011","Ealing 038D","E01001369","Total",525,90,29,61,435,27,27,60,57,20,92,152
"2011","Ealing 039A","E01001300","Total",608,121,38,83,487,15,55,156,110,24,25,102
"2011","Ealing 039B","E01001301","Total",707,243,100,143,464,24,44,101,185,4,18,88
"2011","Ealing 039C","E01001302","Total",614,155,56,99,459,22,41,135,109,17,27,108
"2011","Ealing 039D","E01001304","Total",705,245,71,174,460,22,32,107,167,16,24,92
"2011","Ealing 040A","E01001374","Total",805,277,65,212,528,33,41,113,211,15,27,88
"2011","Ealing 040B","E01001376","Total",743,303,60,243,440,43,41,76,154,12,25,89
"2011","Ealing 040C","E01001380","Total",762,258,95,163,504,19,33,117,180,9,32,114
"2011","Ealing 040D","E01032572","Total",758,310,55,255,448,23,28,104,182,8,16,87
"2011","Enfield 001A","E01001444","Total",638,145,67,78,493,50,80,97,90,14,46,116
"2011","Enfield 001B","E01001446","Total",714,215,70,145,499,76,53,96,96,26,52,100
"2011","Enfield 001C","E01001546","Total",640,133,45,88,507,66,57,105,88,19,62,110
"2011","Enfield 001D","E01001552","Total",659,161,64,97,498,41,87,78,91,20,63,118
"2011","Enfield 002A","E01001442","Total",617,161,74,87,456,137,27,84,57,27,49,75
"2011","Enfield 002B","E01001545","Total",665,174,70,104,491,90,38,93,84,33,68,85
"2011","Enfield 002C","E01001547","Total",659,175,79,96,484,56,77,82,78,22,61,108
"2011","Enfield 002D","E01001548","Total",676,169,75,94,507,77,56,105,88,25,51,105
"2011","Enfield 002E","E01001551","Total",661,201,73,128,460,60,78,73,60,27,54,108
"2011","Enfield 003B","E01001445","Total",980,323,53,270,657,139,37,150,172,28,53,78
"2011","Enfield 003C","E01001447","Total",783,234,85,149,549,81,73,92,122,23,66,92
"2011","Enfield 003D","E01001448","Total",655,162,44,118,493,59,53,86,96,31,68,100
"2011","Enfield 003E","E01001449","Total",575,117,31,86,458,66,47,79,97,36,47,86
"2011","Enfield 003F","E01033148","Total",661,136,25,111,525,115,16,110,94,33,76,81
"2011","Enfield 003G","E01033150","Total",702,210,6,204,492,141,7,122,131,22,34,35
"2011","Enfield 004A","E01001408","Total",731,229,82,147,502,48,58,114,174,14,28,66
"2011","Enfield 004B","E01001411","Total",759,210,76,134,549,51,57,155,147,25,30,84
"2011","Enfield 004C","E01001412","Total",677,146,66,80,531,42,105,66,89,31,69,129
"2011","Enfield 004D","E01001413","Total",612,149,91,58,463,12,81,108,98,15,47,102
"2011","Enfield 004E","E01001414","Total",687,259,118,141,428,66,72,92,79,16,35,68
"2011","Enfield 005A","E01001407","Total",613,125,59,66,488,42,74,118,98,16,44,96
"2011","Enfield 005B","E01001409","Total",806,301,71,230,505,91,36,96,126,19,50,87
"2011","Enfield 005C","E01001410","Total",755,284,47,237,471,113,35,94,111,19,49,50
"2011","Enfield 005D","E01001516","Total",648,145,65,80,503,57,65,88,90,31,65,107
"2011","Enfield 005E","E01001537","Total",709,198,78,120,511,62,60,160,115,10,25,79
"2011","Enfield 006A","E01001439","Total",790,224,65,159,566,153,48,117,84,28,60,76
"2011","Enfield 006B","E01001441","Total",637,225,47,178,412,82,34,79,89,20,39,69
"2011","Enfield 006C","E01001517","Total",696,201,64,137,495,99,34,77,88,39,70,88
"2011","Enfield 006D","E01001549","Total",798,251,46,205,547,170,43,108,75,22,59,70
"2011","Enfield 006E","E01001550","Total",570,104,36,68,466,64,54,105,62,29,62,90
"2011","Enfield 007A","E01001433","Total",584,97,35,62,487,84,40,73,67,31,79,113
"2011","Enfield 007B","E01001434","Total",551,129,51,78,422,43,48,84,66,25,63,93
"2011","Enfield 007C","E01001435","Total",489,80,36,44,409,36,64,67,55,29,51,107
"2011","Enfield 007D","E01001436","Total",653,124,51,73,529,62,82,91,73,37,60,124
"2011","Enfield 007E","E01001438","Total",566,97,29,68,469,58,51,88,74,23,65,110
"2011","Enfield 008A","E01001469","Total",633,160,70,90,473,34,69,93,112,20,47,98
"2011","Enfield 008B","E01001536","Total",742,227,97,130,515,37,93,107,142,15,20,101
"2011","Enfield 008C","E01001540","Total",794,272,92,180,522,49,54,106,175,13,28,97
"2011","Enfield 008D","E01001541","Total",650,224,68,156,426,29,45,135,116,14,23,64
"2011","Enfield 008E","E01001542","Total",678,237,121,116,441,59,57,101,92,12,41,79
"2011","Enfield 009A","E01001538","Total",603,114,61,53,489,23,76,106,93,25,49,117
"2011","Enfield 009B","E01001539","Total",657,175,83,92,482,34,77,111,97,14,45,104
"2011","Enfield 009C","E01001543","Total",596,108,64,44,488,17,96,106,79,25,49,116
"2011","Enfield 009D","E01001544","Total",610,148,83,65,462,14,104,91,80,15,41,117
"2011","Enfield 010A","E01001457","Total",798,331,104,227,467,29,100,87,154,6,23,68
"2011","Enfield 010B","E01001468","Total",524,181,93,88,343,17,71,67,71,19,23,75
"2011","Enfield 010C","E01001471","Total",930,452,157,295,478,35,102,81,166,7,21,66
"2011","Enfield 010D","E01001472","Total",771,278,107,171,493,30,84,100,144,12,28,95
"2011","Enfield 010E","E01001474","Total",840,298,112,186,542,18,115,90,185,13,27,94
"2011","Enfield 011A","E01001415","Total",677,238,172,66,439,26,108,56,95,9,38,107
"2011","Enfield 011B","E01001417","Total",601,126,83,43,475,8,112,79,77,32,53,114
"2011","Enfield 011C","E01001418","Total",703,231,127,104,472,36,94,83,100,10,38,111
"2011","Enfield 011D","E01001422","Total",559,74,36,38,485,10,110,100,69,23,61,112
"2011","Enfield 012A","E01001440","Total",597,162,88,74,435,48,65,76,57,23,59,107
"2011","Enfield 012B","E01001504","Total",513,102,48,54,411,44,49,50,70,29,66,103
"2011","Enfield 012C","E01001505","Total",567,126,47,79,441,49,36,76,70,25,72,113
"2011","Enfield 012D","E01001507","Total",766,268,71,197,498,86,54,90,103,25,53,87
"2011","Enfield 012E","E01001508","Total",718,204,47,157,514,92,29,91,101,22,76,103
"2011","Enfield 012F","E01001513","Total",623,158,79,79,465,57,33,108,67,22,78,100
"2011","Enfield 013A","E01001416","Total",598,100,64,36,498,8,112,97,63,21,54,143
"2011","Enfield 013B","E01001470","Total",641,179,104,75,462,25,114,92,70,12,41,108
"2011","Enfield 013C","E01001473","Total",547,96,62,34,451,27,100,81,72,21,48,102
"2011","Enfield 013D","E01001475","Total",635,140,87,53,495,13,117,102,76,15,49,123
"2011","Enfield 014A","E01001437","Total",990,334,108,226,656,160,67,125,98,34,68,104
"2011","Enfield 014B","E01001506","Total",565,133,30,103,432,78,32,93,59,28,57,85
"2011","Enfield 014C","E01001509","Total",688,220,43,177,468,92,34,91,95,16,58,82
"2011","Enfield 014D","E01001510","Total",610,205,34,171,405,142,10,92,62,28,34,37
"2011","Enfield 015A","E01001405","Total",862,383,176,207,479,27,124,78,154,11,16,69
"2011","Enfield 015B","E01001406","Total",675,209,56,153,466,55,51,94,130,16,36,84
"2011","Enfield 015C","E01001450","Total",924,382,161,221,542,71,74,92,175,13,34,83
"2011","Enfield 015D","E01001512","Total",782,287,88,199,495,64,51,131,126,16,30,77
"2011","Enfield 015E","E01001515","Total",755,231,52,179,524,116,33,100,102,29,69,75
"2011","Enfield 016A","E01001401","Total",501,130,72,58,371,17,63,88,67,15,39,82
"2011","Enfield 016B","E01001478","Total",544,114,54,60,430,47,63,70,62,23,53,112
"2011","Enfield 016C","E01001484","Total",516,141,69,72,375,44,71,71,49,15,47,78
"2011","Enfield 016D","E01001511","Total",648,145,68,77,503,56,52,137,89,21,50,98
"2011","Enfield 016E","E01001514","Total",685,180,54,126,505,59,42,107,125,18,47,107
"2011","Enfield 016F","E01001518","Total",684,177,49,128,507,48,55,105,109,17,49,124
"2011","Enfield 017A","E01001451","Total",661,192,78,114,469,25,113,87,96,18,35,95
"2011","Enfield 017B","E01001452","Total",488,85,44,41,403,15,83,83,69,18,35,100
"2011","Enfield 017C","E01001453","Total",661,164,83,81,497,17,119,92,92,20,40,117
"2011","Enfield 017D","E01001454","Total",660,189,130,59,471,23,106,98,89,24,35,96
"2011","Enfield 018A","E01001476","Total",593,138,63,75,455,48,57,83,71,17,62,117
"2011","Enfield 018B","E01001477","Total",607,128,46,82,479,52,57,72,66,44,75,113
"2011","Enfield 018C","E01001481","Total",556,131,53,78,425,26,54,63,60,32,62,128
"2011","Enfield 018D","E01001502","Total",599,154,57,97,445,55,49,70,44,32,71,124
"2011","Enfield 018E","E01001503","Total",654,143,80,63,511,68,75,85,74,27,76,106
"2011","Enfield 019A","E01001520","Total",673,189,62,127,484,48,67,84,100,19,40,126
"2011","Enfield 019B","E01001522","Total",751,228,32,196,523,89,36,140,157,16,27,58
"2011","Enfield 019C","E01001523","Total",738,240,144,96,498,32,88,106,115,15,34,108
"2011","Enfield 019D","E01001524","Total",546,121,59,62,425,28,54,92,89,12,52,98
"2011","Enfield 019E","E01001526","Total",639,176,98,78,463,20,96,86,80,19,46,116
"2011","Enfield 020A","E01001419","Total",794,215,116,99,579,31,111,81,153,14,45,144
"2011","Enfield 020B","E01001420","Total",569,140,63,77,429,33,55,68,85,22,42,124
"2011","Enfield 020C","E01001421","Total",714,240,124,116,474,59,74,84,111,21,36,89
"2011","Enfield 020D","E01001519","Total",1141,411,109,302,730,75,60,125,264,21,43,142
"2011","Enfield 020E","E01001525","Total",723,215,72,143,508,39,74,105,127,18,29,116
"2011","Enfield 021A","E01001398","Total",491,88,43,45,403,23,53,87,80,10,29,121
"2011","Enfield 021B","E01001399","Total",499,84,48,36,415,13,71,73,67,18,50,123
"2011","Enfield 021C","E01001400","Total",587,147,113,34,440,26,97,57,65,11,52,132
"2011","Enfield 021D","E01001402","Total",691,173,71,102,518,18,93,96,106,16,51,138
"2011","Enfield 021E","E01001403","Total",633,197,100,97,436,30,96,75,62,12,53,108
"2011","Enfield 021F","E01001455","Total",581,151,60,91,430,19,87,72,80,8,44,120
"2011","Enfield 022A","E01001456","Total",481,83,47,36,398,12,68,95,60,27,39,97
"2011","Enfield 022B","E01001564","Total",646,182,54,128,464,26,50,115,109,24,36,104
"2011","Enfield 022C","E01001567","Total",632,162,85,77,470,12,103,98,106,27,29,95
"2011","Enfield 022D","E01001568","Total",538,80,42,38,458,10,114,69,55,24,46,140
"2011","Enfield 022E","E01001569","Total",778,248,92,156,530,31,72,96,201,15,30,85
"2011","Enfield 023A","E01001479","Total",639,203,61,142,436,58,55,63,68,32,61,99
"2011","Enfield 023B","E01001482","Total",690,207,62,145,483,59,43,104,75,33,64,105
"2011","Enfield 023C","E01001487","Total",723,228,103,125,495,77,46,98,72,44,62,96
"2011","Enfield 023D","E01001489","Total",664,171,49,122,493,78,65,94,80,31,44,101
"2011","Enfield 023E","E01001491","Total",722,195,61,134,527,96,42,104,83,21,63,118
"2011","Enfield 024A","E01001459","Total",556,102,43,59,454,36,54,77,64,23,66,134
"2011","Enfield 024B","E01001460","Total",660,215,40,175,445,100,33,71,81,38,58,64
"2011","Enfield 024C","E01001462","Total",531,176,33,143,355,71,33,57,56,14,53,71
"2011","Enfield 024D","E01001480","Total",588,183,51,132,405,30,47,85,81,21,43,98
"2011","Enfield 024E","E01001488","Total",663,163,55,108,500,89,39,95,74,32,51,120
"2011","Enfield 025A","E01001483","Total",609,318,37,281,291,74,24,51,71,12,26,33
"2011","Enfield 025B","E01001485","Total",682,197,89,108,485,73,52,88,83,30,68,91
"2011","Enfield 025C","E01001486","Total",818,241,86,155,577,118,37,131,99,31,58,103
"2011","Enfield 025E","E01001492","Total",680,156,67,89,524,82,58,71,79,33,61,140
"2011","Enfield 025F","E01033146","Total",593,163,23,140,430,87,20,100,86,25,59,53
"2011","Enfield 025G","E01033151","Total",541,136,44,92,405,100,32,66,59,22,50,76
"2011","Enfield 026A","E01001404","Total",525,109,55,54,416,31,70,69,70,17,61,98
"2011","Enfield 026B","E01001493","Total",735,259,95,164,476,49,71,85,103,17,47,104
"2011","Enfield 026C","E01001494","Total",510,87,51,36,423,17,81,71,54,16,69,115
"2011","Enfield 026D","E01001496","Total",602,125,75,50,477,20,75,78,85,20,70,129
"2011","Enfield 026E","E01001570","Total",751,251,97,154,500,60,47,109,116,18,39,111
"2011","Enfield 027A","E01001423","Total",643,174,80,94,469,58,54,83,76,30,78,90
"2011","Enfield 027B","E01001425","Total",737,242,39,203,495,131,27,97,73,35,49,83
"2011","Enfield 027C","E01001428","Total",611,183,84,99,428,68,34,65,62,27,71,101
"2011","Enfield 027D","E01001461","Total",707,270,54,216,437,92,39,86,74,17,49,80
"2011","Enfield 027E","E01001464","Total",422,81,39,42,341,27,46,46,43,15,75,89
"2011","Enfield 028A","E01001521","Total",698,187,91,96,511,23,68,127,120,12,42,119
"2011","Enfield 028B","E01001531","Total",544,121,50,71,423,13,66,94,88,16,44,102
"2011","Enfield 028C","E01001532","Total",687,183,63,120,504,24,72,97,121,19,50,121
"2011","Enfield 028D","E01001533","Total",530,87,65,22,443,8,104,73,55,25,41,137
"2011","Enfield 028E","E01001535","Total",505,92,55,37,413,18,74,68,58,12,50,133
"2011","Enfield 029A","E01001495","Total",731,216,53,163,515,31,46,105,174,16,28,115
"2011","Enfield 029B","E01001498","Total",746,179,57,122,567,41,55,121,156,12,47,135
"2011","Enfield 029C","E01001563","Total",669,217,63,154,452,24,42,101,146,19,30,90
"2011","Enfield 029D","E01001565","Total",709,253,120,133,456,33,61,85,120,15,36,106
"2011","Enfield 029E","E01001566","Total",626,172,47,125,454,18,39,96,128,18,40,115
"2011","Enfield 030A","E01001424","Total",496,164,35,129,332,71,15,84,69,16,30,47
"2011","Enfield 030B","E01001426","Total",628,146,45,101,482,79,40,78,69,24,70,122
"2011","Enfield 030C","E01001427","Total",683,203,65,138,480,96,27,88,83,40,62,84
"2011","Enfield 030D","E01001429","Total",1134,513,170,343,621,136,55,127,141,39,48,75
"2011","Enfield 030E","E01001430","Total",653,149,51,98,504,118,33,93,77,41,62,80
"2011","Enfield 031A","E01001463","Total",513,86,50,36,427,31,58,66,59,27,60,126
"2011","Enfield 031B","E01001465","Total",506,84,42,42,422,42,58,72,60,11,64,115
"2011","Enfield 031C","E01001466","Total",620,139,34,105,481,81,31,99,86,30,68,86
"2011","Enfield 031D","E01001467","Total",634,119,31,88,515,78,40,91,86,34,67,119
"2011","Enfield 031E","E01001497","Total",531,121,71,50,410,41,60,77,51,16,51,114
"2011","Enfield 031F","E01001499","Total",564,118,54,64,446,15,86,57,57,20,67,144
"2011","Enfield 032A","E01001392","Total",665,158,68,90,507,19,61,84,122,18,54,149
"2011","Enfield 032B","E01001528","Total",553,150,28,122,403,65,31,61,79,16,40,111
"2011","Enfield 032C","E01001529","Total",635,216,39,177,419,66,39,66,115,11,34,88
"2011","Enfield 032D","E01001530","Total",467,98,42,56,369,21,54,65,76,9,41,103
"2011","Enfield 032E","E01001534","Total",588,126,46,80,462,18,85,82,87,17,44,129
"2011","Enfield 033A","E01001431","Total",614,196,25,171,418,78,24,80,88,35,39,74
"2011","Enfield 033B","E01001432","Total",700,187,64,123,513,82,41,95,89,36,62,108
"2011","Enfield 033C","E01001555","Total",624,150,48,102,474,55,62,80,68,27,72,110
"2011","Enfield 033D","E01001557","Total",546,113,38,75,433,63,47,77,63,32,61,90
"2011","Enfield 033E","E01001558","Total",558,128,43,85,430,95,31,79,57,39,54,75
"2011","Enfield 033F","E01001559","Total",743,193,38,155,550,111,29,98,112,21,57,122
"2011","Enfield 035A","E01001394","Total",640,188,73,115,452,40,52,64,106,16,46,128
"2011","Enfield 035B","E01001395","Total",620,161,47,114,459,89,32,88,91,15,43,101
"2011","Enfield 035C","E01001397","Total",783,236,40,196,547,66,52,104,147,12,49,117
"2011","Enfield 035D","E01001500","Total",554,126,44,82,428,31,60,88,82,12,57,98
"2011","Enfield 035E","E01001556","Total",543,107,49,58,436,30,68,67,63,16,60,132
"2011","Enfield 035F","E01001560","Total",516,86,39,47,430,40,53,58,65,28,58,128
"2011","Enfield 036A","E01001390","Total",762,194,53,141,568,29,42,106,174,16,31,170
"2011","Enfield 036B","E01001391","Total",687,238,39,199,449,36,35,89,160,7,24,98
"2011","Enfield 036C","E01001393","Total",839,224,44,180,615,36,47,115,195,16,39,167
"2011","Enfield 036D","E01001396","Total",511,120,56,64,391,29,72,53,59,6,39,133
"2011","Enfield 036E","E01001501","Total",818,322,89,233,496,60,33,101,151,8,42,101
"2011","Enfield 036F","E01001527","Total",645,197,82,115,448,25,75,87,114,11,27,109
"2011","Enfield 037A","E01001458","Total",664,202,40,162,462,93,33,91,73,20,46,106
"2011","Enfield 037B","E01001553","Total",530,98,21,77,432,76,42,74,56,23,78,83
"2011","Enfield 037C","E01001554","Total",756,273,74,199,483,101,34,101,94,21,66,66
"2011","Enfield 037D","E01001562","Total",711,273,20,253,438,93,24,80,105,23,50,63
"2011","Enfield 037E","E01032574","Total",695,147,51,96,548,96,53,98,71,31,72,127
"2011","Greenwich 001A","E01001690","Total",845,373,73,300,472,80,41,97,103,41,39,71
"2011","Greenwich 001B","E01001692","Total",522,158,26,132,364,61,23,72,63,31,43,71
"2011","Greenwich 001C","E01001693","Total",610,203,30,173,407,95,26,78,70,23,52,63
"2011","Greenwich 001D","E01001694","Total",598,164,26,138,434,43,24,85,92,31,63,96
"2011","Greenwich 002A","E01001687","Total",511,195,53,142,316,38,28,77,71,14,36,52
"2011","Greenwich 002B","E01001688","Total",937,265,33,232,672,153,22,201,102,49,57,88
"2011","Greenwich 002E","E01033739","Total",571,156,4,152,415,75,3,108,126,20,40,43
"2011","Greenwich 002F","E01033740","Total",550,120,9,111,430,72,16,113,86,26,56,61
"2011","Greenwich 002G","E01033741","Total",559,111,7,104,448,76,9,126,89,32,57,59
"2011","Greenwich 002H","E01033743","Total",663,123,39,84,540,122,14,135,77,47,77,68
"2011","Greenwich 002I","E01033745","Total",591,104,12,92,487,76,24,119,87,38,76,67
"2011","Greenwich 003A","E01001575","Total",599,162,56,106,437,78,44,65,59,42,62,87
"2011","Greenwich 003B","E01001576","Total",658,211,64,147,447,90,45,88,62,35,58,69
"2011","Greenwich 003C","E01001577","Total",737,270,85,185,467,88,52,87,72,41,64,63
"2011","Greenwich 003D","E01001578","Total",809,232,65,167,577,76,39,137,127,31,64,103
"2011","Greenwich 003E","E01001579","Total",637,186,64,122,451,75,60,80,75,27,50,84
"2011","Greenwich 004B","E01001709","Total",494,202,39,163,292,43,33,32,55,18,40,71
"2011","Greenwich 004C","E01001711","Total",612,245,26,219,367,38,13,79,108,13,38,78
"2011","Greenwich 004D","E01001712","Total",935,373,99,274,562,131,19,141,131,31,33,76
"2011","Greenwich 004E","E01033731","Total",559,258,3,255,301,37,1,42,175,4,14,28
"2011","Greenwich 004F","E01033734","Total",579,215,3,212,364,36,4,59,173,21,26,45
"2011","Greenwich 004G","E01033735","Total",555,259,46,213,296,35,16,63,128,3,17,34
"2011","Greenwich 004H","E01033736","Total",608,240,3,237,368,16,7,59,247,2,6,31
"2011","Greenwich 004I","E01033737","Total",602,224,56,168,378,75,18,76,66,27,45,71
"2011","Greenwich 005A","E01001705","Total",760,239,53,186,521,112,19,108,103,38,64,77
"2011","Greenwich 005B","E01001706","Total",479,114,14,100,365,51,29,58,67,20,44,96
"2011","Greenwich 005C","E01001708","Total",640,199,55,144,441,43,50,90,106,23,38,91
"2011","Greenwich 005D","E01001710","Total",685,248,71,177,437,106,19,94,82,22,49,65
"2011","Greenwich 005E","E01001713","Total",636,207,26,181,429,99,26,91,62,37,57,57
"2011","Greenwich 006A","E01001672","Total",630,115,24,91,515,55,36,75,76,36,106,131
"2011","Greenwich 006B","E01001673","Total",685,254,98,156,431,41,40,49,80,19,83,119
"2011","Greenwich 006C","E01001674","Total",671,175,72,103,496,50,56,80,78,27,94,111
"2011","Greenwich 006D","E01001675","Total",629,149,37,112,480,42,35,89,84,19,79,132
"2011","Greenwich 006E","E01001677","Total",668,189,47,142,479,56,31,86,103,24,77,102
"2011","Greenwich 007B","E01001631","Total",793,272,39,233,521,105,32,101,91,34,61,97
"2011","Greenwich 007C","E01001632","Total",635,139,42,97,496,30,20,80,72,16,126,152
"2011","Greenwich 007D","E01001635","Total",618,174,36,138,444,47,33,91,108,17,40,108
"2011","Greenwich 007E","E01001636","Total",593,192,60,132,401,33,39,70,66,15,51,127
"2011","Greenwich 007F","E01033742","Total",581,180,14,166,401,35,12,92,163,9,30,60
"2011","Greenwich 007G","E01033744","Total",646,169,13,156,477,73,21,104,110,30,53,86
"2011","Greenwich 008A","E01001571","Total",615,157,48,109,458,59,42,93,96,18,57,93
"2011","Greenwich 008B","E01001572","Total",628,156,52,104,472,43,50,102,104,32,55,86
"2011","Greenwich 008C","E01001573","Total",513,101,32,69,412,34,43,80,75,15,69,96
"2011","Greenwich 008D","E01001574","Total",768,303,73,230,465,121,40,113,72,20,32,67
"2011","Greenwich 009A","E01001629","Total",852,266,57,209,586,88,42,114,128,35,64,115
"2011","Greenwich 009B","E01001633","Total",652,240,45,195,412,59,28,83,96,29,44,73
"2011","Greenwich 009C","E01001634","Total",667,217,44,173,450,92,33,82,95,28,46,74
"2011","Greenwich 009D","E01001637","Total",706,287,60,227,419,50,38,70,100,14,56,91
"2011","Greenwich 011A","E01001695","Total",654,256,97,159,398,45,33,70,82,26,52,90
"2011","Greenwich 011B","E01001696","Total",506,168,46,122,338,56,15,66,56,19,56,70
"2011","Greenwich 011C","E01001697","Total",770,224,34,190,546,91,27,134,90,29,51,124
"2011","Greenwich 011D","E01001700","Total",703,207,23,184,496,76,25,95,92,39,61,108
"2011","Greenwich 011E","E01001703","Total",753,277,38,239,476,100,18,106,84,44,72,52
"2011","Greenwich 011F","E01001704","Total",615,175,39,136,440,40,37,84,107,33,48,91
"2011","Greenwich 012A","E01001588","Total",659,239,113,126,420,40,61,62,77,16,64,100
"2011","Greenwich 012B","E01001589","Total",616,177,37,140,439,31,43,73,115,11,60,106
"2011","Greenwich 012C","E01001591","Total",839,308,110,198,531,89,37,100,120,34,52,99
"2011","Greenwich 012D","E01001595","Total",693,152,54,98,541,82,49,106,106,35,59,104
"2011","Greenwich 014A","E01001590","Total",701,203,50,153,498,41,38,90,138,18,54,119
"2011","Greenwich 014B","E01001592","Total",740,240,59,181,500,24,38,140,168,12,31,87
"2011","Greenwich 014C","E01001593","Total",728,226,74,152,502,19,67,134,179,12,19,72
"2011","Greenwich 014D","E01001594","Total",763,227,72,155,536,90,34,122,132,25,49,84
"2011","Greenwich 015A","E01001698","Total",682,228,33,195,454,90,22,77,88,33,66,78
"2011","Greenwich 015B","E01001699","Total",602,207,27,180,395,59,16,123,94,15,40,48
"2011","Greenwich 015C","E01001701","Total",598,215,42,173,383,34,24,130,89,43,31,32
"2011","Greenwich 015D","E01001702","Total",475,71,22,49,404,60,23,54,51,49,88,79
"2011","Greenwich 016A","E01001581","Total",838,388,140,248,450,20,54,85,163,13,25,90
"2011","Greenwich 016B","E01001585","Total",628,177,49,128,451,15,57,126,149,12,31,61
"2011","Greenwich 016C","E01001586","Total",683,280,93,187,403,36,66,79,129,13,20,60
"2011","Greenwich 016D","E01001587","Total",921,386,90,296,535,33,71,111,193,17,28,82
"2011","Greenwich 017A","E01001678","Total",628,156,82,74,472,31,77,95,83,16,60,110
"2011","Greenwich 017B","E01001683","Total",565,163,54,109,402,27,39,79,89,29,43,96
"2011","Greenwich 017C","E01001684","Total",561,145,59,86,416,49,57,79,73,18,41,99
"2011","Greenwich 017D","E01001685","Total",610,194,83,111,416,41,56,76,85,12,45,101
"2011","Greenwich 019A","E01001646","Total",1179,386,57,329,793,104,38,175,249,34,60,133
"2011","Greenwich 019B","E01001650","Total",615,130,53,77,485,42,71,76,90,16,59,131
"2011","Greenwich 019C","E01001651","Total",761,303,81,222,458,60,76,86,88,24,49,75
"2011","Greenwich 019D","E01001652","Total",681,253,122,131,428,17,61,83,129,15,35,88
"2011","Greenwich 020A","E01001679","Total",520,135,38,97,385,22,41,90,100,23,44,65
"2011","Greenwich 020B","E01001680","Total",618,151,69,82,467,25,89,94,99,12,41,107
"2011","Greenwich 020C","E01001681","Total",488,153,39,114,335,23,30,78,84,15,31,74
"2011","Greenwich 020D","E01001682","Total",565,169,57,112,396,33,82,71,106,18,29,57
"2011","Greenwich 020E","E01001686","Total",767,289,74,215,478,75,44,98,109,21,42,89
"2011","Greenwich 021A","E01001580","Total",833,331,73,258,502,24,55,89,233,12,18,71
"2011","Greenwich 021B","E01001582","Total",641,235,81,154,406,39,69,101,91,15,22,69
"2011","Greenwich 021C","E01001583","Total",818,349,85,264,469,21,59,73,219,17,22,58
"2011","Greenwich 021D","E01001584","Total",713,290,89,201,423,7,80,94,153,20,22,47
"2011","Greenwich 022A","E01001645","Total",714,232,95,137,482,55,63,95,101,17,40,111
"2011","Greenwich 022B","E01001647","Total",573,163,71,92,410,34,72,67,70,12,49,106
"2011","Greenwich 022C","E01001648","Total",729,249,59,190,480,31,63,93,117,22,49,105
"2011","Greenwich 022D","E01001649","Total",569,146,48,98,423,31,41,87,89,22,48,105
"2011","Greenwich 023A","E01001605","Total",571,96,54,42,475,4,100,88,92,21,53,117
"2011","Greenwich 023B","E01001606","Total",618,130,58,72,488,25,61,124,113,15,40,110
"2011","Greenwich 023C","E01001610","Total",707,211,101,110,496,27,80,117,126,12,35,99
"2011","Greenwich 023D","E01001611","Total",741,263,129,134,478,28,94,107,111,17,28,93
"2011","Greenwich 025A","E01001620","Total",505,87,48,39,418,27,56,54,61,26,79,115
"2011","Greenwich 025B","E01001621","Total",611,209,78,131,402,38,40,61,98,14,51,100
"2011","Greenwich 025C","E01001623","Total",664,160,47,113,504,48,54,99,140,25,41,97
"2011","Greenwich 025D","E01001624","Total",631,174,74,100,457,30,71,107,103,11,44,91
"2011","Greenwich 025E","E01001625","Total",587,149,81,68,438,32,65,64,77,18,62,120
"2011","Greenwich 027A","E01001604","Total",568,152,67,85,416,14,58,100,95,15,35,99
"2011","Greenwich 027B","E01001607","Total",604,163,93,70,441,31,65,101,110,12,28,94
"2011","Greenwich 027C","E01001608","Total",592,196,98,98,396,13,92,66,75,20,45,85
"2011","Greenwich 027D","E01001609","Total",738,322,142,180,416,26,69,89,83,18,22,109
"2011","Greenwich 028A","E01001613","Total",775,343,138,205,432,28,84,75,125,17,23,80
"2011","Greenwich 028B","E01001614","Total",530,93,66,27,437,8,125,56,80,7,47,114
"2011","Greenwich 028C","E01001615","Total",756,346,131,215,410,33,57,74,132,10,27,77
"2011","Greenwich 028D","E01001617","Total",738,284,140,144,454,19,109,79,114,12,29,92
"2011","Greenwich 029A","E01001653","Total",610,168,55,113,442,71,45,95,88,16,49,78
"2011","Greenwich 029B","E01001654","Total",603,185,60,125,418,56,59,84,62,35,45,77
"2011","Greenwich 029C","E01001655","Total",637,218,48,170,419,78,43,71,97,26,29,75
"2011","Greenwich 029D","E01001660","Total",586,144,61,83,442,47,61,73,76,28,53,104
"2011","Greenwich 029E","E01001661","Total",588,142,77,65,446,39,75,73,98,18,57,86
"2011","Greenwich 030C","E01001618","Total",648,187,95,92,461,46,74,107,96,17,31,90
"2011","Greenwich 030D","E01001619","Total",818,255,80,175,563,52,72,113,189,18,35,84
"2011","Greenwich 030E","E01033729","Total",802,287,104,183,515,88,61,97,101,25,43,100
"2011","Greenwich 031A","E01001597","Total",607,181,75,106,426,16,72,76,102,20,43,97
"2011","Greenwich 031B","E01001598","Total",606,150,85,65,456,13,87,72,94,10,50,130
"2011","Greenwich 031C","E01001602","Total",718,209,99,110,509,46,81,77,99,24,77,105
"2011","Greenwich 031D","E01001603","Total",768,332,138,194,436,64,65,94,83,16,36,78
"2011","Greenwich 032A","E01001596","Total",597,120,86,34,477,16,101,96,104,10,47,103
"2011","Greenwich 032B","E01001599","Total",615,133,76,57,482,20,86,87,81,23,59,126
"2011","Greenwich 032C","E01001600","Total",663,215,68,147,448,20,71,94,120,17,30,96
"2011","Greenwich 032D","E01001601","Total",601,187,111,76,414,12,61,97,102,13,37,92
"2011","Greenwich 033A","E01001669","Total",689,191,68,123,498,60,46,91,95,30,76,100
"2011","Greenwich 033B","E01001671","Total",675,245,68,177,430,55,41,110,106,13,35,70
"2011","Greenwich 033C","E01001676","Total",646,172,38,134,474,98,15,103,81,29,60,88
"2011","Greenwich 033D","E01032567","Total",589,137,68,69,452,31,58,83,70,24,64,122
"2011","Greenwich 034A","E01001656","Total",582,209,103,106,373,35,69,70,107,8,23,61
"2011","Greenwich 034B","E01001657","Total",686,253,78,175,433,30,77,108,114,18,34,52
"2011","Greenwich 034C","E01001658","Total",723,287,120,167,436,42,66,86,129,15,32,66
"2011","Greenwich 034D","E01001659","Total",529,133,79,54,396,16,63,66,62,13,49,127
"2011","Greenwich 034E","E01033726","Total",818,164,67,97,654,72,70,112,103,39,105,153
"2011","Greenwich 035A","E01001640","Total",881,254,48,206,627,118,26,111,183,25,34,130
"2011","Greenwich 035B","E01033727","Total",802,282,32,250,520,91,23,90,162,18,52,84
"2011","Greenwich 035C","E01033728","Total",641,258,7,251,383,18,12,71,228,3,5,46
"2011","Greenwich 035D","E01033730","Total",653,287,34,253,366,47,9,61,201,6,8,34
"2011","Greenwich 036A","E01001666","Total",557,174,49,125,383,25,33,63,101,10,43,108
"2011","Greenwich 036B","E01001667","Total",707,291,110,181,416,57,45,67,115,18,24,90
"2011","Greenwich 036C","E01001668","Total",1049,394,106,288,655,86,69,128,228,27,38,79
"2011","Greenwich 036D","E01033732","Total",472,143,5,138,329,44,6,64,150,4,18,43
"2011","Greenwich 036E","E01033733","Total",548,164,3,161,384,17,9,84,227,4,6,37
"2011","Greenwich 037A","E01001662","Total",715,189,36,153,526,29,43,96,226,12,13,107
"2011","Greenwich 037B","E01001664","Total",854,317,103,214,537,21,59,89,204,17,31,116
"2011","Greenwich 037C","E01001665","Total",788,250,34,216,538,18,33,129,185,18,32,123
"2011","Greenwich 037D","E01033738","Total",519,186,55,131,333,15,18,60,117,8,22,93
"2011","Greenwich 038A","E01001638","Total",806,285,55,230,521,97,29,85,151,31,45,83
"2011","Greenwich 038B","E01001641","Total",779,291,89,202,488,41,48,79,203,27,16,74
"2011","Greenwich 038C","E01001642","Total",791,247,94,153,544,23,72,133,218,25,18,55
"2011","Greenwich 038D","E01001644","Total",1022,354,42,312,668,44,43,129,299,12,27,114
"2011","Greenwich 038E","E01033746","Total",715,278,120,158,437,24,54,79,198,10,18,54
"2011","Harrow 001A","E01002112","Total",697,150,93,57,547,14,126,90,93,20,65,139
"2011","Harrow 001B","E01002114","Total",986,424,259,165,562,32,160,100,145,15,27,83
"2011","Harrow 001C","E01002225","Total",623,155,97,58,468,5,175,57,97,15,28,91
"2011","Harrow 001D","E01002226","Total",1003,351,206,145,652,34,167,122,151,17,47,114
"2011","Harrow 002A","E01002113","Total",599,168,82,86,431,21,87,73,72,17,53,108
"2011","Harrow 002B","E01002115","Total",509,82,55,27,427,10,74,77,78,14,54,120
"2011","Harrow 002C","E01002116","Total",680,200,111,89,480,19,126,54,88,14,55,124
"2011","Harrow 002D","E01002117","Total",675,131,52,79,544,31,73,96,85,30,93,136
"2011","Harrow 002E","E01002118","Total",675,193,100,93,482,49,69,80,123,12,52,97
"2011","Harrow 003A","E01002227","Total",611,160,80,80,451,33,56,54,67,24,98,119
"2011","Harrow 003B","E01002228","Total",710,123,47,76,587,27,85,117,123,36,79,120
"2011","Harrow 003C","E01002229","Total",770,270,149,121,500,32,129,84,107,10,36,102
"2011","Harrow 003D","E01002230","Total",637,114,64,50,523,15,126,90,84,17,56,135
"2011","Harrow 004A","E01002144","Total",580,138,91,47,442,13,105,60,75,13,56,120
"2011","Harrow 004B","E01002146","Total",519,97,67,30,422,3,80,107,65,14,54,99
"2011","Harrow 004C","E01002147","Total",502,108,65,43,394,3,114,42,76,15,36,108
"2011","Harrow 004D","E01002149","Total",479,63,46,17,416,5,102,93,57,17,34,108
"2011","Harrow 005A","E01002140","Total",607,131,79,52,476,46,79,64,71,18,72,126
"2011","Harrow 005B","E01002141","Total",680,194,131,63,486,32,100,72,77,16,54,135
"2011","Harrow 005C","E01002142","Total",635,135,68,67,500,20,93,74,86,23,66,138
"2011","Harrow 005D","E01002143","Total",529,92,40,52,437,42,42,85,74,22,60,112
"2011","Harrow 005E","E01002145","Total",631,207,141,66,424,22,111,65,78,20,38,90
"2011","Harrow 006A","E01002139","Total",498,120,70,50,378,59,40,42,65,21,59,92
"2011","Harrow 006B","E01002148","Total",491,73,46,27,418,11,79,88,57,9,63,111
"2011","Harrow 006C","E01002150","Total",839,311,149,162,528,45,104,109,133,15,47,75
"2011","Harrow 006D","E01002151","Total",524,143,81,62,381,29,49,62,61,28,62,90
"2011","Harrow 006E","E01002152","Total",638,160,99,61,478,12,92,112,103,7,45,107
"2011","Harrow 007A","E01002119","Total",568,109,45,64,459,35,51,80,73,20,67,133
"2011","Harrow 007B","E01002120","Total",488,147,66,81,341,23,50,70,52,13,39,94
"2011","Harrow 007C","E01002121","Total",546,85,41,44,461,14,63,74,72,29,71,138
"2011","Harrow 007D","E01002122","Total",582,140,66,74,442,20,51,86,62,16,67,140
"2011","Harrow 007E","E01002123","Total",527,97,45,52,430,16,50,62,46,12,86,158
"2011","Harrow 008A","E01002106","Total",651,98,44,54,553,25,92,77,87,28,65,179
"2011","Harrow 008B","E01002108","Total",559,58,34,24,501,14,68,98,69,30,79,143
"2011","Harrow 008C","E01002109","Total",654,132,75,57,522,14,95,110,99,12,50,142
"2011","Harrow 008D","E01002110","Total",542,59,34,25,483,18,82,93,61,18,83,128
"2011","Harrow 008E","E01002111","Total",681,114,54,60,567,29,62,103,82,34,97,160
"2011","Harrow 009A","E01002185","Total",585,144,70,74,441,70,35,72,100,22,49,93
"2011","Harrow 009B","E01002186","Total",794,328,128,200,466,37,67,99,149,13,31,70
"2011","Harrow 009C","E01002187","Total",761,221,129,92,540,27,132,88,121,18,46,108
"2011","Harrow 009D","E01002190","Total",625,117,83,34,508,3,146,81,83,16,56,123
"2011","Harrow 010A","E01002124","Total",492,60,30,30,432,23,40,77,42,26,90,134
"2011","Harrow 010B","E01002125","Total",512,75,30,45,437,21,49,66,56,25,61,159
"2011","Harrow 010C","E01002198","Total",499,51,26,25,448,24,31,72,44,31,85,161
"2011","Harrow 010D","E01002200","Total",505,67,41,26,438,20,52,59,55,22,79,151
"2011","Harrow 010E","E01002203","Total",524,66,28,38,458,28,47,97,56,23,79,128
"2011","Harrow 011A","E01002232","Total",709,181,80,101,528,38,75,99,97,23,65,131
"2011","Harrow 011B","E01002233","Total",754,210,73,137,544,54,48,132,115,14,76,105
"2011","Harrow 011C","E01002234","Total",548,105,43,62,443,29,38,71,73,37,74,121
"2011","Harrow 011D","E01002235","Total",610,147,90,57,463,42,55,59,49,47,86,125
"2011","Harrow 011E","E01002236","Total",582,121,40,81,461,33,41,71,80,30,77,129
"2011","Harrow 012A","E01002107","Total",575,93,44,49,482,17,47,120,76,24,75,123
"2011","Harrow 012B","E01002197","Total",420,80,54,26,340,12,46,63,36,15,57,111
"2011","Harrow 012C","E01002199","Total",467,72,32,40,395,12,46,61,41,27,67,141
"2011","Harrow 012D","E01002201","Total",508,64,41,23,444,8,56,57,53,18,86,166
"2011","Harrow 012E","E01002202","Total",712,152,66,86,560,69,49,127,99,20,70,126
"2011","Harrow 013A","E01002179","Total",795,173,50,123,622,83,49,128,118,11,74,159
"2011","Harrow 013B","E01002180","Total",783,217,71,146,566,75,42,107,133,27,64,118
"2011","Harrow 013C","E01002183","Total",682,145,67,78,537,38,68,73,83,24,86,165
"2011","Harrow 013D","E01002184","Total",677,154,67,87,523,49,65,113,102,24,64,106
"2011","Harrow 013E","E01002231","Total",679,156,69,87,523,61,43,99,99,31,72,118
"2011","Harrow 015A","E01002154","Total",728,150,75,75,578,33,86,100,107,25,78,149
"2011","Harrow 015B","E01002156","Total",501,62,39,23,439,9,85,78,55,10,57,145
"2011","Harrow 015C","E01002162","Total",687,167,66,101,520,46,59,115,92,28,55,125
"2011","Harrow 015D","E01002163","Total",537,84,47,37,453,14,73,78,66,15,77,130
"2011","Harrow 016A","E01002188","Total",638,140,91,49,498,12,138,84,94,27,37,106
"2011","Harrow 016B","E01002189","Total",714,230,120,110,484,20,104,91,137,14,43,75
"2011","Harrow 016C","E01002192","Total",638,188,112,76,450,7,117,104,88,15,38,81
"2011","Harrow 016D","E01002193","Total",740,217,89,128,523,57,68,131,130,28,29,80
"2011","Harrow 017A","E01002165","Total",528,86,44,42,442,21,46,69,56,19,74,157
"2011","Harrow 017B","E01002166","Total",484,65,35,30,419,13,61,57,44,15,89,140
"2011","Harrow 017C","E01002167","Total",477,74,53,21,403,26,45,49,35,15,81,152
"2011","Harrow 017D","E01002168","Total",511,121,58,63,390,40,36,79,43,11,69,112
"2011","Harrow 017E","E01002169","Total",531,99,62,37,432,29,52,46,68,14,63,160
"2011","Harrow 019A","E01002153","Total",616,121,82,39,495,8,103,97,65,17,83,122
"2011","Harrow 019B","E01002155","Total",641,167,97,70,474,8,83,112,105,9,49,108
"2011","Harrow 019C","E01002157","Total",593,120,51,69,473,17,59,81,81,16,53,166
"2011","Harrow 019D","E01002158","Total",491,74,45,29,417,8,67,87,65,11,55,124
"2011","Harrow 020A","E01002128","Total",784,232,46,186,552,24,44,126,166,15,39,138
"2011","Harrow 020B","E01002130","Total",884,224,39,185,660,72,33,143,210,14,48,140
"2011","Harrow 020C","E01002181","Total",682,167,62,105,515,17,39,124,143,22,53,117
"2011","Harrow 020D","E01002182","Total",689,147,42,105,542,27,54,116,104,15,73,153
"2011","Harrow 021A","E01002159","Total",685,163,57,106,522,25,66,92,108,22,56,153
"2011","Harrow 021B","E01002160","Total",704,166,38,128,538,33,38,132,123,22,58,132
"2011","Harrow 021C","E01002161","Total",728,181,70,111,547,35,63,107,109,22,85,126
"2011","Harrow 021D","E01002164","Total",683,180,59,121,503,37,54,102,140,23,44,103
"2011","Harrow 022A","E01002191","Total",667,110,55,55,557,23,77,151,84,25,67,130
"2011","Harrow 022B","E01002194","Total",657,128,82,46,529,18,126,108,97,20,48,112
"2011","Harrow 022C","E01002195","Total",610,127,87,40,483,21,94,110,84,21,45,108
"2011","Harrow 022D","E01002196","Total",616,99,71,28,517,7,85,117,78,24,56,150
"2011","Harrow 023A","E01002126","Total",1203,397,160,237,806,29,84,206,268,11,58,150
"2011","Harrow 023B","E01002127","Total",628,144,49,95,484,28,65,75,130,9,44,133
"2011","Harrow 023C","E01002129","Total",889,304,76,228,585,45,56,103,211,23,32,115
"2011","Harrow 023D","E01002131","Total",586,146,68,78,440,38,55,74,65,18,57,133
"2011","Harrow 024A","E01002237","Total",648,196,44,152,452,29,32,105,138,12,43,93
"2011","Harrow 024B","E01002238","Total",596,106,49,57,490,22,48,118,87,19,68,128
"2011","Harrow 024C","E01002240","Total",655,176,71,105,479,27,70,92,108,17,52,113
"2011","Harrow 024D","E01002242","Total",613,87,48,39,526,18,101,97,60,20,77,153
"2011","Harrow 025A","E01002208","Total",483,78,56,22,405,6,110,79,52,18,52,88
"2011","Harrow 025B","E01002209","Total",546,85,41,44,461,12,79,80,76,20,62,132
"2011","Harrow 025C","E01002239","Total",635,142,74,68,493,20,110,97,89,21,49,107
"2011","Harrow 025D","E01002241","Total",536,104,34,70,432,26,40,77,64,28,72,125
"2011","Harrow 027A","E01002133","Total",896,350,127,223,546,58,85,110,112,23,45,113
"2011","Harrow 027B","E01002136","Total",638,143,81,62,495,28,65,109,99,31,47,116
"2011","Harrow 027C","E01002138","Total",509,91,36,55,418,29,39,84,77,21,67,101
"2011","Harrow 027D","E01002213","Total",1116,316,99,217,800,90,54,193,188,36,88,151
"2011","Harrow 028A","E01002211","Total",477,72,23,49,405,35,37,79,60,19,64,111
"2011","Harrow 028B","E01002212","Total",647,165,67,98,482,43,46,118,94,23,55,103
"2011","Harrow 028C","E01002216","Total",513,70,39,31,443,17,47,113,49,21,81,115
"2011","Harrow 028D","E01002217","Total",552,151,49,102,401,60,22,71,86,31,66,65
"2011","Harrow 029A","E01002132","Total",828,246,60,186,582,21,62,136,211,20,45,87
"2011","Harrow 029B","E01002134","Total",603,191,65,126,412,17,64,110,116,8,31,66
"2011","Harrow 029C","E01002135","Total",657,181,81,100,476,32,48,108,109,13,50,116
"2011","Harrow 029D","E01002137","Total",468,170,46,124,298,4,31,69,140,11,10,33
"2011","Harrow 030A","E01002218","Total",606,171,79,92,435,34,72,73,70,24,63,99
"2011","Harrow 030B","E01002219","Total",605,140,78,62,465,27,54,89,70,28,81,116
"2011","Harrow 030C","E01002221","Total",511,106,41,65,405,16,53,68,54,20,58,136
"2011","Harrow 030D","E01002222","Total",488,72,33,39,416,17,51,78,52,21,80,117
"2011","Harrow 031A","E01002214","Total",612,128,68,60,484,49,38,106,73,32,81,105
"2011","Harrow 031B","E01002215","Total",595,176,103,73,419,47,58,80,74,17,55,88
"2011","Harrow 031C","E01002220","Total",493,68,34,34,425,16,34,74,59,26,81,135
"2011","Harrow 031D","E01002223","Total",591,87,37,50,504,19,54,111,81,31,88,120
"2011","Harrow 031E","E01002224","Total",497,79,19,60,418,41,31,74,82,26,66,98
"2011","Harrow 032A","E01002204","Total",634,157,57,100,477,24,53,115,94,16,67,108
"2011","Harrow 032B","E01002206","Total",457,83,56,27,374,11,46,73,53,15,70,106
"2011","Harrow 032C","E01002207","Total",524,75,45,30,449,11,47,103,53,18,88,129
"2011","Harrow 032D","E01002210","Total",504,68,37,31,436,12,61,81,63,17,66,136
"2011","Harrow 032E","E01032576","Total",520,66,45,21,454,14,60,93,65,24,73,125
"2011","Harrow 033A","E01002170","Total",408,64,32,32,344,13,47,39,46,20,59,120
"2011","Harrow 033B","E01002171","Total",534,77,32,45,457,21,73,69,65,10,74,145
"2011","Harrow 033C","E01002172","Total",493,64,31,33,429,24,56,70,63,26,66,124
"2011","Harrow 033D","E01002173","Total",529,77,39,38,452,5,54,52,59,26,76,180
"2011","Harrow 033E","E01002174","Total",483,68,39,29,415,15,63,56,43,10,81,147
"2011","Harrow 033F","E01002175","Total",406,57,34,23,349,4,53,32,43,4,71,142
"2011","Harrow 033G","E01002176","Total",535,68,34,34,467,9,65,63,77,7,76,170
"2011","Harrow 033H","E01002177","Total",452,67,37,30,385,13,46,72,54,18,68,114
"2011","Harrow 033I","E01002178","Total",502,59,34,25,443,12,66,63,42,17,109,134
"2011","Havering 001A","E01002276","Total",694,180,72,108,514,47,83,80,101,24,60,119
"2011","Havering 001B","E01002278","Total",631,196,97,99,435,70,63,80,74,27,41,80
"2011","Havering 001C","E01002312","Total",642,244,138,106,398,32,121,61,78,20,27,59
"2011","Havering 001D","E01002313","Total",630,216,104,112,414,41,57,65,94,29,44,84
"2011","Havering 002A","E01002277","Total",608,185,72,113,423,36,60,70,95,15,45,102
"2011","Havering 002B","E01002279","Total",634,195,84,111,439,51,62,96,87,19,44,80
"2011","Havering 002C","E01002281","Total",756,327,84,243,429,79,44,83,104,22,35,62
"2011","Havering 002D","E01002283","Total",594,186,110,76,408,42,67,63,77,29,48,82
"2011","Havering 002E","E01002299","Total",664,190,69,121,474,34,63,92,94,27,63,101
"2011","Havering 003A","E01002301","Total",627,148,72,76,479,22,113,74,104,12,41,113
"2011","Havering 003B","E01002303","Total",823,236,102,134,587,75,102,103,121,28,63,95
"2011","Havering 003C","E01002304","Total",524,131,78,53,393,15,91,67,86,17,34,83
"2011","Havering 003D","E01002306","Total",625,166,56,110,459,88,50,92,94,28,32,75
"2011","Havering 003E","E01002307","Total",636,163,66,97,473,70,69,88,76,19,49,102
"2011","Havering 004A","E01002280","Total",621,224,70,154,397,67,38,99,73,18,40,62
"2011","Havering 004B","E01002282","Total",668,265,66,199,403,62,41,81,77,25,48,69
"2011","Havering 004C","E01002284","Total",765,250,113,137,515,58,66,115,113,29,45,89
"2011","Havering 004D","E01002297","Total",670,290,69,221,380,47,41,65,95,12,50,70
"2011","Havering 004E","E01002314","Total",623,174,95,79,449,55,58,84,72,29,55,96
"2011","Havering 004F","E01002316","Total",740,350,133,217,390,57,54,76,90,18,41,54
"2011","Havering 005A","E01002302","Total",598,125,66,59,473,38,81,84,103,23,39,105
"2011","Havering 005B","E01002305","Total",608,154,82,72,454,37,89,70,99,21,38,100
"2011","Havering 005C","E01002308","Total",670,214,101,113,456,40,78,88,91,24,45,90
"2011","Havering 005D","E01002326","Total",627,190,93,97,437,47,90,78,90,13,32,87
"2011","Havering 005E","E01002331","Total",596,143,80,63,453,21,96,69,104,14,46,103
"2011","Havering 006A","E01002309","Total",651,202,94,108,449,32,107,66,101,22,31,90
"2011","Havering 006B","E01002310","Total",712,259,92,167,453,67,67,79,124,10,34,72
"2011","Havering 006C","E01002311","Total",668,186,82,104,482,58,82,98,85,21,53,85
"2011","Havering 006D","E01002315","Total",633,195,84,111,438,58,57,79,103,22,42,77
"2011","Havering 007A","E01002293","Total",801,351,75,276,450,49,52,114,167,3,19,46
"2011","Havering 007B","E01002294","Total",626,169,97,72,457,11,113,78,110,8,41,96
"2011","Havering 007C","E01002296","Total",691,187,101,86,504,12,120,83,127,11,45,106
"2011","Havering 007D","E01002298","Total",654,185,104,81,469,25,100,73,128,17,47,79
"2011","Havering 007E","E01002300","Total",715,216,136,80,499,23,120,83,147,10,23,93
"2011","Havering 008A","E01002333","Total",516,119,83,36,397,20,104,63,63,12,33,102
"2011","Havering 008B","E01002334","Total",674,157,101,56,517,13,148,75,106,12,47,116
"2011","Havering 008C","E01002336","Total",612,152,90,62,460,23,117,80,101,18,34,87
"2011","Havering 008D","E01002339","Total",602,122,81,41,480,9,115,92,87,16,56,105
"2011","Havering 008E","E01002341","Total",557,116,84,32,441,6,131,69,94,11,27,103
"2011","Havering 009A","E01002327","Total",595,158,97,61,437,34,92,80,82,19,32,98
"2011","Havering 009B","E01002328","Total",642,135,69,66,507,28,77,113,114,23,38,114
"2011","Havering 009C","E01002332","Total",683,199,100,99,484,30,104,109,94,15,29,103
"2011","Havering 009D","E01002335","Total",592,155,80,75,437,38,81,72,98,6,24,118
"2011","Havering 009E","E01002338","Total",523,132,75,57,391,17,71,65,76,28,45,89
"2011","Havering 009F","E01002340","Total",509,108,54,54,401,15,67,89,80,20,46,84
"2011","Havering 010A","E01002268","Total",519,123,85,38,396,11,88,70,81,16,44,86
"2011","Havering 010B","E01002269","Total",678,142,91,51,536,29,122,96,85,19,58,127
"2011","Havering 010C","E01002295","Total",670,210,70,140,460,30,82,94,132,11,25,86
"2011","Havering 010D","E01002377","Total",711,238,105,133,473,30,69,101,131,15,42,85
"2011","Havering 010E","E01002378","Total",604,115,74,41,489,13,69,129,101,16,48,113
"2011","Havering 010F","E01002383","Total",659,179,102,77,480,12,93,107,121,8,39,100
"2011","Havering 011A","E01002244","Total",749,262,67,195,487,56,46,101,158,15,38,73
"2011","Havering 011B","E01002245","Total",630,196,122,74,434,32,58,95,103,20,43,83
"2011","Havering 011C","E01002325","Total",755,230,131,99,525,77,107,95,119,17,20,90
"2011","Havering 011D","E01002329","Total",643,162,77,85,481,24,93,95,110,24,43,92
"2011","Havering 011E","E01002330","Total",737,225,85,140,512,53,93,101,119,24,36,86
"2011","Havering 012A","E01002337","Total",512,142,85,57,370,8,91,56,90,12,40,73
"2011","Havering 012B","E01002354","Total",561,153,81,72,408,14,95,86,93,18,21,81
"2011","Havering 012C","E01002376","Total",520,70,29,41,450,22,88,95,103,14,34,94
"2011","Havering 012D","E01002379","Total",659,228,121,107,431,27,73,76,140,9,32,74
"2011","Havering 012E","E01002380","Total",1036,418,81,337,618,85,86,97,231,13,23,83
"2011","Havering 012F","E01002381","Total",645,183,78,105,462,33,93,76,111,17,34,98
"2011","Havering 013A","E01002243","Total",847,328,121,207,519,100,50,99,143,16,38,73
"2011","Havering 013B","E01002353","Total",832,249,108,141,583,32,117,87,150,20,68,109
"2011","Havering 013C","E01002356","Total",1037,437,97,340,600,106,54,111,177,18,37,97
"2011","Havering 013E","E01032741","Total",663,387,49,338,276,37,19,39,147,4,12,18
"2011","Havering 013F","E01032742","Total",644,290,135,155,354,20,60,82,119,2,15,56
"2011","Havering 014A","E01002272","Total",536,134,71,63,402,19,82,71,97,13,28,92
"2011","Havering 014B","E01002274","Total",692,208,101,107,484,16,97,85,129,21,47,89
"2011","Havering 014C","E01002317","Total",544,89,47,42,455,13,104,78,66,20,45,129
"2011","Havering 014D","E01002318","Total",614,122,73,49,492,13,118,82,98,13,45,123
"2011","Havering 014E","E01002355","Total",574,117,66,51,457,12,83,106,117,24,27,88
"2011","Havering 014F","E01002382","Total",765,239,91,148,526,34,92,96,157,15,37,95
"2011","Havering 015A","E01002270","Total",634,191,112,79,443,7,113,56,67,21,47,132
"2011","Havering 015B","E01002271","Total",515,73,50,23,442,7,134,51,67,15,53,115
"2011","Havering 015C","E01002273","Total",490,79,53,26,411,13,108,51,87,7,45,100
"2011","Havering 015D","E01002275","Total",517,106,63,43,411,3,120,38,79,16,48,107
"2011","Havering 016A","E01002319","Total",652,210,121,89,442,30,74,76,90,17,35,120
"2011","Havering 016B","E01002350","Total",711,308,95,213,403,52,44,78,115,12,25,77
"2011","Havering 016C","E01002351","Total",653,177,64,113,476,36,52,117,140,9,28,94
"2011","Havering 016D","E01002352","Total",722,275,76,199,447,41,49,94,140,14,31,78
"2011","Havering 016E","E01002358","Total",791,275,53,222,516,56,41,115,171,11,39,83
"2011","Havering 017A","E01002246","Total",637,164,86,78,473,30,85,85,100,15,57,101
"2011","Havering 017B","E01002247","Total",729,193,64,129,536,61,51,128,149,15,49,83
"2011","Havering 017C","E01002248","Total",592,169,74,95,423,55,71,88,101,12,21,75
"2011","Havering 017D","E01002249","Total",746,200,52,148,546,52,58,92,138,22,65,119
"2011","Havering 017E","E01002250","Total",642,194,45,149,448,40,56,95,98,19,44,96
"2011","Havering 017F","E01002251","Total",526,127,51,76,399,43,47,71,89,21,50,78
"2011","Havering 018A","E01002252","Total",617,160,115,45,457,22,118,70,81,16,43,107
"2011","Havering 018B","E01002256","Total",620,159,106,53,461,12,130,102,85,13,38,81
"2011","Havering 018C","E01002258","Total",797,319,198,121,478,50,119,84,95,15,32,83
"2011","Havering 018D","E01002259","Total",612,173,116,57,439,30,95,77,83,12,47,95
"2011","Havering 018E","E01002391","Total",608,161,94,67,447,12,122,80,72,9,51,101
"2011","Havering 019A","E01002253","Total",615,139,107,32,476,5,143,85,88,8,45,102
"2011","Havering 019B","E01002254","Total",636,144,99,45,492,14,150,75,83,19,48,103
"2011","Havering 019C","E01002257","Total",651,172,124,48,479,15,114,93,69,24,54,110
"2011","Havering 019D","E01002384","Total",644,189,103,86,455,15,111,93,102,11,24,99
"2011","Havering 020A","E01002359","Total",515,142,110,32,373,10,68,80,74,10,38,93
"2011","Havering 020B","E01002360","Total",742,349,246,103,393,19,116,54,96,8,28,72
"2011","Havering 020C","E01002361","Total",822,322,144,178,500,48,92,88,157,10,22,83
"2011","Havering 020D","E01002363","Total",686,222,126,96,464,39,86,89,120,12,33,85
"2011","Havering 020E","E01002367","Total",658,195,79,116,463,30,82,96,113,12,42,88
"2011","Havering 021A","E01002320","Total",537,106,52,54,431,12,65,98,77,11,49,119
"2011","Havering 021B","E01002321","Total",635,155,74,81,480,15,88,101,101,11,40,124
"2011","Havering 021C","E01002322","Total",731,171,61,110,560,20,70,104,140,17,62,147
"2011","Havering 021D","E01002323","Total",627,130,77,53,497,24,89,107,100,13,60,104
"2011","Havering 021E","E01002324","Total",650,228,118,110,422,28,80,56,107,11,31,109
"2011","Havering 022A","E01002255","Total",630,160,81,79,470,32,110,111,106,7,18,86
"2011","Havering 022B","E01002289","Total",621,160,95,65,461,22,95,81,82,18,60,103
"2011","Havering 022C","E01002292","Total",637,181,115,66,456,34,92,82,102,17,46,83
"2011","Havering 022D","E01002362","Total",616,163,77,86,453,29,96,71,105,10,34,108
"2011","Havering 022E","E01002386","Total",871,335,144,191,536,38,97,113,160,17,26,85
"2011","Havering 023A","E01002287","Total",602,129,67,62,473,21,102,85,84,12,43,126
"2011","Havering 023B","E01002291","Total",775,302,113,189,473,25,112,60,151,8,27,90
"2011","Havering 023C","E01002364","Total",542,116,84,32,426,12,113,63,84,19,29,106
"2011","Havering 023D","E01002365","Total",552,169,93,76,383,24,80,54,80,14,33,98
"2011","Havering 023E","E01002366","Total",568,131,60,71,437,30,70,75,97,25,38,102
"2011","Havering 024A","E01002385","Total",601,133,74,59,468,9,91,88,104,17,52,107
"2011","Havering 024B","E01002387","Total",607,119,91,28,488,10,123,100,89,15,40,111
"2011","Havering 024C","E01002388","Total",608,107,82,25,501,16,120,96,91,18,43,117
"2011","Havering 024D","E01002389","Total",623,146,107,39,477,10,139,68,97,14,32,117
"2011","Havering 024E","E01002390","Total",531,85,64,21,446,8,104,82,96,17,45,94
"2011","Havering 025A","E01002265","Total",638,193,87,106,445,19,72,88,136,11,28,91
"2011","Havering 025B","E01002285","Total",520,140,82,58,380,12,101,52,81,7,32,95
"2011","Havering 025C","E01002286","Total",614,101,70,31,513,24,113,93,109,14,49,111
"2011","Havering 025D","E01002288","Total",554,85,46,39,469,21,73,86,100,10,45,134
"2011","Havering 025E","E01002290","Total",641,182,127,55,459,17,130,58,88,11,46,109
"2011","Havering 026A","E01002260","Total",566,107,62,45,459,30,89,71,93,12,45,119
"2011","Havering 026B","E01002261","Total",645,163,101,62,482,42,77,77,101,24,44,117
"2011","Havering 026C","E01002262","Total",625,165,96,69,460,28,93,62,89,22,57,109
"2011","Havering 026D","E01002263","Total",609,125,61,64,484,19,85,73,119,18,40,130
"2011","Havering 026E","E01002264","Total",710,295,163,132,415,69,83,77,80,13,23,70
"2011","Havering 027A","E01002266","Total",600,174,131,43,426,14,113,71,73,4,38,113
"2011","Havering 027B","E01002267","Total",734,232,154,78,502,49,127,92,99,18,32,85
"2011","Havering 027C","E01002372","Total",603,131,74,57,472,33,102,75,77,20,53,112
"2011","Havering 027D","E01002373","Total",628,156,93,63,472,34,94,89,95,10,45,105
"2011","Havering 027E","E01002374","Total",604,166,94,72,438,37,76,67,94,14,47,103
"2011","Havering 028A","E01002368","Total",696,274,58,216,422,72,57,83,80,21,40,69
"2011","Havering 028B","E01002369","Total",730,191,84,107,539,46,93,90,103,18,64,125
"2011","Havering 028C","E01002370","Total",846,308,109,199,538,57,79,101,120,22,52,107
"2011","Havering 028D","E01002371","Total",643,149,93,56,494,36,121,72,90,14,47,114
"2011","Havering 028E","E01002375","Total",688,200,102,98,488,71,78,90,103,29,36,81
"2011","Havering 029A","E01002343","Total",636,136,90,46,500,26,119,65,81,22,55,132
"2011","Havering 029B","E01002344","Total",638,192,98,94,446,35,109,55,87,17,36,107
"2011","Havering 029C","E01002348","Total",642,166,111,55,476,18,146,74,89,9,33,107
"2011","Havering 029D","E01002349","Total",608,161,97,64,447,9,99,76,88,10,39,126
"2011","Havering 030A","E01002342","Total",632,189,94,95,443,47,57,87,88,18,42,104
"2011","Havering 030B","E01002345","Total",756,272,66,206,484,122,44,96,110,17,34,61
"2011","Havering 030C","E01002346","Total",557,114,49,65,443,38,49,74,108,20,53,101
"2011","Havering 030D","E01002347","Total",526,114,58,56,412,31,78,62,74,20,51,96
"2011","Hillingdon 001A","E01002473","Total",636,191,78,113,445,10,104,63,88,12,43,125
"2011","Hillingdon 001B","E01002475","Total",692,258,99,159,434,26,95,105,120,6,21,61
"2011","Hillingdon 001C","E01002476","Total",611,143,73,70,468,11,102,80,104,12,52,107
"2011","Hillingdon 001D","E01002477","Total",559,199,72,127,360,22,83,70,95,8,23,59
"2011","Hillingdon 001E","E01002482","Total",617,121,74,47,496,9,143,87,92,22,37,106
"2011","Hillingdon 002A","E01002472","Total",771,345,163,182,426,35,97,73,138,4,22,57
"2011","Hillingdon 002B","E01002474","Total",643,218,114,104,425,20,79,88,94,15,40,89
"2011","Hillingdon 002C","E01002478","Total",666,207,81,126,459,23,95,111,124,8,27,71
"2011","Hillingdon 002D","E01002483","Total",714,205,101,104,509,34,82,106,126,19,48,94
"2011","Hillingdon 002E","E01002484","Total",585,185,82,103,400,13,60,99,95,8,41,84
"2011","Hillingdon 002F","E01002485","Total",762,274,101,173,488,50,72,101,131,13,38,83
"2011","Hillingdon 003A","E01002438","Total",480,99,32,67,381,19,57,89,108,12,33,63
"2011","Hillingdon 003B","E01002439","Total",608,172,96,76,436,38,81,88,106,18,32,73
"2011","Hillingdon 003C","E01002440","Total",618,191,103,88,427,34,78,95,107,10,32,71
"2011","Hillingdon 003D","E01002441","Total",667,236,92,144,431,37,69,78,127,14,35,71
"2011","Hillingdon 003E","E01002442","Total",635,201,67,134,434,23,63,93,122,14,36,83
"2011","Hillingdon 004A","E01002433","Total",782,257,124,133,525,36,77,111,152,18,41,90
"2011","Hillingdon 004B","E01002436","Total",658,182,93,89,476,19,97,115,97,14,43,91
"2011","Hillingdon 004C","E01002479","Total",628,154,61,93,474,33,63,112,95,17,48,106
"2011","Hillingdon 004D","E01002480","Total",713,170,107,63,543,17,118,116,138,16,46,92
"2011","Hillingdon 004E","E01002481","Total",659,190,102,88,469,38,73,101,115,17,35,90
"2011","Hillingdon 005A","E01002533","Total",589,158,41,117,431,43,46,106,121,13,33,69
"2011","Hillingdon 005B","E01002534","Total",607,186,111,75,421,18,83,89,96,22,36,77
"2011","Hillingdon 005C","E01002538","Total",746,292,119,173,454,24,84,86,142,8,25,85
"2011","Hillingdon 005D","E01002539","Total",619,155,104,51,464,21,119,87,87,14,27,109
"2011","Hillingdon 006A","E01002418","Total",658,162,99,63,496,23,77,118,94,24,57,103
"2011","Hillingdon 006B","E01002419","Total",611,145,68,77,466,23,73,99,129,21,32,89
"2011","Hillingdon 006C","E01002431","Total",489,77,53,24,412,9,89,85,58,19,49,103
"2011","Hillingdon 006D","E01002432","Total",635,170,101,69,465,16,99,81,112,11,42,104
"2011","Hillingdon 006E","E01002437","Total",608,153,121,32,455,8,159,62,78,10,43,95
"2011","Hillingdon 007A","E01002430","Total",524,73,51,22,451,6,107,73,80,21,43,121
"2011","Hillingdon 007B","E01002434","Total",504,89,67,22,415,12,106,73,82,16,53,73
"2011","Hillingdon 007C","E01002435","Total",535,103,69,34,432,8,113,76,74,24,33,104
"2011","Hillingdon 007D","E01002470","Total",702,209,109,100,493,28,87,96,131,15,33,103
"2011","Hillingdon 007E","E01002535","Total",828,285,117,168,543,20,95,78,228,12,36,74
"2011","Hillingdon 008A","E01002416","Total",593,91,47,44,502,16,71,124,90,16,62,123
"2011","Hillingdon 008B","E01002417","Total",638,173,99,74,465,15,102,89,104,19,36,100
"2011","Hillingdon 008C","E01002420","Total",662,204,98,106,458,40,60,112,108,15,34,89
"2011","Hillingdon 008D","E01002421","Total",636,149,84,65,487,30,86,107,97,18,49,100
"2011","Hillingdon 008E","E01002471","Total",634,152,72,80,482,20,71,129,120,11,40,91
"2011","Hillingdon 009A","E01002465","Total",633,167,73,94,466,51,55,97,130,24,35,74
"2011","Hillingdon 009B","E01002467","Total",639,176,145,31,463,22,117,95,99,21,21,88
"2011","Hillingdon 009C","E01002494","Total",637,144,58,86,493,33,54,109,122,24,40,111
"2011","Hillingdon 009D","E01002536","Total",609,210,49,161,399,32,46,98,138,16,19,50
"2011","Hillingdon 009E","E01002537","Total",579,159,44,115,420,22,60,88,130,15,32,73
"2011","Hillingdon 010A","E01002415","Total",643,131,70,61,512,19,83,124,121,20,50,95
"2011","Hillingdon 010B","E01002466","Total",633,135,66,69,498,20,83,131,103,21,36,104
"2011","Hillingdon 010C","E01002468","Total",633,141,65,76,492,28,51,119,127,20,38,109
"2011","Hillingdon 010D","E01002469","Total",631,133,61,72,498,28,74,106,121,18,45,106
"2011","Hillingdon 010E","E01002495","Total",695,144,50,94,551,46,55,139,153,7,51,100
"2011","Hillingdon 011A","E01002458","Total",543,115,81,34,428,7,115,62,74,20,37,113
"2011","Hillingdon 011B","E01002459","Total",622,115,83,32,507,11,148,93,102,21,39,93
"2011","Hillingdon 011C","E01002460","Total",597,219,141,78,378,15,86,77,81,10,23,86
"2011","Hillingdon 011D","E01002462","Total",506,91,55,36,415,8,82,100,73,19,42,91
"2011","Hillingdon 011E","E01002464","Total",623,158,77,81,465,20,73,144,102,14,30,82
"2011","Hillingdon 013A","E01002461","Total",516,108,63,45,408,10,86,66,67,12,48,119
"2011","Hillingdon 013B","E01002463","Total",528,79,57,22,449,8,92,83,69,25,57,115
"2011","Hillingdon 013C","E01002512","Total",647,148,78,70,499,5,110,89,93,12,51,139
"2011","Hillingdon 013D","E01002513","Total",544,161,94,67,383,4,80,61,82,12,32,112
"2011","Hillingdon 013E","E01002516","Total",490,91,44,47,399,5,83,73,56,11,59,112
"2011","Hillingdon 014A","E01002450","Total",503,95,41,54,408,26,50,106,80,19,38,89
"2011","Hillingdon 014B","E01002451","Total",493,73,45,28,420,20,58,89,56,19,59,119
"2011","Hillingdon 014C","E01002452","Total",500,68,38,30,432,17,50,87,79,20,57,122
"2011","Hillingdon 014D","E01002453","Total",599,110,61,49,489,32,54,102,96,23,57,125
"2011","Hillingdon 014E","E01002454","Total",661,167,77,90,494,63,58,131,80,22,50,90
"2011","Hillingdon 015A","E01002414","Total",527,185,54,131,342,22,38,49,115,5,19,94
"2011","Hillingdon 015C","E01002514","Total",885,358,117,241,527,25,61,112,193,13,29,94
"2011","Hillingdon 015D","E01002515","Total",718,265,117,148,453,53,35,95,139,14,31,86
"2011","Hillingdon 015F","E01033725","Total",945,276,96,180,669,35,79,133,202,23,48,149
"2011","Hillingdon 016B","E01002520","Total",603,141,33,108,462,40,37,110,135,13,37,90
"2011","Hillingdon 016C","E01002521","Total",909,455,187,268,454,52,51,72,153,18,18,90
"2011","Hillingdon 016D","E01002523","Total",549,106,36,70,443,23,38,74,115,15,45,133
"2011","Hillingdon 016F","E01033724","Total",1051,300,93,207,751,58,78,127,164,25,47,252
"2011","Hillingdon 017A","E01002410","Total",638,156,72,84,482,39,67,79,102,13,54,128
"2011","Hillingdon 017B","E01002412","Total",822,167,56,111,655,37,92,106,140,17,67,196
"2011","Hillingdon 017C","E01002456","Total",621,159,92,67,462,47,70,90,100,29,47,79
"2011","Hillingdon 017D","E01002509","Total",502,89,72,17,413,11,73,80,62,17,44,126
"2011","Hillingdon 017E","E01002511","Total",613,179,87,92,434,31,61,103,102,14,37,86
"2011","Hillingdon 018A","E01002422","Total",494,86,43,43,408,35,54,92,50,17,52,108
"2011","Hillingdon 018B","E01002423","Total",568,108,50,58,460,23,74,75,74,26,64,124
"2011","Hillingdon 018C","E01002424","Total",526,96,48,48,430,34,49,97,57,20,63,110
"2011","Hillingdon 018D","E01002425","Total",613,149,57,92,464,44,51,79,74,23,78,115
"2011","Hillingdon 018E","E01002427","Total",514,107,62,45,407,22,48,76,76,17,54,114
"2011","Hillingdon 018F","E01002428","Total",496,76,47,29,420,22,77,67,67,25,66,96
"2011","Hillingdon 019A","E01002408","Total",629,234,75,159,395,45,42,67,93,15,45,88
"2011","Hillingdon 019B","E01002409","Total",672,166,91,75,506,50,90,84,99,18,60,105
"2011","Hillingdon 019C","E01002429","Total",498,125,47,78,373,43,39,79,55,24,49,84
"2011","Hillingdon 019D","E01002455","Total",652,163,74,89,489,39,74,106,87,19,48,116
"2011","Hillingdon 019E","E01002457","Total",517,79,20,59,438,63,37,92,58,17,45,126
"2011","Hillingdon 020A","E01002392","Total",618,156,63,93,462,105,38,91,73,38,45,72
"2011","Hillingdon 020B","E01002393","Total",705,184,54,130,521,69,43,131,75,21,68,114
"2011","Hillingdon 020C","E01002540","Total",621,162,34,128,459,49,41,100,119,23,56,71
"2011","Hillingdon 020D","E01002542","Total",665,141,53,88,524,87,41,117,88,29,53,109
"2011","Hillingdon 020E","E01002543","Total",625,164,65,99,461,86,43,80,70,32,60,90
"2011","Hillingdon 021A","E01002394","Total",508,97,58,39,411,23,57,67,52,37,79,96
"2011","Hillingdon 021B","E01002395","Total",424,69,20,49,355,12,30,64,44,23,66,116
"2011","Hillingdon 021C","E01002397","Total",514,82,27,55,432,41,35,84,58,27,60,127
"2011","Hillingdon 021D","E01002398","Total",493,76,26,50,417,14,33,72,51,13,92,142
"2011","Hillingdon 021E","E01002399","Total",474,81,36,45,393,19,37,47,55,32,79,124
"2011","Hillingdon 021F","E01002426","Total",631,123,63,60,508,64,62,136,80,24,54,88
"2011","Hillingdon 022A","E01002411","Total",632,160,75,85,472,52,68,68,92,16,44,132
"2011","Hillingdon 022B","E01002413","Total",594,159,71,88,435,55,56,86,79,18,32,109
"2011","Hillingdon 022C","E01002518","Total",490,126,57,69,364,11,48,55,80,10,32,128
"2011","Hillingdon 022D","E01002519","Total",719,318,103,215,401,33,60,65,124,10,30,79
"2011","Hillingdon 022E","E01002550","Total",795,277,41,236,518,78,34,117,154,19,35,81
"2011","Hillingdon 022F","E01002554","Total",1073,337,38,299,736,94,26,162,258,31,64,101
"2011","Hillingdon 023A","E01002541","Total",785,227,55,172,558,64,47,138,145,19,48,97
"2011","Hillingdon 023B","E01002544","Total",555,115,35,80,440,25,37,96,91,26,60,105
"2011","Hillingdon 023C","E01002545","Total",483,54,14,40,429,97,20,96,61,17,56,82
"2011","Hillingdon 023D","E01002546","Total",449,60,27,33,389,16,29,61,48,27,87,121
"2011","Hillingdon 023E","E01002547","Total",492,77,22,55,415,48,29,92,65,16,65,100
"2011","Hillingdon 024A","E01002400","Total",599,119,62,57,480,42,53,90,81,31,70,113
"2011","Hillingdon 024B","E01002401","Total",609,158,58,100,451,56,40,96,86,18,56,99
"2011","Hillingdon 024C","E01002402","Total",491,109,49,60,382,34,36,62,49,34,56,111
"2011","Hillingdon 024D","E01002403","Total",543,94,49,45,449,56,37,56,65,38,82,115
"2011","Hillingdon 024E","E01002404","Total",675,168,60,108,507,94,42,121,92,23,60,75
"2011","Hillingdon 025A","E01002548","Total",657,203,111,92,454,64,41,94,93,24,48,90
"2011","Hillingdon 025B","E01002549","Total",672,168,75,93,504,32,70,108,122,17,45,110
"2011","Hillingdon 025C","E01002551","Total",641,131,79,52,510,43,53,88,92,25,60,149
"2011","Hillingdon 025D","E01002552","Total",526,87,41,46,439,44,41,86,82,18,63,105
"2011","Hillingdon 025E","E01002553","Total",603,136,60,76,467,48,54,91,85,27,51,111
"2011","Hillingdon 026A","E01002396","Total",563,137,97,40,426,32,33,78,46,24,88,125
"2011","Hillingdon 026B","E01002501","Total",506,87,40,47,419,27,58,57,54,20,81,122
"2011","Hillingdon 026C","E01002502","Total",491,101,48,53,390,24,33,55,50,22,78,128
"2011","Hillingdon 026D","E01002505","Total",682,209,56,153,473,65,32,108,122,27,35,84
"2011","Hillingdon 026E","E01002508","Total",648,173,99,74,475,57,50,89,59,24,99,97
"2011","Hillingdon 027A","E01002405","Total",634,168,68,100,466,46,45,94,76,18,81,106
"2011","Hillingdon 027B","E01002406","Total",680,131,51,80,549,70,44,91,73,35,86,150
"2011","Hillingdon 027C","E01002503","Total",497,78,25,53,419,26,38,69,46,31,71,138
"2011","Hillingdon 027D","E01002504","Total",726,174,63,111,552,70,62,106,108,21,65,120
"2011","Hillingdon 027E","E01002506","Total",643,177,52,125,466,84,27,75,81,29,71,99
"2011","Hillingdon 027F","E01002507","Total",465,63,27,36,402,18,29,56,45,28,89,137
"2011","Hillingdon 028A","E01002486","Total",699,125,58,67,574,67,44,113,88,43,107,112
"2011","Hillingdon 028B","E01002487","Total",614,154,53,101,460,31,45,90,74,30,63,127
"2011","Hillingdon 028C","E01002526","Total",635,120,49,71,515,58,41,110,92,27,85,102
"2011","Hillingdon 028D","E01002528","Total",563,103,55,48,460,39,62,76,67,23,62,131
"2011","Hillingdon 028E","E01002532","Total",886,244,40,204,642,82,43,168,151,32,61,105
"2011","Hillingdon 029A","E01002445","Total",588,114,55,59,474,117,39,96,72,32,42,76
"2011","Hillingdon 029B","E01002525","Total",647,178,62,116,469,29,78,97,131,12,25,97
"2011","Hillingdon 029C","E01002529","Total",771,184,44,140,587,76,45,136,128,18,56,128
"2011","Hillingdon 029D","E01002530","Total",619,159,84,75,460,80,66,94,75,26,56,63
"2011","Hillingdon 029E","E01002531","Total",644,178,93,85,466,21,82,80,118,19,32,114
"2011","Hillingdon 030A","E01002407","Total",725,137,35,102,588,64,50,115,97,22,112,128
"2011","Hillingdon 030B","E01002488","Total",533,86,43,43,447,24,62,80,55,29,69,128
"2011","Hillingdon 030C","E01002489","Total",537,95,54,41,442,33,37,80,49,18,108,117
"2011","Hillingdon 030D","E01002490","Total",656,115,42,73,541,45,55,111,77,34,79,140
"2011","Hillingdon 030E","E01002492","Total",488,67,31,36,421,32,33,80,48,28,81,119
"2011","Hillingdon 031A","E01002444","Total",625,205,63,142,420,23,58,53,105,12,48,121
"2011","Hillingdon 031B","E01002446","Total",592,166,62,104,426,40,56,83,84,18,52,93
"2011","Hillingdon 031C","E01002447","Total",623,151,35,116,472,52,27,81,117,19,46,130
"2011","Hillingdon 031D","E01002527","Total",622,190,86,104,432,34,58,98,123,12,27,80
"2011","Hillingdon 032A","E01002443","Total",547,108,29,79,439,31,35,97,91,16,58,111
"2011","Hillingdon 032B","E01002448","Total",765,228,86,142,537,52,70,100,122,26,53,114
"2011","Hillingdon 032C","E01002449","Total",710,223,47,176,487,47,45,89,129,8,60,109
"2011","Hillingdon 032D","E01002491","Total",519,106,49,57,413,46,47,72,55,26,73,94
"2011","Hillingdon 032E","E01002493","Total",601,87,30,57,514,91,38,110,75,41,65,94
"2011","Hillingdon 033A","E01002496","Total",767,258,89,169,509,43,46,149,133,12,37,89
"2011","Hillingdon 033B","E01002497","Total",759,227,96,131,532,65,72,111,135,14,49,86
"2011","Hillingdon 033C","E01002498","Total",516,102,53,49,414,24,79,86,67,14,41,103
"2011","Hillingdon 033D","E01002499","Total",678,171,78,93,507,46,80,96,133,17,52,83
"2011","Hillingdon 033E","E01032577","Total",601,106,58,48,495,39,77,96,105,20,53,105
"2011","Hounslow 001A","E01002569","Total",792,283,73,210,509,18,51,115,202,12,17,94
"2011","Hounslow 001B","E01002570","Total",732,242,60,182,490,19,51,74,207,16,33,90
"2011","Hounslow 001C","E01002573","Total",679,205,64,141,474,17,47,113,154,23,36,84
"2011","Hounslow 001D","E01002574","Total",645,182,59,123,463,18,44,95,164,13,31,98
"2011","Hounslow 001E","E01002575","Total",688,205,61,144,483,14,57,87,134,36,42,113
"2011","Hounslow 003A","E01002562","Total",518,145,64,81,373,32,59,53,75,8,33,113
"2011","Hounslow 003B","E01002564","Total",736,207,50,157,529,58,52,104,124,26,45,120
"2011","Hounslow 003C","E01002566","Total",1027,431,71,360,596,101,37,113,209,27,29,80
"2011","Hounslow 003D","E01002568","Total",1181,381,119,262,800,139,59,132,252,27,57,134
"2011","Hounslow 003F","E01033081","Total",649,271,44,227,378,50,17,77,180,4,10,40
"2011","Hounslow 003G","E01033082","Total",659,327,115,212,332,32,46,63,127,3,17,44
"2011","Hounslow 004A","E01002620","Total",676,185,58,127,491,69,44,125,75,24,64,90
"2011","Hounslow 004B","E01002625","Total",492,79,47,32,413,17,39,57,54,11,95,140
"2011","Hounslow 004C","E01002626","Total",490,100,49,51,390,17,36,49,49,12,76,151
"2011","Hounslow 004D","E01002627","Total",609,158,53,105,451,67,40,79,67,19,59,120
"2011","Hounslow 004E","E01002631","Total",509,84,19,65,425,28,31,87,74,26,74,105
"2011","Hounslow 005A","E01002633","Total",623,196,75,121,427,54,39,85,78,23,61,87
"2011","Hounslow 005B","E01002634","Total",546,86,40,46,460,66,33,84,65,41,62,109
"2011","Hounslow 005C","E01002637","Total",563,165,41,124,398,32,37,62,56,30,66,115
"2011","Hounslow 005D","E01002638","Total",582,111,48,63,471,42,45,77,57,34,78,138
"2011","Hounslow 006A","E01002563","Total",635,174,57,117,461,17,76,70,116,6,48,128
"2011","Hounslow 006B","E01002565","Total",1020,461,124,337,559,47,47,113,205,15,33,99
"2011","Hounslow 006C","E01002567","Total",837,332,76,256,505,40,37,107,202,12,22,85
"2011","Hounslow 006D","E01002684","Total",1096,424,80,344,672,58,59,118,271,14,40,112
"2011","Hounslow 006E","E01002686","Total",681,205,89,116,476,43,41,83,103,15,68,123
"2011","Hounslow 007A","E01002571","Total",611,212,59,153,399,20,56,98,148,10,21,46
"2011","Hounslow 007B","E01002572","Total",710,270,79,191,440,66,39,75,112,21,43,84
"2011","Hounslow 007C","E01002577","Total",660,190,50,140,470,23,40,98,150,24,32,103
"2011","Hounslow 007D","E01002578","Total",612,180,61,119,432,18,77,90,94,28,35,90
"2011","Hounslow 007E","E01002689","Total",796,368,123,245,428,37,53,105,142,16,28,47
"2011","Hounslow 007F","E01002690","Total",612,181,52,129,431,23,44,84,141,21,33,85
"2011","Hounslow 008A","E01002576","Total",756,262,67,195,494,56,56,112,139,25,37,69
"2011","Hounslow 008B","E01002579","Total",823,301,117,184,522,25,94,120,167,10,24,82
"2011","Hounslow 008C","E01002580","Total",675,302,96,206,373,32,31,83,124,12,21,70
"2011","Hounslow 008D","E01002581","Total",862,292,74,218,570,31,59,139,223,10,14,94
"2011","Hounslow 008E","E01002582","Total",719,237,86,151,482,29,46,137,145,22,22,81
"2011","Hounslow 009A","E01002675","Total",877,187,62,125,690,51,63,148,158,28,73,169
"2011","Hounslow 009B","E01002678","Total",669,162,46,116,507,20,61,94,113,18,61,140
"2011","Hounslow 009C","E01002679","Total",643,155,63,92,488,19,66,93,93,15,56,146
"2011","Hounslow 009D","E01002680","Total",728,191,54,137,537,23,72,110,115,20,56,141
"2011","Hounslow 010A","E01002619","Total",624,146,86,60,478,19,59,62,59,23,88,168
"2011","Hounslow 010B","E01002622","Total",526,94,30,64,432,19,39,66,46,25,77,160
"2011","Hounslow 010C","E01002632","Total",569,110,54,56,459,29,55,75,42,29,86,143
"2011","Hounslow 010D","E01002635","Total",524,74,27,47,450,19,45,73,55,19,77,162
"2011","Hounslow 010E","E01002636","Total",609,91,47,44,518,25,67,64,66,29,95,172
"2011","Hounslow 011A","E01002618","Total",512,68,33,35,444,22,60,65,47,17,78,155
"2011","Hounslow 011B","E01002621","Total",594,130,26,104,464,33,42,84,64,25,69,147
"2011","Hounslow 011C","E01002623","Total",484,86,35,51,398,39,31,46,50,26,77,129
"2011","Hounslow 011D","E01002628","Total",620,105,41,64,515,20,67,97,69,14,81,167
"2011","Hounslow 011E","E01002629","Total",715,183,87,96,532,48,53,83,87,22,85,154
"2011","Hounslow 012A","E01002630","Total",569,120,44,76,449,24,41,107,66,15,69,127
"2011","Hounslow 012B","E01002639","Total",497,63,37,26,434,11,54,59,49,17,78,166
"2011","Hounslow 012C","E01002640","Total",548,87,29,58,461,14,53,84,67,10,77,156
"2011","Hounslow 012D","E01002674","Total",668,194,60,134,474,19,68,108,110,12,52,105
"2011","Hounslow 012E","E01002676","Total",559,94,48,46,465,13,86,65,63,9,77,152
"2011","Hounslow 013A","E01002583","Total",512,75,24,51,437,31,54,72,50,11,91,128
"2011","Hounslow 013B","E01002584","Total",493,82,31,51,411,29,39,51,43,22,85,142
"2011","Hounslow 013C","E01002585","Total",509,89,43,46,420,30,40,60,56,15,85,134
"2011","Hounslow 013D","E01002586","Total",457,56,33,23,401,8,42,40,32,16,87,176
"2011","Hounslow 013E","E01002589","Total",677,164,51,113,513,49,43,86,96,33,80,126
"2011","Hounslow 014A","E01002668","Total",883,315,83,232,568,41,39,131,236,19,24,78
"2011","Hounslow 014B","E01002669","Total",711,190,47,143,521,72,46,106,140,19,57,81
"2011","Hounslow 014C","E01002681","Total",741,179,38,141,562,60,34,105,132,21,73,137
"2011","Hounslow 014D","E01002682","Total",927,280,83,197,647,57,56,132,181,28,67,126
"2011","Hounslow 014E","E01002683","Total",1037,307,104,203,730,30,54,225,220,31,50,120
"2011","Hounslow 015A","E01002642","Total",735,176,75,101,559,34,37,154,108,15,48,163
"2011","Hounslow 015B","E01002643","Total",910,312,171,141,598,42,81,124,115,20,68,148
"2011","Hounslow 015C","E01002645","Total",766,243,98,145,523,39,43,93,115,8,75,150
"2011","Hounslow 015D","E01002658","Total",501,107,48,59,394,13,54,81,101,16,39,90
"2011","Hounslow 015E","E01002677","Total",652,221,56,165,431,30,29,86,144,18,38,86
"2011","Hounslow 016A","E01002587","Total",605,110,65,45,495,30,61,76,77,15,85,151
"2011","Hounslow 016B","E01002588","Total",677,212,68,144,465,83,41,83,90,37,54,77
"2011","Hounslow 016C","E01002660","Total",522,99,34,65,423,14,35,59,69,13,93,140
"2011","Hounslow 016D","E01002661","Total",518,64,24,40,454,10,62,48,43,12,91,188
"2011","Hounslow 016E","E01002665","Total",524,124,66,58,400,37,41,54,44,16,77,131
"2011","Hounslow 017A","E01002624","Total",480,88,26,62,392,15,37,62,70,18,73,117
"2011","Hounslow 017B","E01002646","Total",712,174,62,112,538,73,43,127,95,34,64,102
"2011","Hounslow 017C","E01002662","Total",627,125,33,92,502,21,54,57,74,9,82,205
"2011","Hounslow 017D","E01002663","Total",751,219,114,105,532,30,63,102,87,23,88,139
"2011","Hounslow 017E","E01002664","Total",596,155,46,109,441,39,24,110,92,14,61,101
"2011","Hounslow 018A","E01002641","Total",637,137,48,89,500,37,58,81,79,9,79,157
"2011","Hounslow 018C","E01002648","Total",900,182,48,134,718,65,52,160,151,22,90,178
"2011","Hounslow 018D","E01002649","Total",692,185,39,146,507,58,30,99,151,7,55,107
"2011","Hounslow 018E","E01002657","Total",650,119,51,68,531,31,66,106,104,25,65,134
"2011","Hounslow 018F","E01033083","Total",643,141,8,133,502,19,8,220,147,2,30,76
"2011","Hounslow 018G","E01033084","Total",648,166,23,143,482,57,18,117,141,17,40,92
"2011","Hounslow 019A","E01002653","Total",542,72,36,36,470,6,55,77,49,17,95,171
"2011","Hounslow 019B","E01002654","Total",646,159,49,110,487,24,52,98,108,14,64,127
"2011","Hounslow 019C","E01002655","Total",622,112,48,64,510,22,65,98,80,12,86,147
"2011","Hounslow 019D","E01002656","Total",479,118,69,49,361,20,52,62,65,15,44,103
"2011","Hounslow 019E","E01002659","Total",504,123,68,55,381,22,60,66,60,18,49,106
"2011","Hounslow 020A","E01002667","Total",651,195,52,143,456,51,36,79,158,17,31,84
"2011","Hounslow 020B","E01002670","Total",708,211,57,154,497,36,62,105,127,14,47,106
"2011","Hounslow 020C","E01002671","Total",636,152,62,90,484,23,58,111,123,14,47,108
"2011","Hounslow 020D","E01002672","Total",683,253,52,201,430,42,34,60,154,15,53,72
"2011","Hounslow 020E","E01002673","Total",621,177,35,142,444,103,32,71,83,33,50,72
"2011","Hounslow 021A","E01002647","Total",753,155,53,102,598,62,49,158,105,34,94,96
"2011","Hounslow 021B","E01002650","Total",792,159,35,124,633,73,36,157,108,42,92,125
"2011","Hounslow 021C","E01002651","Total",550,110,38,72,440,22,38,54,70,23,91,142
"2011","Hounslow 021D","E01002652","Total",516,81,19,62,435,19,28,56,61,21,81,169
"2011","Hounslow 021E","E01002666","Total",407,56,31,25,351,29,40,44,26,12,65,135
"2011","Hounslow 022A","E01002555","Total",681,150,65,85,531,41,52,113,107,18,63,137
"2011","Hounslow 022B","E01002556","Total",639,165,71,94,474,32,64,116,100,26,52,84
"2011","Hounslow 022C","E01002590","Total",726,206,81,125,520,50,61,103,121,11,63,111
"2011","Hounslow 022D","E01002592","Total",789,223,108,115,566,69,85,111,101,15,70,115
"2011","Hounslow 022E","E01002595","Total",712,192,83,109,520,47,55,91,107,28,65,127
"2011","Hounslow 023A","E01002557","Total",743,258,124,134,485,38,73,86,118,15,54,101
"2011","Hounslow 023B","E01002558","Total",773,231,70,161,542,55,59,115,140,21,60,92
"2011","Hounslow 023C","E01002559","Total",857,218,50,168,639,57,59,146,173,24,79,101
"2011","Hounslow 023D","E01002560","Total",615,149,93,56,466,29,80,64,93,13,63,124
"2011","Hounslow 023E","E01002561","Total",551,159,20,139,392,78,13,88,106,30,24,53
"2011","Hounslow 024A","E01002591","Total",626,143,79,64,483,33,74,83,85,17,63,128
"2011","Hounslow 024B","E01002593","Total",725,192,76,116,533,14,79,96,107,21,68,148
"2011","Hounslow 024C","E01002594","Total",642,107,57,50,535,41,74,114,84,10,84,128
"2011","Hounslow 024D","E01002611","Total",636,134,51,83,502,30,72,99,86,21,66,128
"2011","Hounslow 024E","E01002612","Total",699,225,103,122,474,69,45,80,122,18,37,103
"2011","Hounslow 024F","E01002613","Total",609,121,55,66,488,27,60,102,94,16,74,115
"2011","Hounslow 025B","E01002598","Total",649,148,63,85,501,59,27,100,97,23,86,109
"2011","Hounslow 025C","E01002599","Total",569,119,46,73,450,48,39,116,87,20,54,86
"2011","Hounslow 025D","E01002600","Total",520,97,59,38,423,30,32,62,91,27,72,109
"2011","Hounslow 025E","E01002603","Total",666,122,19,103,544,71,21,134,120,26,77,95
"2011","Hounslow 025F","E01033000","Total",663,179,56,123,484,89,29,106,88,38,52,82
"2011","Hounslow 025G","E01033030","Total",773,234,6,228,539,50,4,199,225,12,19,30
"2011","Hounslow 026A","E01002604","Total",588,123,27,96,465,86,38,101,62,33,70,75
"2011","Hounslow 026B","E01002605","Total",753,261,94,167,492,58,60,96,112,23,63,80
"2011","Hounslow 026C","E01002606","Total",671,247,69,178,424,60,39,77,78,25,43,102
"2011","Hounslow 026D","E01002607","Total",676,134,68,66,542,49,51,105,118,38,68,113
"2011","Hounslow 026E","E01002615","Total",606,211,80,131,395,54,41,80,83,12,50,75
"2011","Hounslow 027A","E01002596","Total",772,241,18,223,531,76,20,157,168,18,41,51
"2011","Hounslow 027B","E01002601","Total",637,138,31,107,499,50,35,129,152,27,42,64
"2011","Hounslow 027C","E01002602","Total",564,136,62,74,428,19,48,109,95,19,46,92
"2011","Hounslow 027D","E01002614","Total",758,225,64,161,533,55,59,127,160,15,24,93
"2011","Hounslow 027E","E01002616","Total",535,134,74,60,401,26,67,75,83,20,33,97
"2011","Hounslow 028A","E01002608","Total",676,198,60,138,478,66,61,96,92,26,47,90
"2011","Hounslow 028B","E01002609","Total",655,173,77,96,482,29,69,99,93,18,47,127
"2011","Hounslow 028C","E01002610","Total",632,180,79,101,452,58,71,89,91,26,33,84
"2011","Hounslow 028D","E01002617","Total",642,173,64,109,469,31,70,96,121,13,41,97
"2011","Hounslow 029A","E01002687","Total",832,308,73,235,524,16,47,104,250,9,21,77
"2011","Hounslow 029B","E01002691","Total",591,167,62,105,424,21,60,68,92,13,39,131
"2011","Hounslow 029C","E01002692","Total",911,390,64,326,521,39,34,96,250,10,21,71
"2011","Hounslow 029D","E01002693","Total",841,387,191,196,454,22,59,87,179,10,23,74
"2011","Hounslow 029E","E01032573","Total",860,384,106,278,476,15,50,66,251,14,14,66
"2011","Kingston upon Thames 001A","E01003006","Total",611,178,79,99,433,29,71,91,103,24,39,76
"2011","Kingston upon Thames 001B","E01003007","Total",549,103,58,45,446,20,75,143,70,19,35,84
"2011","Kingston upon Thames 001C","E01003008","Total",514,91,53,38,423,17,64,156,80,21,28,57
"2011","Kingston upon Thames 001D","E01003009","Total",773,221,83,138,552,33,77,158,136,29,35,84
"2011","Kingston upon Thames 001E","E01003010","Total",554,120,44,76,434,13,62,115,85,20,35,104
"2011","Kingston upon Thames 002A","E01002952","Total",486,79,53,26,407,16,79,73,70,20,48,101
"2011","Kingston upon Thames 002B","E01002953","Total",453,90,46,44,363,10,47,61,73,19,48,105
"2011","Kingston upon Thames 002C","E01002955","Total",513,125,61,64,388,9,44,67,98,12,46,112
"2011","Kingston upon Thames 002D","E01002956","Total",437,90,48,42,347,10,83,71,53,16,42,72
"2011","Kingston upon Thames 002E","E01002959","Total",479,77,53,24,402,7,97,85,42,28,41,102
"2011","Kingston upon Thames 003A","E01002935","Total",775,243,56,187,532,23,24,101,218,12,28,126
"2011","Kingston upon Thames 003B","E01002938","Total",782,196,79,117,586,29,63,201,174,29,29,61
"2011","Kingston upon Thames 003C","E01002951","Total",624,168,63,105,456,19,72,99,138,18,24,86
"2011","Kingston upon Thames 003D","E01002954","Total",565,227,94,133,338,32,38,79,122,10,8,49
"2011","Kingston upon Thames 003E","E01002957","Total",608,136,35,101,472,55,38,63,84,37,48,147
"2011","Kingston upon Thames 004A","E01002933","Total",807,273,126,147,534,51,44,155,128,24,42,90
"2011","Kingston upon Thames 004B","E01002934","Total",649,112,31,81,537,10,41,198,131,26,35,96
"2011","Kingston upon Thames 004D","E01002937","Total",645,142,40,102,503,13,37,213,116,20,22,82
"2011","Kingston upon Thames 004E","E01003011","Total",730,203,87,116,527,29,75,128,146,21,28,100
"2011","Kingston upon Thames 004F","E01033568","Total",718,255,20,235,463,61,19,93,229,11,10,40
"2011","Kingston upon Thames 004G","E01033569","Total",696,219,25,194,477,35,28,112,195,15,21,71
"2011","Kingston upon Thames 005A","E01002964","Total",982,431,168,263,551,38,33,115,196,11,25,133
"2011","Kingston upon Thames 005B","E01002969","Total",756,271,70,201,485,76,47,90,123,20,39,90
"2011","Kingston upon Thames 005C","E01002971","Total",705,194,58,136,511,21,39,125,180,13,27,106
"2011","Kingston upon Thames 005D","E01002972","Total",828,275,85,190,553,34,40,97,232,4,19,127
"2011","Kingston upon Thames 005E","E01002974","Total",726,187,57,130,539,33,46,114,140,18,49,139
"2011","Kingston upon Thames 006A","E01002932","Total",678,201,35,166,477,66,24,129,111,17,47,83
"2011","Kingston upon Thames 006B","E01002960","Total",574,116,59,57,458,12,68,100,91,28,47,112
"2011","Kingston upon Thames 006C","E01002962","Total",511,88,41,47,423,24,57,87,70,20,54,111
"2011","Kingston upon Thames 006D","E01002970","Total",570,129,57,72,441,30,38,81,97,16,50,129
"2011","Kingston upon Thames 006E","E01002973","Total",465,95,33,62,370,29,28,68,75,18,51,101
"2011","Kingston upon Thames 007A","E01002929","Total",635,155,62,93,480,11,82,114,118,22,38,95
"2011","Kingston upon Thames 007B","E01002930","Total",683,183,67,116,500,41,62,115,122,13,33,114
"2011","Kingston upon Thames 007C","E01002931","Total",654,121,59,62,533,16,55,148,122,31,48,113
"2011","Kingston upon Thames 007D","E01002963","Total",768,284,121,163,484,31,49,100,149,24,43,88
"2011","Kingston upon Thames 007E","E01002985","Total",603,151,67,84,452,27,48,111,92,20,63,91
"2011","Kingston upon Thames 008A","E01002927","Total",614,187,95,92,427,17,65,81,84,20,46,114
"2011","Kingston upon Thames 008B","E01002928","Total",660,246,115,131,414,29,54,81,101,17,39,93
"2011","Kingston upon Thames 008C","E01002958","Total",659,165,50,115,494,23,54,143,131,25,28,90
"2011","Kingston upon Thames 008D","E01002961","Total",609,97,53,44,512,10,89,129,89,21,59,115
"2011","Kingston upon Thames 008E","E01002986","Total",471,117,62,55,354,8,62,66,66,15,46,91
"2011","Kingston upon Thames 009A","E01002965","Total",1071,385,114,271,686,42,64,94,253,6,28,199
"2011","Kingston upon Thames 009B","E01002967","Total",958,375,114,261,583,27,62,99,311,8,13,63
"2011","Kingston upon Thames 009C","E01002968","Total",1123,452,56,396,671,19,56,125,263,12,28,168
"2011","Kingston upon Thames 009D","E01002990","Total",937,443,96,347,494,16,42,77,284,6,11,58
"2011","Kingston upon Thames 009E","E01002991","Total",710,240,62,178,470,9,40,94,190,16,20,101
"2011","Kingston upon Thames 010A","E01002922","Total",725,253,96,157,472,12,92,97,139,18,42,72
"2011","Kingston upon Thames 010B","E01002926","Total",590,150,80,70,440,20,63,124,82,23,34,94
"2011","Kingston upon Thames 010C","E01002966","Total",744,204,50,154,540,27,34,135,158,25,33,128
"2011","Kingston upon Thames 010D","E01002992","Total",438,124,34,90,314,16,30,58,101,7,18,84
"2011","Kingston upon Thames 011A","E01002921","Total",857,405,95,310,452,20,23,82,263,1,10,53
"2011","Kingston upon Thames 011B","E01002987","Total",844,425,145,280,419,21,26,59,213,6,8,86
"2011","Kingston upon Thames 011C","E01002988","Total",572,195,39,156,377,33,26,72,169,10,10,57
"2011","Kingston upon Thames 011D","E01002989","Total",909,313,38,275,596,20,39,127,340,10,12,48
"2011","Kingston upon Thames 012A","E01002975","Total",483,79,45,34,404,20,83,81,63,17,51,89
"2011","Kingston upon Thames 012B","E01002977","Total",654,180,70,110,474,62,78,92,87,16,44,95
"2011","Kingston upon Thames 012C","E01002980","Total",482,69,47,22,413,13,93,67,68,15,53,104
"2011","Kingston upon Thames 012D","E01002981","Total",518,100,56,44,418,7,71,73,57,22,73,115
"2011","Kingston upon Thames 012E","E01002984","Total",604,229,125,104,375,21,70,77,78,20,31,78
"2011","Kingston upon Thames 013A","E01002923","Total",777,384,180,204,393,56,54,48,109,10,28,88
"2011","Kingston upon Thames 013B","E01002925","Total",796,344,78,266,452,31,13,114,214,6,15,59
"2011","Kingston upon Thames 013C","E01002993","Total",867,400,128,272,467,24,35,69,287,6,7,39
"2011","Kingston upon Thames 013D","E01002995","Total",602,173,68,105,429,8,86,94,144,12,27,58
"2011","Kingston upon Thames 013E","E01002999","Total",743,316,64,252,427,30,28,69,219,10,12,59
"2011","Kingston upon Thames 014A","E01002915","Total",479,99,59,40,380,5,65,56,89,11,46,108
"2011","Kingston upon Thames 014B","E01002916","Total",520,97,67,30,423,7,79,85,71,25,40,116
"2011","Kingston upon Thames 014C","E01002917","Total",497,87,60,27,410,7,87,89,59,16,37,115
"2011","Kingston upon Thames 014D","E01002920","Total",593,130,85,45,463,8,83,130,84,21,45,92
"2011","Kingston upon Thames 014E","E01002924","Total",560,110,66,44,450,8,107,110,68,27,33,97
"2011","Kingston upon Thames 015A","E01002976","Total",641,135,66,69,506,33,77,134,119,17,45,81
"2011","Kingston upon Thames 015B","E01002978","Total",684,156,81,75,528,17,90,94,130,13,49,135
"2011","Kingston upon Thames 015C","E01002979","Total",614,170,54,116,444,20,58,84,118,21,39,104
"2011","Kingston upon Thames 015D","E01002982","Total",517,128,66,62,389,15,89,62,63,14,48,98
"2011","Kingston upon Thames 015E","E01002983","Total",595,119,67,52,476,8,98,95,82,10,55,128
"2011","Kingston upon Thames 016A","E01002994","Total",602,166,61,105,436,12,64,106,149,11,16,78
"2011","Kingston upon Thames 016B","E01002996","Total",589,156,57,99,433,19,50,131,118,16,33,66
"2011","Kingston upon Thames 016C","E01002997","Total",588,177,50,127,411,9,52,108,107,18,26,91
"2011","Kingston upon Thames 016D","E01002998","Total",612,158,70,88,454,56,39,110,132,18,33,66
"2011","Kingston upon Thames 016E","E01003002","Total",783,250,102,148,533,43,67,138,144,11,40,90
"2011","Kingston upon Thames 017A","E01002918","Total",615,112,48,64,503,46,53,141,91,14,56,102
"2011","Kingston upon Thames 017B","E01002919","Total",669,186,74,112,483,53,61,92,102,22,46,107
"2011","Kingston upon Thames 017C","E01003000","Total",587,142,58,84,445,32,65,78,93,21,45,111
"2011","Kingston upon Thames 017D","E01003001","Total",627,112,63,49,515,29,60,108,91,21,68,138
"2011","Kingston upon Thames 017E","E01003003","Total",574,147,56,91,427,28,45,82,109,17,49,97
"2011","Kingston upon Thames 018A","E01002939","Total",605,158,63,95,447,24,53,104,118,19,44,85
"2011","Kingston upon Thames 018B","E01002941","Total",628,196,111,85,432,17,102,77,82,11,40,103
"2011","Kingston upon Thames 018C","E01002942","Total",522,111,56,55,411,12,87,77,90,21,35,89
"2011","Kingston upon Thames 018D","E01003004","Total",591,122,53,69,469,27,75,104,99,21,57,86
"2011","Kingston upon Thames 018E","E01003005","Total",570,122,49,73,448,23,68,109,105,21,40,82
"2011","Kingston upon Thames 019A","E01002944","Total",508,115,43,72,393,28,48,93,88,18,37,81
"2011","Kingston upon Thames 019B","E01002945","Total",655,179,69,110,476,39,60,112,137,12,30,86
"2011","Kingston upon Thames 019C","E01002946","Total",603,126,54,72,477,29,71,90,148,12,37,90
"2011","Kingston upon Thames 019D","E01002947","Total",597,117,51,66,480,21,81,90,102,23,45,118
"2011","Kingston upon Thames 020A","E01002940","Total",604,141,85,56,463,51,67,113,85,13,43,91
"2011","Kingston upon Thames 020B","E01002943","Total",507,114,55,59,393,24,61,65,78,25,43,97
"2011","Kingston upon Thames 020C","E01002948","Total",784,184,63,121,600,48,75,152,139,26,42,118
"2011","Kingston upon Thames 020D","E01002949","Total",677,153,67,86,524,31,80,106,111,26,64,106
"2011","Kingston upon Thames 020E","E01002950","Total",719,244,105,139,475,66,56,106,141,11,37,58
"2011","Merton 001A","E01003472","Total",481,87,41,46,394,5,46,136,88,21,25,73
"2011","Merton 001B","E01003473","Total",505,106,31,75,399,10,30,108,114,12,20,105
"2011","Merton 001C","E01003474","Total",480,86,35,51,394,4,58,84,82,30,53,83
"2011","Merton 001D","E01003475","Total",1162,379,52,327,783,92,48,153,334,12,32,112
"2011","Merton 001E","E01003478","Total",602,128,48,80,474,10,44,146,128,32,25,89
"2011","Merton 002A","E01003460","Total",679,261,119,142,418,16,74,82,137,19,24,66
"2011","Merton 002B","E01003462","Total",599,176,99,77,423,8,92,92,91,26,30,84
"2011","Merton 002C","E01003464","Total",550,156,80,76,394,4,109,91,85,27,23,55
"2011","Merton 002D","E01003465","Total",472,85,43,42,387,11,93,82,72,22,29,78
"2011","Merton 003A","E01003400","Total",659,215,41,174,444,14,32,76,206,13,18,85
"2011","Merton 003B","E01003454","Total",587,199,70,129,388,16,36,86,150,5,23,72
"2011","Merton 003C","E01003456","Total",667,242,58,184,425,15,21,76,192,15,15,91
"2011","Merton 003D","E01003476","Total",482,89,20,69,393,27,24,81,105,22,48,86
"2011","Merton 003E","E01003477","Total",573,121,35,86,452,15,39,108,149,25,27,89
"2011","Merton 004A","E01003401","Total",647,280,123,157,367,6,29,100,140,10,13,69
"2011","Merton 004B","E01003402","Total",705,267,87,180,438,10,61,112,137,11,24,83
"2011","Merton 004C","E01003403","Total",710,262,96,166,448,11,61,84,193,16,19,64
"2011","Merton 004D","E01003404","Total",912,438,185,253,474,14,36,86,269,4,14,51
"2011","Merton 004E","E01003461","Total",712,240,68,172,472,7,64,72,220,23,19,67
"2011","Merton 005A","E01003367","Total",961,277,44,233,684,23,46,114,310,16,36,139
"2011","Merton 005B","E01003369","Total",768,259,40,219,509,32,29,78,233,4,25,108
"2011","Merton 005C","E01003370","Total",869,278,36,242,591,32,30,113,241,9,32,134
"2011","Merton 005D","E01003371","Total",626,182,48,134,444,9,42,77,150,7,26,133
"2011","Merton 005E","E01003455","Total",749,252,31,221,497,32,22,91,253,11,20,68
"2011","Merton 006A","E01003359","Total",816,314,112,202,502,25,46,94,207,12,23,95
"2011","Merton 006B","E01003360","Total",740,237,46,191,503,16,30,126,208,10,16,97
"2011","Merton 006C","E01003457","Total",623,141,47,94,482,8,30,173,158,16,22,75
"2011","Merton 006D","E01003458","Total",693,199,35,164,494,15,40,133,203,12,12,79
"2011","Merton 006E","E01003459","Total",956,325,70,255,631,65,40,115,269,17,30,95
"2011","Merton 007A","E01003394","Total",636,127,59,68,509,15,64,81,86,17,80,166
"2011","Merton 007B","E01003395","Total",503,99,62,37,404,19,61,62,69,13,58,122
"2011","Merton 007C","E01003396","Total",534,111,46,65,423,17,53,66,68,18,53,148
"2011","Merton 007D","E01003397","Total",557,143,55,88,414,15,42,79,81,16,57,124
"2011","Merton 007E","E01003398","Total",583,135,56,79,448,28,46,73,70,25,69,137
"2011","Merton 008A","E01003368","Total",578,148,37,111,430,22,54,71,91,14,53,125
"2011","Merton 008B","E01003372","Total",627,210,41,169,417,52,28,80,112,19,45,81
"2011","Merton 008C","E01003393","Total",646,202,37,165,444,25,22,99,153,11,34,100
"2011","Merton 008D","E01003406","Total",566,118,15,103,448,56,15,99,95,16,69,98
"2011","Merton 008E","E01003407","Total",768,268,19,249,500,29,19,110,191,15,41,95
"2011","Merton 009A","E01003355","Total",765,269,46,223,496,18,22,105,278,7,11,55
"2011","Merton 009B","E01003356","Total",696,201,64,137,495,13,35,131,152,22,33,109
"2011","Merton 009C","E01003358","Total",801,245,63,182,556,13,38,95,271,14,15,110
"2011","Merton 009D","E01003383","Total",692,220,39,181,472,9,21,111,222,11,15,83
"2011","Merton 009E","E01003384","Total",623,163,42,121,460,12,36,101,177,13,28,93
"2011","Merton 010A","E01003442","Total",701,245,93,152,456,20,59,105,162,20,29,61
"2011","Merton 010B","E01003443","Total",633,174,66,108,459,14,61,145,120,26,29,64
"2011","Merton 010C","E01003444","Total",695,246,86,160,449,12,64,124,148,27,20,54
"2011","Merton 010D","E01003445","Total",658,163,84,79,495,12,64,125,127,24,37,106
"2011","Merton 010E","E01003463","Total",459,90,51,39,369,9,75,83,59,29,29,85
"2011","Merton 011A","E01003380","Total",680,174,62,112,506,17,57,122,177,13,24,96
"2011","Merton 011B","E01003382","Total",676,196,63,133,480,9,53,109,203,17,20,69
"2011","Merton 011C","E01003385","Total",626,158,44,114,468,6,44,143,154,22,21,78
"2011","Merton 011D","E01003399","Total",618,202,64,138,416,16,48,61,181,10,17,83
"2011","Merton 011E","E01003423","Total",605,147,42,105,458,13,42,108,157,25,23,90
"2011","Merton 012A","E01003357","Total",750,258,71,187,492,61,33,94,145,12,35,112
"2011","Merton 012B","E01003376","Total",588,158,52,106,430,36,53,64,100,15,57,105
"2011","Merton 012C","E01003377","Total",526,119,21,98,407,52,23,66,74,30,71,91
"2011","Merton 012D","E01003408","Total",873,310,56,254,563,37,29,112,248,9,29,99
"2011","Merton 012E","E01003410","Total",630,182,28,154,448,44,36,89,128,17,44,90
"2011","Merton 013A","E01003386","Total",722,138,46,92,584,64,36,136,97,29,107,115
"2011","Merton 013B","E01003388","Total",590,190,110,80,400,37,59,70,73,14,43,104
"2011","Merton 013C","E01003389","Total",631,168,47,121,463,52,36,89,83,12,76,115
"2011","Merton 013D","E01003392","Total",501,150,25,125,351,19,39,60,79,19,47,88
"2011","Merton 013E","E01003409","Total",562,126,51,75,436,35,47,87,62,19,75,111
"2011","Merton 014A","E01003387","Total",614,174,71,103,440,59,44,82,91,12,65,87
"2011","Merton 014B","E01003391","Total",544,185,34,151,359,70,30,84,57,21,31,66
"2011","Merton 014C","E01003411","Total",719,231,70,161,488,60,44,121,120,14,49,80
"2011","Merton 014D","E01003412","Total",597,160,49,111,437,38,26,80,91,31,64,107
"2011","Merton 014E","E01003435","Total",490,123,55,68,367,15,60,62,72,21,44,93
"2011","Merton 015A","E01003361","Total",621,160,52,108,461,14,61,101,104,20,54,107
"2011","Merton 015B","E01003424","Total",574,108,78,30,466,13,99,106,92,17,42,97
"2011","Merton 015C","E01003425","Total",508,80,44,36,428,9,86,101,79,20,33,100
"2011","Merton 015D","E01003426","Total",609,106,58,48,503,18,101,81,86,30,56,131
"2011","Merton 015E","E01003428","Total",649,240,109,131,409,12,51,83,141,20,28,74
"2011","Merton 016A","E01003366","Total",595,172,66,106,423,13,50,81,109,5,42,123
"2011","Merton 016B","E01003381","Total",720,275,98,177,445,6,41,94,212,3,12,77
"2011","Merton 016C","E01003446","Total",799,313,61,252,486,22,46,83,198,10,24,103
"2011","Merton 016D","E01003447","Total",691,246,63,183,445,51,47,96,158,14,19,60
"2011","Merton 016E","E01003471","Total",604,170,84,86,434,15,61,104,114,17,27,96
"2011","Merton 017A","E01003413","Total",709,186,52,134,523,55,43,99,124,24,69,109
"2011","Merton 017B","E01003414","Total",539,126,65,61,413,24,55,58,72,17,73,114
"2011","Merton 017C","E01003415","Total",548,117,58,59,431,24,54,60,69,29,85,110
"2011","Merton 017D","E01003416","Total",534,124,62,62,410,24,68,49,67,16,75,111
"2011","Merton 017E","E01003434","Total",506,111,57,54,395,25,47,60,66,22,75,100
"2011","Merton 018A","E01003373","Total",536,137,28,109,399,72,34,67,72,31,54,69
"2011","Merton 018B","E01003378","Total",728,174,47,127,554,63,43,110,120,32,68,118
"2011","Merton 018C","E01003379","Total",742,270,151,119,472,63,52,109,82,20,67,79
"2011","Merton 018D","E01003390","Total",623,200,36,164,423,72,21,102,78,16,57,77
"2011","Merton 018E","E01003405","Total",630,190,75,115,440,38,57,79,68,17,69,112
"2011","Merton 019A","E01003429","Total",507,110,43,67,397,29,55,69,74,17,69,84
"2011","Merton 019B","E01003430","Total",545,172,34,138,373,79,31,63,54,16,68,62
"2011","Merton 019C","E01003431","Total",545,141,33,108,404,67,32,61,74,28,61,81
"2011","Merton 019D","E01003432","Total",508,106,35,71,402,79,33,60,48,27,73,82
"2011","Merton 019E","E01003433","Total",578,168,70,98,410,42,51,66,73,13,72,93
"2011","Merton 020A","E01003466","Total",599,117,65,52,482,13,86,104,108,19,42,110
"2011","Merton 020B","E01003467","Total",601,118,62,56,483,8,78,131,105,18,33,110
"2011","Merton 020C","E01003468","Total",630,125,61,64,505,13,76,134,121,20,39,102
"2011","Merton 020D","E01003469","Total",574,106,38,68,468,29,38,118,111,12,63,97
"2011","Merton 020E","E01003470","Total",607,132,57,75,475,19,60,105,88,18,70,115
"2011","Merton 021A","E01003362","Total",499,116,69,47,383,9,74,62,77,12,38,111
"2011","Merton 021B","E01003363","Total",590,116,73,43,474,13,82,97,92,21,59,110
"2011","Merton 021C","E01003364","Total",648,153,93,60,495,12,94,104,97,22,40,126
"2011","Merton 021D","E01003365","Total",497,94,62,32,403,9,89,56,66,12,55,116
"2011","Merton 021E","E01003421","Total",640,186,67,119,454,19,68,94,114,17,41,101
"2011","Merton 022A","E01003374","Total",546,186,78,108,360,58,36,79,88,11,32,56
"2011","Merton 022B","E01003375","Total",654,230,108,122,424,24,69,80,90,20,43,98
"2011","Merton 022C","E01003437","Total",764,238,111,127,526,19,114,89,116,18,64,106
"2011","Merton 022D","E01003440","Total",627,188,62,126,439,42,52,96,112,12,47,78
"2011","Merton 022E","E01003441","Total",617,130,44,86,487,41,63,86,96,25,75,101
"2011","Merton 023A","E01003427","Total",706,213,91,122,493,20,41,97,158,17,56,104
"2011","Merton 023B","E01003436","Total",588,156,69,87,432,33,61,92,92,21,52,81
"2011","Merton 023C","E01003439","Total",548,137,49,88,411,35,35,78,117,15,46,85
"2011","Merton 023D","E01003448","Total",648,178,53,125,470,49,59,93,94,20,63,92
"2011","Merton 023E","E01003453","Total",650,199,83,116,451,35,45,107,98,20,57,89
"2011","Merton 024A","E01003438","Total",650,189,90,99,461,45,51,104,87,16,59,99
"2011","Merton 024B","E01003449","Total",677,206,89,117,471,32,69,95,97,25,60,93
"2011","Merton 024C","E01003450","Total",597,149,68,81,448,45,56,102,80,19,68,78
"2011","Merton 024D","E01003451","Total",598,137,80,57,461,8,90,66,74,17,64,142
"2011","Merton 024E","E01003452","Total",806,266,128,138,540,49,74,117,117,17,55,111
"2011","Merton 025A","E01003417","Total",608,136,73,63,472,26,92,83,111,18,37,105
"2011","Merton 025B","E01003418","Total",531,101,73,28,430,15,73,79,86,14,49,114
"2011","Merton 025C","E01003419","Total",642,144,62,82,498,34,69,107,117,18,52,101
"2011","Merton 025D","E01003420","Total",506,104,47,57,402,21,64,96,77,17,41,86
"2011","Merton 025E","E01003422","Total",513,135,69,66,378,13,69,72,82,12,44,86
"2011","Redbridge 001A","E01003744","Total",592,188,96,92,404,9,106,72,103,6,32,76
"2011","Redbridge 001B","E01003745","Total",483,60,36,24,423,9,81,71,81,23,63,95
"2011","Redbridge 001C","E01003746","Total",661,231,127,104,430,8,128,80,97,15,32,70
"2011","Redbridge 001D","E01003747","Total",490,96,69,27,394,8,90,87,66,25,32,86
"2011","Redbridge 001E","E01003748","Total",572,155,76,79,417,8,89,82,89,15,47,87
"2011","Redbridge 001F","E01003749","Total",681,205,105,100,476,19,75,93,140,13,40,96
"2011","Redbridge 001G","E01003750","Total",798,349,169,180,449,18,80,87,131,15,32,86
"2011","Redbridge 002A","E01003720","Total",821,327,149,178,494,60,98,106,95,10,37,88
"2011","Redbridge 002B","E01003722","Total",690,189,77,112,501,55,84,88,92,25,52,105
"2011","Redbridge 002C","E01003723","Total",704,215,87,128,489,49,80,111,98,22,50,79
"2011","Redbridge 002D","E01003726","Total",649,235,88,147,414,77,46,77,88,24,41,61
"2011","Redbridge 003A","E01003721","Total",604,156,72,84,448,39,69,88,77,24,56,95
"2011","Redbridge 003B","E01003724","Total",511,117,53,64,394,41,48,78,78,19,43,87
"2011","Redbridge 003C","E01003725","Total",650,195,54,141,455,84,55,113,111,13,23,56
"2011","Redbridge 003D","E01003727","Total",655,214,74,140,441,48,64,108,83,15,48,75
"2011","Redbridge 004A","E01003654","Total",603,155,67,88,448,39,59,95,98,18,46,93
"2011","Redbridge 004B","E01003655","Total",642,188,70,118,454,28,64,107,130,8,35,82
"2011","Redbridge 004C","E01003658","Total",699,252,92,160,447,61,40,81,113,25,38,89
"2011","Redbridge 004D","E01003660","Total",663,153,59,94,510,22,53,126,126,14,41,128
"2011","Redbridge 005A","E01003656","Total",643,230,104,126,413,46,71,73,82,15,35,91
"2011","Redbridge 005B","E01003657","Total",870,252,85,167,618,55,105,127,140,19,49,123
"2011","Redbridge 005C","E01003659","Total",638,152,45,107,486,36,66,128,98,16,45,97
"2011","Redbridge 006A","E01003698","Total",519,100,39,61,419,26,69,88,91,10,46,89
"2011","Redbridge 006B","E01003699","Total",594,189,78,111,405,37,60,75,100,16,37,80
"2011","Redbridge 006C","E01003700","Total",849,240,101,139,609,46,97,107,124,25,79,131
"2011","Redbridge 006D","E01003701","Total",626,132,67,65,494,34,75,107,77,16,75,110
"2011","Redbridge 006E","E01003702","Total",744,292,93,199,452,51,56,100,119,8,36,82
"2011","Redbridge 006F","E01003703","Total",968,263,71,192,705,45,87,151,171,47,68,136
"2011","Redbridge 006G","E01003704","Total",666,184,98,86,482,69,60,111,86,9,52,95
"2011","Redbridge 007A","E01003668","Total",755,287,114,173,468,15,60,87,180,18,23,85
"2011","Redbridge 007B","E01003669","Total",606,151,48,103,455,12,47,112,145,18,43,78
"2011","Redbridge 007C","E01003670","Total",577,141,55,86,436,14,69,92,101,29,37,94
"2011","Redbridge 007D","E01003671","Total",552,101,56,45,451,10,67,123,87,14,43,107
"2011","Redbridge 007E","E01003672","Total",690,297,135,162,393,48,35,81,140,14,20,55
"2011","Redbridge 007F","E01003673","Total",789,232,46,186,557,24,49,144,227,10,30,73
"2011","Redbridge 007G","E01003674","Total",1000,382,88,294,618,28,45,138,279,14,30,84
"2011","Redbridge 008A","E01003707","Total",469,96,45,51,373,14,66,60,57,21,46,109
"2011","Redbridge 008B","E01003708","Total",613,201,90,111,412,66,54,70,90,20,41,71
"2011","Redbridge 008C","E01003709","Total",570,102,64,38,468,27,112,71,65,17,71,105
"2011","Redbridge 008D","E01003710","Total",507,114,78,36,393,10,66,53,57,13,71,123
"2011","Redbridge 009A","E01003759","Total",554,117,60,57,437,10,75,105,103,11,40,93
"2011","Redbridge 009B","E01003760","Total",661,149,48,101,512,39,53,120,111,23,54,112
"2011","Redbridge 009C","E01003761","Total",698,237,56,181,461,95,12,119,96,50,43,46
"2011","Redbridge 009D","E01003762","Total",656,182,54,128,474,37,41,120,139,9,47,81
"2011","Redbridge 009E","E01003763","Total",657,134,77,57,523,30,76,98,106,39,67,107
"2011","Redbridge 009F","E01003764","Total",835,267,75,192,568,32,44,127,206,16,50,93
"2011","Redbridge 009G","E01003765","Total",642,175,49,126,467,21,43,127,143,14,35,84
"2011","Redbridge 010A","E01003705","Total",802,183,82,101,619,61,76,135,125,25,65,132
"2011","Redbridge 010B","E01003706","Total",613,162,93,69,451,52,84,104,73,22,42,74
"2011","Redbridge 010C","E01003711","Total",662,166,92,74,496,22,104,90,93,24,63,100
"2011","Redbridge 010D","E01003712","Total",536,189,86,103,347,37,39,69,61,23,42,76
"2011","Redbridge 012A","E01003646","Total",572,172,85,87,400,12,43,61,55,30,80,119
"2011","Redbridge 012B","E01003648","Total",528,118,73,45,410,2,106,56,71,17,44,114
"2011","Redbridge 012C","E01003649","Total",521,72,34,38,449,20,80,85,49,12,83,120
"2011","Redbridge 012D","E01003651","Total",466,96,76,20,370,6,49,59,40,17,78,121
"2011","Redbridge 013A","E01003639","Total",665,195,95,100,470,40,64,89,90,26,68,93
"2011","Redbridge 013B","E01003640","Total",648,159,69,90,489,30,62,112,84,26,77,98
"2011","Redbridge 013C","E01003641","Total",530,91,44,47,439,27,47,84,71,25,72,113
"2011","Redbridge 013D","E01003642","Total",542,106,42,64,436,43,56,69,50,34,78,106
"2011","Redbridge 014A","E01003774","Total",867,369,96,273,498,17,69,127,193,8,25,59
"2011","Redbridge 014B","E01003775","Total",686,178,93,85,508,16,98,108,112,20,50,104
"2011","Redbridge 014C","E01003776","Total",932,517,248,269,415,51,65,71,143,7,21,57
"2011","Redbridge 014D","E01003777","Total",856,343,93,250,513,14,60,91,234,9,28,77
"2011","Redbridge 014E","E01003778","Total",879,342,134,208,537,24,56,105,216,12,33,91
"2011","Redbridge 014F","E01003779","Total",708,316,167,149,392,14,41,106,120,11,32,68
"2011","Redbridge 014G","E01003780","Total",507,87,61,26,420,6,81,70,62,23,62,116
"2011","Redbridge 015A","E01003647","Total",612,131,57,74,481,21,57,71,97,24,78,133
"2011","Redbridge 015B","E01003650","Total",580,165,104,61,415,35,74,67,73,18,61,87
"2011","Redbridge 015C","E01003652","Total",482,73,36,37,409,19,57,72,45,22,86,108
"2011","Redbridge 015D","E01003653","Total",516,125,41,84,391,35,45,81,63,12,66,89
"2011","Redbridge 017A","E01003638","Total",590,176,107,69,414,20,66,63,70,21,65,109
"2011","Redbridge 017B","E01003643","Total",622,147,97,50,475,25,70,98,72,26,87,97
"2011","Redbridge 017C","E01003644","Total",498,74,45,29,424,16,62,84,58,23,61,120
"2011","Redbridge 017D","E01003645","Total",910,193,35,158,717,72,37,199,173,31,82,123
"2011","Redbridge 018A","E01003789","Total",625,228,80,148,397,8,58,74,118,17,26,96
"2011","Redbridge 018B","E01003794","Total",544,117,49,68,427,27,64,115,81,15,38,87
"2011","Redbridge 018C","E01003795","Total",433,80,45,35,353,15,68,85,71,12,31,71
"2011","Redbridge 018D","E01003796","Total",638,179,73,106,459,15,68,106,129,18,33,90
"2011","Redbridge 019A","E01003661","Total",651,137,53,84,514,43,64,100,73,19,70,145
"2011","Redbridge 019B","E01003662","Total",741,240,50,190,501,65,58,109,101,26,51,91
"2011","Redbridge 019C","E01003663","Total",662,208,142,66,454,20,94,83,62,40,56,99
"2011","Redbridge 019D","E01003664","Total",575,115,49,66,460,23,53,95,70,37,72,110
"2011","Redbridge 019E","E01003665","Total",529,88,45,43,441,32,56,91,63,29,67,103
"2011","Redbridge 019F","E01003666","Total",935,325,44,281,610,139,30,164,121,36,49,71
"2011","Redbridge 019H","E01033590","Total",434,110,6,104,324,69,13,87,78,5,31,41
"2011","Redbridge 019I","E01033592","Total",633,104,29,75,529,51,41,115,105,21,79,117
"2011","Redbridge 020A","E01003751","Total",611,103,47,56,508,24,65,84,65,46,93,131
"2011","Redbridge 020B","E01003753","Total",659,151,54,97,508,38,44,111,73,33,91,118
"2011","Redbridge 020C","E01003754","Total",533,148,96,52,385,16,43,60,37,28,78,123
"2011","Redbridge 020D","E01003757","Total",622,136,34,102,486,69,28,85,56,42,89,117
"2011","Redbridge 022A","E01003769","Total",557,121,29,92,436,52,23,83,80,26,68,104
"2011","Redbridge 022B","E01003770","Total",848,211,51,160,637,39,49,161,116,43,96,133
"2011","Redbridge 022C","E01003771","Total",581,107,28,79,474,66,33,92,51,27,89,116
"2011","Redbridge 022D","E01003773","Total",579,137,55,82,442,33,40,91,85,32,71,90
"2011","Redbridge 023A","E01003752","Total",838,176,51,125,662,25,67,104,163,28,115,160
"2011","Redbridge 023B","E01003755","Total",571,76,32,44,495,16,44,110,57,32,121,115
"2011","Redbridge 023C","E01003756","Total",600,96,45,51,504,15,57,88,41,45,123,135
"2011","Redbridge 023D","E01003758","Total",810,121,17,104,689,113,30,186,90,37,103,130
"2011","Redbridge 024A","E01003766","Total",548,74,28,46,474,22,44,77,72,34,94,131
"2011","Redbridge 024B","E01003767","Total",567,119,29,90,448,36,35,81,51,28,84,133
"2011","Redbridge 024C","E01003768","Total",569,156,41,115,413,49,23,79,71,10,82,99
"2011","Redbridge 024D","E01003772","Total",524,98,47,51,426,28,49,65,53,25,86,120
"2011","Redbridge 026A","E01003781","Total",602,185,53,132,417,28,29,98,86,13,71,92
"2011","Redbridge 026B","E01003782","Total",518,107,28,79,411,26,22,87,57,41,76,102
"2011","Redbridge 026C","E01003786","Total",442,80,34,46,362,9,35,71,52,26,62,107
"2011","Redbridge 026D","E01003787","Total",469,99,34,65,370,21,30,61,52,35,72,99
"2011","Redbridge 027A","E01003790","Total",557,165,71,94,392,26,57,78,87,24,36,84
"2011","Redbridge 027B","E01003791","Total",540,106,49,57,434,18,76,76,96,9,44,115
"2011","Redbridge 027C","E01003792","Total",508,119,44,75,389,14,31,89,89,20,50,96
"2011","Redbridge 027D","E01003793","Total",760,334,129,205,426,51,67,81,126,17,19,65
"2011","Redbridge 029A","E01003783","Total",858,307,73,234,551,82,37,133,89,25,73,112
"2011","Redbridge 029B","E01003784","Total",546,120,33,87,426,37,34,77,69,28,82,99
"2011","Redbridge 029C","E01003785","Total",704,201,42,159,503,71,28,129,112,23,56,84
"2011","Redbridge 029D","E01003788","Total",645,191,31,160,454,58,27,102,88,20,72,87
"2011","Redbridge 030A","E01003683","Total",576,81,31,50,495,63,32,68,56,53,87,136
"2011","Redbridge 030B","E01003684","Total",496,78,34,44,418,40,34,57,38,37,102,110
"2011","Redbridge 030C","E01003685","Total",508,68,32,36,440,33,28,61,46,36,91,145
"2011","Redbridge 030D","E01003686","Total",533,71,33,38,462,53,37,62,49,38,105,118
"2011","Redbridge 030F","E01003688","Total",532,107,23,84,425,33,39,63,63,28,85,114
"2011","Redbridge 030G","E01003689","Total",508,131,84,47,377,49,27,55,39,16,75,116
"2011","Redbridge 030H","E01033589","Total",660,142,12,130,518,43,8,197,160,10,22,78
"2011","Redbridge 030I","E01033591","Total",630,141,35,106,489,46,34,97,81,41,71,119
"2011","Redbridge 031A","E01003737","Total",575,124,88,36,451,23,79,60,49,32,93,115
"2011","Redbridge 031B","E01003738","Total",646,121,69,52,525,29,65,73,61,41,96,160
"2011","Redbridge 031C","E01003739","Total",658,125,44,81,533,36,45,111,73,36,103,129
"2011","Redbridge 031D","E01003740","Total",621,119,65,54,502,31,62,60,62,42,95,150
"2011","Redbridge 031E","E01003741","Total",643,188,118,70,455,20,87,74,77,17,75,105
"2011","Redbridge 031F","E01003742","Total",618,89,34,55,529,70,25,95,75,44,94,126
"2011","Redbridge 031G","E01003743","Total",496,70,33,37,426,33,41,60,52,44,95,101
"2011","Redbridge 032A","E01003728","Total",810,199,45,154,611,76,29,134,124,39,72,137
"2011","Redbridge 032B","E01003729","Total",526,115,57,58,411,35,36,50,56,37,89,108
"2011","Redbridge 032C","E01003730","Total",416,41,18,23,375,41,20,42,35,46,84,107
"2011","Redbridge 032D","E01003732","Total",592,142,22,120,450,161,11,96,74,27,31,50
"2011","Redbridge 032E","E01003733","Total",507,88,31,57,419,44,28,63,49,36,78,121
"2011","Redbridge 033A","E01003731","Total",447,103,29,74,344,39,20,40,39,33,71,102
"2011","Redbridge 033B","E01003734","Total",517,98,31,67,419,42,33,63,51,47,76,107
"2011","Redbridge 033C","E01003735","Total",811,200,93,107,611,182,39,83,72,52,85,98
"2011","Redbridge 033D","E01003736","Total",475,63,18,45,412,60,12,82,50,43,75,90
"2011","Redbridge 034A","E01003713","Total",481,76,38,38,405,17,39,61,47,29,91,121
"2011","Redbridge 034B","E01003714","Total",642,111,38,73,531,53,44,86,61,49,99,139
"2011","Redbridge 034C","E01003715","Total",564,113,35,78,451,41,30,53,43,30,111,143
"2011","Redbridge 034D","E01003716","Total",521,115,33,82,406,25,29,61,66,25,87,113
"2011","Redbridge 034E","E01003718","Total",630,178,25,153,452,29,24,140,81,33,67,78
"2011","Redbridge 034F","E01003719","Total",633,138,40,98,495,41,47,82,85,24,86,130
"2011","Redbridge 034G","E01032581","Total",699,252,45,207,447,60,23,95,132,18,48,71
"2011","Redbridge 035A","E01003690","Total",608,175,67,108,433,28,64,66,101,13,60,101
"2011","Redbridge 035B","E01003691","Total",413,79,32,47,334,20,27,43,42,25,88,89
"2011","Redbridge 035C","E01003692","Total",501,95,33,62,406,25,52,73,56,25,77,98
"2011","Redbridge 035D","E01003693","Total",431,61,32,29,370,9,55,46,31,19,76,134
"2011","Redbridge 035E","E01003694","Total",448,97,61,36,351,13,57,46,36,18,70,111
"2011","Redbridge 035F","E01003695","Total",534,151,27,124,383,25,41,91,75,12,55,84
"2011","Redbridge 035G","E01003696","Total",593,112,70,42,481,14,61,53,43,28,95,187
"2011","Redbridge 035H","E01003697","Total",492,89,35,54,403,18,37,68,61,18,83,118
"2011","Redbridge 036A","E01003675","Total",490,84,51,33,406,12,59,67,49,27,85,107
"2011","Redbridge 036B","E01003676","Total",495,75,43,32,420,12,57,65,40,31,89,126
"2011","Redbridge 036C","E01003677","Total",494,72,45,27,422,9,106,52,50,22,75,108
"2011","Redbridge 036D","E01003678","Total",479,54,36,18,425,15,58,70,45,23,83,131
"2011","Redbridge 036E","E01003679","Total",493,74,41,33,419,15,64,53,46,17,89,135
"2011","Redbridge 036F","E01003680","Total",475,47,26,21,428,19,55,77,49,25,84,119
"2011","Redbridge 036G","E01003681","Total",683,208,119,89,475,39,85,81,60,23,79,108
"2011","Redbridge 036H","E01003682","Total",493,69,47,22,424,7,41,75,46,33,88,134
"2011","Richmond upon Thames 001A","E01003797","Total",523,107,75,32,416,6,89,110,67,37,41,66
"2011","Richmond upon Thames 001B","E01003798","Total",691,254,112,142,437,19,70,92,144,23,27,62
"2011","Richmond upon Thames 001C","E01003799","Total",653,176,60,116,477,11,60,117,144,35,33,77
"2011","Richmond upon Thames 001D","E01003800","Total",640,186,73,113,454,41,59,85,118,23,49,79
"2011","Richmond upon Thames 001E","E01003801","Total",534,158,63,95,376,8,50,81,113,16,28,80
"2011","Richmond upon Thames 001F","E01003802","Total",623,225,54,171,398,13,57,94,145,16,13,60
"2011","Richmond upon Thames 001G","E01003803","Total",632,209,96,113,423,47,60,72,100,24,24,96
"2011","Richmond upon Thames 002A","E01003846","Total",628,122,59,63,506,19,86,132,89,32,45,103
"2011","Richmond upon Thames 002B","E01003847","Total",842,383,142,241,459,10,68,93,208,8,13,59
"2011","Richmond upon Thames 002C","E01003849","Total",653,227,81,146,426,14,69,111,124,23,22,63
"2011","Richmond upon Thames 002D","E01003851","Total",691,213,79,134,478,20,88,145,114,24,23,64
"2011","Richmond upon Thames 002E","E01003860","Total",819,278,63,215,541,11,54,119,277,13,15,52
"2011","Richmond upon Thames 002F","E01003864","Total",671,244,98,146,427,8,59,96,163,13,30,58
"2011","Richmond upon Thames 003A","E01003852","Total",652,268,103,165,384,24,66,61,132,16,19,66
"2011","Richmond upon Thames 003B","E01003853","Total",622,206,87,119,416,32,65,94,86,24,20,95
"2011","Richmond upon Thames 003C","E01003854","Total",653,237,85,152,416,15,51,113,152,16,15,54
"2011","Richmond upon Thames 003D","E01003855","Total",831,356,91,265,475,50,49,86,184,13,22,71
"2011","Richmond upon Thames 003E","E01003856","Total",749,270,63,207,479,37,30,123,204,14,5,66
"2011","Richmond upon Thames 003F","E01003857","Total",756,233,85,148,523,30,57,174,169,15,24,54
"2011","Richmond upon Thames 003G","E01003858","Total",678,192,70,122,486,24,39,183,146,16,17,61
"2011","Richmond upon Thames 004A","E01003848","Total",817,249,77,172,568,40,50,139,230,18,22,69
"2011","Richmond upon Thames 004C","E01003861","Total",855,321,89,232,534,29,24,113,276,11,19,62
"2011","Richmond upon Thames 004D","E01003862","Total",627,230,75,155,397,27,48,82,128,21,20,71
"2011","Richmond upon Thames 004E","E01003863","Total",639,255,136,119,384,13,54,94,102,23,20,78
"2011","Richmond upon Thames 004F","E01003865","Total",529,154,75,79,375,29,51,102,87,14,26,66
"2011","Richmond upon Thames 004G","E01033570","Total",709,245,29,216,464,43,23,123,199,18,30,28
"2011","Richmond upon Thames 004H","E01033571","Total",624,196,83,113,428,23,74,93,83,28,45,82
"2011","Richmond upon Thames 005A","E01003804","Total",768,245,107,138,523,35,62,156,162,24,18,66
"2011","Richmond upon Thames 005B","E01003807","Total",817,270,99,171,547,34,68,117,208,17,27,76
"2011","Richmond upon Thames 005C","E01003808","Total",793,266,94,172,527,25,55,180,171,10,28,58
"2011","Richmond upon Thames 005D","E01003809","Total",657,163,72,91,494,17,75,131,101,33,29,108
"2011","Richmond upon Thames 005E","E01003859","Total",631,163,83,80,468,22,57,131,109,38,29,82
"2011","Richmond upon Thames 006A","E01003873","Total",850,376,117,259,474,21,56,107,211,22,19,38
"2011","Richmond upon Thames 006B","E01003874","Total",787,340,83,257,447,9,50,116,223,8,13,28
"2011","Richmond upon Thames 006C","E01003875","Total",681,222,97,125,459,12,82,111,119,34,37,64
"2011","Richmond upon Thames 006D","E01003878","Total",648,295,114,181,353,29,35,86,106,10,24,63
"2011","Richmond upon Thames 007A","E01003866","Total",642,165,58,107,477,21,43,179,140,19,23,52
"2011","Richmond upon Thames 007B","E01003868","Total",639,185,39,146,454,13,33,128,196,23,21,40
"2011","Richmond upon Thames 007C","E01003871","Total",642,144,40,104,498,37,48,172,137,20,25,59
"2011","Richmond upon Thames 007D","E01003872","Total",686,271,61,210,415,14,49,90,170,25,21,46
"2011","Richmond upon Thames 008A","E01003821","Total",784,363,94,269,421,21,55,81,207,8,11,38
"2011","Richmond upon Thames 008B","E01003876","Total",865,385,109,276,480,11,83,66,237,7,18,58
"2011","Richmond upon Thames 008C","E01003877","Total",724,300,117,183,424,14,63,103,164,22,20,38
"2011","Richmond upon Thames 008D","E01003879","Total",613,216,56,160,397,18,38,96,152,20,17,56
"2011","Richmond upon Thames 009A","E01003892","Total",924,351,110,241,573,16,88,169,215,21,17,47
"2011","Richmond upon Thames 009B","E01003893","Total",759,307,85,222,452,13,64,100,175,19,13,68
"2011","Richmond upon Thames 009C","E01003894","Total",760,277,63,214,483,13,49,108,211,31,17,54
"2011","Richmond upon Thames 009D","E01003895","Total",766,275,77,198,491,23,58,119,173,22,32,64
"2011","Richmond upon Thames 010A","E01003905","Total",548,144,62,82,404,14,61,99,95,15,32,88
"2011","Richmond upon Thames 010B","E01003906","Total",649,195,77,118,454,26,58,107,135,15,32,81
"2011","Richmond upon Thames 010C","E01003907","Total",673,220,98,122,453,25,60,108,91,22,46,101
"2011","Richmond upon Thames 010D","E01003908","Total",668,133,72,61,535,14,109,121,108,27,39,117
"2011","Richmond upon Thames 010E","E01003909","Total",606,142,81,61,464,25,93,83,96,16,39,112
"2011","Richmond upon Thames 011A","E01003867","Total",576,146,57,89,430,16,48,109,114,12,36,95
"2011","Richmond upon Thames 011B","E01003869","Total",693,203,74,129,490,12,44,110,195,13,34,82
"2011","Richmond upon Thames 011C","E01003870","Total",721,174,56,118,547,14,44,172,169,30,40,78
"2011","Richmond upon Thames 011D","E01003910","Total",670,182,114,68,488,12,105,117,116,14,31,93
"2011","Richmond upon Thames 012A","E01003805","Total",593,102,70,32,491,13,120,128,72,45,30,83
"2011","Richmond upon Thames 012B","E01003806","Total",523,93,46,47,430,14,88,111,67,27,43,80
"2011","Richmond upon Thames 012C","E01003816","Total",640,147,82,65,493,26,112,128,72,35,47,73
"2011","Richmond upon Thames 012D","E01003817","Total",867,395,192,203,472,23,99,94,151,20,16,69
"2011","Richmond upon Thames 013A","E01003840","Total",560,111,41,70,449,43,44,86,82,18,71,105
"2011","Richmond upon Thames 013B","E01003841","Total",811,298,115,183,513,82,50,112,91,25,51,102
"2011","Richmond upon Thames 013C","E01003842","Total",619,122,57,65,497,37,83,99,85,18,48,127
"2011","Richmond upon Thames 013D","E01003843","Total",753,198,89,109,555,41,91,111,87,28,73,124
"2011","Richmond upon Thames 013E","E01003844","Total",553,112,54,58,441,14,100,73,82,13,46,113
"2011","Richmond upon Thames 013F","E01003845","Total",622,154,97,57,468,13,108,71,92,17,53,114
"2011","Richmond upon Thames 014A","E01003882","Total",793,263,74,189,530,19,51,161,193,20,30,56
"2011","Richmond upon Thames 014B","E01003883","Total",836,270,77,193,566,15,32,175,270,8,12,54
"2011","Richmond upon Thames 014C","E01003896","Total",796,316,75,241,480,17,44,91,206,12,22,88
"2011","Richmond upon Thames 014D","E01003897","Total",848,337,61,276,511,30,35,125,246,12,13,50
"2011","Richmond upon Thames 015A","E01003898","Total",675,212,64,148,463,26,32,132,205,12,9,47
"2011","Richmond upon Thames 015B","E01003899","Total",632,229,84,145,403,21,40,129,133,10,16,54
"2011","Richmond upon Thames 015C","E01003900","Total",614,179,76,103,435,35,49,101,95,18,39,98
"2011","Richmond upon Thames 015D","E01003901","Total",605,126,64,62,479,14,51,159,122,23,36,74
"2011","Richmond upon Thames 015E","E01003902","Total",503,116,52,64,387,19,48,119,90,10,25,76
"2011","Richmond upon Thames 015F","E01003903","Total",580,96,44,52,484,45,65,107,99,22,43,103
"2011","Richmond upon Thames 015G","E01003904","Total",671,231,90,141,440,23,36,142,145,17,23,54
"2011","Richmond upon Thames 016A","E01003880","Total",581,158,45,113,423,16,57,115,105,22,32,76
"2011","Richmond upon Thames 016B","E01003881","Total",492,159,62,97,333,16,41,79,124,10,22,41
"2011","Richmond upon Thames 016C","E01003884","Total",698,241,75,166,457,16,75,94,150,25,27,70
"2011","Richmond upon Thames 016D","E01003885","Total",647,191,64,127,456,33,55,123,134,22,27,62
"2011","Richmond upon Thames 017A","E01003818","Total",661,200,114,86,461,37,81,101,111,16,43,72
"2011","Richmond upon Thames 017B","E01003819","Total",747,283,92,191,464,55,63,99,107,17,35,88
"2011","Richmond upon Thames 017C","E01003820","Total",751,190,112,78,561,39,67,132,128,26,46,123
"2011","Richmond upon Thames 018A","E01003811","Total",640,185,56,129,455,22,39,163,135,25,17,54
"2011","Richmond upon Thames 018B","E01003812","Total",772,221,48,173,551,34,49,153,189,15,31,80
"2011","Richmond upon Thames 018C","E01003890","Total",642,203,49,154,439,18,52,126,127,19,25,72
"2011","Richmond upon Thames 018D","E01003891","Total",826,329,116,213,497,13,98,105,179,12,26,64
"2011","Richmond upon Thames 019A","E01003810","Total",613,152,46,106,461,19,45,143,123,17,36,78
"2011","Richmond upon Thames 019B","E01003813","Total",643,157,80,77,486,20,93,105,112,20,38,98
"2011","Richmond upon Thames 019C","E01003814","Total",760,301,120,181,459,26,68,106,154,20,24,61
"2011","Richmond upon Thames 019D","E01003815","Total",824,290,86,204,534,51,57,158,178,11,25,54
"2011","Richmond upon Thames 020A","E01003828","Total",630,151,72,79,479,30,111,78,114,19,27,100
"2011","Richmond upon Thames 020B","E01003829","Total",686,213,88,125,473,48,72,88,95,17,51,102
"2011","Richmond upon Thames 020C","E01003830","Total",734,191,77,114,543,38,116,121,129,16,34,89
"2011","Richmond upon Thames 020D","E01003831","Total",697,220,85,135,477,45,63,121,133,16,25,74
"2011","Richmond upon Thames 020E","E01003832","Total",681,299,102,197,382,46,41,75,106,15,28,71
"2011","Richmond upon Thames 020F","E01003833","Total",658,268,80,188,390,37,46,94,132,6,12,63
"2011","Richmond upon Thames 021A","E01003886","Total",684,173,53,120,511,22,49,150,170,24,33,63
"2011","Richmond upon Thames 021B","E01003887","Total",789,293,93,200,496,21,59,134,175,17,25,65
"2011","Richmond upon Thames 021C","E01003888","Total",896,383,144,239,513,33,64,110,172,22,25,87
"2011","Richmond upon Thames 021D","E01003889","Total",779,281,92,189,498,11,82,129,169,19,27,61
"2011","Richmond upon Thames 022A","E01003834","Total",829,424,121,303,405,21,48,90,180,13,14,39
"2011","Richmond upon Thames 022B","E01003835","Total",537,110,39,71,427,12,53,138,87,30,32,75
"2011","Richmond upon Thames 022C","E01003836","Total",613,225,128,97,388,16,58,107,74,22,34,77
"2011","Richmond upon Thames 022D","E01003837","Total",802,261,113,148,541,33,111,124,146,26,25,76
"2011","Richmond upon Thames 022E","E01003838","Total",758,253,63,190,505,35,47,134,150,26,33,80
"2011","Richmond upon Thames 022F","E01003839","Total",916,370,117,253,546,73,53,135,200,15,16,54
"2011","Richmond upon Thames 023A","E01003822","Total",516,83,46,37,433,6,98,92,85,23,43,86
"2011","Richmond upon Thames 023B","E01003823","Total",796,284,118,166,512,23,90,74,210,8,25,82
"2011","Richmond upon Thames 023C","E01003824","Total",649,165,98,67,484,27,83,137,104,19,33,81
"2011","Richmond upon Thames 023D","E01003825","Total",653,132,73,59,521,14,78,151,102,19,37,120
"2011","Richmond upon Thames 023E","E01003826","Total",760,262,114,148,498,64,69,105,133,16,29,82
"2011","Richmond upon Thames 023F","E01003827","Total",800,288,80,208,512,37,44,147,186,14,16,68
"2011","Sutton 001A","E01004125","Total",630,203,99,104,427,41,41,108,88,18,53,78
"2011","Sutton 001B","E01004183","Total",663,199,62,137,464,46,45,99,102,21,58,93
"2011","Sutton 001C","E01004184","Total",598,145,62,83,453,70,40,118,88,26,42,69
"2011","Sutton 001D","E01004185","Total",565,172,33,139,393,73,19,85,88,16,48,64
"2011","Sutton 001E","E01004189","Total",750,214,99,115,536,62,65,137,98,21,51,102
"2011","Sutton 002A","E01004123","Total",838,249,67,182,589,74,46,137,137,27,62,106
"2011","Sutton 002B","E01004124","Total",655,143,54,89,512,56,54,120,86,22,56,118
"2011","Sutton 002C","E01004126","Total",564,123,51,72,441,63,53,101,84,25,39,76
"2011","Sutton 002D","E01004128","Total",528,142,70,72,386,43,34,74,65,24,52,94
"2011","Sutton 002E","E01004129","Total",750,277,134,143,473,63,58,109,94,20,36,93
"2011","Sutton 003A","E01004130","Total",644,197,104,93,447,32,80,85,81,11,55,103
"2011","Sutton 003B","E01004131","Total",613,155,86,69,458,25,61,91,94,19,70,98
"2011","Sutton 003C","E01004134","Total",555,134,60,74,421,24,67,70,97,16,42,105
"2011","Sutton 003D","E01004135","Total",517,86,51,35,431,16,80,84,66,11,47,127
"2011","Sutton 003E","E01004136","Total",550,95,46,49,455,12,82,72,86,18,64,121
"2011","Sutton 004A","E01004164","Total",639,225,73,152,414,16,78,84,97,11,42,86
"2011","Sutton 004B","E01004166","Total",658,228,81,147,430,18,63,91,144,13,30,71
"2011","Sutton 004C","E01004169","Total",460,144,34,110,316,35,27,76,87,14,37,40
"2011","Sutton 004D","E01004186","Total",790,299,43,256,491,54,31,144,153,12,31,66
"2011","Sutton 004E","E01004188","Total",724,250,56,194,474,56,40,112,142,30,33,61
"2011","Sutton 005A","E01004127","Total",630,164,56,108,466,46,52,115,97,26,50,80
"2011","Sutton 005B","E01004163","Total",615,150,66,84,465,22,80,111,125,7,43,77
"2011","Sutton 005C","E01004165","Total",705,206,64,142,499,44,58,110,158,17,38,74
"2011","Sutton 005D","E01004167","Total",527,166,76,90,361,40,49,69,73,12,44,74
"2011","Sutton 005E","E01004187","Total",640,204,91,113,436,49,45,94,92,21,49,86
"2011","Sutton 006A","E01004117","Total",508,72,43,29,436,7,71,112,80,18,42,106
"2011","Sutton 006B","E01004121","Total",627,180,87,93,447,16,62,98,118,11,55,87
"2011","Sutton 006C","E01004192","Total",753,162,62,100,591,41,49,164,181,11,50,95
"2011","Sutton 006D","E01004193","Total",923,231,65,166,692,76,51,213,193,38,41,80
"2011","Sutton 006E","E01004195","Total",661,200,88,112,461,24,62,115,124,13,43,80
"2011","Sutton 007A","E01004144","Total",633,138,61,77,495,21,103,86,104,13,50,118
"2011","Sutton 007B","E01004145","Total",786,163,75,88,623,30,88,144,133,23,74,131
"2011","Sutton 007C","E01004146","Total",686,209,88,121,477,41,62,130,118,16,40,70
"2011","Sutton 007D","E01004147","Total",603,142,83,59,461,16,91,92,100,17,48,97
"2011","Sutton 008A","E01004116","Total",640,224,156,68,416,9,99,83,64,15,48,98
"2011","Sutton 008B","E01004122","Total",517,116,77,39,401,10,80,89,62,10,46,104
"2011","Sutton 008C","E01004190","Total",499,97,50,47,402,9,80,70,73,10,58,102
"2011","Sutton 008D","E01004191","Total",657,177,83,94,480,20,100,100,99,16,45,100
"2011","Sutton 008E","E01004194","Total",609,212,79,133,397,27,57,95,128,15,21,54
"2011","Sutton 008F","E01004196","Total",567,146,78,68,421,21,78,83,91,16,41,91
"2011","Sutton 009A","E01004115","Total",664,151,71,80,513,29,84,114,116,23,54,93
"2011","Sutton 009B","E01004118","Total",669,209,103,106,460,22,76,86,93,22,50,111
"2011","Sutton 009C","E01004119","Total",506,89,47,42,417,12,68,80,80,15,40,122
"2011","Sutton 009D","E01004132","Total",514,78,55,23,436,14,61,100,70,35,56,100
"2011","Sutton 009E","E01004133","Total",533,84,48,36,449,20,69,120,83,19,42,96
"2011","Sutton 010A","E01004171","Total",558,126,65,61,432,18,75,97,88,21,45,88
"2011","Sutton 010B","E01004172","Total",748,305,81,224,443,79,40,87,149,11,27,50
"2011","Sutton 010C","E01004173","Total",520,130,76,54,390,20,61,59,78,18,52,102
"2011","Sutton 010D","E01004175","Total",690,206,78,128,484,36,74,123,133,12,39,67
"2011","Sutton 010E","E01004176","Total",583,160,42,118,423,28,37,113,127,15,32,71
"2011","Sutton 011A","E01004076","Total",616,182,72,110,434,35,57,108,112,11,41,70
"2011","Sutton 011B","E01004077","Total",629,184,87,97,445,22,71,102,100,16,46,88
"2011","Sutton 011C","E01004078","Total",686,224,71,153,462,44,46,114,123,23,36,76
"2011","Sutton 011D","E01004079","Total",489,74,41,33,415,8,74,81,78,16,50,108
"2011","Sutton 011E","E01004080","Total",506,104,62,42,402,17,80,63,90,17,38,97
"2011","Sutton 011F","E01004081","Total",615,174,59,115,441,26,62,128,117,21,25,62
"2011","Sutton 011G","E01004082","Total",496,85,53,32,411,12,58,91,84,7,55,104
"2011","Sutton 012A","E01004137","Total",763,324,59,265,439,34,56,124,158,9,14,44
"2011","Sutton 012B","E01004140","Total",746,374,109,265,372,45,43,65,99,11,33,76
"2011","Sutton 012C","E01004141","Total",724,300,115,185,424,49,50,85,130,8,29,73
"2011","Sutton 012D","E01004142","Total",1052,487,155,332,565,81,50,131,198,14,29,62
"2011","Sutton 012E","E01004149","Total",813,311,137,174,502,38,111,96,131,17,32,77
"2011","Sutton 013A","E01004101","Total",531,110,57,53,421,11,99,89,95,13,40,74
"2011","Sutton 013B","E01004103","Total",734,272,60,212,462,43,31,109,177,6,32,64
"2011","Sutton 013C","E01004138","Total",697,240,45,195,457,39,38,122,156,10,28,64
"2011","Sutton 013D","E01004139","Total",595,204,50,154,391,27,39,103,113,7,33,69
"2011","Sutton 013E","E01004168","Total",579,119,61,58,460,16,86,96,78,16,49,119
"2011","Sutton 014A","E01004143","Total",626,195,66,129,431,41,42,117,125,10,34,62
"2011","Sutton 014B","E01004148","Total",643,183,93,90,460,50,47,133,116,21,32,61
"2011","Sutton 014C","E01004159","Total",629,178,72,106,451,20,88,104,102,13,41,83
"2011","Sutton 014D","E01004160","Total",672,226,59,167,446,27,38,128,132,10,43,68
"2011","Sutton 014E","E01004161","Total",594,156,51,105,438,22,43,123,136,16,31,67
"2011","Sutton 015A","E01004097","Total",625,130,56,74,495,18,61,124,121,16,51,104
"2011","Sutton 015B","E01004098","Total",504,156,49,107,348,20,54,82,78,13,27,74
"2011","Sutton 015C","E01004099","Total",711,280,92,188,431,40,47,112,170,7,18,37
"2011","Sutton 015D","E01004100","Total",536,124,69,55,412,18,86,73,100,18,36,81
"2011","Sutton 015E","E01004102","Total",556,164,76,88,392,6,55,85,109,25,27,85
"2011","Sutton 016A","E01004110","Total",790,253,86,167,537,39,81,115,157,16,33,96
"2011","Sutton 016B","E01004111","Total",578,154,96,58,424,16,74,118,77,23,39,77
"2011","Sutton 016C","E01004112","Total",668,177,110,67,491,18,112,112,111,17,43,78
"2011","Sutton 016D","E01004120","Total",547,95,64,31,452,11,90,78,73,8,66,126
"2011","Sutton 016E","E01004157","Total",452,88,50,38,364,5,69,69,60,25,38,98
"2011","Sutton 017A","E01004087","Total",522,91,61,30,431,9,110,66,68,13,52,113
"2011","Sutton 017B","E01004170","Total",751,259,69,190,492,32,65,103,147,16,36,93
"2011","Sutton 017C","E01004174","Total",664,267,78,189,397,42,43,90,111,14,26,71
"2011","Sutton 017D","E01004178","Total",950,408,144,264,542,51,67,116,179,18,39,72
"2011","Sutton 017E","E01004179","Total",599,151,50,101,448,16,73,99,92,22,46,100
"2011","Sutton 018A","E01004152","Total",849,423,172,251,426,58,60,65,166,6,11,60
"2011","Sutton 018B","E01004155","Total",822,400,107,293,422,21,39,126,168,9,15,44
"2011","Sutton 018C","E01004156","Total",892,426,119,307,466,31,60,125,187,7,13,43
"2011","Sutton 018D","E01004158","Total",696,295,82,213,401,18,56,85,139,14,24,65
"2011","Sutton 018E","E01004162","Total",745,317,105,212,428,23,45,120,162,9,17,52
"2011","Sutton 019A","E01004083","Total",612,249,80,169,363,57,36,57,101,21,45,46
"2011","Sutton 019B","E01004086","Total",592,127,52,75,465,33,81,86,86,17,55,107
"2011","Sutton 019C","E01004088","Total",733,273,65,208,460,102,30,70,84,30,75,69
"2011","Sutton 019D","E01004089","Total",549,195,42,153,354,84,32,73,71,20,34,40
"2011","Sutton 019E","E01004182","Total",653,200,69,131,453,80,49,107,103,17,33,64
"2011","Sutton 020A","E01004104","Total",551,89,53,36,462,16,103,87,93,24,42,97
"2011","Sutton 020B","E01004107","Total",619,176,62,114,443,43,55,109,112,20,30,74
"2011","Sutton 020C","E01004177","Total",911,467,272,195,444,61,80,88,119,10,22,64
"2011","Sutton 020D","E01004180","Total",616,111,74,37,505,10,118,74,97,17,55,134
"2011","Sutton 020E","E01004181","Total",756,296,93,203,460,38,73,84,142,11,32,80
"2011","Sutton 021A","E01004090","Total",540,230,86,144,310,51,31,71,81,16,26,34
"2011","Sutton 021B","E01004096","Total",756,361,90,271,395,33,37,98,163,9,15,40
"2011","Sutton 021C","E01004150","Total",936,557,233,324,379,46,43,74,158,5,9,44
"2011","Sutton 021D","E01004151","Total",790,319,60,259,471,31,46,104,202,8,22,58
"2011","Sutton 021E","E01004153","Total",903,423,120,303,480,38,66,119,184,9,20,44
"2011","Sutton 022A","E01004091","Total",474,68,47,21,406,9,107,65,72,10,36,107
"2011","Sutton 022B","E01004092","Total",585,159,72,87,426,10,96,69,92,12,34,113
"2011","Sutton 022C","E01004105","Total",647,99,45,54,548,28,88,118,111,34,45,124
"2011","Sutton 022D","E01004106","Total",522,44,34,10,478,6,104,62,108,23,57,118
"2011","Sutton 022E","E01004154","Total",561,130,62,68,431,6,95,84,106,17,35,88
"2011","Sutton 024A","E01004084","Total",504,74,54,20,430,9,100,56,65,11,53,136
"2011","Sutton 024B","E01004085","Total",582,123,54,69,459,9,102,83,83,18,46,118
"2011","Sutton 024C","E01004108","Total",595,116,48,68,479,26,82,119,96,25,46,85
"2011","Sutton 024D","E01004109","Total",638,157,68,89,481,37,72,100,117,17,34,104
"2011","Sutton 025A","E01004093","Total",598,139,59,80,459,16,88,107,110,19,30,89
"2011","Sutton 025B","E01004094","Total",748,265,105,160,483,33,58,148,142,13,26,63
"2011","Sutton 025C","E01004095","Total",635,183,50,133,452,13,92,97,129,12,28,81
"2011","Sutton 025D","E01004114","Total",595,86,62,24,509,9,145,88,73,26,42,126
"2011","Sutton 025E","E01032623","Total",619,92,64,28,527,4,157,79,95,24,76,92
"2011","Waltham Forest 001A","E01004349","Total",547,131,78,53,416,34,89,76,65,13,47,92
"2011","Waltham Forest 001B","E01004350","Total",915,484,367,117,431,44,103,77,79,13,40,75
"2011","Waltham Forest 001C","E01004351","Total",645,173,96,77,472,31,107,98,96,10,41,89
"2011","Waltham Forest 001D","E01004356","Total",590,124,72,52,466,32,86,74,78,16,63,117
"2011","Waltham Forest 001E","E01004357","Total",574,132,65,67,442,23,99,67,74,17,55,107
"2011","Waltham Forest 002A","E01004352","Total",813,297,142,155,516,18,94,92,133,18,30,131
"2011","Waltham Forest 002B","E01004353","Total",798,270,131,139,528,36,108,88,138,10,44,104
"2011","Waltham Forest 002C","E01004354","Total",749,236,84,152,513,48,79,105,127,18,34,102
"2011","Waltham Forest 002D","E01004358","Total",788,349,153,196,439,52,74,80,97,9,35,92
"2011","Waltham Forest 002E","E01004359","Total",610,142,89,53,468,15,70,94,92,15,67,115
"2011","Waltham Forest 003A","E01004384","Total",695,224,94,130,471,62,43,98,94,22,62,90
"2011","Waltham Forest 003B","E01004385","Total",650,268,117,151,382,48,70,77,92,14,22,59
"2011","Waltham Forest 003C","E01004386","Total",642,142,84,58,500,22,104,84,106,12,45,127
"2011","Waltham Forest 003D","E01004389","Total",706,256,113,143,450,61,78,80,94,23,39,75
"2011","Waltham Forest 003E","E01004390","Total",652,206,90,116,446,53,71,92,93,17,43,77
"2011","Waltham Forest 004A","E01004355","Total",673,221,89,132,452,46,62,97,103,17,36,91
"2011","Waltham Forest 004B","E01004360","Total",492,105,64,41,387,15,79,62,69,13,33,116
"2011","Waltham Forest 004C","E01004413","Total",685,258,128,130,427,56,65,86,93,12,46,69
"2011","Waltham Forest 004D","E01004415","Total",583,162,79,83,421,34,61,71,78,13,60,104
"2011","Waltham Forest 004E","E01004416","Total",632,140,57,83,492,42,80,83,96,23,45,123
"2011","Waltham Forest 005A","E01004361","Total",492,116,53,63,376,14,63,69,74,12,33,111
"2011","Waltham Forest 005B","E01004414","Total",615,149,88,61,466,35,82,85,96,19,56,93
"2011","Waltham Forest 005C","E01004417","Total",650,215,103,112,435,45,65,70,78,17,46,114
"2011","Waltham Forest 005D","E01004451","Total",641,148,86,62,493,37,84,80,86,13,57,136
"2011","Waltham Forest 005E","E01004452","Total",692,239,121,118,453,47,72,88,92,13,43,98
"2011","Waltham Forest 006A","E01004450","Total",605,129,76,53,476,29,81,90,88,18,54,116
"2011","Waltham Forest 006B","E01004453","Total",658,214,52,162,444,49,55,76,94,14,55,101
"2011","Waltham Forest 006C","E01004454","Total",640,175,104,71,465,39,69,85,85,22,60,105
"2011","Waltham Forest 006D","E01004455","Total",544,137,47,90,407,38,47,86,72,18,70,76
"2011","Waltham Forest 006E","E01004456","Total",539,137,48,89,402,46,38,57,66,21,78,96
"2011","Waltham Forest 007A","E01004379","Total",523,116,57,59,407,21,46,84,84,19,45,108
"2011","Waltham Forest 007B","E01004380","Total",607,166,67,99,441,37,77,89,93,13,47,85
"2011","Waltham Forest 007C","E01004381","Total",674,173,49,124,501,32,53,109,106,25,68,108
"2011","Waltham Forest 007D","E01004383","Total",575,122,60,62,453,27,64,99,86,17,57,103
"2011","Waltham Forest 007E","E01004387","Total",525,94,49,45,431,13,61,100,71,20,43,123
"2011","Waltham Forest 007F","E01004388","Total",649,253,84,169,396,35,59,74,103,13,33,79
"2011","Waltham Forest 008A","E01004343","Total",647,139,66,73,508,26,63,105,116,22,66,110
"2011","Waltham Forest 008B","E01004344","Total",667,194,43,151,473,59,31,115,82,28,69,89
"2011","Waltham Forest 008C","E01004382","Total",501,159,45,114,342,48,34,67,54,37,43,59
"2011","Waltham Forest 008D","E01004418","Total",649,182,66,116,467,49,62,97,109,19,41,90
"2011","Waltham Forest 008E","E01004419","Total",637,212,59,153,425,34,57,80,85,17,51,101
"2011","Waltham Forest 009A","E01004398","Total",679,168,79,89,511,55,49,71,87,32,81,136
"2011","Waltham Forest 009B","E01004399","Total",594,147,41,106,447,73,29,76,69,25,80,95
"2011","Waltham Forest 009C","E01004400","Total",641,194,58,136,447,35,37,85,97,27,61,105
"2011","Waltham Forest 009D","E01004402","Total",663,194,59,135,469,41,52,92,87,31,71,95
"2011","Waltham Forest 009E","E01004403","Total",602,130,48,82,472,39,45,91,92,42,69,94
"2011","Waltham Forest 010A","E01004345","Total",624,125,41,84,499,49,33,111,85,30,68,123
"2011","Waltham Forest 010B","E01004348","Total",973,272,47,225,701,69,32,184,140,34,89,153
"2011","Waltham Forest 010C","E01004377","Total",626,135,45,90,491,30,72,102,85,23,70,109
"2011","Waltham Forest 010D","E01004378","Total",677,188,55,133,489,54,52,96,96,19,56,116
"2011","Waltham Forest 011A","E01004342","Total",789,210,84,126,579,46,42,102,109,47,72,161
"2011","Waltham Forest 011B","E01004346","Total",557,107,42,65,450,32,46,108,66,38,68,92
"2011","Waltham Forest 011C","E01004347","Total",809,232,63,169,577,58,47,157,156,18,33,108
"2011","Waltham Forest 011D","E01004460","Total",671,183,38,145,488,39,27,100,110,25,70,117
"2011","Waltham Forest 011E","E01004462","Total",639,187,48,139,452,26,31,77,102,23,80,113
"2011","Waltham Forest 012A","E01004396","Total",647,173,51,122,474,24,37,122,90,19,70,112
"2011","Waltham Forest 012B","E01004457","Total",738,224,50,174,514,46,30,112,136,19,58,113
"2011","Waltham Forest 012C","E01004458","Total",681,188,49,139,493,33,46,91,119,25,58,121
"2011","Waltham Forest 012D","E01004459","Total",535,118,56,62,417,79,39,58,59,42,66,74
"2011","Waltham Forest 012E","E01004463","Total",906,329,44,285,577,64,34,144,200,14,36,85
"2011","Waltham Forest 013A","E01004407","Total",493,169,40,129,324,53,17,61,48,82,26,37
"2011","Waltham Forest 013B","E01004410","Total",852,350,151,199,502,77,46,89,143,25,35,87
"2011","Waltham Forest 013C","E01004464","Total",643,254,55,199,389,65,17,95,70,30,48,64
"2011","Waltham Forest 013D","E01004469","Total",627,231,60,171,396,50,36,80,61,35,64,70
"2011","Waltham Forest 013E","E01004470","Total",602,208,71,137,394,37,28,92,101,19,43,74
"2011","Waltham Forest 013F","E01004471","Total",668,210,39,171,458,60,50,93,100,18,45,92
"2011","Waltham Forest 014A","E01004391","Total",846,358,54,304,488,40,38,109,166,19,44,72
"2011","Waltham Forest 014B","E01004393","Total",1023,342,111,231,681,51,42,101,137,15,38,297
"2011","Waltham Forest 014C","E01004401","Total",803,236,59,177,567,55,34,142,126,22,59,129
"2011","Waltham Forest 014D","E01004404","Total",882,369,38,331,513,58,20,134,137,29,63,72
"2011","Waltham Forest 014E","E01004461","Total",794,202,60,142,592,36,42,144,155,24,43,148
"2011","Waltham Forest 015A","E01004412","Total",740,246,45,201,494,35,35,124,179,15,46,60
"2011","Waltham Forest 015B","E01004465","Total",543,157,44,113,386,19,33,98,83,26,42,85
"2011","Waltham Forest 015C","E01004466","Total",638,180,54,126,458,22,31,119,141,16,32,97
"2011","Waltham Forest 015D","E01004467","Total",881,341,90,251,540,63,34,147,114,37,62,83
"2011","Waltham Forest 015E","E01004468","Total",657,207,73,134,450,22,63,82,128,13,56,86
"2011","Waltham Forest 016A","E01004406","Total",731,274,45,229,457,38,31,115,104,17,52,100
"2011","Waltham Forest 016B","E01004408","Total",676,182,54,128,494,45,36,128,138,18,43,86
"2011","Waltham Forest 016C","E01004409","Total",711,286,96,190,425,32,39,79,130,15,36,94
"2011","Waltham Forest 016D","E01004411","Total",648,188,27,161,460,23,36,82,137,10,58,114
"2011","Waltham Forest 016E","E01004443","Total",586,135,36,99,451,29,27,80,78,20,94,123
"2011","Waltham Forest 016F","E01004447","Total",653,182,40,142,471,19,30,77,111,24,76,134
"2011","Waltham Forest 017A","E01004392","Total",879,286,44,242,593,58,35,108,154,15,80,143
"2011","Waltham Forest 017B","E01004394","Total",744,272,60,212,472,52,36,95,113,26,55,95
"2011","Waltham Forest 017C","E01004397","Total",849,237,27,210,612,33,25,118,171,19,66,180
"2011","Waltham Forest 017D","E01004444","Total",966,326,88,238,640,66,32,136,136,49,105,116
"2011","Waltham Forest 017E","E01004446","Total",677,177,33,144,500,41,46,108,105,24,67,109
"2011","Waltham Forest 018A","E01004395","Total",565,138,49,89,427,27,48,87,86,29,55,95
"2011","Waltham Forest 018B","E01004421","Total",604,125,46,79,479,24,46,56,51,64,102,136
"2011","Waltham Forest 018C","E01004445","Total",624,177,55,122,447,17,38,81,103,21,72,115
"2011","Waltham Forest 018D","E01004448","Total",759,226,31,195,533,85,28,146,127,29,38,80
"2011","Waltham Forest 018E","E01004449","Total",599,179,84,95,420,42,43,55,44,44,93,99
"2011","Waltham Forest 019A","E01004363","Total",506,100,39,61,406,14,43,61,74,27,60,127
"2011","Waltham Forest 019B","E01004364","Total",563,139,52,87,424,40,31,61,61,33,77,121
"2011","Waltham Forest 019C","E01004366","Total",642,163,65,98,479,20,70,68,92,25,61,143
"2011","Waltham Forest 019D","E01004367","Total",537,135,41,94,402,26,29,65,71,28,75,108
"2011","Waltham Forest 019E","E01004368","Total",720,239,46,193,481,31,39,79,122,14,52,144
"2011","Waltham Forest 020A","E01004365","Total",700,170,26,144,530,34,28,85,102,31,79,171
"2011","Waltham Forest 020B","E01004405","Total",566,165,40,125,401,37,29,66,86,32,59,92
"2011","Waltham Forest 020C","E01004420","Total",790,299,46,253,491,30,44,84,79,28,73,153
"2011","Waltham Forest 020D","E01004423","Total",697,252,115,137,445,43,31,73,80,13,94,111
"2011","Waltham Forest 020G","E01033153","Total",936,289,68,221,647,105,56,119,95,67,91,114
"2011","Waltham Forest 021A","E01004362","Total",676,257,51,206,419,24,20,70,146,19,37,103
"2011","Waltham Forest 021B","E01004436","Total",580,154,28,126,426,33,26,62,121,11,54,119
"2011","Waltham Forest 021C","E01004437","Total",762,306,64,242,456,40,29,77,127,13,52,118
"2011","Waltham Forest 021D","E01004439","Total",619,175,36,139,444,43,38,76,110,14,44,119
"2011","Waltham Forest 021E","E01004442","Total",668,165,31,134,503,29,28,94,147,14,36,155
"2011","Waltham Forest 022A","E01004422","Total",589,147,52,95,442,39,55,79,78,27,67,97
"2011","Waltham Forest 022B","E01004424","Total",627,173,36,137,454,50,20,95,69,39,68,113
"2011","Waltham Forest 022C","E01004425","Total",848,259,45,214,589,96,32,149,151,31,42,88
"2011","Waltham Forest 022D","E01004426","Total",590,157,46,111,433,31,39,78,60,34,74,117
"2011","Waltham Forest 022E","E01004427","Total",852,277,30,247,575,81,22,196,131,18,57,70
"2011","Waltham Forest 023A","E01004369","Total",615,148,25,123,467,51,20,100,106,26,50,114
"2011","Waltham Forest 023B","E01004370","Total",636,176,51,125,460,16,39,94,94,39,51,127
"2011","Waltham Forest 023C","E01004372","Total",744,238,44,194,506,33,25,155,140,11,35,107
"2011","Waltham Forest 023D","E01004432","Total",652,180,46,134,472,47,35,124,87,36,43,100
"2011","Waltham Forest 023E","E01004435","Total",749,215,60,155,534,83,32,104,131,22,50,112
"2011","Waltham Forest 024A","E01004333","Total",611,164,24,140,447,57,29,92,73,30,59,107
"2011","Waltham Forest 024B","E01004334","Total",637,255,97,158,382,67,22,87,75,26,33,72
"2011","Waltham Forest 024C","E01004438","Total",772,234,47,187,538,23,19,92,161,11,52,180
"2011","Waltham Forest 024D","E01004440","Total",794,200,33,167,594,31,34,117,182,17,53,160
"2011","Waltham Forest 024E","E01004441","Total",635,188,40,148,447,25,32,73,126,12,43,136
"2011","Waltham Forest 025A","E01004371","Total",615,154,36,118,461,21,31,80,114,15,48,152
"2011","Waltham Forest 025B","E01004373","Total",621,171,44,127,450,21,44,74,90,35,49,137
"2011","Waltham Forest 025C","E01004374","Total",688,186,50,136,502,18,48,93,119,25,56,143
"2011","Waltham Forest 025D","E01004375","Total",647,154,47,107,493,29,25,101,126,16,57,139
"2011","Waltham Forest 025E","E01004376","Total",654,162,33,129,492,23,36,67,89,15,66,196
"2011","Waltham Forest 026A","E01004336","Total",564,146,31,115,418,22,28,42,89,9,54,174
"2011","Waltham Forest 026B","E01004428","Total",653,198,52,146,455,80,42,84,73,32,56,88
"2011","Waltham Forest 026C","E01004429","Total",653,186,38,148,467,58,34,70,110,18,62,115
"2011","Waltham Forest 026D","E01004430","Total",827,247,35,212,580,33,33,88,155,19,55,197
"2011","Waltham Forest 026E","E01004434","Total",737,232,72,160,505,67,37,85,88,32,75,121
"2011","Waltham Forest 027A","E01004335","Total",645,177,33,144,468,95,25,74,77,52,56,89
"2011","Waltham Forest 027B","E01004337","Total",717,219,73,146,498,44,37,90,77,33,86,131
"2011","Waltham Forest 027C","E01004338","Total",580,130,25,105,450,22,21,64,92,16,63,172
"2011","Waltham Forest 027D","E01004339","Total",661,184,26,158,477,42,16,115,124,23,50,107
"2011","Waltham Forest 027E","E01004340","Total",698,221,58,163,477,60,34,71,100,23,59,130
"2011","Waltham Forest 027F","E01004341","Total",665,238,90,148,427,46,29,64,81,29,69,109
"2011","Waltham Forest 028A","E01004327","Total",465,140,53,87,325,22,47,60,69,12,33,82
"2011","Waltham Forest 028B","E01004328","Total",671,172,30,142,499,37,38,90,116,21,55,142
"2011","Waltham Forest 028C","E01004329","Total",671,178,32,146,493,51,27,87,94,18,76,140
"2011","Waltham Forest 028D","E01004330","Total",625,134,39,95,491,27,46,88,89,24,64,153
"2011","Waltham Forest 028E","E01004331","Total",675,201,53,148,474,47,36,96,88,25,60,122
"2011","Waltham Forest 028F","E01004332","Total",633,164,33,131,469,40,29,85,104,27,60,124
"2011","Bracknell Forest 001C","E01016252","Total",658,221,84,137,437,23,99,62,149,13,21,70
"2011","Bracknell Forest 001D","E01016253","Total",521,102,27,75,419,24,64,131,92,14,46,48
"2011","Bracknell Forest 001E","E01032727","Total",1308,364,219,145,944,26,285,217,229,36,52,99
"2011","Bracknell Forest 002A","E01016184","Total",868,202,56,146,666,40,72,158,245,18,46,87
"2011","Bracknell Forest 002B","E01016185","Total",607,213,63,150,394,27,31,86,173,14,19,44
"2011","Bracknell Forest 002C","E01016186","Total",731,171,77,94,560,30,109,120,139,23,34,105
"2011","Bracknell Forest 002D","E01016187","Total",667,162,66,96,505,16,77,130,158,21,25,78
"2011","Bracknell Forest 002E","E01016188","Total",661,146,28,118,515,27,40,177,172,26,27,46
"2011","Bracknell Forest 003A","E01016190","Total",609,145,75,70,464,30,103,85,98,16,54,78
"2011","Bracknell Forest 003B","E01016238","Total",483,121,83,38,362,18,72,47,108,18,26,73
"2011","Bracknell Forest 003C","E01016243","Total",592,144,25,119,448,24,31,169,141,10,24,49
"2011","Bracknell Forest 003D","E01016245","Total",889,162,39,123,727,32,55,233,222,25,67,93
"2011","Bracknell Forest 003E","E01016246","Total",607,133,23,110,474,27,30,170,140,15,41,51
"2011","Bracknell Forest 003F","E01016247","Total",692,174,23,151,518,31,34,165,196,16,22,54
"2011","Bracknell Forest 004A","E01016239","Total",610,161,81,80,449,32,89,70,116,18,37,87
"2011","Bracknell Forest 004B","E01016240","Total",646,200,80,120,446,46,58,105,111,12,32,82
"2011","Bracknell Forest 004C","E01016241","Total",647,184,84,100,463,47,77,91,105,30,34,79
"2011","Bracknell Forest 004D","E01016242","Total",805,307,82,225,498,73,56,111,146,14,25,73
"2011","Bracknell Forest 005A","E01016180","Total",558,174,82,92,384,29,80,73,104,15,36,47
"2011","Bracknell Forest 005B","E01016181","Total",540,155,75,80,385,19,84,67,120,9,24,62
"2011","Bracknell Forest 005C","E01016182","Total",614,155,64,91,459,34,95,110,106,18,30,66
"2011","Bracknell Forest 005D","E01016183","Total",516,135,62,73,381,28,56,117,83,10,19,68
"2011","Bracknell Forest 005E","E01016222","Total",503,100,15,85,403,11,33,113,139,7,28,72
"2011","Bracknell Forest 006B","E01016191","Total",651,159,89,70,492,28,103,113,95,15,43,95
"2011","Bracknell Forest 006C","E01016223","Total",648,239,52,187,409,35,52,89,127,14,30,62
"2011","Bracknell Forest 006D","E01016224","Total",756,240,77,163,516,82,60,120,139,20,24,71
"2011","Bracknell Forest 006E","E01016226","Total",625,230,108,122,395,29,59,79,123,11,24,70
"2011","Bracknell Forest 006F","E01032724","Total",630,254,73,181,376,66,49,64,112,10,20,55
"2011","Bracknell Forest 006G","E01032728","Total",641,248,96,152,393,33,39,81,133,9,28,70
"2011","Bracknell Forest 007A","E01016225","Total",888,231,52,179,657,72,86,150,185,22,55,87
"2011","Bracknell Forest 007B","E01016233","Total",1027,382,83,299,645,85,55,135,202,40,44,84
"2011","Bracknell Forest 007C","E01016248","Total",568,155,81,74,413,25,59,80,86,17,56,90
"2011","Bracknell Forest 007D","E01016249","Total",797,409,114,295,388,52,52,72,138,12,12,50
"2011","Bracknell Forest 007E","E01016250","Total",708,259,106,153,449,33,89,78,108,21,32,88
"2011","Bracknell Forest 008A","E01016200","Total",562,162,12,150,400,26,24,109,134,12,30,65
"2011","Bracknell Forest 008B","E01016201","Total",565,151,14,137,414,24,26,104,158,9,26,67
"2011","Bracknell Forest 008C","E01016202","Total",635,270,22,248,365,20,13,91,201,3,9,28
"2011","Bracknell Forest 008D","E01016203","Total",591,216,96,120,375,37,43,87,114,11,20,63
"2011","Bracknell Forest 008E","E01016204","Total",482,127,37,90,355,23,21,91,98,12,25,85
"2011","Bracknell Forest 009A","E01016209","Total",553,88,44,44,465,26,78,86,116,15,47,97
"2011","Bracknell Forest 009B","E01016210","Total",483,115,38,77,368,58,43,75,89,14,26,63
"2011","Bracknell Forest 009D","E01016213","Total",428,74,30,44,354,17,45,76,95,12,30,79
"2011","Bracknell Forest 009E","E01016214","Total",509,65,32,33,444,4,93,73,123,15,38,98
"2011","Bracknell Forest 009F","E01016215","Total",480,112,40,72,368,35,38,91,100,15,36,53
"2011","Bracknell Forest 009G","E01032725","Total",604,104,8,96,500,56,18,149,183,28,26,40
"2011","Bracknell Forest 009H","E01032726","Total",548,128,55,73,420,38,43,96,116,19,36,72
"2011","Bracknell Forest 010A","E01016205","Total",546,153,43,110,393,16,41,85,126,17,33,75
"2011","Bracknell Forest 010B","E01016217","Total",578,152,33,119,426,20,51,99,141,19,27,69
"2011","Bracknell Forest 010C","E01016218","Total",634,235,99,136,399,31,45,77,140,14,19,73
"2011","Bracknell Forest 010D","E01016231","Total",764,191,60,131,573,48,76,126,161,17,57,88
"2011","Bracknell Forest 010E","E01016232","Total",611,177,59,118,434,29,81,98,119,11,35,61
"2011","Bracknell Forest 011A","E01016212","Total",493,99,24,75,394,42,41,96,95,19,29,72
"2011","Bracknell Forest 011B","E01016216","Total",561,178,47,131,383,25,61,77,118,20,26,56
"2011","Bracknell Forest 011C","E01016219","Total",545,124,63,61,421,19,83,70,110,11,32,96
"2011","Bracknell Forest 011D","E01016220","Total",578,190,44,146,388,47,22,102,116,21,23,57
"2011","Bracknell Forest 011E","E01016221","Total",580,198,63,135,382,25,44,87,130,10,22,64
"2011","Bracknell Forest 012A","E01016206","Total",747,197,85,112,550,23,151,99,139,21,35,82
"2011","Bracknell Forest 012B","E01016208","Total",836,305,138,167,531,18,98,114,151,17,45,88
"2011","Bracknell Forest 012C","E01016229","Total",491,144,92,52,347,12,64,68,93,13,28,69
"2011","Bracknell Forest 012D","E01016230","Total",459,156,64,92,303,7,36,73,101,16,16,54
"2011","Bracknell Forest 013A","E01016207","Total",512,102,39,63,410,27,48,114,85,19,46,71
"2011","Bracknell Forest 013B","E01016234","Total",459,84,28,56,375,14,54,76,121,9,30,71
"2011","Bracknell Forest 013C","E01016235","Total",487,78,19,59,409,17,49,91,106,11,37,98
"2011","Bracknell Forest 013D","E01016236","Total",578,152,51,101,426,49,43,94,119,14,35,72
"2011","Bracknell Forest 013E","E01016237","Total",473,99,20,79,374,21,41,98,120,10,27,57
"2011","Bracknell Forest 014A","E01016192","Total",612,226,103,123,386,21,68,100,97,18,21,61
"2011","Bracknell Forest 014B","E01016194","Total",511,95,51,44,416,8,112,75,118,12,21,70
"2011","Bracknell Forest 014C","E01016195","Total",473,130,17,113,343,25,23,96,117,11,24,47
"2011","Bracknell Forest 014D","E01016227","Total",482,75,40,35,407,14,72,89,110,18,39,65
"2011","Bracknell Forest 014E","E01016228","Total",574,113,62,51,461,12,89,109,117,13,36,85
"2011","Bracknell Forest 015A","E01016193","Total",528,173,40,133,355,23,23,83,122,8,36,60
"2011","Bracknell Forest 015B","E01016196","Total",557,72,20,52,485,24,35,170,112,27,53,64
"2011","Bracknell Forest 015C","E01016197","Total",511,112,48,64,399,35,59,79,91,13,35,87
"2011","Bracknell Forest 015D","E01016198","Total",517,162,99,63,355,11,57,76,106,13,26,66
"2011","Bracknell Forest 015E","E01016199","Total",470,86,25,61,384,14,54,75,112,15,31,83
"2011","Brighton and Hove 001A","E01016924","Total",582,138,88,50,444,23,89,106,87,21,36,82
"2011","Brighton and Hove 001B","E01016926","Total",606,139,66,73,467,65,62,105,91,21,34,89
"2011","Brighton and Hove 001C","E01016927","Total",626,162,77,85,464,32,67,101,117,20,36,91
"2011","Brighton and Hove 001D","E01016929","Total",639,163,98,65,476,32,77,111,117,18,26,95
"2011","Brighton and Hove 001E","E01016931","Total",635,169,99,70,466,21,104,100,114,14,22,91
"2011","Brighton and Hove 002A","E01016898","Total",757,241,133,108,516,39,83,73,105,16,51,149
"2011","Brighton and Hove 002B","E01016899","Total",404,115,49,66,289,11,52,61,64,6,23,72
"2011","Brighton and Hove 002C","E01016914","Total",506,108,25,83,398,58,35,44,80,19,44,118
"2011","Brighton and Hove 002D","E01016915","Total",499,106,45,61,393,45,36,53,48,25,57,129
"2011","Brighton and Hove 003A","E01016923","Total",675,241,147,94,434,29,82,81,101,28,35,78
"2011","Brighton and Hove 003B","E01016928","Total",662,151,90,61,511,35,142,99,105,19,30,81
"2011","Brighton and Hove 003C","E01016998","Total",591,119,76,43,472,21,106,120,97,20,36,72
"2011","Brighton and Hove 003D","E01016999","Total",569,124,74,50,445,11,107,77,111,11,34,94
"2011","Brighton and Hove 003E","E01017000","Total",851,357,199,158,494,43,101,97,148,18,21,66
"2011","Brighton and Hove 004A","E01016925","Total",612,164,66,98,448,28,68,91,108,17,45,91
"2011","Brighton and Hove 004B","E01016930","Total",760,179,99,80,581,25,130,113,150,21,32,110
"2011","Brighton and Hove 004C","E01017001","Total",598,140,100,40,458,22,109,73,102,29,35,88
"2011","Brighton and Hove 004D","E01017003","Total",671,191,72,119,480,35,69,121,115,23,35,82
"2011","Brighton and Hove 005A","E01016916","Total",611,143,85,58,468,22,133,91,102,16,26,78
"2011","Brighton and Hove 005B","E01016917","Total",578,123,58,65,455,34,95,81,128,7,28,82
"2011","Brighton and Hove 005C","E01016918","Total",592,186,102,84,406,44,71,77,82,15,46,71
"2011","Brighton and Hove 005D","E01016919","Total",551,131,38,93,420,44,37,94,116,15,35,79
"2011","Brighton and Hove 005E","E01016920","Total",638,151,64,87,487,55,56,127,133,15,29,72
"2011","Brighton and Hove 006A","E01016882","Total",627,166,92,74,461,57,100,89,115,17,19,64
"2011","Brighton and Hove 006B","E01016883","Total",661,179,128,51,482,21,184,73,104,4,26,70
"2011","Brighton and Hove 006C","E01016884","Total",616,162,92,70,454,28,90,90,79,22,42,103
"2011","Brighton and Hove 006D","E01016885","Total",619,231,74,157,388,80,46,85,95,19,23,40
"2011","Brighton and Hove 006E","E01016886","Total",623,194,126,68,429,25,79,87,82,19,50,87
"2011","Brighton and Hove 007A","E01016980","Total",570,140,65,75,430,21,60,103,96,21,48,81
"2011","Brighton and Hove 007B","E01016982","Total",498,103,74,29,395,13,80,99,77,20,33,73
"2011","Brighton and Hove 007C","E01016983","Total",535,112,62,50,423,15,107,70,83,16,44,88
"2011","Brighton and Hove 007D","E01016984","Total",575,119,75,44,456,14,116,92,92,15,41,86
"2011","Brighton and Hove 007E","E01016985","Total",626,154,64,90,472,38,69,100,127,28,34,76
"2011","Brighton and Hove 008A","E01016900","Total",764,346,132,214,418,105,50,65,94,15,14,75
"2011","Brighton and Hove 008B","E01016902","Total",577,122,42,80,455,50,86,88,94,15,26,96
"2011","Brighton and Hove 008C","E01016904","Total",684,236,76,160,448,108,33,81,97,15,30,84
"2011","Brighton and Hove 008D","E01016905","Total",803,358,137,221,445,49,57,85,118,11,16,109
"2011","Brighton and Hove 008E","E01016909","Total",647,149,76,73,498,51,62,50,79,14,41,201
"2011","Brighton and Hove 009A","E01016906","Total",603,146,64,82,457,59,53,82,83,17,54,109
"2011","Brighton and Hove 009B","E01016907","Total",579,119,68,51,460,26,55,32,65,19,46,217
"2011","Brighton and Hove 009C","E01016908","Total",577,158,60,98,419,71,40,77,73,34,35,89
"2011","Brighton and Hove 009D","E01016910","Total",541,125,65,60,416,67,25,68,75,15,37,129
"2011","Brighton and Hove 009E","E01016911","Total",543,106,44,62,437,43,72,59,75,14,43,131
"2011","Brighton and Hove 010A","E01016901","Total",611,136,55,81,475,41,53,126,97,15,37,106
"2011","Brighton and Hove 010B","E01016903","Total",690,134,35,99,556,65,38,116,119,18,35,165
"2011","Brighton and Hove 010C","E01016934","Total",528,137,44,93,391,15,33,128,85,25,35,70
"2011","Brighton and Hove 010D","E01016939","Total",604,126,44,82,478,37,48,154,106,31,28,74
"2011","Brighton and Hove 010E","E01016940","Total",616,138,30,108,478,22,20,153,139,30,27,87
"2011","Brighton and Hove 011A","E01016981","Total",657,167,86,81,490,23,132,95,97,28,29,86
"2011","Brighton and Hove 011B","E01017002","Total",774,259,119,140,515,26,87,113,176,17,22,74
"2011","Brighton and Hove 011C","E01017004","Total",776,313,89,224,463,46,43,104,144,20,32,74
"2011","Brighton and Hove 011D","E01017005","Total",715,220,55,165,495,29,36,134,168,31,32,65
"2011","Brighton and Hove 011E","E01017006","Total",763,283,61,222,480,36,49,115,206,10,13,51
"2011","Brighton and Hove 012A","E01016921","Total",640,177,63,114,463,53,53,97,117,20,34,89
"2011","Brighton and Hove 012B","E01016922","Total",523,130,61,69,393,45,60,93,84,13,24,74
"2011","Brighton and Hove 012C","E01016973","Total",648,178,110,68,470,60,77,100,120,17,30,66
"2011","Brighton and Hove 012D","E01016977","Total",618,172,91,81,446,47,71,86,101,11,44,86
"2011","Brighton and Hove 012E","E01016978","Total",716,250,101,149,466,62,55,92,136,30,25,66
"2011","Brighton and Hove 013A","E01016879","Total",558,131,67,64,427,32,49,97,94,19,47,89
"2011","Brighton and Hove 013B","E01016880","Total",495,111,46,65,384,68,46,68,59,27,34,82
"2011","Brighton and Hove 013C","E01016881","Total",605,181,97,84,424,46,53,93,93,24,44,71
"2011","Brighton and Hove 013D","E01016887","Total",619,190,100,90,429,37,93,86,98,10,29,76
"2011","Brighton and Hove 013E","E01016888","Total",587,173,127,46,414,23,70,92,88,26,41,74
"2011","Brighton and Hove 013F","E01016976","Total",623,135,81,54,488,29,97,79,103,21,56,103
"2011","Brighton and Hove 014A","E01016932","Total",687,240,63,177,447,31,37,117,130,22,31,79
"2011","Brighton and Hove 014B","E01016933","Total",635,214,57,157,421,30,34,82,168,15,28,64
"2011","Brighton and Hove 014C","E01016935","Total",813,354,157,197,459,40,62,89,181,11,18,58
"2011","Brighton and Hove 014D","E01016936","Total",684,211,25,186,473,33,27,118,159,14,18,104
"2011","Brighton and Hove 014E","E01016937","Total",1019,440,56,384,579,45,17,76,312,9,11,109
"2011","Brighton and Hove 015A","E01016890","Total",777,289,29,260,488,36,22,65,188,4,11,162
"2011","Brighton and Hove 015B","E01016966","Total",753,277,91,186,476,37,24,66,153,5,12,179
"2011","Brighton and Hove 015C","E01016970","Total",696,220,53,167,476,43,37,98,144,14,15,125
"2011","Brighton and Hove 015D","E01016971","Total",756,261,24,237,495,26,12,55,145,5,17,235
"2011","Brighton and Hove 015E","E01016972","Total",804,281,49,232,523,43,24,85,199,13,21,138
"2011","Brighton and Hove 016A","E01016979","Total",625,144,59,85,481,40,48,143,115,16,35,84
"2011","Brighton and Hove 016B","E01016990","Total",749,249,85,164,500,73,31,143,162,15,18,58
"2011","Brighton and Hove 016C","E01016991","Total",794,263,58,205,531,65,32,137,200,12,19,66
"2011","Brighton and Hove 016D","E01016996","Total",703,203,74,129,500,43,44,165,150,17,18,63
"2011","Brighton and Hove 017A","E01017007","Total",652,183,105,78,469,70,84,88,78,20,37,92
"2011","Brighton and Hove 017B","E01017008","Total",694,177,110,67,517,33,137,65,119,18,34,111
"2011","Brighton and Hove 017C","E01017009","Total",631,148,88,60,483,39,105,82,111,19,32,95
"2011","Brighton and Hove 017D","E01017010","Total",695,144,96,48,551,35,129,88,120,24,42,113
"2011","Brighton and Hove 017E","E01017011","Total",531,105,62,43,426,57,70,61,84,25,47,82
"2011","Brighton and Hove 017F","E01017012","Total",721,160,97,63,561,44,115,120,132,17,42,91
"2011","Brighton and Hove 018A","E01016892","Total",628,141,41,100,487,50,39,108,109,20,21,140
"2011","Brighton and Hove 018B","E01016893","Total",773,211,56,155,562,38,34,132,186,9,24,139
"2011","Brighton and Hove 018C","E01016912","Total",785,249,44,205,536,43,26,81,179,4,16,187
"2011","Brighton and Hove 018D","E01016913","Total",612,105,31,74,507,33,46,52,115,4,21,236
"2011","Brighton and Hove 018E","E01016946","Total",620,191,72,119,429,39,44,107,111,12,24,92
"2011","Brighton and Hove 019A","E01016860","Total",795,341,71,270,454,50,41,79,205,10,13,56
"2011","Brighton and Hove 019B","E01016871","Total",1059,552,194,358,507,52,71,61,240,4,6,73
"2011","Brighton and Hove 019C","E01016872","Total",963,433,51,382,530,46,26,101,241,8,15,93
"2011","Brighton and Hove 019D","E01016873","Total",1002,522,140,382,480,26,26,92,268,3,1,64
"2011","Brighton and Hove 019E","E01016878","Total",876,353,138,215,523,38,45,108,218,22,19,73
"2011","Brighton and Hove 020A","E01016870","Total",688,231,33,198,457,43,29,96,168,15,29,77
"2011","Brighton and Hove 020B","E01016874","Total",1032,538,220,318,494,36,74,108,220,5,9,42
"2011","Brighton and Hove 020C","E01016875","Total",600,149,37,112,451,19,26,129,138,26,33,80
"2011","Brighton and Hove 020D","E01016876","Total",816,363,106,257,453,37,36,85,197,12,8,78
"2011","Brighton and Hove 020E","E01016877","Total",919,399,130,269,520,48,66,86,238,8,19,55
"2011","Brighton and Hove 021A","E01016974","Total",706,227,86,141,479,52,48,125,124,15,31,84
"2011","Brighton and Hove 021B","E01016975","Total",592,145,55,90,447,44,56,99,107,22,41,78
"2011","Brighton and Hove 021C","E01016992","Total",659,197,111,86,462,18,75,133,112,19,24,81
"2011","Brighton and Hove 021D","E01016994","Total",730,242,66,176,488,55,44,127,144,18,20,80
"2011","Brighton and Hove 021E","E01016997","Total",631,182,82,100,449,19,58,133,109,23,24,83
"2011","Brighton and Hove 022A","E01016889","Total",761,265,80,185,496,25,35,100,145,9,11,171
"2011","Brighton and Hove 022B","E01016891","Total",805,328,64,264,477,42,30,70,173,9,16,137
"2011","Brighton and Hove 022C","E01016894","Total",709,229,55,174,480,56,26,68,169,4,19,138
"2011","Brighton and Hove 022D","E01016896","Total",700,176,37,139,524,38,13,117,175,9,11,161
"2011","Brighton and Hove 022E","E01016897","Total",761,238,59,179,523,39,34,127,190,9,13,111
"2011","Brighton and Hove 023A","E01016987","Total",761,273,99,174,488,31,64,110,153,25,26,79
"2011","Brighton and Hove 023B","E01016989","Total",744,321,114,207,423,26,62,85,152,13,18,67
"2011","Brighton and Hove 023C","E01016993","Total",754,359,179,180,395,42,81,92,111,7,15,47
"2011","Brighton and Hove 023D","E01016995","Total",648,164,78,86,484,21,81,126,117,28,39,72
"2011","Brighton and Hove 024A","E01016938","Total",911,374,58,316,537,35,27,84,288,7,16,80
"2011","Brighton and Hove 024B","E01016950","Total",1029,516,126,390,513,36,37,61,329,8,2,40
"2011","Brighton and Hove 024C","E01016951","Total",883,496,101,395,387,23,30,46,241,6,7,34
"2011","Brighton and Hove 024D","E01016967","Total",1109,551,43,508,558,35,26,60,346,5,8,78
"2011","Brighton and Hove 024E","E01016968","Total",924,462,44,418,462,23,6,57,302,4,3,67
"2011","Brighton and Hove 025A","E01016864","Total",584,155,80,75,429,36,104,59,85,22,36,87
"2011","Brighton and Hove 025B","E01016865","Total",578,136,44,92,442,82,35,95,74,29,43,84
"2011","Brighton and Hove 025C","E01016866","Total",542,141,47,94,401,67,42,64,66,33,49,80
"2011","Brighton and Hove 025D","E01016867","Total",661,265,75,190,396,79,37,79,97,12,28,64
"2011","Brighton and Hove 025E","E01016868","Total",707,304,92,212,403,96,37,60,85,18,46,61
"2011","Brighton and Hove 025F","E01016895","Total",587,150,63,87,437,52,65,66,96,29,54,75
"2011","Brighton and Hove 026A","E01016849","Total",893,442,82,360,451,25,35,58,256,3,7,67
"2011","Brighton and Hove 026B","E01016852","Total",964,505,64,441,459,31,19,53,299,3,0,54
"2011","Brighton and Hove 026C","E01016853","Total",1113,557,104,453,556,45,24,79,345,3,5,55
"2011","Brighton and Hove 026D","E01016855","Total",1021,502,75,427,519,31,19,67,351,3,7,41
"2011","Brighton and Hove 026E","E01016856","Total",981,559,204,355,422,21,45,65,217,1,7,66
"2011","Brighton and Hove 027A","E01016952","Total",805,345,37,308,460,24,18,35,253,1,7,122
"2011","Brighton and Hove 027B","E01016953","Total",866,389,75,314,477,23,49,62,247,5,7,84
"2011","Brighton and Hove 027C","E01016964","Total",1015,474,83,391,541,41,35,53,225,5,12,170
"2011","Brighton and Hove 027E","E01016969","Total",1037,443,133,310,594,56,34,60,293,5,10,136
"2011","Brighton and Hove 027F","E01033328","Total",717,286,70,216,431,27,24,53,209,8,11,99
"2011","Brighton and Hove 027G","E01033329","Total",798,269,16,253,529,45,21,89,235,3,8,128
"2011","Brighton and Hove 028A","E01016857","Total",811,395,83,312,416,28,50,62,213,6,10,47
"2011","Brighton and Hove 028B","E01016858","Total",878,475,89,386,403,28,45,57,239,5,4,25
"2011","Brighton and Hove 028C","E01016859","Total",891,483,198,285,408,22,95,54,187,1,3,46
"2011","Brighton and Hove 028D","E01016986","Total",841,404,136,268,437,34,78,78,182,4,10,51
"2011","Brighton and Hove 028E","E01016988","Total",737,363,121,242,374,30,38,86,141,15,16,48
"2011","Brighton and Hove 029A","E01016850","Total",912,384,61,323,528,41,21,55,286,4,11,110
"2011","Brighton and Hove 029B","E01016851","Total",992,480,78,402,512,27,19,70,322,1,8,65
"2011","Brighton and Hove 029C","E01016854","Total",1001,531,60,471,470,56,19,48,298,0,5,44
"2011","Brighton and Hove 029D","E01016954","Total",1110,606,78,528,504,18,28,50,348,4,5,51
"2011","Brighton and Hove 029E","E01016955","Total",1037,548,76,472,489,31,37,38,294,3,3,83
"2011","Brighton and Hove 030A","E01016941","Total",1118,574,134,440,544,28,54,33,310,1,14,104
"2011","Brighton and Hove 030B","E01016945","Total",981,553,66,487,428,30,13,18,287,3,4,73
"2011","Brighton and Hove 030C","E01016947","Total",900,458,103,355,442,74,42,54,183,5,13,71
"2011","Brighton and Hove 030D","E01016948","Total",780,273,52,221,507,72,38,92,164,13,27,101
"2011","Brighton and Hove 030E","E01016949","Total",911,489,166,323,422,39,47,63,164,5,9,95
"2011","Brighton and Hove 031A","E01016861","Total",907,416,59,357,491,20,52,58,298,2,11,50
"2011","Brighton and Hove 031B","E01016862","Total",845,408,144,264,437,15,43,64,237,4,8,66
"2011","Brighton and Hove 031C","E01016942","Total",1114,807,527,280,307,23,122,20,102,3,6,31
"2011","Brighton and Hove 031D","E01016943","Total",696,224,47,177,472,54,23,110,167,15,18,85
"2011","Brighton and Hove 031E","E01016944","Total",862,445,53,392,417,21,21,47,235,6,11,76
"2011","Brighton and Hove 032A","E01016863","Total",928,488,174,314,440,69,65,58,170,1,13,64
"2011","Brighton and Hove 032B","E01016869","Total",809,281,106,175,528,44,73,89,172,15,24,111
"2011","Brighton and Hove 032C","E01016957","Total",889,453,124,329,436,25,79,41,222,6,9,54
"2011","Brighton and Hove 032D","E01016963","Total",958,374,111,263,584,48,64,100,261,11,13,87
"2011","Brighton and Hove 033A","E01016956","Total",717,232,133,99,485,36,122,81,140,12,25,69
"2011","Brighton and Hove 033B","E01016958","Total",821,271,173,98,550,29,159,99,155,13,15,80
"2011","Brighton and Hove 033C","E01016959","Total",619,185,111,74,434,11,122,67,118,13,29,74
"2011","Brighton and Hove 033D","E01016960","Total",829,307,175,132,522,52,136,83,140,18,34,59
"2011","Brighton and Hove 033E","E01016961","Total",792,271,101,170,521,26,103,115,160,6,28,83
"2011","Brighton and Hove 033F","E01016962","Total",734,201,118,83,533,21,152,98,140,13,29,80
"2011","Isle of Wight 001A","E01017300","Total",1200,576,286,290,624,40,181,79,213,25,23,63
"2011","Isle of Wight 001B","E01017303","Total",550,192,68,124,358,15,52,73,126,12,23,57
"2011","Isle of Wight 001C","E01017305","Total",652,269,80,189,383,45,47,84,127,17,21,42
"2011","Isle of Wight 001D","E01017306","Total",553,148,47,101,405,43,58,83,108,18,37,58
"2011","Isle of Wight 001E","E01017309","Total",714,218,75,143,496,44,72,126,142,19,30,63
"2011","Isle of Wight 002A","E01017301","Total",488,158,107,51,330,11,138,54,60,10,18,39
"2011","Isle of Wight 002B","E01017302","Total",671,144,66,78,527,25,122,114,120,33,31,82
"2011","Isle of Wight 002C","E01017304","Total",560,148,69,79,412,35,52,102,110,16,27,70
"2011","Isle of Wight 002D","E01017316","Total",819,315,170,145,504,25,146,86,141,9,32,65
"2011","Isle of Wight 002E","E01017329","Total",978,237,167,70,741,21,219,126,180,19,60,116
"2011","Isle of Wight 003A","E01017307","Total",902,263,137,126,639,30,220,79,188,14,34,74
"2011","Isle of Wight 003B","E01017308","Total",739,224,111,113,515,50,89,90,147,22,37,80
"2011","Isle of Wight 003D","E01033229","Total",647,209,126,83,438,16,147,64,124,11,24,52
"2011","Isle of Wight 003E","E01033237","Total",559,167,82,85,392,47,69,76,95,21,31,53
"2011","Isle of Wight 004A","E01017335","Total",765,360,137,223,405,44,64,81,128,9,24,55
"2011","Isle of Wight 004B","E01017336","Total",847,424,101,323,423,64,57,64,169,3,18,48
"2011","Isle of Wight 004C","E01017337","Total",797,381,110,271,416,36,71,68,151,12,25,53
"2011","Isle of Wight 004D","E01017346","Total",740,324,100,224,416,50,74,76,134,9,16,57
"2011","Isle of Wight 005A","E01017286","Total",694,184,116,68,510,12,198,62,130,11,28,69
"2011","Isle of Wight 005B","E01017287","Total",746,220,136,84,526,26,146,90,146,14,27,77
"2011","Isle of Wight 005C","E01017367","Total",861,252,178,74,609,15,240,75,151,12,39,77
"2011","Isle of Wight 005D","E01017368","Total",717,254,155,99,463,27,119,87,122,24,28,56
"2011","Isle of Wight 006A","E01017282","Total",590,162,79,83,428,39,86,73,109,16,33,72
"2011","Isle of Wight 006B","E01017283","Total",667,196,92,104,471,25,112,87,126,12,36,73
"2011","Isle of Wight 006C","E01017338","Total",625,221,131,90,404,30,125,59,91,9,25,65
"2011","Isle of Wight 006D","E01017341","Total",660,187,100,87,473,40,122,102,101,13,33,62
"2011","Isle of Wight 006E","E01017342","Total",726,211,83,128,515,69,93,100,126,24,36,67
"2011","Isle of Wight 007A","E01017339","Total",671,185,83,102,486,36,87,117,113,14,42,77
"2011","Isle of Wight 007B","E01017340","Total",799,291,122,169,508,77,63,129,115,17,36,71
"2011","Isle of Wight 007C","E01017343","Total",575,201,92,109,374,27,63,84,94,16,28,62
"2011","Isle of Wight 007D","E01017344","Total",729,214,119,95,515,19,156,77,141,16,25,81
"2011","Isle of Wight 007E","E01017345","Total",836,241,55,186,595,116,68,114,161,42,38,56
"2011","Isle of Wight 008A","E01017310","Total",520,140,97,43,380,10,105,42,100,12,42,69
"2011","Isle of Wight 008B","E01017311","Total",713,239,93,146,474,40,108,77,153,8,21,67
"2011","Isle of Wight 008C","E01017331","Total",671,251,116,135,420,58,90,67,103,18,24,60
"2011","Isle of Wight 008D","E01017332","Total",535,163,82,81,372,32,69,72,77,24,28,70
"2011","Isle of Wight 008E","E01017334","Total",478,105,40,65,373,17,69,72,102,21,26,66
"2011","Isle of Wight 009A","E01017295","Total",539,139,51,88,400,43,67,93,109,13,19,56
"2011","Isle of Wight 009B","E01017325","Total",612,232,102,130,380,42,69,74,103,10,29,53
"2011","Isle of Wight 009C","E01017326","Total",843,402,160,242,441,73,68,68,156,9,22,45
"2011","Isle of Wight 009D","E01017328","Total",667,264,86,178,403,68,55,81,110,16,21,52
"2011","Isle of Wight 009E","E01017333","Total",659,120,48,72,539,37,76,131,109,25,56,105
"2011","Isle of Wight 010A","E01017284","Total",783,262,175,87,521,18,216,63,120,23,22,59
"2011","Isle of Wight 010B","E01017285","Total",920,344,231,113,576,20,249,54,122,13,29,89
"2011","Isle of Wight 010C","E01017288","Total",590,221,124,97,369,9,110,54,111,11,23,51
"2011","Isle of Wight 010D","E01017351","Total",679,250,136,114,429,19,152,57,98,16,28,59
"2011","Isle of Wight 010E","E01017352","Total",577,194,152,42,383,9,175,33,92,6,16,52
"2011","Isle of Wight 011A","E01017292","Total",665,164,70,94,501,55,103,80,121,12,41,89
"2011","Isle of Wight 011B","E01017293","Total",771,161,87,74,610,43,109,146,138,33,43,98
"2011","Isle of Wight 011C","E01017296","Total",527,127,69,58,400,15,116,60,104,6,26,73
"2011","Isle of Wight 011D","E01017321","Total",494,128,81,47,366,14,110,49,93,8,25,67
"2011","Isle of Wight 011E","E01017322","Total",609,176,85,91,433,55,66,59,111,19,44,79
"2011","Isle of Wight 011F","E01017327","Total",684,189,98,91,495,43,96,90,120,27,40,79
"2011","Isle of Wight 012A","E01017312","Total",767,310,163,147,457,37,142,60,122,13,28,55
"2011","Isle of Wight 012D","E01017315","Total",685,236,143,93,449,31,149,66,83,17,40,63
"2011","Isle of Wight 012E","E01017354","Total",590,226,141,85,364,23,134,44,101,12,18,32
"2011","Isle of Wight 012F","E01017361","Total",637,194,129,65,443,23,185,45,109,7,16,58
"2011","Isle of Wight 012G","E01017362","Total",661,215,102,113,446,39,124,63,115,13,22,70
"2011","Isle of Wight 012H","E01033239","Total",1135,383,257,126,752,31,327,64,181,16,21,112
"2011","Isle of Wight 013A","E01017290","Total",588,148,72,76,440,11,149,51,133,8,24,64
"2011","Isle of Wight 013B","E01017291","Total",563,178,134,44,385,12,158,39,94,8,19,55
"2011","Isle of Wight 013C","E01017294","Total",657,167,77,90,490,22,116,75,142,17,41,77
"2011","Isle of Wight 013D","E01017353","Total",542,127,77,50,415,12,123,55,137,11,25,52
"2011","Isle of Wight 014A","E01017289","Total",910,252,141,111,658,33,194,83,182,18,41,107
"2011","Isle of Wight 014B","E01017347","Total",724,223,109,114,501,37,141,80,123,19,22,79
"2011","Isle of Wight 014C","E01017348","Total",538,168,67,101,370,29,78,66,77,11,43,66
"2011","Isle of Wight 014D","E01017349","Total",936,311,127,184,625,70,122,104,177,12,54,86
"2011","Isle of Wight 014E","E01017350","Total",802,219,84,135,583,76,122,116,136,21,46,66
"2011","Isle of Wight 015A","E01017317","Total",672,193,116,77,479,39,125,75,114,10,38,78
"2011","Isle of Wight 015B","E01017320","Total",557,202,157,45,355,13,149,41,83,7,12,50
"2011","Isle of Wight 015C","E01017323","Total",510,114,65,49,396,5,141,50,112,8,22,58
"2011","Isle of Wight 015D","E01017324","Total",622,147,75,72,475,24,121,68,142,16,25,79
"2011","Isle of Wight 015E","E01017355","Total",663,177,102,75,486,31,132,66,123,13,27,94
"2011","Isle of Wight 015F","E01017358","Total",589,183,125,58,406,22,164,42,74,12,26,66
"2011","Isle of Wight 016A","E01017318","Total",522,158,72,86,364,46,80,70,76,12,26,54
"2011","Isle of Wight 016B","E01017319","Total",670,305,215,90,365,19,134,42,80,9,26,55
"2011","Isle of Wight 016C","E01017356","Total",686,290,126,164,396,50,77,56,112,12,27,62
"2011","Isle of Wight 016D","E01017357","Total",645,214,128,86,431,32,110,57,96,12,39,85
"2011","Isle of Wight 016E","E01017359","Total",685,240,118,122,445,17,147,52,129,6,28,66
"2011","Isle of Wight 016F","E01017360","Total",812,346,130,216,466,57,107,68,143,15,14,62
"2011","Isle of Wight 017A","E01017297","Total",606,149,88,61,457,24,130,71,114,13,39,66
"2011","Isle of Wight 017B","E01017298","Total",681,189,133,56,492,11,164,65,139,17,25,71
"2011","Isle of Wight 017C","E01017299","Total",546,150,69,81,396,18,116,47,110,7,28,70
"2011","Isle of Wight 017D","E01017369","Total",631,171,102,69,460,17,143,68,113,20,35,64
"2011","Isle of Wight 018A","E01017363","Total",813,392,147,245,421,59,81,58,139,10,19,55
"2011","Isle of Wight 018B","E01017364","Total",699,282,116,166,417,24,121,50,99,29,29,65
"2011","Isle of Wight 018C","E01017365","Total",711,251,163,88,460,8,230,37,101,6,16,62
"2011","Isle of Wight 018D","E01017366","Total",623,170,74,96,453,42,92,74,115,21,30,79
"2011","Isle of Wight 018E","E01017370","Total",794,230,148,82,564,26,180,81,136,9,33,99
"2011","Medway 001A","E01016070","Total",731,230,108,122,501,29,120,73,147,12,45,75
"2011","Medway 001B","E01016071","Total",630,140,56,84,490,34,75,79,145,31,56,70
"2011","Medway 001C","E01016072","Total",525,136,61,75,389,23,71,59,110,19,32,75
"2011","Medway 001D","E01016074","Total",838,328,168,160,510,22,172,61,151,13,28,63
"2011","Medway 002A","E01016142","Total",491,97,43,54,394,9,67,83,111,14,32,78
"2011","Medway 002B","E01016144","Total",575,114,56,58,461,14,90,67,127,21,40,102
"2011","Medway 002C","E01016145","Total",485,78,25,53,407,19,51,110,104,22,21,80
"2011","Medway 002D","E01016149","Total",586,166,79,87,420,33,71,84,103,21,41,67
"2011","Medway 003A","E01016073","Total",794,162,79,83,632,18,138,127,153,17,50,129
"2011","Medway 003B","E01016075","Total",576,131,78,53,445,16,110,85,106,15,37,76
"2011","Medway 003C","E01016076","Total",920,188,87,101,732,44,125,146,181,37,64,135
"2011","Medway 003D","E01016077","Total",634,202,108,94,432,29,91,79,117,12,39,65
"2011","Medway 003E","E01016143","Total",949,247,79,168,702,65,82,198,191,32,47,87
"2011","Medway 004A","E01016146","Total",852,252,142,110,600,48,114,123,163,16,49,87
"2011","Medway 004B","E01016147","Total",738,172,102,70,566,17,124,109,125,30,43,118
"2011","Medway 004C","E01016148","Total",731,126,53,73,605,21,112,136,150,20,52,114
"2011","Medway 005A","E01016133","Total",539,103,64,39,436,5,125,59,104,15,37,91
"2011","Medway 005B","E01016134","Total",526,90,41,49,436,26,76,81,103,22,41,87
"2011","Medway 005C","E01016138","Total",592,124,78,46,468,15,121,70,108,13,39,102
"2011","Medway 005D","E01016139","Total",616,113,62,51,503,26,81,106,110,26,56,98
"2011","Medway 006A","E01016135","Total",624,160,73,87,464,45,70,91,130,13,34,81
"2011","Medway 006B","E01016136","Total",624,191,78,113,433,53,56,96,106,20,33,69
"2011","Medway 006C","E01016137","Total",614,152,39,113,462,45,42,103,130,21,42,79
"2011","Medway 006D","E01016140","Total",596,199,45,154,397,36,38,71,147,17,30,58
"2011","Medway 006E","E01016141","Total",723,256,81,175,467,62,33,114,128,18,38,74
"2011","Medway 007A","E01016035","Total",737,223,49,174,514,85,26,107,134,17,54,91
"2011","Medway 007D","E01016112","Total",1162,271,42,229,891,65,78,256,304,33,33,122
"2011","Medway 007E","E01032798","Total",1228,476,128,348,752,66,70,197,242,27,47,103
"2011","Medway 008A","E01016151","Total",623,126,55,71,497,14,96,101,122,20,51,93
"2011","Medway 008B","E01016152","Total",632,207,103,104,425,44,86,66,83,17,33,96
"2011","Medway 008C","E01016153","Total",607,205,89,116,402,57,60,68,90,24,32,71
"2011","Medway 008D","E01016155","Total",619,156,75,81,463,41,88,82,98,14,36,104
"2011","Medway 009A","E01016033","Total",474,167,54,113,307,39,47,57,62,17,27,58
"2011","Medway 009B","E01016036","Total",715,205,48,157,510,55,58,84,125,14,35,139
"2011","Medway 009C","E01016037","Total",665,193,45,148,472,66,33,88,114,11,41,119
"2011","Medway 009D","E01016039","Total",692,225,54,171,467,49,37,115,121,18,34,93
"2011","Medway 010A","E01016030","Total",696,169,44,125,527,76,54,124,119,24,54,76
"2011","Medway 010B","E01016032","Total",466,103,40,63,363,64,21,61,75,37,47,58
"2011","Medway 010C","E01016034","Total",1035,294,79,215,741,55,82,175,201,34,78,116
"2011","Medway 010D","E01016038","Total",586,142,63,79,444,53,57,81,116,21,34,82
"2011","Medway 011A","E01016150","Total",607,155,54,101,452,57,35,98,100,33,46,83
"2011","Medway 011B","E01016154","Total",648,205,65,140,443,39,50,89,112,21,50,82
"2011","Medway 011C","E01016156","Total",659,147,33,114,512,56,48,146,127,26,26,83
"2011","Medway 011D","E01016157","Total",778,179,85,94,599,48,90,134,159,19,43,106
"2011","Medway 011E","E01016158","Total",880,239,92,147,641,42,96,151,176,35,51,90
"2011","Medway 012A","E01016031","Total",859,381,126,255,478,102,29,114,131,17,21,64
"2011","Medway 012B","E01016041","Total",714,223,47,176,491,51,50,100,156,18,33,83
"2011","Medway 012C","E01016045","Total",630,165,46,119,465,39,44,107,97,27,42,109
"2011","Medway 012D","E01016049","Total",876,347,87,260,529,86,40,105,161,19,40,78
"2011","Medway 013A","E01016040","Total",681,197,64,133,484,39,60,86,102,33,60,104
"2011","Medway 013B","E01016042","Total",570,149,34,115,421,54,38,105,95,23,33,73
"2011","Medway 013C","E01016043","Total",561,157,83,74,404,18,61,77,96,26,32,94
"2011","Medway 013D","E01016177","Total",625,166,62,104,459,48,58,107,99,18,30,99
"2011","Medway 013E","E01016178","Total",555,138,58,80,417,29,60,99,86,25,42,76
"2011","Medway 014A","E01016117","Total",867,401,110,291,466,67,25,79,177,23,22,73
"2011","Medway 014B","E01016129","Total",948,367,58,309,581,86,46,132,227,14,18,58
"2011","Medway 014C","E01016130","Total",920,410,128,282,510,32,83,81,192,14,28,80
"2011","Medway 014D","E01016131","Total",783,305,173,132,478,25,86,103,122,20,36,86
"2011","Medway 015A","E01016016","Total",650,230,63,167,420,33,42,84,119,20,38,84
"2011","Medway 015B","E01016017","Total",750,345,72,273,405,29,47,60,139,12,29,89
"2011","Medway 015C","E01016019","Total",657,163,37,126,494,58,26,120,112,27,64,87
"2011","Medway 015D","E01016110","Total",955,469,98,371,486,47,36,60,207,5,21,110
"2011","Medway 015E","E01016111","Total",568,269,109,160,299,26,32,87,85,13,22,34
"2011","Medway 016A","E01016044","Total",673,193,53,140,480,56,43,101,128,16,44,92
"2011","Medway 016B","E01016046","Total",632,197,49,148,435,36,45,92,127,17,39,79
"2011","Medway 016C","E01016047","Total",649,179,64,115,470,40,32,116,120,30,36,96
"2011","Medway 016D","E01016048","Total",683,204,66,138,479,42,47,118,120,24,44,84
"2011","Medway 017A","E01016113","Total",598,152,58,94,446,27,81,91,107,18,33,89
"2011","Medway 017B","E01016114","Total",656,206,57,149,450,47,34,85,143,16,39,86
"2011","Medway 017C","E01016115","Total",765,171,68,103,594,71,85,130,148,29,48,83
"2011","Medway 017D","E01016118","Total",752,224,75,149,528,43,57,103,172,18,38,97
"2011","Medway 018A","E01016160","Total",612,191,103,88,421,39,89,80,66,17,35,95
"2011","Medway 018B","E01016161","Total",743,317,179,138,426,49,84,65,109,16,28,75
"2011","Medway 018C","E01016162","Total",648,163,83,80,485,27,80,96,122,23,47,90
"2011","Medway 018D","E01016163","Total",505,103,56,47,402,28,70,73,87,14,40,90
"2011","Medway 018E","E01016164","Total",646,198,122,76,448,47,101,72,94,21,35,78
"2011","Medway 018F","E01016165","Total",520,125,72,53,395,22,90,56,88,17,40,82
"2011","Medway 019A","E01016159","Total",512,106,44,62,406,75,55,83,71,18,35,69
"2011","Medway 019B","E01016174","Total",514,130,45,85,384,14,43,77,96,5,50,99
"2011","Medway 019C","E01016175","Total",707,150,70,80,557,20,119,100,125,19,58,116
"2011","Medway 019D","E01016179","Total",505,92,57,35,413,12,79,80,87,16,40,99
"2011","Medway 020A","E01016061","Total",694,225,37,188,469,52,33,100,123,22,41,98
"2011","Medway 020B","E01016063","Total",741,314,99,215,427,56,46,79,110,26,36,74
"2011","Medway 020C","E01016064","Total",701,291,92,199,410,63,54,70,106,28,28,61
"2011","Medway 020D","E01016069","Total",764,280,38,242,484,56,32,129,114,30,36,87
"2011","Medway 021A","E01016020","Total",506,156,54,102,350,28,45,87,87,18,24,61
"2011","Medway 021B","E01016021","Total",595,167,63,104,428,34,52,101,93,10,39,99
"2011","Medway 021C","E01016022","Total",507,115,34,81,392,33,36,76,80,21,41,105
"2011","Medway 021D","E01016125","Total",646,155,46,109,491,30,63,99,119,16,65,99
"2011","Medway 022A","E01016018","Total",754,199,56,143,555,79,35,136,135,35,49,86
"2011","Medway 022B","E01016023","Total",603,136,62,74,467,86,46,86,84,41,47,77
"2011","Medway 022C","E01016024","Total",768,197,52,145,571,79,40,148,153,25,52,74
"2011","Medway 022D","E01016062","Total",594,166,39,127,428,58,58,84,101,17,41,69
"2011","Medway 023A","E01016093","Total",665,164,116,48,501,6,156,90,119,13,29,88
"2011","Medway 023B","E01016096","Total",633,192,138,54,441,19,131,66,110,8,25,82
"2011","Medway 023C","E01016166","Total",580,126,73,53,454,22,106,92,103,6,40,85
"2011","Medway 023D","E01016167","Total",576,143,82,61,433,30,98,73,94,17,32,89
"2011","Medway 024A","E01016116","Total",757,220,111,109,537,45,108,107,113,23,51,90
"2011","Medway 024B","E01016127","Total",705,257,103,154,448,43,83,89,127,17,27,62
"2011","Medway 024C","E01016128","Total",545,142,80,62,403,35,97,65,95,9,28,74
"2011","Medway 024D","E01016132","Total",640,137,56,81,503,21,104,109,111,12,47,99
"2011","Medway 025A","E01016094","Total",616,157,84,73,459,23,99,91,121,13,34,78
"2011","Medway 025B","E01016095","Total",523,123,44,79,400,29,48,105,119,18,25,56
"2011","Medway 025C","E01016097","Total",637,225,87,138,412,37,59,79,115,23,20,79
"2011","Medway 025D","E01016098","Total",682,289,146,143,393,50,56,78,127,13,19,50
"2011","Medway 025E","E01016102","Total",620,205,95,110,415,48,70,60,87,15,34,101
"2011","Medway 026A","E01016119","Total",532,96,52,44,436,13,96,82,81,10,55,99
"2011","Medway 026B","E01016120","Total",596,196,117,79,400,34,95,63,82,15,35,76
"2011","Medway 026C","E01016124","Total",673,178,89,89,495,22,100,107,126,17,35,88
"2011","Medway 026D","E01016126","Total",613,118,67,51,495,24,78,98,111,25,58,101
"2011","Medway 027A","E01016025","Total",629,214,120,94,415,29,92,74,80,27,37,76
"2011","Medway 027B","E01016065","Total",635,212,86,126,423,19,97,69,117,14,38,69
"2011","Medway 027C","E01016066","Total",608,187,63,124,421,35,71,68,94,23,39,91
"2011","Medway 027D","E01016067","Total",651,188,88,100,463,31,77,89,105,14,55,92
"2011","Medway 027E","E01016068","Total",667,194,80,114,473,72,54,108,96,25,39,79
"2011","Medway 028A","E01016026","Total",506,125,37,88,381,20,42,110,122,17,22,48
"2011","Medway 028B","E01016027","Total",572,84,54,30,488,10,107,100,114,26,29,102
"2011","Medway 028C","E01016028","Total",598,178,113,65,420,13,109,79,114,9,25,71
"2011","Medway 028D","E01016029","Total",535,144,58,86,391,25,61,72,114,18,35,66
"2011","Medway 029A","E01016087","Total",694,172,88,84,522,25,112,101,138,14,36,96
"2011","Medway 029B","E01016088","Total",597,139,74,65,458,22,81,82,117,19,41,96
"2011","Medway 029C","E01016089","Total",667,211,131,80,456,18,97,78,109,19,41,94
"2011","Medway 029D","E01016090","Total",609,140,103,37,469,17,115,97,98,7,36,99
"2011","Medway 030A","E01016085","Total",646,117,75,42,529,10,180,83,109,14,32,101
"2011","Medway 030B","E01016086","Total",499,105,75,30,394,6,89,65,86,13,33,102
"2011","Medway 030C","E01016091","Total",614,123,86,37,491,11,137,73,115,13,40,102
"2011","Medway 030D","E01016176","Total",575,98,44,54,477,15,84,78,134,17,45,104
"2011","Medway 031A","E01016058","Total",622,161,49,112,461,22,73,85,159,17,34,71
"2011","Medway 031B","E01016059","Total",532,157,73,84,375,33,40,92,91,19,37,63
"2011","Medway 031C","E01016079","Total",488,94,34,60,394,16,48,75,97,20,51,87
"2011","Medway 031D","E01016083","Total",570,201,89,112,369,46,49,72,85,15,38,64
"2011","Medway 031E","E01016084","Total",513,95,26,69,418,40,36,93,85,31,53,80
"2011","Medway 032A","E01016101","Total",565,122,46,76,443,26,49,116,117,23,33,79
"2011","Medway 032B","E01016103","Total",575,119,46,73,456,20,69,108,122,10,29,98
"2011","Medway 032C","E01016104","Total",566,111,31,80,455,23,49,108,154,18,25,78
"2011","Medway 032D","E01016107","Total",602,130,44,86,472,25,49,103,148,19,37,91
"2011","Medway 033A","E01016121","Total",640,154,104,50,486,27,141,80,123,12,33,70
"2011","Medway 033B","E01016122","Total",617,151,86,65,466,18,115,78,114,12,45,84
"2011","Medway 033C","E01016123","Total",635,158,80,78,477,26,91,86,111,15,44,104
"2011","Medway 033D","E01016173","Total",648,195,70,125,453,40,86,79,110,21,45,72
"2011","Medway 034A","E01016078","Total",658,190,14,176,468,42,19,165,170,11,20,41
"2011","Medway 034B","E01016080","Total",620,153,66,87,467,36,64,129,137,10,30,61
"2011","Medway 034C","E01016081","Total",567,87,15,72,480,33,28,124,137,27,54,77
"2011","Medway 034D","E01016082","Total",580,89,23,66,491,21,73,110,124,22,42,99
"2011","Medway 035A","E01016050","Total",666,125,62,63,541,14,110,92,163,19,43,100
"2011","Medway 035B","E01016051","Total",592,130,49,81,462,21,72,116,114,21,36,82
"2011","Medway 035C","E01016052","Total",648,108,72,36,540,12,153,84,121,16,44,110
"2011","Medway 035D","E01016053","Total",637,154,113,41,483,11,146,63,114,13,32,104
"2011","Medway 035E","E01016054","Total",596,141,70,71,455,16,89,76,114,10,42,108
"2011","Medway 036A","E01016092","Total",630,150,73,77,480,14,124,88,102,18,35,99
"2011","Medway 036B","E01016099","Total",621,147,52,95,474,49,59,115,129,15,31,76
"2011","Medway 036C","E01016100","Total",657,184,94,90,473,48,74,92,127,10,23,99
"2011","Medway 036D","E01016105","Total",592,176,102,74,416,17,103,73,91,14,34,84
"2011","Medway 036E","E01016106","Total",591,139,81,58,452,37,114,92,93,16,27,73
"2011","Medway 037A","E01016168","Total",658,188,99,89,470,30,99,83,113,19,30,96
"2011","Medway 037B","E01016169","Total",638,121,52,69,517,20,95,96,116,17,49,124
"2011","Medway 037C","E01016171","Total",638,158,86,72,480,52,94,88,104,25,40,77
"2011","Medway 037D","E01016172","Total",587,139,86,53,448,19,96,81,115,17,34,86
"2011","Medway 038A","E01016055","Total",651,196,110,86,455,30,92,86,97,13,33,104
"2011","Medway 038B","E01016056","Total",630,207,61,146,423,48,34,96,153,12,28,52
"2011","Medway 038C","E01016057","Total",642,117,38,79,525,50,62,128,124,15,45,101
"2011","Medway 038D","E01016060","Total",628,123,75,48,505,8,125,85,112,16,46,113
"2011","Medway 038E","E01016170","Total",634,137,52,85,497,46,80,107,115,15,59,75
"2011","Milton Keynes 001A","E01016796","Total",657,201,96,105,456,18,96,90,139,21,16,76
"2011","Milton Keynes 001B","E01016797","Total",810,288,152,136,522,19,117,113,160,22,24,67
"2011","Milton Keynes 001C","E01016798","Total",731,144,63,81,587,25,83,162,155,26,45,91
"2011","Milton Keynes 001D","E01016799","Total",778,200,106,94,578,17,111,148,170,28,26,78
"2011","Milton Keynes 001E","E01016800","Total",694,179,75,104,515,20,108,116,157,24,28,62
"2011","Milton Keynes 002A","E01016759","Total",582,160,71,89,422,31,72,94,125,17,20,63
"2011","Milton Keynes 002B","E01016760","Total",975,213,76,137,762,51,97,184,264,28,50,88
"2011","Milton Keynes 002C","E01016761","Total",568,117,51,66,451,16,105,79,144,15,22,70
"2011","Milton Keynes 002D","E01016801","Total",565,129,73,56,436,18,117,81,109,13,22,76
"2011","Milton Keynes 002E","E01016802","Total",569,129,59,70,440,12,104,80,129,18,33,64
"2011","Milton Keynes 002F","E01016803","Total",547,116,63,53,431,14,100,94,126,7,27,63
"2011","Milton Keynes 003A","E01016786","Total",625,156,105,51,469,19,128,68,133,14,23,84
"2011","Milton Keynes 003B","E01016787","Total",660,199,105,94,461,40,81,83,121,19,35,82
"2011","Milton Keynes 003C","E01016788","Total",611,99,42,57,512,24,64,106,157,13,35,113
"2011","Milton Keynes 003D","E01016789","Total",502,87,13,74,415,29,29,112,128,10,36,71
"2011","Milton Keynes 003E","E01016790","Total",527,103,65,38,424,13,96,71,113,9,36,86
"2011","Milton Keynes 004A","E01016791","Total",595,149,88,61,446,24,85,78,122,12,30,95
"2011","Milton Keynes 004B","E01016792","Total",525,128,38,90,397,20,42,98,123,16,30,68
"2011","Milton Keynes 004C","E01016793","Total",792,195,85,110,597,28,84,147,186,16,41,95
"2011","Milton Keynes 004D","E01016794","Total",691,242,88,154,449,30,65,93,154,11,12,84
"2011","Milton Keynes 004E","E01016795","Total",686,204,67,137,482,33,51,108,172,11,24,83
"2011","Milton Keynes 005A","E01016762","Total",517,129,50,79,388,25,65,69,111,17,30,71
"2011","Milton Keynes 005B","E01016764","Total",604,143,59,84,461,19,81,80,154,8,24,95
"2011","Milton Keynes 005C","E01016766","Total",536,120,65,55,416,34,56,67,126,19,29,85
"2011","Milton Keynes 005D","E01016767","Total",521,93,43,50,428,12,64,90,132,5,29,96
"2011","Milton Keynes 005E","E01016771","Total",491,126,58,68,365,28,50,67,84,21,42,73
"2011","Milton Keynes 006A","E01016806","Total",697,175,58,117,522,58,38,107,122,46,59,92
"2011","Milton Keynes 006B","E01016807","Total",678,167,70,97,511,36,66,92,144,23,52,98
"2011","Milton Keynes 006C","E01016809","Total",517,105,37,68,412,58,57,61,83,17,46,90
"2011","Milton Keynes 006D","E01016835","Total",677,202,80,122,475,74,48,93,119,21,37,83
"2011","Milton Keynes 007A","E01016763","Total",632,223,109,114,409,13,79,59,153,9,27,69
"2011","Milton Keynes 007B","E01016769","Total",581,160,71,89,421,19,60,90,132,15,26,79
"2011","Milton Keynes 007C","E01016770","Total",675,186,57,129,489,31,59,107,143,9,44,96
"2011","Milton Keynes 007D","E01016773","Total",797,243,175,68,554,15,137,84,161,13,40,104
"2011","Milton Keynes 008A","E01016836","Total",619,123,47,76,496,32,56,99,147,23,50,89
"2011","Milton Keynes 008B","E01016837","Total",698,184,66,118,514,40,37,120,144,23,56,94
"2011","Milton Keynes 008C","E01016838","Total",604,145,78,67,459,24,80,90,106,35,53,71
"2011","Milton Keynes 008D","E01016841","Total",984,353,76,277,631,64,46,145,258,32,24,62
"2011","Milton Keynes 009A","E01016721","Total",619,170,76,94,449,36,48,74,105,31,48,107
"2011","Milton Keynes 009B","E01016765","Total",651,198,114,84,453,31,81,65,131,21,47,77
"2011","Milton Keynes 009C","E01016772","Total",501,132,52,80,369,50,32,60,86,22,48,71
"2011","Milton Keynes 009D","E01016804","Total",719,242,102,140,477,70,50,81,153,24,35,64
"2011","Milton Keynes 010A","E01016812","Total",642,155,61,94,487,17,113,85,130,28,30,84
"2011","Milton Keynes 010B","E01016817","Total",657,188,79,109,469,27,81,73,156,19,21,92
"2011","Milton Keynes 010C","E01016818","Total",840,347,153,194,493,16,111,90,184,11,11,70
"2011","Milton Keynes 010D","E01016840","Total",1052,249,88,161,803,39,119,145,263,52,50,135
"2011","Milton Keynes 011A","E01016719","Total",646,201,75,126,445,27,73,89,145,16,23,72
"2011","Milton Keynes 011B","E01016722","Total",621,120,52,68,501,22,67,97,134,23,41,117
"2011","Milton Keynes 011C","E01016805","Total",606,172,53,119,434,12,87,62,157,8,25,83
"2011","Milton Keynes 011D","E01016808","Total",533,106,38,68,427,26,58,83,129,19,26,86
"2011","Milton Keynes 012A","E01016810","Total",580,226,62,164,354,51,41,62,89,25,27,59
"2011","Milton Keynes 012B","E01016811","Total",490,88,11,77,402,91,21,66,69,40,54,61
"2011","Milton Keynes 012C","E01016819","Total",451,154,64,90,297,32,36,51,63,23,35,57
"2011","Milton Keynes 012D","E01016839","Total",613,147,33,114,466,98,20,94,112,43,43,56
"2011","Milton Keynes 013A","E01016717","Total",632,187,77,110,445,28,42,78,148,29,45,75
"2011","Milton Keynes 013B","E01016720","Total",650,243,121,122,407,62,35,92,78,35,30,75
"2011","Milton Keynes 013C","E01016723","Total",618,100,24,76,518,26,65,101,135,30,42,119
"2011","Milton Keynes 013D","E01016724","Total",643,167,32,135,476,40,40,83,121,21,55,116
"2011","Milton Keynes 014A","E01016718","Total",610,194,24,170,416,63,19,66,93,30,52,93
"2011","Milton Keynes 014B","E01016729","Total",784,212,67,145,572,63,34,106,134,33,77,125
"2011","Milton Keynes 014D","E01016768","Total",869,259,50,209,610,46,46,95,235,14,40,134
"2011","Milton Keynes 014E","E01033499","Total",757,396,39,357,361,32,20,61,160,7,14,67
"2011","Milton Keynes 014F","E01033500","Total",795,401,6,395,394,18,3,49,269,1,5,49
"2011","Milton Keynes 015A","E01016776","Total",539,96,28,68,443,23,60,88,106,12,45,109
"2011","Milton Keynes 015B","E01016813","Total",664,264,19,245,400,35,21,101,151,16,25,51
"2011","Milton Keynes 015C","E01016815","Total",531,150,51,99,381,32,42,89,89,20,27,82
"2011","Milton Keynes 015D","E01016816","Total",601,134,62,72,467,14,97,94,125,16,36,85
"2011","Milton Keynes 016A","E01016731","Total",644,184,55,129,460,30,78,82,150,16,35,69
"2011","Milton Keynes 016B","E01016732","Total",522,102,31,71,420,22,62,54,121,14,40,107
"2011","Milton Keynes 016D","E01016784","Total",665,184,43,141,481,43,81,82,133,13,28,101
"2011","Milton Keynes 016E","E01033501","Total",704,115,12,103,589,65,5,187,161,38,45,88
"2011","Milton Keynes 016F","E01033506","Total",703,107,17,90,596,42,30,209,154,29,51,81
"2011","Milton Keynes 017A","E01016783","Total",744,176,18,158,568,70,18,186,156,33,36,69
"2011","Milton Keynes 017C","E01016820","Total",629,147,23,124,482,38,35,115,134,31,43,86
"2011","Milton Keynes 017D","E01016821","Total",489,89,18,71,400,38,18,138,109,14,30,53
"2011","Milton Keynes 017E","E01016823","Total",788,295,22,273,493,61,12,147,180,14,28,51
"2011","Milton Keynes 017F","E01033503","Total",588,111,31,80,477,28,40,137,158,26,36,52
"2011","Milton Keynes 017G","E01033508","Total",627,101,3,98,526,46,7,190,179,17,35,52
"2011","Milton Keynes 017H","E01033509","Total",602,114,3,111,488,50,6,177,144,26,33,52
"2011","Milton Keynes 017I","E01033511","Total",595,140,4,136,455,36,13,113,185,17,37,54
"2011","Milton Keynes 017J","E01033512","Total",606,84,12,72,522,34,44,158,166,31,37,52
"2011","Milton Keynes 018A","E01016726","Total",581,135,17,118,446,75,10,58,121,28,73,81
"2011","Milton Keynes 018B","E01016733","Total",589,129,32,97,460,56,28,97,69,36,86,88
"2011","Milton Keynes 018C","E01016845","Total",709,202,50,152,507,102,37,99,115,42,44,68
"2011","Milton Keynes 018D","E01016846","Total",626,182,61,121,444,47,48,101,98,20,50,80
"2011","Milton Keynes 018E","E01016848","Total",575,171,71,100,404,34,72,62,120,17,30,69
"2011","Milton Keynes 019B","E01016780","Total",651,135,29,106,516,28,39,146,156,20,50,77
"2011","Milton Keynes 019C","E01016781","Total",553,109,60,49,444,13,41,127,101,15,58,89
"2011","Milton Keynes 019D","E01016814","Total",738,195,126,69,543,15,152,96,156,6,24,94
"2011","Milton Keynes 019E","E01033505","Total",514,107,9,98,407,28,16,133,137,24,32,37
"2011","Milton Keynes 019F","E01033522","Total",548,147,15,132,401,36,12,125,147,18,33,30
"2011","Milton Keynes 019G","E01033523","Total",528,117,3,114,411,43,5,112,128,28,54,41
"2011","Milton Keynes 019H","E01033525","Total",582,94,15,79,488,62,13,150,111,32,47,73
"2011","Milton Keynes 020A","E01016774","Total",675,158,78,80,517,18,68,141,139,21,47,83
"2011","Milton Keynes 020B","E01016775","Total",685,172,51,121,513,49,53,113,143,25,38,92
"2011","Milton Keynes 020C","E01016777","Total",641,157,61,96,484,29,51,137,152,16,31,68
"2011","Milton Keynes 020D","E01016778","Total",683,159,48,111,524,40,40,145,152,24,42,81
"2011","Milton Keynes 021A","E01016725","Total",574,133,18,115,441,42,21,76,122,34,51,95
"2011","Milton Keynes 021B","E01016727","Total",653,177,59,118,476,36,42,91,120,20,50,117
"2011","Milton Keynes 021C","E01016728","Total",707,110,9,101,597,38,25,177,182,31,46,98
"2011","Milton Keynes 021D","E01016847","Total",844,264,87,177,580,80,53,136,148,36,57,70
"2011","Milton Keynes 022A","E01016822","Total",662,202,33,169,460,58,36,129,136,19,30,52
"2011","Milton Keynes 022B","E01016824","Total",658,173,19,154,485,48,43,151,140,22,35,46
"2011","Milton Keynes 022C","E01016825","Total",635,204,38,166,431,39,35,129,119,22,35,52
"2011","Milton Keynes 022D","E01016827","Total",715,206,21,185,509,63,23,152,169,9,37,56
"2011","Milton Keynes 022E","E01016828","Total",732,175,20,155,557,25,64,149,185,17,38,79
"2011","Milton Keynes 023B","E01016842","Total",601,181,46,135,420,62,40,94,80,48,39,57
"2011","Milton Keynes 023C","E01016843","Total",528,135,29,106,393,85,22,68,71,42,38,67
"2011","Milton Keynes 023D","E01016844","Total",636,198,71,127,438,54,66,62,97,43,34,82
"2011","Milton Keynes 023E","E01033497","Total",592,284,99,185,308,45,51,48,118,5,9,32
"2011","Milton Keynes 023F","E01033498","Total",643,280,59,221,363,40,38,85,122,7,20,51
"2011","Milton Keynes 024A","E01016734","Total",517,131,75,56,386,18,98,58,120,16,28,48
"2011","Milton Keynes 024B","E01016735","Total",869,249,75,174,620,28,95,145,196,26,34,96
"2011","Milton Keynes 024C","E01016736","Total",591,185,107,78,406,17,107,67,122,8,24,61
"2011","Milton Keynes 024D","E01016826","Total",531,75,7,68,456,19,32,137,117,16,56,79
"2011","Milton Keynes 025B","E01016752","Total",609,95,15,80,514,54,25,156,123,32,50,74
"2011","Milton Keynes 025C","E01016753","Total",881,216,19,197,665,77,21,204,206,29,58,70
"2011","Milton Keynes 025D","E01016755","Total",719,173,60,113,546,51,41,156,154,27,45,72
"2011","Milton Keynes 025E","E01033514","Total",511,91,26,65,420,35,9,176,107,24,30,39
"2011","Milton Keynes 025F","E01033515","Total",620,84,26,58,536,38,20,166,94,35,95,88
"2011","Milton Keynes 025G","E01033517","Total",548,91,6,85,457,24,7,197,112,22,46,49
"2011","Milton Keynes 026A","E01016754","Total",728,220,96,124,508,36,81,107,160,17,27,80
"2011","Milton Keynes 026B","E01016756","Total",933,305,79,226,628,79,46,171,158,33,55,86
"2011","Milton Keynes 026C","E01016757","Total",593,113,31,82,480,32,51,106,132,28,39,92
"2011","Milton Keynes 026D","E01016758","Total",660,128,19,109,532,45,45,140,160,13,44,85
"2011","Milton Keynes 027A","E01016737","Total",615,100,35,65,515,49,81,99,121,20,47,98
"2011","Milton Keynes 027B","E01016738","Total",763,230,131,99,533,80,87,93,137,23,38,75
"2011","Milton Keynes 027C","E01016739","Total",594,111,40,71,483,34,63,78,134,21,49,104
"2011","Milton Keynes 027D","E01016740","Total",559,123,63,60,436,24,125,62,98,18,36,73
"2011","Milton Keynes 027E","E01016741","Total",712,234,85,149,478,60,87,84,102,19,43,83
"2011","Milton Keynes 028A","E01016748","Total",815,209,28,181,606,59,29,191,203,21,37,66
"2011","Milton Keynes 028C","E01016750","Total",634,159,58,101,475,25,54,109,129,20,43,95
"2011","Milton Keynes 028D","E01016751","Total",629,146,32,114,483,40,37,156,135,19,40,56
"2011","Milton Keynes 028E","E01033519","Total",701,154,11,143,547,42,31,205,149,29,39,52
"2011","Milton Keynes 028F","E01033520","Total",631,93,16,77,538,32,30,187,140,34,44,71
"2011","Milton Keynes 029A","E01016829","Total",664,187,94,93,477,52,90,90,119,19,29,78
"2011","Milton Keynes 029B","E01016831","Total",611,118,60,58,493,32,100,78,127,14,48,94
"2011","Milton Keynes 029C","E01016832","Total",498,101,49,52,397,33,71,80,90,11,28,84
"2011","Milton Keynes 029D","E01016833","Total",506,95,62,33,411,4,121,61,82,13,33,97
"2011","Milton Keynes 029E","E01016834","Total",651,196,125,71,455,60,79,87,96,15,29,89
"2011","Milton Keynes 030A","E01016710","Total",743,224,169,55,519,35,129,69,129,27,36,94
"2011","Milton Keynes 030B","E01016714","Total",750,224,126,98,526,65,81,88,126,31,56,79
"2011","Milton Keynes 030C","E01016716","Total",772,227,100,127,545,42,110,97,133,25,37,101
"2011","Milton Keynes 030D","E01016745","Total",616,128,66,62,488,26,97,80,128,23,41,93
"2011","Milton Keynes 031A","E01016711","Total",955,222,94,128,733,49,150,120,209,15,61,129
"2011","Milton Keynes 031B","E01016713","Total",714,164,88,76,550,38,139,100,133,6,36,98
"2011","Milton Keynes 031C","E01016715","Total",640,149,83,66,491,47,81,78,117,30,48,90
"2011","Milton Keynes 031D","E01016830","Total",515,144,49,95,371,27,47,98,130,7,19,43
"2011","Milton Keynes 032A","E01016742","Total",577,139,28,111,438,91,41,82,80,47,40,57
"2011","Milton Keynes 032B","E01016743","Total",787,185,39,146,602,118,35,123,174,34,47,71
"2011","Milton Keynes 032C","E01016744","Total",545,106,31,75,439,70,37,88,85,42,51,66
"2011","Milton Keynes 032D","E01016746","Total",681,169,80,89,512,32,108,84,125,36,45,82
"2011","Portsmouth 001A","E01017112","Total",664,158,50,108,506,65,59,89,83,35,62,113
"2011","Portsmouth 001B","E01017115","Total",485,94,45,49,391,47,52,54,80,25,58,75
"2011","Portsmouth 001C","E01017117","Total",600,130,52,78,470,70,61,92,106,23,42,76
"2011","Portsmouth 001D","E01017119","Total",648,149,66,83,499,57,54,96,108,35,41,108
"2011","Portsmouth 001E","E01017120","Total",679,266,132,134,413,48,65,62,116,24,31,67
"2011","Portsmouth 002A","E01017051","Total",789,216,64,152,573,101,78,117,141,12,45,79
"2011","Portsmouth 002B","E01017052","Total",572,163,76,87,409,52,59,62,95,27,36,78
"2011","Portsmouth 002C","E01017053","Total",535,154,65,89,381,63,53,66,69,17,41,72
"2011","Portsmouth 002D","E01017118","Total",563,127,50,77,436,67,43,79,70,36,45,96
"2011","Portsmouth 003A","E01017050","Total",690,221,145,76,469,28,116,70,124,14,30,87
"2011","Portsmouth 003B","E01017061","Total",664,144,88,56,520,10,150,85,121,16,39,99
"2011","Portsmouth 003C","E01017063","Total",626,132,98,34,494,15,118,89,106,19,32,115
"2011","Portsmouth 003D","E01017064","Total",707,230,151,79,477,23,131,84,96,15,34,94
"2011","Portsmouth 004A","E01017054","Total",624,216,115,101,408,32,83,65,99,10,39,80
"2011","Portsmouth 004B","E01017113","Total",621,164,78,86,457,44,80,72,128,22,36,75
"2011","Portsmouth 004C","E01017114","Total",702,276,82,194,426,19,90,56,182,10,16,53
"2011","Portsmouth 004D","E01017116","Total",624,141,63,78,483,96,61,111,95,28,37,55
"2011","Portsmouth 006A","E01017055","Total",676,234,115,119,442,41,85,87,107,14,30,78
"2011","Portsmouth 006B","E01017056","Total",497,102,64,38,395,24,63,97,59,24,35,93
"2011","Portsmouth 006C","E01017057","Total",570,103,50,53,467,20,82,97,105,23,37,103
"2011","Portsmouth 006D","E01017058","Total",651,146,58,88,505,77,63,103,114,20,43,85
"2011","Portsmouth 006E","E01017060","Total",633,182,116,66,451,32,102,112,78,18,38,71
"2011","Portsmouth 007A","E01017086","Total",500,98,63,35,402,19,63,86,106,15,29,84
"2011","Portsmouth 007B","E01017089","Total",629,137,54,83,492,60,37,121,150,24,37,63
"2011","Portsmouth 007C","E01017090","Total",607,134,48,86,473,44,50,81,148,26,42,82
"2011","Portsmouth 007D","E01017091","Total",723,275,152,123,448,64,78,87,122,21,21,55
"2011","Portsmouth 007E","E01017092","Total",642,197,89,108,445,24,100,81,117,12,34,77
"2011","Portsmouth 008A","E01017014","Total",634,150,60,90,484,46,90,102,109,19,42,76
"2011","Portsmouth 008B","E01017046","Total",780,252,67,185,528,22,94,77,184,9,35,107
"2011","Portsmouth 008C","E01017047","Total",636,148,78,70,488,40,72,110,102,21,46,97
"2011","Portsmouth 008D","E01017048","Total",593,105,52,53,488,29,91,105,112,12,49,90
"2011","Portsmouth 008E","E01017085","Total",671,237,101,136,434,24,113,59,120,14,30,74
"2011","Portsmouth 009A","E01017084","Total",565,151,54,97,414,26,55,78,103,17,43,92
"2011","Portsmouth 009B","E01017087","Total",596,165,49,116,431,27,51,81,127,15,33,97
"2011","Portsmouth 009C","E01017088","Total",687,214,66,148,473,26,74,88,118,22,49,96
"2011","Portsmouth 009D","E01017105","Total",639,236,102,134,403,43,50,75,123,18,26,68
"2011","Portsmouth 009E","E01017107","Total",662,221,55,166,441,53,47,82,131,15,47,66
"2011","Portsmouth 010A","E01017104","Total",473,128,58,70,345,27,49,65,107,17,29,51
"2011","Portsmouth 010B","E01017106","Total",627,190,65,125,437,53,51,76,120,28,29,80
"2011","Portsmouth 010C","E01017108","Total",709,266,130,136,443,66,57,83,113,17,23,84
"2011","Portsmouth 010D","E01017109","Total",599,192,75,117,407,71,40,83,115,19,20,59
"2011","Portsmouth 011A","E01017041","Total",517,122,48,74,395,24,59,77,79,19,43,94
"2011","Portsmouth 011B","E01017043","Total",524,119,43,76,405,26,43,82,88,37,47,82
"2011","Portsmouth 011C","E01017044","Total",617,179,56,123,438,33,37,91,123,22,44,88
"2011","Portsmouth 011D","E01017049","Total",594,143,75,68,451,16,78,85,106,14,34,118
"2011","Portsmouth 011E","E01017110","Total",605,172,45,127,433,43,44,87,124,19,45,71
"2011","Portsmouth 011F","E01017111","Total",612,168,48,120,444,60,40,113,116,10,33,72
"2011","Portsmouth 012A","E01017013","Total",649,164,63,101,485,70,36,111,147,21,28,72
"2011","Portsmouth 012B","E01017042","Total",528,103,35,68,425,52,43,90,105,22,34,79
"2011","Portsmouth 012C","E01017045","Total",510,96,32,64,414,42,44,101,104,25,30,68
"2011","Portsmouth 012D","E01017075","Total",672,185,52,133,487,90,38,102,127,16,41,73
"2011","Portsmouth 012E","E01017082","Total",728,225,47,178,503,56,43,108,152,35,42,67
"2011","Portsmouth 012F","E01017083","Total",723,204,55,149,519,63,41,123,146,20,34,92
"2011","Portsmouth 013A","E01017036","Total",593,126,45,81,467,96,52,81,84,31,41,82
"2011","Portsmouth 013B","E01017037","Total",649,230,105,125,419,88,58,85,72,20,30,66
"2011","Portsmouth 013C","E01017038","Total",820,402,224,178,418,81,80,77,83,21,20,56
"2011","Portsmouth 013D","E01017102","Total",713,294,122,172,419,44,42,62,129,28,36,78
"2011","Portsmouth 013E","E01017103","Total",502,136,50,86,366,89,36,64,77,20,26,54
"2011","Portsmouth 014A","E01017015","Total",627,182,81,101,445,48,90,82,110,11,37,67
"2011","Portsmouth 014B","E01017016","Total",634,172,72,100,462,47,62,97,101,26,42,87
"2011","Portsmouth 014C","E01017017","Total",602,156,84,72,446,14,75,104,94,17,42,100
"2011","Portsmouth 014D","E01017018","Total",620,154,96,58,466,31,83,95,86,17,42,112
"2011","Portsmouth 014E","E01017019","Total",746,208,68,140,538,60,67,109,158,22,42,80
"2011","Portsmouth 014F","E01017020","Total",953,263,109,154,690,76,106,133,177,36,46,116
"2011","Portsmouth 015A","E01017076","Total",742,242,59,183,500,79,38,85,187,14,21,76
"2011","Portsmouth 015B","E01017077","Total",886,439,172,267,447,72,45,101,130,16,22,61
"2011","Portsmouth 015C","E01017078","Total",638,166,51,115,472,53,45,106,123,22,26,97
"2011","Portsmouth 015D","E01017079","Total",627,162,49,113,465,46,36,80,129,11,36,127
"2011","Portsmouth 015E","E01017080","Total",827,268,56,212,559,60,61,111,127,20,32,148
"2011","Portsmouth 015F","E01017081","Total",666,170,53,117,496,53,38,106,138,11,31,119
"2011","Portsmouth 016A","E01017031","Total",970,469,178,291,501,80,78,103,106,22,32,80
"2011","Portsmouth 016B","E01017032","Total",612,337,66,271,275,37,33,38,83,9,17,58
"2011","Portsmouth 016D","E01017034","Total",582,255,60,195,327,57,33,62,99,7,18,51
"2011","Portsmouth 016E","E01017039","Total",746,294,134,160,452,62,62,81,85,34,43,85
"2011","Portsmouth 016F","E01017040","Total",644,254,92,162,390,77,39,75,84,16,43,56
"2011","Portsmouth 016G","E01033381","Total",724,303,21,282,421,33,26,54,219,7,11,71
"2011","Portsmouth 016H","E01033383","Total",594,211,70,141,383,57,49,46,126,15,24,66
"2011","Portsmouth 017A","E01017021","Total",637,184,117,67,453,17,142,63,116,10,19,86
"2011","Portsmouth 017B","E01017093","Total",495,169,65,104,326,26,91,52,86,6,15,50
"2011","Portsmouth 017C","E01017096","Total",670,242,117,125,428,43,74,91,125,11,11,73
"2011","Portsmouth 017D","E01017099","Total",706,238,103,135,468,52,69,78,115,17,31,106
"2011","Portsmouth 017E","E01017100","Total",521,113,54,59,408,28,63,97,75,25,37,83
"2011","Portsmouth 017F","E01017101","Total",656,186,78,108,470,63,65,94,117,21,25,85
"2011","Portsmouth 018A","E01017035","Total",765,373,204,169,392,75,58,73,75,30,32,49
"2011","Portsmouth 018B","E01017128","Total",653,243,43,200,410,17,21,24,138,8,19,183
"2011","Portsmouth 018C","E01017129","Total",664,202,48,154,462,22,15,35,115,8,24,243
"2011","Portsmouth 018D","E01017130","Total",777,278,125,153,499,79,54,87,80,44,44,111
"2011","Portsmouth 018E","E01017132","Total",925,298,136,162,627,71,52,116,136,78,48,126
"2011","Portsmouth 018F","E01017133","Total",847,375,181,194,472,46,63,33,121,17,34,158
"2011","Portsmouth 019A","E01017023","Total",669,180,68,112,489,37,66,93,114,17,26,136
"2011","Portsmouth 019B","E01017025","Total",818,209,70,139,609,42,54,74,178,22,20,219
"2011","Portsmouth 019C","E01017026","Total",771,239,109,130,532,37,57,78,127,12,36,185
"2011","Portsmouth 019D","E01017029","Total",706,203,71,132,503,30,57,85,129,18,26,158
"2011","Portsmouth 019E","E01017030","Total",705,158,58,100,547,39,48,63,120,32,19,226
"2011","Portsmouth 020A","E01017022","Total",661,277,82,195,384,21,39,38,142,4,17,123
"2011","Portsmouth 020B","E01017024","Total",725,202,41,161,523,23,46,63,155,6,16,214
"2011","Portsmouth 020C","E01017027","Total",626,157,52,105,469,12,34,52,114,8,23,226
"2011","Portsmouth 020D","E01017028","Total",690,132,29,103,558,20,38,60,96,12,26,306
"2011","Portsmouth 020E","E01017124","Total",801,292,69,223,509,21,43,98,222,13,21,91
"2011","Portsmouth 021A","E01017094","Total",611,135,55,80,476,24,54,136,126,10,38,88
"2011","Portsmouth 021B","E01017095","Total",869,297,100,197,572,62,66,125,224,5,20,70
"2011","Portsmouth 021C","E01017097","Total",725,225,66,159,500,57,55,107,168,14,16,83
"2011","Portsmouth 021D","E01017098","Total",646,223,61,162,423,67,36,79,132,14,25,70
"2011","Portsmouth 022A","E01017122","Total",854,389,89,300,465,27,38,40,237,21,19,83
"2011","Portsmouth 022B","E01017125","Total",866,445,203,242,421,23,70,51,149,8,19,101
"2011","Portsmouth 022C","E01017127","Total",999,457,86,371,542,21,33,57,284,7,21,119
"2011","Portsmouth 022D","E01017135","Total",836,370,134,236,466,22,64,57,182,7,17,117
"2011","Portsmouth 023A","E01017067","Total",653,200,83,117,453,42,98,84,117,17,20,75
"2011","Portsmouth 023B","E01017068","Total",908,358,104,254,550,67,92,89,216,10,13,63
"2011","Portsmouth 023C","E01017069","Total",745,196,78,118,549,25,80,106,163,75,26,74
"2011","Portsmouth 023D","E01017070","Total",726,313,114,199,413,15,94,48,137,18,21,80
"2011","Portsmouth 023E","E01017074","Total",793,222,58,164,571,92,65,149,153,35,17,60
"2011","Portsmouth 024A","E01017073","Total",953,473,132,341,480,40,63,59,226,7,15,70
"2011","Portsmouth 024B","E01017123","Total",1129,576,152,424,553,23,89,59,284,7,7,84
"2011","Portsmouth 024C","E01017131","Total",735,245,107,138,490,20,99,73,177,32,12,77
"2011","Portsmouth 024E","E01033380","Total",850,392,63,329,458,15,56,51,268,8,17,43
"2011","Portsmouth 024F","E01033384","Total",803,372,176,196,431,12,122,54,170,2,13,58
"2011","Portsmouth 025A","E01017071","Total",656,207,32,175,449,20,32,57,148,43,35,114
"2011","Portsmouth 025B","E01017072","Total",627,193,76,117,434,12,84,72,126,25,31,84
"2011","Portsmouth 025C","E01017121","Total",763,303,70,233,460,21,69,75,169,13,23,90
"2011","Portsmouth 025D","E01017126","Total",820,309,86,223,511,28,44,75,202,11,18,133
"2011","Portsmouth 026A","E01017059","Total",648,169,116,53,479,15,159,102,83,17,31,72
"2011","Portsmouth 026B","E01017062","Total",619,115,67,48,504,15,84,146,139,17,34,69
"2011","Portsmouth 026C","E01017066","Total",758,185,84,101,573,46,123,109,141,19,40,95
"2011","Portsmouth 026D","E01032604","Total",605,135,65,70,470,22,102,89,111,18,41,87
"2011","Reading 001A","E01016407","Total",653,191,120,71,462,30,114,91,113,17,30,67
"2011","Reading 001B","E01016408","Total",577,144,51,93,433,17,66,101,103,16,50,80
"2011","Reading 001C","E01016410","Total",659,136,47,89,523,18,100,103,161,23,32,86
"2011","Reading 001D","E01016411","Total",641,141,100,41,500,6,171,85,103,29,27,79
"2011","Reading 001E","E01016412","Total",585,126,42,84,459,26,72,119,94,22,27,99
"2011","Reading 002A","E01016386","Total",594,137,91,46,457,6,138,90,109,15,33,66
"2011","Reading 002B","E01016387","Total",585,105,66,39,480,9,109,119,99,20,32,92
"2011","Reading 002C","E01016425","Total",658,117,68,49,541,16,96,162,128,31,42,66
"2011","Reading 002D","E01016426","Total",502,83,51,32,419,4,68,117,97,29,37,67
"2011","Reading 002E","E01016430","Total",507,75,35,40,432,13,61,123,106,25,39,65
"2011","Reading 003A","E01016364","Total",578,172,79,93,406,6,45,107,116,17,33,82
"2011","Reading 003B","E01016409","Total",728,248,145,103,480,24,109,102,120,10,38,77
"2011","Reading 003C","E01016427","Total",642,163,94,69,479,27,105,124,135,13,23,52
"2011","Reading 003D","E01016428","Total",723,187,88,99,536,30,105,144,119,36,25,77
"2011","Reading 003E","E01016429","Total",615,122,58,64,493,13,96,136,117,20,38,73
"2011","Reading 004A","E01016362","Total",819,380,130,250,439,33,47,83,208,10,10,48
"2011","Reading 004B","E01016363","Total",709,162,21,141,547,100,23,142,151,26,49,56
"2011","Reading 004C","E01016365","Total",765,257,61,196,508,30,47,100,243,9,13,66
"2011","Reading 004D","E01016366","Total",667,192,62,130,475,24,65,113,149,18,33,73
"2011","Reading 004E","E01016367","Total",687,214,71,143,473,34,58,98,165,22,32,64
"2011","Reading 005A","E01016380","Total",674,172,65,107,502,39,81,102,145,14,36,85
"2011","Reading 005B","E01016383","Total",649,195,69,126,454,43,43,101,158,14,22,73
"2011","Reading 005C","E01016384","Total",604,95,45,50,509,20,105,78,129,21,47,109
"2011","Reading 005D","E01016431","Total",625,144,75,69,481,27,85,106,114,17,40,92
"2011","Reading 005E","E01016432","Total",634,201,144,57,433,35,94,90,78,10,33,93
"2011","Reading 006A","E01016381","Total",520,108,45,63,412,43,47,79,103,26,42,72
"2011","Reading 006B","E01016382","Total",697,187,61,126,510,75,55,110,122,20,47,81
"2011","Reading 006C","E01016385","Total",602,135,42,93,467,34,44,119,140,18,37,75
"2011","Reading 006D","E01016396","Total",543,186,46,140,357,69,36,71,77,15,29,60
"2011","Reading 006E","E01016397","Total",565,200,97,103,365,57,44,58,78,32,37,59
"2011","Reading 007A","E01016355","Total",790,243,38,205,547,24,28,121,229,14,38,93
"2011","Reading 007B","E01016358","Total",740,249,27,222,491,52,30,78,173,20,39,99
"2011","Reading 007C","E01016359","Total",820,230,44,186,590,81,47,159,135,27,54,87
"2011","Reading 007D","E01016360","Total",772,231,38,193,541,50,30,105,161,34,69,92
"2011","Reading 007E","E01016361","Total",739,220,48,172,519,86,29,114,153,11,44,82
"2011","Reading 008A","E01016356","Total",673,235,37,198,438,60,25,95,152,19,30,57
"2011","Reading 008B","E01016357","Total",736,270,36,234,466,42,28,104,167,15,37,73
"2011","Reading 008C","E01016395","Total",639,242,123,119,397,32,100,64,85,14,30,72
"2011","Reading 008D","E01016398","Total",743,226,23,203,517,59,29,115,197,23,30,64
"2011","Reading 008E","E01016399","Total",562,128,45,83,434,35,53,90,126,12,33,85
"2011","Reading 008F","E01016400","Total",642,230,59,171,412,39,29,86,124,10,35,89
"2011","Reading 009A","E01016394","Total",566,162,99,63,404,66,88,68,76,16,31,59
"2011","Reading 009B","E01016433","Total",601,207,130,77,394,29,70,76,93,18,22,86
"2011","Reading 009C","E01016434","Total",680,139,68,71,541,37,98,102,132,30,42,100
"2011","Reading 009D","E01016435","Total",567,157,97,60,410,27,100,83,74,25,31,70
"2011","Reading 009E","E01016436","Total",608,162,76,86,446,30,80,100,97,21,40,78
"2011","Reading 010B","E01016402","Total",643,143,36,107,500,52,20,84,90,15,27,212
"2011","Reading 010C","E01016404","Total",801,241,56,185,560,48,21,131,185,24,52,99
"2011","Reading 010D","E01016405","Total",650,146,24,122,504,32,24,93,105,19,110,121
"2011","Reading 010E","E01016406","Total",480,112,24,88,368,14,21,44,70,17,46,156
"2011","Reading 010F","E01033417","Total",598,270,48,222,328,12,21,45,195,0,11,44
"2011","Reading 010G","E01033421","Total",868,385,76,309,483,43,27,99,195,20,31,68
"2011","Reading 011B","E01016353","Total",817,313,40,273,504,45,36,101,190,15,33,84
"2011","Reading 011D","E01016378","Total",966,421,43,378,545,43,17,117,266,3,23,76
"2011","Reading 011E","E01016391","Total",850,304,44,260,546,74,27,120,219,15,30,61
"2011","Reading 011F","E01033415","Total",766,359,33,326,407,13,13,81,248,5,6,41
"2011","Reading 011G","E01033418","Total",625,269,8,261,356,24,9,82,204,4,10,23
"2011","Reading 011H","E01033420","Total",645,331,62,269,314,12,21,62,185,2,6,26
"2011","Reading 011I","E01033422","Total",613,312,52,260,301,24,15,52,155,3,7,45
"2011","Reading 011J","E01033423","Total",609,265,13,252,344,20,7,47,209,8,13,40
"2011","Reading 012A","E01016401","Total",590,200,61,139,390,18,37,67,121,13,35,99
"2011","Reading 012B","E01016403","Total",678,160,49,111,518,15,49,123,127,29,48,127
"2011","Reading 012C","E01016416","Total",625,209,20,189,416,15,13,53,130,9,18,178
"2011","Reading 012D","E01016417","Total",568,142,32,110,426,19,24,56,99,12,24,192
"2011","Reading 012E","E01016418","Total",591,123,27,96,468,32,31,55,125,14,13,198
"2011","Reading 013A","E01016388","Total",602,167,76,91,435,30,79,72,117,11,31,95
"2011","Reading 013B","E01016389","Total",702,211,47,164,491,104,38,108,107,35,42,57
"2011","Reading 013C","E01016390","Total",758,342,83,259,416,15,32,79,206,8,22,54
"2011","Reading 013D","E01016392","Total",968,399,83,316,569,46,58,118,286,3,18,40
"2011","Reading 013E","E01016393","Total",652,214,82,132,438,22,85,83,127,16,32,73
"2011","Reading 014A","E01016374","Total",693,208,29,179,485,35,29,81,190,9,36,105
"2011","Reading 014B","E01016375","Total",507,170,35,135,337,32,23,54,99,15,29,85
"2011","Reading 014C","E01016376","Total",665,260,53,207,405,21,29,68,150,9,26,102
"2011","Reading 014D","E01016379","Total",764,242,36,206,522,32,25,68,251,9,38,99
"2011","Reading 014E","E01016413","Total",453,157,43,114,296,3,40,65,98,12,19,59
"2011","Reading 014F","E01016414","Total",643,252,42,210,391,16,31,87,157,5,24,71
"2011","Reading 015A","E01016419","Total",762,286,104,182,476,36,61,85,168,14,29,83
"2011","Reading 015B","E01016420","Total",567,188,52,136,379,88,38,89,63,21,33,47
"2011","Reading 015C","E01016421","Total",521,135,91,44,386,19,106,64,86,9,31,71
"2011","Reading 015D","E01016422","Total",650,258,160,98,392,41,106,53,87,16,24,65
"2011","Reading 015E","E01016423","Total",602,182,105,77,420,50,74,82,78,15,40,81
"2011","Reading 015F","E01016424","Total",480,78,36,42,402,17,63,91,88,16,28,99
"2011","Reading 016A","E01016370","Total",498,153,51,102,345,37,64,70,74,12,22,66
"2011","Reading 016B","E01016371","Total",606,173,80,93,433,28,77,56,115,22,46,89
"2011","Reading 016C","E01016373","Total",535,115,34,81,420,67,34,75,88,20,54,82
"2011","Reading 016D","E01016415","Total",687,278,104,174,409,55,54,79,82,24,50,65
"2011","Reading 017A","E01016368","Total",531,152,69,83,379,61,44,61,66,22,54,71
"2011","Reading 017B","E01016372","Total",478,128,40,88,350,50,40,55,74,25,44,62
"2011","Reading 017C","E01016377","Total",635,201,60,141,434,64,39,76,98,12,40,105
"2011","Reading 017D","E01016438","Total",521,160,68,92,361,55,48,73,73,15,37,60
"2011","Reading 017E","E01016442","Total",1106,300,36,264,806,97,47,167,267,41,73,114
"2011","Reading 017F","E01016443","Total",545,99,36,63,446,86,47,78,95,31,49,60
"2011","Reading 018A","E01016369","Total",639,162,88,74,477,30,105,67,101,19,45,110
"2011","Reading 018B","E01016437","Total",518,117,38,79,401,37,41,83,93,25,47,75
"2011","Reading 018C","E01016439","Total",584,132,55,77,452,45,56,77,123,20,52,79
"2011","Reading 018D","E01016440","Total",555,135,64,71,420,47,54,73,93,18,50,85
"2011","Reading 018E","E01016441","Total",574,172,69,103,402,72,35,68,98,19,41,69
"2011","Slough 001A","E01016450","Total",593,157,36,121,436,84,30,99,74,41,53,55
"2011","Slough 001B","E01016451","Total",607,203,73,130,404,97,14,90,68,38,47,50
"2011","Slough 001C","E01016452","Total",643,195,78,117,448,45,63,90,78,24,54,94
"2011","Slough 001D","E01016453","Total",660,227,91,136,433,36,72,103,93,21,35,73
"2011","Slough 001E","E01016454","Total",611,199,73,126,412,34,54,103,72,29,41,79
"2011","Slough 001F","E01016455","Total",534,136,41,95,398,59,31,82,95,18,42,71
"2011","Slough 002A","E01016483","Total",561,117,27,90,444,45,27,90,54,27,77,124
"2011","Slough 002B","E01016484","Total",547,143,30,113,404,32,48,67,79,16,75,87
"2011","Slough 002C","E01016485","Total",539,116,37,79,423,34,29,80,55,33,82,110
"2011","Slough 002D","E01016486","Total",640,214,57,157,426,59,49,99,75,24,54,66
"2011","Slough 002E","E01016487","Total",470,62,28,34,408,30,33,48,35,27,98,137
"2011","Slough 002F","E01016488","Total",705,230,55,175,475,47,33,129,105,29,56,76
"2011","Slough 003A","E01016493","Total",484,140,38,102,344,21,41,74,96,11,33,68
"2011","Slough 003B","E01016494","Total",825,263,36,227,562,69,44,133,177,22,49,68
"2011","Slough 003C","E01016495","Total",682,273,63,210,409,24,62,106,133,11,32,41
"2011","Slough 003D","E01016496","Total",574,200,84,116,374,68,39,101,84,19,17,46
"2011","Slough 003E","E01016497","Total",484,76,29,47,408,17,75,82,66,22,51,95
"2011","Slough 003F","E01016498","Total",647,176,29,147,471,66,24,106,125,18,45,87
"2011","Slough 003G","E01016499","Total",502,151,26,125,351,50,16,89,71,14,48,63
"2011","Slough 004A","E01016444","Total",473,75,33,42,398,22,26,72,39,48,94,97
"2011","Slough 004B","E01016445","Total",524,89,36,53,435,32,30,83,54,42,96,98
"2011","Slough 004C","E01016446","Total",453,76,40,36,377,20,26,60,47,36,81,107
"2011","Slough 004D","E01016447","Total",506,73,22,51,433,34,35,59,60,41,90,114
"2011","Slough 004E","E01016448","Total",753,198,83,115,555,43,45,90,86,28,107,156
"2011","Slough 004F","E01016449","Total",625,124,50,74,501,29,34,87,78,54,97,122
"2011","Slough 005A","E01016516","Total",456,69,36,33,387,26,27,54,33,39,101,107
"2011","Slough 005B","E01016517","Total",458,93,29,64,365,16,32,61,54,22,79,101
"2011","Slough 005C","E01016518","Total",600,158,34,124,442,35,29,80,96,23,76,103
"2011","Slough 005D","E01016519","Total",1038,466,145,321,572,31,93,120,96,42,84,106
"2011","Slough 005E","E01016520","Total",573,130,60,70,443,52,47,83,73,35,72,81
"2011","Slough 005F","E01016521","Total",634,171,105,66,463,19,62,93,77,38,67,107
"2011","Slough 006A","E01016467","Total",576,183,33,150,393,36,35,111,88,14,42,67
"2011","Slough 006B","E01016468","Total",627,151,42,109,476,26,46,134,95,22,47,106
"2011","Slough 006C","E01016469","Total",674,224,70,154,450,35,60,102,111,15,52,75
"2011","Slough 006D","E01016470","Total",678,245,41,204,433,36,43,96,113,21,47,77
"2011","Slough 006E","E01016471","Total",494,112,40,72,382,17,44,78,89,22,47,85
"2011","Slough 006F","E01016472","Total",592,165,84,81,427,34,53,76,75,27,66,96
"2011","Slough 007A","E01016456","Total",639,181,69,112,458,37,25,61,60,32,103,140
"2011","Slough 007B","E01016457","Total",511,82,12,70,429,24,34,48,50,25,108,140
"2011","Slough 007C","E01016458","Total",557,139,47,92,418,45,32,80,67,34,78,82
"2011","Slough 007D","E01016459","Total",695,161,33,128,534,52,28,112,104,26,106,106
"2011","Slough 007E","E01016460","Total",545,93,41,52,452,25,55,45,53,35,89,150
"2011","Slough 007F","E01016461","Total",933,257,23,234,676,57,31,167,173,29,99,120
"2011","Slough 008A","E01016473","Total",746,174,31,143,572,51,20,190,129,42,56,84
"2011","Slough 008B","E01016474","Total",831,313,99,214,518,45,58,121,141,28,60,65
"2011","Slough 008C","E01016475","Total",622,132,47,85,490,38,44,73,56,37,103,139
"2011","Slough 008D","E01016476","Total",673,187,10,177,486,55,15,177,124,30,35,50
"2011","Slough 008E","E01016477","Total",1023,358,23,335,665,72,24,198,236,33,45,57
"2011","Slough 008F","E01016478","Total",694,208,36,172,486,29,35,125,124,24,64,85
"2011","Slough 009A","E01016462","Total",830,235,27,208,595,50,21,123,136,33,99,133
"2011","Slough 009B","E01016463","Total",613,162,54,108,451,38,49,68,71,44,83,98
"2011","Slough 009C","E01016464","Total",608,190,34,156,418,32,33,55,69,30,96,103
"2011","Slough 009D","E01016465","Total",967,269,40,229,698,81,48,185,121,45,89,129
"2011","Slough 009F","E01032729","Total",603,192,40,152,411,54,40,96,86,16,52,67
"2011","Slough 009G","E01032730","Total",620,194,24,170,426,59,9,136,138,11,30,43
"2011","Slough 010A","E01016506","Total",811,310,22,288,501,51,12,137,193,15,31,62
"2011","Slough 010B","E01016507","Total",614,191,89,102,423,25,49,90,84,26,43,106
"2011","Slough 010C","E01016508","Total",605,117,54,63,488,38,83,103,79,26,65,94
"2011","Slough 010D","E01016509","Total",619,195,55,140,424,17,54,83,114,15,48,93
"2011","Slough 010E","E01016510","Total",457,54,32,22,403,7,66,42,67,8,73,140
"2011","Slough 011A","E01016511","Total",775,329,87,242,446,42,36,105,113,18,56,76
"2011","Slough 011B","E01016512","Total",842,357,60,297,485,49,24,129,150,21,40,72
"2011","Slough 011C","E01016513","Total",592,107,54,53,485,9,57,72,64,40,104,139
"2011","Slough 011D","E01016514","Total",821,343,71,272,478,36,45,98,179,27,41,52
"2011","Slough 011E","E01016515","Total",624,105,50,55,519,11,58,103,71,24,104,148
"2011","Slough 012A","E01016500","Total",606,123,48,75,483,39,43,104,106,18,72,101
"2011","Slough 012B","E01016501","Total",603,177,66,111,426,55,43,92,97,26,53,60
"2011","Slough 012C","E01016502","Total",502,124,60,64,378,31,34,87,66,29,56,75
"2011","Slough 012D","E01016503","Total",601,205,69,136,396,30,40,88,79,19,61,79
"2011","Slough 012E","E01016504","Total",473,108,44,64,365,13,55,42,58,14,68,115
"2011","Slough 012F","E01016505","Total",660,231,87,144,429,47,38,97,79,25,58,85
"2011","Slough 013B","E01016490","Total",843,329,103,226,514,89,49,132,94,26,49,75
"2011","Slough 013C","E01016491","Total",665,171,80,91,494,22,106,96,106,10,60,94
"2011","Slough 013D","E01016492","Total",601,140,55,85,461,35,57,115,79,29,48,98
"2011","Slough 013E","E01032731","Total",507,84,21,63,423,51,21,131,76,30,47,67
"2011","Slough 013F","E01032732","Total",660,220,71,149,440,38,60,114,90,20,48,70
"2011","Slough 014A","E01016479","Total",579,142,20,122,437,56,22,104,91,23,58,83
"2011","Slough 014B","E01016480","Total",519,133,26,107,386,38,45,70,93,18,47,75
"2011","Slough 014C","E01016481","Total",715,313,45,268,402,47,20,89,162,8,30,46
"2011","Slough 014D","E01016482","Total",720,232,40,192,488,26,54,101,143,11,48,105
"2011","Southampton 001A","E01017144","Total",427,116,46,70,311,18,66,41,89,9,22,66
"2011","Southampton 001B","E01017145","Total",651,206,108,98,445,6,109,56,154,10,29,81
"2011","Southampton 001C","E01017146","Total",707,207,85,122,500,12,98,114,165,9,25,77
"2011","Southampton 001D","E01017148","Total",604,269,42,227,335,4,83,56,117,8,16,51
"2011","Southampton 001E","E01017149","Total",460,90,39,51,370,20,35,34,65,18,49,149
"2011","Southampton 002A","E01017180","Total",581,123,39,84,458,21,60,89,136,16,43,93
"2011","Southampton 002B","E01017181","Total",559,133,66,67,426,32,73,76,122,17,36,70
"2011","Southampton 002C","E01017183","Total",664,140,60,80,524,26,91,115,168,15,34,75
"2011","Southampton 002D","E01017185","Total",730,201,88,113,529,67,84,122,112,24,29,91
"2011","Southampton 002E","E01017187","Total",682,197,61,136,485,39,72,92,160,22,31,69
"2011","Southampton 003A","E01017264","Total",483,241,62,179,242,29,30,57,64,12,15,35
"2011","Southampton 003B","E01017265","Total",751,307,116,191,444,53,71,79,112,22,43,64
"2011","Southampton 003C","E01017270","Total",556,234,141,93,322,12,73,54,96,14,18,55
"2011","Southampton 003D","E01017271","Total",466,135,63,72,331,12,78,53,89,10,27,62
"2011","Southampton 004A","E01017182","Total",725,364,258,106,361,16,83,47,99,17,25,74
"2011","Southampton 004B","E01017184","Total",603,177,80,97,426,36,69,81,120,18,26,76
"2011","Southampton 004C","E01017186","Total",695,225,53,172,470,60,35,84,132,23,40,96
"2011","Southampton 004D","E01017188","Total",623,124,54,70,499,50,62,92,109,36,53,97
"2011","Southampton 005A","E01017266","Total",483,90,42,48,393,37,40,47,69,27,32,141
"2011","Southampton 005B","E01017267","Total",442,107,27,80,335,6,36,37,77,11,30,138
"2011","Southampton 005E","E01017272","Total",506,103,43,60,403,37,41,80,107,32,42,64
"2011","Southampton 005F","E01032756","Total",963,201,78,123,762,18,55,73,153,27,37,399
"2011","Southampton 006A","E01017147","Total",637,206,99,107,431,13,70,78,156,8,24,82
"2011","Southampton 006B","E01017150","Total",615,178,105,73,437,7,124,66,114,15,29,82
"2011","Southampton 006C","E01017151","Total",733,275,138,137,458,26,100,78,125,12,38,79
"2011","Southampton 006D","E01017152","Total",661,210,61,149,451,31,60,101,124,13,35,87
"2011","Southampton 007A","E01017238","Total",582,191,87,104,391,45,71,60,85,19,42,69
"2011","Southampton 007B","E01017241","Total",657,263,176,87,394,65,66,68,89,20,23,63
"2011","Southampton 007C","E01017242","Total",730,311,92,219,419,32,56,75,169,9,17,61
"2011","Southampton 007D","E01017243","Total",660,153,75,78,507,19,74,92,125,22,53,122
"2011","Southampton 007E","E01017244","Total",511,122,72,50,389,39,56,59,93,22,42,78
"2011","Southampton 008A","E01017174","Total",553,130,78,52,423,22,118,79,92,15,21,76
"2011","Southampton 008B","E01017175","Total",623,164,63,101,459,26,81,107,107,12,48,78
"2011","Southampton 008C","E01017176","Total",677,172,68,104,505,36,103,90,140,15,39,82
"2011","Southampton 008D","E01017179","Total",618,189,74,115,429,57,65,84,112,17,33,61
"2011","Southampton 009A","E01017226","Total",830,416,203,213,414,7,99,46,191,4,16,51
"2011","Southampton 009D","E01017231","Total",640,181,69,112,459,13,45,43,115,8,19,216
"2011","Southampton 009E","E01017232","Total",495,149,71,78,346,7,53,68,76,15,14,113
"2011","Southampton 009F","E01032753","Total",788,204,77,127,584,15,92,88,130,21,40,198
"2011","Southampton 010A","E01017246","Total",879,306,66,240,573,43,71,139,216,9,33,62
"2011","Southampton 010B","E01017250","Total",728,356,171,185,372,60,70,63,92,16,20,51
"2011","Southampton 010C","E01017251","Total",661,206,63,143,455,55,57,101,119,11,48,64
"2011","Southampton 010D","E01017253","Total",656,165,68,97,491,49,71,94,113,34,44,86
"2011","Southampton 011A","E01017247","Total",622,154,77,77,468,17,79,104,119,21,43,85
"2011","Southampton 011B","E01017248","Total",600,156,84,72,444,10,76,103,103,24,50,78
"2011","Southampton 011C","E01017249","Total",508,96,56,40,412,9,78,86,94,22,45,78
"2011","Southampton 011D","E01017252","Total",663,201,109,92,462,11,86,102,122,16,42,83
"2011","Southampton 011E","E01017254","Total",672,195,74,121,477,43,52,102,148,19,40,73
"2011","Southampton 012A","E01017236","Total",599,203,98,105,396,75,59,66,83,20,26,67
"2011","Southampton 012B","E01017237","Total",590,180,58,122,410,46,49,90,85,32,44,64
"2011","Southampton 012C","E01017239","Total",641,193,67,126,448,42,57,95,130,23,40,61
"2011","Southampton 012D","E01017240","Total",599,259,63,196,340,73,57,47,86,17,22,38
"2011","Southampton 012E","E01017245","Total",611,170,75,95,441,111,54,89,73,25,33,56
"2011","Southampton 013A","E01017227","Total",410,133,21,112,277,6,4,15,78,4,13,157
"2011","Southampton 013B","E01017228","Total",712,261,56,205,451,45,49,72,163,16,29,77
"2011","Southampton 013C","E01017233","Total",723,242,89,153,481,39,62,78,171,14,29,88
"2011","Southampton 013D","E01017234","Total",735,259,84,175,476,28,48,61,117,12,24,186
"2011","Southampton 013E","E01017235","Total",601,232,36,196,369,14,19,51,126,6,10,143
"2011","Southampton 014A","E01017171","Total",872,362,82,280,510,30,60,108,199,15,29,69
"2011","Southampton 014B","E01017172","Total",809,303,58,245,506,39,47,97,184,16,34,89
"2011","Southampton 014C","E01017173","Total",617,178,78,100,439,31,75,93,117,16,30,77
"2011","Southampton 014D","E01017177","Total",749,313,106,207,436,21,86,87,151,2,24,65
"2011","Southampton 014E","E01017178","Total",589,124,38,86,465,25,60,99,147,22,38,74
"2011","Southampton 015A","E01017207","Total",697,243,70,173,454,101,60,97,92,31,28,45
"2011","Southampton 015B","E01017209","Total",584,168,59,109,416,39,43,115,90,16,23,90
"2011","Southampton 015C","E01017211","Total",934,480,269,211,454,24,94,84,156,6,30,60
"2011","Southampton 015D","E01017212","Total",555,151,66,85,404,26,58,76,116,16,35,77
"2011","Southampton 015E","E01017213","Total",713,259,60,199,454,16,56,76,181,14,21,90
"2011","Southampton 016A","E01017200","Total",840,323,186,137,517,19,112,93,146,11,38,98
"2011","Southampton 016B","E01017201","Total",630,231,88,143,399,57,85,77,89,21,26,44
"2011","Southampton 016C","E01017202","Total",747,247,59,188,500,110,58,107,135,15,23,52
"2011","Southampton 016D","E01017203","Total",632,137,63,74,495,28,93,93,127,26,46,82
"2011","Southampton 016E","E01017204","Total",625,161,88,73,464,20,87,107,110,12,31,97
"2011","Southampton 017A","E01017157","Total",571,221,47,174,350,6,16,23,113,3,11,178
"2011","Southampton 017B","E01017158","Total",796,315,80,235,481,24,31,45,184,6,16,175
"2011","Southampton 017C","E01017159","Total",527,114,12,102,413,19,20,30,107,6,22,209
"2011","Southampton 017D","E01017160","Total",669,241,34,207,428,17,20,44,194,5,19,129
"2011","Southampton 018A","E01017198","Total",673,249,156,93,424,15,122,72,99,9,25,82
"2011","Southampton 018B","E01017199","Total",771,274,158,116,497,46,148,71,119,15,28,70
"2011","Southampton 018C","E01017205","Total",515,154,81,73,361,43,51,56,66,24,54,67
"2011","Southampton 018D","E01017206","Total",648,175,80,95,473,23,88,68,125,26,50,93
"2011","Southampton 019A","E01017208","Total",561,163,58,105,398,63,46,83,77,25,34,70
"2011","Southampton 019B","E01017210","Total",603,166,81,85,437,85,45,73,95,34,44,61
"2011","Southampton 019C","E01017214","Total",552,136,38,98,416,30,57,101,109,19,34,66
"2011","Southampton 019D","E01017215","Total",696,163,74,89,533,21,84,124,156,26,37,85
"2011","Southampton 019E","E01017216","Total",579,154,44,110,425,27,47,78,121,25,37,90
"2011","Southampton 020A","E01017189","Total",734,364,34,330,370,8,18,74,168,7,20,75
"2011","Southampton 020B","E01017190","Total",730,317,38,279,413,10,41,49,207,6,11,89
"2011","Southampton 020C","E01017191","Total",791,348,29,319,443,25,26,90,165,10,39,88
"2011","Southampton 020D","E01017196","Total",1012,423,58,365,589,23,62,75,334,14,16,65
"2011","Southampton 020E","E01017197","Total",553,127,45,82,426,15,40,95,119,25,36,96
"2011","Southampton 021A","E01017192","Total",911,332,76,256,579,61,50,117,199,12,49,91
"2011","Southampton 021B","E01017193","Total",848,394,137,257,454,37,40,81,178,10,23,85
"2011","Southampton 021C","E01017194","Total",827,321,58,263,506,26,32,95,211,10,35,97
"2011","Southampton 021D","E01017195","Total",941,382,79,303,559,58,45,97,228,9,31,91
"2011","Southampton 022A","E01017153","Total",466,96,19,77,370,12,13,56,67,38,79,105
"2011","Southampton 022B","E01017154","Total",888,325,48,277,563,88,31,118,128,65,64,69
"2011","Southampton 022C","E01017155","Total",538,149,35,114,389,17,16,61,79,35,74,107
"2011","Southampton 022D","E01017156","Total",492,104,26,78,388,26,22,37,38,50,101,114
"2011","Southampton 022F","E01032738","Total",630,301,15,286,329,18,8,31,163,2,6,101
"2011","Southampton 022G","E01032750","Total",621,372,34,338,249,23,11,42,88,7,20,58
"2011","Southampton 023A","E01017136","Total",622,228,74,154,394,3,31,20,129,2,10,199
"2011","Southampton 023B","E01017137","Total",647,246,18,228,401,2,11,8,96,2,10,272
"2011","Southampton 023C","E01017138","Total",940,384,103,281,556,20,41,57,242,6,2,188
"2011","Southampton 023D","E01017140","Total",831,479,150,329,352,20,53,54,143,7,11,64
"2011","Southampton 024A","E01017217","Total",663,228,100,128,435,21,89,71,123,25,30,76
"2011","Southampton 024B","E01017223","Total",662,149,55,94,513,18,82,105,133,21,47,107
"2011","Southampton 024C","E01017224","Total",550,129,66,63,421,16,77,80,110,15,29,94
"2011","Southampton 024D","E01017225","Total",609,143,62,81,466,38,74,111,114,24,29,76
"2011","Southampton 025A","E01017162","Total",625,176,103,73,449,24,130,63,107,14,32,79
"2011","Southampton 025B","E01017163","Total",651,220,55,165,431,83,51,90,99,29,36,43
"2011","Southampton 025C","E01017164","Total",670,220,99,121,450,21,95,74,137,14,36,73
"2011","Southampton 025D","E01017165","Total",622,204,128,76,418,39,91,58,99,16,40,75
"2011","Southampton 025E","E01017166","Total",668,257,113,144,411,90,51,71,78,24,32,65
"2011","Southampton 026A","E01017256","Total",863,236,115,121,627,32,146,115,167,20,40,107
"2011","Southampton 026B","E01017257","Total",767,342,112,230,425,26,63,99,132,10,24,71
"2011","Southampton 026C","E01017259","Total",601,138,68,70,463,22,100,99,121,14,34,73
"2011","Southampton 026D","E01017260","Total",653,222,131,91,431,18,127,73,111,10,20,72
"2011","Southampton 026E","E01017262","Total",528,123,55,68,405,33,55,95,112,8,35,67
"2011","Southampton 027A","E01017167","Total",673,242,50,192,431,104,53,78,92,29,21,54
"2011","Southampton 027B","E01017168","Total",824,337,99,238,487,83,83,75,140,17,33,56
"2011","Southampton 027C","E01017169","Total",641,212,112,100,429,55,72,85,86,33,38,60
"2011","Southampton 027D","E01017170","Total",670,213,105,108,457,36,90,97,98,24,35,77
"2011","Southampton 028A","E01017218","Total",495,107,43,64,388,35,45,72,85,25,51,75
"2011","Southampton 028B","E01017219","Total",857,383,123,260,474,64,79,84,137,11,26,73
"2011","Southampton 028C","E01017220","Total",800,291,110,181,509,42,65,87,136,22,51,106
"2011","Southampton 028D","E01017221","Total",662,169,54,115,493,36,52,116,149,20,34,86
"2011","Southampton 028E","E01017222","Total",620,178,35,143,442,28,56,112,103,19,37,87
"2011","Southampton 029A","E01017139","Total",904,429,125,304,475,48,43,81,168,23,38,74
"2011","Southampton 029C","E01017142","Total",1021,485,21,464,536,18,45,46,366,1,11,49
"2011","Southampton 029E","E01032745","Total",577,240,36,204,337,43,5,55,132,19,15,68
"2011","Southampton 029F","E01032746","Total",713,348,4,344,365,8,8,46,278,1,2,22
"2011","Southampton 029G","E01032748","Total",635,299,32,267,336,7,22,21,227,1,8,50
"2011","Southampton 029H","E01032751","Total",565,224,32,192,341,21,27,52,156,7,16,62
"2011","Southampton 029I","E01032755","Total",493,220,29,191,273,50,11,79,65,31,15,22
"2011","Southampton 030A","E01017255","Total",686,199,76,123,487,27,98,103,130,14,37,78
"2011","Southampton 030B","E01017258","Total",640,203,89,114,437,26,49,107,121,20,40,74
"2011","Southampton 030C","E01017261","Total",717,201,86,115,516,28,86,104,161,17,34,86
"2011","Southampton 030D","E01017263","Total",598,174,78,96,424,23,83,68,113,20,39,78
"2011","Southampton 031A","E01017273","Total",594,187,73,114,407,22,96,74,102,16,29,68
"2011","Southampton 031B","E01017275","Total",691,213,59,154,478,25,79,86,140,20,26,102
"2011","Southampton 031C","E01017276","Total",742,238,51,187,504,50,47,123,157,21,32,74
"2011","Southampton 031D","E01017278","Total",600,184,57,127,416,36,51,78,152,15,24,60
"2011","Southampton 031E","E01017279","Total",730,234,79,155,496,30,83,112,161,17,22,71
"2011","Southampton 032A","E01017274","Total",613,174,83,91,439,67,72,79,102,18,36,65
"2011","Southampton 032B","E01017277","Total",582,119,46,73,463,45,54,98,139,26,32,69
"2011","Southampton 032C","E01017280","Total",604,214,102,112,390,47,57,72,96,22,28,68
"2011","Southampton 032D","E01017281","Total",818,369,69,300,449,136,28,116,103,18,11,37
"2011","West Berkshire 001A","E01016277","Total",527,91,53,38,436,9,116,104,126,22,28,31
"2011","West Berkshire 001B","E01016286","Total",602,123,46,77,479,36,65,111,140,19,38,70
"2011","West Berkshire 001C","E01016287","Total",573,121,40,81,452,17,67,120,141,19,31,57
"2011","West Berkshire 001D","E01016288","Total",666,137,67,70,529,23,101,105,160,23,37,80
"2011","West Berkshire 002A","E01016303","Total",633,174,62,112,459,12,121,96,130,25,27,48
"2011","West Berkshire 002B","E01016304","Total",672,192,78,114,480,22,87,96,165,15,17,78
"2011","West Berkshire 002C","E01016305","Total",581,201,83,118,380,7,84,68,137,10,20,54
"2011","West Berkshire 002D","E01016306","Total",530,142,64,78,388,12,84,81,98,21,30,62
"2011","West Berkshire 003A","E01016256","Total",666,108,42,66,558,14,118,124,147,23,35,97
"2011","West Berkshire 003B","E01016257","Total",534,126,63,63,408,7,93,96,111,27,27,47
"2011","West Berkshire 003C","E01016313","Total",706,218,109,109,488,28,104,116,121,14,25,80
"2011","West Berkshire 003D","E01016314","Total",521,159,78,81,362,8,106,64,98,16,19,51
"2011","West Berkshire 004A","E01016315","Total",713,210,80,130,503,13,127,96,150,11,26,80
"2011","West Berkshire 004B","E01016316","Total",793,161,72,89,632,20,107,141,187,15,44,118
"2011","West Berkshire 004C","E01016317","Total",510,84,43,41,426,18,99,78,93,21,28,89
"2011","West Berkshire 004D","E01016318","Total",626,147,65,82,479,17,96,109,123,20,29,85
"2011","West Berkshire 005A","E01016258","Total",669,196,110,86,473,14,129,82,114,12,36,86
"2011","West Berkshire 005B","E01016261","Total",550,55,16,39,495,16,48,130,112,19,51,119
"2011","West Berkshire 005C","E01016349","Total",472,81,59,22,391,10,94,81,86,13,25,82
"2011","West Berkshire 005D","E01016350","Total",596,129,81,48,467,21,106,101,103,13,39,84
"2011","West Berkshire 006A","E01016259","Total",584,102,34,68,482,26,78,106,121,14,41,96
"2011","West Berkshire 006B","E01016260","Total",617,85,41,44,532,20,112,110,117,20,45,108
"2011","West Berkshire 006C","E01016262","Total",531,106,77,29,425,19,131,71,69,10,35,90
"2011","West Berkshire 006D","E01016272","Total",590,115,36,79,475,20,80,80,122,17,35,121
"2011","West Berkshire 006E","E01016273","Total",627,202,123,79,425,48,56,92,95,15,34,85
"2011","West Berkshire 007A","E01016263","Total",849,149,62,87,700,49,117,208,171,36,39,80
"2011","West Berkshire 007B","E01016278","Total",411,45,21,24,366,13,45,122,93,18,34,41
"2011","West Berkshire 007C","E01016283","Total",575,83,41,42,492,14,114,105,141,14,36,68
"2011","West Berkshire 007D","E01016284","Total",515,80,38,42,435,10,86,105,101,20,33,80
"2011","West Berkshire 007E","E01016285","Total",622,139,65,74,483,17,87,100,137,31,36,75
"2011","West Berkshire 008A","E01016271","Total",597,168,75,93,429,21,81,76,119,9,29,94
"2011","West Berkshire 008B","E01016274","Total",512,76,23,53,436,29,73,66,121,21,31,95
"2011","West Berkshire 008C","E01016275","Total",647,199,43,156,448,37,36,119,171,17,15,53
"2011","West Berkshire 008D","E01016276","Total",578,137,30,107,441,33,37,118,129,16,36,72
"2011","West Berkshire 009A","E01016327","Total",471,86,31,55,385,19,61,88,118,18,20,61
"2011","West Berkshire 009B","E01016328","Total",717,176,69,107,541,40,103,122,140,25,35,76
"2011","West Berkshire 009C","E01016344","Total",714,276,120,156,438,46,66,76,154,15,28,53
"2011","West Berkshire 009D","E01016345","Total",538,140,35,105,398,26,55,93,115,14,32,63
"2011","West Berkshire 010A","E01016296","Total",766,294,157,137,472,37,81,93,166,9,18,68
"2011","West Berkshire 010B","E01016297","Total",628,163,92,71,465,23,100,85,120,20,32,85
"2011","West Berkshire 010C","E01016298","Total",564,218,87,131,346,17,74,65,135,7,10,38
"2011","West Berkshire 010D","E01016299","Total",642,190,70,120,452,17,94,114,132,17,19,59
"2011","West Berkshire 011A","E01016254","Total",611,207,103,104,404,14,94,73,132,8,24,59
"2011","West Berkshire 011B","E01016255","Total",581,137,66,71,444,10,96,80,130,20,30,78
"2011","West Berkshire 011C","E01016264","Total",430,114,47,67,316,13,65,71,94,16,16,41
"2011","West Berkshire 011D","E01016265","Total",578,119,56,63,459,15,108,100,114,20,28,74
"2011","West Berkshire 011E","E01016266","Total",530,113,62,51,417,12,88,75,113,19,39,71
"2011","West Berkshire 011F","E01016339","Total",1124,243,63,180,881,64,107,238,278,45,36,113
"2011","West Berkshire 012A","E01016310","Total",826,319,176,143,507,32,84,99,149,14,39,90
"2011","West Berkshire 012B","E01016311","Total",819,334,135,199,485,23,100,87,182,12,17,64
"2011","West Berkshire 012C","E01016323","Total",595,176,95,81,419,16,111,74,115,13,22,68
"2011","West Berkshire 012D","E01016324","Total",577,145,77,68,432,14,101,82,112,14,29,80
"2011","West Berkshire 012E","E01016325","Total",649,187,102,85,462,60,102,87,96,19,30,68
"2011","West Berkshire 013A","E01016279","Total",914,311,84,227,603,53,60,138,197,18,42,95
"2011","West Berkshire 013B","E01016280","Total",700,162,49,113,538,60,71,97,158,24,39,89
"2011","West Berkshire 013C","E01016281","Total",556,113,50,63,443,20,81,90,122,16,36,78
"2011","West Berkshire 013D","E01016282","Total",615,147,34,113,468,30,53,120,161,15,24,65
"2011","West Berkshire 014A","E01016329","Total",606,153,26,127,453,22,29,116,172,14,28,72
"2011","West Berkshire 014B","E01016340","Total",631,153,79,74,478,29,90,90,126,18,37,88
"2011","West Berkshire 014C","E01016341","Total",512,78,30,48,434,20,61,87,125,21,39,81
"2011","West Berkshire 014D","E01016342","Total",783,168,35,133,615,44,56,138,193,24,41,119
"2011","West Berkshire 014E","E01016343","Total",578,129,66,63,449,9,80,85,126,12,35,102
"2011","West Berkshire 015A","E01016267","Total",550,92,40,52,458,18,88,100,134,17,30,71
"2011","West Berkshire 015B","E01016268","Total",624,141,55,86,483,31,91,92,125,25,34,85
"2011","West Berkshire 015C","E01016269","Total",565,142,63,79,423,9,70,94,128,13,32,77
"2011","West Berkshire 015D","E01016270","Total",533,83,23,60,450,22,39,138,141,25,36,49
"2011","West Berkshire 016A","E01016330","Total",665,243,84,159,422,30,55,95,145,10,21,66
"2011","West Berkshire 016B","E01016331","Total",593,119,56,63,474,36,47,134,120,25,35,77
"2011","West Berkshire 016C","E01016332","Total",755,330,210,120,425,35,99,90,98,9,21,73
"2011","West Berkshire 016D","E01016334","Total",637,146,32,114,491,35,36,141,140,19,45,75
"2011","West Berkshire 016E","E01016336","Total",479,120,51,69,359,49,57,82,64,10,46,51
"2011","West Berkshire 017A","E01016333","Total",492,100,20,80,392,20,36,123,108,13,33,59
"2011","West Berkshire 017B","E01016335","Total",586,101,34,67,485,15,65,124,134,23,22,102
"2011","West Berkshire 017C","E01016337","Total",887,229,97,132,658,44,107,170,157,36,34,110
"2011","West Berkshire 017D","E01016338","Total",743,171,68,103,572,25,58,150,159,20,43,117
"2011","West Berkshire 018A","E01016300","Total",642,193,92,101,449,25,91,107,138,21,13,54
"2011","West Berkshire 018B","E01016301","Total",771,158,72,86,613,13,123,112,196,26,28,115
"2011","West Berkshire 018C","E01016302","Total",633,120,55,65,513,13,86,126,146,18,37,87
"2011","West Berkshire 018D","E01016326","Total",541,129,64,65,412,21,84,86,127,17,27,50
"2011","West Berkshire 019A","E01016293","Total",1005,190,53,137,815,49,118,190,224,38,81,115
"2011","West Berkshire 019B","E01016346","Total",729,379,118,261,350,30,49,54,158,4,14,41
"2011","West Berkshire 019C","E01016347","Total",880,472,170,302,408,26,63,79,191,6,10,33
"2011","West Berkshire 019D","E01016348","Total",978,365,90,275,613,32,44,155,273,14,22,73
"2011","West Berkshire 020A","E01016294","Total",650,173,59,114,477,16,86,101,153,14,16,91
"2011","West Berkshire 020B","E01016295","Total",616,193,47,146,423,75,33,83,112,28,27,65
"2011","West Berkshire 020C","E01016312","Total",825,248,68,180,577,40,68,147,174,20,39,89
"2011","West Berkshire 020D","E01016319","Total",737,283,152,131,454,23,98,96,125,13,33,66
"2011","West Berkshire 020E","E01016320","Total",637,228,78,150,409,14,94,85,112,14,27,63
"2011","West Berkshire 021A","E01016289","Total",579,105,80,25,474,8,158,75,104,22,23,84
"2011","West Berkshire 021B","E01016290","Total",629,147,74,73,482,20,86,123,127,17,24,85
"2011","West Berkshire 021C","E01016291","Total",688,143,84,59,545,18,100,161,129,29,29,79
"2011","West Berkshire 021D","E01016292","Total",615,128,80,48,487,28,90,80,110,23,51,105
"2011","West Berkshire 021E","E01016321","Total",609,164,77,87,445,24,84,77,128,10,32,90
"2011","West Berkshire 021F","E01016322","Total",491,96,60,36,395,11,94,81,76,19,30,84
"2011","West Berkshire 022A","E01016307","Total",679,212,112,100,467,27,110,99,101,26,31,73
"2011","West Berkshire 022B","E01016308","Total",759,153,76,77,606,25,144,121,172,42,32,70
"2011","West Berkshire 022C","E01016309","Total",888,235,110,125,653,48,137,149,180,26,29,84
"2011","Windsor and Maidenhead 001A","E01016570","Total",640,143,76,67,497,19,88,134,126,13,25,92
"2011","Windsor and Maidenhead 001B","E01016572","Total",559,142,83,59,417,24,100,76,103,18,24,72
"2011","Windsor and Maidenhead 001C","E01016582","Total",501,122,48,74,379,16,50,75,85,20,58,75
"2011","Windsor and Maidenhead 001D","E01016600","Total",448,88,47,41,360,12,106,65,74,16,33,54
"2011","Windsor and Maidenhead 002A","E01016530","Total",647,213,119,94,434,26,93,94,105,14,32,70
"2011","Windsor and Maidenhead 002B","E01016531","Total",607,146,68,78,461,13,134,90,123,17,24,60
"2011","Windsor and Maidenhead 002C","E01016532","Total",840,220,95,125,620,13,159,126,183,24,26,89
"2011","Windsor and Maidenhead 002D","E01016533","Total",770,155,68,87,615,24,149,152,147,28,37,78
"2011","Windsor and Maidenhead 002E","E01016578","Total",589,140,63,77,449,15,87,64,144,22,28,89
"2011","Windsor and Maidenhead 002F","E01016579","Total",693,172,75,97,521,24,122,112,138,17,35,73
"2011","Windsor and Maidenhead 002G","E01016581","Total",572,137,60,77,435,15,87,105,104,18,30,76
"2011","Windsor and Maidenhead 003A","E01016571","Total",562,93,50,43,469,16,83,110,94,23,42,101
"2011","Windsor and Maidenhead 003B","E01016573","Total",523,127,57,70,396,37,55,78,86,20,40,80
"2011","Windsor and Maidenhead 003C","E01016574","Total",604,184,102,82,420,19,101,68,95,18,41,78
"2011","Windsor and Maidenhead 003D","E01016599","Total",600,132,46,86,468,42,74,92,89,18,60,93
"2011","Windsor and Maidenhead 004A","E01016583","Total",680,191,75,116,489,7,116,92,145,17,27,85
"2011","Windsor and Maidenhead 004B","E01016585","Total",781,306,109,197,475,17,90,70,188,10,26,74
"2011","Windsor and Maidenhead 004C","E01016586","Total",542,126,57,69,416,8,125,57,105,17,27,77
"2011","Windsor and Maidenhead 004D","E01016591","Total",629,105,40,65,524,8,110,123,123,18,53,89
"2011","Windsor and Maidenhead 004E","E01016592","Total",798,263,125,138,535,16,114,109,171,13,28,84
"2011","Windsor and Maidenhead 005A","E01016525","Total",635,149,67,82,486,15,74,125,140,23,33,76
"2011","Windsor and Maidenhead 005B","E01016528","Total",631,174,66,108,457,11,79,102,118,25,49,73
"2011","Windsor and Maidenhead 005C","E01016529","Total",654,238,101,137,416,41,58,74,98,22,56,67
"2011","Windsor and Maidenhead 005D","E01016536","Total",848,327,93,234,521,25,55,107,200,17,40,77
"2011","Windsor and Maidenhead 005E","E01016584","Total",669,196,70,126,473,53,51,99,138,19,45,68
"2011","Windsor and Maidenhead 005G","E01032733","Total",617,339,143,196,278,35,24,63,134,1,4,17
"2011","Windsor and Maidenhead 005H","E01032734","Total",650,251,49,202,399,33,35,98,123,15,25,70
"2011","Windsor and Maidenhead 006A","E01016526","Total",713,179,69,110,534,26,43,175,145,32,40,73
"2011","Windsor and Maidenhead 006B","E01016527","Total",656,190,41,149,466,26,40,138,160,11,30,61
"2011","Windsor and Maidenhead 006C","E01016534","Total",587,108,71,37,479,6,121,80,102,15,36,119
"2011","Windsor and Maidenhead 006D","E01016598","Total",513,101,57,44,412,7,104,93,78,19,30,81
"2011","Windsor and Maidenhead 006E","E01016601","Total",616,155,64,91,461,24,69,146,88,18,36,80
"2011","Windsor and Maidenhead 006F","E01016602","Total",636,165,120,45,471,14,109,100,92,14,37,105
"2011","Windsor and Maidenhead 007A","E01016535","Total",491,122,49,73,369,16,67,67,87,22,31,79
"2011","Windsor and Maidenhead 007B","E01016537","Total",470,69,26,43,401,11,56,80,65,36,62,91
"2011","Windsor and Maidenhead 007C","E01016538","Total",625,141,44,97,484,28,76,122,127,18,29,84
"2011","Windsor and Maidenhead 007D","E01016593","Total",665,183,69,114,482,36,65,96,126,31,52,76
"2011","Windsor and Maidenhead 007E","E01016594","Total",582,166,66,100,416,31,65,82,106,26,39,67
"2011","Windsor and Maidenhead 008A","E01016559","Total",562,110,51,59,452,5,111,100,83,19,35,99
"2011","Windsor and Maidenhead 008B","E01016560","Total",646,207,88,119,439,42,80,94,104,24,37,58
"2011","Windsor and Maidenhead 008C","E01016561","Total",674,112,38,74,562,19,86,139,143,9,46,120
"2011","Windsor and Maidenhead 008D","E01016562","Total",513,86,51,35,427,5,80,101,97,10,39,95
"2011","Windsor and Maidenhead 008E","E01016563","Total",507,89,29,60,418,11,61,95,109,13,24,105
"2011","Windsor and Maidenhead 008F","E01016580","Total",643,209,83,126,434,35,62,93,104,18,36,86
"2011","Windsor and Maidenhead 009A","E01016539","Total",641,169,93,76,472,8,106,104,123,16,39,76
"2011","Windsor and Maidenhead 009B","E01016540","Total",652,159,71,88,493,20,99,109,126,18,38,83
"2011","Windsor and Maidenhead 009C","E01016541","Total",512,84,28,56,428,10,83,88,100,16,36,95
"2011","Windsor and Maidenhead 009D","E01016542","Total",491,136,59,77,355,22,66,94,81,17,25,50
"2011","Windsor and Maidenhead 009E","E01016543","Total",670,170,65,105,500,18,104,104,151,17,30,76
"2011","Windsor and Maidenhead 010A","E01016544","Total",800,356,101,255,444,15,53,95,198,7,15,61
"2011","Windsor and Maidenhead 010B","E01016567","Total",817,340,84,256,477,17,70,87,181,25,31,66
"2011","Windsor and Maidenhead 010C","E01016568","Total",499,132,81,51,367,25,61,70,84,8,25,94
"2011","Windsor and Maidenhead 010D","E01016569","Total",493,189,78,111,304,13,60,56,94,6,21,54
"2011","Windsor and Maidenhead 011A","E01016564","Total",644,191,91,100,453,27,64,94,112,24,54,78
"2011","Windsor and Maidenhead 011B","E01016565","Total",624,157,73,84,467,11,88,92,131,20,34,91
"2011","Windsor and Maidenhead 011C","E01016566","Total",764,283,65,218,481,36,51,107,165,24,32,66
"2011","Windsor and Maidenhead 011D","E01016577","Total",698,217,75,142,481,36,76,83,125,7,48,106
"2011","Windsor and Maidenhead 012A","E01016545","Total",1069,541,211,330,528,53,57,115,233,6,18,46
"2011","Windsor and Maidenhead 012B","E01016547","Total",756,243,68,175,513,32,34,128,219,15,18,67
"2011","Windsor and Maidenhead 012C","E01016550","Total",510,156,67,89,354,12,42,109,84,14,31,62
"2011","Windsor and Maidenhead 012D","E01016552","Total",686,211,64,147,475,22,90,115,124,22,28,74
"2011","Windsor and Maidenhead 013A","E01016551","Total",623,140,93,47,483,11,141,85,84,15,42,105
"2011","Windsor and Maidenhead 013B","E01016553","Total",676,246,146,100,430,18,134,65,89,13,25,86
"2011","Windsor and Maidenhead 013C","E01016557","Total",832,259,143,116,573,41,119,91,156,11,46,109
"2011","Windsor and Maidenhead 013D","E01016558","Total",613,95,32,63,518,40,40,206,130,33,35,34
"2011","Windsor and Maidenhead 014A","E01016548","Total",830,261,84,177,569,29,88,119,176,21,46,90
"2011","Windsor and Maidenhead 014B","E01016549","Total",858,306,149,157,552,49,88,126,149,20,33,87
"2011","Windsor and Maidenhead 014C","E01016554","Total",650,196,70,126,454,59,83,102,96,21,30,63
"2011","Windsor and Maidenhead 014D","E01016555","Total",588,175,68,107,413,35,50,85,96,17,45,85
"2011","Windsor and Maidenhead 014E","E01016556","Total",762,258,128,130,504,47,87,92,117,15,44,102
"2011","Windsor and Maidenhead 015A","E01016546","Total",750,265,73,192,485,12,73,140,179,20,14,47
"2011","Windsor and Maidenhead 015B","E01016595","Total",680,168,70,98,512,35,76,124,146,26,37,68
"2011","Windsor and Maidenhead 015C","E01016596","Total",797,272,103,169,525,24,93,124,150,30,26,78
"2011","Windsor and Maidenhead 015D","E01016597","Total",617,64,27,37,553,14,126,124,101,22,53,113
"2011","Windsor and Maidenhead 016A","E01016575","Total",637,122,69,53,515,10,136,64,114,5,48,138
"2011","Windsor and Maidenhead 016B","E01016576","Total",661,155,85,70,506,15,103,103,111,20,56,98
"2011","Windsor and Maidenhead 016C","E01016587","Total",638,161,89,72,477,14,120,96,94,20,26,107
"2011","Windsor and Maidenhead 016D","E01016588","Total",777,264,147,117,513,17,100,114,141,15,30,96
"2011","Windsor and Maidenhead 016E","E01016589","Total",642,166,97,69,476,14,101,92,116,20,34,99
"2011","Windsor and Maidenhead 017A","E01016522","Total",698,136,52,84,562,11,101,141,118,35,41,115
"2011","Windsor and Maidenhead 017B","E01016523","Total",584,169,55,114,415,19,92,83,96,20,27,78
"2011","Windsor and Maidenhead 017C","E01016524","Total",864,291,82,209,573,31,114,126,145,38,35,84
"2011","Windsor and Maidenhead 017D","E01016609","Total",740,211,90,121,529,45,63,140,142,22,39,78
"2011","Windsor and Maidenhead 018A","E01016603","Total",744,245,132,113,499,14,119,113,115,25,40,73
"2011","Windsor and Maidenhead 018B","E01016604","Total",778,230,108,122,548,19,125,115,135,31,41,82
"2011","Windsor and Maidenhead 018C","E01016605","Total",613,167,57,110,446,18,90,103,101,30,31,73
"2011","Windsor and Maidenhead 018D","E01016606","Total",646,158,49,109,488,14,108,117,106,29,36,78
"2011","Windsor and Maidenhead 018E","E01016607","Total",529,100,50,50,429,10,89,81,88,26,46,89
"2011","Windsor and Maidenhead 018F","E01016608","Total",808,269,136,133,539,58,92,131,143,23,24,68
"2011","Wokingham 001A","E01016675","Total",469,163,77,86,306,6,75,58,91,11,17,48
"2011","Wokingham 001B","E01016676","Total",621,127,74,53,494,16,147,92,120,19,30,70
"2011","Wokingham 001C","E01016677","Total",619,175,97,78,444,13,108,94,117,11,28,73
"2011","Wokingham 001D","E01016678","Total",563,158,78,80,405,8,101,76,110,19,25,66
"2011","Wokingham 002A","E01016619","Total",571,75,35,40,496,14,104,119,127,26,41,65
"2011","Wokingham 002B","E01016620","Total",526,82,34,48,444,12,68,123,100,20,41,80
"2011","Wokingham 002C","E01016692","Total",653,200,119,81,453,12,112,93,150,20,19,47
"2011","Wokingham 002D","E01016693","Total",604,175,38,137,429,17,57,110,177,10,21,37
"2011","Wokingham 002E","E01016694","Total",683,263,137,126,420,12,96,108,137,17,13,37
"2011","Wokingham 002F","E01016695","Total",597,116,79,37,481,14,95,122,125,21,25,79
"2011","Wokingham 003A","E01016621","Total",582,115,57,58,467,37,83,94,109,17,31,96
"2011","Wokingham 003B","E01016623","Total",605,145,95,50,460,12,120,103,99,18,29,79
"2011","Wokingham 003C","E01016624","Total",527,79,56,23,448,10,114,84,87,23,42,88
"2011","Wokingham 003D","E01016684","Total",619,123,52,71,496,28,110,88,109,19,37,105
"2011","Wokingham 003E","E01016685","Total",621,163,99,64,458,14,115,93,101,16,39,80
"2011","Wokingham 004A","E01016622","Total",462,73,39,34,389,9,90,70,91,23,31,75
"2011","Wokingham 004B","E01016657","Total",547,96,32,64,451,21,62,163,109,24,23,49
"2011","Wokingham 004C","E01016658","Total",484,89,25,64,395,21,25,106,103,19,42,79
"2011","Wokingham 004D","E01016659","Total",643,224,69,155,419,45,30,106,143,5,29,61
"2011","Wokingham 004E","E01016660","Total",624,127,35,92,497,25,62,119,137,22,46,86
"2011","Wokingham 005A","E01016615","Total",605,193,135,58,412,19,90,65,75,27,39,97
"2011","Wokingham 005B","E01016616","Total",622,195,136,59,427,12,121,65,89,21,39,80
"2011","Wokingham 005C","E01016617","Total",502,124,99,25,378,8,113,73,70,8,27,79
"2011","Wokingham 005D","E01016662","Total",700,203,84,119,497,47,74,109,114,38,38,77
"2011","Wokingham 006A","E01016613","Total",479,80,39,41,399,22,41,73,76,19,78,90
"2011","Wokingham 006B","E01016614","Total",477,83,52,31,394,10,75,53,86,20,50,100
"2011","Wokingham 006C","E01016618","Total",486,124,83,41,362,8,73,64,79,14,36,88
"2011","Wokingham 006D","E01016664","Total",476,109,74,35,367,8,83,100,52,21,30,73
"2011","Wokingham 006E","E01016668","Total",602,139,65,74,463,20,91,112,90,19,37,94
"2011","Wokingham 006F","E01016669","Total",703,177,90,87,526,16,112,114,117,27,54,86
"2011","Wokingham 007A","E01016661","Total",493,71,33,38,422,14,72,93,102,22,31,88
"2011","Wokingham 007B","E01016663","Total",598,126,67,59,472,17,98,96,107,23,38,93
"2011","Wokingham 007C","E01016686","Total",486,142,32,110,344,18,37,81,108,8,26,66
"2011","Wokingham 007D","E01016687","Total",500,105,53,52,395,10,97,81,92,12,30,73
"2011","Wokingham 007E","E01016688","Total",454,87,23,64,367,20,62,68,92,10,29,86
"2011","Wokingham 007F","E01016689","Total",579,138,85,53,441,7,132,96,78,15,23,90
"2011","Wokingham 008B","E01016652","Total",470,86,22,64,384,20,58,98,81,15,29,83
"2011","Wokingham 008C","E01016653","Total",450,83,50,33,367,6,54,67,86,17,42,95
"2011","Wokingham 008D","E01016665","Total",642,171,64,107,471,23,70,134,118,16,31,79
"2011","Wokingham 008E","E01016666","Total",503,74,27,47,429,11,47,93,134,21,36,87
"2011","Wokingham 008G","E01032761","Total",970,181,115,66,789,9,197,161,171,37,68,146
"2011","Wokingham 009A","E01016647","Total",626,85,13,72,541,23,39,163,135,28,55,98
"2011","Wokingham 009B","E01016701","Total",643,110,47,63,533,7,92,130,134,23,48,99
"2011","Wokingham 009C","E01016702","Total",697,135,45,90,562,24,81,126,163,25,51,92
"2011","Wokingham 009D","E01016703","Total",691,140,37,103,551,25,66,162,151,29,44,74
"2011","Wokingham 009E","E01016704","Total",796,205,67,138,591,52,84,139,151,29,49,87
"2011","Wokingham 010A","E01016627","Total",716,139,49,90,577,15,97,123,167,32,35,108
"2011","Wokingham 010B","E01016628","Total",619,128,78,50,491,15,133,110,107,21,26,79
"2011","Wokingham 010C","E01016656","Total",560,130,65,65,430,14,82,76,124,17,41,76
"2011","Wokingham 010D","E01016700","Total",722,142,56,86,580,19,75,137,173,20,33,123
"2011","Wokingham 011A","E01016644","Total",529,103,27,76,426,20,37,143,100,16,37,73
"2011","Wokingham 011B","E01016645","Total",745,306,45,261,439,17,39,123,182,14,14,50
"2011","Wokingham 011C","E01016646","Total",610,138,17,121,472,11,39,140,148,22,36,76
"2011","Wokingham 011D","E01016648","Total",638,208,43,165,430,19,27,138,162,9,18,57
"2011","Wokingham 011E","E01016649","Total",622,193,43,150,429,11,38,101,155,15,33,76
"2011","Wokingham 012A","E01016651","Total",587,157,52,105,430,20,67,90,138,16,31,68
"2011","Wokingham 012B","E01016654","Total",590,170,70,100,420,17,71,98,125,10,31,68
"2011","Wokingham 012C","E01016655","Total",503,96,19,77,407,12,39,98,147,13,27,71
"2011","Wokingham 012D","E01016679","Total",842,181,39,142,661,55,67,168,182,22,49,118
"2011","Wokingham 012E","E01016680","Total",496,132,49,83,364,42,38,82,84,23,37,58
"2011","Wokingham 012G","E01032758","Total",608,114,35,79,494,31,44,165,146,14,27,67
"2011","Wokingham 012H","E01032759","Total",580,111,48,63,469,14,79,106,158,19,20,73
"2011","Wokingham 013A","E01016626","Total",800,331,142,189,469,35,74,105,167,15,29,44
"2011","Wokingham 013B","E01016671","Total",869,407,270,137,462,11,141,82,150,12,13,53
"2011","Wokingham 013C","E01016673","Total",740,241,101,140,499,51,89,97,124,19,42,77
"2011","Wokingham 013D","E01016674","Total",580,152,54,98,428,32,71,85,116,17,26,81
"2011","Wokingham 013E","E01016696","Total",736,302,117,185,434,25,53,99,191,10,9,47
"2011","Wokingham 014A","E01016670","Total",821,188,45,143,633,29,76,204,197,23,38,66
"2011","Wokingham 014B","E01016672","Total",702,118,57,61,584,12,148,137,152,17,29,89
"2011","Wokingham 014E","E01032763","Total",905,191,117,74,714,11,182,161,177,20,55,108
"2011","Wokingham 015A","E01016612","Total",788,105,46,59,683,11,124,186,158,35,54,115
"2011","Wokingham 015B","E01016629","Total",523,83,53,30,440,3,130,73,84,20,32,98
"2011","Wokingham 015C","E01016630","Total",569,113,31,82,456,21,40,122,128,22,34,89
"2011","Wokingham 015D","E01016635","Total",507,95,37,58,412,14,35,120,102,24,29,88
"2011","Wokingham 016A","E01016625","Total",658,141,70,71,517,17,136,101,137,26,35,65
"2011","Wokingham 016B","E01016631","Total",558,166,68,98,392,23,46,94,108,17,23,81
"2011","Wokingham 016C","E01016632","Total",588,128,41,87,460,7,71,121,127,15,38,81
"2011","Wokingham 016D","E01016634","Total",606,147,62,85,459,9,109,110,123,17,26,65
"2011","Wokingham 016E","E01016699","Total",635,178,70,108,457,19,103,97,134,16,29,59
"2011","Wokingham 017A","E01016682","Total",748,176,65,111,572,22,84,168,182,21,20,75
"2011","Wokingham 017B","E01016683","Total",728,158,54,104,570,21,95,145,148,23,33,105
"2011","Wokingham 017C","E01016690","Total",747,206,95,111,541,41,82,121,169,22,28,78
"2011","Wokingham 017D","E01016691","Total",446,85,46,39,361,3,70,85,104,13,34,52
"2011","Wokingham 018A","E01016610","Total",1094,239,66,173,855,56,103,245,253,42,52,104
"2011","Wokingham 018B","E01016611","Total",438,81,23,58,357,17,44,108,120,13,14,41
"2011","Wokingham 018C","E01016641","Total",548,122,76,46,426,4,108,85,102,19,34,74
"2011","Wokingham 018D","E01016642","Total",455,112,66,46,343,25,58,68,85,17,22,68
"2011","Wokingham 019A","E01016633","Total",497,74,29,45,423,11,66,125,96,15,30,80
"2011","Wokingham 019B","E01016636","Total",562,84,48,36,478,6,124,106,109,9,34,90
"2011","Wokingham 019C","E01016637","Total",408,59,30,29,349,2,75,75,87,13,25,72
"2011","Wokingham 019D","E01016638","Total",493,84,30,54,409,16,58,121,102,17,30,65
"2011","Wokingham 019E","E01016639","Total",609,119,45,74,490,22,76,137,133,20,34,68
"2011","Wokingham 019F","E01016640","Total",611,125,76,49,486,8,117,92,125,15,38,91
"2011","Wokingham 019G","E01016643","Total",499,76,17,59,423,8,58,116,116,27,31,67
"2011","Wokingham 020A","E01016705","Total",501,125,40,85,376,17,59,94,108,14,35,49
"2011","Wokingham 020B","E01016706","Total",636,107,47,60,529,17,86,130,139,25,38,94
"2011","Wokingham 020C","E01016707","Total",629,138,90,48,491,18,116,126,90,21,35,85
"2011","Wokingham 020D","E01016708","Total",653,145,71,74,508,8,134,88,137,16,29,96
"2011","Wokingham 020E","E01016709","Total",608,101,70,31,507,12,172,96,87,31,28,81
"2011","Aylesbury Vale 001A","E01017648","Total",683,120,46,74,563,15,98,135,140,21,40,114
"2011","Aylesbury Vale 001B","E01017649","Total",833,229,117,112,604,42,107,123,164,21,38,109
"2011","Aylesbury Vale 001C","E01017650","Total",609,111,44,67,498,21,68,145,113,27,49,75
"2011","Aylesbury Vale 001F","E01032960","Total",954,209,83,126,745,30,144,141,220,22,53,135
"2011","Aylesbury Vale 002A","E01017644","Total",633,178,58,120,455,28,48,109,148,12,30,80
"2011","Aylesbury Vale 002B","E01017645","Total",574,199,73,126,375,33,38,57,162,9,15,61
"2011","Aylesbury Vale 002C","E01017646","Total",790,245,146,99,545,45,111,119,128,17,36,89
"2011","Aylesbury Vale 002D","E01017647","Total",619,110,69,41,509,10,119,104,116,28,44,88
"2011","Aylesbury Vale 003A","E01017671","Total",609,119,55,64,490,13,86,116,130,18,37,90
"2011","Aylesbury Vale 003B","E01017672","Total",578,124,58,66,454,10,79,96,129,24,31,85
"2011","Aylesbury Vale 003C","E01017695","Total",511,127,75,52,384,13,112,61,96,10,26,66
"2011","Aylesbury Vale 003D","E01017696","Total",510,111,64,47,399,14,84,74,113,15,32,67
"2011","Aylesbury Vale 004A","E01017693","Total",438,97,41,56,341,9,62,71,105,11,28,55
"2011","Aylesbury Vale 004B","E01017694","Total",826,125,49,76,701,15,114,198,178,57,54,85
"2011","Aylesbury Vale 004C","E01017713","Total",589,148,65,83,441,22,71,90,131,20,29,78
"2011","Aylesbury Vale 004D","E01017714","Total",521,98,39,59,423,8,79,85,120,21,24,86
"2011","Aylesbury Vale 004E","E01017717","Total",692,162,86,76,530,23,118,106,148,29,28,78
"2011","Aylesbury Vale 004F","E01017718","Total",640,167,76,91,473,13,84,120,137,19,31,69
"2011","Aylesbury Vale 005A","E01017735","Total",545,131,54,77,414,14,85,74,127,16,40,58
"2011","Aylesbury Vale 005B","E01017736","Total",662,193,111,82,469,37,99,84,125,14,30,80
"2011","Aylesbury Vale 005C","E01017737","Total",593,153,103,50,440,12,124,75,115,11,23,80
"2011","Aylesbury Vale 005D","E01017738","Total",685,232,102,130,453,24,103,82,145,12,32,55
"2011","Aylesbury Vale 006A","E01017669","Total",605,143,77,66,462,17,91,77,139,15,33,90
"2011","Aylesbury Vale 006B","E01017670","Total",633,138,63,75,495,13,103,98,156,16,35,74
"2011","Aylesbury Vale 006C","E01017715","Total",460,104,54,50,356,7,89,77,95,10,25,53
"2011","Aylesbury Vale 006D","E01017716","Total",713,153,70,83,560,8,129,116,146,35,46,80
"2011","Aylesbury Vale 007A","E01017641","Total",708,170,97,73,538,13,142,107,144,12,34,86
"2011","Aylesbury Vale 007B","E01017731","Total",550,153,75,78,397,23,74,81,97,20,33,69
"2011","Aylesbury Vale 007C","E01017732","Total",549,111,48,63,438,18,71,89,142,15,24,79
"2011","Aylesbury Vale 007D","E01017733","Total",509,128,73,55,381,13,82,83,110,10,25,58
"2011","Aylesbury Vale 007E","E01017734","Total",553,98,43,55,455,11,84,98,159,18,24,61
"2011","Aylesbury Vale 008A","E01017703","Total",523,128,61,67,395,24,93,78,90,18,32,60
"2011","Aylesbury Vale 008B","E01017704","Total",486,97,47,50,389,5,84,91,97,23,25,64
"2011","Aylesbury Vale 008C","E01017719","Total",501,144,76,68,357,16,64,74,94,16,32,61
"2011","Aylesbury Vale 008D","E01017720","Total",512,115,43,72,397,19,57,79,120,27,31,64
"2011","Aylesbury Vale 008F","E01032958","Total",622,140,68,72,482,11,108,105,137,20,26,75
"2011","Aylesbury Vale 008G","E01032959","Total",628,112,7,105,516,78,12,178,134,45,31,38
"2011","Aylesbury Vale 009A","E01017651","Total",602,115,58,57,487,16,87,103,143,22,34,82
"2011","Aylesbury Vale 009B","E01017652","Total",625,182,77,105,443,21,82,107,121,14,30,68
"2011","Aylesbury Vale 009C","E01017657","Total",584,135,80,55,449,9,122,99,105,21,25,68
"2011","Aylesbury Vale 009D","E01017658","Total",594,146,56,90,448,13,73,96,148,19,30,69
"2011","Aylesbury Vale 009E","E01017701","Total",810,152,59,93,658,28,79,205,173,41,54,78
"2011","Aylesbury Vale 009F","E01017702","Total",608,150,76,74,458,13,93,100,130,19,32,71
"2011","Aylesbury Vale 010A","E01017642","Total",539,153,82,71,386,13,100,84,91,14,29,55
"2011","Aylesbury Vale 010B","E01017643","Total",529,131,55,76,398,5,76,84,119,13,26,75
"2011","Aylesbury Vale 010C","E01017673","Total",486,89,39,50,397,10,85,80,94,24,39,65
"2011","Aylesbury Vale 010D","E01017674","Total",512,100,36,64,412,10,55,97,129,20,40,61
"2011","Aylesbury Vale 011A","E01017659","Total",607,149,68,81,458,43,84,80,98,30,59,64
"2011","Aylesbury Vale 011B","E01017660","Total",740,243,54,189,497,54,33,139,187,16,33,35
"2011","Aylesbury Vale 011C","E01017661","Total",618,183,61,122,435,43,53,89,113,25,41,71
"2011","Aylesbury Vale 011D","E01017664","Total",627,206,30,176,421,15,38,105,165,8,19,71
"2011","Aylesbury Vale 012A","E01017705","Total",483,114,28,86,369,14,43,64,138,16,22,72
"2011","Aylesbury Vale 012B","E01017706","Total",498,101,33,68,397,43,28,86,105,30,30,75
"2011","Aylesbury Vale 012C","E01017707","Total",468,99,37,62,369,61,24,59,77,23,45,80
"2011","Aylesbury Vale 012D","E01017708","Total",595,160,55,105,435,62,50,86,95,24,47,71
"2011","Aylesbury Vale 013A","E01017665","Total",584,157,63,94,427,52,46,78,92,32,49,78
"2011","Aylesbury Vale 013B","E01017666","Total",733,280,129,151,453,44,50,98,142,20,27,72
"2011","Aylesbury Vale 013C","E01017667","Total",506,118,45,73,388,54,55,83,75,26,36,59
"2011","Aylesbury Vale 013D","E01017668","Total",617,159,69,90,458,28,59,104,139,15,41,72
"2011","Aylesbury Vale 014A","E01017697","Total",621,174,33,141,447,32,54,109,159,14,32,47
"2011","Aylesbury Vale 014B","E01017698","Total",534,119,44,75,415,45,41,90,92,28,52,67
"2011","Aylesbury Vale 014C","E01017699","Total",435,126,36,90,309,22,28,75,107,14,21,42
"2011","Aylesbury Vale 014D","E01017700","Total",619,119,83,36,500,13,144,97,113,14,34,85
"2011","Aylesbury Vale 015B","E01017634","Total",634,182,34,148,452,28,25,93,183,19,38,66
"2011","Aylesbury Vale 015C","E01017662","Total",515,148,53,95,367,34,47,65,105,19,39,58
"2011","Aylesbury Vale 015D","E01017663","Total",600,196,93,103,404,32,44,68,111,21,56,72
"2011","Aylesbury Vale 015E","E01032955","Total",722,393,178,215,329,17,51,62,157,2,6,34
"2011","Aylesbury Vale 015F","E01032961","Total",503,202,47,155,301,44,20,57,115,7,12,46
"2011","Aylesbury Vale 016A","E01017653","Total",608,149,46,103,459,25,62,102,137,14,34,85
"2011","Aylesbury Vale 016B","E01017654","Total",542,170,25,145,372,41,20,72,96,41,44,58
"2011","Aylesbury Vale 016C","E01017655","Total",813,225,40,185,588,40,43,162,229,19,23,72
"2011","Aylesbury Vale 016E","E01032956","Total",670,143,14,129,527,23,24,169,231,27,19,34
"2011","Aylesbury Vale 016F","E01032957","Total",598,165,14,151,433,24,19,128,196,12,16,38
"2011","Aylesbury Vale 016G","E01032962","Total",656,162,22,140,494,35,37,167,192,12,17,34
"2011","Aylesbury Vale 017A","E01017635","Total",609,197,88,109,412,11,112,99,80,25,26,59
"2011","Aylesbury Vale 017B","E01017636","Total",637,150,93,57,487,20,139,112,89,16,29,82
"2011","Aylesbury Vale 017C","E01017637","Total",492,102,42,60,390,19,53,91,113,12,28,74
"2011","Aylesbury Vale 017D","E01017638","Total",499,91,59,32,408,5,121,76,73,20,30,83
"2011","Aylesbury Vale 017E","E01017639","Total",611,110,63,47,501,4,121,88,115,21,38,114
"2011","Aylesbury Vale 017F","E01017640","Total",624,156,105,51,468,9,111,94,105,24,45,80
"2011","Aylesbury Vale 018A","E01017709","Total",569,149,88,61,420,33,53,67,71,37,61,98
"2011","Aylesbury Vale 018B","E01017710","Total",517,88,45,43,429,27,57,68,86,33,64,94
"2011","Aylesbury Vale 018C","E01017711","Total",622,196,88,108,426,49,55,78,95,25,54,70
"2011","Aylesbury Vale 018D","E01017712","Total",798,199,41,158,599,69,38,118,193,43,65,73
"2011","Aylesbury Vale 019A","E01017687","Total",886,338,46,292,548,59,42,143,170,27,43,64
"2011","Aylesbury Vale 019B","E01017688","Total",513,145,36,109,368,19,35,99,132,16,24,43
"2011","Aylesbury Vale 019C","E01017689","Total",568,138,63,75,430,13,60,111,129,10,23,84
"2011","Aylesbury Vale 019D","E01017690","Total",483,134,69,65,349,20,66,67,92,8,22,74
"2011","Aylesbury Vale 019E","E01017691","Total",517,101,28,73,416,8,52,96,122,11,34,93
"2011","Aylesbury Vale 019F","E01017692","Total",683,222,64,158,461,36,68,87,139,18,33,80
"2011","Aylesbury Vale 020A","E01017721","Total",773,296,56,240,477,53,30,121,208,6,20,39
"2011","Aylesbury Vale 020B","E01017722","Total",624,165,27,138,459,29,32,104,168,25,26,75
"2011","Aylesbury Vale 020C","E01017723","Total",500,116,35,81,384,45,34,71,94,28,43,69
"2011","Aylesbury Vale 020D","E01017724","Total",498,110,33,77,388,48,38,89,82,32,41,58
"2011","Aylesbury Vale 021A","E01017627","Total",676,198,72,126,478,24,73,116,138,18,28,81
"2011","Aylesbury Vale 021B","E01017628","Total",633,128,60,68,505,21,100,104,134,23,33,90
"2011","Aylesbury Vale 021C","E01017629","Total",649,137,62,75,512,9,121,109,141,15,40,77
"2011","Aylesbury Vale 021D","E01017630","Total",617,128,79,49,489,12,129,93,119,21,32,83
"2011","Aylesbury Vale 021E","E01017631","Total",644,164,85,79,480,10,100,100,131,17,35,87
"2011","Aylesbury Vale 021F","E01017632","Total",618,121,56,65,497,16,101,100,146,15,32,87
"2011","Aylesbury Vale 022A","E01017675","Total",605,137,77,60,468,26,117,93,129,14,28,61
"2011","Aylesbury Vale 022B","E01017676","Total",568,99,63,36,469,6,143,89,118,15,28,70
"2011","Aylesbury Vale 022C","E01017677","Total",602,171,105,66,431,12,120,76,123,7,26,67
"2011","Aylesbury Vale 022D","E01017678","Total",547,149,67,82,398,8,78,73,124,6,16,93
"2011","Aylesbury Vale 022E","E01017679","Total",616,129,60,69,487,29,91,117,129,19,29,73
"2011","Aylesbury Vale 022F","E01017680","Total",449,155,93,62,294,11,73,49,74,10,23,54
"2011","Aylesbury Vale 023A","E01017681","Total",523,143,89,54,380,14,82,72,114,17,24,57
"2011","Aylesbury Vale 023B","E01017682","Total",481,100,52,48,381,9,109,84,82,26,26,45
"2011","Aylesbury Vale 023C","E01017683","Total",671,127,69,58,544,15,110,100,152,18,44,105
"2011","Aylesbury Vale 023D","E01017684","Total",462,101,64,37,361,8,101,64,100,17,20,51
"2011","Aylesbury Vale 024A","E01017726","Total",527,194,124,70,333,7,120,41,89,13,13,50
"2011","Aylesbury Vale 024B","E01017727","Total",661,158,102,56,503,15,124,126,113,26,33,66
"2011","Aylesbury Vale 024C","E01017728","Total",740,109,23,86,631,66,24,222,174,42,44,59
"2011","Aylesbury Vale 024D","E01017729","Total",679,167,94,73,512,21,109,135,109,23,29,86
"2011","Aylesbury Vale 024E","E01017730","Total",734,277,188,89,457,35,104,100,116,23,20,59
"2011","Chiltern 001A","E01017750","Total",883,213,97,116,670,10,151,123,167,35,56,128
"2011","Chiltern 001B","E01017752","Total",887,196,97,99,691,11,175,140,164,36,48,117
"2011","Chiltern 001C","E01017766","Total",904,173,109,64,731,12,193,158,166,31,46,125
"2011","Chiltern 001D","E01017778","Total",516,127,63,64,389,13,101,79,84,25,18,69
"2011","Chiltern 002A","E01017747","Total",533,135,61,74,398,20,80,81,77,26,40,74
"2011","Chiltern 002B","E01017748","Total",727,224,101,123,503,34,80,125,110,30,44,80
"2011","Chiltern 002C","E01017749","Total",659,155,94,61,504,8,128,115,105,23,34,91
"2011","Chiltern 002D","E01017789","Total",508,120,70,50,388,22,80,76,104,18,19,69
"2011","Chiltern 002E","E01017790","Total",495,100,47,53,395,43,64,78,70,25,49,66
"2011","Chiltern 002F","E01017795","Total",829,201,81,120,628,33,100,143,164,34,49,105
"2011","Chiltern 003A","E01017769","Total",627,151,56,95,476,7,81,105,138,13,41,91
"2011","Chiltern 003B","E01017771","Total",623,169,110,59,454,11,144,73,104,13,35,74
"2011","Chiltern 003C","E01017780","Total",490,102,38,64,388,8,75,92,103,17,26,67
"2011","Chiltern 003D","E01017781","Total",455,136,33,103,319,25,25,83,82,25,42,37
"2011","Chiltern 004A","E01017770","Total",642,227,108,119,415,33,40,122,117,11,33,59
"2011","Chiltern 004B","E01017791","Total",621,199,67,132,422,44,57,93,116,20,33,59
"2011","Chiltern 004C","E01017792","Total",923,396,191,205,527,29,120,122,149,16,25,66
"2011","Chiltern 004D","E01017793","Total",610,133,61,72,477,30,94,84,121,20,28,100
"2011","Chiltern 005A","E01017768","Total",960,283,185,98,677,26,188,138,151,29,45,100
"2011","Chiltern 005B","E01017779","Total",425,67,46,21,358,6,87,68,70,26,36,65
"2011","Chiltern 005C","E01017785","Total",666,121,60,61,545,13,152,103,116,11,33,117
"2011","Chiltern 005D","E01017786","Total",603,130,71,59,473,12,102,114,104,18,37,86
"2011","Chiltern 005E","E01017787","Total",615,108,72,36,507,14,145,117,83,19,39,90
"2011","Chiltern 005F","E01017788","Total",763,272,161,111,491,43,80,128,98,24,34,84
"2011","Chiltern 006A","E01017741","Total",665,213,141,72,452,25,103,106,86,27,33,72
"2011","Chiltern 006B","E01017742","Total",701,196,140,56,505,18,106,126,122,25,32,76
"2011","Chiltern 006C","E01017743","Total",638,157,62,95,481,48,62,115,113,16,44,83
"2011","Chiltern 006D","E01017763","Total",750,251,181,70,499,19,113,110,129,25,40,63
"2011","Chiltern 006E","E01017764","Total",609,95,67,28,514,17,119,117,81,31,51,98
"2011","Chiltern 006F","E01017765","Total",619,83,59,24,536,2,154,113,82,44,54,87
"2011","Chiltern 007A","E01017739","Total",493,101,45,56,392,8,82,94,103,19,28,58
"2011","Chiltern 007B","E01017740","Total",532,130,50,80,402,14,57,112,114,13,28,64
"2011","Chiltern 007C","E01017744","Total",569,132,72,60,437,12,97,94,103,26,27,78
"2011","Chiltern 007D","E01017745","Total",813,302,136,166,511,10,141,106,141,24,34,55
"2011","Chiltern 007E","E01017746","Total",593,113,54,59,480,20,91,122,121,21,25,80
"2011","Chiltern 008A","E01017762","Total",527,74,49,25,453,5,114,102,86,28,45,73
"2011","Chiltern 008B","E01017775","Total",677,206,126,80,471,20,110,105,114,19,32,71
"2011","Chiltern 008C","E01017776","Total",661,166,57,109,495,37,91,102,130,28,35,72
"2011","Chiltern 008D","E01017777","Total",644,147,101,46,497,11,141,109,87,26,38,85
"2011","Chiltern 010A","E01017759","Total",776,229,108,121,547,31,133,131,124,27,28,73
"2011","Chiltern 010B","E01017760","Total",658,124,98,26,534,4,153,99,116,36,37,89
"2011","Chiltern 010C","E01017761","Total",862,210,120,90,652,22,159,167,144,28,41,91
"2011","Chiltern 010D","E01017794","Total",889,205,117,88,684,20,118,183,147,35,51,130
"2011","Chiltern 011A","E01017754","Total",551,94,51,43,457,9,126,90,84,25,38,85
"2011","Chiltern 011B","E01017755","Total",662,217,113,104,445,28,74,83,128,22,30,80
"2011","Chiltern 011C","E01017756","Total",584,111,87,24,473,11,134,87,97,20,40,84
"2011","Chiltern 011D","E01017757","Total",479,117,74,43,362,20,82,77,66,23,27,67
"2011","Chiltern 011E","E01017758","Total",426,62,41,21,364,10,83,84,69,19,30,69
"2011","Chiltern 012A","E01017751","Total",787,144,95,49,643,9,152,138,114,35,69,126
"2011","Chiltern 012B","E01017753","Total",516,150,80,70,366,19,67,93,81,18,27,61
"2011","Chiltern 012C","E01017767","Total",879,229,126,103,650,37,135,142,147,36,44,109
"2011","Chiltern 013A","E01017773","Total",609,141,83,58,468,9,131,94,89,17,41,87
"2011","Chiltern 013B","E01017774","Total",505,98,79,19,407,6,110,72,84,24,30,81
"2011","Chiltern 013C","E01017782","Total",544,79,55,24,465,8,139,96,92,28,32,70
"2011","Chiltern 013D","E01017783","Total",601,143,69,74,458,11,109,110,112,15,27,74
"2011","Chiltern 013E","E01017784","Total",645,162,86,76,483,8,117,108,107,12,32,99
"2011","Chiltern 013F","E01032609","Total",518,160,75,85,358,11,87,72,81,12,28,67
"2011","South Bucks 001A","E01017796","Total",776,272,147,125,504,23,111,97,126,20,30,97
"2011","South Bucks 001B","E01017797","Total",533,89,59,30,444,5,107,99,73,32,37,91
"2011","South Bucks 001C","E01017798","Total",714,149,103,46,565,11,183,105,103,32,45,86
"2011","South Bucks 001D","E01017799","Total",791,223,115,108,568,15,112,150,140,36,42,73
"2011","South Bucks 001E","E01017800","Total",684,220,97,123,464,35,63,161,115,19,21,50
"2011","South Bucks 001F","E01017801","Total",580,110,56,54,470,12,96,117,80,31,52,82
"2011","South Bucks 001G","E01017802","Total",655,195,106,89,460,33,108,90,86,25,36,82
"2011","South Bucks 002A","E01017818","Total",715,144,73,71,571,29,101,114,129,37,56,105
"2011","South Bucks 002B","E01017819","Total",552,98,56,42,454,8,97,87,73,41,48,100
"2011","South Bucks 002C","E01017820","Total",703,256,169,87,447,9,141,62,118,28,24,65
"2011","South Bucks 002D","E01017821","Total",561,117,66,51,444,9,91,75,88,33,53,95
"2011","South Bucks 002E","E01017822","Total",629,72,52,20,557,8,117,102,82,31,86,131
"2011","South Bucks 003A","E01017810","Total",902,403,257,146,499,42,133,87,140,8,24,65
"2011","South Bucks 003B","E01017811","Total",498,135,80,55,363,11,114,52,80,6,19,81
"2011","South Bucks 003C","E01017812","Total",651,170,69,101,481,32,70,91,107,27,49,105
"2011","South Bucks 003D","E01017813","Total",755,199,105,94,556,20,105,92,161,16,36,126
"2011","South Bucks 004A","E01017815","Total",679,135,79,56,544,16,133,112,105,21,41,116
"2011","South Bucks 004B","E01017816","Total",723,246,128,118,477,15,91,104,123,20,32,92
"2011","South Bucks 004C","E01017817","Total",724,182,84,98,542,17,115,119,104,20,58,109
"2011","South Bucks 004D","E01017823","Total",572,157,73,84,415,20,98,95,99,17,27,59
"2011","South Bucks 005A","E01017830","Total",779,237,118,119,542,24,114,103,153,14,43,91
"2011","South Bucks 005B","E01017831","Total",648,153,92,61,495,10,125,96,90,24,55,95
"2011","South Bucks 005C","E01017832","Total",601,151,87,64,450,16,86,63,96,14,60,115
"2011","South Bucks 005D","E01017834","Total",552,128,63,65,424,16,93,64,90,14,51,96
"2011","South Bucks 005E","E01017835","Total",774,275,112,163,499,25,103,87,149,6,44,85
"2011","South Bucks 006A","E01017803","Total",486,97,53,44,389,13,104,61,93,21,27,70
"2011","South Bucks 006B","E01017806","Total",648,130,78,52,518,10,128,95,109,17,51,108
"2011","South Bucks 006C","E01017814","Total",595,125,73,52,470,13,109,89,109,13,37,100
"2011","South Bucks 006D","E01017833","Total",791,271,113,158,520,12,138,79,186,18,21,66
"2011","South Bucks 007A","E01017804","Total",683,248,149,99,435,17,106,70,104,12,37,89
"2011","South Bucks 007B","E01017805","Total",774,232,86,146,542,60,61,123,144,28,40,86
"2011","South Bucks 007C","E01017807","Total",608,154,72,82,454,24,75,100,122,19,29,85
"2011","South Bucks 007D","E01017808","Total",642,197,64,133,445,33,83,109,126,9,33,52
"2011","South Bucks 007E","E01017809","Total",587,148,55,93,439,29,52,110,115,16,44,73
"2011","South Bucks 008A","E01017824","Total",685,197,88,109,488,26,107,92,97,19,43,104
"2011","South Bucks 008B","E01017825","Total",651,132,58,74,519,24,80,119,122,16,49,109
"2011","South Bucks 008C","E01017826","Total",623,201,121,80,422,30,84,86,78,8,48,88
"2011","South Bucks 008D","E01017827","Total",664,181,83,98,483,19,91,102,112,8,47,104
"2011","South Bucks 008E","E01017828","Total",659,210,120,90,449,30,69,103,102,11,41,93
"2011","South Bucks 008F","E01017829","Total",667,97,49,48,570,14,90,93,104,19,74,176
"2011","Wycombe 001A","E01017929","Total",785,402,267,135,383,25,85,74,98,19,34,48
"2011","Wycombe 001B","E01017930","Total",731,174,103,71,557,16,148,108,144,14,25,102
"2011","Wycombe 001C","E01017931","Total",600,167,73,94,433,16,95,87,117,14,29,75
"2011","Wycombe 001D","E01017932","Total",680,179,98,81,501,9,152,76,135,20,33,76
"2011","Wycombe 001E","E01017933","Total",704,187,141,46,517,12,143,96,113,26,44,83
"2011","Wycombe 002A","E01017885","Total",672,123,60,63,549,18,142,114,137,20,36,82
"2011","Wycombe 002B","E01017886","Total",614,149,71,78,465,12,130,95,111,21,29,67
"2011","Wycombe 002C","E01017887","Total",468,109,68,41,359,6,91,75,92,17,21,57
"2011","Wycombe 002D","E01017888","Total",630,95,50,45,535,20,102,129,141,33,48,62
"2011","Wycombe 003A","E01017869","Total",511,74,49,25,437,10,121,81,88,12,28,97
"2011","Wycombe 003B","E01017870","Total",478,68,42,26,410,10,106,74,99,13,25,83
"2011","Wycombe 003C","E01017871","Total",609,122,68,54,487,7,135,87,109,16,42,91
"2011","Wycombe 003D","E01017872","Total",673,142,97,45,531,10,169,97,112,10,34,99
"2011","Wycombe 003E","E01017873","Total",517,56,23,33,461,12,90,111,121,15,27,85
"2011","Wycombe 003F","E01017874","Total",459,109,63,46,350,20,53,92,97,23,26,39
"2011","Wycombe 004A","E01017915","Total",530,108,53,55,422,23,82,82,108,17,31,79
"2011","Wycombe 004B","E01017916","Total",480,100,37,63,380,2,91,58,111,15,24,79
"2011","Wycombe 004C","E01017917","Total",578,125,47,78,453,28,68,95,125,20,29,88
"2011","Wycombe 004D","E01017918","Total",702,255,128,127,447,33,94,90,117,19,24,70
"2011","Wycombe 006A","E01017857","Total",598,235,66,169,363,38,41,57,94,24,41,68
"2011","Wycombe 006B","E01017858","Total",601,201,16,185,400,49,8,73,158,21,23,68
"2011","Wycombe 006C","E01017859","Total",503,82,37,45,421,14,75,82,91,24,33,102
"2011","Wycombe 006D","E01017860","Total",493,93,35,58,400,24,54,86,78,31,41,86
"2011","Wycombe 006E","E01017861","Total",607,115,54,61,492,17,94,127,121,16,43,74
"2011","Wycombe 006F","E01017862","Total",706,144,73,71,562,21,92,159,129,25,55,81
"2011","Wycombe 006G","E01017863","Total",641,109,61,48,532,12,119,120,105,28,40,108
"2011","Wycombe 007A","E01017842","Total",1053,200,88,112,853,21,197,180,221,34,61,139
"2011","Wycombe 007B","E01017853","Total",575,174,42,132,401,20,64,85,128,23,20,61
"2011","Wycombe 007C","E01017854","Total",505,116,45,71,389,16,87,73,86,18,40,69
"2011","Wycombe 007D","E01017878","Total",1074,260,109,151,814,15,222,157,205,48,57,110
"2011","Wycombe 008A","E01017920","Total",476,106,47,59,370,18,59,85,93,17,28,70
"2011","Wycombe 008B","E01017921","Total",674,173,38,135,501,37,57,85,152,15,44,111
"2011","Wycombe 008C","E01017922","Total",676,211,73,138,465,29,63,90,138,20,42,83
"2011","Wycombe 008D","E01017923","Total",666,271,54,217,395,34,38,56,132,9,32,94
"2011","Wycombe 008E","E01017924","Total",557,97,33,64,460,14,95,99,97,20,46,89
"2011","Wycombe 009A","E01017937","Total",567,109,53,56,458,10,82,120,100,27,38,81
"2011","Wycombe 009B","E01017938","Total",503,90,43,47,413,9,84,94,87,24,28,87
"2011","Wycombe 009C","E01017940","Total",673,202,41,161,471,22,61,114,177,10,21,66
"2011","Wycombe 009D","E01017942","Total",587,122,86,36,465,16,109,104,94,19,34,89
"2011","Wycombe 010A","E01017850","Total",474,99,17,82,375,36,18,70,99,28,55,69
"2011","Wycombe 010B","E01017851","Total",678,209,79,130,469,30,24,100,149,21,48,97
"2011","Wycombe 010C","E01017852","Total",709,116,50,66,593,19,66,87,73,60,123,165
"2011","Wycombe 010D","E01017919","Total",630,248,107,141,382,29,33,76,137,8,16,83
"2011","Wycombe 011A","E01017925","Total",785,182,36,146,603,43,62,105,180,39,57,117
"2011","Wycombe 011B","E01017926","Total",669,233,67,166,436,88,37,105,130,26,13,37
"2011","Wycombe 011C","E01017927","Total",589,143,82,61,446,16,81,85,109,29,50,76
"2011","Wycombe 011D","E01017928","Total",614,219,109,110,395,10,102,56,97,16,36,78
"2011","Wycombe 012A","E01017911","Total",670,187,71,116,483,55,54,105,121,32,42,74
"2011","Wycombe 012B","E01017912","Total",523,125,32,93,398,9,54,81,118,16,46,74
"2011","Wycombe 012C","E01017913","Total",745,323,30,293,422,33,21,106,123,24,46,69
"2011","Wycombe 012D","E01017914","Total",507,110,33,77,397,10,55,96,106,16,40,74
"2011","Wycombe 013A","E01017903","Total",508,110,22,88,398,26,24,59,78,31,92,88
"2011","Wycombe 013B","E01017904","Total",607,184,25,159,423,38,15,73,101,30,61,105
"2011","Wycombe 013C","E01017905","Total",838,306,32,274,532,52,26,65,163,24,67,135
"2011","Wycombe 013D","E01017906","Total",501,53,16,37,448,34,25,68,56,68,112,85
"2011","Wycombe 013E","E01017907","Total",621,157,71,86,464,44,55,84,82,45,65,89
"2011","Wycombe 014A","E01017899","Total",688,216,104,112,472,37,76,121,111,18,37,72
"2011","Wycombe 014B","E01017900","Total",528,120,26,94,408,55,45,76,112,25,28,67
"2011","Wycombe 014C","E01017901","Total",462,110,28,82,352,52,41,72,75,19,38,55
"2011","Wycombe 014D","E01017902","Total",637,168,47,121,469,86,39,95,116,22,46,65
"2011","Wycombe 015A","E01017836","Total",551,129,32,97,422,7,42,88,98,36,66,85
"2011","Wycombe 015B","E01017837","Total",779,286,55,231,493,60,39,72,143,14,35,130
"2011","Wycombe 015C","E01017838","Total",510,93,38,55,417,13,49,82,85,31,58,99
"2011","Wycombe 015D","E01017839","Total",496,162,46,116,334,5,76,39,119,6,22,67
"2011","Wycombe 015E","E01017840","Total",666,157,60,97,509,13,81,87,132,26,58,112
"2011","Wycombe 015F","E01017841","Total",518,76,25,51,442,8,80,97,114,11,52,80
"2011","Wycombe 016A","E01017908","Total",1167,472,126,346,695,83,55,159,235,33,44,86
"2011","Wycombe 016B","E01017909","Total",938,269,39,230,669,90,41,170,227,32,29,80
"2011","Wycombe 016C","E01017910","Total",1072,381,114,267,691,31,82,129,256,21,44,128
"2011","Wycombe 016D","E01017941","Total",671,257,78,179,414,31,71,78,138,9,20,67
"2011","Wycombe 017A","E01017843","Total",654,155,90,65,499,14,146,84,121,8,28,98
"2011","Wycombe 017B","E01017844","Total",731,306,168,138,425,18,81,88,95,20,46,77
"2011","Wycombe 017C","E01017845","Total",706,253,109,144,453,23,73,83,141,19,38,76
"2011","Wycombe 017D","E01017855","Total",617,169,87,82,448,23,97,106,123,8,26,65
"2011","Wycombe 017E","E01017856","Total",538,131,61,70,407,30,56,70,103,36,38,74
"2011","Wycombe 018A","E01017864","Total",520,89,50,39,431,10,123,86,93,10,28,81
"2011","Wycombe 018B","E01017865","Total",611,125,84,41,486,6,144,95,101,14,38,88
"2011","Wycombe 018C","E01017867","Total",610,160,99,61,450,40,83,103,91,24,35,74
"2011","Wycombe 018D","E01017868","Total",649,176,97,79,473,14,137,93,102,16,39,72
"2011","Wycombe 019A","E01017934","Total",750,260,74,186,490,46,59,121,129,21,37,77
"2011","Wycombe 019B","E01017935","Total",872,290,97,193,582,38,80,154,199,12,28,71
"2011","Wycombe 019C","E01017936","Total",649,171,94,77,478,19,115,89,107,16,32,100
"2011","Wycombe 019D","E01017939","Total",558,134,37,97,424,32,71,82,119,17,29,74
"2011","Wycombe 020A","E01017866","Total",603,162,82,80,441,4,110,79,122,16,37,73
"2011","Wycombe 020B","E01017875","Total",544,88,32,56,456,11,78,142,103,32,43,47
"2011","Wycombe 020C","E01017876","Total",775,122,71,51,653,11,130,174,160,23,46,109
"2011","Wycombe 020D","E01017877","Total",641,122,75,47,519,20,135,95,117,36,44,72
"2011","Wycombe 021A","E01017846","Total",639,238,127,111,401,34,102,47,97,15,30,76
"2011","Wycombe 021B","E01017847","Total",682,233,113,120,449,23,117,101,108,13,24,63
"2011","Wycombe 021C","E01017848","Total",474,96,66,30,378,8,102,76,82,10,19,81
"2011","Wycombe 021D","E01017849","Total",665,238,80,158,427,15,87,81,151,13,21,59
"2011","Wycombe 022A","E01017889","Total",530,152,67,85,378,21,48,80,94,20,25,90
"2011","Wycombe 022B","E01017890","Total",500,80,49,31,420,7,103,95,91,18,33,73
"2011","Wycombe 022C","E01017891","Total",635,207,132,75,428,16,96,107,104,14,27,64
"2011","Wycombe 022D","E01017892","Total",607,103,66,37,504,15,170,112,81,25,34,67
"2011","Wycombe 022E","E01017893","Total",799,363,206,157,436,31,82,69,153,11,25,65
"2011","Wycombe 022F","E01017894","Total",658,181,97,84,477,19,121,109,121,22,23,62
"2011","Wycombe 023A","E01017895","Total",606,240,110,130,366,22,62,85,103,13,25,56
"2011","Wycombe 023B","E01017896","Total",629,190,96,94,439,17,131,90,108,13,22,58
"2011","Wycombe 023C","E01017897","Total",643,166,67,99,477,22,77,101,144,19,39,75
"2011","Wycombe 023D","E01017898","Total",499,123,37,86,376,32,32,83,119,16,22,72
"2011","Wycombe 024A","E01017880","Total",519,64,37,27,455,10,104,107,101,21,35,77
"2011","Wycombe 024B","E01017881","Total",701,146,96,50,555,15,144,118,111,26,38,103
"2011","Wycombe 024C","E01017882","Total",635,150,76,74,485,16,101,113,108,18,38,91
"2011","Wycombe 024D","E01017883","Total",626,133,67,66,493,24,91,96,126,30,51,75
"2011","Wycombe 024E","E01017884","Total",627,221,145,76,406,20,76,103,96,17,27,67
"2011","Wycombe 024F","E01032610","Total",652,147,77,70,505,23,127,103,96,16,37,103
"2011","Eastbourne 001A","E01020924","Total",551,120,53,67,431,28,92,65,107,16,44,79
"2011","Eastbourne 001B","E01020925","Total",605,181,57,124,424,58,43,71,91,22,52,87
"2011","Eastbourne 001C","E01020927","Total",567,126,44,82,441,47,61,91,99,26,44,73
"2011","Eastbourne 001D","E01020928","Total",791,287,178,109,504,29,176,73,152,6,22,46
"2011","Eastbourne 001E","E01020930","Total",495,76,22,54,419,58,24,81,77,21,58,100
"2011","Eastbourne 002A","E01020917","Total",587,179,63,116,408,56,33,76,93,38,33,79
"2011","Eastbourne 002B","E01020918","Total",625,132,62,70,493,60,66,94,134,24,43,72
"2011","Eastbourne 002C","E01020919","Total",584,101,54,47,483,43,81,102,118,25,43,71
"2011","Eastbourne 002D","E01020923","Total",569,177,55,122,392,55,38,70,81,31,36,81
"2011","Eastbourne 002E","E01020949","Total",685,172,101,71,513,36,145,73,124,11,27,97
"2011","Eastbourne 003A","E01020926","Total",613,102,49,53,511,29,116,72,116,20,51,107
"2011","Eastbourne 003B","E01020929","Total",739,289,139,150,450,56,101,85,99,24,27,58
"2011","Eastbourne 003C","E01020955","Total",700,252,117,135,448,55,102,81,115,12,32,51
"2011","Eastbourne 003D","E01020956","Total",822,291,203,88,531,17,261,54,123,5,16,55
"2011","Eastbourne 003E","E01020957","Total",663,204,126,78,459,51,123,70,93,18,25,79
"2011","Eastbourne 004A","E01020920","Total",741,333,148,185,408,45,91,85,103,14,23,47
"2011","Eastbourne 004B","E01020921","Total",604,166,82,84,438,35,96,75,99,13,34,86
"2011","Eastbourne 004C","E01020922","Total",599,165,76,89,434,57,72,74,98,21,39,73
"2011","Eastbourne 004D","E01020945","Total",802,197,135,62,605,18,231,90,117,12,30,107
"2011","Eastbourne 004E","E01020950","Total",738,205,131,74,533,26,201,64,112,15,21,94
"2011","Eastbourne 006A","E01020940","Total",602,150,117,33,452,10,149,69,77,27,35,85
"2011","Eastbourne 006B","E01020941","Total",646,162,79,83,484,58,71,93,101,24,46,91
"2011","Eastbourne 006C","E01020942","Total",626,157,82,75,469,30,90,91,106,26,37,89
"2011","Eastbourne 006D","E01020946","Total",734,172,117,55,562,15,213,73,137,11,26,87
"2011","Eastbourne 006E","E01020947","Total",722,291,128,163,431,26,141,79,83,11,24,67
"2011","Eastbourne 007A","E01020914","Total",814,231,84,147,583,61,70,113,179,22,40,98
"2011","Eastbourne 007B","E01020915","Total",839,361,201,160,478,53,96,105,125,12,28,59
"2011","Eastbourne 007C","E01020952","Total",741,255,131,124,486,47,76,96,110,18,50,89
"2011","Eastbourne 007D","E01020953","Total",572,113,53,60,459,21,79,91,109,23,44,92
"2011","Eastbourne 007E","E01020954","Total",619,104,46,58,515,20,93,125,84,30,52,111
"2011","Eastbourne 008A","E01020948","Total",758,352,208,144,406,6,183,53,74,7,25,58
"2011","Eastbourne 008B","E01020963","Total",639,169,60,109,470,27,93,80,118,22,47,83
"2011","Eastbourne 008C","E01020965","Total",1027,565,192,373,462,27,68,57,227,6,21,56
"2011","Eastbourne 008D","E01020966","Total",856,474,192,282,382,9,96,49,149,5,15,59
"2011","Eastbourne 009A","E01020938","Total",627,169,86,83,458,27,85,120,85,21,32,88
"2011","Eastbourne 009B","E01020939","Total",649,193,100,93,456,43,71,94,120,25,32,71
"2011","Eastbourne 009C","E01020943","Total",751,280,123,157,471,57,83,104,125,9,28,65
"2011","Eastbourne 009D","E01020964","Total",887,429,247,182,458,38,115,79,148,8,12,58
"2011","Eastbourne 009E","E01020967","Total",994,546,353,193,448,15,165,47,139,9,21,52
"2011","Eastbourne 010A","E01020910","Total",829,385,143,242,444,51,55,88,143,9,25,73
"2011","Eastbourne 010B","E01020911","Total",958,444,87,357,514,49,34,85,194,12,26,114
"2011","Eastbourne 010C","E01020912","Total",1034,528,90,438,506,50,44,86,205,11,19,91
"2011","Eastbourne 010D","E01020916","Total",769,255,99,156,514,70,56,102,177,12,22,75
"2011","Eastbourne 011A","E01020935","Total",1075,556,189,367,519,42,86,74,234,6,10,67
"2011","Eastbourne 011B","E01020936","Total",1025,570,340,230,455,18,210,26,152,1,8,40
"2011","Eastbourne 011C","E01020937","Total",747,394,148,246,353,19,83,50,146,10,12,33
"2011","Eastbourne 011D","E01020968","Total",911,491,224,267,420,23,87,78,168,9,15,40
"2011","Eastbourne 012A","E01020931","Total",829,419,255,164,410,15,169,37,134,11,10,34
"2011","Eastbourne 012B","E01020932","Total",843,461,346,115,382,15,244,21,67,3,5,27
"2011","Eastbourne 012C","E01020933","Total",434,140,82,58,294,8,126,43,62,7,17,31
"2011","Eastbourne 012D","E01020934","Total",685,318,197,121,367,14,147,50,105,3,6,42
"2011","Eastbourne 012E","E01020944","Total",610,125,73,52,485,21,143,88,100,10,29,94
"2011","Eastbourne 013A","E01020913","Total",972,344,161,183,628,86,108,106,179,28,36,85
"2011","Eastbourne 013B","E01020951","Total",647,223,105,118,424,24,69,82,109,25,37,78
"2011","Eastbourne 013C","E01020959","Total",609,180,121,59,429,22,113,100,86,15,32,61
"2011","Eastbourne 013D","E01020961","Total",652,178,121,57,474,8,204,59,94,10,20,79
"2011","Eastbourne 013E","E01020962","Total",976,335,166,169,641,42,187,106,190,14,29,73
"2011","Eastbourne 014A","E01020960","Total",1172,417,144,273,755,65,160,148,239,25,35,83
"2011","Eastbourne 014B","E01032831","Total",701,177,56,121,524,24,137,108,153,13,26,63
"2011","Eastbourne 014C","E01032832","Total",672,183,53,130,489,62,90,83,137,25,36,56
"2011","Eastbourne 014D","E01032833","Total",679,247,37,210,432,35,76,80,175,9,9,48
"2011","Hastings 001A","E01020969","Total",656,200,105,95,456,17,135,72,114,13,29,76
"2011","Hastings 001B","E01020970","Total",1003,192,69,123,811,22,157,165,187,33,86,161
"2011","Hastings 001C","E01020971","Total",841,226,97,129,615,46,110,112,160,28,50,109
"2011","Hastings 001D","E01020987","Total",753,209,56,153,544,54,51,135,162,23,44,75
"2011","Hastings 002A","E01020974","Total",605,146,95,51,459,24,155,60,91,14,31,84
"2011","Hastings 002B","E01020986","Total",590,122,68,54,468,28,137,65,119,16,31,72
"2011","Hastings 002C","E01020988","Total",744,194,134,60,550,11,206,74,125,14,33,87
"2011","Hastings 002D","E01021007","Total",667,190,130,60,477,5,174,48,133,12,22,83
"2011","Hastings 002E","E01021008","Total",792,352,233,119,440,25,129,71,111,8,33,63
"2011","Hastings 002F","E01021009","Total",808,197,114,83,611,21,174,121,143,21,39,92
"2011","Hastings 003A","E01020993","Total",593,211,78,133,382,64,50,54,95,18,29,72
"2011","Hastings 003B","E01020994","Total",581,138,46,92,443,56,73,78,108,31,44,53
"2011","Hastings 003C","E01020995","Total",585,179,69,110,406,36,63,71,105,29,32,70
"2011","Hastings 003D","E01020996","Total",637,91,25,66,546,62,70,112,128,32,38,104
"2011","Hastings 003E","E01021019","Total",827,400,173,227,427,33,97,68,125,21,32,51
"2011","Hastings 004A","E01021004","Total",773,237,115,122,536,42,134,72,144,23,38,83
"2011","Hastings 004B","E01021005","Total",661,199,88,111,462,79,84,75,78,20,56,70
"2011","Hastings 004C","E01021006","Total",847,286,102,184,561,67,92,111,184,19,19,69
"2011","Hastings 004D","E01021013","Total",726,181,63,118,545,62,62,118,156,22,45,80
"2011","Hastings 005A","E01020972","Total",661,242,87,155,419,96,42,62,88,33,37,61
"2011","Hastings 005B","E01020973","Total",716,186,110,76,530,42,111,104,128,30,45,70
"2011","Hastings 005C","E01020977","Total",742,305,65,240,437,76,39,79,133,18,36,56
"2011","Hastings 005D","E01021015","Total",682,228,68,160,454,114,39,91,95,33,22,60
"2011","Hastings 006A","E01021010","Total",636,157,78,79,479,25,106,87,107,12,49,93
"2011","Hastings 006B","E01021011","Total",650,189,70,119,461,44,61,104,129,18,39,66
"2011","Hastings 006C","E01021012","Total",774,325,162,163,449,27,83,80,137,15,34,73
"2011","Hastings 006D","E01021020","Total",734,202,114,88,532,60,108,86,113,34,47,84
"2011","Hastings 006E","E01021021","Total",844,260,90,170,584,59,107,92,183,20,41,82
"2011","Hastings 007A","E01021000","Total",645,220,68,152,425,36,67,88,114,20,40,60
"2011","Hastings 007B","E01021001","Total",497,134,57,77,363,38,56,65,91,12,31,70
"2011","Hastings 007C","E01021002","Total",639,221,73,148,418,35,92,72,113,15,32,59
"2011","Hastings 007D","E01021003","Total",941,494,166,328,447,38,111,52,169,9,12,56
"2011","Hastings 007E","E01021014","Total",808,253,76,177,555,92,66,127,144,21,41,64
"2011","Hastings 008A","E01020975","Total",838,369,145,224,469,34,67,99,153,19,26,71
"2011","Hastings 008B","E01020976","Total",876,301,121,180,575,33,125,97,185,15,38,82
"2011","Hastings 008C","E01020990","Total",697,252,59,193,445,58,37,104,122,14,36,74
"2011","Hastings 008D","E01020991","Total",660,305,72,233,355,31,64,65,123,6,18,48
"2011","Hastings 008E","E01020992","Total",902,415,85,330,487,71,45,91,160,18,29,73
"2011","Hastings 009A","E01020978","Total",1113,635,152,483,478,67,39,86,183,20,23,60
"2011","Hastings 009B","E01020979","Total",1171,781,169,612,390,59,44,56,169,7,17,38
"2011","Hastings 009C","E01020980","Total",811,386,89,297,425,53,41,77,166,14,26,48
"2011","Hastings 009D","E01020981","Total",698,248,52,196,450,30,67,91,143,24,36,59
"2011","Hastings 010A","E01020997","Total",642,166,71,95,476,39,78,102,129,24,32,72
"2011","Hastings 010B","E01020998","Total",939,507,157,350,432,40,73,68,173,10,29,39
"2011","Hastings 010C","E01020999","Total",736,226,125,101,510,24,154,82,133,20,26,71
"2011","Hastings 010D","E01021016","Total",754,296,121,175,458,54,83,73,143,10,36,59
"2011","Hastings 010E","E01021017","Total",667,175,63,112,492,37,73,94,136,14,39,99
"2011","Hastings 010F","E01021018","Total",742,150,62,88,592,27,127,122,126,11,65,114
"2011","Hastings 011A","E01020982","Total",1034,665,102,563,369,73,25,59,149,7,18,38
"2011","Hastings 011B","E01020983","Total",1034,676,249,427,358,52,62,40,144,13,14,33
"2011","Hastings 011C","E01020984","Total",1173,680,147,533,493,52,60,81,231,10,16,43
"2011","Hastings 011D","E01020985","Total",1088,668,144,524,420,47,65,70,165,11,24,38
"2011","Hastings 011E","E01020989","Total",926,514,75,439,412,57,42,89,158,12,20,34
"2011","Lewes 001A","E01021022","Total",840,178,91,87,662,34,160,139,162,30,52,85
"2011","Lewes 001B","E01021024","Total",487,111,56,55,376,34,62,76,101,7,25,71
"2011","Lewes 001C","E01021025","Total",681,106,47,59,575,22,134,117,145,30,42,85
"2011","Lewes 001D","E01021052","Total",516,122,89,33,394,13,100,70,101,14,26,70
"2011","Lewes 001E","E01021053","Total",484,121,77,44,363,17,101,67,74,14,23,67
"2011","Lewes 002A","E01021023","Total",758,160,78,82,598,21,113,119,142,30,46,127
"2011","Lewes 002B","E01021026","Total",994,293,191,102,701,18,258,123,140,34,38,90
"2011","Lewes 002C","E01021032","Total",847,212,128,84,635,21,181,107,150,23,56,97
"2011","Lewes 002D","E01021067","Total",453,108,64,44,345,6,62,74,83,7,25,88
"2011","Lewes 002E","E01021068","Total",439,118,48,70,321,14,60,65,87,10,23,62
"2011","Lewes 003A","E01021033","Total",807,298,143,155,509,38,100,108,136,19,31,77
"2011","Lewes 003B","E01021034","Total",559,159,55,104,400,41,53,88,104,9,31,74
"2011","Lewes 003C","E01021035","Total",922,426,175,251,496,40,87,71,210,5,28,55
"2011","Lewes 003D","E01021036","Total",631,196,92,104,435,22,103,91,104,22,28,65
"2011","Lewes 003E","E01021037","Total",625,181,74,107,444,44,45,100,100,18,52,85
"2011","Lewes 003F","E01021038","Total",819,309,130,179,510,38,79,109,173,15,24,72
"2011","Lewes 004A","E01021054","Total",598,141,75,66,457,13,103,80,123,13,32,93
"2011","Lewes 004B","E01021055","Total",766,237,174,63,529,25,145,109,117,17,36,80
"2011","Lewes 004C","E01021056","Total",723,198,112,86,525,20,165,81,129,22,25,83
"2011","Lewes 004D","E01021057","Total",682,207,111,96,475,47,98,85,137,12,25,71
"2011","Lewes 005A","E01021039","Total",654,235,107,128,419,30,90,86,126,24,28,35
"2011","Lewes 005B","E01021040","Total",675,270,121,149,405,33,76,99,106,18,20,53
"2011","Lewes 005C","E01021041","Total",646,178,123,55,468,27,134,91,75,24,38,79
"2011","Lewes 005D","E01021042","Total",499,97,54,43,402,21,74,93,76,21,34,83
"2011","Lewes 005E","E01021043","Total",620,138,57,81,482,64,58,131,101,24,27,77
"2011","Lewes 006A","E01021027","Total",655,170,91,79,485,19,134,90,113,18,37,74
"2011","Lewes 006B","E01021028","Total",615,118,58,60,497,38,82,108,112,16,41,100
"2011","Lewes 006C","E01021029","Total",610,135,70,65,475,28,99,86,109,18,31,104
"2011","Lewes 006D","E01021030","Total",570,213,138,75,357,22,88,61,93,12,30,51
"2011","Lewes 006E","E01021031","Total",711,304,150,154,407,17,85,72,134,14,24,61
"2011","Lewes 007A","E01021061","Total",593,104,48,56,489,32,85,103,116,8,50,95
"2011","Lewes 007B","E01021063","Total",698,175,85,90,523,34,112,99,124,13,36,105
"2011","Lewes 007C","E01021064","Total",821,322,179,143,499,28,165,68,138,9,22,69
"2011","Lewes 007D","E01021065","Total",657,326,168,158,331,35,82,59,99,10,10,36
"2011","Lewes 007E","E01021066","Total",652,158,108,50,494,35,147,64,112,14,28,94
"2011","Lewes 008A","E01021045","Total",849,286,166,120,563,32,200,75,132,17,33,74
"2011","Lewes 008B","E01021046","Total",595,121,74,47,474,29,106,95,122,12,31,79
"2011","Lewes 008C","E01021047","Total",610,158,80,78,452,38,97,79,117,6,27,88
"2011","Lewes 008D","E01021048","Total",730,267,93,174,463,48,78,97,143,5,22,70
"2011","Lewes 009A","E01021044","Total",716,168,65,103,548,67,68,109,129,40,52,83
"2011","Lewes 009B","E01021049","Total",686,286,95,191,400,48,40,86,128,14,26,58
"2011","Lewes 009C","E01021050","Total",542,143,55,88,399,39,53,80,98,21,30,78
"2011","Lewes 009D","E01021051","Total",524,141,63,78,383,23,71,84,114,13,26,52
"2011","Lewes 010A","E01021058","Total",795,221,123,98,574,48,130,98,153,19,33,93
"2011","Lewes 010B","E01021059","Total",711,228,147,81,483,29,154,60,131,11,23,75
"2011","Lewes 010C","E01021060","Total",712,205,116,89,507,31,151,68,132,15,37,73
"2011","Lewes 010D","E01021062","Total",610,183,53,130,427,38,86,67,109,19,43,65
"2011","Lewes 011A","E01021069","Total",669,194,121,73,475,18,146,79,100,13,22,97
"2011","Lewes 011B","E01021075","Total",748,163,110,53,585,32,185,110,126,25,27,80
"2011","Lewes 011C","E01021077","Total",656,212,160,52,444,13,145,64,104,12,29,77
"2011","Lewes 011D","E01021081","Total",747,271,176,95,476,13,177,44,134,9,30,69
"2011","Lewes 011E","E01021082","Total",788,245,166,79,543,5,223,65,154,10,15,71
"2011","Lewes 011F","E01021083","Total",572,107,73,34,465,15,180,44,98,21,25,82
"2011","Lewes 012A","E01021072","Total",725,189,159,30,536,8,272,51,108,8,20,69
"2011","Lewes 012B","E01021073","Total",634,175,131,44,459,10,152,72,101,16,37,71
"2011","Lewes 012C","E01021074","Total",772,255,161,94,517,36,165,74,130,18,30,64
"2011","Lewes 012D","E01021076","Total",790,224,119,105,566,53,121,101,129,21,54,87
"2011","Lewes 012E","E01021078","Total",552,114,88,26,438,12,160,56,112,13,20,65
"2011","Lewes 013A","E01021070","Total",795,359,194,165,436,35,94,72,140,13,17,65
"2011","Lewes 013B","E01021071","Total",982,497,185,312,485,52,114,69,190,5,9,46
"2011","Lewes 013C","E01021079","Total",759,323,195,128,436,28,137,64,114,10,21,62
"2011","Lewes 013D","E01021080","Total",605,185,119,66,420,18,113,69,110,7,34,69
"2011","Rother 001A","E01021132","Total",495,124,74,50,371,8,107,77,75,17,25,62
"2011","Rother 001B","E01021133","Total",707,201,83,118,506,30,107,96,156,22,24,71
"2011","Rother 001C","E01021134","Total",599,149,68,81,450,28,79,94,113,19,27,90
"2011","Rother 001D","E01021139","Total",561,188,118,70,373,31,93,76,81,27,29,36
"2011","Rother 001E","E01021140","Total",693,149,77,72,544,15,122,104,141,30,41,91
"2011","Rother 001F","E01021141","Total",584,116,60,56,468,15,102,104,108,29,32,78
"2011","Rother 002A","E01021103","Total",673,207,114,93,466,23,154,58,126,15,29,61
"2011","Rother 002B","E01021114","Total",692,210,119,91,482,21,167,65,116,16,34,63
"2011","Rother 002C","E01021115","Total",728,202,120,82,526,10,194,67,151,12,21,71
"2011","Rother 002D","E01021116","Total",670,213,128,85,457,25,116,63,128,15,27,83
"2011","Rother 003A","E01021098","Total",722,193,98,95,529,22,152,82,155,21,31,66
"2011","Rother 003B","E01021099","Total",679,174,91,83,505,9,141,87,141,15,30,82
"2011","Rother 003C","E01021100","Total",658,126,55,71,532,27,122,84,131,25,56,87
"2011","Rother 003D","E01021104","Total",588,166,81,85,422,18,126,61,106,14,33,64
"2011","Rother 003E","E01021105","Total",548,188,95,93,360,21,104,53,84,16,24,58
"2011","Rother 004A","E01021101","Total",833,294,198,96,539,29,191,58,140,17,25,79
"2011","Rother 004B","E01021102","Total",761,282,136,146,479,34,123,62,132,14,34,80
"2011","Rother 004C","E01021117","Total",783,313,167,146,470,20,147,66,141,12,27,57
"2011","Rother 004D","E01021118","Total",753,291,162,129,462,19,142,64,128,10,33,66
"2011","Rother 004E","E01021119","Total",512,210,121,89,302,29,72,51,67,16,20,47
"2011","Rother 005A","E01021087","Total",695,179,99,80,516,9,162,71,133,14,41,86
"2011","Rother 005B","E01021088","Total",673,181,123,58,492,11,170,47,136,7,32,89
"2011","Rother 005C","E01021089","Total",646,172,107,65,474,28,126,70,109,17,40,84
"2011","Rother 005D","E01021109","Total",697,181,102,79,516,17,181,62,128,9,40,79
"2011","Rother 005E","E01021110","Total",1104,327,209,118,777,14,343,64,218,9,33,96
"2011","Rother 006A","E01021084","Total",929,437,258,179,492,59,109,87,119,20,33,65
"2011","Rother 006B","E01021085","Total",698,167,95,72,531,28,138,103,119,21,40,82
"2011","Rother 006C","E01021086","Total",714,198,122,76,516,30,148,96,107,17,40,78
"2011","Rother 006D","E01021096","Total",492,109,60,49,383,12,90,57,105,21,35,63
"2011","Rother 006E","E01021097","Total",529,102,53,49,427,15,128,74,100,19,31,60
"2011","Rother 007A","E01021111","Total",520,266,175,91,254,21,91,31,61,7,12,31
"2011","Rother 007B","E01021113","Total",603,193,108,85,410,39,86,79,86,23,32,65
"2011","Rother 007C","E01021131","Total",633,160,50,110,473,58,63,113,82,23,54,80
"2011","Rother 007D","E01021135","Total",735,226,95,131,509,82,82,87,96,54,40,68
"2011","Rother 007E","E01021136","Total",575,225,118,107,350,57,62,61,60,31,23,56
"2011","Rother 007F","E01021137","Total",613,178,99,79,435,41,86,72,112,18,40,66
"2011","Rother 008A","E01021112","Total",642,209,128,81,433,16,149,63,99,13,33,60
"2011","Rother 008B","E01021120","Total",749,405,324,81,344,12,178,28,67,8,14,37
"2011","Rother 008C","E01021126","Total",649,250,128,122,399,24,127,64,102,8,25,49
"2011","Rother 008D","E01021127","Total",686,192,118,74,494,36,131,75,133,17,29,73
"2011","Rother 008E","E01021128","Total",846,275,179,96,571,28,177,82,151,15,40,78
"2011","Rother 009A","E01021093","Total",687,184,130,54,503,10,229,45,119,9,28,63
"2011","Rother 009B","E01021095","Total",631,184,142,42,447,6,230,35,88,7,26,55
"2011","Rother 009C","E01021123","Total",714,199,157,42,515,11,231,64,99,11,25,74
"2011","Rother 009D","E01021124","Total",828,271,196,75,557,10,262,53,125,10,26,71
"2011","Rother 009E","E01021125","Total",555,154,111,43,401,8,170,33,101,11,23,55
"2011","Rother 009F","E01021129","Total",806,204,133,71,602,18,235,67,154,15,36,77
"2011","Rother 009G","E01021138","Total",476,143,89,54,333,7,121,39,84,7,23,52
"2011","Rother 010A","E01021094","Total",842,393,303,90,449,13,224,35,99,4,18,56
"2011","Rother 010B","E01021106","Total",893,374,298,76,519,8,272,35,116,15,17,56
"2011","Rother 010C","E01021107","Total",744,221,184,37,523,4,266,56,100,13,25,59
"2011","Rother 010D","E01021108","Total",638,191,99,92,447,29,121,82,104,15,21,75
"2011","Rother 010E","E01021130","Total",684,252,151,101,432,22,144,60,111,10,24,61
"2011","Rother 011A","E01021090","Total",802,337,108,229,465,75,68,71,134,32,27,58
"2011","Rother 011B","E01021091","Total",1086,601,248,353,485,49,107,78,171,11,13,56
"2011","Rother 011C","E01021092","Total",1146,674,358,316,472,37,134,75,132,9,21,64
"2011","Rother 011D","E01021121","Total",818,348,188,160,470,28,145,62,152,7,20,56
"2011","Rother 011E","E01021122","Total",860,531,274,257,329,29,99,46,124,4,2,25
"2011","Wealden 001A","E01021167","Total",945,304,155,149,641,66,123,123,148,21,50,110
"2011","Wealden 001B","E01021168","Total",675,159,76,83,516,27,127,102,109,18,34,99
"2011","Wealden 001C","E01021169","Total",495,105,46,59,390,18,84,67,91,13,40,77
"2011","Wealden 001D","E01021186","Total",508,126,60,66,382,16,94,74,95,16,19,68
"2011","Wealden 002A","E01021171","Total",812,187,99,88,625,30,134,132,146,28,42,113
"2011","Wealden 002B","E01021172","Total",732,173,91,82,559,28,139,126,121,32,33,80
"2011","Wealden 002C","E01021173","Total",548,110,45,65,438,11,104,79,116,27,41,60
"2011","Wealden 002D","E01021218","Total",478,108,54,54,370,10,106,61,94,12,28,59
"2011","Wealden 003A","E01021156","Total",758,222,147,75,536,25,107,125,147,23,34,75
"2011","Wealden 003B","E01021157","Total",742,161,106,55,581,15,162,94,133,25,42,110
"2011","Wealden 003C","E01021158","Total",842,160,82,78,682,31,157,149,152,29,53,111
"2011","Wealden 004A","E01021159","Total",942,207,142,65,735,11,240,85,181,21,56,141
"2011","Wealden 004B","E01021160","Total",739,281,169,112,458,21,145,67,124,17,17,67
"2011","Wealden 004C","E01021161","Total",667,185,83,102,482,29,115,100,110,14,31,83
"2011","Wealden 004D","E01021162","Total",640,131,77,54,509,13,159,80,122,14,32,89
"2011","Wealden 005A","E01021202","Total",521,207,130,77,314,14,95,59,91,7,10,38
"2011","Wealden 005B","E01021203","Total",618,157,78,79,461,11,144,79,101,21,27,78
"2011","Wealden 005C","E01021229","Total",695,188,91,97,507,21,112,114,129,19,31,81
"2011","Wealden 005D","E01021230","Total",688,153,84,69,535,22,134,106,120,26,41,86
"2011","Wealden 005E","E01021231","Total",773,260,158,102,513,32,120,100,119,23,36,83
"2011","Wealden 006A","E01021151","Total",679,127,64,63,552,28,102,106,147,25,48,96
"2011","Wealden 006B","E01021152","Total",501,130,67,63,371,28,76,69,72,14,43,69
"2011","Wealden 006C","E01021153","Total",861,285,122,163,576,42,81,129,173,20,46,85
"2011","Wealden 006D","E01021154","Total",606,156,61,95,450,34,84,102,105,15,31,79
"2011","Wealden 006E","E01021155","Total",479,112,40,72,367,29,46,87,110,10,21,64
"2011","Wealden 007A","E01021163","Total",837,187,114,73,650,8,192,113,160,21,43,113
"2011","Wealden 007B","E01021164","Total",770,204,86,118,566,31,137,120,159,26,28,65
"2011","Wealden 007C","E01021187","Total",582,124,56,68,458,14,129,81,113,13,25,83
"2011","Wealden 008A","E01021144","Total",689,125,75,50,564,12,127,112,153,30,37,93
"2011","Wealden 008B","E01021145","Total",817,208,109,99,609,15,158,103,174,23,37,99
"2011","Wealden 008C","E01021170","Total",1103,222,107,115,881,33,232,141,248,33,59,135
"2011","Wealden 008D","E01021217","Total",544,149,91,58,395,3,116,79,85,19,23,70
"2011","Wealden 009A","E01021219","Total",545,105,69,36,440,13,106,84,119,12,21,85
"2011","Wealden 009B","E01021220","Total",793,311,191,120,482,24,125,92,137,11,27,66
"2011","Wealden 009C","E01021223","Total",494,157,80,77,337,19,73,63,92,10,22,58
"2011","Wealden 009D","E01021224","Total",641,220,117,103,421,38,65,70,107,28,33,80
"2011","Wealden 009E","E01021225","Total",673,169,82,87,504,31,120,113,138,12,23,67
"2011","Wealden 009F","E01021226","Total",522,108,44,64,414,37,44,88,118,20,37,70
"2011","Wealden 010A","E01021150","Total",441,76,47,29,365,1,100,70,84,18,23,69
"2011","Wealden 010B","E01021191","Total",841,350,168,182,491,30,142,79,152,6,23,59
"2011","Wealden 010C","E01021192","Total",659,166,87,79,493,26,106,107,111,17,24,102
"2011","Wealden 010D","E01021193","Total",756,250,142,108,506,40,103,86,136,22,42,77
"2011","Wealden 010E","E01021194","Total",633,144,77,67,489,39,82,124,105,26,41,72
"2011","Wealden 011A","E01021149","Total",529,153,75,78,376,13,89,65,102,11,25,71
"2011","Wealden 011B","E01021189","Total",523,104,49,55,419,8,92,79,114,19,38,69
"2011","Wealden 011C","E01021190","Total",640,156,87,69,484,11,140,74,133,21,28,77
"2011","Wealden 011D","E01021200","Total",510,188,111,77,322,26,72,58,77,6,22,61
"2011","Wealden 011E","E01021201","Total",604,135,82,53,469,16,129,83,117,17,38,69
"2011","Wealden 012A","E01021221","Total",540,160,57,103,380,25,69,85,108,9,27,57
"2011","Wealden 012B","E01021222","Total",685,250,118,132,435,21,63,98,141,15,31,66
"2011","Wealden 012C","E01021227","Total",607,103,37,66,504,31,70,119,132,16,40,96
"2011","Wealden 012D","E01021228","Total",577,114,51,63,463,29,82,100,104,18,47,83
"2011","Wealden 013A","E01021146","Total",701,143,79,64,558,29,149,93,124,28,38,97
"2011","Wealden 013B","E01021147","Total",642,145,61,84,497,14,105,86,116,17,43,116
"2011","Wealden 013C","E01021148","Total",600,132,66,66,468,25,100,81,121,23,33,85
"2011","Wealden 013D","E01021165","Total",455,75,42,33,380,8,84,65,103,24,19,77
"2011","Wealden 014A","E01021188","Total",477,119,58,61,358,11,97,59,90,18,16,67
"2011","Wealden 014B","E01021198","Total",644,194,96,98,450,35,104,80,96,22,33,80
"2011","Wealden 014C","E01021199","Total",581,152,85,67,429,11,144,63,116,12,27,56
"2011","Wealden 014D","E01021204","Total",499,135,87,48,364,22,73,74,90,16,23,66
"2011","Wealden 014E","E01021205","Total",494,114,58,56,380,8,107,46,99,13,39,68
"2011","Wealden 015A","E01021174","Total",659,149,84,65,510,25,136,95,109,18,41,86
"2011","Wealden 015B","E01021175","Total",628,166,95,71,462,16,144,88,108,17,24,65
"2011","Wealden 015C","E01021176","Total",652,234,160,74,418,13,138,58,103,16,33,57
"2011","Wealden 015D","E01021177","Total",581,268,152,116,313,22,86,46,101,5,13,40
"2011","Wealden 016A","E01021180","Total",537,130,66,64,407,20,128,67,106,9,21,56
"2011","Wealden 016B","E01021181","Total",529,126,72,54,403,15,116,94,73,16,26,63
"2011","Wealden 016C","E01021182","Total",677,218,150,68,459,17,150,65,85,23,28,91
"2011","Wealden 016D","E01021183","Total",541,157,59,98,384,65,55,79,79,27,28,51
"2011","Wealden 017A","E01021178","Total",546,131,81,50,415,44,102,83,71,24,26,65
"2011","Wealden 017B","E01021179","Total",637,212,95,117,425,53,64,63,116,27,31,71
"2011","Wealden 017C","E01021184","Total",648,190,108,82,458,13,156,77,110,25,28,49
"2011","Wealden 017D","E01021185","Total",642,218,126,92,424,52,72,77,107,32,24,60
"2011","Wealden 018A","E01021142","Total",609,232,170,62,377,3,233,21,72,5,14,29
"2011","Wealden 018B","E01021143","Total",560,187,105,82,373,19,118,48,114,9,26,39
"2011","Wealden 018C","E01021166","Total",1050,295,178,117,755,16,305,89,199,24,36,86
"2011","Wealden 018D","E01021195","Total",780,198,118,80,582,23,164,75,161,20,44,95
"2011","Wealden 018E","E01021196","Total",805,191,107,84,614,35,163,105,141,22,37,111
"2011","Wealden 018F","E01021197","Total",723,159,64,95,564,28,104,116,157,21,33,105
"2011","Wealden 019A","E01021212","Total",918,328,197,131,590,32,207,83,171,13,18,66
"2011","Wealden 019B","E01021213","Total",805,279,119,160,526,56,104,98,160,15,28,65
"2011","Wealden 019C","E01021214","Total",774,291,204,87,483,25,174,80,117,11,19,57
"2011","Wealden 019D","E01021215","Total",642,255,184,71,387,16,138,48,112,7,18,48
"2011","Wealden 019E","E01021216","Total",510,151,91,60,359,17,113,50,92,11,18,58
"2011","Wealden 020A","E01021206","Total",667,233,153,80,434,21,124,63,109,17,18,82
"2011","Wealden 020B","E01021207","Total",660,224,124,100,436,18,152,63,129,7,16,51
"2011","Wealden 020C","E01021208","Total",743,127,64,63,616,40,128,150,154,23,49,72
"2011","Wealden 020D","E01021209","Total",668,130,79,51,538,21,194,84,113,13,38,75
"2011","Wealden 020E","E01021210","Total",581,85,35,50,496,29,91,144,107,18,43,64
"2011","Wealden 020F","E01021211","Total",806,338,215,123,468,9,209,39,133,11,25,42
"2011","Wealden 021A","E01021232","Total",816,291,194,97,525,24,207,61,128,18,23,64
"2011","Wealden 021B","E01021233","Total",640,181,118,63,459,20,161,73,90,23,28,64
"2011","Wealden 021C","E01021234","Total",675,193,127,66,482,20,165,82,123,8,26,58
"2011","Wealden 021D","E01021235","Total",647,198,137,61,449,11,189,52,109,7,22,59
"2011","Wealden 021E","E01021236","Total",728,273,163,110,455,16,156,72,113,8,23,67
"2011","Basingstoke and Deane 001A","E01022553","Total",606,156,62,94,450,21,105,81,119,13,34,77
"2011","Basingstoke and Deane 001B","E01022554","Total",678,164,83,81,514,18,97,106,148,26,31,88
"2011","Basingstoke and Deane 001C","E01022555","Total",629,184,99,85,445,32,96,74,117,15,33,78
"2011","Basingstoke and Deane 001D","E01022556","Total",666,206,94,112,460,39,69,103,119,21,38,71
"2011","Basingstoke and Deane 001E","E01022560","Total",481,119,42,77,362,11,51,81,115,11,25,68
"2011","Basingstoke and Deane 002A","E01022493","Total",521,95,39,56,426,8,96,104,120,14,22,62
"2011","Basingstoke and Deane 002B","E01022536","Total",551,127,73,54,424,4,120,77,108,9,30,76
"2011","Basingstoke and Deane 002C","E01022537","Total",550,119,73,46,431,12,102,75,129,9,22,82
"2011","Basingstoke and Deane 002D","E01022557","Total",627,165,58,107,462,32,95,98,118,19,22,78
"2011","Basingstoke and Deane 002E","E01022558","Total",588,241,49,192,347,25,29,78,120,19,24,52
"2011","Basingstoke and Deane 002F","E01022559","Total",524,130,58,72,394,17,80,70,104,12,35,76
"2011","Basingstoke and Deane 003A","E01022488","Total",451,90,47,43,361,13,53,87,105,23,31,49
"2011","Basingstoke and Deane 003B","E01022489","Total",548,108,61,47,440,12,90,96,120,16,33,73
"2011","Basingstoke and Deane 003C","E01022499","Total",557,86,40,46,471,8,91,129,118,24,27,74
"2011","Basingstoke and Deane 003D","E01022500","Total",535,103,48,55,432,14,76,92,138,15,22,75
"2011","Basingstoke and Deane 003E","E01022513","Total",616,109,56,53,507,17,103,120,132,21,33,81
"2011","Basingstoke and Deane 004A","E01022472","Total",500,97,49,48,403,9,109,61,114,24,24,62
"2011","Basingstoke and Deane 004B","E01022473","Total",504,106,54,52,398,21,87,81,95,7,26,81
"2011","Basingstoke and Deane 004C","E01022520","Total",759,282,136,146,477,26,90,90,143,18,30,80
"2011","Basingstoke and Deane 004D","E01022521","Total",741,207,97,110,534,20,126,117,159,10,31,71
"2011","Basingstoke and Deane 004E","E01022522","Total",623,127,47,80,496,20,103,82,153,20,32,86
"2011","Basingstoke and Deane 005A","E01022490","Total",742,178,68,110,564,24,95,161,179,19,26,60
"2011","Basingstoke and Deane 005B","E01022491","Total",746,148,37,111,598,58,68,153,187,37,43,52
"2011","Basingstoke and Deane 005C","E01022492","Total",661,152,61,91,509,8,98,117,184,14,15,73
"2011","Basingstoke and Deane 005D","E01022546","Total",557,145,65,80,412,10,74,98,125,17,25,63
"2011","Basingstoke and Deane 005E","E01022547","Total",724,180,99,81,544,16,128,109,161,27,29,74
"2011","Basingstoke and Deane 006A","E01022495","Total",652,207,31,176,445,30,24,123,183,15,21,49
"2011","Basingstoke and Deane 006B","E01022496","Total",937,167,18,149,770,40,54,258,241,29,49,99
"2011","Basingstoke and Deane 006C","E01022497","Total",610,196,45,151,414,18,46,128,143,8,18,53
"2011","Basingstoke and Deane 006D","E01022498","Total",650,172,32,140,478,20,57,124,166,14,36,61
"2011","Basingstoke and Deane 007B","E01022539","Total",488,130,40,90,358,27,53,89,85,22,24,58
"2011","Basingstoke and Deane 007C","E01022540","Total",749,175,43,132,574,70,63,119,157,31,59,75
"2011","Basingstoke and Deane 007E","E01022542","Total",456,100,28,72,356,33,50,72,70,25,38,68
"2011","Basingstoke and Deane 007F","E01022543","Total",653,201,53,148,452,33,45,94,139,27,35,79
"2011","Basingstoke and Deane 007H","E01032843","Total",695,188,8,180,507,42,14,156,213,12,32,38
"2011","Basingstoke and Deane 007I","E01032844","Total",685,252,106,146,433,35,49,86,148,18,32,65
"2011","Basingstoke and Deane 007J","E01032851","Total",825,235,63,172,590,69,83,136,132,29,54,87
"2011","Basingstoke and Deane 008A","E01022470","Total",791,214,67,147,577,16,53,140,225,20,38,85
"2011","Basingstoke and Deane 008B","E01022471","Total",619,125,38,87,494,21,71,118,158,20,26,80
"2011","Basingstoke and Deane 008C","E01022494","Total",1024,292,71,221,732,43,54,197,269,39,42,88
"2011","Basingstoke and Deane 008D","E01022523","Total",804,222,71,151,582,78,64,97,148,25,52,118
"2011","Basingstoke and Deane 009A","E01022524","Total",745,202,73,129,543,64,69,109,123,32,56,90
"2011","Basingstoke and Deane 009B","E01022525","Total",651,177,77,100,474,17,100,79,134,22,31,91
"2011","Basingstoke and Deane 009C","E01022526","Total",657,157,56,101,500,37,77,91,135,23,47,90
"2011","Basingstoke and Deane 009D","E01022527","Total",749,297,124,173,452,43,68,98,138,13,33,59
"2011","Basingstoke and Deane 010B","E01022566","Total",473,63,35,28,410,17,86,93,84,8,33,89
"2011","Basingstoke and Deane 010C","E01022567","Total",511,144,73,71,367,46,54,72,72,19,41,63
"2011","Basingstoke and Deane 010D","E01022568","Total",614,208,87,121,406,38,54,70,122,18,37,67
"2011","Basingstoke and Deane 010E","E01022570","Total",637,124,59,65,513,24,133,93,125,9,34,95
"2011","Basingstoke and Deane 010F","E01032840","Total",708,188,8,180,520,44,3,181,208,27,24,33
"2011","Basingstoke and Deane 010G","E01032841","Total",702,200,19,181,502,35,29,152,189,22,35,40
"2011","Basingstoke and Deane 011B","E01022502","Total",690,232,77,155,458,32,74,92,128,13,30,89
"2011","Basingstoke and Deane 011C","E01022506","Total",592,215,69,146,377,25,56,67,137,14,19,59
"2011","Basingstoke and Deane 011D","E01022507","Total",680,222,62,160,458,31,67,77,144,17,34,88
"2011","Basingstoke and Deane 011E","E01032842","Total",679,319,16,303,360,15,9,94,206,1,11,24
"2011","Basingstoke and Deane 011F","E01032847","Total",651,274,91,183,377,30,51,60,152,12,23,49
"2011","Basingstoke and Deane 012A","E01022481","Total",753,208,97,111,545,24,113,108,145,12,45,98
"2011","Basingstoke and Deane 012B","E01022482","Total",712,304,140,164,408,51,53,69,114,14,38,69
"2011","Basingstoke and Deane 012D","E01022503","Total",617,196,46,150,421,17,54,71,157,18,31,73
"2011","Basingstoke and Deane 012E","E01032845","Total",720,216,55,161,504,36,43,121,171,15,29,89
"2011","Basingstoke and Deane 012F","E01032846","Total",742,260,13,247,482,35,14,134,252,6,5,36
"2011","Basingstoke and Deane 013A","E01022484","Total",504,130,49,81,374,55,45,84,79,17,28,66
"2011","Basingstoke and Deane 013B","E01022485","Total",465,131,38,93,334,30,58,64,80,20,33,49
"2011","Basingstoke and Deane 013C","E01022486","Total",801,170,34,136,631,75,42,159,205,25,42,83
"2011","Basingstoke and Deane 013D","E01022487","Total",484,117,46,71,367,40,49,67,82,30,35,64
"2011","Basingstoke and Deane 013E","E01022569","Total",507,114,49,65,393,14,96,74,108,16,18,67
"2011","Basingstoke and Deane 014A","E01022548","Total",631,188,113,75,443,38,127,65,123,14,17,59
"2011","Basingstoke and Deane 014B","E01022549","Total",791,348,117,231,443,52,83,87,108,17,30,66
"2011","Basingstoke and Deane 014C","E01022550","Total",793,295,119,176,498,59,117,89,123,21,19,70
"2011","Basingstoke and Deane 014D","E01022551","Total",650,197,93,104,453,27,83,82,111,17,38,95
"2011","Basingstoke and Deane 014E","E01022552","Total",607,171,66,105,436,41,54,89,110,21,29,92
"2011","Basingstoke and Deane 015A","E01022528","Total",497,90,55,35,407,11,92,67,109,16,35,77
"2011","Basingstoke and Deane 015B","E01022529","Total",660,220,127,93,440,21,98,61,151,18,24,67
"2011","Basingstoke and Deane 015C","E01022530","Total",523,97,69,28,426,7,135,51,112,13,32,76
"2011","Basingstoke and Deane 015D","E01022531","Total",597,99,60,39,498,15,126,82,144,14,31,86
"2011","Basingstoke and Deane 016A","E01022475","Total",719,220,38,182,499,44,36,110,178,12,32,87
"2011","Basingstoke and Deane 016B","E01022476","Total",696,125,42,83,571,26,65,149,172,25,44,90
"2011","Basingstoke and Deane 016C","E01022480","Total",494,106,44,62,388,34,41,76,91,21,36,89
"2011","Basingstoke and Deane 016D","E01022504","Total",643,169,82,87,474,18,146,67,123,18,33,69
"2011","Basingstoke and Deane 016E","E01022505","Total",627,144,66,78,483,17,109,89,121,21,43,83
"2011","Basingstoke and Deane 017A","E01022467","Total",668,134,78,56,534,10,151,84,133,26,38,92
"2011","Basingstoke and Deane 017B","E01022468","Total",749,197,93,104,552,26,151,105,172,15,30,53
"2011","Basingstoke and Deane 017C","E01022469","Total",662,180,112,68,482,16,111,111,113,22,28,81
"2011","Basingstoke and Deane 017D","E01022561","Total",608,135,50,85,473,14,107,90,150,22,27,63
"2011","Basingstoke and Deane 017E","E01022562","Total",545,103,60,43,442,8,106,85,144,19,24,56
"2011","Basingstoke and Deane 018A","E01022515","Total",656,221,155,66,435,6,206,31,97,2,14,79
"2011","Basingstoke and Deane 018B","E01022516","Total",610,140,110,30,470,8,146,79,99,15,32,91
"2011","Basingstoke and Deane 018C","E01022517","Total",489,60,38,22,429,6,107,67,134,15,22,78
"2011","Basingstoke and Deane 018D","E01022518","Total",744,119,42,77,625,21,88,156,177,35,46,102
"2011","Basingstoke and Deane 018E","E01022519","Total",497,78,45,33,419,5,116,74,104,15,30,75
"2011","Basingstoke and Deane 019A","E01022474","Total",614,159,49,110,455,66,54,101,104,24,36,70
"2011","Basingstoke and Deane 019B","E01022477","Total",633,228,57,171,405,36,38,102,146,8,28,47
"2011","Basingstoke and Deane 019C","E01022478","Total",621,191,62,129,430,46,41,114,126,12,17,74
"2011","Basingstoke and Deane 019D","E01022479","Total",599,189,99,90,410,50,49,78,116,18,25,74
"2011","Basingstoke and Deane 019E","E01022509","Total",574,135,36,99,439,29,40,139,139,12,27,53
"2011","Basingstoke and Deane 020A","E01022514","Total",631,164,75,89,467,15,102,93,130,20,30,77
"2011","Basingstoke and Deane 020B","E01022563","Total",731,183,83,100,548,17,103,116,180,19,33,80
"2011","Basingstoke and Deane 020C","E01022564","Total",783,229,104,125,554,29,134,125,142,25,35,64
"2011","Basingstoke and Deane 020D","E01022565","Total",727,228,108,120,499,36,87,109,149,13,34,71
"2011","Basingstoke and Deane 021B","E01022510","Total",577,64,10,54,513,29,26,169,139,15,44,91
"2011","Basingstoke and Deane 021C","E01022511","Total",446,54,11,43,392,11,33,104,116,24,35,69
"2011","Basingstoke and Deane 021D","E01022512","Total",468,54,14,40,414,12,21,129,101,22,53,76
"2011","Basingstoke and Deane 021E","E01032848","Total",573,97,6,91,476,55,14,167,135,34,30,41
"2011","Basingstoke and Deane 021F","E01032849","Total",564,99,14,85,465,50,15,172,130,31,23,44
"2011","Basingstoke and Deane 021G","E01032850","Total",607,147,25,122,460,36,28,124,170,20,24,58
"2011","Basingstoke and Deane 022A","E01022532","Total",537,100,50,50,437,19,96,80,130,21,23,68
"2011","Basingstoke and Deane 022B","E01022533","Total",694,129,55,74,565,23,100,122,173,21,45,81
"2011","Basingstoke and Deane 022C","E01022534","Total",724,202,117,85,522,21,122,119,146,14,16,84
"2011","Basingstoke and Deane 022D","E01022535","Total",689,242,139,103,447,12,134,86,125,11,26,53
"2011","East Hampshire 001A","E01022581","Total",573,131,54,77,442,19,86,105,110,32,30,60
"2011","East Hampshire 001B","E01022582","Total",558,104,55,49,454,8,113,86,120,15,37,75
"2011","East Hampshire 001C","E01022604","Total",485,99,50,49,386,11,100,78,99,19,19,60
"2011","East Hampshire 001D","E01022605","Total",607,158,77,81,449,10,82,83,139,24,39,72
"2011","East Hampshire 002A","E01022574","Total",621,255,135,120,366,23,54,94,97,10,24,64
"2011","East Hampshire 002B","E01022575","Total",573,138,57,81,435,47,57,77,101,37,43,73
"2011","East Hampshire 002C","E01022576","Total",803,399,224,175,404,54,65,67,135,8,27,48
"2011","East Hampshire 002D","E01022579","Total",506,175,85,90,331,36,76,56,76,14,21,52
"2011","East Hampshire 003A","E01022571","Total",475,78,43,35,397,10,74,86,127,16,20,64
"2011","East Hampshire 003B","E01022572","Total",507,117,45,72,390,14,75,73,107,15,26,80
"2011","East Hampshire 003C","E01022573","Total",1066,319,127,192,747,16,151,140,241,23,61,115
"2011","East Hampshire 003D","E01022577","Total",736,305,189,116,431,24,100,82,137,14,21,53
"2011","East Hampshire 003E","E01022578","Total",1174,244,119,125,930,46,212,171,224,41,70,166
"2011","East Hampshire 003F","E01022580","Total",484,99,47,52,385,15,65,70,126,15,19,75
"2011","East Hampshire 004A","E01022603","Total",534,121,53,68,413,26,63,78,105,26,46,69
"2011","East Hampshire 004B","E01022634","Total",498,194,103,91,304,19,38,63,105,9,22,48
"2011","East Hampshire 004C","E01022639","Total",567,87,20,67,480,29,25,191,123,30,42,40
"2011","East Hampshire 004D","E01022640","Total",571,146,14,132,425,40,23,114,127,24,29,68
"2011","East Hampshire 006A","E01022615","Total",1101,249,92,157,852,46,148,184,219,30,63,162
"2011","East Hampshire 006B","E01022633","Total",608,218,59,159,390,16,63,86,142,8,27,48
"2011","East Hampshire 006C","E01022635","Total",514,85,34,51,429,40,58,78,91,30,53,79
"2011","East Hampshire 006D","E01022636","Total",499,91,30,61,408,22,44,89,121,17,37,78
"2011","East Hampshire 006E","E01022641","Total",519,158,43,115,361,19,52,71,107,17,30,65
"2011","East Hampshire 007A","E01022591","Total",961,155,71,84,806,17,232,156,208,32,46,115
"2011","East Hampshire 007B","E01022593","Total",482,92,57,35,390,8,106,75,89,12,29,71
"2011","East Hampshire 007C","E01022594","Total",587,126,71,55,461,21,104,94,131,16,28,67
"2011","East Hampshire 007D","E01022595","Total",728,123,55,68,605,20,116,128,156,31,37,117
"2011","East Hampshire 007E","E01022596","Total",537,77,37,40,460,2,141,80,123,13,24,77
"2011","East Hampshire 007F","E01022627","Total",880,174,89,85,706,22,175,122,176,26,55,130
"2011","East Hampshire 008A","E01022630","Total",939,209,98,111,730,25,191,122,199,19,48,126
"2011","East Hampshire 008D","E01022642","Total",420,86,43,43,334,8,68,67,89,17,26,59
"2011","East Hampshire 008E","E01032663","Total",966,244,98,146,722,50,130,150,198,21,45,128
"2011","East Hampshire 009A","E01022583","Total",699,190,101,89,509,28,122,105,105,17,39,93
"2011","East Hampshire 009B","E01022584","Total",785,316,175,141,469,29,95,105,100,31,35,74
"2011","East Hampshire 009C","E01022585","Total",653,145,94,51,508,11,114,95,134,22,35,97
"2011","East Hampshire 009D","E01022586","Total",634,119,56,63,515,12,126,105,116,24,32,100
"2011","East Hampshire 009E","E01022587","Total",761,238,114,124,523,38,90,117,149,19,26,84
"2011","East Hampshire 010A","E01022616","Total",735,248,126,122,487,39,94,107,114,22,34,77
"2011","East Hampshire 010B","E01022617","Total",657,196,111,85,461,21,98,77,136,22,42,65
"2011","East Hampshire 010C","E01022618","Total",671,143,87,56,528,12,160,94,135,23,26,78
"2011","East Hampshire 010D","E01022631","Total",514,129,64,65,385,15,69,97,102,11,36,55
"2011","East Hampshire 010E","E01022632","Total",453,101,42,59,352,11,86,70,89,18,15,63
"2011","East Hampshire 011A","E01022592","Total",929,222,114,108,707,41,156,119,188,34,57,112
"2011","East Hampshire 011B","E01022597","Total",993,225,99,126,768,25,184,148,190,41,61,119
"2011","East Hampshire 011C","E01022619","Total",517,120,43,77,397,13,80,83,116,14,26,65
"2011","East Hampshire 011D","E01022624","Total",1000,274,168,106,726,9,207,118,205,25,50,112
"2011","East Hampshire 011E","E01022625","Total",1090,282,157,125,808,25,200,202,176,40,48,117
"2011","East Hampshire 012A","E01022620","Total",489,150,54,96,339,17,45,79,111,11,22,54
"2011","East Hampshire 012B","E01022621","Total",607,204,118,86,403,41,72,80,92,29,35,54
"2011","East Hampshire 012C","E01022622","Total",568,158,91,67,410,12,119,101,85,14,16,63
"2011","East Hampshire 012D","E01022623","Total",940,236,124,112,704,60,135,147,183,31,53,95
"2011","East Hampshire 012F","E01032664","Total",656,370,202,168,286,14,69,47,113,2,13,28
"2011","East Hampshire 012G","E01032665","Total",658,259,125,134,399,26,72,76,136,12,22,55
"2011","East Hampshire 013A","E01022588","Total",647,127,80,47,520,17,139,91,124,16,42,91
"2011","East Hampshire 013B","E01022589","Total",741,185,81,104,556,29,110,114,172,15,35,81
"2011","East Hampshire 013C","E01022590","Total",595,86,46,40,509,22,143,87,125,15,24,93
"2011","East Hampshire 013D","E01022607","Total",515,132,69,63,383,15,92,68,111,9,28,60
"2011","East Hampshire 013E","E01022608","Total",522,83,42,41,439,8,95,90,127,16,37,66
"2011","East Hampshire 014A","E01022606","Total",943,184,76,108,759,21,153,133,218,22,69,143
"2011","East Hampshire 014B","E01022611","Total",634,172,99,73,462,21,89,102,120,20,29,81
"2011","East Hampshire 014C","E01022613","Total",518,94,47,47,424,29,73,78,95,16,38,95
"2011","East Hampshire 014D","E01022614","Total",474,127,66,61,347,27,94,53,85,8,16,64
"2011","East Hampshire 016A","E01022610","Total",536,139,90,49,397,12,82,62,104,13,34,90
"2011","East Hampshire 016B","E01022628","Total",520,151,55,96,369,22,76,69,121,10,14,57
"2011","East Hampshire 016C","E01022629","Total",618,160,109,51,458,9,191,50,107,8,29,64
"2011","East Hampshire 016D","E01032615","Total",466,115,83,32,351,2,144,49,70,14,16,56
"2011","East Hampshire 016E","E01032616","Total",632,125,62,63,507,14,113,95,129,14,37,105
"2011","East Hampshire 017A","E01022599","Total",597,233,125,108,364,18,95,68,97,15,17,54
"2011","East Hampshire 017B","E01022600","Total",640,159,92,67,481,13,151,81,136,8,24,68
"2011","East Hampshire 017C","E01022601","Total",597,141,93,48,456,11,127,80,115,16,31,76
"2011","East Hampshire 017D","E01022602","Total",520,79,49,30,441,2,125,64,149,13,20,68
"2011","East Hampshire 017E","E01032625","Total",455,109,84,25,346,7,124,46,72,23,22,52
"2011","Eastleigh 001A","E01022705","Total",652,163,123,40,489,7,178,101,79,18,34,72
"2011","Eastleigh 001B","E01022706","Total",647,129,103,26,518,3,156,87,106,26,41,99
"2011","Eastleigh 001C","E01022707","Total",761,129,69,60,632,24,139,136,134,42,44,113
"2011","Eastleigh 001D","E01022708","Total",736,179,91,88,557,26,139,129,139,18,31,75
"2011","Eastleigh 001E","E01022709","Total",691,159,95,64,532,25,167,106,111,19,37,67
"2011","Eastleigh 002A","E01022659","Total",630,127,57,70,503,35,73,109,123,11,45,107
"2011","Eastleigh 002B","E01022660","Total",663,237,138,99,426,17,93,69,106,23,27,91
"2011","Eastleigh 002C","E01022675","Total",566,119,51,68,447,9,90,72,141,9,29,97
"2011","Eastleigh 002D","E01022676","Total",608,121,63,58,487,13,98,69,149,13,31,114
"2011","Eastleigh 002E","E01022704","Total",745,185,102,83,560,21,123,128,135,19,44,90
"2011","Eastleigh 003A","E01022661","Total",799,261,163,98,538,18,157,91,179,7,21,65
"2011","Eastleigh 003B","E01022662","Total",543,108,57,51,435,9,101,74,129,11,28,83
"2011","Eastleigh 003C","E01022663","Total",635,141,53,88,494,14,87,105,144,15,44,85
"2011","Eastleigh 003D","E01022664","Total",646,166,96,70,480,20,106,100,140,20,25,69
"2011","Eastleigh 003E","E01022665","Total",748,304,132,172,444,36,80,81,160,6,26,55
"2011","Eastleigh 004A","E01022648","Total",612,241,124,117,371,18,81,48,117,11,27,69
"2011","Eastleigh 004B","E01022667","Total",614,148,55,93,466,27,58,102,148,12,21,98
"2011","Eastleigh 004C","E01022672","Total",623,158,64,94,465,19,77,80,114,20,40,115
"2011","Eastleigh 004D","E01022673","Total",864,243,57,186,621,39,86,136,189,19,49,103
"2011","Eastleigh 004E","E01022674","Total",716,203,83,120,513,26,76,96,190,10,18,97
"2011","Eastleigh 005A","E01022643","Total",667,166,52,114,501,23,86,116,135,10,29,102
"2011","Eastleigh 005B","E01022644","Total",511,106,51,55,405,28,61,90,108,20,27,71
"2011","Eastleigh 005C","E01022646","Total",650,174,79,95,476,39,82,100,114,15,42,84
"2011","Eastleigh 005D","E01022647","Total",618,141,77,64,477,18,97,96,125,18,25,98
"2011","Eastleigh 005E","E01022649","Total",656,175,96,79,481,67,87,98,95,33,36,65
"2011","Eastleigh 005F","E01022650","Total",461,101,51,50,360,16,67,70,106,13,19,69
"2011","Eastleigh 006A","E01022668","Total",1010,224,52,172,786,62,67,166,258,41,63,129
"2011","Eastleigh 006B","E01022677","Total",849,240,144,96,609,68,67,139,175,21,36,103
"2011","Eastleigh 006C","E01022678","Total",718,171,82,89,547,43,82,132,137,21,39,93
"2011","Eastleigh 006D","E01022680","Total",779,309,155,154,470,54,105,94,124,11,29,53
"2011","Eastleigh 006E","E01022681","Total",640,188,100,88,452,37,83,69,115,19,41,88
"2011","Eastleigh 007A","E01022666","Total",930,311,83,228,619,34,55,124,222,24,39,121
"2011","Eastleigh 007B","E01022669","Total",740,192,65,127,548,39,57,117,193,24,40,78
"2011","Eastleigh 007C","E01022670","Total",671,186,56,130,485,76,31,97,161,25,23,72
"2011","Eastleigh 007D","E01022671","Total",719,312,76,236,407,32,37,88,135,20,31,64
"2011","Eastleigh 007E","E01022679","Total",736,161,47,114,575,50,63,126,185,26,36,89
"2011","Eastleigh 008A","E01022645","Total",494,105,68,37,389,5,113,55,118,7,24,67
"2011","Eastleigh 008B","E01022682","Total",508,76,40,36,432,7,93,83,106,13,31,99
"2011","Eastleigh 008C","E01022683","Total",544,134,64,70,410,17,56,104,106,16,31,80
"2011","Eastleigh 008D","E01022684","Total",592,113,60,53,479,20,116,111,101,12,27,92
"2011","Eastleigh 008E","E01022685","Total",553,208,112,96,345,13,77,64,89,10,25,67
"2011","Eastleigh 008F","E01022686","Total",615,126,50,76,489,16,76,128,117,17,58,77
"2011","Eastleigh 008G","E01022687","Total",671,139,32,107,532,37,72,140,146,16,47,74
"2011","Eastleigh 009A","E01022713","Total",695,180,92,88,515,27,118,104,148,14,29,75
"2011","Eastleigh 009B","E01022714","Total",720,183,134,49,537,13,154,77,144,14,40,95
"2011","Eastleigh 009C","E01022715","Total",747,249,92,157,498,39,100,86,170,10,23,70
"2011","Eastleigh 009D","E01022716","Total",765,310,64,246,455,44,59,101,164,11,17,59
"2011","Eastleigh 009E","E01022717","Total",523,140,33,107,383,23,68,74,122,8,21,67
"2011","Eastleigh 009F","E01022718","Total",605,156,63,93,449,17,103,76,119,18,34,82
"2011","Eastleigh 009G","E01022719","Total",693,223,135,88,470,12,135,69,126,11,30,87
"2011","Eastleigh 010A","E01022653","Total",616,144,99,45,472,8,131,82,132,11,34,74
"2011","Eastleigh 010B","E01022691","Total",627,150,32,118,477,37,29,148,158,21,30,54
"2011","Eastleigh 010C","E01022692","Total",1110,224,13,211,886,121,28,302,286,34,43,72
"2011","Eastleigh 010D","E01022693","Total",544,91,27,64,453,17,37,167,110,20,34,68
"2011","Eastleigh 010E","E01022694","Total",672,122,25,97,550,44,29,177,170,22,38,70
"2011","Eastleigh 011A","E01022652","Total",746,212,126,86,534,29,118,105,137,16,40,89
"2011","Eastleigh 011B","E01022695","Total",594,211,124,87,383,26,73,69,97,14,30,74
"2011","Eastleigh 011C","E01022700","Total",677,232,126,106,445,34,79,104,104,22,33,69
"2011","Eastleigh 011D","E01022701","Total",416,108,79,29,308,12,91,47,63,11,23,61
"2011","Eastleigh 011E","E01022703","Total",665,209,69,140,456,28,89,79,159,15,24,62
"2011","Eastleigh 012A","E01022651","Total",794,195,56,139,599,42,76,147,214,8,23,89
"2011","Eastleigh 012B","E01022696","Total",644,137,96,41,507,17,160,95,101,14,30,90
"2011","Eastleigh 012C","E01022697","Total",610,119,70,49,491,16,125,96,125,13,36,80
"2011","Eastleigh 012D","E01022698","Total",652,145,97,48,507,16,146,86,118,19,31,91
"2011","Eastleigh 012E","E01022699","Total",620,134,47,87,486,20,110,109,126,18,25,78
"2011","Eastleigh 012F","E01022702","Total",496,99,27,72,397,8,44,111,123,10,31,70
"2011","Eastleigh 013A","E01022654","Total",572,154,36,118,418,23,50,93,141,16,21,74
"2011","Eastleigh 013B","E01022655","Total",558,120,47,73,438,81,38,106,72,27,53,61
"2011","Eastleigh 013C","E01022656","Total",604,150,79,71,454,18,103,95,119,8,33,78
"2011","Eastleigh 013D","E01022657","Total",745,244,79,165,501,34,79,98,177,13,19,81
"2011","Eastleigh 013E","E01022658","Total",721,165,72,93,556,17,154,96,167,23,23,76
"2011","Eastleigh 014A","E01022710","Total",964,375,178,197,589,26,155,97,189,16,25,81
"2011","Eastleigh 014B","E01022711","Total",749,264,149,115,485,38,100,94,109,19,42,83
"2011","Eastleigh 014C","E01022712","Total",685,203,51,152,482,30,64,114,149,12,34,79
"2011","Eastleigh 015A","E01022688","Total",1037,340,107,233,697,45,133,134,255,12,30,88
"2011","Eastleigh 015B","E01022689","Total",659,158,82,76,501,17,129,105,147,6,23,74
"2011","Eastleigh 015C","E01022690","Total",821,209,116,93,612,57,125,139,150,23,33,85
"2011","Fareham 001A","E01022758","Total",600,113,48,65,487,52,67,117,126,17,23,85
"2011","Fareham 001B","E01022771","Total",601,93,18,75,508,19,34,189,164,24,34,44
"2011","Fareham 001C","E01022772","Total",793,95,16,79,698,32,59,233,206,32,43,93
"2011","Fareham 001D","E01022773","Total",651,134,59,75,517,22,132,105,139,10,34,75
"2011","Fareham 001E","E01022774","Total",739,119,56,63,620,20,135,133,164,26,36,106
"2011","Fareham 002A","E01022749","Total",536,97,61,36,439,10,109,75,115,17,32,81
"2011","Fareham 002B","E01022753","Total",493,116,66,50,377,15,59,74,94,17,32,86
"2011","Fareham 002C","E01022754","Total",760,222,69,153,538,42,78,126,177,24,33,58
"2011","Fareham 002D","E01022780","Total",614,116,30,86,498,32,57,158,160,21,17,53
"2011","Fareham 002E","E01022787","Total",541,137,79,58,404,26,72,66,116,14,35,75
"2011","Fareham 002F","E01022788","Total",528,146,55,91,382,23,50,103,110,12,27,57
"2011","Fareham 003A","E01022730","Total",631,160,87,73,471,25,125,62,122,15,30,92
"2011","Fareham 003B","E01022731","Total",515,87,31,56,428,15,53,103,132,10,32,83
"2011","Fareham 003C","E01022732","Total",666,211,99,112,455,69,48,85,132,21,37,63
"2011","Fareham 003D","E01022733","Total",735,198,117,81,537,25,152,87,140,21,33,79
"2011","Fareham 003E","E01022734","Total",515,121,51,70,394,21,56,72,106,21,33,85
"2011","Fareham 004A","E01022720","Total",525,66,36,30,459,6,113,82,113,13,41,91
"2011","Fareham 004B","E01022725","Total",496,91,71,20,405,7,145,48,85,15,26,79
"2011","Fareham 004C","E01022726","Total",607,153,106,47,454,8,163,64,94,14,30,81
"2011","Fareham 004D","E01022727","Total",655,163,103,60,492,15,154,96,94,14,30,89
"2011","Fareham 004E","E01022729","Total",455,83,28,55,372,14,60,83,118,18,20,59
"2011","Fareham 004F","E01022743","Total",806,208,111,97,598,15,178,80,183,11,31,100
"2011","Fareham 005A","E01022750","Total",631,195,136,59,436,8,91,91,111,7,38,90
"2011","Fareham 005B","E01022751","Total",652,168,104,64,484,14,145,84,101,15,32,93
"2011","Fareham 005C","E01022752","Total",542,90,50,40,452,9,94,95,123,13,33,85
"2011","Fareham 005D","E01022757","Total",695,198,31,167,497,30,37,146,189,15,26,54
"2011","Fareham 005E","E01022790","Total",712,150,60,90,562,18,115,106,160,25,48,90
"2011","Fareham 006A","E01022755","Total",610,125,72,53,485,19,142,88,113,12,30,81
"2011","Fareham 006B","E01022756","Total",524,118,49,69,406,13,75,85,114,9,38,72
"2011","Fareham 006C","E01022791","Total",838,250,145,105,588,21,172,124,138,18,32,83
"2011","Fareham 006D","E01022792","Total",626,150,68,82,476,31,113,93,110,15,37,77
"2011","Fareham 006E","E01022793","Total",681,109,61,48,572,19,137,127,145,13,36,95
"2011","Fareham 007A","E01022781","Total",564,151,69,82,413,20,83,92,108,23,32,55
"2011","Fareham 007B","E01022782","Total",646,193,92,101,453,12,124,76,146,14,13,68
"2011","Fareham 007C","E01022785","Total",614,150,64,86,464,10,91,92,136,26,28,81
"2011","Fareham 007D","E01022786","Total",653,144,58,86,509,33,104,98,138,13,31,92
"2011","Fareham 007E","E01022789","Total",634,178,53,125,456,18,75,109,154,13,15,72
"2011","Fareham 008A","E01022721","Total",634,189,71,118,445,23,97,86,150,8,21,60
"2011","Fareham 008B","E01022722","Total",703,245,146,99,458,27,101,98,108,11,40,73
"2011","Fareham 008C","E01022723","Total",723,280,99,181,443,39,76,85,156,9,14,64
"2011","Fareham 008D","E01022724","Total",577,130,51,79,447,35,58,104,134,12,36,68
"2011","Fareham 008E","E01022737","Total",652,162,77,85,490,20,99,91,144,11,34,91
"2011","Fareham 008F","E01022766","Total",529,96,48,48,433,6,127,66,111,8,27,88
"2011","Fareham 008G","E01022769","Total",552,164,44,120,388,27,65,79,136,9,15,57
"2011","Fareham 009A","E01022740","Total",727,187,91,96,540,9,174,61,151,7,34,104
"2011","Fareham 009B","E01022741","Total",466,78,42,36,388,9,91,83,102,18,25,60
"2011","Fareham 009C","E01022742","Total",872,297,212,85,575,9,241,54,143,12,24,92
"2011","Fareham 009D","E01022783","Total",641,155,93,62,486,11,154,65,138,13,32,73
"2011","Fareham 009E","E01022784","Total",500,68,32,36,432,4,88,88,119,14,42,77
"2011","Fareham 010A","E01022759","Total",660,176,107,69,484,16,143,95,105,10,27,88
"2011","Fareham 010B","E01022763","Total",686,168,110,58,518,8,180,71,126,8,28,97
"2011","Fareham 010C","E01022765","Total",760,243,162,81,517,16,131,94,140,11,28,97
"2011","Fareham 010D","E01022768","Total",599,169,70,99,430,13,95,68,135,12,21,86
"2011","Fareham 010E","E01022770","Total",693,135,81,54,558,19,156,82,132,16,37,116
"2011","Fareham 011A","E01022728","Total",841,325,181,144,516,62,73,118,172,7,22,62
"2011","Fareham 011B","E01022735","Total",619,160,53,107,459,32,67,89,164,11,35,61
"2011","Fareham 011C","E01022736","Total",662,194,87,107,468,20,103,78,124,18,27,98
"2011","Fareham 011D","E01022738","Total",483,178,66,112,305,32,50,64,84,16,9,50
"2011","Fareham 011E","E01022739","Total",673,228,128,100,445,64,52,109,91,25,49,55
"2011","Fareham 012A","E01022760","Total",644,157,97,60,487,25,108,85,131,11,35,92
"2011","Fareham 012B","E01022761","Total",657,177,107,70,480,33,131,68,129,13,23,83
"2011","Fareham 012C","E01022762","Total",639,152,87,65,487,26,109,83,133,15,42,79
"2011","Fareham 012D","E01022764","Total",761,294,195,99,467,19,139,68,118,7,27,89
"2011","Fareham 012E","E01022767","Total",511,112,72,40,399,21,94,77,95,7,23,82
"2011","Fareham 013B","E01022776","Total",627,128,69,59,499,12,120,79,126,18,40,104
"2011","Fareham 013C","E01022777","Total",769,272,216,56,497,25,177,63,96,13,40,83
"2011","Fareham 013D","E01022778","Total",598,126,77,49,472,17,138,80,109,13,33,82
"2011","Fareham 013F","E01032877","Total",919,233,162,71,686,24,247,85,156,18,47,109
"2011","Fareham 014A","E01022744","Total",567,125,86,39,442,8,144,54,97,12,34,93
"2011","Fareham 014B","E01022745","Total",633,144,105,39,489,11,159,66,128,11,34,80
"2011","Fareham 014C","E01022746","Total",703,173,118,55,530,11,185,119,113,14,33,55
"2011","Fareham 014D","E01022747","Total",586,214,138,76,372,23,90,57,101,11,27,63
"2011","Fareham 014E","E01022748","Total",629,182,89,93,447,23,107,77,109,13,23,95
"2011","Gosport 001A","E01022800","Total",645,156,99,57,489,41,81,64,132,20,55,96
"2011","Gosport 001B","E01022801","Total",644,204,95,109,440,38,80,63,109,26,36,88
"2011","Gosport 001C","E01022802","Total",607,120,65,55,487,30,105,80,133,13,24,102
"2011","Gosport 001D","E01022803","Total",626,150,78,72,476,45,68,77,100,23,55,108
"2011","Gosport 001E","E01022836","Total",639,157,118,39,482,19,185,54,113,10,22,79
"2011","Gosport 002A","E01022804","Total",680,193,93,100,487,20,105,78,139,11,42,92
"2011","Gosport 002B","E01022805","Total",646,186,127,59,460,30,97,91,124,14,36,68
"2011","Gosport 002C","E01022834","Total",614,186,115,71,428,29,125,48,126,12,22,66
"2011","Gosport 002D","E01022835","Total",627,174,67,107,453,44,90,71,134,16,35,63
"2011","Gosport 002E","E01022840","Total",664,195,62,133,469,44,69,70,124,27,45,90
"2011","Gosport 003A","E01022813","Total",546,108,46,62,438,30,73,76,120,16,41,82
"2011","Gosport 003B","E01022814","Total",762,249,130,119,513,36,86,95,166,19,32,79
"2011","Gosport 003C","E01022815","Total",619,134,59,75,485,16,101,106,110,17,42,93
"2011","Gosport 003D","E01022823","Total",644,154,70,84,490,28,91,81,145,18,34,93
"2011","Gosport 003E","E01022825","Total",591,149,55,94,442,27,71,100,131,16,27,70
"2011","Gosport 004A","E01022819","Total",671,201,32,169,470,95,30,106,139,17,36,47
"2011","Gosport 004B","E01022820","Total",610,99,11,88,511,94,10,135,117,56,46,53
"2011","Gosport 004E","E01022841","Total",608,179,58,121,429,43,52,118,114,22,26,54
"2011","Gosport 004F","E01022842","Total",607,99,38,61,508,51,52,167,113,29,37,59
"2011","Gosport 004G","E01032882","Total",755,152,22,130,603,127,40,118,143,44,49,82
"2011","Gosport 005A","E01022807","Total",760,278,108,170,482,62,59,88,177,13,18,65
"2011","Gosport 005B","E01022816","Total",615,164,61,103,451,36,60,89,140,23,32,71
"2011","Gosport 005C","E01022817","Total",709,187,71,116,522,43,65,100,143,29,43,99
"2011","Gosport 005D","E01022818","Total",606,187,84,103,419,53,63,78,93,16,43,73
"2011","Gosport 005E","E01022824","Total",1210,376,73,303,834,91,79,197,292,23,41,111
"2011","Gosport 006A","E01022826","Total",675,167,67,100,508,31,113,85,166,9,25,79
"2011","Gosport 006C","E01022828","Total",764,384,275,109,380,18,173,35,100,4,12,38
"2011","Gosport 006D","E01022829","Total",805,198,115,83,607,10,183,91,141,46,43,93
"2011","Gosport 006E","E01022830","Total",639,165,112,53,474,21,158,64,129,11,19,72
"2011","Gosport 006F","E01032880","Total",506,74,17,57,432,17,53,151,107,22,34,48
"2011","Gosport 006G","E01032881","Total",595,92,18,74,503,40,33,177,109,36,40,68
"2011","Gosport 006H","E01032883","Total",632,216,130,86,416,51,104,69,99,9,29,55
"2011","Gosport 007A","E01022806","Total",602,148,59,89,454,46,69,77,131,19,29,83
"2011","Gosport 007D","E01022832","Total",697,191,49,142,506,61,61,108,148,20,36,72
"2011","Gosport 007E","E01022839","Total",639,263,94,169,376,27,62,65,110,10,29,73
"2011","Gosport 007F","E01032884","Total",976,304,143,161,672,36,152,147,212,16,29,80
"2011","Gosport 008A","E01022810","Total",731,295,160,135,436,33,64,73,123,17,37,89
"2011","Gosport 008B","E01022811","Total",1093,410,66,344,683,113,70,143,238,20,29,70
"2011","Gosport 008C","E01022833","Total",867,353,97,256,514,96,48,104,144,28,28,66
"2011","Gosport 008D","E01022843","Total",703,273,118,155,430,70,55,85,117,22,29,52
"2011","Gosport 008F","E01032878","Total",607,275,48,227,332,59,33,34,153,5,13,35
"2011","Gosport 008G","E01032879","Total",766,434,148,286,332,41,92,29,140,7,0,23
"2011","Gosport 009A","E01022794","Total",626,172,114,58,454,22,128,79,127,17,21,60
"2011","Gosport 009B","E01022795","Total",740,287,127,160,453,24,136,84,119,8,19,63
"2011","Gosport 009C","E01022796","Total",496,127,99,28,369,7,147,67,76,6,25,41
"2011","Gosport 009D","E01022837","Total",676,186,130,56,490,15,149,78,102,21,35,90
"2011","Gosport 009E","E01022838","Total",520,103,75,28,417,14,125,65,95,18,38,62
"2011","Gosport 010A","E01022797","Total",451,124,56,68,327,10,90,53,82,6,23,63
"2011","Gosport 010B","E01022798","Total",497,151,83,68,346,14,92,54,108,6,15,57
"2011","Gosport 010C","E01022799","Total",582,159,81,78,423,11,108,77,130,10,26,61
"2011","Gosport 010D","E01022812","Total",529,152,50,102,377,23,56,77,116,13,31,61
"2011","Gosport 010E","E01022831","Total",636,190,93,97,446,42,77,75,131,14,39,68
"2011","Gosport 010F","E01022845","Total",675,236,111,125,439,41,72,95,131,14,22,64
"2011","Hart 001A","E01022890","Total",612,155,90,65,457,29,112,83,97,16,37,83
"2011","Hart 001B","E01022891","Total",650,100,46,54,550,22,89,125,132,18,41,123
"2011","Hart 001C","E01022892","Total",782,183,93,90,599,10,183,94,141,17,46,108
"2011","Hart 001D","E01022893","Total",627,131,70,61,496,24,104,105,111,24,39,89
"2011","Hart 001E","E01022894","Total",622,175,82,93,447,23,86,97,119,13,31,78
"2011","Hart 002A","E01022859","Total",622,116,52,64,506,18,88,114,147,26,38,75
"2011","Hart 002B","E01022895","Total",738,179,81,98,559,24,105,130,128,18,38,116
"2011","Hart 002C","E01022896","Total",594,84,36,48,510,14,106,95,102,19,41,133
"2011","Hart 002D","E01022897","Total",627,109,27,82,518,26,51,113,132,16,45,135
"2011","Hart 002E","E01022898","Total",581,122,59,63,459,7,82,89,118,19,41,103
"2011","Hart 003A","E01022846","Total",456,106,36,70,350,10,74,56,116,8,16,70
"2011","Hart 003B","E01022847","Total",746,218,86,132,528,26,103,115,149,18,23,94
"2011","Hart 003C","E01022848","Total",631,143,85,58,488,12,139,85,103,14,38,97
"2011","Hart 003D","E01022874","Total",491,85,51,34,406,15,84,71,86,15,42,93
"2011","Hart 003E","E01022875","Total",485,71,27,44,414,20,46,88,96,30,48,86
"2011","Hart 003F","E01022876","Total",499,80,36,44,419,8,86,92,90,17,43,83
"2011","Hart 003G","E01022877","Total",543,93,47,46,450,11,113,85,84,27,37,93
"2011","Hart 004A","E01022858","Total",410,80,29,51,330,11,93,48,73,12,30,63
"2011","Hart 004B","E01022878","Total",705,136,85,51,569,6,164,106,154,25,34,80
"2011","Hart 004C","E01022879","Total",806,284,186,98,522,35,123,100,151,26,33,54
"2011","Hart 004D","E01022880","Total",628,175,82,93,453,16,87,68,138,24,33,87
"2011","Hart 005A","E01022860","Total",889,321,219,102,568,12,169,97,151,16,38,85
"2011","Hart 005B","E01022862","Total",945,402,177,225,543,21,79,127,194,18,27,77
"2011","Hart 005D","E01022867","Total",645,179,29,150,466,20,42,138,174,12,25,55
"2011","Hart 005E","E01032852","Total",619,95,12,83,524,36,23,199,153,31,36,46
"2011","Hart 005F","E01032853","Total",616,97,13,84,519,16,28,225,143,28,32,47
"2011","Hart 005G","E01032854","Total",604,92,6,86,512,26,24,216,169,26,25,26
"2011","Hart 005H","E01032857","Total",410,102,16,86,308,4,20,86,112,13,15,58
"2011","Hart 006A","E01022881","Total",915,205,103,102,710,40,86,183,186,41,48,126
"2011","Hart 006B","E01022882","Total",565,117,46,71,448,16,75,110,117,14,37,79
"2011","Hart 006C","E01022883","Total",524,87,25,62,437,24,58,101,125,20,34,75
"2011","Hart 006D","E01022884","Total",666,195,116,79,471,15,100,105,118,21,26,86
"2011","Hart 006E","E01022885","Total",544,80,16,64,464,24,50,119,137,15,34,85
"2011","Hart 007A","E01022861","Total",643,98,53,45,545,15,132,114,120,18,43,103
"2011","Hart 007B","E01022863","Total",631,129,91,38,502,12,147,108,108,20,28,79
"2011","Hart 007C","E01022865","Total",628,114,65,49,514,7,135,102,107,20,35,108
"2011","Hart 007D","E01022868","Total",674,122,77,45,552,1,154,130,123,19,21,104
"2011","Hart 007E","E01022870","Total",584,143,84,59,441,8,114,101,88,13,27,90
"2011","Hart 008A","E01022864","Total",636,185,94,91,451,17,154,88,90,16,29,57
"2011","Hart 008B","E01022871","Total",562,140,38,102,422,24,51,117,110,19,31,70
"2011","Hart 008C","E01022872","Total",714,174,99,75,540,15,132,113,116,29,45,90
"2011","Hart 008D","E01022873","Total",638,101,59,42,537,11,145,103,117,15,49,97
"2011","Hart 008E","E01022887","Total",550,90,40,50,460,10,118,75,140,14,26,77
"2011","Hart 009A","E01022849","Total",646,128,74,54,518,9,114,131,112,24,35,93
"2011","Hart 009B","E01022850","Total",631,200,62,138,431,17,86,104,109,19,31,65
"2011","Hart 009C","E01022851","Total",662,141,67,74,521,18,115,113,137,22,30,86
"2011","Hart 009D","E01022853","Total",693,156,92,64,537,18,118,158,117,17,39,70
"2011","Hart 009E","E01022869","Total",607,153,71,82,454,11,114,107,113,16,24,69
"2011","Hart 010A","E01022852","Total",754,197,35,162,557,34,53,149,201,26,36,58
"2011","Hart 010B","E01022854","Total",648,113,45,68,535,27,81,158,137,22,38,72
"2011","Hart 010C","E01022855","Total",504,113,61,52,391,17,106,79,91,20,24,54
"2011","Hart 010D","E01022856","Total",591,123,72,51,468,10,122,92,118,19,32,75
"2011","Hart 010E","E01022857","Total",444,39,12,27,405,20,22,124,89,47,48,55
"2011","Hart 011B","E01022888","Total",739,202,102,100,537,17,145,109,149,18,26,73
"2011","Hart 011C","E01022889","Total",638,192,115,77,446,28,97,89,114,18,32,68
"2011","Hart 011D","E01032855","Total",440,96,40,56,344,16,60,75,96,18,15,64
"2011","Hart 011E","E01032856","Total",456,15,3,12,441,13,21,212,125,27,20,23
"2011","Havant 003A","E01022930","Total",753,203,140,63,550,15,187,64,142,9,18,115
"2011","Havant 003B","E01022931","Total",641,105,80,25,536,17,145,100,125,11,38,100
"2011","Havant 003C","E01022935","Total",650,177,119,58,473,16,160,72,101,18,35,71
"2011","Havant 003D","E01022975","Total",688,167,118,49,521,13,206,50,129,8,35,80
"2011","Havant 003E","E01022976","Total",689,293,118,175,396,26,89,60,96,14,42,69
"2011","Havant 004A","E01022922","Total",675,202,52,150,473,45,34,116,179,13,18,68
"2011","Havant 004B","E01022971","Total",722,267,112,155,455,21,117,68,129,6,34,80
"2011","Havant 004C","E01022972","Total",646,144,89,55,502,13,131,81,127,16,38,96
"2011","Havant 004D","E01022974","Total",597,121,56,65,476,20,122,73,127,13,29,92
"2011","Havant 005A","E01022959","Total",556,128,76,52,428,60,75,59,90,23,57,64
"2011","Havant 005B","E01022962","Total",608,152,85,67,456,24,93,92,116,15,27,89
"2011","Havant 005C","E01022965","Total",601,184,60,124,417,50,62,81,84,23,45,72
"2011","Havant 005D","E01022973","Total",867,346,221,125,521,43,114,82,115,41,38,88
"2011","Havant 006A","E01022901","Total",643,138,53,85,505,58,84,94,121,29,40,79
"2011","Havant 006B","E01022902","Total",575,108,45,63,467,43,69,98,99,26,50,82
"2011","Havant 006C","E01022966","Total",516,112,41,71,404,64,47,76,86,24,39,68
"2011","Havant 006D","E01022967","Total",513,178,76,102,335,73,39,54,66,28,17,58
"2011","Havant 007A","E01022960","Total",508,93,24,69,415,39,30,76,123,24,37,86
"2011","Havant 007B","E01022961","Total",492,72,22,50,420,32,45,99,105,22,38,79
"2011","Havant 007C","E01022963","Total",621,174,84,90,447,8,128,66,122,11,35,77
"2011","Havant 007D","E01022964","Total",653,278,130,148,375,58,44,64,105,17,23,64
"2011","Havant 008A","E01022903","Total",776,258,81,177,518,85,75,104,113,26,36,79
"2011","Havant 008B","E01022906","Total",570,127,65,62,443,68,46,88,114,20,46,61
"2011","Havant 008C","E01022968","Total",525,117,58,59,408,66,38,76,81,27,43,77
"2011","Havant 008D","E01022969","Total",607,124,42,82,483,78,51,99,83,23,50,99
"2011","Havant 009A","E01022913","Total",549,161,74,87,388,47,59,63,97,19,26,77
"2011","Havant 009B","E01022914","Total",543,186,63,123,357,38,70,54,70,18,35,72
"2011","Havant 009C","E01022915","Total",621,200,62,138,421,65,56,66,100,24,34,76
"2011","Havant 009D","E01022916","Total",639,159,60,99,480,56,73,110,111,20,36,74
"2011","Havant 009E","E01022917","Total",528,186,93,93,342,42,72,56,62,10,41,59
"2011","Havant 010A","E01022900","Total",747,190,84,106,557,60,107,89,118,36,33,114
"2011","Havant 010B","E01022904","Total",766,170,85,85,596,37,117,104,133,32,49,124
"2011","Havant 010C","E01022905","Total",823,305,120,185,518,114,80,91,118,27,27,61
"2011","Havant 010D","E01022908","Total",593,148,64,84,445,41,87,80,101,18,31,87
"2011","Havant 010E","E01022970","Total",692,139,62,77,553,96,59,103,118,37,46,94
"2011","Havant 011A","E01022947","Total",633,116,63,53,517,17,99,109,132,11,33,116
"2011","Havant 011B","E01022948","Total",687,213,99,114,474,30,97,93,105,12,40,97
"2011","Havant 011C","E01022949","Total",757,343,173,170,414,41,60,84,122,14,21,72
"2011","Havant 011D","E01022950","Total",584,116,79,37,468,5,138,86,113,13,34,79
"2011","Havant 011E","E01022951","Total",562,106,74,32,456,18,109,76,123,10,33,87
"2011","Havant 011F","E01022952","Total",629,155,74,81,474,24,132,58,135,11,35,79
"2011","Havant 013A","E01022924","Total",719,218,117,101,501,22,140,77,140,11,21,90
"2011","Havant 013B","E01022925","Total",594,149,102,47,445,22,128,76,108,18,27,66
"2011","Havant 013C","E01022926","Total",625,131,96,35,494,14,165,92,99,19,33,72
"2011","Havant 013D","E01022927","Total",719,238,161,77,481,29,146,75,113,10,26,82
"2011","Havant 013E","E01022928","Total",815,267,197,70,548,4,232,83,133,12,21,63
"2011","Havant 013F","E01022929","Total",857,397,223,174,460,20,162,57,141,13,14,53
"2011","Havant 014A","E01022953","Total",1030,453,199,254,577,65,117,92,193,14,28,68
"2011","Havant 014B","E01022954","Total",693,198,112,86,495,15,169,57,137,10,34,73
"2011","Havant 014C","E01022955","Total",615,213,140,73,402,10,128,64,95,6,24,75
"2011","Havant 014D","E01022956","Total",496,132,45,87,364,28,43,93,111,16,24,49
"2011","Havant 014E","E01022957","Total",522,141,75,66,381,14,84,85,90,10,40,58
"2011","Havant 014F","E01022958","Total",613,139,79,60,474,12,131,70,137,12,30,82
"2011","Havant 015A","E01022937","Total",585,168,95,73,417,19,97,64,94,13,34,96
"2011","Havant 015B","E01022943","Total",650,174,109,65,476,3,226,46,100,19,17,65
"2011","Havant 015C","E01022944","Total",536,106,56,50,430,6,121,50,137,7,30,79
"2011","Havant 015D","E01022946","Total",775,220,129,91,555,21,191,83,131,19,31,79
"2011","Havant 016A","E01022940","Total",729,230,127,103,499,35,152,70,128,11,20,83
"2011","Havant 016B","E01022942","Total",830,394,207,187,436,41,130,56,137,11,19,42
"2011","Havant 016C","E01022945","Total",1049,314,185,129,735,46,262,98,182,21,23,103
"2011","Havant 017A","E01022936","Total",776,278,116,162,498,42,163,50,171,4,14,54
"2011","Havant 017B","E01022938","Total",638,224,143,81,414,17,140,51,99,10,23,74
"2011","Havant 017C","E01022939","Total",697,206,119,87,491,23,160,50,127,11,35,85
"2011","Havant 017D","E01022941","Total",694,195,94,101,499,15,169,56,145,10,32,72
"2011","Havant 018A","E01022899","Total",503,94,44,50,409,37,66,66,83,19,37,101
"2011","Havant 018B","E01022907","Total",632,152,104,48,480,10,142,73,123,7,39,86
"2011","Havant 018C","E01022909","Total",628,120,79,41,508,16,125,72,146,12,43,94
"2011","Havant 018D","E01022910","Total",654,235,90,145,419,34,73,65,128,13,25,81
"2011","Havant 018E","E01022911","Total",638,169,89,80,469,13,140,63,114,20,34,85
"2011","Havant 018F","E01032605","Total",547,108,77,31,439,9,115,72,107,10,26,100
"2011","Havant 019A","E01022919","Total",644,138,70,68,506,29,112,77,135,19,46,88
"2011","Havant 019B","E01022933","Total",711,261,67,194,450,78,50,89,96,32,42,63
"2011","Havant 019C","E01022934","Total",798,257,63,194,541,92,55,117,119,35,37,86
"2011","Havant 019D","E01032618","Total",618,141,67,74,477,30,103,76,134,14,38,82
"2011","Havant 020A","E01022918","Total",667,197,130,67,470,19,131,75,118,11,30,86
"2011","Havant 020B","E01022920","Total",657,156,96,60,501,18,116,95,142,17,20,93
"2011","Havant 020C","E01022921","Total",651,152,78,74,499,21,128,90,117,15,32,96
"2011","Havant 020D","E01032617","Total",661,149,114,35,512,23,168,73,114,10,30,94
"2011","New Forest 001A","E01023011","Total",614,145,69,76,469,20,116,87,121,15,21,89
"2011","New Forest 001B","E01023012","Total",593,141,81,60,452,11,140,74,121,7,29,70
"2011","New Forest 001C","E01023021","Total",625,147,88,59,478,9,139,85,129,14,30,72
"2011","New Forest 001D","E01023022","Total",888,358,207,151,530,43,120,110,167,9,15,66
"2011","New Forest 001E","E01023023","Total",754,209,120,89,545,23,156,86,134,22,36,88
"2011","New Forest 001F","E01023024","Total",629,140,105,35,489,22,126,87,124,16,31,83
"2011","New Forest 001G","E01023025","Total",588,127,78,49,461,7,163,62,120,13,27,69
"2011","New Forest 002A","E01023076","Total",637,168,117,51,469,12,164,57,119,8,28,81
"2011","New Forest 002B","E01023082","Total",617,179,48,131,438,34,46,106,120,9,27,96
"2011","New Forest 002C","E01023083","Total",660,215,105,110,445,37,69,93,126,12,32,76
"2011","New Forest 002D","E01023088","Total",636,156,91,65,480,31,80,80,126,19,49,95
"2011","New Forest 003A","E01023073","Total",518,102,22,80,416,26,36,96,114,7,39,98
"2011","New Forest 003B","E01023080","Total",526,109,45,64,417,38,74,79,102,15,34,75
"2011","New Forest 003C","E01023081","Total",749,152,51,101,597,36,65,169,159,30,49,89
"2011","New Forest 003D","E01023089","Total",716,227,84,143,489,27,95,94,165,8,28,72
"2011","New Forest 003E","E01023090","Total",823,257,61,196,566,47,61,152,176,12,35,83
"2011","New Forest 004A","E01023074","Total",649,233,160,73,416,12,107,83,99,9,25,81
"2011","New Forest 004B","E01023077","Total",712,283,102,181,429,52,67,97,114,9,29,61
"2011","New Forest 004C","E01023078","Total",633,180,137,43,453,5,141,65,128,13,20,81
"2011","New Forest 004D","E01023079","Total",693,162,66,96,531,31,95,113,128,19,35,110
"2011","New Forest 004E","E01023085","Total",635,164,85,79,471,54,86,104,106,16,34,71
"2011","New Forest 005A","E01023072","Total",547,140,29,111,407,24,46,99,136,9,19,74
"2011","New Forest 005B","E01023075","Total",486,119,61,58,367,22,79,82,79,10,20,75
"2011","New Forest 005C","E01023084","Total",627,133,85,48,494,18,118,99,120,13,33,93
"2011","New Forest 005D","E01023086","Total",640,150,94,56,490,39,136,82,105,11,31,86
"2011","New Forest 005E","E01023087","Total",624,163,21,142,461,35,39,114,166,12,27,68
"2011","New Forest 006A","E01022977","Total",609,135,81,54,474,5,143,79,123,15,36,73
"2011","New Forest 006B","E01022978","Total",633,136,72,64,497,16,150,75,119,8,30,99
"2011","New Forest 006C","E01022979","Total",498,112,62,50,386,9,130,50,102,4,15,76
"2011","New Forest 006D","E01022980","Total",549,116,74,42,433,6,121,62,107,13,28,96
"2011","New Forest 007A","E01022992","Total",484,111,59,52,373,4,103,55,107,3,24,77
"2011","New Forest 007B","E01022993","Total",564,149,70,79,415,10,115,66,127,12,20,65
"2011","New Forest 007C","E01023045","Total",716,233,129,104,483,14,150,87,130,14,27,61
"2011","New Forest 007D","E01023046","Total",658,238,117,121,420,23,115,56,118,19,17,72
"2011","New Forest 008A","E01023007","Total",507,158,78,80,349,10,101,49,94,12,24,59
"2011","New Forest 008B","E01023010","Total",655,200,39,161,455,54,59,111,115,22,32,62
"2011","New Forest 008C","E01023047","Total",546,125,35,90,421,23,60,93,130,12,30,73
"2011","New Forest 008D","E01023048","Total",525,90,45,45,435,18,85,78,121,19,30,84
"2011","New Forest 008E","E01023049","Total",682,187,27,160,495,39,45,136,194,11,27,43
"2011","New Forest 008F","E01023050","Total",693,140,30,110,553,42,65,169,151,17,35,74
"2011","New Forest 009A","E01023008","Total",859,393,237,156,466,20,216,48,118,6,17,41
"2011","New Forest 009B","E01023009","Total",648,169,49,120,479,31,70,101,166,14,26,71
"2011","New Forest 009C","E01023038","Total",634,136,89,47,498,13,164,82,128,10,20,81
"2011","New Forest 009D","E01023039","Total",666,205,117,88,461,31,143,67,119,11,29,61
"2011","New Forest 009E","E01023040","Total",673,182,122,60,491,16,179,76,123,12,17,68
"2011","New Forest 010A","E01023026","Total",476,128,75,53,348,13,82,52,111,8,25,57
"2011","New Forest 010B","E01023062","Total",564,96,51,45,468,15,106,95,108,16,38,90
"2011","New Forest 010C","E01023064","Total",536,112,52,60,424,36,82,86,99,11,39,71
"2011","New Forest 010D","E01023066","Total",695,175,111,64,520,14,172,86,115,19,41,73
"2011","New Forest 010E","E01023067","Total",616,138,81,57,478,13,141,104,120,17,27,56
"2011","New Forest 011A","E01023003","Total",779,220,165,55,559,23,182,71,132,9,33,109
"2011","New Forest 011B","E01023004","Total",709,128,77,51,581,28,139,107,131,19,45,112
"2011","New Forest 011C","E01023005","Total",627,145,93,52,482,10,138,70,130,16,26,92
"2011","New Forest 011D","E01023006","Total",501,86,39,47,415,53,58,67,89,20,53,75
"2011","New Forest 011E","E01023028","Total",859,214,118,96,645,52,139,149,150,25,42,88
"2011","New Forest 011F","E01023037","Total",931,385,207,178,546,49,133,78,160,20,34,72
"2011","New Forest 012A","E01023065","Total",680,174,103,71,506,21,153,84,101,21,40,86
"2011","New Forest 012B","E01023068","Total",525,118,55,63,407,29,104,71,82,20,30,71
"2011","New Forest 012C","E01023069","Total",669,190,118,72,479,29,118,76,127,15,37,77
"2011","New Forest 012D","E01023070","Total",925,448,259,189,477,56,108,85,156,10,17,45
"2011","New Forest 012E","E01023071","Total",646,233,70,163,413,26,80,80,138,12,24,53
"2011","New Forest 013A","E01023029","Total",621,143,69,74,478,93,47,91,87,32,46,82
"2011","New Forest 013B","E01023030","Total",507,100,39,61,407,21,61,93,112,13,36,71
"2011","New Forest 013C","E01023032","Total",549,133,76,57,416,11,114,72,111,9,24,75
"2011","New Forest 013D","E01023033","Total",524,128,75,53,396,34,92,62,94,20,31,63
"2011","New Forest 014A","E01023013","Total",650,175,84,91,475,30,137,65,133,12,23,75
"2011","New Forest 014B","E01023014","Total",720,169,105,64,551,36,166,73,137,15,31,93
"2011","New Forest 014C","E01023015","Total",599,144,73,71,455,28,112,70,121,16,29,79
"2011","New Forest 014D","E01023016","Total",614,149,95,54,465,2,145,65,142,12,25,74
"2011","New Forest 014E","E01023027","Total",592,145,68,77,447,25,100,73,114,22,27,86
"2011","New Forest 014F","E01023031","Total",548,144,67,77,404,24,102,53,113,6,23,83
"2011","New Forest 015A","E01022989","Total",719,195,109,86,524,20,154,96,107,15,47,85
"2011","New Forest 015B","E01022991","Total",891,230,139,91,661,14,233,75,172,20,39,108
"2011","New Forest 015C","E01022998","Total",680,121,84,37,559,8,218,65,129,23,40,76
"2011","New Forest 015D","E01023000","Total",791,267,177,90,524,24,158,87,130,24,30,71
"2011","New Forest 016A","E01022994","Total",670,154,97,57,516,13,162,78,137,21,33,72
"2011","New Forest 016B","E01022995","Total",589,130,69,61,459,15,123,81,121,13,29,77
"2011","New Forest 016C","E01022996","Total",515,122,68,54,393,12,116,60,106,13,24,62
"2011","New Forest 016D","E01022997","Total",585,170,94,76,415,15,123,72,101,11,17,76
"2011","New Forest 016E","E01023063","Total",466,88,47,41,378,10,83,74,77,22,35,77
"2011","New Forest 017A","E01022990","Total",651,171,97,74,480,24,151,70,112,18,30,75
"2011","New Forest 017B","E01022999","Total",906,228,116,112,678,18,198,92,198,28,35,109
"2011","New Forest 017C","E01023041","Total",743,251,149,102,492,18,192,60,127,12,20,63
"2011","New Forest 017D","E01023042","Total",893,509,290,219,384,29,141,47,116,3,6,42
"2011","New Forest 017E","E01023043","Total",835,301,188,113,534,38,142,91,148,18,20,77
"2011","New Forest 018A","E01022984","Total",654,158,119,39,496,5,214,59,95,7,23,93
"2011","New Forest 018B","E01022985","Total",528,117,66,51,411,23,103,79,119,5,23,59
"2011","New Forest 018C","E01023020","Total",624,138,96,42,486,15,192,69,102,12,24,72
"2011","New Forest 018D","E01023034","Total",785,229,145,84,556,29,191,80,141,16,30,69
"2011","New Forest 018E","E01023035","Total",732,164,110,54,568,27,169,102,127,15,36,92
"2011","New Forest 018F","E01023036","Total",936,268,206,62,668,15,302,75,145,17,34,80
"2011","New Forest 019A","E01023001","Total",861,326,121,205,535,43,111,124,166,6,17,68
"2011","New Forest 019B","E01023002","Total",777,255,128,127,522,56,111,102,134,24,25,70
"2011","New Forest 019C","E01023058","Total",645,218,112,106,427,62,76,80,85,20,38,66
"2011","New Forest 019D","E01023060","Total",590,146,95,51,444,18,120,75,104,14,25,88
"2011","New Forest 019E","E01023061","Total",667,232,123,109,435,30,104,69,109,21,30,72
"2011","New Forest 020A","E01023017","Total",810,203,123,80,607,54,162,104,123,24,50,90
"2011","New Forest 020B","E01023018","Total",679,265,150,115,414,47,118,64,94,14,13,64
"2011","New Forest 020C","E01023019","Total",668,251,105,146,417,48,54,97,117,10,29,62
"2011","New Forest 020D","E01023055","Total",511,150,76,74,361,50,60,63,63,19,36,70
"2011","New Forest 021A","E01022986","Total",642,194,140,54,448,20,160,48,100,5,29,86
"2011","New Forest 021B","E01022988","Total",676,241,106,135,435,42,84,72,128,11,21,77
"2011","New Forest 021C","E01023054","Total",849,329,216,113,520,28,213,56,91,12,29,91
"2011","New Forest 021D","E01023056","Total",811,362,281,81,449,39,196,73,83,10,10,38
"2011","New Forest 021E","E01023057","Total",903,428,267,161,475,24,189,51,113,10,30,58
"2011","New Forest 022A","E01022981","Total",909,249,195,54,660,13,329,59,137,9,25,88
"2011","New Forest 022B","E01022982","Total",935,329,233,96,606,16,280,54,166,5,13,72
"2011","New Forest 022C","E01022983","Total",808,257,180,77,551,14,270,46,118,10,30,63
"2011","New Forest 022D","E01022987","Total",909,266,196,70,643,14,331,57,147,11,18,65
"2011","New Forest 023A","E01023044","Total",535,171,125,46,364,3,204,33,76,4,18,26
"2011","New Forest 023B","E01023051","Total",658,175,113,62,483,9,186,78,92,9,29,80
"2011","New Forest 023C","E01023052","Total",890,374,281,93,516,11,260,39,117,6,17,66
"2011","New Forest 023D","E01023053","Total",859,320,239,81,539,14,260,47,141,11,16,50
"2011","New Forest 023E","E01023059","Total",774,264,183,81,510,19,201,65,111,13,35,66
"2011","Rushmoor 001A","E01023099","Total",609,134,71,63,475,43,84,95,97,24,42,90
"2011","Rushmoor 001B","E01023104","Total",601,123,63,60,478,30,76,79,109,22,79,83
"2011","Rushmoor 001C","E01023106","Total",567,157,57,100,410,45,56,74,96,14,51,74
"2011","Rushmoor 001D","E01023121","Total",770,167,90,77,603,39,102,114,144,22,65,117
"2011","Rushmoor 002A","E01023105","Total",602,184,89,95,418,35,48,85,83,14,49,104
"2011","Rushmoor 002B","E01023119","Total",466,130,24,106,336,46,26,67,65,21,49,62
"2011","Rushmoor 002C","E01023120","Total",608,142,58,84,466,37,50,81,99,23,87,89
"2011","Rushmoor 002D","E01023122","Total",500,84,29,55,416,36,37,76,78,17,64,108
"2011","Rushmoor 002E","E01023146","Total",472,86,28,58,386,30,35,66,84,20,57,94
"2011","Rushmoor 003A","E01023100","Total",484,116,17,99,368,33,27,94,108,19,34,53
"2011","Rushmoor 003B","E01023101","Total",487,73,35,38,414,14,87,64,107,12,34,96
"2011","Rushmoor 003C","E01023102","Total",541,113,50,63,428,13,65,92,125,11,31,91
"2011","Rushmoor 003D","E01023134","Total",703,153,38,115,550,24,59,105,192,26,52,92
"2011","Rushmoor 003E","E01023147","Total",565,111,60,51,454,19,88,87,100,15,45,100
"2011","Rushmoor 004A","E01023096","Total",910,263,99,164,647,38,128,134,185,16,47,99
"2011","Rushmoor 004B","E01023097","Total",570,114,68,46,456,9,106,76,130,11,41,83
"2011","Rushmoor 004C","E01023103","Total",631,135,58,77,496,14,80,116,139,12,39,96
"2011","Rushmoor 004D","E01023111","Total",756,238,114,124,518,18,106,107,132,13,40,102
"2011","Rushmoor 004E","E01023112","Total",467,80,33,47,387,16,35,113,98,14,27,84
"2011","Rushmoor 005A","E01023092","Total",569,118,21,97,451,19,37,143,137,17,24,74
"2011","Rushmoor 005B","E01023093","Total",524,80,22,58,444,13,61,120,126,7,19,98
"2011","Rushmoor 005C","E01023132","Total",614,148,85,63,466,14,78,100,123,19,41,91
"2011","Rushmoor 005D","E01023133","Total",525,102,21,81,423,21,38,114,149,11,34,56
"2011","Rushmoor 005E","E01023135","Total",945,218,77,141,727,60,99,187,205,34,52,90
"2011","Rushmoor 006A","E01023091","Total",670,192,72,120,478,59,42,121,101,23,49,83
"2011","Rushmoor 006B","E01023094","Total",558,137,40,97,421,14,91,71,137,17,26,65
"2011","Rushmoor 006C","E01023095","Total",743,233,94,139,510,31,61,133,156,14,36,79
"2011","Rushmoor 006D","E01023098","Total",669,185,78,107,484,25,76,92,155,12,31,93
"2011","Rushmoor 006E","E01023148","Total",602,183,67,116,419,14,92,76,113,6,30,88
"2011","Rushmoor 006F","E01023149","Total",543,135,79,56,408,6,124,71,92,10,28,77
"2011","Rushmoor 007A","E01023113","Total",668,214,71,143,454,36,73,86,136,11,27,85
"2011","Rushmoor 007B","E01023114","Total",547,115,21,94,432,17,46,136,120,22,25,66
"2011","Rushmoor 007C","E01023136","Total",657,158,35,123,499,15,38,141,143,31,43,88
"2011","Rushmoor 007D","E01023137","Total",520,116,39,77,404,30,40,101,130,8,29,66
"2011","Rushmoor 007E","E01023138","Total",654,290,96,194,364,30,42,75,135,10,18,54
"2011","Rushmoor 007F","E01023139","Total",531,183,84,99,348,23,49,85,98,15,31,47
"2011","Rushmoor 007G","E01023140","Total",603,143,50,93,460,21,10,181,145,33,34,36
"2011","Rushmoor 008A","E01023141","Total",630,75,1,74,555,38,2,278,147,31,30,29
"2011","Rushmoor 008B","E01023142","Total",853,293,15,278,560,39,36,182,200,10,37,56
"2011","Rushmoor 008C","E01023143","Total",699,172,44,128,527,25,12,223,127,56,52,32
"2011","Rushmoor 008D","E01023144","Total",674,213,64,149,461,29,31,107,127,12,69,86
"2011","Rushmoor 009A","E01023118","Total",675,189,64,125,486,30,42,108,128,15,54,109
"2011","Rushmoor 009B","E01023124","Total",486,108,33,75,378,16,39,83,118,9,39,74
"2011","Rushmoor 009C","E01023125","Total",920,169,38,131,751,48,86,189,226,33,47,122
"2011","Rushmoor 009F","E01032858","Total",864,242,60,182,622,91,58,143,156,24,46,104
"2011","Rushmoor 010A","E01023128","Total",607,221,104,117,386,18,56,81,115,19,28,69
"2011","Rushmoor 010B","E01023129","Total",531,170,42,128,361,24,39,61,112,4,48,73
"2011","Rushmoor 010C","E01023130","Total",549,113,66,47,436,19,89,74,116,9,30,99
"2011","Rushmoor 010D","E01023131","Total",585,196,123,73,389,13,93,66,106,12,33,66
"2011","Rushmoor 010E","E01023145","Total",938,402,103,299,536,35,39,116,199,10,54,83
"2011","Rushmoor 011A","E01023109","Total",592,124,51,73,468,28,63,95,136,10,30,106
"2011","Rushmoor 011B","E01023115","Total",464,73,36,37,391,11,58,88,91,14,44,85
"2011","Rushmoor 011C","E01023116","Total",665,134,28,106,531,27,54,95,156,15,60,124
"2011","Rushmoor 011D","E01023117","Total",674,123,46,77,551,14,86,111,150,27,39,124
"2011","Rushmoor 012A","E01023107","Total",611,210,124,86,401,27,68,80,95,16,36,79
"2011","Rushmoor 012B","E01023108","Total",592,206,108,98,386,27,88,67,90,19,31,64
"2011","Rushmoor 012C","E01023110","Total",705,176,77,99,529,49,73,109,125,21,44,108
"2011","Rushmoor 012D","E01023123","Total",579,129,50,79,450,20,69,95,139,11,47,69
"2011","Test Valley 001A","E01023165","Total",867,190,87,103,677,20,166,122,201,43,41,84
"2011","Test Valley 001B","E01023169","Total",839,213,120,93,626,11,156,110,195,10,38,106
"2011","Test Valley 001C","E01023181","Total",513,71,12,59,442,23,40,129,130,12,40,68
"2011","Test Valley 001D","E01023182","Total",642,143,36,107,499,33,44,139,172,15,18,78
"2011","Test Valley 002A","E01023153","Total",742,243,45,198,499,70,53,93,169,18,31,65
"2011","Test Valley 002B","E01023154","Total",636,126,44,82,510,52,69,123,118,28,30,90
"2011","Test Valley 002C","E01023156","Total",470,69,16,53,401,58,30,91,68,41,42,71
"2011","Test Valley 002D","E01023157","Total",534,112,46,66,422,57,54,87,96,20,38,70
"2011","Test Valley 002E","E01023205","Total",455,66,24,42,389,48,36,88,73,28,45,71
"2011","Test Valley 003A","E01023155","Total",1086,267,65,202,819,57,104,184,240,44,64,126
"2011","Test Valley 003B","E01023201","Total",625,141,83,58,484,40,90,68,124,21,48,93
"2011","Test Valley 003C","E01023202","Total",971,500,214,286,471,51,79,75,189,9,16,52
"2011","Test Valley 003D","E01023215","Total",669,191,110,81,478,25,109,94,120,12,26,92
"2011","Test Valley 003E","E01023219","Total",617,178,74,104,439,30,105,67,122,8,33,74
"2011","Test Valley 004A","E01023179","Total",706,156,67,89,550,58,69,106,142,21,54,100
"2011","Test Valley 004B","E01023183","Total",583,153,67,86,430,38,72,92,108,17,31,72
"2011","Test Valley 004C","E01023190","Total",561,186,104,82,375,14,93,56,128,10,20,54
"2011","Test Valley 004D","E01023203","Total",668,189,80,109,479,20,106,68,147,7,51,80
"2011","Test Valley 004E","E01023204","Total",741,209,84,125,532,62,71,94,189,28,20,68
"2011","Test Valley 005B","E01023180","Total",701,162,101,61,539,27,132,94,157,26,28,75
"2011","Test Valley 005C","E01023186","Total",721,189,73,116,532,40,103,114,152,20,29,74
"2011","Test Valley 005D","E01023189","Total",609,111,52,59,498,18,80,114,136,23,42,85
"2011","Test Valley 005E","E01023196","Total",692,162,81,81,530,12,131,110,148,25,29,75
"2011","Test Valley 005F","E01032870","Total",732,142,56,86,590,19,106,141,156,29,60,79
"2011","Test Valley 005G","E01032871","Total",637,165,90,75,472,25,112,84,119,21,32,79
"2011","Test Valley 006A","E01023187","Total",632,161,74,87,471,16,84,84,172,18,26,71
"2011","Test Valley 006B","E01023188","Total",515,111,48,63,404,13,57,97,105,18,32,82
"2011","Test Valley 006C","E01023216","Total",847,317,114,203,530,43,91,98,177,15,28,78
"2011","Test Valley 006D","E01023217","Total",670,184,95,89,486,18,108,88,137,12,43,80
"2011","Test Valley 006E","E01023218","Total",627,127,73,54,500,15,129,96,139,15,33,73
"2011","Test Valley 007A","E01023159","Total",931,218,103,115,713,22,205,107,203,31,40,105
"2011","Test Valley 007B","E01023195","Total",722,103,34,69,619,11,84,186,188,42,38,70
"2011","Test Valley 007C","E01023197","Total",584,105,46,59,479,23,69,130,140,22,19,76
"2011","Test Valley 007D","E01023198","Total",619,151,83,68,468,13,125,76,151,18,24,61
"2011","Test Valley 008A","E01023160","Total",600,135,87,48,465,8,129,74,130,18,27,79
"2011","Test Valley 008B","E01023168","Total",644,166,90,76,478,4,137,71,151,7,25,83
"2011","Test Valley 008C","E01023178","Total",917,194,91,103,723,22,169,135,215,40,41,101
"2011","Test Valley 009A","E01023166","Total",646,177,95,82,469,26,105,75,145,21,22,75
"2011","Test Valley 009B","E01023167","Total",697,195,135,60,502,18,168,67,133,21,30,65
"2011","Test Valley 009C","E01023177","Total",883,190,94,96,693,27,162,121,195,35,44,109
"2011","Test Valley 009D","E01023184","Total",516,75,38,37,441,10,91,85,126,18,41,70
"2011","Test Valley 009E","E01023185","Total",513,123,67,56,390,20,108,73,93,17,27,52
"2011","Test Valley 010A","E01023174","Total",721,183,64,119,538,23,89,113,162,19,40,92
"2011","Test Valley 010B","E01023175","Total",701,170,73,97,531,20,165,102,133,12,32,67
"2011","Test Valley 010C","E01023176","Total",719,256,126,130,463,28,114,63,147,10,28,73
"2011","Test Valley 010D","E01023207","Total",645,140,80,60,505,14,153,98,122,10,31,77
"2011","Test Valley 010E","E01023208","Total",484,125,56,69,359,26,79,66,89,11,24,64
"2011","Test Valley 010F","E01023209","Total",544,111,50,61,433,11,87,84,121,15,31,84
"2011","Test Valley 011A","E01023150","Total",727,293,151,142,434,41,85,68,118,8,26,88
"2011","Test Valley 011B","E01023151","Total",782,387,265,122,395,45,106,67,97,11,14,55
"2011","Test Valley 011C","E01023152","Total",858,380,257,123,478,16,183,54,129,7,25,64
"2011","Test Valley 011D","E01023206","Total",497,153,95,58,344,16,94,52,77,11,37,57
"2011","Test Valley 012A","E01023158","Total",916,192,111,81,724,15,215,129,155,27,50,133
"2011","Test Valley 012B","E01023191","Total",778,203,79,124,575,28,96,114,202,25,34,76
"2011","Test Valley 012C","E01023192","Total",822,280,160,120,542,60,121,119,127,19,31,65
"2011","Test Valley 012D","E01023193","Total",660,139,96,43,521,16,154,79,121,14,31,106
"2011","Test Valley 012E","E01023194","Total",642,113,84,29,529,15,177,65,119,13,36,104
"2011","Test Valley 012F","E01023200","Total",598,127,53,74,471,18,79,96,160,11,26,81
"2011","Test Valley 013A","E01023162","Total",669,131,72,59,538,13,155,92,122,19,40,97
"2011","Test Valley 013B","E01023163","Total",663,118,62,56,545,9,161,86,137,18,35,99
"2011","Test Valley 013C","E01023164","Total",654,171,97,74,483,16,135,76,122,12,34,88
"2011","Test Valley 013D","E01023199","Total",634,162,64,98,472,17,97,82,121,17,37,101
"2011","Test Valley 014A","E01023210","Total",532,55,15,40,477,12,58,137,115,30,44,81
"2011","Test Valley 014B","E01023211","Total",679,100,15,85,579,49,26,215,165,30,39,55
"2011","Test Valley 014C","E01023212","Total",592,124,55,69,468,10,76,94,137,20,42,89
"2011","Test Valley 014D","E01023213","Total",498,77,34,43,421,15,50,124,106,19,24,83
"2011","Test Valley 014E","E01023214","Total",530,108,36,72,422,15,60,112,124,7,28,76
"2011","Test Valley 015A","E01023170","Total",703,154,66,88,549,46,99,111,145,12,45,91
"2011","Test Valley 015B","E01023171","Total",595,105,52,53,490,5,124,66,131,14,48,102
"2011","Test Valley 015C","E01023172","Total",615,124,78,46,491,6,125,70,138,17,33,102
"2011","Test Valley 015D","E01023173","Total",588,108,58,50,480,6,109,67,145,13,40,100
"2011","Winchester 001A","E01023286","Total",591,153,82,71,438,19,91,95,120,17,29,67
"2011","Winchester 001B","E01023287","Total",1068,148,86,62,920,19,181,223,267,35,47,148
"2011","Winchester 001C","E01023288","Total",577,129,51,78,448,15,76,104,164,21,11,57
"2011","Winchester 002A","E01023236","Total",804,203,95,108,601,15,176,107,162,31,39,71
"2011","Winchester 002B","E01023237","Total",563,182,89,93,381,40,63,72,117,12,21,56
"2011","Winchester 002C","E01023238","Total",587,127,66,61,460,17,91,102,135,18,25,72
"2011","Winchester 002D","E01023239","Total",654,145,62,83,509,13,106,112,148,21,33,76
"2011","Winchester 003A","E01023240","Total",879,196,132,64,683,18,214,143,117,33,41,117
"2011","Winchester 003B","E01023241","Total",518,111,65,46,407,5,141,66,103,5,32,55
"2011","Winchester 003C","E01023248","Total",685,148,110,38,537,7,167,95,111,32,37,88
"2011","Winchester 003D","E01023253","Total",709,239,139,100,470,18,140,110,116,16,16,54
"2011","Winchester 003E","E01023274","Total",626,153,97,56,473,12,133,91,103,25,25,84
"2011","Winchester 004A","E01023225","Total",830,149,87,62,681,19,155,132,181,50,51,93
"2011","Winchester 004B","E01023278","Total",727,236,151,85,491,21,119,103,124,17,33,74
"2011","Winchester 004C","E01023279","Total",613,136,76,60,477,17,131,100,118,11,26,74
"2011","Winchester 004D","E01023280","Total",588,117,68,49,471,12,113,99,116,22,32,77
"2011","Winchester 004E","E01023281","Total",833,301,197,104,532,21,190,93,121,18,25,64
"2011","Winchester 005A","E01023247","Total",631,176,120,56,455,12,121,76,120,27,23,76
"2011","Winchester 005B","E01023249","Total",524,173,104,69,351,7,88,63,79,16,33,65
"2011","Winchester 005C","E01023250","Total",681,201,121,80,480,39,86,82,124,30,40,79
"2011","Winchester 005D","E01023268","Total",485,105,38,67,380,11,62,102,94,25,31,55
"2011","Winchester 005E","E01023269","Total",651,152,49,103,499,23,82,110,127,21,29,107
"2011","Winchester 005F","E01023270","Total",456,103,53,50,353,20,52,81,93,27,28,52
"2011","Winchester 006A","E01023251","Total",635,331,227,104,304,22,58,46,111,3,9,55
"2011","Winchester 006B","E01023255","Total",700,269,89,180,431,31,64,94,134,9,20,79
"2011","Winchester 006C","E01023256","Total",620,220,78,142,400,52,62,63,101,18,26,78
"2011","Winchester 006D","E01023257","Total",688,229,86,143,459,41,81,83,133,9,27,85
"2011","Winchester 006E","E01023258","Total",524,148,52,96,376,20,52,68,105,25,24,82
"2011","Winchester 007A","E01023252","Total",961,507,151,356,454,24,57,65,204,7,24,73
"2011","Winchester 007B","E01023254","Total",831,315,134,181,516,40,70,126,171,32,18,59
"2011","Winchester 007C","E01023263","Total",596,227,96,131,369,12,93,63,109,13,16,63
"2011","Winchester 007D","E01023264","Total",680,320,147,173,360,9,62,85,129,9,6,60
"2011","Winchester 007E","E01023265","Total",816,325,163,162,491,14,95,99,153,30,26,74
"2011","Winchester 007F","E01023267","Total",534,179,44,135,355,10,45,92,122,12,14,60
"2011","Winchester 008A","E01023260","Total",493,145,65,80,348,36,30,65,63,18,29,107
"2011","Winchester 008B","E01023261","Total",616,204,95,109,412,28,57,59,77,13,31,147
"2011","Winchester 008C","E01023262","Total",499,81,45,36,418,31,54,50,68,14,33,168
"2011","Winchester 008D","E01023266","Total",569,169,72,97,400,19,86,74,87,26,27,81
"2011","Winchester 009A","E01023229","Total",776,172,97,75,604,7,153,135,133,41,50,85
"2011","Winchester 009B","E01023242","Total",491,120,37,83,371,3,51,88,125,14,24,66
"2011","Winchester 009C","E01023243","Total",617,224,51,173,393,19,30,91,176,10,14,53
"2011","Winchester 009D","E01023244","Total",655,149,107,42,506,7,182,77,110,11,40,79
"2011","Winchester 009E","E01023259","Total",553,117,72,45,436,18,88,82,80,19,37,112
"2011","Winchester 010A","E01023226","Total",638,161,87,74,477,14,117,113,108,26,28,71
"2011","Winchester 010B","E01023227","Total",796,222,105,117,574,31,120,124,166,20,29,84
"2011","Winchester 010C","E01023228","Total",869,242,126,116,627,16,163,123,159,30,43,93
"2011","Winchester 010D","E01023230","Total",807,184,67,117,623,11,136,142,164,27,40,103
"2011","Winchester 010E","E01023246","Total",575,120,58,62,455,11,90,78,132,20,43,81
"2011","Winchester 011A","E01023235","Total",841,184,111,73,657,12,181,129,184,27,26,98
"2011","Winchester 011B","E01023275","Total",580,129,89,40,451,15,108,82,119,16,44,67
"2011","Winchester 011C","E01023276","Total",585,84,42,42,501,14,119,102,121,18,50,77
"2011","Winchester 011D","E01023277","Total",494,85,47,38,409,5,96,69,116,9,32,82
"2011","Winchester 011E","E01023282","Total",814,228,116,112,586,18,159,105,163,27,41,73
"2011","Winchester 012A","E01023220","Total",838,225,80,145,613,29,105,149,179,19,44,88
"2011","Winchester 012B","E01023221","Total",819,316,206,110,503,30,124,79,151,19,30,70
"2011","Winchester 012C","E01023222","Total",631,160,75,85,471,8,124,78,138,18,29,76
"2011","Winchester 012D","E01023223","Total",599,149,88,61,450,26,91,91,116,19,32,75
"2011","Winchester 012E","E01023272","Total",520,117,54,63,403,18,85,80,120,16,23,61
"2011","Winchester 012F","E01023273","Total",579,123,61,62,456,13,110,92,102,22,32,85
"2011","Winchester 013A","E01023245","Total",917,184,93,91,733,19,181,126,204,31,53,119
"2011","Winchester 013B","E01023271","Total",454,97,61,36,357,9,89,66,88,17,22,66
"2011","Winchester 013D","E01023284","Total",1170,358,89,269,812,51,130,169,288,34,47,93
"2011","Winchester 013E","E01023285","Total",696,232,148,84,464,19,139,84,111,21,19,71
"2011","Winchester 013F","E01032859","Total",645,98,14,84,547,36,42,187,155,26,29,72
"2011","Winchester 013G","E01032860","Total",635,176,12,164,459,41,23,130,192,17,16,40
"2011","Winchester 014A","E01023224","Total",502,88,52,36,414,16,85,98,110,11,32,62
"2011","Winchester 014B","E01023231","Total",695,112,60,52,583,11,144,115,164,24,36,89
"2011","Winchester 014C","E01023232","Total",737,142,71,71,595,12,139,99,157,28,51,109
"2011","Winchester 014D","E01023233","Total",630,194,123,71,436,9,98,118,106,13,37,55
"2011","Winchester 014E","E01023234","Total",665,193,116,77,472,24,97,107,118,18,35,73
"2011","Ashford 001B","E01023987","Total",453,134,77,57,319,9,81,56,87,18,18,50
"2011","Ashford 001C","E01023988","Total",558,124,52,72,434,8,110,77,107,21,38,73
"2011","Ashford 001D","E01024040","Total",548,209,123,86,339,21,103,69,76,11,14,45
"2011","Ashford 001E","E01024041","Total",507,174,107,67,333,11,98,63,85,15,24,37
"2011","Ashford 001F","E01032810","Total",596,135,32,103,461,57,48,127,123,27,19,60
"2011","Ashford 001G","E01032812","Total",669,119,51,68,550,26,94,145,151,16,57,61
"2011","Ashford 002A","E01023985","Total",508,160,101,59,348,10,128,42,84,8,25,51
"2011","Ashford 002B","E01023986","Total",563,185,104,81,378,14,90,68,116,12,17,61
"2011","Ashford 002C","E01023989","Total",454,84,51,33,370,7,96,67,89,17,33,61
"2011","Ashford 002D","E01023990","Total",504,114,64,50,390,21,98,66,113,13,24,55
"2011","Ashford 002E","E01024033","Total",679,130,75,55,549,14,119,110,154,21,30,101
"2011","Ashford 002F","E01024035","Total",453,111,67,44,342,6,100,61,84,14,28,49
"2011","Ashford 003A","E01023983","Total",606,173,114,59,433,13,132,72,107,13,21,75
"2011","Ashford 003B","E01023999","Total",904,192,116,76,712,23,201,113,206,25,51,93
"2011","Ashford 003D","E01032811","Total",596,106,17,89,490,53,41,139,123,34,36,64
"2011","Ashford 003E","E01032822","Total",563,135,93,42,428,15,97,86,81,17,47,85
"2011","Ashford 004A","E01023980","Total",516,158,77,81,358,23,95,68,86,10,14,62
"2011","Ashford 004B","E01023981","Total",507,144,68,76,363,27,83,54,84,18,34,63
"2011","Ashford 004C","E01023984","Total",493,135,49,86,358,56,53,70,84,17,21,57
"2011","Ashford 004E","E01023992","Total",624,184,84,100,440,47,67,84,120,11,34,77
"2011","Ashford 004F","E01023993","Total",528,97,34,63,431,21,41,116,110,23,39,81
"2011","Ashford 004G","E01024021","Total",614,254,81,173,360,36,47,67,123,11,24,52
"2011","Ashford 004H","E01024022","Total",610,173,101,72,437,28,120,74,99,12,32,72
"2011","Ashford 004I","E01032820","Total",625,134,20,114,491,43,56,148,149,19,19,57
"2011","Ashford 004J","E01032821","Total",619,116,56,60,503,27,50,145,131,27,52,71
"2011","Ashford 005A","E01023973","Total",712,257,88,169,455,82,64,97,112,16,23,61
"2011","Ashford 005B","E01024002","Total",566,140,43,97,426,50,38,101,113,18,35,71
"2011","Ashford 005C","E01024023","Total",994,281,111,170,713,77,81,174,179,44,52,106
"2011","Ashford 005D","E01024027","Total",713,293,90,203,420,45,46,79,129,14,28,79
"2011","Ashford 005E","E01024029","Total",937,258,116,142,679,60,116,134,145,33,55,136
"2011","Ashford 006A","E01023972","Total",508,138,65,73,370,27,58,76,84,16,39,70
"2011","Ashford 006B","E01023995","Total",479,105,44,61,374,8,79,69,96,12,28,82
"2011","Ashford 006C","E01023996","Total",481,77,29,48,404,28,41,99,105,16,40,75
"2011","Ashford 006D","E01024003","Total",757,208,120,88,549,30,146,72,156,11,37,97
"2011","Ashford 006E","E01024004","Total",705,173,68,105,532,16,118,94,146,22,43,93
"2011","Ashford 006F","E01024005","Total",645,191,85,106,454,33,73,91,127,20,33,77
"2011","Ashford 007A","E01023974","Total",520,134,69,65,386,49,69,57,80,15,42,74
"2011","Ashford 007B","E01023975","Total",614,142,77,65,472,46,89,77,84,30,48,98
"2011","Ashford 007C","E01023977","Total",530,160,52,108,370,30,57,68,136,6,25,48
"2011","Ashford 007D","E01024016","Total",655,254,53,201,401,44,49,88,141,10,16,53
"2011","Ashford 007E","E01024017","Total",779,247,89,158,532,45,79,122,183,14,30,59
"2011","Ashford 007F","E01024028","Total",697,199,65,134,498,94,47,97,113,23,46,78
"2011","Ashford 008A","E01023976","Total",672,227,125,102,445,32,93,81,85,24,46,84
"2011","Ashford 008B","E01024019","Total",484,93,18,75,391,58,38,62,68,32,57,76
"2011","Ashford 008C","E01024020","Total",634,112,32,80,522,105,30,113,84,58,64,68
"2011","Ashford 008E","E01032816","Total",672,122,26,96,550,27,45,152,178,20,47,81
"2011","Ashford 008F","E01032823","Total",607,120,37,83,487,43,57,110,103,25,49,100
"2011","Ashford 009A","E01024001","Total",650,200,85,115,450,53,72,85,120,17,29,74
"2011","Ashford 009B","E01024006","Total",445,57,20,37,388,21,40,121,88,20,47,51
"2011","Ashford 009D","E01024008","Total",720,100,23,77,620,54,51,186,156,34,55,84
"2011","Ashford 009F","E01032815","Total",420,128,28,100,292,49,26,67,72,26,17,35
"2011","Ashford 009G","E01032817","Total",449,92,9,83,357,47,21,93,93,16,32,55
"2011","Ashford 009H","E01032818","Total",553,84,14,70,469,51,29,147,121,36,37,48
"2011","Ashford 009I","E01032819","Total",648,103,17,86,545,56,32,164,153,38,48,54
"2011","Ashford 009J","E01032824","Total",588,145,40,105,443,29,58,104,123,15,42,72
"2011","Ashford 010A","E01024013","Total",709,174,106,68,535,33,136,94,134,17,27,94
"2011","Ashford 010B","E01024014","Total",650,105,48,57,545,21,151,83,135,25,38,92
"2011","Ashford 010C","E01024015","Total",651,119,64,55,532,9,146,89,147,19,31,91
"2011","Ashford 010D","E01024034","Total",942,188,91,97,754,26,149,161,221,23,60,114
"2011","Ashford 011A","E01023978","Total",510,93,64,29,417,9,152,54,90,15,35,62
"2011","Ashford 011B","E01023979","Total",534,134,71,63,400,29,92,86,91,20,29,53
"2011","Ashford 011C","E01024032","Total",623,154,76,78,469,17,110,82,102,24,48,86
"2011","Ashford 011D","E01024036","Total",526,122,62,60,404,15,86,69,119,15,32,68
"2011","Ashford 012B","E01024031","Total",629,172,98,74,457,15,128,64,119,22,30,79
"2011","Ashford 012C","E01024038","Total",818,224,148,76,594,14,215,102,134,19,33,77
"2011","Ashford 012D","E01024039","Total",577,102,63,39,475,11,122,72,123,17,51,79
"2011","Ashford 012E","E01032813","Total",730,175,29,146,555,51,34,186,175,22,37,50
"2011","Ashford 012F","E01032814","Total",740,173,78,95,567,29,99,139,151,25,37,87
"2011","Ashford 013A","E01024009","Total",482,123,74,49,359,6,138,40,83,9,23,60
"2011","Ashford 013B","E01024010","Total",577,188,97,91,389,15,108,65,103,14,25,59
"2011","Ashford 013C","E01024011","Total",497,126,79,47,371,18,98,79,69,14,28,65
"2011","Ashford 013D","E01024012","Total",453,118,67,51,335,17,84,61,84,14,23,52
"2011","Ashford 013E","E01024024","Total",1105,426,285,141,679,39,263,93,143,22,37,82
"2011","Ashford 013F","E01024025","Total",572,223,159,64,349,46,116,46,83,7,17,34
"2011","Ashford 014A","E01023997","Total",609,163,90,73,446,18,116,83,98,14,32,85
"2011","Ashford 014B","E01023998","Total",474,119,69,50,355,18,100,51,89,12,24,61
"2011","Ashford 014C","E01024026","Total",503,112,69,43,391,8,117,63,77,22,33,71
"2011","Ashford 014D","E01024037","Total",745,189,115,74,556,32,147,107,136,23,29,82
"2011","Canterbury 001A","E01024078","Total",920,512,192,320,408,80,39,77,131,20,24,37
"2011","Canterbury 001B","E01024080","Total",608,281,80,201,327,51,43,66,98,11,15,43
"2011","Canterbury 001C","E01024081","Total",789,445,195,250,344,43,57,51,94,16,23,60
"2011","Canterbury 001D","E01024082","Total",598,181,93,88,417,51,77,82,107,14,26,60
"2011","Canterbury 001E","E01024095","Total",607,178,68,110,429,42,95,73,104,14,29,72
"2011","Canterbury 002A","E01024094","Total",989,224,108,116,765,25,220,132,186,31,59,112
"2011","Canterbury 002B","E01024096","Total",756,218,146,72,538,24,185,74,121,18,43,73
"2011","Canterbury 002C","E01024097","Total",748,286,216,70,462,18,172,58,105,10,19,80
"2011","Canterbury 002D","E01024098","Total",659,151,118,33,508,22,182,62,113,10,33,86
"2011","Canterbury 003A","E01024064","Total",913,175,87,88,738,25,155,158,172,27,80,121
"2011","Canterbury 003B","E01024066","Total",647,178,109,69,469,57,83,81,112,22,41,73
"2011","Canterbury 003C","E01024079","Total",627,183,112,71,444,27,113,81,101,15,30,77
"2011","Canterbury 003D","E01024083","Total",654,266,168,98,388,48,101,67,77,9,26,60
"2011","Canterbury 003E","E01024118","Total",762,254,155,99,508,41,127,78,106,22,52,82
"2011","Canterbury 004A","E01024059","Total",752,308,193,115,444,42,142,47,108,22,32,51
"2011","Canterbury 004B","E01024065","Total",789,184,112,72,605,36,128,106,141,25,62,107
"2011","Canterbury 004C","E01024117","Total",633,179,118,61,454,19,167,62,99,11,23,73
"2011","Canterbury 004D","E01024119","Total",618,160,73,87,458,65,73,113,77,27,35,68
"2011","Canterbury 004E","E01024120","Total",766,258,152,106,508,23,196,73,120,6,21,69
"2011","Canterbury 005A","E01024056","Total",788,139,95,44,649,7,239,87,145,19,52,100
"2011","Canterbury 005B","E01024057","Total",802,204,130,74,598,16,228,65,159,12,43,75
"2011","Canterbury 005C","E01024058","Total",666,171,76,95,495,33,113,91,122,19,33,84
"2011","Canterbury 005D","E01024114","Total",786,263,163,100,523,13,157,108,127,16,27,75
"2011","Canterbury 005E","E01024115","Total",646,179,131,48,467,13,181,55,113,10,30,65
"2011","Canterbury 006A","E01024073","Total",808,193,93,100,615,43,145,110,167,23,45,82
"2011","Canterbury 006B","E01024074","Total",542,81,49,32,461,24,91,74,112,23,32,105
"2011","Canterbury 006C","E01024075","Total",685,188,103,85,497,23,140,77,135,20,34,68
"2011","Canterbury 006D","E01024076","Total",752,198,77,121,554,41,95,122,140,17,60,79
"2011","Canterbury 006E","E01024077","Total",565,109,45,64,456,40,76,94,114,23,39,70
"2011","Canterbury 007A","E01024055","Total",691,199,139,60,492,14,171,82,109,11,28,77
"2011","Canterbury 007B","E01024061","Total",658,243,132,111,415,61,86,54,90,28,36,60
"2011","Canterbury 007C","E01024063","Total",622,138,71,67,484,23,113,97,118,20,31,82
"2011","Canterbury 007D","E01024071","Total",706,226,107,119,480,45,68,106,126,18,42,75
"2011","Canterbury 007E","E01024116","Total",640,198,126,72,442,16,131,82,106,16,31,60
"2011","Canterbury 008A","E01024060","Total",663,202,91,111,461,36,97,85,127,14,28,74
"2011","Canterbury 008B","E01024069","Total",602,201,70,131,401,49,40,101,121,19,24,47
"2011","Canterbury 008C","E01024070","Total",694,307,112,195,387,36,79,73,128,11,17,43
"2011","Canterbury 008D","E01024072","Total",656,283,68,215,373,48,51,87,124,8,18,37
"2011","Canterbury 008E","E01024106","Total",688,212,121,91,476,32,147,88,112,8,24,65
"2011","Canterbury 009A","E01024062","Total",620,134,68,66,486,24,104,84,136,23,36,79
"2011","Canterbury 009B","E01024105","Total",696,203,121,82,493,20,187,70,100,10,24,82
"2011","Canterbury 009C","E01024107","Total",589,121,65,56,468,24,127,93,97,13,31,83
"2011","Canterbury 009D","E01024108","Total",532,163,69,94,369,43,97,62,103,9,21,34
"2011","Canterbury 009E","E01024109","Total",956,239,165,74,717,25,232,122,181,26,43,88
"2011","Canterbury 010A","E01024084","Total",469,124,62,62,345,33,72,66,92,10,23,49
"2011","Canterbury 010B","E01024085","Total",645,170,84,86,475,17,115,87,126,18,38,74
"2011","Canterbury 010C","E01024086","Total",795,184,52,132,611,55,83,130,162,43,44,94
"2011","Canterbury 010D","E01024087","Total",471,111,49,62,360,13,79,66,105,12,28,57
"2011","Canterbury 011A","E01024091","Total",495,92,32,60,403,34,48,75,92,20,46,88
"2011","Canterbury 011B","E01024110","Total",557,165,100,65,392,7,133,69,75,4,27,77
"2011","Canterbury 011C","E01024111","Total",613,148,82,66,465,53,94,86,102,17,37,76
"2011","Canterbury 011D","E01024112","Total",662,166,104,62,496,15,124,82,123,12,33,107
"2011","Canterbury 011E","E01024113","Total",538,153,88,65,385,17,102,63,95,15,18,75
"2011","Canterbury 012C","E01024067","Total",456,105,50,55,351,5,92,60,110,10,21,53
"2011","Canterbury 012D","E01024068","Total",590,153,85,68,437,19,139,67,96,15,23,78
"2011","Canterbury 012E","E01024123","Total",631,165,93,72,466,17,103,81,109,13,15,128
"2011","Canterbury 012F","E01032809","Total",958,255,160,95,703,30,191,112,165,26,38,141
"2011","Canterbury 013A","E01024099","Total",545,141,58,83,404,54,25,41,79,12,20,173
"2011","Canterbury 013B","E01024100","Total",511,87,52,35,424,24,64,45,52,11,21,207
"2011","Canterbury 013C","E01024101","Total",617,124,49,75,493,25,58,62,69,8,39,232
"2011","Canterbury 013D","E01024102","Total",657,147,78,69,510,13,100,60,114,7,36,180
"2011","Canterbury 013E","E01024103","Total",629,187,78,109,442,37,60,56,89,12,29,159
"2011","Canterbury 014A","E01024047","Total",495,66,21,45,429,27,19,164,61,44,38,76
"2011","Canterbury 014B","E01024049","Total",551,154,79,75,397,48,50,50,67,27,35,120
"2011","Canterbury 014C","E01024090","Total",751,230,75,155,521,46,52,56,139,23,29,176
"2011","Canterbury 014D","E01024092","Total",627,242,92,150,385,32,39,35,89,4,20,166
"2011","Canterbury 014E","E01024093","Total",734,372,142,230,362,57,27,39,126,12,11,90
"2011","Canterbury 016A","E01024044","Total",857,311,110,201,546,27,72,73,199,17,24,134
"2011","Canterbury 016B","E01024045","Total",661,188,110,78,473,20,113,59,121,18,31,111
"2011","Canterbury 016C","E01024046","Total",781,281,138,143,500,20,111,80,148,20,36,85
"2011","Canterbury 016D","E01024048","Total",535,138,49,89,397,38,41,42,74,16,17,169
"2011","Canterbury 016E","E01024131","Total",661,217,85,132,444,17,78,73,140,14,28,94
"2011","Canterbury 017A","E01024052","Total",910,248,86,162,662,64,83,161,194,41,46,73
"2011","Canterbury 017B","E01024053","Total",743,148,68,80,595,30,120,121,167,30,25,102
"2011","Canterbury 017C","E01024054","Total",732,148,62,86,584,18,149,112,162,19,37,87
"2011","Canterbury 017D","E01024127","Total",661,162,93,69,499,24,129,59,142,21,29,95
"2011","Canterbury 018A","E01024042","Total",535,129,64,65,406,23,79,68,117,19,31,69
"2011","Canterbury 018B","E01024043","Total",565,144,85,59,421,15,122,70,105,11,32,66
"2011","Canterbury 018C","E01024088","Total",621,181,111,70,440,20,110,92,97,13,35,73
"2011","Canterbury 018D","E01024089","Total",482,131,86,45,351,10,88,67,79,14,36,57
"2011","Canterbury 019A","E01024128","Total",631,160,52,108,471,62,47,86,122,27,34,93
"2011","Canterbury 019B","E01024129","Total",641,172,48,124,469,21,37,52,154,9,23,173
"2011","Canterbury 019C","E01024130","Total",1084,346,135,211,738,50,102,120,238,24,33,171
"2011","Canterbury 020A","E01024104","Total",956,364,136,228,592,25,65,67,248,9,19,159
"2011","Canterbury 020B","E01024121","Total",666,238,92,146,428,12,71,50,147,7,22,119
"2011","Canterbury 020C","E01024122","Total",619,251,167,84,368,30,64,48,92,13,17,104
"2011","Canterbury 020D","E01024124","Total",543,260,118,142,283,4,43,43,109,5,9,70
"2011","Canterbury 020E","E01024126","Total",532,103,62,41,429,47,65,72,74,13,52,106
"2011","Canterbury 020F","E01032807","Total",755,325,95,230,430,23,50,40,182,5,9,121
"2011","Canterbury 020G","E01032808","Total",715,284,56,228,431,52,14,68,201,5,5,86
"2011","Dartford 001A","E01024148","Total",849,418,177,241,431,95,70,73,83,19,35,56
"2011","Dartford 001B","E01024149","Total",1220,355,110,245,865,137,72,223,233,42,71,87
"2011","Dartford 001C","E01024154","Total",512,140,61,79,372,47,68,53,78,18,43,65
"2011","Dartford 001D","E01024155","Total",575,189,69,120,386,65,53,75,65,31,51,46
"2011","Dartford 002A","E01024140","Total",1175,353,25,328,822,82,30,249,318,23,55,65
"2011","Dartford 002B","E01024141","Total",633,169,48,121,464,32,77,99,137,14,28,77
"2011","Dartford 002C","E01024143","Total",999,283,22,261,716,48,54,190,297,16,33,78
"2011","Dartford 002D","E01024179","Total",1214,405,59,346,809,104,43,229,242,33,51,107
"2011","Dartford 003A","E01024180","Total",673,255,39,216,418,43,30,107,150,12,19,57
"2011","Dartford 003B","E01024181","Total",499,86,30,56,413,30,51,100,105,19,33,75
"2011","Dartford 003C","E01024182","Total",773,379,82,297,394,31,30,99,120,13,29,72
"2011","Dartford 003D","E01024183","Total",521,123,66,57,398,17,66,94,77,16,43,85
"2011","Dartford 003E","E01024184","Total",771,178,55,123,593,55,65,147,147,32,41,106
"2011","Dartford 003F","E01024185","Total",856,260,85,175,596,41,73,154,163,24,48,93
"2011","Dartford 004A","E01024142","Total",1249,470,50,420,779,75,53,202,285,29,35,100
"2011","Dartford 004B","E01024176","Total",787,320,141,179,467,71,77,102,113,15,24,65
"2011","Dartford 004C","E01024177","Total",599,177,68,109,422,90,73,54,83,19,38,65
"2011","Dartford 004D","E01024178","Total",623,145,59,86,478,52,57,101,109,23,45,91
"2011","Dartford 005A","E01024156","Total",784,330,66,264,454,37,44,86,163,12,47,65
"2011","Dartford 005B","E01024161","Total",800,219,57,162,581,52,35,138,179,22,37,118
"2011","Dartford 005C","E01024162","Total",818,386,56,330,432,37,34,93,173,10,29,56
"2011","Dartford 005D","E01024163","Total",728,203,73,130,525,40,87,123,118,11,55,91
"2011","Dartford 005E","E01024164","Total",801,234,52,182,567,46,49,147,188,23,38,76
"2011","Dartford 006A","E01024169","Total",629,198,108,90,431,41,73,93,95,19,39,71
"2011","Dartford 006B","E01024170","Total",668,235,86,149,433,59,55,98,104,19,44,54
"2011","Dartford 006C","E01024171","Total",620,171,59,112,449,35,50,93,132,22,36,81
"2011","Dartford 006D","E01024172","Total",980,434,46,388,546,53,43,119,222,15,22,72
"2011","Dartford 007A","E01024144","Total",544,108,61,47,436,10,75,99,80,15,45,112
"2011","Dartford 007B","E01024145","Total",594,112,52,60,482,23,93,87,100,23,58,98
"2011","Dartford 007C","E01024146","Total",538,89,52,37,449,11,104,79,88,15,49,103
"2011","Dartford 007D","E01024147","Total",653,131,76,55,522,12,99,117,116,22,51,105
"2011","Dartford 007E","E01024186","Total",514,108,40,68,406,23,78,92,91,18,36,68
"2011","Dartford 008A","E01024133","Total",460,86,20,66,374,19,40,100,100,24,40,51
"2011","Dartford 008B","E01024136","Total",679,251,64,187,428,29,57,90,107,16,44,85
"2011","Dartford 008C","E01024137","Total",552,104,57,47,448,23,73,114,85,11,49,93
"2011","Dartford 008D","E01024138","Total",657,175,78,97,482,63,59,115,103,20,34,88
"2011","Dartford 008E","E01024139","Total",690,152,95,57,538,14,141,81,114,21,47,120
"2011","Dartford 009A","E01024165","Total",675,256,118,138,419,63,49,85,100,25,36,61
"2011","Dartford 009B","E01024166","Total",620,134,47,87,486,53,50,101,110,23,59,90
"2011","Dartford 009C","E01024167","Total",773,244,106,138,529,54,70,111,136,24,35,99
"2011","Dartford 009D","E01024168","Total",488,137,94,43,351,27,63,49,63,14,43,92
"2011","Dartford 010A","E01024150","Total",643,163,112,51,480,14,187,49,85,13,40,92
"2011","Dartford 010B","E01024151","Total",625,154,105,49,471,10,191,70,82,14,20,84
"2011","Dartford 010C","E01024152","Total",931,162,46,116,769,84,69,189,192,49,70,116
"2011","Dartford 010D","E01024153","Total",543,104,73,31,439,16,132,75,64,14,34,104
"2011","Dartford 011A","E01024173","Total",698,147,81,66,551,25,116,122,136,14,41,97
"2011","Dartford 011B","E01024187","Total",442,119,66,53,323,7,74,58,76,11,31,66
"2011","Dartford 011C","E01024188","Total",508,123,75,48,385,17,95,86,81,12,33,61
"2011","Dartford 011D","E01024189","Total",685,225,134,91,460,25,100,75,111,23,33,93
"2011","Dartford 012A","E01024132","Total",489,98,44,54,391,25,59,78,102,17,50,60
"2011","Dartford 012B","E01024134","Total",650,132,56,76,518,39,96,91,140,15,45,92
"2011","Dartford 012C","E01024135","Total",541,159,72,87,382,37,63,60,95,14,40,73
"2011","Dartford 012D","E01024174","Total",498,167,82,85,331,15,65,60,91,7,35,58
"2011","Dartford 012E","E01024175","Total",514,110,36,74,404,21,78,87,113,12,24,69
"2011","Dartford 013A","E01024157","Total",674,160,73,87,514,27,132,82,130,18,35,90
"2011","Dartford 013B","E01024158","Total",650,200,107,93,450,16,140,74,99,10,33,78
"2011","Dartford 013C","E01024159","Total",647,120,81,39,527,6,165,79,123,9,35,110
"2011","Dartford 013D","E01024160","Total",550,98,64,34,452,8,138,74,87,18,36,91
"2011","Dover 001A","E01024206","Total",717,164,86,78,553,15,128,96,139,31,40,104
"2011","Dover 001B","E01024207","Total",719,150,70,80,569,18,129,125,148,21,35,93
"2011","Dover 001C","E01024208","Total",666,185,103,82,481,23,96,94,128,23,30,87
"2011","Dover 001D","E01024209","Total",749,215,105,110,534,26,140,98,135,27,26,82
"2011","Dover 002A","E01024202","Total",800,245,135,110,555,29,146,89,136,37,30,88
"2011","Dover 002B","E01024242","Total",730,192,94,98,538,19,172,76,139,33,36,63
"2011","Dover 002C","E01024243","Total",761,276,175,101,485,39,116,67,125,12,39,87
"2011","Dover 002D","E01024244","Total",960,432,202,230,528,33,158,61,190,10,17,59
"2011","Dover 002E","E01024245","Total",748,176,97,79,572,23,156,89,148,19,52,85
"2011","Dover 003A","E01024219","Total",562,170,100,70,392,37,115,50,92,7,27,64
"2011","Dover 003B","E01024220","Total",754,307,211,96,447,20,130,72,115,6,25,79
"2011","Dover 003C","E01024221","Total",635,134,60,74,501,25,115,83,145,19,24,90
"2011","Dover 003D","E01024227","Total",675,239,89,150,436,35,93,78,127,17,39,47
"2011","Dover 003E","E01024229","Total",727,297,144,153,430,30,96,63,134,10,15,82
"2011","Dover 004A","E01024228","Total",801,387,185,202,414,22,100,52,140,15,27,58
"2011","Dover 004B","E01024230","Total",761,370,164,206,391,31,105,48,136,4,20,47
"2011","Dover 004C","E01024231","Total",743,330,125,205,413,28,114,65,115,7,37,47
"2011","Dover 004D","E01024252","Total",1141,431,158,273,710,36,158,131,229,14,46,96
"2011","Dover 005A","E01024201","Total",613,154,67,87,459,18,99,89,119,19,33,82
"2011","Dover 005B","E01024217","Total",754,242,127,115,512,43,110,77,141,16,34,91
"2011","Dover 005C","E01024223","Total",625,153,83,70,472,34,95,76,104,22,50,91
"2011","Dover 005D","E01024225","Total",680,170,85,85,510,34,82,101,124,32,38,99
"2011","Dover 005E","E01024226","Total",626,181,104,77,445,40,123,69,83,15,39,76
"2011","Dover 006A","E01024190","Total",594,159,63,96,435,19,96,60,122,19,49,70
"2011","Dover 006B","E01024191","Total",687,171,64,107,516,36,91,112,109,23,44,101
"2011","Dover 006C","E01024192","Total",681,207,124,83,474,55,91,75,88,42,39,84
"2011","Dover 006D","E01024204","Total",657,166,93,73,491,26,124,80,137,26,37,61
"2011","Dover 007A","E01024218","Total",528,162,63,99,366,55,54,62,87,12,23,73
"2011","Dover 007B","E01024222","Total",670,199,94,105,471,44,68,93,133,19,40,74
"2011","Dover 007C","E01024224","Total",647,169,112,57,478,15,117,93,133,10,27,83
"2011","Dover 007D","E01024250","Total",777,282,176,106,495,29,157,70,107,10,37,85
"2011","Dover 007E","E01024251","Total",732,253,175,78,479,12,182,66,117,10,28,64
"2011","Dover 008A","E01024200","Total",715,171,84,87,544,20,136,76,157,14,45,96
"2011","Dover 008B","E01024203","Total",649,136,74,62,513,13,129,71,165,14,32,89
"2011","Dover 008C","E01024205","Total",643,148,67,81,495,25,81,100,150,24,36,79
"2011","Dover 008D","E01024255","Total",671,168,110,58,503,16,159,65,131,9,24,99
"2011","Dover 009A","E01024232","Total",913,266,143,123,647,17,214,81,185,19,35,96
"2011","Dover 009B","E01024236","Total",742,237,127,110,505,20,174,64,133,14,22,78
"2011","Dover 009C","E01024237","Total",758,234,142,92,524,11,216,63,140,14,20,60
"2011","Dover 009D","E01024253","Total",787,238,142,96,549,17,207,58,145,11,35,76
"2011","Dover 010C","E01024233","Total",646,123,77,46,523,10,130,95,144,18,35,91
"2011","Dover 010D","E01024235","Total",699,248,123,125,451,26,137,66,113,11,28,70
"2011","Dover 010E","E01024254","Total",805,163,60,103,642,55,112,137,138,44,60,96
"2011","Dover 010F","E01024256","Total",608,134,77,57,474,20,131,73,133,16,28,73
"2011","Dover 010G","E01033210","Total",961,255,130,125,706,26,150,128,208,18,44,132
"2011","Dover 011A","E01024193","Total",723,279,104,175,444,59,64,86,113,32,24,66
"2011","Dover 011B","E01024194","Total",638,201,45,156,437,56,44,85,127,15,36,74
"2011","Dover 011C","E01024195","Total",528,121,59,62,407,27,46,69,108,15,49,93
"2011","Dover 011D","E01024196","Total",628,191,76,115,437,56,64,87,105,17,32,76
"2011","Dover 011E","E01024197","Total",686,210,74,136,476,45,98,95,116,17,26,79
"2011","Dover 011F","E01024240","Total",651,195,70,125,456,94,30,99,91,43,47,52
"2011","Dover 011G","E01024241","Total",810,184,50,134,626,98,53,147,155,39,52,82
"2011","Dover 011H","E01024248","Total",850,308,85,223,542,97,63,105,143,27,39,68
"2011","Dover 012B","E01024238","Total",566,109,25,84,457,30,36,155,111,19,52,54
"2011","Dover 012C","E01024239","Total",873,398,190,208,475,38,87,75,156,26,26,67
"2011","Dover 012D","E01024247","Total",909,423,146,277,486,31,69,79,151,27,38,91
"2011","Dover 012E","E01033209","Total",574,293,100,193,281,13,82,25,101,6,13,41
"2011","Dover 012F","E01033211","Total",668,373,161,212,295,10,98,24,118,1,14,30
"2011","Dover 013A","E01024214","Total",726,286,86,200,440,42,44,88,135,27,43,61
"2011","Dover 013B","E01024215","Total",674,280,47,233,394,41,21,78,137,16,43,58
"2011","Dover 013C","E01024216","Total",604,143,62,81,461,31,61,125,117,12,31,84
"2011","Dover 013D","E01024246","Total",894,317,69,248,577,75,53,132,176,42,37,62
"2011","Dover 013E","E01024249","Total",915,361,184,177,554,44,133,87,132,33,31,94
"2011","Dover 014A","E01024198","Total",1076,284,165,119,792,17,288,90,240,14,40,103
"2011","Dover 014B","E01024212","Total",663,202,65,137,461,16,80,85,147,17,27,89
"2011","Dover 014C","E01024213","Total",572,128,60,68,444,16,90,90,120,12,20,96
"2011","Dover 014D","E01024234","Total",565,101,55,46,464,11,136,64,126,11,28,88
"2011","Gravesham 001A","E01024276","Total",916,161,32,129,755,64,74,171,201,27,85,133
"2011","Gravesham 001B","E01024277","Total",769,265,86,179,504,81,47,108,120,20,55,73
"2011","Gravesham 001C","E01024278","Total",863,343,65,278,520,120,39,127,132,23,30,49
"2011","Gravesham 001D","E01024279","Total",619,195,59,136,424,63,50,104,90,14,34,69
"2011","Gravesham 002A","E01024257","Total",890,399,95,304,491,44,33,101,134,18,64,97
"2011","Gravesham 002C","E01024290","Total",584,174,56,118,410,35,39,59,100,19,64,94
"2011","Gravesham 002D","E01024291","Total",793,342,142,200,451,40,49,97,116,16,52,81
"2011","Gravesham 002E","E01024295","Total",934,480,163,317,454,53,55,111,135,14,31,55
"2011","Gravesham 002F","E01032799","Total",660,286,62,224,374,24,31,66,118,15,40,80
"2011","Gravesham 002G","E01032800","Total",689,398,90,308,291,29,29,46,136,2,14,35
"2011","Gravesham 003A","E01024258","Total",625,196,44,152,429,26,47,81,111,20,50,94
"2011","Gravesham 003B","E01024261","Total",946,281,156,125,665,24,184,121,149,10,49,128
"2011","Gravesham 003C","E01024293","Total",599,124,56,68,475,34,63,105,88,36,56,93
"2011","Gravesham 003D","E01024294","Total",811,212,51,161,599,95,30,145,130,37,75,87
"2011","Gravesham 003E","E01024296","Total",1165,372,74,298,793,69,58,179,242,22,83,140
"2011","Gravesham 004A","E01024262","Total",715,225,100,125,490,48,50,105,145,18,40,84
"2011","Gravesham 004B","E01024263","Total",593,166,95,71,427,39,66,79,97,21,43,82
"2011","Gravesham 004C","E01024282","Total",580,124,36,88,456,38,39,96,109,22,56,96
"2011","Gravesham 004D","E01024283","Total",491,118,58,60,373,30,40,77,104,15,51,56
"2011","Gravesham 004E","E01024284","Total",595,146,60,86,449,46,50,100,104,22,38,89
"2011","Gravesham 005A","E01024259","Total",560,98,61,37,462,9,94,82,103,22,41,111
"2011","Gravesham 005B","E01024260","Total",808,281,127,154,527,31,94,108,146,11,40,97
"2011","Gravesham 005C","E01024292","Total",557,121,52,69,436,20,58,61,91,21,68,117
"2011","Gravesham 005D","E01024313","Total",631,148,82,66,483,32,85,106,114,10,43,93
"2011","Gravesham 005E","E01024317","Total",641,181,118,63,460,14,67,107,92,23,53,104
"2011","Gravesham 005F","E01024318","Total",622,160,73,87,462,36,69,100,113,21,42,81
"2011","Gravesham 006A","E01024280","Total",682,201,67,134,481,66,38,94,134,16,55,78
"2011","Gravesham 006B","E01024281","Total",528,115,67,48,413,33,75,67,65,19,59,95
"2011","Gravesham 006C","E01024285","Total",525,131,58,73,394,17,78,79,92,11,36,81
"2011","Gravesham 006D","E01024287","Total",645,228,156,72,417,30,121,60,85,13,41,67
"2011","Gravesham 006E","E01024288","Total",499,96,73,23,403,11,126,53,82,13,37,81
"2011","Gravesham 007A","E01024308","Total",612,244,112,132,368,54,52,69,66,19,38,70
"2011","Gravesham 007B","E01024310","Total",627,161,93,68,466,26,121,88,89,17,41,84
"2011","Gravesham 007C","E01024311","Total",457,93,44,49,364,49,30,80,58,19,60,68
"2011","Gravesham 007D","E01024314","Total",485,111,66,45,374,14,72,82,71,15,38,82
"2011","Gravesham 007E","E01024315","Total",596,172,73,99,424,23,81,62,95,18,68,77
"2011","Gravesham 008A","E01024297","Total",564,96,49,47,468,23,97,85,88,23,39,113
"2011","Gravesham 008B","E01024298","Total",537,85,66,19,452,13,118,79,86,12,36,108
"2011","Gravesham 008C","E01024299","Total",553,111,64,47,442,16,106,86,91,16,43,84
"2011","Gravesham 008D","E01024309","Total",478,88,31,57,390,48,53,81,95,20,31,62
"2011","Gravesham 008E","E01024312","Total",474,96,52,44,378,19,73,68,72,15,42,89
"2011","Gravesham 009A","E01024264","Total",612,187,116,71,425,38,90,66,67,20,51,93
"2011","Gravesham 009B","E01024286","Total",620,129,78,51,491,17,68,109,114,12,40,131
"2011","Gravesham 009C","E01024316","Total",683,131,71,60,552,35,89,124,124,18,51,111
"2011","Gravesham 009D","E01024319","Total",554,88,60,28,466,41,71,102,88,25,57,82
"2011","Gravesham 010A","E01024265","Total",499,96,67,29,403,8,106,70,111,12,36,60
"2011","Gravesham 010B","E01024266","Total",482,134,88,46,348,26,76,52,81,11,28,74
"2011","Gravesham 010C","E01024267","Total",623,142,91,51,481,25,126,80,111,17,28,94
"2011","Gravesham 010D","E01024300","Total",580,116,84,32,464,17,133,72,108,15,38,81
"2011","Gravesham 010E","E01024301","Total",518,146,79,67,372,7,116,55,88,15,24,67
"2011","Gravesham 011A","E01024303","Total",668,216,84,132,452,38,64,110,124,19,33,64
"2011","Gravesham 011B","E01024304","Total",610,148,73,75,462,45,91,85,107,15,45,74
"2011","Gravesham 011C","E01024305","Total",547,140,48,92,407,57,39,82,72,31,59,67
"2011","Gravesham 011D","E01024306","Total",436,122,49,73,314,49,41,49,60,19,38,58
"2011","Gravesham 011E","E01024307","Total",643,214,129,85,429,27,115,68,90,16,38,75
"2011","Gravesham 012A","E01024268","Total",631,120,80,40,511,11,170,74,94,21,41,100
"2011","Gravesham 012B","E01024269","Total",758,153,105,48,605,18,193,92,125,12,40,125
"2011","Gravesham 012C","E01024270","Total",586,139,80,59,447,21,112,91,102,12,22,87
"2011","Gravesham 012D","E01024271","Total",579,143,86,57,436,15,122,93,86,14,26,80
"2011","Gravesham 012E","E01024272","Total",592,117,81,36,475,5,150,94,95,11,44,76
"2011","Gravesham 013A","E01024273","Total",552,71,37,34,481,10,107,82,115,17,57,93
"2011","Gravesham 013B","E01024274","Total",616,134,69,65,482,17,108,76,138,13,32,98
"2011","Gravesham 013C","E01024275","Total",526,94,28,66,432,24,59,111,111,22,30,75
"2011","Gravesham 013D","E01024302","Total",598,127,71,56,471,12,147,72,99,18,25,98
"2011","Maidstone 001A","E01024333","Total",521,102,17,85,419,39,32,105,124,18,29,72
"2011","Maidstone 001B","E01024334","Total",412,91,22,69,321,17,22,96,117,8,24,37
"2011","Maidstone 001C","E01024335","Total",605,132,59,73,473,13,93,77,129,16,45,100
"2011","Maidstone 001D","E01024338","Total",513,83,22,61,430,7,56,99,126,11,38,93
"2011","Maidstone 001E","E01024347","Total",655,149,84,65,506,16,107,94,138,16,40,95
"2011","Maidstone 002A","E01024353","Total",720,150,70,80,570,15,122,96,168,18,35,116
"2011","Maidstone 002B","E01024354","Total",602,135,60,75,467,40,83,106,131,9,20,78
"2011","Maidstone 002C","E01024355","Total",823,221,78,143,602,45,73,136,204,18,36,90
"2011","Maidstone 002D","E01024385","Total",623,126,72,54,497,29,108,98,110,22,41,89
"2011","Maidstone 002E","E01024386","Total",697,181,68,113,516,21,96,114,163,15,36,71
"2011","Maidstone 003A","E01024320","Total",492,113,73,40,379,14,87,76,107,11,27,57
"2011","Maidstone 003B","E01024321","Total",736,191,145,46,545,23,181,110,109,13,32,77
"2011","Maidstone 003C","E01024322","Total",494,133,91,42,361,8,108,73,78,10,21,63
"2011","Maidstone 003D","E01024323","Total",593,159,89,70,434,27,145,71,88,12,18,73
"2011","Maidstone 003E","E01024324","Total",637,184,106,78,453,21,122,106,106,12,31,55
"2011","Maidstone 003F","E01024341","Total",698,162,98,64,536,6,177,89,137,11,33,83
"2011","Maidstone 004A","E01024352","Total",868,353,120,233,515,71,39,103,193,13,28,68
"2011","Maidstone 004C","E01024382","Total",641,184,27,157,457,49,31,77,194,12,29,65
"2011","Maidstone 004D","E01024383","Total",868,262,38,224,606,40,25,200,221,18,45,57
"2011","Maidstone 004E","E01024384","Total",783,247,88,159,536,40,76,100,178,24,37,81
"2011","Maidstone 004F","E01033090","Total",632,294,112,182,338,54,29,58,138,2,11,46
"2011","Maidstone 004G","E01033092","Total",631,299,52,247,332,36,30,62,126,8,15,55
"2011","Maidstone 005A","E01024330","Total",641,119,74,45,522,14,129,118,140,20,20,81
"2011","Maidstone 005B","E01024336","Total",624,106,50,56,518,17,94,113,120,18,49,107
"2011","Maidstone 005C","E01024337","Total",606,133,62,71,473,32,101,106,110,17,28,79
"2011","Maidstone 005D","E01024348","Total",518,89,35,54,429,15,56,106,110,13,32,97
"2011","Maidstone 005E","E01024351","Total",666,214,134,80,452,19,98,70,130,12,29,94
"2011","Maidstone 006A","E01024339","Total",850,331,96,235,519,37,60,99,191,10,35,87
"2011","Maidstone 006B","E01024340","Total",1034,388,79,309,646,41,71,122,257,20,44,91
"2011","Maidstone 006C","E01024356","Total",625,165,38,127,460,38,37,101,155,7,28,94
"2011","Maidstone 006E","E01024373","Total",790,269,95,174,521,52,70,95,145,18,37,104
"2011","Maidstone 006F","E01033087","Total",699,304,21,283,395,54,14,66,202,4,9,46
"2011","Maidstone 006G","E01033091","Total",715,236,46,190,479,33,42,110,175,15,26,78
"2011","Maidstone 007A","E01024326","Total",784,194,145,49,590,5,216,117,105,15,31,101
"2011","Maidstone 007B","E01024327","Total",672,161,83,78,511,27,95,110,141,16,29,93
"2011","Maidstone 007C","E01024328","Total",673,192,117,75,481,22,130,100,117,11,26,75
"2011","Maidstone 007D","E01024329","Total",604,135,93,42,469,9,128,89,93,22,44,84
"2011","Maidstone 007E","E01024349","Total",603,188,37,151,415,33,28,123,149,10,13,59
"2011","Maidstone 008A","E01024357","Total",670,168,33,135,502,55,39,127,142,9,41,89
"2011","Maidstone 008B","E01024358","Total",748,235,125,110,513,61,94,101,113,16,41,87
"2011","Maidstone 008C","E01024367","Total",543,121,54,67,422,31,60,98,110,18,33,72
"2011","Maidstone 008E","E01024369","Total",615,139,70,69,476,28,101,120,104,16,35,72
"2011","Maidstone 008F","E01033088","Total",549,112,13,99,437,31,16,138,163,15,32,42
"2011","Maidstone 008G","E01033089","Total",575,118,37,81,457,54,40,108,119,29,36,71
"2011","Maidstone 009A","E01024360","Total",636,132,41,91,504,41,82,106,154,12,33,76
"2011","Maidstone 009B","E01024372","Total",801,234,49,185,567,48,52,117,176,17,40,117
"2011","Maidstone 009C","E01024374","Total",580,93,25,68,487,79,38,104,80,31,69,86
"2011","Maidstone 009D","E01024401","Total",640,185,71,114,455,58,41,103,151,14,31,57
"2011","Maidstone 009E","E01024403","Total",777,236,78,158,541,29,74,134,183,14,29,78
"2011","Maidstone 010A","E01024371","Total",648,142,73,69,506,24,98,93,139,20,39,93
"2011","Maidstone 010B","E01024392","Total",608,127,64,63,481,46,79,74,118,11,50,103
"2011","Maidstone 010C","E01024393","Total",607,140,81,59,467,37,97,90,106,21,31,85
"2011","Maidstone 010D","E01024395","Total",528,111,66,45,417,44,59,68,77,20,59,90
"2011","Maidstone 010E","E01024396","Total",630,189,101,88,441,47,73,104,88,19,41,69
"2011","Maidstone 011A","E01024361","Total",725,209,126,83,516,28,131,85,122,23,26,101
"2011","Maidstone 011B","E01024362","Total",699,160,87,73,539,20,102,114,164,8,38,93
"2011","Maidstone 011C","E01024363","Total",824,172,87,85,652,32,147,127,168,22,54,102
"2011","Maidstone 011D","E01024387","Total",982,201,109,92,781,19,206,134,209,28,56,129
"2011","Maidstone 012A","E01024331","Total",580,136,73,63,444,13,117,87,108,13,31,75
"2011","Maidstone 012B","E01024394","Total",521,85,46,39,436,10,109,68,101,15,48,85
"2011","Maidstone 012C","E01024402","Total",601,133,85,48,468,6,130,91,127,8,34,72
"2011","Maidstone 012D","E01024404","Total",615,113,71,42,502,17,125,110,111,23,33,83
"2011","Maidstone 012E","E01024405","Total",924,292,163,129,632,33,161,117,181,14,38,88
"2011","Maidstone 013A","E01024389","Total",920,231,67,164,689,219,59,147,137,36,41,50
"2011","Maidstone 013B","E01024390","Total",573,161,62,99,412,89,49,98,71,21,25,59
"2011","Maidstone 013C","E01024391","Total",494,95,52,43,399,56,49,74,62,29,51,78
"2011","Maidstone 013D","E01024397","Total",654,238,115,123,416,52,88,70,83,7,31,85
"2011","Maidstone 013E","E01024398","Total",711,222,84,138,489,86,64,87,91,22,43,96
"2011","Maidstone 013F","E01024399","Total",620,238,151,87,382,37,100,63,83,6,25,68
"2011","Maidstone 013G","E01024400","Total",558,143,92,51,415,37,130,68,78,9,31,62
"2011","Maidstone 014A","E01024325","Total",1002,238,163,75,764,16,274,124,152,16,48,134
"2011","Maidstone 014B","E01024346","Total",560,147,82,65,413,13,125,74,102,9,34,56
"2011","Maidstone 014C","E01024377","Total",717,230,100,130,487,19,116,74,157,23,31,67
"2011","Maidstone 014D","E01024378","Total",582,152,86,66,430,18,106,83,114,23,25,61
"2011","Maidstone 015A","E01024332","Total",496,116,57,59,380,8,94,62,107,13,30,66
"2011","Maidstone 015B","E01024350","Total",566,122,44,78,444,25,64,105,114,20,35,81
"2011","Maidstone 015C","E01024375","Total",977,199,105,94,778,29,180,145,216,18,47,143
"2011","Maidstone 015D","E01024388","Total",1146,233,89,144,913,84,98,242,271,42,64,112
"2011","Maidstone 015E","E01024410","Total",635,142,77,65,493,15,129,64,150,10,39,86
"2011","Maidstone 016A","E01024342","Total",749,234,129,105,515,37,117,77,165,19,31,69
"2011","Maidstone 016B","E01024343","Total",522,85,48,37,437,14,89,81,102,22,39,90
"2011","Maidstone 016C","E01024344","Total",616,164,109,55,452,11,144,73,112,5,21,86
"2011","Maidstone 016D","E01024376","Total",921,189,108,81,732,22,195,135,185,22,47,126
"2011","Maidstone 017A","E01024364","Total",699,180,103,77,519,36,150,89,114,22,26,82
"2011","Maidstone 017B","E01024365","Total",760,215,115,100,545,18,143,113,138,21,24,88
"2011","Maidstone 017C","E01024366","Total",652,131,62,69,521,22,113,79,137,18,54,98
"2011","Maidstone 017D","E01024411","Total",468,96,39,57,372,21,72,69,94,13,35,68
"2011","Maidstone 018A","E01024345","Total",605,110,52,58,495,10,115,91,143,25,35,76
"2011","Maidstone 018B","E01024379","Total",658,128,66,62,530,14,110,111,134,17,53,91
"2011","Maidstone 018C","E01024380","Total",689,172,82,90,517,15,111,107,141,22,43,78
"2011","Maidstone 018D","E01024381","Total",612,165,75,90,447,47,102,94,108,13,21,62
"2011","Maidstone 019A","E01024406","Total",547,117,48,69,430,32,65,108,104,26,30,65
"2011","Maidstone 019B","E01024407","Total",567,119,49,70,448,22,68,97,112,15,42,92
"2011","Maidstone 019C","E01024408","Total",580,125,61,64,455,18,90,95,134,20,25,73
"2011","Maidstone 019D","E01024409","Total",617,157,103,54,460,16,132,87,110,19,25,71
"2011","Sevenoaks 001A","E01024445","Total",498,86,38,48,412,12,91,82,97,12,33,85
"2011","Sevenoaks 001B","E01024446","Total",586,114,58,56,472,21,99,78,117,8,37,112
"2011","Sevenoaks 001C","E01024447","Total",578,190,116,74,388,15,101,65,86,17,23,81
"2011","Sevenoaks 001D","E01024472","Total",526,107,51,56,419,22,75,80,96,12,39,95
"2011","Sevenoaks 001E","E01024479","Total",616,164,82,82,452,17,111,80,106,15,28,95
"2011","Sevenoaks 002A","E01024476","Total",593,152,46,106,441,58,58,99,80,31,42,73
"2011","Sevenoaks 002B","E01024477","Total",614,236,81,155,378,32,66,76,77,13,37,77
"2011","Sevenoaks 002C","E01024478","Total",579,123,67,56,456,25,110,80,111,17,27,86
"2011","Sevenoaks 002D","E01024480","Total",809,357,188,169,452,53,93,90,110,12,25,69
"2011","Sevenoaks 002E","E01024481","Total",660,203,103,100,457,42,89,80,107,12,37,90
"2011","Sevenoaks 002F","E01024482","Total",661,245,99,146,416,40,60,78,111,19,22,86
"2011","Sevenoaks 003A","E01024421","Total",801,235,135,100,566,15,145,97,132,21,51,105
"2011","Sevenoaks 003B","E01024473","Total",637,151,66,85,486,24,88,95,105,14,37,123
"2011","Sevenoaks 003C","E01024474","Total",472,74,30,44,398,19,91,71,75,14,29,99
"2011","Sevenoaks 003D","E01024475","Total",623,172,72,100,451,27,103,93,98,7,34,89
"2011","Sevenoaks 004A","E01024441","Total",630,127,97,30,503,7,170,63,107,17,40,99
"2011","Sevenoaks 004B","E01024442","Total",596,108,65,43,488,17,137,68,127,15,40,84
"2011","Sevenoaks 004C","E01024443","Total",654,219,170,49,435,3,160,64,91,10,28,79
"2011","Sevenoaks 004D","E01024444","Total",525,170,74,96,355,25,53,62,91,19,37,68
"2011","Sevenoaks 005A","E01024431","Total",799,259,142,117,540,17,137,115,112,22,24,113
"2011","Sevenoaks 005B","E01024432","Total",611,146,70,76,465,19,96,87,129,21,27,86
"2011","Sevenoaks 005C","E01024433","Total",552,162,80,82,390,12,74,75,107,12,26,84
"2011","Sevenoaks 005D","E01024434","Total",934,372,175,197,562,31,96,110,189,22,36,78
"2011","Sevenoaks 007A","E01024435","Total",579,113,57,56,466,8,96,77,123,20,43,99
"2011","Sevenoaks 007B","E01024436","Total",700,219,141,78,481,9,173,48,123,13,24,91
"2011","Sevenoaks 007C","E01024437","Total",603,161,97,64,442,9,102,80,89,13,42,107
"2011","Sevenoaks 007D","E01024438","Total",623,158,84,74,465,8,138,79,101,12,40,87
"2011","Sevenoaks 008A","E01024422","Total",769,235,73,162,534,32,84,154,135,23,31,75
"2011","Sevenoaks 008B","E01024423","Total",758,265,117,148,493,28,51,146,168,21,23,56
"2011","Sevenoaks 008C","E01024439","Total",628,140,73,67,488,19,112,96,123,13,33,92
"2011","Sevenoaks 008D","E01024440","Total",769,178,102,76,591,24,128,121,135,19,40,124
"2011","Sevenoaks 008E","E01024452","Total",590,168,85,83,422,16,109,89,103,18,29,58
"2011","Sevenoaks 009A","E01024448","Total",504,130,68,62,374,16,78,88,90,14,20,68
"2011","Sevenoaks 009B","E01024449","Total",563,87,64,23,476,12,159,82,94,16,24,89
"2011","Sevenoaks 009C","E01024450","Total",621,159,95,64,462,35,97,98,107,21,28,76
"2011","Sevenoaks 009D","E01024453","Total",644,133,96,37,511,8,161,104,102,29,37,70
"2011","Sevenoaks 009E","E01024454","Total",618,138,70,68,480,24,113,129,95,22,25,72
"2011","Sevenoaks 010A","E01024457","Total",519,173,93,80,346,22,71,84,95,7,26,41
"2011","Sevenoaks 010B","E01024460","Total",669,178,87,91,491,37,98,123,101,25,32,75
"2011","Sevenoaks 010C","E01024461","Total",1049,348,154,194,701,21,114,190,219,31,48,78
"2011","Sevenoaks 010D","E01024465","Total",617,195,71,124,422,24,59,86,155,12,22,64
"2011","Sevenoaks 010E","E01024466","Total",526,146,50,96,380,25,61,88,88,22,32,64
"2011","Sevenoaks 010F","E01024468","Total",629,176,69,107,453,25,78,120,128,22,26,54
"2011","Sevenoaks 011A","E01024416","Total",621,140,85,55,481,8,100,116,119,33,31,74
"2011","Sevenoaks 011B","E01024418","Total",514,85,58,27,429,12,113,105,78,30,23,68
"2011","Sevenoaks 011C","E01024424","Total",486,79,51,28,407,4,83,120,72,40,36,52
"2011","Sevenoaks 011D","E01024463","Total",519,68,40,28,451,8,88,130,87,29,38,71
"2011","Sevenoaks 011E","E01024464","Total",577,82,44,38,495,12,114,117,95,36,38,83
"2011","Sevenoaks 011F","E01024467","Total",645,138,78,60,507,19,102,153,94,35,27,77
"2011","Sevenoaks 012A","E01024458","Total",526,102,54,48,424,16,93,72,105,34,46,58
"2011","Sevenoaks 012B","E01024459","Total",637,177,104,73,460,14,92,97,109,29,40,79
"2011","Sevenoaks 012C","E01024462","Total",659,171,104,67,488,15,108,107,98,30,43,87
"2011","Sevenoaks 012D","E01024469","Total",709,256,80,176,453,8,46,102,181,20,25,71
"2011","Sevenoaks 012E","E01024470","Total",642,187,116,71,455,12,102,125,98,33,19,66
"2011","Sevenoaks 012F","E01024471","Total",741,340,225,115,401,8,93,80,116,28,17,59
"2011","Sevenoaks 013A","E01024417","Total",650,155,80,75,495,24,102,97,147,21,29,75
"2011","Sevenoaks 013B","E01024419","Total",731,173,72,101,558,16,133,109,160,23,33,84
"2011","Sevenoaks 013C","E01024483","Total",682,196,92,104,486,23,105,84,166,9,25,74
"2011","Sevenoaks 013D","E01024484","Total",500,107,59,48,393,12,103,75,103,16,22,62
"2011","Sevenoaks 013E","E01024485","Total",702,214,91,123,488,41,70,132,114,19,29,83
"2011","Sevenoaks 014A","E01024425","Total",724,271,169,102,453,24,81,120,124,12,23,69
"2011","Sevenoaks 014B","E01024426","Total",770,215,102,113,555,6,133,109,182,14,37,74
"2011","Sevenoaks 014C","E01024427","Total",508,132,55,77,376,25,69,60,88,28,22,84
"2011","Sevenoaks 014D","E01024428","Total",532,121,62,59,411,21,84,98,113,17,28,50
"2011","Sevenoaks 014E","E01024429","Total",651,187,80,107,464,49,79,90,134,24,21,67
"2011","Sevenoaks 014F","E01024430","Total",600,166,70,96,434,19,90,89,137,15,26,58
"2011","Sevenoaks 015A","E01024420","Total",831,217,95,122,614,16,133,129,164,29,42,101
"2011","Sevenoaks 015B","E01024451","Total",873,202,110,92,671,27,114,134,181,39,45,131
"2011","Sevenoaks 015C","E01024455","Total",472,105,48,57,367,10,74,75,109,25,24,50
"2011","Sevenoaks 015D","E01024456","Total",518,136,73,63,382,11,106,71,88,23,29,54
"2011","Sevenoaks 016A","E01024413","Total",719,248,102,146,471,35,59,116,136,19,23,83
"2011","Sevenoaks 016B","E01024414","Total",606,126,37,89,480,34,47,106,140,22,43,88
"2011","Sevenoaks 016C","E01024415","Total",507,83,34,49,424,15,93,65,99,16,42,94
"2011","Sevenoaks 016D","E01032619","Total",636,146,65,81,490,20,97,108,118,16,37,94
"2011","Shepway 001A","E01024490","Total",883,220,124,96,663,12,187,97,176,20,49,122
"2011","Shepway 001B","E01024544","Total",574,125,73,52,449,10,132,58,120,7,38,84
"2011","Shepway 001C","E01024545","Total",625,160,95,65,465,14,128,61,134,17,36,75
"2011","Shepway 001D","E01024547","Total",613,202,136,66,411,17,111,74,101,16,22,70
"2011","Shepway 002A","E01024492","Total",639,189,91,98,450,29,92,82,110,14,43,80
"2011","Shepway 002B","E01024541","Total",899,167,73,94,732,63,103,162,183,39,76,106
"2011","Shepway 002C","E01024542","Total",802,179,80,99,623,29,128,143,151,31,49,92
"2011","Shepway 002E","E01033213","Total",643,102,16,86,541,59,39,159,145,32,51,56
"2011","Shepway 002F","E01033214","Total",619,82,31,51,537,26,82,143,142,33,46,65
"2011","Shepway 003A","E01024496","Total",660,193,91,102,467,74,78,75,110,28,42,60
"2011","Shepway 003B","E01024497","Total",653,160,81,79,493,34,96,86,121,30,52,74
"2011","Shepway 003C","E01024498","Total",638,173,92,81,465,61,75,67,90,35,60,77
"2011","Shepway 003D","E01024503","Total",760,266,145,121,494,29,104,76,139,24,46,76
"2011","Shepway 003E","E01024518","Total",677,154,97,57,523,20,115,86,121,19,52,110
"2011","Shepway 004A","E01024499","Total",654,199,54,145,455,57,49,84,109,41,43,72
"2011","Shepway 004B","E01024500","Total",532,187,76,111,345,55,48,67,85,12,34,44
"2011","Shepway 004C","E01024501","Total",635,184,61,123,451,76,44,98,117,34,25,57
"2011","Shepway 004D","E01024502","Total",605,221,52,169,384,52,40,59,116,33,33,51
"2011","Shepway 004E","E01024505","Total",828,332,106,226,496,58,64,94,147,33,43,57
"2011","Shepway 005A","E01024491","Total",551,106,53,53,445,55,49,89,89,21,49,93
"2011","Shepway 005B","E01024493","Total",575,181,97,84,394,23,66,69,87,30,44,75
"2011","Shepway 005C","E01024494","Total",649,191,113,78,458,26,85,72,93,19,64,99
"2011","Shepway 005D","E01024495","Total",677,148,42,106,529,37,49,177,131,17,55,63
"2011","Shepway 005E","E01024520","Total",626,211,103,108,415,28,88,86,105,14,36,58
"2011","Shepway 005F","E01024528","Total",530,153,58,95,377,19,85,79,93,6,33,62
"2011","Shepway 006A","E01024511","Total",538,115,60,55,423,25,107,73,94,9,32,83
"2011","Shepway 006B","E01024512","Total",698,206,84,122,492,41,90,97,97,18,44,105
"2011","Shepway 006C","E01024513","Total",651,175,90,85,476,32,83,90,99,27,57,88
"2011","Shepway 006D","E01024514","Total",511,108,46,62,403,24,73,74,78,24,46,84
"2011","Shepway 006E","E01024515","Total",639,186,114,72,453,21,121,60,118,11,28,94
"2011","Shepway 006F","E01024516","Total",552,123,76,47,429,15,103,61,98,16,53,83
"2011","Shepway 006G","E01024519","Total",622,210,72,138,412,16,101,66,156,10,14,49
"2011","Shepway 006H","E01024521","Total",857,369,159,210,488,30,121,68,177,7,21,64
"2011","Shepway 008A","E01024523","Total",677,171,115,56,506,20,202,71,101,17,27,68
"2011","Shepway 008B","E01024526","Total",663,191,103,88,472,11,171,64,121,8,28,69
"2011","Shepway 008C","E01024527","Total",695,266,184,82,429,15,165,52,105,12,21,59
"2011","Shepway 008D","E01024550","Total",858,219,118,101,639,34,188,109,166,17,42,83
"2011","Shepway 009A","E01024489","Total",795,237,152,85,558,5,220,48,143,10,40,92
"2011","Shepway 009B","E01024530","Total",587,135,76,59,452,12,128,67,93,16,46,90
"2011","Shepway 009C","E01024536","Total",809,180,78,102,629,15,156,118,161,16,50,113
"2011","Shepway 009D","E01024546","Total",662,165,95,70,497,20,128,92,121,16,33,87
"2011","Shepway 010A","E01024522","Total",688,286,129,157,402,28,108,67,125,9,15,50
"2011","Shepway 010B","E01024524","Total",780,389,244,145,391,35,107,53,105,19,15,57
"2011","Shepway 010C","E01024525","Total",860,435,229,206,425,45,150,39,120,6,20,45
"2011","Shepway 010D","E01024529","Total",680,232,149,83,448,24,156,55,111,10,25,67
"2011","Shepway 010E","E01024531","Total",640,198,116,82,442,31,135,57,93,26,28,72
"2011","Shepway 011A","E01024486","Total",874,270,186,84,604,22,207,63,140,16,52,104
"2011","Shepway 011B","E01024487","Total",559,173,87,86,386,16,127,36,91,10,31,75
"2011","Shepway 011C","E01024488","Total",664,220,149,71,444,19,200,35,109,7,8,66
"2011","Shepway 011D","E01024548","Total",500,138,64,74,362,13,77,60,93,20,38,61
"2011","Shepway 011E","E01024549","Total",450,92,34,58,358,16,75,51,105,16,26,69
"2011","Shepway 012A","E01024537","Total",750,232,106,126,518,17,165,59,146,18,34,79
"2011","Shepway 012B","E01024538","Total",705,164,111,53,541,12,198,55,130,8,37,101
"2011","Shepway 012C","E01024539","Total",889,305,171,134,584,56,130,100,136,23,39,100
"2011","Shepway 012D","E01024540","Total",640,161,104,57,479,9,139,66,112,14,41,98
"2011","Shepway 013A","E01024532","Total",639,186,93,93,453,20,136,53,105,15,35,89
"2011","Shepway 013B","E01024533","Total",558,158,96,62,400,23,139,41,115,12,23,47
"2011","Shepway 013C","E01024534","Total",609,168,86,82,441,37,77,90,86,24,51,76
"2011","Shepway 013D","E01024535","Total",1008,303,122,181,705,50,177,105,194,34,50,95
"2011","Shepway 014A","E01024504","Total",1078,567,76,491,511,93,32,91,180,26,39,50
"2011","Shepway 014B","E01024507","Total",1060,592,181,411,468,65,39,88,172,20,35,49
"2011","Shepway 014C","E01033212","Total",913,553,85,468,360,49,30,40,191,5,14,31
"2011","Shepway 014D","E01033215","Total",791,513,201,312,278,25,94,19,108,7,5,20
"2011","Shepway 015A","E01024508","Total",1110,610,160,450,500,84,66,82,222,4,13,29
"2011","Shepway 015B","E01024509","Total",957,557,268,289,400,38,94,54,171,7,9,27
"2011","Shepway 015C","E01024510","Total",874,436,153,283,438,25,116,55,156,7,16,63
"2011","Shepway 015D","E01024517","Total",742,312,54,258,430,26,63,56,154,15,35,81
"2011","Swale 001A","E01024609","Total",530,241,53,188,289,52,23,52,83,14,30,35
"2011","Swale 001B","E01024610","Total",660,210,56,154,450,86,52,102,91,19,29,71
"2011","Swale 001C","E01024611","Total",617,170,60,110,447,107,25,86,104,23,29,73
"2011","Swale 001D","E01024612","Total",634,181,75,106,453,73,62,73,102,20,36,87
"2011","Swale 002A","E01024613","Total",615,227,81,146,388,47,51,74,101,26,31,58
"2011","Swale 002B","E01024614","Total",639,208,103,105,431,74,72,90,74,28,27,66
"2011","Swale 002C","E01024615","Total",613,197,91,106,416,74,63,63,82,21,41,72
"2011","Swale 002D","E01024616","Total",700,234,137,97,466,48,82,87,99,28,46,76
"2011","Swale 003A","E01024585","Total",607,191,109,82,416,42,95,70,82,13,52,62
"2011","Swale 003B","E01024587","Total",638,183,106,77,455,18,136,43,130,11,37,80
"2011","Swale 003C","E01024588","Total",585,123,64,59,462,11,130,69,128,10,36,78
"2011","Swale 003D","E01024589","Total",662,147,93,54,515,14,154,45,143,16,32,111
"2011","Swale 004A","E01024595","Total",635,181,112,69,454,34,104,78,109,9,41,79
"2011","Swale 004B","E01024598","Total",610,143,49,94,467,32,84,88,121,24,45,73
"2011","Swale 004D","E01024619","Total",602,167,86,81,435,19,102,81,107,15,31,80
"2011","Swale 004E","E01024621","Total",478,147,87,60,331,65,54,54,46,16,42,54
"2011","Swale 004F","E01032653","Total",662,176,66,110,486,50,99,85,140,10,27,75
"2011","Swale 004G","E01032654","Total",709,133,17,116,576,55,32,154,202,24,43,66
"2011","Swale 005A","E01024594","Total",593,150,103,47,443,23,131,62,100,7,33,87
"2011","Swale 005B","E01024596","Total",689,197,87,110,492,57,89,99,135,17,25,70
"2011","Swale 005C","E01024597","Total",612,188,81,107,424,54,73,63,108,27,40,59
"2011","Swale 005D","E01024620","Total",544,136,79,57,408,16,126,37,116,13,26,74
"2011","Swale 006A","E01024580","Total",797,300,149,151,497,53,137,46,144,20,30,67
"2011","Swale 006B","E01024581","Total",539,129,50,79,410,36,78,63,115,15,35,68
"2011","Swale 006C","E01024586","Total",662,153,89,64,509,28,117,90,128,14,39,93
"2011","Swale 006D","E01024618","Total",731,176,73,103,555,41,109,76,173,21,48,87
"2011","Swale 007B","E01024576","Total",673,169,28,141,504,34,59,128,154,18,38,73
"2011","Swale 007C","E01024577","Total",521,103,30,73,418,39,59,84,110,23,30,73
"2011","Swale 007D","E01024578","Total",659,154,46,108,505,46,50,131,150,14,44,70
"2011","Swale 007E","E01024579","Total",1056,204,41,163,852,127,52,217,203,72,78,103
"2011","Swale 007F","E01024583","Total",640,143,45,98,497,61,60,105,136,19,41,75
"2011","Swale 007G","E01032655","Total",586,89,15,74,497,32,34,168,161,25,31,46
"2011","Swale 007H","E01032656","Total",571,115,38,77,456,28,60,131,125,22,32,58
"2011","Swale 008A","E01024570","Total",679,149,79,70,530,25,131,87,118,24,51,94
"2011","Swale 008B","E01024571","Total",658,186,68,118,472,18,115,71,144,12,32,80
"2011","Swale 008C","E01024572","Total",447,100,54,46,347,11,61,64,89,12,33,77
"2011","Swale 008D","E01024573","Total",538,127,79,48,411,23,99,70,88,13,37,81
"2011","Swale 008E","E01024575","Total",473,95,49,46,378,16,77,63,107,14,34,67
"2011","Swale 009A","E01024554","Total",988,216,78,138,772,33,183,131,217,17,64,127
"2011","Swale 009B","E01024561","Total",543,139,42,97,404,48,44,69,115,19,36,73
"2011","Swale 009C","E01024567","Total",1133,308,87,221,825,107,98,220,219,48,44,89
"2011","Swale 009D","E01024568","Total",1035,185,80,105,850,38,128,232,214,43,73,122
"2011","Swale 009E","E01024582","Total",629,151,74,77,478,22,87,78,140,16,30,105
"2011","Swale 010A","E01024559","Total",650,286,150,136,364,43,55,74,99,6,30,57
"2011","Swale 010B","E01024584","Total",707,224,123,101,483,48,73,98,113,26,47,78
"2011","Swale 010C","E01024590","Total",685,311,80,231,374,60,46,72,84,28,34,50
"2011","Swale 010D","E01024599","Total",835,261,104,157,574,89,56,150,150,16,28,85
"2011","Swale 010E","E01024608","Total",815,327,155,172,488,38,92,86,127,11,45,89
"2011","Swale 011A","E01024591","Total",768,239,69,170,529,53,59,118,153,26,39,81
"2011","Swale 011B","E01024592","Total",512,117,46,71,395,24,85,89,93,13,20,71
"2011","Swale 011C","E01024593","Total",504,101,29,72,403,42,43,85,91,28,44,70
"2011","Swale 011D","E01024600","Total",618,182,109,73,436,34,85,57,113,12,47,88
"2011","Swale 011E","E01024601","Total",718,243,126,117,475,16,104,74,131,16,35,99
"2011","Swale 012A","E01024560","Total",503,123,59,64,380,41,59,63,90,20,40,67
"2011","Swale 012B","E01024562","Total",571,118,58,60,453,38,73,104,114,21,34,69
"2011","Swale 012C","E01024569","Total",707,172,90,82,535,24,132,97,129,15,43,95
"2011","Swale 012D","E01024630","Total",755,230,149,81,525,23,177,66,122,15,31,91
"2011","Swale 012E","E01024632","Total",648,130,90,40,518,11,183,75,114,7,40,88
"2011","Swale 013A","E01024606","Total",523,129,63,66,394,21,83,52,94,20,48,76
"2011","Swale 013C","E01024628","Total",605,143,73,70,462,21,113,83,106,18,41,80
"2011","Swale 013D","E01024629","Total",452,76,39,37,376,10,90,70,108,18,23,57
"2011","Swale 013E","E01024631","Total",648,119,89,30,529,8,162,84,112,15,43,105
"2011","Swale 013F","E01032735","Total",595,97,39,58,498,26,94,117,119,13,42,87
"2011","Swale 013G","E01032737","Total",583,140,44,96,443,30,66,106,125,17,33,66
"2011","Swale 014A","E01024564","Total",441,112,72,40,329,11,106,56,73,7,22,54
"2011","Swale 014B","E01024603","Total",510,125,50,75,385,15,64,106,103,11,13,73
"2011","Swale 014C","E01024604","Total",478,132,32,100,346,55,34,79,87,24,30,37
"2011","Swale 014D","E01024605","Total",583,150,87,63,433,14,112,78,131,13,24,61
"2011","Swale 014E","E01024626","Total",620,142,70,72,478,14,107,115,128,18,37,59
"2011","Swale 014F","E01024627","Total",817,253,110,143,564,72,112,86,136,30,51,77
"2011","Swale 015A","E01024551","Total",987,311,116,195,676,78,82,156,224,25,37,74
"2011","Swale 015B","E01024552","Total",760,221,116,105,539,43,79,108,144,25,50,90
"2011","Swale 015C","E01024553","Total",1002,451,212,239,551,28,120,111,193,14,21,64
"2011","Swale 015D","E01024563","Total",655,222,96,126,433,47,73,70,97,16,54,76
"2011","Swale 015E","E01024602","Total",699,267,149,118,432,30,86,91,117,13,23,72
"2011","Swale 015F","E01024625","Total",793,188,84,104,605,21,160,123,155,15,28,103
"2011","Swale 016A","E01024565","Total",520,116,61,55,404,15,91,61,117,24,37,59
"2011","Swale 016B","E01024566","Total",603,131,66,65,472,28,114,74,131,15,39,71
"2011","Swale 016C","E01024622","Total",712,194,85,109,518,40,116,86,151,12,33,80
"2011","Swale 016D","E01024623","Total",785,235,128,107,550,30,117,99,138,17,40,109
"2011","Swale 016E","E01024624","Total",738,197,84,113,541,38,117,106,133,18,45,84
"2011","Swale 017A","E01024555","Total",519,137,72,65,382,20,102,75,103,15,28,39
"2011","Swale 017B","E01024556","Total",494,141,82,59,353,13,82,61,92,14,35,56
"2011","Swale 017C","E01024557","Total",611,156,73,83,455,29,100,99,104,18,32,73
"2011","Swale 017D","E01024558","Total",664,158,79,79,506,16,114,88,149,21,36,82
"2011","Thanet 001A","E01024657","Total",1009,476,75,401,533,125,24,107,158,41,34,44
"2011","Thanet 001B","E01024658","Total",949,403,166,237,546,73,112,105,135,20,38,63
"2011","Thanet 001C","E01024659","Total",641,260,99,161,381,35,63,66,98,20,44,55
"2011","Thanet 001D","E01024660","Total",756,305,92,213,451,74,47,74,130,25,45,56
"2011","Thanet 001E","E01024678","Total",1038,569,147,422,469,90,49,77,158,15,28,52
"2011","Thanet 002A","E01024653","Total",722,218,143,75,504,17,184,72,107,19,22,83
"2011","Thanet 002B","E01024654","Total",737,273,199,74,464,17,179,59,107,13,30,59
"2011","Thanet 002C","E01024655","Total",628,152,103,49,476,19,176,56,95,16,23,91
"2011","Thanet 002D","E01024656","Total",779,301,168,133,478,18,153,56,112,15,47,77
"2011","Thanet 002E","E01024675","Total",873,212,123,89,661,21,206,98,151,17,45,123
"2011","Thanet 003A","E01024676","Total",822,410,122,288,412,75,49,77,130,11,28,42
"2011","Thanet 003B","E01024677","Total",677,179,60,119,498,94,43,113,126,25,33,64
"2011","Thanet 003C","E01024695","Total",488,112,45,67,376,48,39,101,88,25,31,44
"2011","Thanet 003D","E01024697","Total",504,154,64,90,350,73,31,71,63,23,34,55
"2011","Thanet 003E","E01024710","Total",588,304,50,254,284,35,35,55,85,5,27,42
"2011","Thanet 004A","E01024661","Total",643,228,53,175,415,76,38,82,99,20,39,61
"2011","Thanet 004B","E01024664","Total",604,165,68,97,439,64,59,99,100,16,35,66
"2011","Thanet 004C","E01024665","Total",594,154,81,73,440,43,64,101,99,23,39,71
"2011","Thanet 004D","E01024694","Total",786,314,115,199,472,34,76,112,110,19,41,80
"2011","Thanet 004E","E01024696","Total",595,179,86,93,416,41,109,67,93,15,31,60
"2011","Thanet 005A","E01024672","Total",598,185,101,84,413,52,76,59,81,23,42,80
"2011","Thanet 005B","E01024673","Total",804,260,143,117,544,41,148,109,106,12,36,92
"2011","Thanet 005C","E01024674","Total",607,120,64,56,487,12,94,95,118,18,46,104
"2011","Thanet 005D","E01024711","Total",542,137,80,57,405,12,92,57,87,13,51,93
"2011","Thanet 005E","E01024712","Total",625,160,83,77,465,15,127,78,106,15,43,81
"2011","Thanet 006A","E01024633","Total",659,223,126,97,436,56,73,74,102,20,38,73
"2011","Thanet 006B","E01024634","Total",546,133,59,74,413,48,62,89,87,18,42,67
"2011","Thanet 006C","E01024662","Total",649,154,81,73,495,46,142,88,89,30,29,71
"2011","Thanet 006D","E01024663","Total",617,157,40,117,460,109,47,82,98,35,37,52
"2011","Thanet 006E","E01024666","Total",734,273,106,167,461,83,82,74,97,26,38,61
"2011","Thanet 007A","E01024641","Total",730,305,194,111,425,31,121,63,109,10,32,59
"2011","Thanet 007B","E01024713","Total",708,227,107,120,481,45,99,97,109,26,40,65
"2011","Thanet 007C","E01024714","Total",735,340,183,157,395,25,131,40,119,11,23,46
"2011","Thanet 007D","E01024715","Total",967,522,165,357,445,41,105,70,157,11,24,37
"2011","Thanet 007E","E01024716","Total",845,248,124,124,597,50,115,132,129,21,47,103
"2011","Thanet 008A","E01024636","Total",1088,438,307,131,650,26,281,61,179,10,18,75
"2011","Thanet 008B","E01024637","Total",748,217,167,50,531,14,211,61,133,5,35,72
"2011","Thanet 008C","E01024638","Total",780,286,201,85,494,24,201,55,117,9,23,65
"2011","Thanet 008D","E01024639","Total",826,316,189,127,510,36,172,71,134,12,16,69
"2011","Thanet 008E","E01024640","Total",772,273,199,74,499,15,202,70,111,15,23,63
"2011","Thanet 009A","E01024635","Total",695,170,92,78,525,37,161,78,117,25,39,68
"2011","Thanet 009B","E01024642","Total",730,270,179,91,460,28,197,52,107,10,23,43
"2011","Thanet 009C","E01024644","Total",597,170,108,62,427,10,158,64,113,8,23,51
"2011","Thanet 009D","E01024692","Total",810,333,206,127,477,56,114,86,121,13,24,63
"2011","Thanet 009E","E01024693","Total",597,174,104,70,423,26,129,76,90,13,28,61
"2011","Thanet 010A","E01024643","Total",616,268,101,167,348,31,55,56,125,14,16,51
"2011","Thanet 010B","E01024705","Total",612,301,115,186,311,26,70,35,105,4,26,45
"2011","Thanet 010C","E01024706","Total",644,224,114,110,420,28,101,79,106,18,30,58
"2011","Thanet 010D","E01024707","Total",587,180,92,88,407,31,84,81,104,14,30,63
"2011","Thanet 010E","E01024708","Total",674,187,133,54,487,8,190,60,129,7,29,64
"2011","Thanet 011A","E01024686","Total",717,237,142,95,480,33,118,68,117,16,35,93
"2011","Thanet 011B","E01024688","Total",734,242,133,109,492,24,164,68,126,13,30,67
"2011","Thanet 011C","E01024689","Total",536,149,101,48,387,16,114,55,86,13,31,72
"2011","Thanet 011D","E01024690","Total",643,209,156,53,434,17,132,59,93,17,33,83
"2011","Thanet 011E","E01024691","Total",478,108,56,52,370,24,80,72,79,13,21,81
"2011","Thanet 012A","E01024669","Total",717,211,66,145,506,80,65,92,127,26,36,80
"2011","Thanet 012B","E01024698","Total",633,199,82,117,434,39,69,88,144,8,29,57
"2011","Thanet 012C","E01024699","Total",762,214,102,112,548,86,97,116,122,26,39,62
"2011","Thanet 012D","E01024700","Total",735,184,93,91,551,63,94,125,129,21,38,81
"2011","Thanet 012E","E01024709","Total",603,172,129,43,431,8,145,54,109,12,29,74
"2011","Thanet 013A","E01024682","Total",717,230,76,154,487,74,61,92,125,29,45,61
"2011","Thanet 013B","E01024683","Total",691,216,88,128,475,70,87,58,92,41,44,83
"2011","Thanet 013C","E01024684","Total",642,173,74,99,469,45,81,92,100,28,41,82
"2011","Thanet 013D","E01024685","Total",764,214,110,104,550,60,112,105,121,18,46,88
"2011","Thanet 013E","E01024687","Total",626,236,86,150,390,46,55,71,94,21,46,57
"2011","Thanet 014A","E01024701","Total",853,219,92,127,634,28,149,91,203,26,51,86
"2011","Thanet 014B","E01024702","Total",623,217,152,65,406,21,135,72,94,15,28,41
"2011","Thanet 014C","E01024703","Total",753,220,108,112,533,27,134,89,146,21,46,70
"2011","Thanet 014D","E01024704","Total",719,200,105,95,519,42,123,94,134,20,36,70
"2011","Thanet 015A","E01024645","Total",612,167,72,95,445,52,71,88,102,16,47,69
"2011","Thanet 015B","E01024647","Total",649,215,48,167,434,42,48,90,119,28,36,71
"2011","Thanet 015C","E01024668","Total",485,126,45,81,359,72,45,74,84,20,23,41
"2011","Thanet 015D","E01024670","Total",687,251,102,149,436,80,51,87,106,17,29,66
"2011","Thanet 015E","E01024681","Total",697,180,68,112,517,84,52,114,130,19,34,84
"2011","Thanet 016A","E01024646","Total",943,445,162,283,498,66,81,75,155,22,36,63
"2011","Thanet 016B","E01024648","Total",715,327,110,217,388,54,61,71,94,13,35,60
"2011","Thanet 016C","E01024649","Total",913,456,115,341,457,69,70,87,151,11,16,53
"2011","Thanet 016D","E01024667","Total",972,519,174,345,453,85,63,78,151,8,23,45
"2011","Thanet 016E","E01024671","Total",912,475,177,298,437,56,76,72,155,10,20,48
"2011","Thanet 017A","E01024650","Total",626,158,81,77,468,20,134,70,132,10,30,72
"2011","Thanet 017B","E01024651","Total",685,266,146,120,419,20,127,63,115,5,30,59
"2011","Thanet 017C","E01024652","Total",772,176,106,70,596,16,181,91,143,17,40,108
"2011","Thanet 017D","E01024679","Total",621,212,150,62,409,11,180,39,87,6,16,70
"2011","Thanet 017E","E01024680","Total",703,204,120,84,499,37,115,111,130,6,37,63
"2011","Tonbridge and Malling 001A","E01024719","Total",780,189,73,116,591,28,77,130,163,30,50,113
"2011","Tonbridge and Malling 001B","E01024720","Total",542,100,62,38,442,11,114,73,111,20,35,78
"2011","Tonbridge and Malling 001C","E01024721","Total",507,84,45,39,423,13,91,79,127,9,37,67
"2011","Tonbridge and Malling 001D","E01024722","Total",556,133,49,84,423,25,72,97,106,11,33,79
"2011","Tonbridge and Malling 001E","E01024727","Total",1106,302,92,210,804,58,113,195,256,22,50,110
"2011","Tonbridge and Malling 001F","E01024728","Total",676,158,68,90,518,37,101,88,153,15,45,79
"2011","Tonbridge and Malling 002C","E01024771","Total",764,207,58,149,557,75,60,141,151,16,39,75
"2011","Tonbridge and Malling 002D","E01024772","Total",650,140,49,91,510,27,82,116,130,11,37,107
"2011","Tonbridge and Malling 002E","E01024773","Total",736,183,86,97,553,17,132,92,171,17,23,101
"2011","Tonbridge and Malling 002F","E01024774","Total",1127,376,124,252,751,81,94,169,252,27,36,92
"2011","Tonbridge and Malling 002G","E01032830","Total",1011,311,132,179,700,70,102,125,147,44,70,142
"2011","Tonbridge and Malling 003A","E01024741","Total",557,113,60,53,444,50,71,88,84,28,40,83
"2011","Tonbridge and Malling 003B","E01024761","Total",884,202,101,101,682,41,118,139,180,28,54,122
"2011","Tonbridge and Malling 003C","E01024762","Total",826,172,63,109,654,38,84,142,208,21,33,128
"2011","Tonbridge and Malling 003D","E01024763","Total",529,90,57,33,439,28,105,83,96,15,33,79
"2011","Tonbridge and Malling 003E","E01024764","Total",517,129,68,61,388,23,92,76,87,10,21,79
"2011","Tonbridge and Malling 003F","E01024765","Total",523,101,53,48,422,15,88,88,93,12,22,104
"2011","Tonbridge and Malling 003G","E01024782","Total",481,94,35,59,387,17,46,90,101,7,43,83
"2011","Tonbridge and Malling 003H","E01024785","Total",615,165,86,79,450,28,65,116,132,14,26,69
"2011","Tonbridge and Malling 005A","E01024717","Total",689,246,190,56,443,20,124,67,91,20,44,77
"2011","Tonbridge and Malling 005B","E01024718","Total",522,73,50,23,449,10,128,66,118,12,24,91
"2011","Tonbridge and Malling 005C","E01024735","Total",608,104,71,33,504,20,127,102,116,11,35,93
"2011","Tonbridge and Malling 005D","E01024736","Total",704,176,95,81,528,42,101,105,153,14,45,68
"2011","Tonbridge and Malling 005E","E01024737","Total",937,198,67,131,739,85,103,176,214,26,44,91
"2011","Tonbridge and Malling 006A","E01024723","Total",625,150,79,71,475,12,106,115,103,32,33,74
"2011","Tonbridge and Malling 006B","E01024724","Total",769,144,94,50,625,33,146,138,166,29,43,70
"2011","Tonbridge and Malling 006C","E01024725","Total",656,137,76,61,519,22,135,120,120,17,27,78
"2011","Tonbridge and Malling 006D","E01024726","Total",738,213,134,79,525,29,128,91,131,24,32,90
"2011","Tonbridge and Malling 006E","E01024755","Total",763,120,65,55,643,18,142,150,141,45,52,95
"2011","Tonbridge and Malling 006F","E01024786","Total",782,225,132,93,557,47,133,111,112,32,38,84
"2011","Tonbridge and Malling 007A","E01024746","Total",427,100,39,61,327,12,63,60,89,17,28,58
"2011","Tonbridge and Malling 007C","E01024760","Total",538,59,25,34,479,26,74,165,86,33,31,64
"2011","Tonbridge and Malling 007D","E01024781","Total",810,162,74,88,648,23,135,145,169,21,50,105
"2011","Tonbridge and Malling 007E","E01032825","Total",564,85,15,70,479,53,28,169,125,37,30,37
"2011","Tonbridge and Malling 007F","E01032826","Total",572,98,14,84,474,34,36,158,125,45,35,41
"2011","Tonbridge and Malling 007G","E01032827","Total",571,60,10,50,511,38,33,225,98,44,28,45
"2011","Tonbridge and Malling 007H","E01032828","Total",438,58,19,39,380,13,43,129,102,28,22,43
"2011","Tonbridge and Malling 008A","E01024743","Total",753,207,120,87,546,23,110,105,137,21,46,104
"2011","Tonbridge and Malling 008B","E01024744","Total",793,152,74,78,641,16,152,119,155,26,44,129
"2011","Tonbridge and Malling 008C","E01024745","Total",723,162,83,79,561,23,160,97,125,25,35,96
"2011","Tonbridge and Malling 008D","E01024747","Total",646,211,108,103,435,35,84,77,97,18,37,87
"2011","Tonbridge and Malling 009A","E01024730","Total",548,136,100,36,412,12,150,77,75,12,17,69
"2011","Tonbridge and Malling 009B","E01024731","Total",472,107,78,29,365,4,116,66,66,21,23,69
"2011","Tonbridge and Malling 009C","E01024775","Total",641,194,75,119,447,58,78,88,94,19,34,76
"2011","Tonbridge and Malling 009D","E01024776","Total",509,127,71,56,382,24,91,67,62,21,37,80
"2011","Tonbridge and Malling 009E","E01024777","Total",507,150,83,67,357,18,87,51,64,13,37,87
"2011","Tonbridge and Malling 010A","E01024734","Total",666,180,108,72,486,18,126,94,111,16,33,88
"2011","Tonbridge and Malling 010B","E01024752","Total",639,126,85,41,513,16,129,120,107,20,45,76
"2011","Tonbridge and Malling 010C","E01024753","Total",621,143,80,63,478,21,101,102,110,18,36,90
"2011","Tonbridge and Malling 010D","E01024754","Total",624,108,55,53,516,13,103,107,133,34,39,87
"2011","Tonbridge and Malling 011A","E01024729","Total",712,190,115,75,522,46,120,100,110,25,46,75
"2011","Tonbridge and Malling 011B","E01024748","Total",534,84,64,20,450,9,131,70,83,22,49,86
"2011","Tonbridge and Malling 011C","E01024749","Total",622,158,100,58,464,49,102,111,87,18,29,68
"2011","Tonbridge and Malling 011D","E01024750","Total",630,160,111,49,470,22,163,75,85,21,32,72
"2011","Tonbridge and Malling 011E","E01024751","Total",647,162,134,28,485,7,187,80,81,19,36,75
"2011","Tonbridge and Malling 012A","E01024732","Total",662,252,64,188,410,29,40,105,142,12,24,58
"2011","Tonbridge and Malling 012B","E01024733","Total",704,180,74,106,524,23,102,118,130,32,34,85
"2011","Tonbridge and Malling 012C","E01024756","Total",639,142,67,75,497,50,71,123,118,17,41,77
"2011","Tonbridge and Malling 012D","E01024766","Total",915,289,103,186,626,34,89,125,244,13,29,92
"2011","Tonbridge and Malling 012E","E01024767","Total",546,89,38,51,457,49,61,97,92,28,45,85
"2011","Tonbridge and Malling 012F","E01024768","Total",744,258,139,119,486,13,92,95,158,23,36,69
"2011","Tonbridge and Malling 013A","E01024757","Total",684,209,105,104,475,17,59,121,159,17,32,70
"2011","Tonbridge and Malling 013B","E01024758","Total",625,156,54,102,469,21,70,101,121,26,33,97
"2011","Tonbridge and Malling 013C","E01024778","Total",650,155,48,107,495,24,52,132,171,20,26,70
"2011","Tonbridge and Malling 013D","E01024779","Total",775,232,97,135,543,15,78,107,187,22,41,93
"2011","Tonbridge and Malling 013E","E01024780","Total",598,110,35,75,488,40,50,123,127,25,46,77
"2011","Tonbridge and Malling 014A","E01024740","Total",752,179,79,100,573,30,116,105,168,26,39,89
"2011","Tonbridge and Malling 014B","E01024742","Total",705,173,74,99,532,46,102,133,135,18,32,66
"2011","Tonbridge and Malling 014C","E01024783","Total",726,264,148,116,462,21,96,69,149,12,31,84
"2011","Tonbridge and Malling 014D","E01024784","Total",583,173,107,66,410,8,81,91,118,17,25,70
"2011","Tonbridge and Malling 014E","E01032620","Total",904,176,95,81,728,25,199,97,184,27,54,142
"2011","Tonbridge and Malling 014F","E01032829","Total",541,102,54,48,439,14,106,79,122,17,28,73
"2011","Tunbridge Wells 001A","E01024798","Total",918,176,88,88,742,30,129,154,194,44,57,134
"2011","Tunbridge Wells 001B","E01024811","Total",481,95,68,27,386,13,89,73,80,9,28,94
"2011","Tunbridge Wells 001C","E01024812","Total",501,105,69,36,396,15,89,83,78,22,33,76
"2011","Tunbridge Wells 001D","E01024813","Total",789,299,146,153,490,27,69,101,183,17,21,72
"2011","Tunbridge Wells 001E","E01024814","Total",512,110,71,39,402,9,83,70,89,18,45,88
"2011","Tunbridge Wells 001F","E01024815","Total",501,96,42,54,405,22,75,73,94,26,37,78
"2011","Tunbridge Wells 001G","E01024816","Total",496,88,41,47,408,24,56,105,90,25,30,78
"2011","Tunbridge Wells 002A","E01024837","Total",651,98,51,47,553,30,55,132,111,55,68,102
"2011","Tunbridge Wells 002B","E01024844","Total",660,185,52,133,475,33,53,103,142,30,38,76
"2011","Tunbridge Wells 002C","E01024846","Total",641,156,76,80,485,26,76,104,140,23,34,82
"2011","Tunbridge Wells 002D","E01024849","Total",670,184,96,88,486,24,77,111,123,25,35,91
"2011","Tunbridge Wells 002E","E01024850","Total",475,63,39,24,412,7,121,79,60,22,36,87
"2011","Tunbridge Wells 003A","E01024836","Total",710,202,67,135,508,37,59,111,158,31,41,71
"2011","Tunbridge Wells 003B","E01024839","Total",743,220,64,156,523,20,105,101,158,33,22,84
"2011","Tunbridge Wells 003C","E01024845","Total",529,125,70,55,404,29,89,75,74,23,33,81
"2011","Tunbridge Wells 003D","E01024847","Total",700,198,62,136,502,45,77,107,156,27,27,63
"2011","Tunbridge Wells 003E","E01024848","Total",636,293,198,95,343,22,90,60,78,19,19,55
"2011","Tunbridge Wells 004A","E01024793","Total",677,161,81,80,516,15,123,77,130,30,38,103
"2011","Tunbridge Wells 004B","E01024825","Total",522,83,48,35,439,11,111,72,109,20,33,83
"2011","Tunbridge Wells 004C","E01024826","Total",626,189,95,94,437,8,111,95,95,20,29,79
"2011","Tunbridge Wells 004D","E01024827","Total",614,158,87,71,456,24,84,109,88,26,44,81
"2011","Tunbridge Wells 004E","E01024828","Total",638,187,86,101,451,26,87,95,114,26,42,61
"2011","Tunbridge Wells 005A","E01024840","Total",696,155,46,109,541,62,54,96,117,56,59,97
"2011","Tunbridge Wells 005B","E01024841","Total",856,322,112,210,534,65,73,124,111,31,35,95
"2011","Tunbridge Wells 005C","E01024842","Total",706,234,112,122,472,34,111,90,109,20,27,81
"2011","Tunbridge Wells 005D","E01024843","Total",581,151,42,109,430,51,26,99,127,27,32,68
"2011","Tunbridge Wells 006A","E01024829","Total",654,146,70,76,508,22,93,122,125,23,30,93
"2011","Tunbridge Wells 006B","E01024851","Total",666,186,91,95,480,19,94,106,109,32,47,73
"2011","Tunbridge Wells 006C","E01024852","Total",505,72,56,16,433,5,148,81,68,19,42,70
"2011","Tunbridge Wells 006D","E01024853","Total",538,140,76,64,398,7,110,65,90,22,46,58
"2011","Tunbridge Wells 006E","E01024854","Total",594,100,68,32,494,12,99,116,105,35,52,75
"2011","Tunbridge Wells 007A","E01024799","Total",937,359,162,197,578,20,125,113,213,12,29,66
"2011","Tunbridge Wells 007B","E01024800","Total",657,149,77,72,508,10,129,92,117,35,41,84
"2011","Tunbridge Wells 007C","E01024835","Total",830,217,50,167,613,24,52,179,192,37,44,85
"2011","Tunbridge Wells 007D","E01024838","Total",673,186,56,130,487,20,48,126,129,32,49,83
"2011","Tunbridge Wells 008A","E01024801","Total",1405,676,94,582,729,35,71,130,389,16,23,65
"2011","Tunbridge Wells 008B","E01024802","Total",1082,543,90,453,539,24,41,112,251,17,30,64
"2011","Tunbridge Wells 008C","E01024823","Total",896,352,123,229,544,18,73,101,240,18,24,70
"2011","Tunbridge Wells 008D","E01024833","Total",1247,599,168,431,648,54,39,125,300,33,36,61
"2011","Tunbridge Wells 009A","E01024821","Total",970,370,213,157,600,20,146,132,204,28,17,53
"2011","Tunbridge Wells 009B","E01024822","Total",844,325,187,138,519,19,134,114,135,10,30,77
"2011","Tunbridge Wells 009C","E01024824","Total",617,154,83,71,463,17,98,119,97,26,28,78
"2011","Tunbridge Wells 009D","E01024832","Total",674,198,33,165,476,20,63,129,153,23,29,59
"2011","Tunbridge Wells 009E","E01024834","Total",923,208,48,160,715,52,50,182,278,37,29,87
"2011","Tunbridge Wells 010A","E01024795","Total",591,181,61,120,410,62,50,80,95,28,30,65
"2011","Tunbridge Wells 010B","E01024796","Total",629,222,75,147,407,24,93,77,109,20,25,59
"2011","Tunbridge Wells 010C","E01024830","Total",804,279,144,135,525,42,108,102,138,18,23,94
"2011","Tunbridge Wells 010D","E01024831","Total",618,199,75,124,419,37,48,91,130,22,30,61
"2011","Tunbridge Wells 011A","E01024792","Total",697,123,73,50,574,15,114,112,125,36,50,122
"2011","Tunbridge Wells 011B","E01024794","Total",662,163,81,82,499,27,102,110,106,40,38,76
"2011","Tunbridge Wells 011C","E01024804","Total",546,119,49,70,427,17,92,98,91,35,35,59
"2011","Tunbridge Wells 011D","E01024805","Total",667,145,66,79,522,18,111,116,130,36,32,79
"2011","Tunbridge Wells 011E","E01024806","Total",641,161,88,73,480,19,120,95,107,29,38,72
"2011","Tunbridge Wells 012A","E01024797","Total",743,223,115,108,520,8,153,77,152,15,28,87
"2011","Tunbridge Wells 012B","E01024817","Total",755,195,73,122,560,15,131,127,162,30,31,64
"2011","Tunbridge Wells 012C","E01024818","Total",716,198,90,108,518,19,124,106,130,17,43,79
"2011","Tunbridge Wells 012D","E01024819","Total",859,352,90,262,507,17,67,86,249,16,15,57
"2011","Tunbridge Wells 012E","E01024820","Total",661,152,87,65,509,13,112,147,104,36,29,68
"2011","Tunbridge Wells 013A","E01024787","Total",459,81,47,34,378,16,62,71,97,33,30,69
"2011","Tunbridge Wells 013B","E01024788","Total",606,163,78,85,443,48,71,95,99,21,32,77
"2011","Tunbridge Wells 013C","E01024790","Total",500,197,132,65,303,18,58,44,91,25,11,56
"2011","Tunbridge Wells 013D","E01024791","Total",549,139,96,43,410,25,124,67,78,14,23,79
"2011","Tunbridge Wells 013E","E01024803","Total",847,157,93,64,690,40,183,104,167,26,62,108
"2011","Tunbridge Wells 014A","E01024789","Total",803,251,119,132,552,25,141,104,124,26,47,85
"2011","Tunbridge Wells 014B","E01024807","Total",675,213,121,92,462,39,97,91,111,21,28,75
"2011","Tunbridge Wells 014C","E01024808","Total",709,206,95,111,503,26,111,92,149,24,30,71
"2011","Tunbridge Wells 014D","E01024809","Total",583,130,69,61,453,19,117,72,106,23,44,72
"2011","Tunbridge Wells 014E","E01024810","Total",613,125,47,78,488,20,92,95,100,45,41,95
"2011","Cherwell 001A","E01028479","Total",552,137,72,65,415,10,97,72,153,6,17,60
"2011","Cherwell 001B","E01028480","Total",609,149,84,65,460,17,120,87,129,12,23,72
"2011","Cherwell 001C","E01028508","Total",442,78,43,35,364,11,102,67,100,12,19,53
"2011","Cherwell 001D","E01028509","Total",645,161,67,94,484,14,129,84,139,16,19,83
"2011","Cherwell 002A","E01028441","Total",997,265,80,185,732,83,47,180,252,38,47,85
"2011","Cherwell 002C","E01028443","Total",586,127,32,95,459,34,55,118,139,8,35,70
"2011","Cherwell 002D","E01028444","Total",586,91,56,35,495,18,92,88,135,13,49,100
"2011","Cherwell 002E","E01032943","Total",623,123,13,110,500,49,30,141,181,26,34,39
"2011","Cherwell 002F","E01032944","Total",612,198,38,160,414,43,48,89,139,12,23,60
"2011","Cherwell 003A","E01028445","Total",510,81,38,43,429,37,52,105,96,23,45,71
"2011","Cherwell 003B","E01028446","Total",619,154,84,70,465,25,106,76,118,23,43,74
"2011","Cherwell 003C","E01028447","Total",541,192,78,114,349,25,38,64,113,14,34,61
"2011","Cherwell 003D","E01028448","Total",631,199,108,91,432,53,55,88,107,25,42,62
"2011","Cherwell 004A","E01028435","Total",922,519,187,332,403,50,59,52,155,7,23,57
"2011","Cherwell 004C","E01028437","Total",568,134,39,95,434,19,52,109,114,19,43,78
"2011","Cherwell 004D","E01028438","Total",773,307,62,245,466,31,28,108,180,20,42,57
"2011","Cherwell 004E","E01028439","Total",569,142,28,114,427,28,31,116,137,12,36,67
"2011","Cherwell 004F","E01028440","Total",734,265,56,209,469,50,27,110,174,17,24,67
"2011","Cherwell 004G","E01032941","Total",629,242,129,113,387,39,63,67,100,20,33,65
"2011","Cherwell 004H","E01032942","Total",657,239,14,225,418,67,4,91,174,10,18,54
"2011","Cherwell 005A","E01028449","Total",529,144,76,68,385,39,73,71,70,26,33,73
"2011","Cherwell 005B","E01028450","Total",533,119,34,85,414,69,42,86,74,21,45,77
"2011","Cherwell 005C","E01028451","Total",478,80,43,37,398,25,60,76,93,21,41,82
"2011","Cherwell 005D","E01028452","Total",493,107,47,60,386,40,41,89,83,20,47,66
"2011","Cherwell 005E","E01028453","Total",498,90,33,57,408,50,58,85,94,17,36,68
"2011","Cherwell 005F","E01028454","Total",608,181,109,72,427,57,75,59,67,30,60,79
"2011","Cherwell 006A","E01028430","Total",659,240,63,177,419,24,53,80,156,18,23,65
"2011","Cherwell 006B","E01028431","Total",650,180,110,70,470,13,147,78,115,10,32,75
"2011","Cherwell 006C","E01028432","Total",637,151,78,73,486,18,139,82,107,20,38,82
"2011","Cherwell 006D","E01028433","Total",751,209,147,62,542,15,185,77,124,12,34,95
"2011","Cherwell 006E","E01028434","Total",513,91,50,41,422,10,114,74,90,12,41,81
"2011","Cherwell 007A","E01028426","Total",562,135,63,72,427,30,68,102,111,12,30,74
"2011","Cherwell 007B","E01028427","Total",668,236,39,197,432,23,42,122,152,13,30,50
"2011","Cherwell 007C","E01028428","Total",518,74,36,38,444,11,107,74,98,24,43,87
"2011","Cherwell 007D","E01028429","Total",471,166,101,65,305,9,81,53,71,9,24,58
"2011","Cherwell 008A","E01028422","Total",621,129,74,55,492,25,95,114,135,16,32,75
"2011","Cherwell 008B","E01028423","Total",612,143,71,72,469,20,149,78,114,12,30,66
"2011","Cherwell 008C","E01028475","Total",872,200,105,95,672,20,182,116,168,19,53,114
"2011","Cherwell 008D","E01028476","Total",870,161,68,93,709,27,155,153,191,26,40,117
"2011","Cherwell 009A","E01028474","Total",657,162,78,84,495,31,104,112,132,17,30,69
"2011","Cherwell 009B","E01028485","Total",531,142,91,51,389,21,71,90,93,23,28,63
"2011","Cherwell 009C","E01028486","Total",540,120,57,63,420,6,115,77,124,17,18,63
"2011","Cherwell 009D","E01028503","Total",496,97,55,42,399,9,117,56,126,13,23,55
"2011","Cherwell 009E","E01028504","Total",590,141,55,86,449,10,116,88,113,16,21,85
"2011","Cherwell 010A","E01028481","Total",617,177,104,73,440,20,128,89,106,15,29,53
"2011","Cherwell 010B","E01028482","Total",490,102,64,38,388,10,102,77,100,18,28,53
"2011","Cherwell 010C","E01028505","Total",713,149,59,90,564,39,91,124,182,27,24,77
"2011","Cherwell 010D","E01028506","Total",721,169,69,100,552,18,111,127,165,18,32,81
"2011","Cherwell 010E","E01028507","Total",582,127,64,63,455,9,107,98,124,19,17,81
"2011","Cherwell 011A","E01028425","Total",687,96,14,82,591,35,29,250,157,34,23,63
"2011","Cherwell 011B","E01028477","Total",581,112,50,62,469,23,71,96,141,24,40,74
"2011","Cherwell 011C","E01028478","Total",483,88,21,67,395,18,17,140,95,39,34,52
"2011","Cherwell 011D","E01028483","Total",501,97,41,56,404,9,80,93,122,21,23,56
"2011","Cherwell 011E","E01028484","Total",455,111,46,65,344,7,77,75,92,8,25,60
"2011","Cherwell 011F","E01028499","Total",618,132,68,64,486,9,111,82,148,19,33,84
"2011","Cherwell 012A","E01028459","Total",652,207,19,188,445,31,17,134,179,12,26,46
"2011","Cherwell 012B","E01028460","Total",726,95,12,83,631,40,38,264,146,30,51,62
"2011","Cherwell 012C","E01028461","Total",678,135,14,121,543,38,26,174,177,13,43,72
"2011","Cherwell 012D","E01028462","Total",627,134,49,85,493,21,69,126,125,19,41,92
"2011","Cherwell 013A","E01028455","Total",529,71,16,55,458,22,48,107,133,14,32,102
"2011","Cherwell 013B","E01028456","Total",601,141,82,59,460,32,107,62,118,19,33,89
"2011","Cherwell 013C","E01028457","Total",503,80,29,51,423,9,57,96,116,19,36,90
"2011","Cherwell 013D","E01028458","Total",613,162,48,114,451,32,27,120,137,22,38,75
"2011","Cherwell 013E","E01028467","Total",704,225,85,140,479,20,114,96,137,17,30,65
"2011","Cherwell 014A","E01028466","Total",690,175,69,106,515,47,92,91,124,34,37,90
"2011","Cherwell 014B","E01028469","Total",596,111,75,36,485,8,136,75,101,19,30,116
"2011","Cherwell 014C","E01028470","Total",676,140,68,72,536,22,128,103,124,17,43,99
"2011","Cherwell 014D","E01028471","Total",481,79,39,40,402,42,52,89,83,22,38,76
"2011","Cherwell 014E","E01028472","Total",481,77,36,41,404,13,51,96,109,13,28,94
"2011","Cherwell 014F","E01028473","Total",607,137,31,106,470,16,48,105,154,17,45,85
"2011","Cherwell 015A","E01028463","Total",1029,274,24,250,755,63,29,250,275,40,28,70
"2011","Cherwell 015B","E01028464","Total",576,147,24,123,429,17,32,134,148,20,25,53
"2011","Cherwell 015C","E01028465","Total",531,86,14,72,445,32,37,150,118,18,30,60
"2011","Cherwell 015D","E01028468","Total",986,500,303,197,486,24,89,90,184,9,22,68
"2011","Cherwell 016A","E01028424","Total",639,159,65,94,480,4,107,100,145,16,28,80
"2011","Cherwell 016B","E01028497","Total",589,146,70,76,443,13,127,76,114,18,22,73
"2011","Cherwell 016C","E01028498","Total",638,161,71,90,477,21,87,114,108,28,29,90
"2011","Cherwell 016D","E01028500","Total",505,94,46,48,411,22,93,78,121,14,23,60
"2011","Cherwell 016E","E01028501","Total",467,88,45,43,379,6,94,68,105,13,33,60
"2011","Cherwell 016F","E01028502","Total",497,110,53,57,387,12,80,90,122,17,21,45
"2011","Cherwell 017A","E01028487","Total",532,146,49,97,386,24,35,83,141,12,25,66
"2011","Cherwell 017B","E01028489","Total",617,151,107,44,466,4,172,62,110,8,26,84
"2011","Cherwell 017C","E01028490","Total",496,132,83,49,364,11,90,55,82,9,42,75
"2011","Cherwell 017D","E01028491","Total",665,193,118,75,472,8,128,86,126,12,21,91
"2011","Cherwell 017E","E01028494","Total",458,101,55,46,357,24,52,78,100,14,26,63
"2011","Cherwell 018A","E01028492","Total",600,139,83,56,461,17,119,74,107,8,39,97
"2011","Cherwell 018B","E01028493","Total",531,110,64,46,421,22,98,58,83,21,38,101
"2011","Cherwell 018C","E01028495","Total",517,116,56,60,401,19,65,86,107,11,32,81
"2011","Cherwell 018D","E01028496","Total",501,96,59,37,405,30,53,80,87,17,47,91
"2011","Cherwell 019A","E01028488","Total",625,215,35,180,410,29,51,103,143,4,19,61
"2011","Cherwell 019B","E01028510","Total",636,152,88,64,484,17,111,89,123,22,27,95
"2011","Cherwell 019C","E01028511","Total",716,215,133,82,501,16,145,80,117,10,23,110
"2011","Cherwell 019D","E01028512","Total",603,146,59,87,457,27,79,85,129,11,27,99
"2011","Oxford 001A","E01028594","Total",661,176,92,84,485,12,129,80,128,18,38,80
"2011","Oxford 001B","E01028595","Total",622,204,100,104,418,20,66,113,111,20,26,62
"2011","Oxford 001C","E01028596","Total",673,260,108,152,413,15,81,90,124,15,30,58
"2011","Oxford 001D","E01028597","Total",637,236,108,128,401,28,78,71,107,15,33,69
"2011","Oxford 002C","E01028591","Total",548,203,79,124,345,8,65,70,104,19,23,56
"2011","Oxford 002D","E01028592","Total",504,216,74,142,288,11,28,61,104,15,14,55
"2011","Oxford 002F","E01032554","Total",991,402,210,192,589,14,125,112,190,19,31,98
"2011","Oxford 002G","E01032555","Total",792,230,84,146,562,83,57,123,133,27,45,94
"2011","Oxford 003A","E01028565","Total",511,150,46,104,361,5,46,92,109,17,23,69
"2011","Oxford 003B","E01028583","Total",443,212,109,103,231,12,59,35,76,9,14,26
"2011","Oxford 003C","E01028584","Total",1101,356,78,278,745,40,118,186,220,42,43,96
"2011","Oxford 003D","E01028585","Total",403,188,39,149,215,8,48,36,65,13,18,27
"2011","Oxford 004A","E01028560","Total",672,247,130,117,425,20,101,71,108,11,38,76
"2011","Oxford 004B","E01028561","Total",645,168,107,61,477,24,127,69,88,17,39,113
"2011","Oxford 004C","E01028562","Total",612,150,70,80,462,38,62,87,93,29,42,111
"2011","Oxford 004D","E01028563","Total",587,155,61,94,432,15,55,94,121,18,39,90
"2011","Oxford 005A","E01028513","Total",929,322,68,254,607,124,30,112,174,29,46,92
"2011","Oxford 005B","E01028514","Total",551,154,72,82,397,64,49,55,67,29,57,76
"2011","Oxford 005C","E01028516","Total",703,200,78,122,503,62,78,97,110,20,37,99
"2011","Oxford 005D","E01028538","Total",630,217,104,113,413,37,76,73,92,17,36,82
"2011","Oxford 006A","E01028534","Total",459,149,97,52,310,7,59,62,84,20,19,59
"2011","Oxford 006B","E01028535","Total",661,191,60,131,470,11,50,92,161,17,20,119
"2011","Oxford 006C","E01028536","Total",627,248,109,139,379,14,62,81,112,5,18,87
"2011","Oxford 006D","E01028537","Total",809,383,93,290,426,12,79,82,140,12,17,84
"2011","Oxford 006E","E01028539","Total",666,150,52,98,516,32,45,106,102,21,55,155
"2011","Oxford 006F","E01028540","Total",550,158,72,86,392,17,86,72,89,19,35,74
"2011","Oxford 007A","E01028515","Total",667,174,51,123,493,33,50,120,140,13,40,97
"2011","Oxford 007B","E01028571","Total",676,205,83,122,471,25,61,100,148,11,31,95
"2011","Oxford 007C","E01028572","Total",669,177,64,113,492,25,73,104,147,21,35,87
"2011","Oxford 007D","E01028573","Total",674,194,85,109,480,12,64,135,111,23,34,101
"2011","Oxford 007E","E01028574","Total",620,239,126,113,381,30,66,65,105,9,30,76
"2011","Oxford 008A","E01028521","Total",668,307,24,283,361,7,34,34,184,7,11,84
"2011","Oxford 008B","E01028522","Total",746,461,73,388,285,31,28,35,143,2,9,37
"2011","Oxford 008E","E01033282","Total",1291,557,178,379,734,32,111,118,265,19,28,161
"2011","Oxford 009A","E01028548","Total",760,278,101,177,482,19,57,96,179,17,15,99
"2011","Oxford 009B","E01028549","Total",778,306,73,233,472,15,38,90,195,10,15,109
"2011","Oxford 009C","E01028550","Total",695,323,84,239,372,25,31,46,130,6,6,128
"2011","Oxford 009D","E01028551","Total",623,182,39,143,441,19,40,52,175,4,12,139
"2011","Oxford 010A","E01028523","Total",638,230,44,186,408,39,45,54,120,11,18,121
"2011","Oxford 010B","E01028524","Total",632,227,77,150,405,65,52,71,85,13,41,78
"2011","Oxford 010C","E01028525","Total",706,248,112,136,458,81,58,77,87,22,34,99
"2011","Oxford 010D","E01028526","Total",551,152,52,100,399,20,32,36,97,7,25,182
"2011","Oxford 011A","E01028579","Total",529,108,28,80,421,7,21,32,118,6,31,206
"2011","Oxford 011B","E01028580","Total",573,189,47,142,384,15,25,30,125,4,10,175
"2011","Oxford 011C","E01028581","Total",484,117,43,74,367,12,44,52,90,7,16,146
"2011","Oxford 011D","E01028582","Total",588,261,87,174,327,19,24,23,111,3,12,135
"2011","Oxford 011E","E01028586","Total",684,261,39,222,423,16,19,48,125,8,16,191
"2011","Oxford 011F","E01028587","Total",755,264,30,234,491,31,14,53,131,8,23,231
"2011","Oxford 011G","E01028588","Total",467,146,14,132,321,4,14,30,110,2,12,149
"2011","Oxford 012A","E01028541","Total",616,199,63,136,417,21,41,90,121,18,17,109
"2011","Oxford 012B","E01028542","Total",755,236,49,187,519,40,42,75,192,16,41,113
"2011","Oxford 012C","E01028543","Total",621,250,83,167,371,26,59,68,106,14,16,82
"2011","Oxford 012D","E01028544","Total",600,252,91,161,348,11,47,53,121,14,11,91
"2011","Oxford 013A","E01028531","Total",867,309,32,277,558,34,36,105,236,10,23,114
"2011","Oxford 013B","E01028532","Total",1004,355,71,284,649,36,57,86,188,14,62,206
"2011","Oxford 013C","E01028533","Total",820,229,52,177,591,59,45,85,171,25,68,138
"2011","Oxford 013D","E01028556","Total",696,186,53,133,510,50,42,93,156,19,44,106
"2011","Oxford 013E","E01028557","Total",699,182,71,111,517,56,60,82,93,32,61,133
"2011","Oxford 013F","E01028558","Total",588,121,50,71,467,37,63,72,90,21,48,136
"2011","Oxford 013G","E01028559","Total",643,159,57,102,484,24,70,71,132,13,43,131
"2011","Oxford 014A","E01028545","Total",612,179,24,155,433,18,30,89,116,16,29,135
"2011","Oxford 014B","E01028546","Total",745,236,100,136,509,39,68,76,124,19,56,127
"2011","Oxford 014C","E01028547","Total",830,232,46,186,598,26,20,107,200,14,31,200
"2011","Oxford 015A","E01028527","Total",685,212,89,123,473,25,61,96,131,20,30,110
"2011","Oxford 015B","E01028528","Total",537,137,51,86,400,23,38,68,86,22,44,119
"2011","Oxford 015C","E01028529","Total",632,210,85,125,422,59,52,79,82,18,38,94
"2011","Oxford 015D","E01028530","Total",633,166,91,75,467,47,66,70,91,17,47,129
"2011","Oxford 015E","E01028575","Total",675,230,107,123,445,19,105,66,126,11,32,86
"2011","Oxford 015F","E01028578","Total",638,224,100,124,414,12,62,64,105,24,40,107
"2011","Oxford 016A","E01028552","Total",731,242,95,147,489,87,64,88,102,27,28,93
"2011","Oxford 016B","E01028553","Total",752,240,48,192,512,69,58,80,193,21,19,72
"2011","Oxford 016C","E01028554","Total",546,176,58,118,370,31,63,45,85,12,47,87
"2011","Oxford 016D","E01028555","Total",665,186,67,119,479,43,67,82,140,15,33,99
"2011","Oxford 016E","E01028576","Total",489,109,34,75,380,70,29,67,83,20,56,55
"2011","Oxford 016F","E01028577","Total",753,229,87,142,524,66,77,83,107,35,59,97
"2011","Oxford 017A","E01028517","Total",509,132,24,108,377,67,34,72,85,15,37,67
"2011","Oxford 017B","E01028518","Total",676,249,64,185,427,104,70,62,54,19,44,74
"2011","Oxford 017C","E01028519","Total",544,127,61,66,417,46,81,63,54,26,38,109
"2011","Oxford 017D","E01028567","Total",661,193,93,100,468,79,52,83,70,16,57,111
"2011","Oxford 018A","E01028520","Total",632,172,65,107,460,96,67,74,57,33,61,72
"2011","Oxford 018B","E01028568","Total",623,187,90,97,436,103,53,82,65,31,40,62
"2011","Oxford 018C","E01028569","Total",664,209,28,181,455,108,19,112,87,33,38,58
"2011","Oxford 018D","E01028570","Total",773,230,16,214,543,92,16,172,144,27,39,53
"2011","South Oxfordshire 001A","E01028666","Total",685,238,93,145,447,24,57,93,149,17,39,68
"2011","South Oxfordshire 001B","E01028667","Total",525,114,33,81,411,19,17,118,121,20,36,80
"2011","South Oxfordshire 001C","E01028668","Total",552,124,64,60,428,9,84,92,99,15,34,95
"2011","South Oxfordshire 001D","E01028669","Total",539,112,61,51,427,17,83,94,117,14,36,66
"2011","South Oxfordshire 002A","E01028638","Total",563,120,59,61,443,17,111,62,120,19,32,82
"2011","South Oxfordshire 002B","E01028639","Total",500,104,52,52,396,7,71,76,120,11,31,80
"2011","South Oxfordshire 002C","E01028640","Total",583,142,63,79,441,16,103,92,101,15,25,89
"2011","South Oxfordshire 002D","E01028683","Total",568,153,91,62,415,4,118,72,80,12,32,97
"2011","South Oxfordshire 003A","E01028670","Total",554,108,70,38,446,9,100,104,103,26,29,75
"2011","South Oxfordshire 003B","E01028671","Total",669,283,174,109,386,23,78,80,108,23,15,59
"2011","South Oxfordshire 003C","E01028672","Total",695,148,80,68,547,12,146,99,139,26,35,90
"2011","South Oxfordshire 003D","E01028673","Total",504,116,45,71,388,24,58,84,116,22,22,62
"2011","South Oxfordshire 004A","E01028646","Total",466,115,53,62,351,12,77,67,95,15,26,59
"2011","South Oxfordshire 004B","E01028647","Total",617,120,58,62,497,15,110,106,138,11,33,84
"2011","South Oxfordshire 004C","E01028681","Total",522,109,66,43,413,10,104,73,105,12,25,84
"2011","South Oxfordshire 004D","E01028682","Total",503,133,83,50,370,11,106,69,79,7,27,71
"2011","South Oxfordshire 004E","E01028684","Total",637,197,76,121,440,16,88,83,150,11,23,69
"2011","South Oxfordshire 005A","E01028598","Total",951,199,101,98,752,19,155,151,212,25,54,136
"2011","South Oxfordshire 005B","E01028613","Total",523,73,28,45,450,15,75,113,109,15,34,89
"2011","South Oxfordshire 005C","E01028614","Total",601,137,67,70,464,14,96,101,116,21,30,86
"2011","South Oxfordshire 005D","E01028615","Total",677,173,114,59,504,17,149,69,129,12,27,101
"2011","South Oxfordshire 005E","E01028616","Total",533,97,36,61,436,17,73,92,107,18,30,99
"2011","South Oxfordshire 006A","E01028604","Total",552,124,39,85,428,25,56,98,96,29,56,68
"2011","South Oxfordshire 006B","E01028605","Total",637,173,81,92,464,39,99,87,91,19,37,92
"2011","South Oxfordshire 006C","E01028607","Total",496,105,55,50,391,4,88,73,109,21,23,73
"2011","South Oxfordshire 006D","E01028641","Total",503,117,71,46,386,11,106,61,108,11,26,63
"2011","South Oxfordshire 006E","E01028657","Total",548,195,53,142,353,11,58,58,131,12,21,62
"2011","South Oxfordshire 006F","E01028658","Total",490,112,55,57,378,14,92,72,79,21,28,72
"2011","South Oxfordshire 007A","E01028600","Total",629,170,95,75,459,19,114,91,112,20,27,76
"2011","South Oxfordshire 007B","E01028603","Total",458,103,53,50,355,7,66,74,87,24,25,72
"2011","South Oxfordshire 007C","E01028606","Total",756,220,134,86,536,13,163,97,122,21,31,89
"2011","South Oxfordshire 007D","E01028609","Total",490,62,32,30,428,17,91,95,105,25,27,68
"2011","South Oxfordshire 007E","E01028610","Total",601,129,57,72,472,12,98,93,131,7,30,101
"2011","South Oxfordshire 008A","E01028678","Total",631,134,83,51,497,16,132,120,121,18,25,65
"2011","South Oxfordshire 008B","E01028679","Total",853,178,77,101,675,22,159,129,181,28,51,105
"2011","South Oxfordshire 008C","E01028680","Total",768,245,142,103,523,17,128,120,147,25,32,54
"2011","South Oxfordshire 009A","E01028625","Total",772,148,24,124,624,35,21,228,239,21,29,51
"2011","South Oxfordshire 009B","E01028626","Total",618,105,15,90,513,29,18,153,188,18,31,76
"2011","South Oxfordshire 009C","E01028627","Total",611,134,27,107,477,43,33,149,169,13,22,48
"2011","South Oxfordshire 009D","E01028628","Total",540,88,9,79,452,26,30,130,137,16,37,76
"2011","South Oxfordshire 009E","E01028629","Total",632,205,25,180,427,25,18,124,166,17,27,50
"2011","South Oxfordshire 010A","E01028621","Total",508,105,35,70,403,57,32,113,100,24,24,53
"2011","South Oxfordshire 010B","E01028622","Total",529,150,84,66,379,20,101,70,88,10,24,66
"2011","South Oxfordshire 010C","E01028623","Total",656,174,75,99,482,26,72,90,119,23,37,115
"2011","South Oxfordshire 010D","E01028624","Total",572,151,89,62,421,16,102,70,101,15,26,91
"2011","South Oxfordshire 011A","E01028599","Total",598,159,94,65,439,9,125,79,119,9,30,68
"2011","South Oxfordshire 011B","E01028601","Total",469,96,42,54,373,7,74,110,83,20,23,56
"2011","South Oxfordshire 011C","E01028602","Total",519,27,15,12,492,10,27,231,151,31,22,20
"2011","South Oxfordshire 011D","E01028620","Total",973,226,97,129,747,27,159,168,202,27,47,117
"2011","South Oxfordshire 012A","E01028608","Total",465,83,48,35,382,7,102,78,87,13,40,55
"2011","South Oxfordshire 012B","E01028617","Total",789,225,112,113,564,26,127,126,152,31,23,79
"2011","South Oxfordshire 012C","E01028674","Total",542,111,61,50,431,17,118,96,109,18,16,57
"2011","South Oxfordshire 012D","E01028675","Total",505,149,76,73,356,19,50,77,85,21,29,75
"2011","South Oxfordshire 012E","E01028676","Total",826,253,74,179,573,38,91,133,150,26,34,101
"2011","South Oxfordshire 012F","E01028677","Total",774,392,189,203,382,16,73,81,146,12,14,40
"2011","South Oxfordshire 013A","E01028630","Total",703,256,17,239,447,39,18,112,168,11,29,70
"2011","South Oxfordshire 013B","E01028631","Total",458,137,58,79,321,24,59,68,75,7,22,66
"2011","South Oxfordshire 013C","E01028632","Total",534,100,44,56,434,36,61,71,99,24,39,104
"2011","South Oxfordshire 013D","E01028633","Total",689,260,33,227,429,57,38,88,143,20,22,61
"2011","South Oxfordshire 014A","E01028634","Total",509,102,59,43,407,5,100,86,92,16,42,66
"2011","South Oxfordshire 014B","E01028635","Total",616,157,85,72,459,32,95,83,103,21,30,95
"2011","South Oxfordshire 014C","E01028636","Total",566,215,155,60,351,31,72,63,65,20,36,64
"2011","South Oxfordshire 014D","E01028637","Total",620,136,72,64,484,12,94,102,129,16,36,95
"2011","South Oxfordshire 015A","E01028618","Total",702,134,52,82,568,10,120,126,173,34,23,82
"2011","South Oxfordshire 015B","E01028619","Total",740,164,84,80,576,29,147,119,130,19,39,93
"2011","South Oxfordshire 015C","E01028644","Total",701,200,130,70,501,16,150,103,134,9,25,64
"2011","South Oxfordshire 015D","E01028648","Total",472,116,67,49,356,14,80,76,84,11,27,64
"2011","South Oxfordshire 015E","E01028649","Total",595,108,61,47,487,17,99,95,132,21,36,87
"2011","South Oxfordshire 016A","E01028650","Total",820,243,140,103,577,27,119,140,132,27,33,99
"2011","South Oxfordshire 016B","E01028651","Total",754,290,167,123,464,19,131,79,126,15,20,74
"2011","South Oxfordshire 016C","E01028652","Total",1042,454,229,225,588,37,167,99,178,18,20,69
"2011","South Oxfordshire 017A","E01028653","Total",633,225,79,146,408,37,57,125,118,16,16,39
"2011","South Oxfordshire 017B","E01028654","Total",615,142,78,64,473,17,100,121,90,35,40,70
"2011","South Oxfordshire 017C","E01028655","Total",860,353,139,214,507,49,82,112,175,13,17,59
"2011","South Oxfordshire 017D","E01028656","Total",533,114,77,37,419,3,149,85,76,17,27,62
"2011","South Oxfordshire 018A","E01028611","Total",445,91,45,46,354,7,79,72,93,20,28,55
"2011","South Oxfordshire 018B","E01028642","Total",492,91,64,27,401,14,99,87,85,25,31,60
"2011","South Oxfordshire 018C","E01028643","Total",560,135,73,62,425,18,103,94,101,15,24,70
"2011","South Oxfordshire 018D","E01028645","Total",627,171,116,55,456,9,190,69,97,15,20,56
"2011","South Oxfordshire 018E","E01028685","Total",485,99,59,40,386,13,95,87,97,9,15,70
"2011","South Oxfordshire 018F","E01028686","Total",473,106,50,56,367,14,83,69,87,14,32,68
"2011","South Oxfordshire 019A","E01028612","Total",511,114,43,71,397,9,113,93,100,19,18,45
"2011","South Oxfordshire 019B","E01028660","Total",687,160,84,76,527,24,103,106,136,36,33,89
"2011","South Oxfordshire 019C","E01028661","Total",577,107,70,37,470,3,142,82,101,30,35,77
"2011","South Oxfordshire 019D","E01028662","Total",503,80,47,33,423,4,125,83,96,27,35,53
"2011","South Oxfordshire 020A","E01028659","Total",624,115,59,56,509,11,128,99,123,29,28,91
"2011","South Oxfordshire 020B","E01028663","Total",611,163,82,81,448,32,91,108,101,16,24,76
"2011","South Oxfordshire 020C","E01028664","Total",543,131,97,34,412,11,143,77,79,11,21,70
"2011","South Oxfordshire 020D","E01028665","Total",527,102,70,32,425,11,133,88,83,9,35,66
"2011","Vale of White Horse 001A","E01028708","Total",747,219,120,99,528,20,124,76,145,17,40,106
"2011","Vale of White Horse 001B","E01028709","Total",658,142,62,80,516,7,135,71,140,16,30,117
"2011","Vale of White Horse 001C","E01028710","Total",667,150,86,64,517,13,128,114,130,16,33,83
"2011","Vale of White Horse 001D","E01028711","Total",667,147,81,66,520,27,128,99,117,25,40,84
"2011","Vale of White Horse 002A","E01028733","Total",547,158,96,62,389,3,121,70,83,16,30,66
"2011","Vale of White Horse 002B","E01028734","Total",655,182,97,85,473,14,126,71,133,21,29,79
"2011","Vale of White Horse 002C","E01028735","Total",641,130,79,51,511,23,132,93,99,14,42,108
"2011","Vale of White Horse 002D","E01028740","Total",657,177,94,83,480,14,106,103,128,9,32,88
"2011","Vale of White Horse 002E","E01028741","Total",502,108,53,55,394,7,66,81,104,15,39,82
"2011","Vale of White Horse 002F","E01028742","Total",726,286,169,117,440,16,88,81,137,13,22,83
"2011","Vale of White Horse 003A","E01028738","Total",474,45,21,24,429,21,37,178,92,31,26,44
"2011","Vale of White Horse 003B","E01028739","Total",699,165,112,53,534,24,121,111,140,17,32,89
"2011","Vale of White Horse 003C","E01028743","Total",478,184,72,112,294,4,93,46,86,15,11,39
"2011","Vale of White Horse 003D","E01028744","Total",524,139,81,58,385,12,92,49,110,16,22,84
"2011","Vale of White Horse 003E","E01028750","Total",589,146,91,55,443,23,96,104,101,20,28,71
"2011","Vale of White Horse 003F","E01028751","Total",585,125,64,61,460,9,115,81,115,14,34,92
"2011","Vale of White Horse 003G","E01028752","Total",656,130,65,65,526,21,126,100,120,29,34,96
"2011","Vale of White Horse 004A","E01028693","Total",603,107,54,53,496,9,81,129,121,17,46,93
"2011","Vale of White Horse 004B","E01028694","Total",607,181,24,157,426,18,32,114,119,12,37,94
"2011","Vale of White Horse 004C","E01028701","Total",638,153,69,84,485,24,89,118,126,16,37,75
"2011","Vale of White Horse 004D","E01028705","Total",490,67,37,30,423,15,90,77,112,10,24,95
"2011","Vale of White Horse 004E","E01028706","Total",599,131,37,94,468,9,81,107,129,9,29,104
"2011","Vale of White Horse 004F","E01028707","Total",607,117,40,77,490,18,66,105,145,13,47,96
"2011","Vale of White Horse 005A","E01028688","Total",507,137,36,101,370,14,34,93,127,11,17,74
"2011","Vale of White Horse 005B","E01028689","Total",637,196,33,163,441,34,37,114,149,13,26,68
"2011","Vale of White Horse 005C","E01028695","Total",656,154,88,66,502,16,136,122,115,9,30,74
"2011","Vale of White Horse 005D","E01028699","Total",650,146,82,64,504,11,137,105,119,20,38,74
"2011","Vale of White Horse 006B","E01028696","Total",519,115,64,51,404,14,112,76,75,22,29,76
"2011","Vale of White Horse 006C","E01028697","Total",674,227,87,140,447,50,74,90,120,13,35,65
"2011","Vale of White Horse 006D","E01028698","Total",669,197,53,144,472,25,55,116,182,18,16,60
"2011","Vale of White Horse 006E","E01028700","Total",699,224,116,108,475,59,71,101,107,27,41,69
"2011","Vale of White Horse 006F","E01028703","Total",816,320,116,204,496,47,66,105,183,10,19,66
"2011","Vale of White Horse 006G","E01033305","Total",664,272,53,219,392,40,34,89,186,8,8,27
"2011","Vale of White Horse 006H","E01033306","Total",804,374,127,247,430,29,77,90,157,8,16,53
"2011","Vale of White Horse 007A","E01028726","Total",929,213,118,95,716,15,189,135,210,20,39,108
"2011","Vale of White Horse 007B","E01028736","Total",935,183,85,98,752,33,156,171,214,25,41,112
"2011","Vale of White Horse 007C","E01028737","Total",948,215,88,127,733,28,188,140,176,36,49,116
"2011","Vale of White Horse 008A","E01028690","Total",712,202,69,133,510,32,122,85,140,18,22,91
"2011","Vale of White Horse 008B","E01028691","Total",611,193,113,80,418,22,89,62,100,18,28,99
"2011","Vale of White Horse 008C","E01028692","Total",507,126,56,70,381,63,36,64,68,38,46,66
"2011","Vale of White Horse 008D","E01028702","Total",518,106,57,49,412,11,98,52,122,3,38,88
"2011","Vale of White Horse 008E","E01028704","Total",853,297,148,149,556,44,103,119,162,17,28,83
"2011","Vale of White Horse 009A","E01028716","Total",749,170,47,123,579,45,56,173,181,19,39,66
"2011","Vale of White Horse 009B","E01028717","Total",820,400,156,244,420,29,76,94,135,11,32,43
"2011","Vale of White Horse 009C","E01028718","Total",609,182,71,111,427,26,60,100,112,25,39,65
"2011","Vale of White Horse 009D","E01028719","Total",654,131,81,50,523,13,142,101,144,9,26,88
"2011","Vale of White Horse 009E","E01028749","Total",990,242,105,137,748,32,186,160,188,39,55,88
"2011","Vale of White Horse 010A","E01028714","Total",958,247,144,103,711,26,161,147,160,30,52,135
"2011","Vale of White Horse 010B","E01028731","Total",542,147,93,54,395,14,101,79,85,10,32,74
"2011","Vale of White Horse 010C","E01028732","Total",502,136,39,97,366,21,54,89,125,15,20,42
"2011","Vale of White Horse 010D","E01028753","Total",585,148,71,77,437,31,104,75,92,18,31,86
"2011","Vale of White Horse 010E","E01028754","Total",569,157,61,96,412,15,91,75,109,16,26,80
"2011","Vale of White Horse 011A","E01028721","Total",517,102,23,79,415,25,48,109,121,15,29,68
"2011","Vale of White Horse 011B","E01028722","Total",690,190,78,112,500,15,146,90,116,16,35,82
"2011","Vale of White Horse 011C","E01028723","Total",590,133,87,46,457,15,145,68,93,12,40,84
"2011","Vale of White Horse 011D","E01028724","Total",505,92,38,54,413,15,83,84,108,14,28,81
"2011","Vale of White Horse 011E","E01028725","Total",616,165,61,104,451,36,44,105,134,18,36,78
"2011","Vale of White Horse 014A","E01028755","Total",686,187,118,69,499,28,123,91,106,31,37,83
"2011","Vale of White Horse 014B","E01028756","Total",1167,471,167,304,696,63,117,145,258,28,19,66
"2011","Vale of White Horse 014C","E01028758","Total",609,134,102,32,475,9,143,81,81,17,47,97
"2011","Vale of White Horse 014D","E01028759","Total",623,167,75,92,456,14,90,85,119,19,38,91
"2011","Vale of White Horse 014E","E01028760","Total",479,86,49,37,393,21,63,88,105,17,27,72
"2011","Vale of White Horse 014F","E01028761","Total",510,93,24,69,417,16,65,101,112,19,33,71
"2011","Vale of White Horse 015A","E01028712","Total",880,244,130,114,636,23,178,121,184,21,31,78
"2011","Vale of White Horse 015B","E01028727","Total",661,148,83,65,513,16,129,102,131,18,34,83
"2011","Vale of White Horse 015C","E01028728","Total",479,124,72,52,355,17,83,70,91,12,31,51
"2011","Vale of White Horse 015D","E01028729","Total",437,96,40,56,341,15,60,82,107,15,12,50
"2011","Vale of White Horse 015E","E01028730","Total",648,149,71,78,499,10,117,106,125,25,36,80
"2011","Vale of White Horse 015F","E01028757","Total",643,217,106,111,426,45,85,75,116,22,28,55
"2011","Vale of White Horse 016E","E01028713","Total",972,232,99,133,740,18,161,150,218,36,37,120
"2011","Vale of White Horse 016F","E01028715","Total",554,121,44,77,433,18,102,103,120,16,25,49
"2011","Vale of White Horse 016G","E01028720","Total",910,210,112,98,700,17,179,116,198,34,44,112
"2011","Vale of White Horse 016A","E01028745","Total",546,145,71,74,401,15,103,80,124,19,17,43
"2011","Vale of White Horse 016B","E01028746","Total",510,128,69,59,382,10,105,69,85,14,29,70
"2011","Vale of White Horse 016C","E01028747","Total",450,71,23,48,379,9,41,138,98,28,22,43
"2011","Vale of White Horse 016D","E01028748","Total",423,114,44,70,309,14,29,115,80,21,10,40
"2011","West Oxfordshire 001A","E01028780","Total",909,283,128,155,626,31,144,128,200,21,31,71
"2011","West Oxfordshire 001B","E01028781","Total",516,153,85,68,363,32,72,76,64,12,32,75
"2011","West Oxfordshire 001C","E01028782","Total",643,160,86,74,483,21,99,98,133,19,35,78
"2011","West Oxfordshire 001D","E01028783","Total",747,298,158,140,449,35,90,82,151,8,18,65
"2011","West Oxfordshire 002A","E01028795","Total",658,170,79,91,488,11,120,84,144,25,22,82
"2011","West Oxfordshire 002B","E01028796","Total",518,151,69,82,367,15,97,92,97,13,19,34
"2011","West Oxfordshire 002C","E01028797","Total",453,112,49,63,341,3,82,76,85,18,19,58
"2011","West Oxfordshire 002D","E01028806","Total",816,190,91,99,626,19,144,141,168,23,34,97
"2011","West Oxfordshire 003A","E01028763","Total",831,211,116,95,620,23,158,118,185,31,25,80
"2011","West Oxfordshire 003B","E01028776","Total",809,225,113,112,584,8,143,97,163,35,44,94
"2011","West Oxfordshire 003C","E01028798","Total",871,249,133,116,622,25,173,137,139,28,31,89
"2011","West Oxfordshire 004B","E01028804","Total",544,137,82,55,407,18,105,89,94,21,27,53
"2011","West Oxfordshire 004D","E01028823","Total",634,247,125,122,387,25,96,75,138,10,4,39
"2011","West Oxfordshire 004E","E01028824","Total",664,196,120,76,468,20,112,102,120,13,34,67
"2011","West Oxfordshire 004F","E01028825","Total",497,125,74,51,372,14,108,84,85,13,20,48
"2011","West Oxfordshire 004G","E01032954","Total",1130,288,153,135,842,35,206,174,216,36,45,130
"2011","West Oxfordshire 005A","E01028777","Total",530,195,87,108,335,20,76,55,116,13,15,40
"2011","West Oxfordshire 005B","E01028778","Total",658,213,134,79,445,23,113,83,109,17,20,80
"2011","West Oxfordshire 005C","E01028779","Total",452,108,49,59,344,11,89,58,100,6,22,58
"2011","West Oxfordshire 005D","E01028799","Total",779,168,95,73,611,13,170,100,149,18,49,112
"2011","West Oxfordshire 006A","E01028788","Total",700,209,106,103,491,7,134,105,125,13,29,78
"2011","West Oxfordshire 006B","E01028789","Total",605,145,79,66,460,6,108,97,123,12,29,85
"2011","West Oxfordshire 006C","E01028790","Total",465,91,47,44,374,4,91,68,97,19,31,64
"2011","West Oxfordshire 006D","E01028791","Total",587,106,56,50,481,6,128,87,115,13,35,97
"2011","West Oxfordshire 007A","E01028784","Total",853,186,95,91,667,20,146,120,172,27,44,138
"2011","West Oxfordshire 007B","E01028792","Total",459,113,60,53,346,9,99,58,92,16,12,60
"2011","West Oxfordshire 007C","E01028793","Total",620,156,67,89,464,26,93,92,129,17,42,65
"2011","West Oxfordshire 007D","E01028794","Total",578,124,73,51,454,13,123,79,111,8,31,89
"2011","West Oxfordshire 008A","E01028810","Total",587,185,41,144,402,17,52,93,127,10,36,67
"2011","West Oxfordshire 008B","E01028811","Total",592,168,83,85,424,38,71,84,118,15,28,70
"2011","West Oxfordshire 008D","E01028813","Total",489,114,42,72,375,24,63,75,82,18,36,77
"2011","West Oxfordshire 008E","E01028814","Total",606,164,76,88,442,18,93,78,132,13,33,75
"2011","West Oxfordshire 008F","E01028815","Total",497,81,51,30,416,3,118,76,103,7,21,88
"2011","West Oxfordshire 008G","E01032947","Total",693,132,8,124,561,54,18,203,185,26,27,48
"2011","West Oxfordshire 008H","E01032948","Total",706,123,37,86,583,17,95,166,173,32,33,67
"2011","West Oxfordshire 008I","E01032952","Total",620,209,86,123,411,24,70,77,139,10,28,63
"2011","West Oxfordshire 009A","E01028809","Total",522,101,73,28,421,47,105,57,82,32,31,67
"2011","West Oxfordshire 009B","E01028820","Total",525,124,24,100,401,13,36,113,126,12,37,64
"2011","West Oxfordshire 009C","E01028821","Total",626,175,37,138,451,32,39,108,157,21,35,59
"2011","West Oxfordshire 009D","E01028822","Total",578,142,33,109,436,10,45,120,147,16,25,73
"2011","West Oxfordshire 010A","E01028807","Total",1005,350,123,227,655,37,106,117,260,18,24,93
"2011","West Oxfordshire 010B","E01028808","Total",725,178,65,113,547,37,124,90,149,19,39,89
"2011","West Oxfordshire 010C","E01028816","Total",491,84,39,45,407,9,66,83,86,21,39,103
"2011","West Oxfordshire 010D","E01028817","Total",591,147,61,86,444,25,74,81,117,19,36,92
"2011","West Oxfordshire 010E","E01028818","Total",836,360,210,150,476,37,105,77,130,17,31,79
"2011","West Oxfordshire 010F","E01028819","Total",732,273,176,97,459,46,106,64,117,20,26,80
"2011","West Oxfordshire 011A","E01028785","Total",658,185,98,87,473,26,101,97,119,12,31,87
"2011","West Oxfordshire 011B","E01028786","Total",518,106,70,36,412,6,126,73,90,8,26,83
"2011","West Oxfordshire 011C","E01028787","Total",542,143,74,69,399,21,95,67,103,18,27,68
"2011","West Oxfordshire 011D","E01028800","Total",518,112,57,55,406,19,75,89,105,20,27,71
"2011","West Oxfordshire 012A","E01028762","Total",749,192,85,107,557,16,112,114,190,24,30,71
"2011","West Oxfordshire 012B","E01028766","Total",834,212,96,116,622,29,135,114,211,24,27,82
"2011","West Oxfordshire 012C","E01028767","Total",863,296,183,113,567,17,202,80,165,17,18,68
"2011","West Oxfordshire 013D","E01028772","Total",748,189,47,142,559,27,100,109,209,10,18,86
"2011","West Oxfordshire 013E","E01032949","Total",577,125,7,118,452,36,12,123,184,16,31,50
"2011","West Oxfordshire 013F","E01032950","Total",679,129,15,114,550,50,14,170,217,24,29,46
"2011","West Oxfordshire 013G","E01032951","Total",710,116,26,90,594,39,48,200,154,31,47,75
"2011","West Oxfordshire 013H","E01032953","Total",850,136,36,100,714,39,87,239,217,24,36,72
"2011","West Oxfordshire 014A","E01028771","Total",653,209,109,100,444,23,100,63,125,13,28,92
"2011","West Oxfordshire 014B","E01028773","Total",578,186,72,114,392,19,91,67,103,4,31,77
"2011","West Oxfordshire 014C","E01028774","Total",531,114,41,73,417,23,39,132,84,24,40,75
"2011","West Oxfordshire 014D","E01028775","Total",559,161,60,101,398,12,72,69,127,8,27,83
"2011","West Oxfordshire 015A","E01028764","Total",760,199,104,95,561,18,147,96,165,19,27,89
"2011","West Oxfordshire 015B","E01028765","Total",822,228,137,91,594,25,144,121,142,26,38,98
"2011","West Oxfordshire 015C","E01028801","Total",545,125,58,67,420,13,79,91,113,18,31,75
"2011","West Oxfordshire 015D","E01028802","Total",600,130,70,60,470,10,126,89,135,23,31,56
"2011","Elmbridge 001A","E01030330","Total",655,180,79,101,475,17,101,108,130,12,34,73
"2011","Elmbridge 001B","E01030331","Total",679,193,70,123,486,28,87,112,157,11,25,66
"2011","Elmbridge 001C","E01030332","Total",593,156,90,66,437,26,87,94,98,12,37,83
"2011","Elmbridge 001D","E01030333","Total",582,155,78,77,427,14,98,94,84,12,36,89
"2011","Elmbridge 002A","E01030326","Total",785,313,100,213,472,16,81,89,179,14,28,65
"2011","Elmbridge 002B","E01030327","Total",642,175,74,101,467,10,93,112,122,19,33,78
"2011","Elmbridge 002C","E01030328","Total",630,126,71,55,504,4,91,164,114,19,34,78
"2011","Elmbridge 002D","E01030329","Total",628,190,91,99,438,15,89,108,125,10,30,61
"2011","Elmbridge 003A","E01030334","Total",543,126,64,62,417,20,72,74,80,14,42,115
"2011","Elmbridge 003B","E01030335","Total",755,221,88,133,534,32,90,128,124,31,37,92
"2011","Elmbridge 003C","E01030336","Total",795,234,91,143,561,52,65,145,162,24,31,82
"2011","Elmbridge 003D","E01030337","Total",731,300,155,145,431,28,73,99,113,15,31,72
"2011","Elmbridge 004A","E01030361","Total",811,226,92,134,585,25,71,175,161,17,42,94
"2011","Elmbridge 004B","E01030362","Total",481,140,49,91,341,28,58,70,85,13,35,52
"2011","Elmbridge 004C","E01030363","Total",785,235,71,164,550,41,73,143,159,19,29,86
"2011","Elmbridge 004D","E01030364","Total",710,278,44,234,432,45,24,105,159,19,17,63
"2011","Elmbridge 005A","E01030350","Total",686,187,86,101,499,17,87,138,150,26,17,64
"2011","Elmbridge 005B","E01030351","Total",634,175,75,100,459,13,62,136,141,23,27,57
"2011","Elmbridge 005C","E01030352","Total",581,146,82,64,435,20,74,103,97,38,33,70
"2011","Elmbridge 005D","E01030353","Total",550,105,51,54,445,12,47,129,127,38,32,60
"2011","Elmbridge 006A","E01030322","Total",751,211,78,133,540,16,62,172,170,23,29,68
"2011","Elmbridge 006B","E01030323","Total",524,118,58,60,406,6,77,109,86,25,28,75
"2011","Elmbridge 006C","E01030324","Total",639,157,76,81,482,23,60,128,153,21,31,66
"2011","Elmbridge 006D","E01030325","Total",590,145,85,60,445,7,81,122,90,21,40,84
"2011","Elmbridge 007A","E01030357","Total",729,254,129,125,475,19,95,114,145,11,15,76
"2011","Elmbridge 007B","E01030358","Total",618,175,78,97,443,19,83,109,127,14,26,65
"2011","Elmbridge 007C","E01030359","Total",1054,382,119,263,672,50,101,149,253,21,23,75
"2011","Elmbridge 007D","E01030360","Total",662,184,86,98,478,30,74,91,144,19,38,82
"2011","Elmbridge 008A","E01030354","Total",541,122,39,83,419,44,35,107,95,20,43,75
"2011","Elmbridge 008B","E01030355","Total",515,94,43,51,421,15,53,125,104,24,24,76
"2011","Elmbridge 008C","E01030356","Total",507,101,53,48,406,18,55,125,96,20,27,65
"2011","Elmbridge 008D","E01030365","Total",603,131,47,84,472,16,81,118,130,15,37,75
"2011","Elmbridge 008E","E01030368","Total",607,113,56,57,494,23,103,138,107,18,25,80
"2011","Elmbridge 009A","E01030319","Total",608,86,52,34,522,17,106,159,90,20,49,81
"2011","Elmbridge 009B","E01030320","Total",678,190,118,72,488,25,57,147,110,22,47,80
"2011","Elmbridge 009C","E01030321","Total",573,104,76,28,469,7,100,129,88,20,44,81
"2011","Elmbridge 009D","E01030369","Total",775,95,66,29,680,13,121,196,143,38,68,101
"2011","Elmbridge 009E","E01030370","Total",592,123,73,50,469,17,67,158,96,29,37,65
"2011","Elmbridge 010A","E01030313","Total",644,187,93,94,457,30,64,130,115,14,28,76
"2011","Elmbridge 010B","E01030314","Total",645,190,103,87,455,14,81,124,127,22,28,59
"2011","Elmbridge 010C","E01030366","Total",815,296,92,204,519,27,81,109,170,17,35,80
"2011","Elmbridge 010D","E01030367","Total",618,127,64,63,491,7,120,98,105,22,38,101
"2011","Elmbridge 011A","E01030338","Total",619,125,70,55,494,8,107,172,85,25,40,57
"2011","Elmbridge 011B","E01030339","Total",683,274,110,164,409,21,88,104,141,9,11,35
"2011","Elmbridge 011C","E01030340","Total",620,199,108,91,421,21,80,100,93,22,35,70
"2011","Elmbridge 011D","E01030341","Total",740,198,98,100,542,12,125,141,127,24,32,81
"2011","Elmbridge 012A","E01030371","Total",711,291,87,204,420,27,63,85,144,18,21,62
"2011","Elmbridge 012B","E01030372","Total",546,200,106,94,346,18,43,118,81,16,26,44
"2011","Elmbridge 012C","E01030373","Total",657,193,73,120,464,23,69,144,134,19,24,51
"2011","Elmbridge 012D","E01030374","Total",771,312,131,181,459,12,87,105,156,19,19,61
"2011","Elmbridge 012E","E01030375","Total",781,296,94,202,485,28,59,128,165,23,27,55
"2011","Elmbridge 012F","E01030376","Total",536,147,62,85,389,25,66,99,119,12,21,47
"2011","Elmbridge 013A","E01030307","Total",646,147,61,86,499,11,99,122,110,32,42,83
"2011","Elmbridge 013B","E01030308","Total",645,166,89,77,479,9,118,117,90,23,33,89
"2011","Elmbridge 013C","E01030309","Total",619,161,95,66,458,14,124,93,95,25,38,69
"2011","Elmbridge 013D","E01030310","Total",728,179,54,125,549,65,48,138,134,23,47,94
"2011","Elmbridge 014A","E01030311","Total",662,226,127,99,436,33,86,93,96,22,27,79
"2011","Elmbridge 014B","E01030312","Total",518,120,41,79,398,29,49,90,103,9,35,83
"2011","Elmbridge 014C","E01030315","Total",636,159,70,89,477,25,83,135,99,17,31,87
"2011","Elmbridge 014D","E01030316","Total",635,154,74,80,481,10,119,117,101,24,40,70
"2011","Elmbridge 014E","E01030317","Total",749,262,123,139,487,20,107,110,121,21,30,78
"2011","Elmbridge 014F","E01030318","Total",644,264,230,34,380,3,137,64,51,21,42,62
"2011","Elmbridge 015A","E01030296","Total",649,115,71,44,534,11,123,139,97,30,30,104
"2011","Elmbridge 015B","E01030297","Total",823,173,106,67,650,17,147,169,138,37,38,104
"2011","Elmbridge 015C","E01030298","Total",679,238,180,58,441,21,93,117,97,18,37,58
"2011","Elmbridge 015D","E01030299","Total",637,152,74,78,485,20,78,134,114,16,34,89
"2011","Elmbridge 016A","E01030346","Total",519,102,27,75,417,17,66,91,99,36,39,69
"2011","Elmbridge 016B","E01030347","Total",681,205,50,155,476,27,47,145,134,17,36,70
"2011","Elmbridge 016C","E01030348","Total",664,177,78,99,487,8,89,128,139,20,33,70
"2011","Elmbridge 016D","E01030349","Total",703,209,87,122,494,16,111,120,142,21,29,55
"2011","Elmbridge 017A","E01030300","Total",756,287,150,137,469,37,82,126,125,9,17,73
"2011","Elmbridge 017B","E01030301","Total",601,148,76,72,453,13,99,117,89,30,37,68
"2011","Elmbridge 017C","E01030302","Total",711,270,145,125,441,19,111,93,121,10,24,63
"2011","Elmbridge 017D","E01030304","Total",696,217,85,132,479,55,60,107,124,17,22,94
"2011","Elmbridge 017E","E01030305","Total",520,68,39,29,452,8,85,126,81,41,42,69
"2011","Elmbridge 017F","E01030306","Total",481,70,37,33,411,8,78,119,67,37,48,54
"2011","Elmbridge 018A","E01030303","Total",690,138,75,63,552,10,137,147,126,37,40,55
"2011","Elmbridge 018B","E01030342","Total",613,131,84,47,482,6,118,104,92,32,59,71
"2011","Elmbridge 018C","E01030343","Total",637,135,68,67,502,8,91,154,108,17,51,73
"2011","Elmbridge 018D","E01030344","Total",526,72,45,27,454,7,90,108,81,32,52,84
"2011","Elmbridge 018E","E01030345","Total",646,142,78,64,504,22,106,138,105,26,33,74
"2011","Epsom and Ewell 001A","E01030386","Total",533,79,44,35,454,6,108,83,96,15,32,114
"2011","Epsom and Ewell 001B","E01030387","Total",643,142,57,85,501,25,62,134,129,12,56,83
"2011","Epsom and Ewell 001C","E01030388","Total",520,111,67,44,409,13,95,81,92,8,28,92
"2011","Epsom and Ewell 001D","E01030389","Total",670,235,126,109,435,27,71,85,121,11,36,84
"2011","Epsom and Ewell 001E","E01030393","Total",821,261,149,112,560,11,163,89,111,13,41,132
"2011","Epsom and Ewell 002A","E01030394","Total",636,101,60,41,535,12,100,122,95,23,53,130
"2011","Epsom and Ewell 002B","E01030399","Total",911,314,125,189,597,38,96,145,158,16,44,100
"2011","Epsom and Ewell 002C","E01030400","Total",599,122,37,85,477,83,44,94,98,30,56,72
"2011","Epsom and Ewell 002D","E01030414","Total",524,138,68,70,386,23,52,87,87,15,45,77
"2011","Epsom and Ewell 003A","E01030377","Total",901,177,113,64,724,17,173,169,135,33,51,146
"2011","Epsom and Ewell 003B","E01030378","Total",611,120,55,65,491,21,115,101,115,11,31,97
"2011","Epsom and Ewell 003C","E01030406","Total",613,133,67,66,480,20,89,92,107,16,48,108
"2011","Epsom and Ewell 003D","E01030407","Total",537,112,71,41,425,6,109,85,78,14,31,102
"2011","Epsom and Ewell 003E","E01030408","Total",641,93,66,27,548,4,111,113,99,25,57,139
"2011","Epsom and Ewell 004A","E01030395","Total",763,205,148,57,558,8,185,79,128,20,38,100
"2011","Epsom and Ewell 004B","E01030413","Total",743,124,57,67,619,39,70,184,135,29,46,116
"2011","Epsom and Ewell 004C","E01030415","Total",607,114,63,51,493,19,63,134,105,18,40,114
"2011","Epsom and Ewell 004D","E01030416","Total",525,123,71,52,402,11,82,74,91,13,35,96
"2011","Epsom and Ewell 005A","E01030383","Total",903,225,50,175,678,51,47,154,187,34,64,141
"2011","Epsom and Ewell 005B","E01030384","Total",980,198,44,154,782,62,49,258,195,39,55,124
"2011","Epsom and Ewell 005C","E01030401","Total",1015,274,117,157,741,30,135,180,195,29,48,124
"2011","Epsom and Ewell 005D","E01030402","Total",481,104,33,71,377,37,40,122,86,14,22,56
"2011","Epsom and Ewell 007A","E01030385","Total",684,246,124,122,438,40,59,73,96,23,49,98
"2011","Epsom and Ewell 007B","E01030391","Total",829,302,134,168,527,27,86,122,143,18,23,108
"2011","Epsom and Ewell 007C","E01030403","Total",591,132,73,59,459,23,94,115,84,19,37,87
"2011","Epsom and Ewell 007D","E01030404","Total",626,137,85,52,489,10,110,111,114,29,19,96
"2011","Epsom and Ewell 007E","E01030409","Total",524,105,48,57,419,19,63,81,66,14,39,137
"2011","Epsom and Ewell 007F","E01030410","Total",592,186,44,142,406,33,33,112,112,17,19,80
"2011","Epsom and Ewell 008A","E01030381","Total",646,242,138,104,404,15,85,74,110,22,33,65
"2011","Epsom and Ewell 008B","E01030411","Total",1077,507,199,308,570,35,59,116,249,9,17,85
"2011","Epsom and Ewell 008C","E01030412","Total",961,411,165,246,550,42,83,112,228,11,13,61
"2011","Epsom and Ewell 008D","E01030419","Total",708,240,126,114,468,15,110,126,112,23,20,62
"2011","Epsom and Ewell 009A","E01030379","Total",502,128,59,69,374,13,62,96,87,12,33,71
"2011","Epsom and Ewell 009B","E01030380","Total",509,87,64,23,422,6,113,88,80,23,35,77
"2011","Epsom and Ewell 009C","E01030405","Total",650,156,62,94,494,25,87,129,132,21,32,68
"2011","Epsom and Ewell 009D","E01030417","Total",523,114,67,47,409,9,107,95,82,22,33,61
"2011","Epsom and Ewell 009E","E01030418","Total",566,112,50,62,454,11,92,120,105,9,32,85
"2011","Epsom and Ewell 009F","E01030420","Total",489,147,100,47,342,23,59,76,75,18,29,62
"2011","Epsom and Ewell 010A","E01030382","Total",591,174,67,107,417,8,94,84,112,17,34,68
"2011","Epsom and Ewell 010B","E01030390","Total",811,286,129,157,525,40,87,141,161,10,27,59
"2011","Epsom and Ewell 010C","E01030392","Total",799,234,131,103,565,21,130,106,144,19,39,106
"2011","Epsom and Ewell 010D","E01030396","Total",646,102,64,38,544,4,137,112,96,24,60,111
"2011","Epsom and Ewell 010E","E01030398","Total",626,96,66,30,530,2,120,102,89,24,59,134
"2011","Epsom and Ewell 010F","E01032624","Total",657,81,63,18,576,4,156,117,83,24,55,137
"2011","Guildford 001A","E01030440","Total",617,119,64,55,498,16,127,102,107,32,39,75
"2011","Guildford 001B","E01030458","Total",524,139,62,77,385,8,83,77,111,20,22,64
"2011","Guildford 001C","E01030459","Total",485,156,77,79,329,16,74,74,79,14,19,53
"2011","Guildford 001D","E01030475","Total",505,100,59,41,405,9,103,82,84,17,34,76
"2011","Guildford 001E","E01030476","Total",456,55,29,26,401,4,98,97,91,14,31,66
"2011","Guildford 001F","E01030477","Total",704,206,99,107,498,28,111,106,124,23,32,74
"2011","Guildford 002A","E01030465","Total",584,127,67,60,457,15,100,89,135,19,22,77
"2011","Guildford 002B","E01030466","Total",726,221,124,97,505,10,189,81,128,21,16,60
"2011","Guildford 002C","E01030473","Total",655,123,58,65,532,14,81,146,139,25,34,93
"2011","Guildford 002D","E01030474","Total",446,11,1,10,435,14,4,197,116,31,37,36
"2011","Guildford 003A","E01030441","Total",514,112,71,41,402,16,109,79,90,16,21,71
"2011","Guildford 003B","E01030442","Total",557,85,61,24,472,6,145,98,81,21,39,82
"2011","Guildford 003C","E01030443","Total",534,100,70,30,434,15,119,100,102,19,30,49
"2011","Guildford 003D","E01030444","Total",597,129,82,47,468,16,112,116,90,32,28,74
"2011","Guildford 003E","E01030445","Total",606,197,128,69,409,15,96,83,102,20,30,63
"2011","Guildford 003F","E01030446","Total",508,113,72,41,395,10,101,78,81,20,39,66
"2011","Guildford 003G","E01030447","Total",546,132,74,58,414,20,99,89,87,18,26,75
"2011","Guildford 004A","E01030426","Total",614,147,22,125,467,32,43,125,176,20,24,47
"2011","Guildford 004B","E01030427","Total",610,139,63,76,471,20,78,113,140,12,23,85
"2011","Guildford 004C","E01030428","Total",510,133,65,68,377,15,93,75,107,14,30,43
"2011","Guildford 004D","E01030429","Total",718,277,56,221,441,37,59,113,152,14,20,46
"2011","Guildford 004E","E01030430","Total",627,145,66,79,482,13,145,84,124,11,19,86
"2011","Guildford 005A","E01030499","Total",645,155,96,59,490,12,155,88,103,16,31,85
"2011","Guildford 005B","E01030500","Total",605,136,58,78,469,12,107,101,102,16,26,105
"2011","Guildford 005C","E01030501","Total",642,136,49,87,506,22,74,128,151,19,29,83
"2011","Guildford 005D","E01030502","Total",500,125,67,58,375,16,82,56,105,8,30,78
"2011","Guildford 005E","E01030503","Total",572,146,38,108,426,34,45,116,117,14,33,67
"2011","Guildford 005F","E01030504","Total",492,138,93,45,354,10,118,61,78,7,26,54
"2011","Guildford 006A","E01030485","Total",741,215,49,166,526,32,46,116,183,16,19,114
"2011","Guildford 006B","E01030487","Total",638,168,67,101,470,20,48,97,133,12,26,134
"2011","Guildford 006C","E01030488","Total",780,194,92,102,586,27,71,159,159,21,47,102
"2011","Guildford 006D","E01030489","Total",947,205,60,145,742,32,54,231,223,31,47,124
"2011","Guildford 007A","E01030481","Total",632,130,65,65,502,27,78,72,118,34,43,130
"2011","Guildford 007B","E01030482","Total",513,104,41,63,409,27,47,87,97,13,30,108
"2011","Guildford 007C","E01030483","Total",587,198,89,109,389,48,51,62,94,15,27,92
"2011","Guildford 007D","E01030484","Total",668,180,64,116,488,24,61,90,140,18,36,119
"2011","Guildford 008A","E01030434","Total",738,264,42,222,474,26,46,153,159,19,20,51
"2011","Guildford 008B","E01030435","Total",647,117,76,41,530,18,116,146,101,24,48,77
"2011","Guildford 008C","E01030462","Total",746,268,153,115,478,26,82,108,130,12,41,79
"2011","Guildford 008D","E01030463","Total",628,175,60,115,453,24,61,109,140,9,29,81
"2011","Guildford 008E","E01030464","Total",645,190,82,108,455,38,67,103,79,25,57,86
"2011","Guildford 009A","E01030486","Total",611,110,47,63,501,11,77,120,124,17,34,118
"2011","Guildford 009B","E01030493","Total",510,141,73,68,369,24,37,73,89,13,20,113
"2011","Guildford 009C","E01030495","Total",643,139,72,67,504,9,73,84,104,8,26,200
"2011","Guildford 009D","E01030498","Total",510,92,44,48,418,9,54,92,105,16,27,115
"2011","Guildford 010A","E01030424","Total",661,205,106,99,456,43,77,105,121,16,24,70
"2011","Guildford 010B","E01030431","Total",627,163,96,67,464,16,122,74,135,12,32,73
"2011","Guildford 010C","E01030432","Total",630,169,65,104,461,30,81,97,135,22,27,69
"2011","Guildford 010D","E01030433","Total",694,197,63,134,497,31,70,92,169,15,40,80
"2011","Guildford 011A","E01030436","Total",982,333,139,194,649,28,102,159,183,29,35,113
"2011","Guildford 011B","E01030437","Total",694,152,71,81,542,21,121,109,141,27,36,87
"2011","Guildford 011C","E01030439","Total",639,118,68,50,521,7,139,120,74,26,50,105
"2011","Guildford 011D","E01030460","Total",633,162,91,71,471,8,120,101,104,34,35,69
"2011","Guildford 011E","E01030461","Total",651,158,86,72,493,23,109,113,98,27,31,92
"2011","Guildford 012A","E01030470","Total",514,111,49,62,403,7,55,54,96,21,19,151
"2011","Guildford 012B","E01030494","Total",651,183,80,103,468,18,98,62,109,20,35,126
"2011","Guildford 012C","E01030496","Total",597,156,68,88,441,27,62,86,75,19,27,145
"2011","Guildford 012D","E01030497","Total",606,134,42,92,472,68,34,101,105,14,40,110
"2011","Guildford 013A","E01030438","Total",730,257,117,140,473,20,76,95,164,12,28,78
"2011","Guildford 013B","E01030450","Total",993,281,54,227,712,26,31,148,272,17,29,189
"2011","Guildford 013C","E01030451","Total",864,313,54,259,551,25,40,114,250,6,15,101
"2011","Guildford 013D","E01030453","Total",774,355,75,280,419,7,47,92,199,13,13,48
"2011","Guildford 013E","E01030455","Total",836,389,109,280,447,15,55,55,231,10,10,71
"2011","Guildford 013F","E01030457","Total",780,336,58,278,444,26,26,85,184,9,16,98
"2011","Guildford 014A","E01030421","Total",617,139,59,80,478,16,115,91,149,13,25,69
"2011","Guildford 014B","E01030422","Total",650,215,81,134,435,25,64,100,132,13,25,76
"2011","Guildford 014C","E01030423","Total",712,198,77,121,514,16,112,99,163,21,28,75
"2011","Guildford 014D","E01030425","Total",657,167,63,104,490,9,110,106,131,15,30,89
"2011","Guildford 015A","E01030452","Total",834,278,48,230,556,9,30,90,226,10,18,173
"2011","Guildford 015B","E01030467","Total",633,145,83,62,488,6,98,109,107,30,30,108
"2011","Guildford 015C","E01030468","Total",497,171,106,65,326,6,27,35,84,11,19,144
"2011","Guildford 015D","E01030469","Total",508,88,52,36,420,15,74,80,79,27,24,121
"2011","Guildford 016A","E01030448","Total",614,128,54,74,486,4,99,100,156,18,25,84
"2011","Guildford 016B","E01030449","Total",674,322,139,183,352,8,69,63,158,9,11,34
"2011","Guildford 016C","E01030454","Total",729,236,96,140,493,25,69,130,144,21,32,72
"2011","Guildford 016D","E01030456","Total",542,92,62,30,450,7,109,82,103,34,33,82
"2011","Guildford 017A","E01030471","Total",482,78,47,31,404,4,108,80,112,18,28,54
"2011","Guildford 017B","E01030472","Total",508,125,61,64,383,11,75,103,96,20,18,60
"2011","Guildford 017C","E01030478","Total",686,158,66,92,528,13,121,107,131,22,37,97
"2011","Guildford 017D","E01030479","Total",759,213,104,109,546,35,90,141,169,18,34,59
"2011","Guildford 017E","E01030480","Total",785,227,136,91,558,9,152,140,135,32,24,66
"2011","Guildford 018A","E01030490","Total",662,169,90,79,493,12,120,106,126,16,37,76
"2011","Guildford 018B","E01030491","Total",789,253,119,134,536,21,119,116,135,25,36,84
"2011","Guildford 018C","E01030492","Total",796,156,79,77,640,8,163,131,167,29,37,105
"2011","Mole Valley 001A","E01030506","Total",486,80,58,22,406,7,74,107,77,19,32,90
"2011","Mole Valley 001B","E01030508","Total",513,100,76,24,413,7,141,56,85,17,47,60
"2011","Mole Valley 001C","E01030509","Total",519,194,99,95,325,11,91,83,77,4,12,47
"2011","Mole Valley 001D","E01030513","Total",520,99,56,43,421,16,95,96,69,19,46,80
"2011","Mole Valley 001E","E01030514","Total",639,209,138,71,430,13,104,104,93,29,18,69
"2011","Mole Valley 002A","E01030505","Total",630,168,80,88,462,22,93,97,111,16,32,91
"2011","Mole Valley 002B","E01030507","Total",501,127,75,52,374,7,74,98,106,17,25,47
"2011","Mole Valley 002C","E01030511","Total",545,100,60,40,445,7,115,97,86,30,31,79
"2011","Mole Valley 002D","E01030512","Total",664,205,136,69,459,8,121,105,112,22,19,72
"2011","Mole Valley 003A","E01030548","Total",709,185,31,154,524,36,56,109,158,36,44,85
"2011","Mole Valley 003B","E01030549","Total",826,283,70,213,543,38,56,118,207,19,32,73
"2011","Mole Valley 003C","E01030550","Total",958,501,184,317,457,26,82,96,172,9,17,55
"2011","Mole Valley 003D","E01030551","Total",684,219,82,137,465,51,57,103,121,17,35,81
"2011","Mole Valley 004A","E01030510","Total",622,134,94,40,488,10,119,120,107,19,34,79
"2011","Mole Valley 004B","E01030552","Total",680,332,155,177,348,14,51,79,132,7,18,47
"2011","Mole Valley 004C","E01030553","Total",786,289,147,142,497,12,141,94,131,18,31,70
"2011","Mole Valley 004D","E01030554","Total",447,81,59,22,366,3,120,67,72,16,27,61
"2011","Mole Valley 005A","E01030539","Total",694,173,74,99,521,21,98,120,121,22,36,103
"2011","Mole Valley 005B","E01030540","Total",814,132,96,36,682,4,257,96,121,20,49,135
"2011","Mole Valley 005C","E01030541","Total",515,85,58,27,430,6,125,81,81,14,36,87
"2011","Mole Valley 005D","E01030542","Total",485,104,59,45,381,14,77,104,67,13,28,78
"2011","Mole Valley 005E","E01030543","Total",604,148,63,85,456,18,92,121,114,20,27,64
"2011","Mole Valley 006A","E01030516","Total",644,299,154,145,345,25,110,68,76,12,19,35
"2011","Mole Valley 006B","E01030517","Total",634,154,78,76,480,8,152,89,89,23,30,89
"2011","Mole Valley 006C","E01030518","Total",544,105,89,16,439,3,167,73,66,15,34,81
"2011","Mole Valley 006D","E01030519","Total",622,148,100,48,474,24,114,92,94,32,44,74
"2011","Mole Valley 007A","E01030520","Total",655,227,150,77,428,23,125,89,85,18,24,64
"2011","Mole Valley 007B","E01030521","Total",684,190,104,86,494,19,126,101,109,12,43,84
"2011","Mole Valley 007C","E01030522","Total",524,106,69,37,418,8,124,77,88,16,28,77
"2011","Mole Valley 007D","E01030523","Total",533,175,108,67,358,10,121,70,64,18,19,56
"2011","Mole Valley 008A","E01030524","Total",1013,387,187,200,626,9,242,78,168,18,28,83
"2011","Mole Valley 008B","E01030525","Total",643,173,107,66,470,11,128,92,105,19,34,81
"2011","Mole Valley 008C","E01030526","Total",548,137,89,48,411,18,89,102,97,12,27,66
"2011","Mole Valley 008D","E01030527","Total",662,178,90,88,484,13,146,85,122,18,29,71
"2011","Mole Valley 009A","E01030532","Total",639,192,66,126,447,22,62,129,126,18,22,68
"2011","Mole Valley 009B","E01030533","Total",517,117,67,50,400,9,69,115,75,21,27,84
"2011","Mole Valley 009C","E01030534","Total",686,341,181,160,345,24,68,62,124,8,12,47
"2011","Mole Valley 009D","E01030556","Total",804,242,115,127,562,11,130,100,182,22,36,81
"2011","Mole Valley 010A","E01030535","Total",802,286,152,134,516,14,86,134,136,29,22,95
"2011","Mole Valley 010B","E01030536","Total",786,280,120,160,506,21,106,105,147,17,38,72
"2011","Mole Valley 010C","E01030537","Total",745,253,145,108,492,11,118,97,138,18,36,74
"2011","Mole Valley 010D","E01030538","Total",692,235,85,150,457,20,61,105,140,17,31,83
"2011","Mole Valley 011A","E01030544","Total",643,171,88,83,472,14,98,86,138,26,29,81
"2011","Mole Valley 011B","E01030545","Total",695,216,63,153,479,26,67,125,169,9,28,55
"2011","Mole Valley 011C","E01030546","Total",679,192,88,104,487,33,79,104,125,21,43,82
"2011","Mole Valley 011D","E01030547","Total",686,206,89,117,480,75,90,84,97,17,28,89
"2011","Mole Valley 012A","E01030529","Total",684,173,77,96,511,24,92,105,145,20,39,86
"2011","Mole Valley 012B","E01030555","Total",680,138,74,64,542,27,112,91,153,26,42,91
"2011","Mole Valley 012C","E01030557","Total",757,165,77,88,592,21,129,120,160,28,42,92
"2011","Mole Valley 012D","E01030558","Total",918,262,111,151,656,21,162,171,149,27,42,84
"2011","Mole Valley 013A","E01030515","Total",863,281,143,138,582,23,148,107,167,21,26,90
"2011","Mole Valley 013B","E01030528","Total",597,161,78,83,436,10,113,88,108,14,38,65
"2011","Mole Valley 013C","E01030530","Total",497,96,58,38,401,11,113,74,83,18,33,69
"2011","Mole Valley 013D","E01030531","Total",911,243,100,143,668,22,127,121,187,14,61,136
"2011","Reigate and Banstead 001A","E01030603","Total",549,94,56,38,455,11,91,86,101,20,36,110
"2011","Reigate and Banstead 001B","E01030604","Total",636,161,86,75,475,17,115,93,112,16,37,85
"2011","Reigate and Banstead 001C","E01030605","Total",528,95,48,47,433,15,59,117,96,19,39,88
"2011","Reigate and Banstead 001D","E01030607","Total",668,128,77,51,540,8,127,99,125,12,58,111
"2011","Reigate and Banstead 002A","E01030559","Total",503,129,80,49,374,7,122,66,69,13,23,74
"2011","Reigate and Banstead 002B","E01030560","Total",764,334,190,144,430,31,111,77,129,11,13,58
"2011","Reigate and Banstead 002C","E01030561","Total",591,192,142,50,399,16,127,61,90,8,23,74
"2011","Reigate and Banstead 002D","E01030562","Total",567,189,74,115,378,27,65,81,101,10,28,66
"2011","Reigate and Banstead 002E","E01030563","Total",408,52,32,20,356,6,70,101,63,15,25,76
"2011","Reigate and Banstead 002F","E01030564","Total",516,101,56,45,415,14,82,98,76,28,30,87
"2011","Reigate and Banstead 003A","E01030606","Total",507,104,67,37,403,9,103,77,80,19,40,75
"2011","Reigate and Banstead 003B","E01030641","Total",625,147,76,71,478,11,102,95,112,21,48,89
"2011","Reigate and Banstead 003C","E01030642","Total",650,170,100,70,480,21,115,109,101,24,30,80
"2011","Reigate and Banstead 003D","E01030644","Total",505,93,56,37,412,0,129,76,82,5,34,86
"2011","Reigate and Banstead 004A","E01030565","Total",567,150,82,68,417,25,97,78,92,12,28,85
"2011","Reigate and Banstead 004B","E01030566","Total",550,94,41,53,456,8,74,145,99,15,41,74
"2011","Reigate and Banstead 004C","E01030567","Total",615,123,64,59,492,6,114,73,138,18,35,108
"2011","Reigate and Banstead 004D","E01030568","Total",568,91,41,50,477,6,107,109,96,14,42,103
"2011","Reigate and Banstead 004E","E01030569","Total",1025,241,55,186,784,65,74,210,203,47,66,119
"2011","Reigate and Banstead 005A","E01030608","Total",587,188,105,83,399,45,51,95,87,25,29,67
"2011","Reigate and Banstead 005B","E01030609","Total",589,147,71,76,442,67,40,118,89,23,41,64
"2011","Reigate and Banstead 005C","E01030640","Total",722,297,87,210,425,42,72,90,111,20,20,70
"2011","Reigate and Banstead 005D","E01030643","Total",621,236,126,110,385,29,72,94,103,11,22,54
"2011","Reigate and Banstead 006A","E01030635","Total",643,185,91,94,458,11,101,114,112,27,33,60
"2011","Reigate and Banstead 006B","E01030636","Total",449,81,40,41,368,9,79,78,73,11,33,85
"2011","Reigate and Banstead 006C","E01030637","Total",458,58,36,22,400,5,90,70,100,22,30,83
"2011","Reigate and Banstead 006D","E01030638","Total",602,128,79,49,474,11,114,91,109,18,44,87
"2011","Reigate and Banstead 006E","E01030639","Total",646,236,160,76,410,8,124,70,107,7,29,65
"2011","Reigate and Banstead 007A","E01030589","Total",646,93,48,45,553,6,163,87,118,16,53,110
"2011","Reigate and Banstead 007B","E01030590","Total",740,167,69,98,573,19,127,121,141,25,40,100
"2011","Reigate and Banstead 007C","E01030591","Total",538,141,70,71,397,8,90,79,97,14,29,80
"2011","Reigate and Banstead 007D","E01030592","Total",843,293,149,144,550,17,131,84,159,20,41,98
"2011","Reigate and Banstead 008A","E01030599","Total",670,276,93,183,394,56,29,72,89,24,35,89
"2011","Reigate and Banstead 008B","E01030600","Total",603,151,76,75,452,27,61,107,120,20,32,85
"2011","Reigate and Banstead 008C","E01030601","Total",591,152,77,75,439,25,46,122,99,27,47,73
"2011","Reigate and Banstead 008D","E01030602","Total",710,182,79,103,528,21,75,132,158,24,31,87
"2011","Reigate and Banstead 009A","E01030598","Total",651,174,96,78,477,22,97,93,143,20,30,72
"2011","Reigate and Banstead 009B","E01030623","Total",904,290,119,171,614,12,140,168,182,28,33,51
"2011","Reigate and Banstead 009C","E01030624","Total",523,145,61,84,378,14,83,94,104,33,22,28
"2011","Reigate and Banstead 009D","E01030625","Total",470,90,43,47,380,8,82,98,89,17,27,59
"2011","Reigate and Banstead 009E","E01030626","Total",442,133,59,74,309,6,91,58,72,13,15,54
"2011","Reigate and Banstead 009F","E01030627","Total",846,380,152,228,466,11,79,96,195,12,19,54
"2011","Reigate and Banstead 010A","E01030615","Total",650,223,65,158,427,49,33,112,103,16,28,86
"2011","Reigate and Banstead 010B","E01030616","Total",685,201,109,92,484,13,142,99,110,23,26,71
"2011","Reigate and Banstead 010C","E01030617","Total",697,197,92,105,500,17,107,95,152,17,34,78
"2011","Reigate and Banstead 010D","E01030618","Total",765,238,88,150,527,29,57,132,134,25,41,109
"2011","Reigate and Banstead 010E","E01030619","Total",624,230,115,115,394,38,70,83,76,27,30,70
"2011","Reigate and Banstead 010F","E01030622","Total",776,242,53,189,534,30,44,144,180,21,32,83
"2011","Reigate and Banstead 011A","E01030610","Total",543,176,56,120,367,31,60,89,90,20,28,49
"2011","Reigate and Banstead 011B","E01030611","Total",1097,296,67,229,801,55,60,207,307,30,45,97
"2011","Reigate and Banstead 011C","E01030612","Total",1182,412,60,352,770,30,54,189,386,16,35,60
"2011","Reigate and Banstead 011D","E01030613","Total",856,300,34,266,556,29,32,157,237,19,22,60
"2011","Reigate and Banstead 011E","E01030614","Total",606,104,40,64,502,14,83,135,129,12,30,99
"2011","Reigate and Banstead 012A","E01030593","Total",594,170,52,118,424,21,55,106,140,20,16,66
"2011","Reigate and Banstead 012B","E01030596","Total",518,78,49,29,440,5,68,133,104,36,35,59
"2011","Reigate and Banstead 012C","E01030597","Total",616,127,65,62,489,15,68,183,127,18,18,60
"2011","Reigate and Banstead 012D","E01030620","Total",792,277,129,148,515,15,87,125,173,26,30,59
"2011","Reigate and Banstead 012E","E01030621","Total",644,219,108,111,425,30,65,116,98,30,27,59
"2011","Reigate and Banstead 013A","E01030594","Total",704,174,87,87,530,28,103,150,115,20,40,74
"2011","Reigate and Banstead 013B","E01030595","Total",603,173,84,89,430,18,63,129,97,23,36,64
"2011","Reigate and Banstead 013C","E01030630","Total",629,133,76,57,496,32,110,120,85,20,40,89
"2011","Reigate and Banstead 013D","E01030631","Total",649,190,93,97,459,38,80,110,131,17,27,56
"2011","Reigate and Banstead 014A","E01030570","Total",643,171,82,89,472,20,74,90,131,20,36,101
"2011","Reigate and Banstead 014B","E01030571","Total",600,111,53,58,489,19,88,109,118,21,36,98
"2011","Reigate and Banstead 014C","E01030572","Total",872,269,51,218,603,47,56,164,201,26,30,79
"2011","Reigate and Banstead 014D","E01030573","Total",719,205,103,102,514,26,78,130,142,25,43,70
"2011","Reigate and Banstead 014E","E01030574","Total",719,203,63,140,516,23,45,133,170,26,39,80
"2011","Reigate and Banstead 015A","E01030628","Total",561,134,78,56,427,7,83,82,104,8,33,110
"2011","Reigate and Banstead 015B","E01030629","Total",514,150,60,90,364,12,80,71,113,19,17,52
"2011","Reigate and Banstead 015C","E01030632","Total",532,123,62,61,409,15,77,95,95,19,31,77
"2011","Reigate and Banstead 015D","E01030633","Total",564,160,86,74,404,24,81,71,99,16,30,83
"2011","Reigate and Banstead 015E","E01030634","Total",576,151,75,76,425,45,79,95,81,20,37,68
"2011","Reigate and Banstead 016A","E01030584","Total",636,113,66,47,523,21,107,97,139,24,39,96
"2011","Reigate and Banstead 016B","E01030585","Total",627,113,51,62,514,19,96,103,147,16,28,105
"2011","Reigate and Banstead 016C","E01030586","Total",654,149,61,88,505,25,84,118,120,21,51,86
"2011","Reigate and Banstead 016D","E01030587","Total",603,165,94,71,438,15,89,111,91,5,34,93
"2011","Reigate and Banstead 016E","E01030588","Total",614,190,83,107,424,43,71,81,94,19,25,91
"2011","Reigate and Banstead 017A","E01030580","Total",764,171,40,131,593,44,47,176,184,17,39,86
"2011","Reigate and Banstead 017B","E01030581","Total",493,92,56,36,401,7,88,79,98,11,21,97
"2011","Reigate and Banstead 017C","E01030582","Total",523,132,35,97,391,26,27,111,140,17,22,48
"2011","Reigate and Banstead 017D","E01030583","Total",556,92,60,32,464,7,101,90,121,11,42,92
"2011","Reigate and Banstead 018A","E01030575","Total",975,373,140,233,602,39,57,138,231,17,25,95
"2011","Reigate and Banstead 018B","E01030576","Total",664,159,45,114,505,24,69,112,142,17,33,108
"2011","Reigate and Banstead 018C","E01030577","Total",734,251,105,146,483,35,70,104,143,12,29,90
"2011","Reigate and Banstead 018D","E01030578","Total",611,190,107,83,421,20,81,65,111,13,29,102
"2011","Reigate and Banstead 018E","E01030579","Total",603,225,136,89,378,15,103,55,112,9,20,64
"2011","Runnymede 001A","E01030667","Total",751,369,149,220,382,22,51,75,144,4,12,74
"2011","Runnymede 001B","E01030668","Total",869,340,138,202,529,29,66,99,203,12,17,103
"2011","Runnymede 001C","E01030669","Total",599,145,60,85,454,19,62,87,99,14,25,148
"2011","Runnymede 001D","E01030670","Total",490,81,39,42,409,12,60,80,72,12,25,148
"2011","Runnymede 002A","E01030671","Total",424,127,33,94,297,16,43,71,83,8,16,60
"2011","Runnymede 002B","E01030672","Total",789,184,74,110,605,12,108,143,137,23,42,140
"2011","Runnymede 002C","E01030673","Total",426,122,64,58,304,12,64,64,75,4,20,65
"2011","Runnymede 002D","E01030674","Total",651,281,171,110,370,27,68,64,86,12,21,92
"2011","Runnymede 002E","E01030675","Total",547,172,62,110,375,16,40,56,99,14,24,126
"2011","Runnymede 002F","E01030676","Total",496,152,92,60,344,15,38,33,60,19,26,153
"2011","Runnymede 003A","E01030663","Total",642,195,110,85,447,47,63,94,91,18,40,94
"2011","Runnymede 003B","E01030664","Total",706,254,119,135,452,34,73,86,111,21,38,89
"2011","Runnymede 003C","E01030665","Total",624,172,50,122,452,28,35,113,143,18,37,78
"2011","Runnymede 003D","E01030666","Total",741,220,61,159,521,19,75,118,177,15,32,85
"2011","Runnymede 003E","E01030687","Total",483,127,53,74,356,8,64,65,108,7,29,75
"2011","Runnymede 003F","E01030688","Total",604,161,74,87,443,20,68,96,119,13,29,98
"2011","Runnymede 004A","E01030656","Total",588,133,63,70,455,28,71,78,110,19,43,106
"2011","Runnymede 004B","E01030658","Total",738,350,144,206,388,16,138,50,128,5,13,38
"2011","Runnymede 004C","E01030685","Total",511,114,48,66,397,12,80,96,85,6,31,87
"2011","Runnymede 004D","E01030686","Total",589,152,72,80,437,6,113,84,104,8,29,93
"2011","Runnymede 005A","E01030689","Total",575,157,73,84,418,7,82,81,117,12,34,85
"2011","Runnymede 005B","E01030690","Total",662,189,72,117,473,12,81,109,157,13,37,64
"2011","Runnymede 005C","E01030691","Total",600,110,67,43,490,12,126,119,96,25,38,74
"2011","Runnymede 005D","E01030692","Total",486,122,71,51,364,11,85,65,79,29,31,64
"2011","Runnymede 006A","E01030652","Total",708,222,88,134,486,33,73,112,134,22,29,83
"2011","Runnymede 006B","E01030653","Total",633,236,91,145,397,31,47,74,138,13,28,66
"2011","Runnymede 006C","E01030654","Total",622,164,44,120,458,30,66,116,159,14,15,58
"2011","Runnymede 006D","E01030657","Total",648,224,96,128,424,46,56,70,111,22,33,86
"2011","Runnymede 006E","E01030659","Total",737,271,129,142,466,15,89,100,135,13,29,85
"2011","Runnymede 007A","E01030647","Total",763,291,151,140,472,23,131,86,119,20,24,69
"2011","Runnymede 007B","E01030648","Total",628,156,64,92,472,28,80,118,110,12,37,87
"2011","Runnymede 007C","E01030649","Total",807,321,132,189,486,45,87,118,141,11,16,68
"2011","Runnymede 007D","E01030650","Total",519,142,52,90,377,43,49,91,88,13,24,69
"2011","Runnymede 007E","E01030651","Total",562,142,54,88,420,20,74,98,129,13,28,58
"2011","Runnymede 007F","E01030655","Total",688,208,65,143,480,15,113,90,132,12,32,86
"2011","Runnymede 007G","E01030662","Total",607,142,78,64,465,25,102,107,97,17,40,77
"2011","Runnymede 008A","E01030677","Total",677,192,71,121,485,17,88,110,152,13,31,74
"2011","Runnymede 008B","E01030678","Total",583,225,80,145,358,23,47,86,118,15,20,49
"2011","Runnymede 008C","E01030679","Total",480,84,46,38,396,10,100,85,112,14,16,59
"2011","Runnymede 008D","E01030680","Total",634,149,87,62,485,21,124,100,116,16,35,73
"2011","Runnymede 009A","E01030645","Total",911,404,196,208,507,55,83,108,113,24,33,91
"2011","Runnymede 009B","E01030646","Total",928,335,126,209,593,32,92,131,181,17,38,102
"2011","Runnymede 009C","E01030660","Total",799,177,74,103,622,32,85,152,167,22,60,104
"2011","Runnymede 009D","E01030661","Total",669,160,93,67,509,16,152,90,119,10,31,91
"2011","Runnymede 009E","E01030684","Total",651,216,54,162,435,22,75,97,121,14,25,81
"2011","Runnymede 010A","E01030681","Total",650,172,82,90,478,25,86,90,127,19,28,103
"2011","Runnymede 010B","E01030682","Total",515,119,55,64,396,20,65,111,80,9,27,84
"2011","Runnymede 010C","E01030683","Total",551,137,50,87,414,14,70,92,120,14,28,76
"2011","Runnymede 010D","E01030693","Total",507,122,77,45,385,14,98,65,102,14,21,71
"2011","Runnymede 010E","E01030694","Total",530,137,79,58,393,24,57,84,94,11,40,83
"2011","Runnymede 010F","E01030695","Total",496,94,64,30,402,4,122,69,79,11,26,91
"2011","Runnymede 010G","E01030696","Total",620,165,108,57,455,26,118,92,96,16,32,75
"2011","Spelthorne 001A","E01030743","Total",651,224,75,149,427,24,89,58,107,13,40,96
"2011","Spelthorne 001B","E01030744","Total",844,433,78,355,411,51,56,74,130,13,27,60
"2011","Spelthorne 001C","E01030745","Total",577,118,50,68,459,39,64,96,80,20,41,119
"2011","Spelthorne 001D","E01030747","Total",550,129,25,104,421,22,55,86,137,14,37,70
"2011","Spelthorne 002A","E01030709","Total",562,116,34,82,446,31,57,111,99,21,45,82
"2011","Spelthorne 002B","E01030710","Total",648,163,65,98,485,43,63,114,98,16,47,104
"2011","Spelthorne 002C","E01030711","Total",638,156,40,116,482,35,71,98,100,29,57,92
"2011","Spelthorne 002D","E01030746","Total",628,169,100,69,459,53,73,79,92,14,51,97
"2011","Spelthorne 003A","E01030707","Total",674,178,66,112,496,30,81,102,138,13,36,96
"2011","Spelthorne 003B","E01030708","Total",618,124,62,62,494,19,71,107,126,18,57,96
"2011","Spelthorne 003C","E01030712","Total",545,125,47,78,420,12,80,65,144,12,24,83
"2011","Spelthorne 003D","E01030713","Total",489,131,60,71,358,13,52,84,82,12,24,91
"2011","Spelthorne 003E","E01030714","Total",476,98,45,53,378,16,67,90,87,11,30,77
"2011","Spelthorne 003F","E01030715","Total",600,145,65,80,455,19,81,88,112,11,37,107
"2011","Spelthorne 003G","E01030716","Total",593,135,88,47,458,11,107,88,90,16,38,108
"2011","Spelthorne 004A","E01030734","Total",551,106,35,71,445,22,51,105,114,15,37,101
"2011","Spelthorne 004B","E01030735","Total",670,181,58,123,489,30,79,98,151,17,23,91
"2011","Spelthorne 004C","E01030736","Total",937,412,67,345,525,23,54,134,229,3,23,59
"2011","Spelthorne 004D","E01030737","Total",681,271,92,179,410,21,61,93,136,5,30,64
"2011","Spelthorne 004E","E01030738","Total",689,249,73,176,440,31,47,115,146,7,23,71
"2011","Spelthorne 005A","E01030701","Total",625,162,98,64,463,28,100,101,77,21,37,99
"2011","Spelthorne 005B","E01030702","Total",489,171,78,93,318,24,48,81,73,18,29,45
"2011","Spelthorne 005C","E01030703","Total",627,158,86,72,469,28,111,91,81,17,31,110
"2011","Spelthorne 005D","E01030704","Total",647,218,130,88,429,15,115,64,96,13,33,93
"2011","Spelthorne 005E","E01030705","Total",643,155,65,90,488,13,105,87,111,19,50,103
"2011","Spelthorne 005F","E01030706","Total",553,126,62,64,427,17,77,90,100,11,34,98
"2011","Spelthorne 006A","E01030697","Total",639,173,80,93,466,19,107,95,91,11,45,98
"2011","Spelthorne 006B","E01030698","Total",655,154,87,67,501,29,89,122,107,13,41,100
"2011","Spelthorne 006C","E01030699","Total",627,177,105,72,450,28,122,83,88,13,38,78
"2011","Spelthorne 006D","E01030700","Total",778,274,92,182,504,32,78,116,146,14,43,75
"2011","Spelthorne 006E","E01030725","Total",787,256,57,199,531,46,34,139,200,17,32,63
"2011","Spelthorne 007A","E01030729","Total",623,138,66,72,485,27,106,99,118,14,32,89
"2011","Spelthorne 007B","E01030739","Total",690,222,142,80,468,42,75,110,93,23,44,81
"2011","Spelthorne 007C","E01030740","Total",745,270,151,119,475,29,90,87,93,23,50,103
"2011","Spelthorne 007D","E01030741","Total",654,142,51,91,512,24,63,116,121,26,41,121
"2011","Spelthorne 008A","E01030748","Total",669,160,75,85,509,27,85,102,114,22,59,100
"2011","Spelthorne 008B","E01030749","Total",608,161,100,61,447,49,54,110,100,16,43,75
"2011","Spelthorne 008C","E01030750","Total",618,148,56,92,470,34,63,83,131,21,47,91
"2011","Spelthorne 008D","E01030751","Total",653,194,69,125,459,28,58,93,131,15,28,106
"2011","Spelthorne 008E","E01030752","Total",615,177,54,123,438,35,51,98,110,17,50,77
"2011","Spelthorne 009A","E01030726","Total",638,107,71,36,531,5,122,121,111,22,41,109
"2011","Spelthorne 009B","E01030727","Total",862,303,141,162,559,31,116,114,173,6,24,95
"2011","Spelthorne 009C","E01030728","Total",723,186,112,74,537,13,158,89,146,13,30,88
"2011","Spelthorne 009D","E01030742","Total",810,238,129,109,572,19,130,122,126,19,42,114
"2011","Spelthorne 010A","E01030753","Total",746,237,135,102,509,12,123,97,144,18,30,85
"2011","Spelthorne 010B","E01030754","Total",625,160,113,47,465,9,130,96,91,14,32,93
"2011","Spelthorne 010C","E01030755","Total",794,215,97,118,579,55,80,139,158,17,41,89
"2011","Spelthorne 010D","E01030756","Total",666,147,72,75,519,13,125,98,119,11,40,113
"2011","Spelthorne 011A","E01030717","Total",730,264,117,147,466,35,108,90,107,14,28,84
"2011","Spelthorne 011B","E01030718","Total",506,112,66,46,394,9,80,103,62,15,38,87
"2011","Spelthorne 011C","E01030719","Total",619,170,90,80,449,25,97,87,90,12,46,92
"2011","Spelthorne 011D","E01030720","Total",641,183,110,73,458,14,114,85,105,14,43,83
"2011","Spelthorne 012A","E01030721","Total",619,159,74,85,460,34,93,84,119,14,32,84
"2011","Spelthorne 012B","E01030722","Total",656,157,75,82,499,23,102,103,119,16,23,113
"2011","Spelthorne 012C","E01030723","Total",617,130,73,57,487,12,113,86,107,15,36,118
"2011","Spelthorne 012D","E01030724","Total",647,201,93,108,446,32,81,96,108,13,34,82
"2011","Spelthorne 013A","E01030730","Total",783,231,147,84,552,9,195,98,115,13,25,97
"2011","Spelthorne 013B","E01030731","Total",767,186,87,99,581,33,132,134,126,19,35,102
"2011","Spelthorne 013C","E01030732","Total",689,236,125,111,453,9,130,78,133,7,26,70
"2011","Spelthorne 013D","E01030733","Total",808,341,175,166,467,25,127,79,137,5,17,77
"2011","Surrey Heath 001A","E01030763","Total",509,119,62,57,390,5,109,67,120,9,16,64
"2011","Surrey Heath 001B","E01030764","Total",506,125,67,58,381,5,98,71,108,19,26,54
"2011","Surrey Heath 001C","E01030765","Total",601,177,106,71,424,22,99,93,99,18,26,67
"2011","Surrey Heath 001D","E01030809","Total",643,196,99,97,447,18,96,100,135,15,18,65
"2011","Surrey Heath 001E","E01030810","Total",542,85,30,55,457,10,114,114,114,23,29,53
"2011","Surrey Heath 001F","E01030811","Total",597,122,70,52,475,10,111,133,107,11,22,81
"2011","Surrey Heath 002A","E01030757","Total",675,204,34,170,471,20,41,133,162,14,25,76
"2011","Surrey Heath 002B","E01030758","Total",439,92,40,52,347,10,74,90,88,10,24,51
"2011","Surrey Heath 002C","E01030759","Total",725,271,150,121,454,28,95,94,126,15,30,66
"2011","Surrey Heath 002D","E01030760","Total",493,117,51,66,376,12,64,96,105,9,23,67
"2011","Surrey Heath 003A","E01030778","Total",741,173,61,112,568,14,138,121,140,19,44,92
"2011","Surrey Heath 003B","E01030779","Total",745,191,123,68,554,11,141,114,140,18,39,91
"2011","Surrey Heath 003C","E01030780","Total",652,151,65,86,501,10,84,121,163,11,42,70
"2011","Surrey Heath 003D","E01030781","Total",640,156,71,85,484,26,85,130,119,14,32,78
"2011","Surrey Heath 004A","E01030786","Total",754,251,114,137,503,48,63,133,124,20,34,81
"2011","Surrey Heath 004B","E01030787","Total",528,105,57,48,423,22,84,81,75,18,51,92
"2011","Surrey Heath 004C","E01030788","Total",487,86,47,39,401,43,62,75,70,28,48,75
"2011","Surrey Heath 004D","E01030801","Total",638,142,33,109,496,23,48,132,166,17,31,79
"2011","Surrey Heath 004E","E01030802","Total",672,158,70,88,514,12,121,92,140,23,33,93
"2011","Surrey Heath 005A","E01030796","Total",522,95,55,40,427,6,115,96,80,12,41,77
"2011","Surrey Heath 005B","E01030797","Total",519,92,37,55,427,14,64,115,98,16,36,84
"2011","Surrey Heath 005C","E01030798","Total",547,72,52,20,475,6,132,93,85,29,43,87
"2011","Surrey Heath 005D","E01030799","Total",501,71,30,41,430,4,104,93,91,14,46,78
"2011","Surrey Heath 005E","E01030800","Total",699,223,110,113,476,24,95,101,136,11,34,75
"2011","Surrey Heath 006A","E01030761","Total",575,111,67,44,464,16,103,104,94,15,44,88
"2011","Surrey Heath 006B","E01030762","Total",735,171,53,118,564,21,73,147,147,16,43,117
"2011","Surrey Heath 006C","E01030806","Total",544,77,45,32,467,9,67,126,107,27,50,81
"2011","Surrey Heath 006D","E01030807","Total",510,95,47,48,415,6,81,105,85,26,29,83
"2011","Surrey Heath 006E","E01030808","Total",634,156,72,84,478,19,85,122,126,22,30,74
"2011","Surrey Heath 007A","E01030774","Total",531,123,37,86,408,19,51,116,101,22,36,63
"2011","Surrey Heath 007B","E01030775","Total",556,101,59,42,455,5,109,86,118,22,43,72
"2011","Surrey Heath 007C","E01030776","Total",616,116,55,61,500,14,101,113,111,20,38,103
"2011","Surrey Heath 007D","E01030777","Total",641,141,66,75,500,27,66,141,151,16,30,69
"2011","Surrey Heath 008A","E01030793","Total",608,176,56,120,432,50,43,88,105,22,46,78
"2011","Surrey Heath 008B","E01030794","Total",613,174,56,118,439,20,58,95,120,20,41,85
"2011","Surrey Heath 008C","E01030795","Total",960,369,161,208,591,12,128,114,195,20,35,87
"2011","Surrey Heath 008D","E01030803","Total",656,147,55,92,509,21,69,91,156,14,53,105
"2011","Surrey Heath 008E","E01030804","Total",668,125,76,49,543,10,127,99,136,23,42,106
"2011","Surrey Heath 008F","E01030805","Total",606,135,76,59,471,36,80,85,107,14,57,92
"2011","Surrey Heath 009A","E01030789","Total",562,97,47,50,465,3,130,75,107,16,41,93
"2011","Surrey Heath 009B","E01030790","Total",663,157,90,67,506,19,92,116,116,31,34,98
"2011","Surrey Heath 009C","E01030791","Total",643,117,68,49,526,8,141,96,117,15,41,108
"2011","Surrey Heath 009D","E01030792","Total",492,69,31,38,423,5,112,79,88,16,34,89
"2011","Surrey Heath 010A","E01030766","Total",662,207,84,123,455,12,74,93,132,9,44,91
"2011","Surrey Heath 010B","E01030767","Total",609,142,61,81,467,36,78,111,89,22,54,77
"2011","Surrey Heath 010C","E01030768","Total",513,104,50,54,409,13,105,81,82,18,35,75
"2011","Surrey Heath 010D","E01030769","Total",570,87,41,46,483,13,107,89,110,13,53,98
"2011","Surrey Heath 011A","E01030770","Total",616,157,69,88,459,11,82,113,122,14,29,88
"2011","Surrey Heath 011B","E01030771","Total",485,87,35,52,398,9,63,84,116,10,37,79
"2011","Surrey Heath 011C","E01030772","Total",623,178,94,84,445,24,77,92,114,16,37,85
"2011","Surrey Heath 011D","E01030773","Total",542,101,51,50,441,11,68,110,114,15,33,90
"2011","Surrey Heath 012A","E01030782","Total",659,181,115,66,478,7,113,85,117,17,38,101
"2011","Surrey Heath 012B","E01030783","Total",636,143,64,79,493,11,93,100,127,18,40,104
"2011","Surrey Heath 012C","E01030784","Total",803,152,22,130,651,31,35,214,198,36,58,79
"2011","Surrey Heath 012D","E01030785","Total",640,197,111,86,443,12,102,86,123,7,27,86
"2011","Tandridge 002A","E01030855","Total",753,165,83,82,588,7,175,80,148,13,41,124
"2011","Tandridge 002B","E01030856","Total",613,168,92,76,445,12,108,102,92,11,42,78
"2011","Tandridge 002C","E01030859","Total",848,297,68,229,551,29,71,134,182,13,31,91
"2011","Tandridge 002D","E01030860","Total",935,338,75,263,597,55,59,165,212,15,37,54
"2011","Tandridge 003A","E01030844","Total",679,133,47,86,546,34,80,133,137,24,45,93
"2011","Tandridge 003B","E01030845","Total",497,137,59,78,360,21,42,109,82,16,26,64
"2011","Tandridge 003C","E01030846","Total",550,105,65,40,445,12,114,75,95,21,45,83
"2011","Tandridge 003D","E01030857","Total",876,236,61,175,640,56,67,182,178,26,55,76
"2011","Tandridge 003E","E01030858","Total",871,248,80,168,623,48,87,159,175,28,34,92
"2011","Tandridge 004A","E01030828","Total",494,114,55,59,380,10,79,80,100,13,29,69
"2011","Tandridge 004B","E01030829","Total",672,255,111,144,417,29,78,75,143,13,15,64
"2011","Tandridge 004C","E01030830","Total",513,118,62,56,395,13,56,107,99,21,23,76
"2011","Tandridge 004D","E01030850","Total",1031,415,205,210,616,46,68,157,212,33,24,76
"2011","Tandridge 004E","E01030851","Total",811,199,54,145,612,39,85,152,153,28,40,115
"2011","Tandridge 004F","E01030861","Total",744,139,72,67,605,13,155,102,165,26,48,96
"2011","Tandridge 005A","E01030820","Total",644,115,76,39,529,8,157,91,105,21,44,103
"2011","Tandridge 005B","E01030847","Total",698,274,175,99,424,10,117,66,96,19,39,77
"2011","Tandridge 005C","E01030848","Total",851,240,117,123,611,36,86,162,134,28,50,115
"2011","Tandridge 006A","E01030831","Total",875,185,114,71,690,12,172,120,184,30,54,118
"2011","Tandridge 006B","E01030832","Total",555,157,93,64,398,9,107,80,91,15,36,60
"2011","Tandridge 006C","E01030836","Total",728,280,202,78,448,36,103,101,90,19,34,65
"2011","Tandridge 006D","E01030837","Total",549,114,69,45,435,25,84,110,95,22,35,64
"2011","Tandridge 006E","E01030838","Total",507,109,52,57,398,13,85,90,105,12,24,69
"2011","Tandridge 006F","E01030839","Total",546,113,76,37,433,5,109,92,96,25,37,69
"2011","Tandridge 007A","E01030840","Total",572,130,79,51,442,32,87,102,91,16,35,79
"2011","Tandridge 007B","E01030841","Total",489,97,62,35,392,6,112,82,70,20,23,79
"2011","Tandridge 007C","E01030842","Total",687,156,77,79,531,24,86,127,125,32,40,97
"2011","Tandridge 007D","E01030843","Total",610,162,58,104,448,29,86,92,115,21,23,82
"2011","Tandridge 008A","E01030812","Total",633,181,69,112,452,31,82,101,116,17,34,71
"2011","Tandridge 008B","E01030813","Total",652,194,76,118,458,16,79,106,139,16,24,78
"2011","Tandridge 008C","E01030814","Total",473,108,66,42,365,16,77,67,89,19,37,60
"2011","Tandridge 008D","E01030815","Total",603,164,74,90,439,17,86,100,131,15,32,58
"2011","Tandridge 009A","E01030824","Total",612,186,100,86,426,42,71,97,101,22,22,71
"2011","Tandridge 009B","E01030825","Total",594,185,101,84,409,8,114,88,88,21,29,61
"2011","Tandridge 009C","E01030826","Total",567,115,59,56,452,30,89,101,111,12,52,57
"2011","Tandridge 009D","E01030827","Total",613,124,55,69,489,20,107,93,130,16,39,84
"2011","Tandridge 010A","E01030821","Total",772,187,104,83,585,9,140,105,149,26,49,107
"2011","Tandridge 010B","E01030822","Total",678,124,65,59,554,11,115,118,148,21,46,95
"2011","Tandridge 010C","E01030833","Total",602,235,149,86,367,15,96,80,94,12,20,50
"2011","Tandridge 010D","E01030834","Total",566,146,65,81,420,25,87,85,105,14,30,74
"2011","Tandridge 010E","E01030835","Total",581,150,65,85,431,8,82,107,109,28,34,63
"2011","Tandridge 011A","E01030816","Total",609,147,56,91,462,17,103,81,111,17,46,87
"2011","Tandridge 011B","E01030817","Total",582,140,76,64,442,1,105,93,121,19,26,77
"2011","Tandridge 011C","E01030818","Total",522,157,76,81,365,12,89,73,77,13,34,67
"2011","Tandridge 011D","E01030819","Total",609,168,69,99,441,11,110,71,129,14,29,77
"2011","Tandridge 011E","E01030823","Total",829,168,105,63,661,10,179,121,169,25,47,110
"2011","Tandridge 012A","E01030852","Total",801,239,140,99,562,40,109,111,135,13,45,109
"2011","Tandridge 012B","E01030853","Total",703,212,139,73,491,23,92,91,122,18,47,98
"2011","Tandridge 012C","E01030854","Total",804,216,139,77,588,21,165,126,108,12,35,121
"2011","Tandridge 012D","E01032571","Total",739,164,89,75,575,20,141,98,132,23,47,114
"2011","Waverley 001A","E01030890","Total",647,187,93,94,460,29,87,106,125,19,35,59
"2011","Waverley 001B","E01030902","Total",534,107,60,47,427,16,112,91,105,15,26,62
"2011","Waverley 001C","E01030903","Total",670,188,76,112,482,25,75,128,143,12,23,76
"2011","Waverley 001D","E01030904","Total",639,203,120,83,436,17,136,70,113,16,21,63
"2011","Waverley 002A","E01030891","Total",637,136,68,68,501,14,128,108,118,18,36,79
"2011","Waverley 002B","E01030892","Total",522,113,45,68,409,20,81,107,104,15,22,60
"2011","Waverley 002C","E01030899","Total",672,166,81,85,506,13,110,106,139,18,36,84
"2011","Waverley 002D","E01030900","Total",501,113,74,39,388,9,94,72,111,14,22,66
"2011","Waverley 002E","E01030901","Total",512,104,23,81,408,53,35,78,90,28,34,90
"2011","Waverley 003A","E01030884","Total",707,258,86,172,449,30,95,89,146,10,14,65
"2011","Waverley 003B","E01030885","Total",682,410,254,156,272,10,68,34,110,5,5,40
"2011","Waverley 003C","E01030886","Total",490,101,56,45,389,7,85,89,89,18,25,76
"2011","Waverley 003D","E01030893","Total",777,211,69,142,566,16,79,135,196,27,34,79
"2011","Waverley 003E","E01030895","Total",640,229,101,128,411,18,50,93,130,17,20,83
"2011","Waverley 004A","E01030881","Total",544,103,70,33,441,12,134,102,77,27,24,65
"2011","Waverley 004B","E01030883","Total",522,128,82,46,394,10,98,78,87,31,39,51
"2011","Waverley 004C","E01030888","Total",627,188,75,113,439,11,81,124,120,34,21,48
"2011","Waverley 004D","E01030894","Total",597,112,73,39,485,5,128,97,119,24,39,73
"2011","Waverley 005A","E01030911","Total",618,144,83,61,474,9,115,110,96,16,30,98
"2011","Waverley 005B","E01030912","Total",547,144,78,66,403,20,97,65,97,8,28,88
"2011","Waverley 005C","E01030913","Total",506,130,62,68,376,40,57,87,88,10,32,62
"2011","Waverley 005D","E01030920","Total",636,190,66,124,446,29,67,100,139,7,24,80
"2011","Waverley 005E","E01030921","Total",834,381,223,158,453,29,62,105,151,22,19,65
"2011","Waverley 006A","E01030882","Total",519,103,68,35,416,9,96,113,87,23,25,63
"2011","Waverley 006B","E01030887","Total",529,132,91,41,397,12,87,103,78,26,23,68
"2011","Waverley 006C","E01030889","Total",634,211,112,99,423,24,90,95,98,23,24,69
"2011","Waverley 006D","E01030896","Total",514,167,53,114,347,31,43,82,110,7,22,52
"2011","Waverley 006E","E01030897","Total",522,111,44,67,411,15,83,95,102,20,32,64
"2011","Waverley 007A","E01030916","Total",799,293,102,191,506,22,61,132,205,12,15,59
"2011","Waverley 007B","E01030917","Total",518,185,35,150,333,9,47,78,139,8,13,39
"2011","Waverley 007C","E01030918","Total",536,199,90,109,337,13,73,74,132,7,9,29
"2011","Waverley 007D","E01030919","Total",521,103,46,57,418,7,104,102,116,16,14,59
"2011","Waverley 007E","E01030922","Total",621,170,58,112,451,19,75,107,155,12,20,63
"2011","Waverley 008A","E01030863","Total",748,178,108,70,570,11,157,115,123,53,29,82
"2011","Waverley 008B","E01030865","Total",622,216,128,88,406,18,108,82,98,15,25,60
"2011","Waverley 008C","E01030866","Total",629,157,96,61,472,7,111,111,113,31,31,68
"2011","Waverley 008D","E01030940","Total",731,208,113,95,523,15,137,110,108,35,29,89
"2011","Waverley 009A","E01030898","Total",626,133,73,60,493,13,122,118,91,28,40,81
"2011","Waverley 009B","E01030905","Total",606,159,57,102,447,26,64,92,132,20,30,83
"2011","Waverley 009C","E01030906","Total",709,195,85,110,514,29,113,128,116,26,34,68
"2011","Waverley 009D","E01030907","Total",471,98,73,25,373,8,117,63,86,33,21,45
"2011","Waverley 010A","E01030914","Total",531,150,65,85,381,29,58,99,109,10,20,56
"2011","Waverley 010B","E01030915","Total",654,154,71,83,500,25,81,127,136,25,28,78
"2011","Waverley 010C","E01030923","Total",558,114,62,52,444,8,85,105,116,35,25,70
"2011","Waverley 010D","E01030924","Total",504,117,45,72,387,15,77,91,105,17,21,61
"2011","Waverley 010E","E01030925","Total",571,98,56,42,473,4,76,151,119,18,32,73
"2011","Waverley 011A","E01030877","Total",517,166,100,66,351,7,113,63,84,13,27,44
"2011","Waverley 011B","E01030878","Total",635,148,88,60,487,14,154,91,94,22,38,74
"2011","Waverley 011C","E01030937","Total",653,157,72,85,496,20,98,118,128,35,33,64
"2011","Waverley 011D","E01030938","Total",621,241,152,89,380,18,82,77,105,13,23,62
"2011","Waverley 011E","E01030939","Total",468,110,56,54,358,14,72,88,85,15,25,59
"2011","Waverley 012A","E01030864","Total",545,111,64,47,434,8,98,99,120,23,30,56
"2011","Waverley 012B","E01030879","Total",459,107,59,48,352,8,88,66,99,27,14,50
"2011","Waverley 012C","E01030941","Total",488,94,48,46,394,8,78,87,107,26,31,57
"2011","Waverley 012D","E01030942","Total",557,130,62,68,427,8,93,104,110,26,27,59
"2011","Waverley 012E","E01030943","Total",514,124,59,65,390,27,71,96,85,30,24,57
"2011","Waverley 013A","E01030870","Total",645,130,96,34,515,13,162,88,102,22,31,97
"2011","Waverley 013B","E01030871","Total",658,151,72,79,507,18,99,127,120,15,38,90
"2011","Waverley 013C","E01030872","Total",812,313,172,141,499,43,124,109,109,17,31,66
"2011","Waverley 013D","E01030873","Total",608,177,103,74,431,24,97,77,102,24,25,82
"2011","Waverley 013E","E01030874","Total",511,129,65,64,382,3,101,67,95,18,24,74
"2011","Waverley 013F","E01030875","Total",601,234,81,153,367,20,82,65,103,18,21,58
"2011","Waverley 013G","E01030876","Total",537,127,83,44,410,5,165,52,88,15,24,61
"2011","Waverley 015A","E01030862","Total",861,334,242,92,527,15,169,90,123,15,30,85
"2011","Waverley 015B","E01030867","Total",596,154,84,70,442,18,117,84,128,14,27,54
"2011","Waverley 015C","E01030868","Total",487,86,53,33,401,8,98,100,69,22,33,71
"2011","Waverley 015D","E01030869","Total",477,125,63,62,352,13,78,79,89,19,26,48
"2011","Waverley 015E","E01030880","Total",814,222,128,94,592,14,167,118,161,34,31,67
"2011","Waverley 016A","E01030930","Total",642,156,107,49,486,7,119,122,122,31,24,61
"2011","Waverley 016B","E01030931","Total",761,245,153,92,516,14,128,121,142,25,21,65
"2011","Waverley 016C","E01030932","Total",591,144,82,62,447,24,74,105,110,26,27,81
"2011","Waverley 016D","E01030933","Total",772,252,156,96,520,17,136,116,130,33,20,68
"2011","Waverley 017A","E01030926","Total",604,188,97,91,416,6,89,112,99,22,26,62
"2011","Waverley 017B","E01030927","Total",528,151,54,97,377,9,59,84,97,26,24,78
"2011","Waverley 017C","E01030928","Total",819,337,135,202,482,32,57,123,186,7,29,48
"2011","Waverley 017D","E01030929","Total",494,119,48,71,375,6,77,104,94,13,24,57
"2011","Waverley 018A","E01030908","Total",590,128,69,59,462,8,103,100,94,31,32,94
"2011","Waverley 018B","E01030909","Total",499,118,63,55,381,11,90,63,113,24,24,56
"2011","Waverley 018C","E01030910","Total",494,132,81,51,362,7,108,75,79,15,31,47
"2011","Waverley 018D","E01030934","Total",568,168,86,82,400,7,116,85,99,18,37,38
"2011","Waverley 018E","E01030935","Total",505,108,53,55,397,10,69,94,111,16,33,64
"2011","Waverley 018F","E01032626","Total",615,185,83,102,430,8,108,83,135,13,16,67
"2011","Woking 001A","E01030946","Total",607,211,113,98,396,47,58,91,118,12,20,50
"2011","Woking 001B","E01030947","Total",532,98,61,37,434,24,71,97,84,23,45,90
"2011","Woking 001C","E01030948","Total",620,139,72,67,481,25,79,114,130,19,23,91
"2011","Woking 001D","E01030949","Total",705,193,74,119,512,36,73,130,140,23,26,84
"2011","Woking 001E","E01030950","Total",710,223,135,88,487,29,91,108,143,11,34,71
"2011","Woking 002A","E01030996","Total",577,86,58,28,491,5,135,113,83,23,33,99
"2011","Woking 002B","E01030998","Total",718,111,80,31,607,8,206,126,95,32,34,106
"2011","Woking 002C","E01031002","Total",678,139,88,51,539,12,114,117,148,21,40,87
"2011","Woking 002D","E01031003","Total",648,104,66,38,544,5,119,155,101,33,39,92
"2011","Woking 002E","E01031004","Total",994,375,171,204,619,48,80,164,217,13,22,75
"2011","Woking 003A","E01030963","Total",530,76,55,21,454,5,120,82,79,21,44,103
"2011","Woking 003B","E01030964","Total",741,181,51,130,560,15,119,111,177,19,25,94
"2011","Woking 003C","E01030965","Total",556,91,41,50,465,14,106,87,115,21,32,90
"2011","Woking 003D","E01030966","Total",507,74,43,31,433,13,74,129,74,30,36,77
"2011","Woking 003E","E01030967","Total",631,149,93,56,482,11,109,116,105,30,28,83
"2011","Woking 003F","E01030968","Total",533,163,76,87,370,22,48,73,104,21,29,73
"2011","Woking 004A","E01030980","Total",556,134,25,109,422,14,22,63,118,30,74,101
"2011","Woking 004B","E01030981","Total",464,93,42,51,371,6,50,40,45,38,107,85
"2011","Woking 004C","E01030982","Total",596,114,30,84,482,23,33,94,108,31,65,128
"2011","Woking 004D","E01030983","Total",681,221,52,169,460,21,18,104,151,15,56,95
"2011","Woking 004E","E01030984","Total",694,151,84,67,543,36,57,93,108,57,77,115
"2011","Woking 004F","E01030985","Total",627,236,73,163,391,37,39,90,78,23,49,75
"2011","Woking 005A","E01030951","Total",611,244,76,168,367,18,37,71,132,20,27,62
"2011","Woking 005B","E01030952","Total",602,198,70,128,404,76,43,106,44,43,35,57
"2011","Woking 005C","E01030953","Total",650,215,89,126,435,8,68,92,144,9,36,78
"2011","Woking 005D","E01030956","Total",509,126,33,93,383,17,24,83,116,15,35,93
"2011","Woking 005E","E01030957","Total",493,105,28,77,388,41,29,105,97,26,25,65
"2011","Woking 005F","E01030958","Total",609,171,48,123,438,24,43,97,149,13,29,83
"2011","Woking 005G","E01030959","Total",471,173,90,83,298,9,50,72,89,4,23,51
"2011","Woking 006A","E01030988","Total",821,250,55,195,571,14,86,124,203,19,25,100
"2011","Woking 006B","E01030989","Total",604,118,57,61,486,14,69,116,126,23,43,95
"2011","Woking 006C","E01030990","Total",581,142,79,63,439,5,115,91,91,25,44,68
"2011","Woking 006D","E01030997","Total",690,230,124,106,460,12,148,88,103,18,24,67
"2011","Woking 007A","E01030974","Total",629,186,45,141,443,15,50,103,130,20,39,86
"2011","Woking 007B","E01030975","Total",554,131,72,59,423,9,72,109,96,16,32,89
"2011","Woking 007C","E01030976","Total",631,162,71,91,469,17,79,120,134,15,30,74
"2011","Woking 007D","E01030977","Total",693,169,84,85,524,15,91,121,141,23,44,89
"2011","Woking 007E","E01030979","Total",832,178,29,149,654,65,38,199,200,36,40,76
"2011","Woking 008A","E01030954","Total",979,327,81,246,652,25,55,148,250,16,41,117
"2011","Woking 008B","E01030969","Total",539,112,54,58,427,4,74,124,88,23,30,84
"2011","Woking 008C","E01030970","Total",628,199,90,109,429,10,65,118,123,21,30,62
"2011","Woking 008D","E01030991","Total",1031,494,242,252,537,24,72,126,232,6,22,55
"2011","Woking 008E","E01030993","Total",1216,489,128,361,727,42,52,197,340,9,17,70
"2011","Woking 009A","E01030960","Total",742,222,76,146,520,33,45,129,175,12,30,96
"2011","Woking 009B","E01030961","Total",717,118,80,38,599,21,147,115,113,24,61,118
"2011","Woking 009C","E01030962","Total",768,279,121,158,489,40,65,96,142,13,29,104
"2011","Woking 009D","E01031000","Total",655,185,83,102,470,14,94,101,144,18,26,73
"2011","Woking 010A","E01030955","Total",578,154,62,92,424,13,71,90,136,9,30,75
"2011","Woking 010B","E01030992","Total",698,195,70,125,503,15,84,108,156,22,34,84
"2011","Woking 010C","E01030999","Total",495,70,49,21,425,5,94,84,93,28,33,88
"2011","Woking 010D","E01031001","Total",738,235,107,128,503,9,95,107,166,15,28,83
"2011","Woking 011A","E01030971","Total",737,179,90,89,558,31,90,116,120,33,50,118
"2011","Woking 011B","E01030972","Total",688,167,88,79,521,24,86,100,137,16,50,108
"2011","Woking 011C","E01030973","Total",694,178,80,98,516,24,92,110,122,22,51,95
"2011","Woking 011D","E01030994","Total",687,159,76,83,528,22,60,157,132,36,36,85
"2011","Woking 011E","E01030995","Total",549,147,52,95,402,20,34,118,124,18,32,56
"2011","Woking 012A","E01030944","Total",497,81,30,51,416,12,68,116,94,20,41,65
"2011","Woking 012B","E01030945","Total",463,96,59,37,367,21,64,86,98,17,22,59
"2011","Woking 012C","E01030978","Total",510,79,39,40,431,18,62,119,85,23,39,85
"2011","Woking 012D","E01030986","Total",449,97,65,32,352,6,116,61,78,11,25,55
"2011","Woking 012E","E01030987","Total",524,77,46,31,447,11,107,84,109,22,36,78
"2011","Adur 001A","E01031349","Total",552,149,95,54,403,12,105,63,80,13,38,92
"2011","Adur 001B","E01031350","Total",496,154,59,95,342,23,50,72,75,13,35,74
"2011","Adur 001C","E01031351","Total",647,158,117,41,489,17,147,93,92,17,28,95
"2011","Adur 001D","E01031352","Total",635,163,101,62,472,29,136,83,104,12,28,80
"2011","Adur 001E","E01031370","Total",568,131,85,46,437,32,86,95,96,16,31,81
"2011","Adur 001F","E01031374","Total",646,193,104,89,453,27,108,87,109,16,32,74
"2011","Adur 002A","E01031338","Total",497,116,64,52,381,12,103,78,92,9,21,66
"2011","Adur 002B","E01031339","Total",519,157,60,97,362,15,71,89,103,9,20,55
"2011","Adur 002C","E01031340","Total",628,145,108,37,483,8,137,74,137,9,35,83
"2011","Adur 002D","E01031365","Total",639,196,107,89,443,18,110,103,103,14,32,63
"2011","Adur 002E","E01031367","Total",546,122,80,42,424,7,124,79,116,4,28,66
"2011","Adur 003A","E01031345","Total",648,179,104,75,469,15,111,83,144,9,22,85
"2011","Adur 003B","E01031353","Total",469,113,68,45,356,4,110,66,90,14,19,53
"2011","Adur 003C","E01031354","Total",543,142,77,65,401,20,100,65,125,7,22,62
"2011","Adur 003D","E01031355","Total",692,198,102,96,494,29,111,106,116,22,32,78
"2011","Adur 003E","E01031359","Total",523,108,59,49,415,19,67,93,107,14,41,74
"2011","Adur 004A","E01031347","Total",656,190,98,92,466,52,69,89,96,11,48,101
"2011","Adur 004B","E01031348","Total",675,188,68,120,487,70,59,106,110,30,38,74
"2011","Adur 004C","E01031366","Total",495,129,46,83,366,23,49,66,81,20,51,76
"2011","Adur 004D","E01031371","Total",610,258,135,123,352,50,71,72,83,10,17,49
"2011","Adur 004E","E01031372","Total",539,160,92,68,379,38,94,69,72,15,26,65
"2011","Adur 004F","E01031373","Total",628,205,97,108,423,28,79,95,111,15,32,63
"2011","Adur 004G","E01031375","Total",701,272,156,116,429,21,102,95,117,7,24,63
"2011","Adur 005A","E01031356","Total",1035,298,113,185,737,43,153,163,236,17,22,103
"2011","Adur 005B","E01031357","Total",1035,375,143,232,660,55,101,157,207,19,32,89
"2011","Adur 005C","E01031364","Total",797,356,114,242,441,55,77,73,179,4,7,46
"2011","Adur 005D","E01031368","Total",552,169,89,80,383,20,105,71,93,9,16,69
"2011","Adur 005E","E01031369","Total",640,289,183,106,351,15,92,84,92,6,15,47
"2011","Adur 006A","E01031344","Total",608,204,72,132,404,22,102,62,110,19,21,68
"2011","Adur 006B","E01031346","Total",640,216,105,111,424,15,128,75,107,9,23,67
"2011","Adur 006C","E01031361","Total",631,189,96,93,442,39,91,83,99,16,41,73
"2011","Adur 006D","E01031362","Total",507,109,41,68,398,25,73,82,114,13,19,72
"2011","Adur 006E","E01031363","Total",746,237,155,82,509,24,176,71,117,8,31,82
"2011","Adur 007A","E01031358","Total",647,211,146,65,436,31,97,83,92,15,41,77
"2011","Adur 007B","E01031360","Total",649,177,90,87,472,35,106,86,105,15,33,92
"2011","Adur 007C","E01031376","Total",630,235,134,101,395,18,157,46,90,3,16,65
"2011","Adur 007D","E01031378","Total",663,236,124,112,427,23,118,68,127,10,16,65
"2011","Adur 008A","E01031341","Total",629,249,135,114,380,44,69,69,100,14,25,59
"2011","Adur 008B","E01031342","Total",829,317,203,114,512,35,182,73,141,8,14,59
"2011","Adur 008C","E01031343","Total",611,198,111,87,413,22,118,69,83,14,32,75
"2011","Adur 008D","E01031377","Total",807,388,142,246,419,36,86,78,155,7,12,45
"2011","Adur 008E","E01031379","Total",749,274,183,91,475,12,148,83,127,8,23,74
"2011","Arun 001A","E01031390","Total",591,167,101,66,424,20,138,64,92,17,22,71
"2011","Arun 001B","E01031391","Total",730,280,115,165,450,24,109,87,151,12,19,48
"2011","Arun 001C","E01031392","Total",730,296,167,129,434,16,141,54,132,10,7,74
"2011","Arun 001D","E01031465","Total",578,154,83,71,424,10,132,81,90,15,33,63
"2011","Arun 002A","E01031386","Total",592,147,80,67,445,18,106,77,113,20,42,69
"2011","Arun 002B","E01031387","Total",696,236,132,104,460,26,131,85,110,19,23,66
"2011","Arun 002C","E01031425","Total",610,159,101,58,451,15,155,72,113,6,25,65
"2011","Arun 002D","E01031426","Total",534,162,93,69,372,17,105,54,100,9,14,73
"2011","Arun 003A","E01031393","Total",751,199,130,69,552,19,169,83,146,11,35,89
"2011","Arun 003B","E01031394","Total",680,184,85,99,496,33,71,111,133,14,36,98
"2011","Arun 003C","E01031395","Total",637,153,83,70,484,18,128,100,124,14,28,72
"2011","Arun 003D","E01031396","Total",791,218,107,111,573,21,128,121,145,25,43,90
"2011","Arun 003E","E01031397","Total",679,163,98,65,516,14,131,85,134,12,45,95
"2011","Arun 003F","E01031466","Total",590,146,90,56,444,12,147,78,100,15,31,61
"2011","Arun 004A","E01031427","Total",615,237,128,109,378,43,74,79,80,15,33,54
"2011","Arun 004B","E01031429","Total",558,151,55,96,407,72,41,64,95,29,42,64
"2011","Arun 004C","E01031430","Total",602,157,68,89,445,39,105,83,101,18,28,71
"2011","Arun 004D","E01031467","Total",743,216,102,114,527,41,117,100,145,17,34,73
"2011","Arun 004E","E01031468","Total",940,233,69,164,707,48,98,156,207,31,55,112
"2011","Arun 005A","E01031388","Total",1067,248,118,130,819,53,183,188,197,31,65,102
"2011","Arun 005B","E01031389","Total",912,205,139,66,707,25,255,132,152,21,44,78
"2011","Arun 005C","E01031414","Total",636,171,121,50,465,17,131,88,99,18,36,76
"2011","Arun 005D","E01031415","Total",776,332,268,64,444,18,180,58,97,8,22,61
"2011","Arun 005E","E01031459","Total",810,310,162,148,500,44,112,106,115,7,39,77
"2011","Arun 006A","E01031470","Total",629,154,66,88,475,35,115,99,134,12,31,49
"2011","Arun 006B","E01031471","Total",520,118,54,64,402,15,65,81,132,14,25,70
"2011","Arun 006C","E01031472","Total",658,197,113,84,461,21,128,67,123,18,36,68
"2011","Arun 006D","E01031473","Total",493,154,69,85,339,22,59,69,79,15,26,69
"2011","Arun 007A","E01031407","Total",611,120,51,69,491,43,77,126,116,18,32,79
"2011","Arun 007B","E01031408","Total",823,209,72,137,614,54,98,148,181,24,31,78
"2011","Arun 007C","E01031410","Total",600,207,102,105,393,25,78,71,133,11,20,55
"2011","Arun 007D","E01031462","Total",636,189,103,86,447,37,98,101,103,14,26,68
"2011","Arun 007E","E01031463","Total",650,157,98,59,493,27,145,100,90,14,33,84
"2011","Arun 007F","E01031464","Total",813,352,249,103,461,33,183,72,81,11,24,57
"2011","Arun 008A","E01031412","Total",638,175,122,53,463,4,203,66,96,10,24,60
"2011","Arun 008B","E01031422","Total",764,279,201,78,485,5,255,40,102,6,22,55
"2011","Arun 008C","E01031423","Total",776,258,162,96,518,11,222,74,107,8,28,68
"2011","Arun 008D","E01031424","Total",686,240,183,57,446,10,227,46,103,6,12,42
"2011","Arun 009A","E01031398","Total",604,157,82,75,447,20,114,72,101,11,40,89
"2011","Arun 009B","E01031399","Total",753,190,135,55,563,16,238,74,114,11,28,82
"2011","Arun 009C","E01031409","Total",510,111,63,48,399,29,67,71,72,19,52,89
"2011","Arun 009D","E01031455","Total",644,249,174,75,395,26,99,58,95,9,33,75
"2011","Arun 009E","E01031461","Total",848,277,184,93,571,19,224,68,136,13,29,82
"2011","Arun 009F","E01031469","Total",759,233,136,97,526,36,162,94,109,9,20,96
"2011","Arun 010A","E01031411","Total",674,223,174,49,451,8,231,40,92,5,17,58
"2011","Arun 010B","E01031413","Total",640,266,179,87,374,17,138,54,100,8,12,45
"2011","Arun 010C","E01031457","Total",868,385,268,117,483,12,241,46,104,12,16,52
"2011","Arun 010D","E01031458","Total",909,295,231,64,614,5,316,49,152,6,21,65
"2011","Arun 010E","E01031460","Total",958,447,321,126,511,19,251,41,124,6,8,62
"2011","Arun 011A","E01031400","Total",839,426,137,289,413,28,98,71,139,12,17,48
"2011","Arun 011B","E01031428","Total",654,208,79,129,446,33,63,89,124,18,30,89
"2011","Arun 011C","E01031454","Total",999,441,116,325,558,68,77,102,176,14,40,81
"2011","Arun 011D","E01031456","Total",970,568,236,332,402,44,68,72,146,6,32,34
"2011","Arun 012A","E01031401","Total",666,190,106,84,476,32,115,87,126,9,26,81
"2011","Arun 012B","E01031402","Total",713,190,100,90,523,22,148,87,149,11,29,77
"2011","Arun 012C","E01031403","Total",634,216,110,106,418,28,96,73,109,15,36,61
"2011","Arun 012D","E01031405","Total",626,195,116,79,431,21,105,86,125,9,16,69
"2011","Arun 012E","E01031406","Total",500,108,60,48,392,22,52,96,81,16,45,80
"2011","Arun 013A","E01031417","Total",693,196,116,80,497,46,113,107,112,19,29,71
"2011","Arun 013B","E01031438","Total",739,270,142,128,469,38,100,111,113,15,26,66
"2011","Arun 013C","E01031439","Total",938,329,228,101,609,23,253,77,126,6,36,88
"2011","Arun 013D","E01031440","Total",770,271,179,92,499,13,198,47,142,8,22,69
"2011","Arun 014A","E01031404","Total",490,170,67,103,320,47,26,64,75,18,44,46
"2011","Arun 014B","E01031433","Total",610,169,90,79,441,33,124,67,88,12,33,84
"2011","Arun 014C","E01031434","Total",711,252,89,163,459,43,71,79,153,8,26,79
"2011","Arun 014D","E01031441","Total",746,270,149,121,476,39,97,90,120,16,39,75
"2011","Arun 014E","E01031442","Total",607,163,66,97,444,27,63,100,113,21,34,86
"2011","Arun 015A","E01031416","Total",643,124,85,39,519,5,175,64,111,15,45,104
"2011","Arun 015B","E01031418","Total",766,234,165,69,532,15,186,76,118,12,36,89
"2011","Arun 015C","E01031419","Total",784,325,193,132,459,34,135,63,112,7,39,69
"2011","Arun 015D","E01031420","Total",736,228,154,74,508,9,187,67,114,17,29,85
"2011","Arun 015E","E01031421","Total",730,201,128,73,529,26,173,97,102,22,34,75
"2011","Arun 016A","E01031443","Total",507,117,49,68,390,32,58,69,92,19,53,67
"2011","Arun 016B","E01031444","Total",654,220,66,154,434,36,48,97,101,17,34,101
"2011","Arun 016C","E01031450","Total",518,163,48,115,355,45,41,82,83,16,20,68
"2011","Arun 016D","E01031451","Total",621,185,103,82,436,42,82,96,107,13,29,67
"2011","Arun 016E","E01031452","Total",528,123,65,58,405,14,72,80,87,23,40,89
"2011","Arun 017A","E01031431","Total",488,281,177,104,207,11,56,20,79,3,10,28
"2011","Arun 017B","E01031432","Total",937,446,145,301,491,39,90,72,157,5,22,106
"2011","Arun 017C","E01031435","Total",724,275,98,177,449,21,98,64,148,11,24,83
"2011","Arun 017D","E01031436","Total",998,536,194,342,462,53,69,89,169,2,24,56
"2011","Arun 017E","E01031437","Total",991,531,143,388,460,40,87,83,171,5,22,52
"2011","Arun 017F","E01031453","Total",712,329,174,155,383,24,85,51,96,9,33,85
"2011","Arun 018A","E01031380","Total",749,227,164,63,522,13,241,54,110,6,22,76
"2011","Arun 018B","E01031381","Total",768,267,207,60,501,18,198,61,129,9,23,63
"2011","Arun 018C","E01031382","Total",795,217,159,58,578,10,254,75,133,9,22,75
"2011","Arun 018D","E01031383","Total",745,197,160,37,548,11,264,43,130,11,20,69
"2011","Arun 018E","E01031384","Total",774,197,150,47,577,15,223,88,124,9,21,97
"2011","Arun 019A","E01031385","Total",763,273,177,96,490,31,185,74,109,14,23,54
"2011","Arun 019B","E01031445","Total",766,272,199,73,494,18,267,50,76,8,14,61
"2011","Arun 019C","E01031446","Total",623,181,121,60,442,16,174,76,99,6,18,53
"2011","Arun 019D","E01031447","Total",733,224,163,61,509,21,218,55,113,12,24,66
"2011","Arun 019E","E01031448","Total",766,260,157,103,506,17,185,49,148,15,19,73
"2011","Arun 019F","E01031449","Total",670,189,113,76,481,36,103,99,105,12,41,85
"2011","Chichester 001A","E01031502","Total",592,111,56,55,481,15,94,146,109,31,15,71
"2011","Chichester 001B","E01031503","Total",567,130,70,60,437,26,74,106,106,25,29,71
"2011","Chichester 001C","E01031504","Total",935,291,153,138,644,34,177,138,167,27,23,78
"2011","Chichester 001D","E01031519","Total",542,116,48,68,426,12,95,96,108,24,29,62
"2011","Chichester 002A","E01031517","Total",734,155,89,66,579,13,151,110,144,39,34,88
"2011","Chichester 002B","E01031518","Total",619,117,71,46,502,14,145,99,116,24,32,72
"2011","Chichester 002C","E01031544","Total",519,117,49,68,402,17,102,83,99,13,36,52
"2011","Chichester 002D","E01031545","Total",515,145,94,51,370,8,105,63,95,15,17,67
"2011","Chichester 003A","E01031508","Total",874,240,134,106,634,15,188,108,163,22,40,98
"2011","Chichester 003B","E01031520","Total",548,147,84,63,401,14,114,68,103,13,27,62
"2011","Chichester 003C","E01031521","Total",453,88,48,40,365,10,92,64,104,20,18,57
"2011","Chichester 003D","E01031536","Total",517,166,79,87,351,3,100,70,101,19,21,37
"2011","Chichester 004A","E01031497","Total",565,158,85,73,407,18,107,77,98,16,28,63
"2011","Chichester 004C","E01031511","Total",749,296,195,101,453,24,162,65,118,8,16,60
"2011","Chichester 004D","E01031512","Total",882,328,186,142,554,34,121,94,160,18,34,93
"2011","Chichester 004F","E01032717","Total",1228,473,263,210,755,41,230,139,199,21,24,101
"2011","Chichester 005A","E01031478","Total",464,133,66,67,331,5,107,62,81,13,10,53
"2011","Chichester 005B","E01031479","Total",442,118,59,59,324,11,91,43,98,13,12,56
"2011","Chichester 005C","E01031498","Total",482,161,90,71,321,7,96,66,56,14,34,48
"2011","Chichester 005D","E01031514","Total",758,270,164,106,488,22,159,84,119,20,17,67
"2011","Chichester 005E","E01031515","Total",702,220,106,114,482,40,113,95,107,24,24,79
"2011","Chichester 005F","E01031516","Total",654,169,85,84,485,18,147,81,155,12,21,51
"2011","Chichester 006A","E01031477","Total",1002,335,170,165,667,37,207,107,171,26,35,84
"2011","Chichester 006B","E01031485","Total",675,197,155,42,478,4,199,75,91,11,27,71
"2011","Chichester 006C","E01031487","Total",675,198,134,64,477,17,189,63,84,9,28,87
"2011","Chichester 006D","E01031509","Total",1004,275,118,157,729,34,174,133,206,19,42,121
"2011","Chichester 007A","E01031506","Total",529,123,69,54,406,14,124,60,101,20,29,58
"2011","Chichester 007B","E01031507","Total",588,138,64,74,450,14,126,75,128,17,26,64
"2011","Chichester 007C","E01031531","Total",524,115,75,40,409,7,125,76,80,15,30,76
"2011","Chichester 007D","E01031533","Total",508,164,108,56,344,19,84,67,75,6,25,68
"2011","Chichester 007E","E01031543","Total",1000,287,125,162,713,46,173,135,205,29,40,85
"2011","Chichester 008A","E01031482","Total",683,256,89,167,427,49,38,66,137,13,20,104
"2011","Chichester 008B","E01031483","Total",1006,350,92,258,656,65,69,124,190,24,55,129
"2011","Chichester 008C","E01031486","Total",841,423,228,195,418,16,140,43,147,6,6,60
"2011","Chichester 008D","E01031488","Total",771,247,66,181,524,35,71,111,133,18,29,127
"2011","Chichester 008E","E01031494","Total",730,263,168,95,467,54,105,84,97,11,19,97
"2011","Chichester 008F","E01031495","Total",760,296,191,105,464,21,118,67,130,12,23,93
"2011","Chichester 009A","E01031475","Total",505,120,63,57,385,7,111,88,78,12,15,74
"2011","Chichester 009B","E01031476","Total",692,227,146,81,465,5,179,83,104,13,21,60
"2011","Chichester 009C","E01031532","Total",456,93,45,48,363,6,47,153,88,29,22,18
"2011","Chichester 009D","E01031534","Total",867,343,160,183,524,42,166,71,148,12,27,58
"2011","Chichester 009E","E01031535","Total",677,193,113,80,484,21,133,75,138,20,33,64
"2011","Chichester 010A","E01031480","Total",605,206,40,166,399,26,54,80,145,15,15,64
"2011","Chichester 010B","E01031481","Total",740,297,128,169,443,34,93,77,142,13,16,68
"2011","Chichester 010C","E01031484","Total",905,402,183,219,503,32,116,74,161,6,23,91
"2011","Chichester 010D","E01031490","Total",956,535,340,195,421,12,126,50,149,7,13,64
"2011","Chichester 010E","E01031491","Total",924,398,150,248,526,22,124,101,178,16,19,66
"2011","Chichester 011A","E01031474","Total",636,196,106,90,440,28,98,83,123,13,29,66
"2011","Chichester 011B","E01031493","Total",786,274,163,111,512,27,167,72,124,15,22,85
"2011","Chichester 011C","E01031496","Total",933,244,137,107,689,34,167,129,187,18,42,112
"2011","Chichester 011D","E01031505","Total",988,287,161,126,701,25,180,127,178,20,52,119
"2011","Chichester 012A","E01031489","Total",645,206,89,117,439,22,92,86,110,11,35,83
"2011","Chichester 012B","E01031492","Total",614,228,134,94,386,37,54,56,81,20,41,97
"2011","Chichester 012C","E01031513","Total",907,228,115,113,679,29,184,120,160,28,37,121
"2011","Chichester 012D","E01031530","Total",535,163,85,78,372,22,74,58,103,19,34,62
"2011","Chichester 012E","E01031538","Total",615,143,57,86,472,31,85,89,137,23,39,68
"2011","Chichester 012F","E01031539","Total",491,167,43,124,324,29,38,79,114,14,10,40
"2011","Chichester 013A","E01031499","Total",797,247,119,128,550,44,130,93,153,20,32,78
"2011","Chichester 013B","E01031500","Total",766,208,123,85,558,18,181,75,131,12,46,95
"2011","Chichester 013C","E01031501","Total",692,293,188,105,399,18,133,53,91,11,29,64
"2011","Chichester 013D","E01031529","Total",479,108,56,52,371,7,107,53,94,16,24,70
"2011","Chichester 013E","E01031540","Total",664,228,159,69,436,12,196,49,95,14,14,56
"2011","Chichester 013F","E01031541","Total",688,279,200,79,409,16,176,46,77,10,13,71
"2011","Chichester 013G","E01031542","Total",785,204,138,66,581,14,220,83,128,19,35,82
"2011","Chichester 014A","E01031522","Total",925,367,233,134,558,36,133,96,157,29,34,73
"2011","Chichester 014B","E01031523","Total",697,221,141,80,476,23,159,72,103,13,31,75
"2011","Chichester 014C","E01031524","Total",712,253,185,68,459,7,213,50,100,6,19,64
"2011","Chichester 014D","E01031525","Total",627,201,132,69,426,20,128,52,110,12,21,83
"2011","Chichester 014E","E01031526","Total",543,129,93,36,414,15,141,53,96,21,20,68
"2011","Chichester 014F","E01031527","Total",678,186,124,62,492,21,199,51,104,15,28,74
"2011","Chichester 014G","E01031528","Total",681,258,137,121,423,32,133,61,101,9,26,61
"2011","Crawley 001A","E01031573","Total",642,198,91,107,444,32,66,88,97,27,45,89
"2011","Crawley 001B","E01031574","Total",649,132,64,68,517,32,65,111,106,33,63,107
"2011","Crawley 001C","E01031575","Total",647,198,40,158,449,33,49,77,114,26,40,110
"2011","Crawley 001D","E01031576","Total",564,141,78,63,423,43,66,70,52,32,60,100
"2011","Crawley 001E","E01031577","Total",440,84,50,34,356,24,47,37,50,23,61,114
"2011","Crawley 002A","E01031586","Total",726,220,70,150,506,45,39,161,129,17,40,75
"2011","Crawley 002B","E01031587","Total",650,116,50,66,534,22,100,94,155,15,27,121
"2011","Crawley 002C","E01031588","Total",606,172,89,83,434,16,92,88,90,13,47,88
"2011","Crawley 002D","E01031590","Total",649,166,59,107,483,11,69,110,143,14,36,100
"2011","Crawley 002E","E01031593","Total",597,171,47,124,426,12,66,87,134,14,30,83
"2011","Crawley 003A","E01031570","Total",510,110,55,55,400,34,73,70,84,14,38,87
"2011","Crawley 003B","E01031571","Total",674,203,111,92,471,41,85,99,102,20,38,86
"2011","Crawley 003C","E01031572","Total",637,223,105,118,414,32,91,82,103,14,21,71
"2011","Crawley 003D","E01031609","Total",684,255,122,133,429,42,53,67,115,28,34,90
"2011","Crawley 003E","E01031610","Total",796,277,136,141,519,49,94,113,125,15,35,88
"2011","Crawley 004A","E01031583","Total",931,353,71,282,578,52,47,123,225,12,33,86
"2011","Crawley 004B","E01031584","Total",655,173,87,86,482,35,84,75,116,21,46,105
"2011","Crawley 004C","E01031585","Total",673,224,112,112,449,14,77,57,110,21,51,119
"2011","Crawley 004D","E01031601","Total",487,125,64,61,362,17,80,59,76,18,40,72
"2011","Crawley 004F","E01032835","Total",758,307,36,271,451,51,24,128,198,4,13,33
"2011","Crawley 004G","E01032836","Total",637,191,103,88,446,24,77,84,97,18,42,104
"2011","Crawley 005A","E01031589","Total",707,202,109,93,505,11,101,107,113,21,53,99
"2011","Crawley 005B","E01031591","Total",766,212,69,143,554,62,77,92,173,18,45,87
"2011","Crawley 005C","E01031594","Total",577,155,73,82,422,46,74,99,89,16,35,63
"2011","Crawley 005D","E01031600","Total",624,221,107,114,403,29,67,84,108,10,28,77
"2011","Crawley 005E","E01031603","Total",595,156,61,95,439,33,59,78,127,14,37,91
"2011","Crawley 006A","E01031564","Total",614,157,77,80,457,22,99,95,110,12,33,86
"2011","Crawley 006B","E01031565","Total",846,234,136,98,612,58,106,111,114,26,66,131
"2011","Crawley 006C","E01031566","Total",668,177,68,109,491,34,110,80,106,12,37,112
"2011","Crawley 006D","E01031567","Total",518,120,51,69,398,26,87,58,90,12,37,88
"2011","Crawley 006E","E01031568","Total",635,213,41,172,422,44,37,96,164,13,24,44
"2011","Crawley 007A","E01031596","Total",788,251,101,150,537,71,86,112,112,24,33,99
"2011","Crawley 007B","E01031597","Total",587,150,85,65,437,11,100,63,104,16,40,103
"2011","Crawley 007C","E01031598","Total",765,330,113,217,435,43,51,87,147,12,28,67
"2011","Crawley 007D","E01031599","Total",772,263,106,157,509,38,65,118,150,16,31,91
"2011","Crawley 007E","E01031608","Total",738,251,63,188,487,42,53,93,141,17,36,105
"2011","Crawley 008A","E01031578","Total",743,206,40,166,537,29,36,182,170,17,33,70
"2011","Crawley 008B","E01031580","Total",860,133,27,106,727,79,39,244,205,31,54,75
"2011","Crawley 008C","E01031581","Total",619,85,12,73,534,22,39,210,129,25,45,64
"2011","Crawley 008D","E01031592","Total",786,147,46,101,639,16,104,148,205,28,32,106
"2011","Crawley 009A","E01031560","Total",624,186,99,87,438,16,107,71,97,10,37,100
"2011","Crawley 009B","E01031561","Total",597,152,84,68,445,16,111,73,104,11,25,105
"2011","Crawley 009C","E01031562","Total",604,247,133,114,357,42,62,59,92,12,24,66
"2011","Crawley 009D","E01031563","Total",484,113,75,38,371,9,85,57,75,9,37,99
"2011","Crawley 009E","E01031579","Total",701,233,65,168,468,37,21,138,167,16,42,47
"2011","Crawley 009F","E01031582","Total",799,241,13,228,558,49,23,197,211,20,16,42
"2011","Crawley 010A","E01031547","Total",518,143,34,109,375,45,20,79,105,14,32,80
"2011","Crawley 010B","E01031548","Total",698,277,49,228,421,56,29,100,109,21,44,62
"2011","Crawley 010C","E01031549","Total",523,120,23,97,403,51,16,83,89,22,57,85
"2011","Crawley 010D","E01031550","Total",522,117,8,109,405,41,15,87,94,17,45,106
"2011","Crawley 010E","E01031569","Total",639,156,61,95,483,47,76,91,130,30,31,78
"2011","Crawley 011A","E01031595","Total",642,146,77,69,496,49,82,96,93,23,46,107
"2011","Crawley 011B","E01031604","Total",674,222,122,100,452,24,85,89,114,21,27,92
"2011","Crawley 011C","E01031605","Total",599,140,86,54,459,47,86,83,83,24,41,95
"2011","Crawley 011D","E01031606","Total",611,161,97,64,450,34,94,88,96,26,36,76
"2011","Crawley 011E","E01031607","Total",570,180,93,87,390,30,78,75,71,21,45,70
"2011","Crawley 012A","E01031546","Total",477,74,11,63,403,20,20,85,94,20,68,96
"2011","Crawley 012B","E01031551","Total",496,67,14,53,429,32,22,99,81,26,61,108
"2011","Crawley 012C","E01031553","Total",504,80,15,65,424,39,18,92,90,38,65,82
"2011","Crawley 012D","E01031554","Total",700,226,31,195,474,35,30,106,141,22,50,90
"2011","Crawley 012E","E01031555","Total",485,76,21,55,409,30,44,70,65,33,64,103
"2011","Crawley 013A","E01031552","Total",753,200,67,133,553,65,53,112,148,20,38,117
"2011","Crawley 013B","E01031556","Total",663,180,15,165,483,84,20,111,133,27,40,68
"2011","Crawley 013C","E01031557","Total",862,361,27,334,501,43,28,129,211,10,17,63
"2011","Crawley 013D","E01031558","Total",648,246,103,143,402,59,44,75,71,26,54,73
"2011","Crawley 013E","E01031559","Total",514,83,20,63,431,39,23,107,104,27,49,82
"2011","Horsham 001A","E01031670","Total",702,247,85,162,455,16,81,96,149,17,25,71
"2011","Horsham 001B","E01031671","Total",798,349,106,243,449,24,63,102,151,17,25,67
"2011","Horsham 001C","E01031673","Total",645,190,65,125,455,47,55,102,121,18,25,87
"2011","Horsham 001D","E01031676","Total",1053,250,80,170,803,21,161,163,230,29,71,128
"2011","Horsham 002A","E01031644","Total",559,118,38,80,441,22,71,103,106,23,29,87
"2011","Horsham 002B","E01031645","Total",550,111,40,71,439,18,54,118,124,17,44,64
"2011","Horsham 002C","E01031646","Total",603,145,41,104,458,28,48,121,127,17,38,79
"2011","Horsham 002D","E01031647","Total",508,164,61,103,344,19,53,64,102,18,31,57
"2011","Horsham 002E","E01031649","Total",455,116,45,71,339,7,43,91,89,13,25,71
"2011","Horsham 002F","E01031650","Total",490,89,25,64,401,10,76,94,92,18,40,71
"2011","Horsham 002G","E01031666","Total",646,112,75,37,534,10,163,106,130,21,36,68
"2011","Horsham 002H","E01031668","Total",654,157,105,52,497,19,155,96,106,11,32,78
"2011","Horsham 003A","E01031620","Total",680,203,67,136,477,39,68,107,127,18,31,87
"2011","Horsham 003B","E01031648","Total",783,281,119,162,502,28,108,84,160,18,32,72
"2011","Horsham 003C","E01031651","Total",646,161,54,107,485,29,60,134,131,20,36,75
"2011","Horsham 003D","E01031658","Total",874,247,144,103,627,33,159,121,167,19,34,94
"2011","Horsham 003E","E01031689","Total",663,194,84,110,469,17,81,118,128,18,31,76
"2011","Horsham 004A","E01031654","Total",650,179,107,72,471,14,120,102,93,19,31,92
"2011","Horsham 004B","E01031655","Total",619,165,55,110,454,30,46,136,138,17,25,62
"2011","Horsham 004C","E01031667","Total",652,181,98,83,471,18,111,97,108,24,29,84
"2011","Horsham 004D","E01031669","Total",685,220,87,133,465,42,73,80,142,22,28,78
"2011","Horsham 004E","E01031672","Total",822,344,118,226,478,15,75,106,179,18,24,61
"2011","Horsham 005A","E01031657","Total",789,224,95,129,565,28,117,121,151,24,27,97
"2011","Horsham 005B","E01031659","Total",555,111,62,49,444,8,90,86,110,21,39,90
"2011","Horsham 005C","E01031674","Total",545,159,86,73,386,5,97,78,112,17,11,66
"2011","Horsham 005D","E01031675","Total",541,114,56,58,427,12,94,88,106,20,28,79
"2011","Horsham 006A","E01031636","Total",1091,515,211,304,576,39,132,103,167,13,41,81
"2011","Horsham 006B","E01031652","Total",631,155,80,75,476,37,72,107,81,32,54,93
"2011","Horsham 006C","E01031653","Total",779,314,92,222,465,22,60,93,178,11,33,68
"2011","Horsham 006D","E01031656","Total",817,347,168,179,470,30,46,116,156,13,42,67
"2011","Horsham 006E","E01031688","Total",603,205,138,67,398,23,99,83,87,17,29,60
"2011","Horsham 006F","E01031691","Total",776,268,157,111,508,20,127,112,153,15,22,59
"2011","Horsham 007A","E01031619","Total",643,200,50,150,443,19,55,103,137,10,41,78
"2011","Horsham 007B","E01031637","Total",812,222,101,121,590,43,114,115,169,22,26,101
"2011","Horsham 007C","E01031638","Total",796,245,95,150,551,30,78,119,198,17,28,81
"2011","Horsham 007D","E01031690","Total",641,161,108,53,480,4,142,90,121,26,25,72
"2011","Horsham 008A","E01031639","Total",798,222,89,133,576,16,137,110,177,18,38,80
"2011","Horsham 008B","E01031640","Total",713,112,83,29,601,8,192,101,129,22,40,109
"2011","Horsham 008C","E01031660","Total",515,113,62,51,402,12,120,68,98,17,21,66
"2011","Horsham 008D","E01031661","Total",630,127,66,61,503,7,130,77,144,16,34,95
"2011","Horsham 008E","E01031679","Total",498,113,42,71,385,8,70,82,119,24,30,52
"2011","Horsham 009A","E01031677","Total",604,158,82,76,446,21,96,103,98,20,26,82
"2011","Horsham 009B","E01031678","Total",571,79,39,40,492,11,71,120,112,29,47,102
"2011","Horsham 009C","E01031680","Total",493,71,31,40,422,9,55,115,107,17,39,80
"2011","Horsham 009D","E01031681","Total",581,137,60,77,444,23,56,122,116,25,37,65
"2011","Horsham 009E","E01031682","Total",470,113,26,87,357,16,25,118,110,11,26,51
"2011","Horsham 009F","E01031683","Total",623,172,53,119,451,28,61,111,138,14,34,65
"2011","Horsham 010A","E01031611","Total",669,167,68,99,502,12,114,87,147,14,35,93
"2011","Horsham 010B","E01031612","Total",874,223,99,124,651,27,123,178,187,18,40,78
"2011","Horsham 010C","E01031613","Total",842,226,85,141,616,24,119,155,163,31,43,81
"2011","Horsham 010D","E01031614","Total",839,253,130,123,586,51,87,158,154,34,29,73
"2011","Horsham 010E","E01031615","Total",721,256,151,105,465,12,135,85,121,16,24,72
"2011","Horsham 011A","E01031632","Total",615,144,57,87,471,13,101,85,153,12,29,78
"2011","Horsham 011B","E01031633","Total",524,131,71,60,393,9,96,82,87,15,29,75
"2011","Horsham 011C","E01031634","Total",493,112,49,63,381,19,71,81,108,20,27,55
"2011","Horsham 011D","E01031635","Total",552,111,43,68,441,15,76,111,106,16,30,87
"2011","Horsham 012A","E01031621","Total",793,159,124,35,634,6,305,53,173,6,13,78
"2011","Horsham 012B","E01031623","Total",752,189,129,60,563,8,181,77,148,15,22,112
"2011","Horsham 012C","E01031627","Total",838,196,135,61,642,18,213,111,146,26,33,95
"2011","Horsham 012D","E01031664","Total",666,132,77,55,534,12,160,90,137,14,31,90
"2011","Horsham 013A","E01031626","Total",669,194,116,78,475,13,138,86,144,23,22,49
"2011","Horsham 013B","E01031630","Total",825,321,218,103,504,15,161,88,134,12,26,68
"2011","Horsham 013C","E01031631","Total",791,323,213,110,468,33,143,89,120,15,17,51
"2011","Horsham 013D","E01031662","Total",719,261,117,144,458,20,104,90,142,9,20,73
"2011","Horsham 013E","E01031663","Total",777,236,99,137,541,36,111,106,144,22,35,87
"2011","Horsham 013F","E01031665","Total",543,147,81,66,396,7,112,65,124,13,20,55
"2011","Horsham 014A","E01031618","Total",542,105,50,55,437,19,113,58,116,15,32,84
"2011","Horsham 014B","E01031641","Total",749,273,173,100,476,17,172,72,103,14,34,64
"2011","Horsham 014C","E01031642","Total",772,175,112,63,597,34,177,92,143,21,37,93
"2011","Horsham 014D","E01031643","Total",725,264,165,99,461,38,125,108,82,12,32,64
"2011","Horsham 014E","E01031687","Total",676,225,117,108,451,29,82,94,94,18,34,100
"2011","Horsham 015A","E01031622","Total",637,114,44,70,523,18,119,130,143,5,33,75
"2011","Horsham 015B","E01031624","Total",599,110,48,62,489,21,89,107,143,13,39,77
"2011","Horsham 015C","E01031625","Total",547,103,51,52,444,15,87,95,106,18,31,92
"2011","Horsham 015D","E01031628","Total",507,134,51,83,373,18,87,60,88,13,33,74
"2011","Horsham 015E","E01031629","Total",631,138,88,50,493,8,163,75,143,10,26,68
"2011","Horsham 016A","E01031616","Total",685,210,86,124,475,31,105,102,109,16,32,80
"2011","Horsham 016B","E01031617","Total",993,257,142,115,736,26,208,145,173,14,47,123
"2011","Horsham 016C","E01031684","Total",631,175,95,80,456,15,119,86,119,12,30,75
"2011","Horsham 016D","E01031685","Total",842,349,216,133,493,22,159,87,128,14,27,56
"2011","Horsham 016E","E01031686","Total",633,183,125,58,450,11,170,81,74,11,27,76
"2011","Mid Sussex 001A","E01031731","Total",860,303,164,139,557,55,87,114,119,29,41,112
"2011","Mid Sussex 001B","E01031732","Total",699,143,62,81,556,39,88,128,141,23,37,100
"2011","Mid Sussex 001C","E01031733","Total",755,260,91,169,495,34,70,127,139,14,24,87
"2011","Mid Sussex 001D","E01031734","Total",620,100,53,47,520,13,105,113,105,14,42,128
"2011","Mid Sussex 001E","E01031741","Total",819,334,140,194,485,24,93,96,166,9,28,69
"2011","Mid Sussex 001F","E01031742","Total",971,479,252,227,492,20,113,80,161,11,32,75
"2011","Mid Sussex 001G","E01031743","Total",769,310,83,227,459,41,59,89,153,21,23,73
"2011","Mid Sussex 002A","E01031718","Total",685,144,63,81,541,18,92,104,130,19,46,132
"2011","Mid Sussex 002B","E01031719","Total",722,172,72,100,550,34,111,106,135,24,40,100
"2011","Mid Sussex 002C","E01031720","Total",548,117,62,55,431,10,99,87,100,17,44,74
"2011","Mid Sussex 002D","E01031722","Total",474,138,52,86,336,10,54,63,102,21,25,61
"2011","Mid Sussex 003A","E01031695","Total",565,125,57,68,440,12,84,87,115,19,33,90
"2011","Mid Sussex 003B","E01031696","Total",563,158,66,92,405,22,97,84,94,11,26,71
"2011","Mid Sussex 003C","E01031729","Total",706,129,82,47,577,11,133,107,146,12,35,133
"2011","Mid Sussex 003D","E01031730","Total",781,238,47,191,543,38,31,154,200,19,30,71
"2011","Mid Sussex 003E","E01031735","Total",695,148,61,87,547,21,113,108,150,11,26,118
"2011","Mid Sussex 004A","E01031736","Total",620,123,62,61,497,8,134,82,121,27,29,96
"2011","Mid Sussex 004B","E01031737","Total",580,109,40,69,471,20,92,115,107,23,32,82
"2011","Mid Sussex 004C","E01031738","Total",512,132,95,37,380,3,109,69,76,15,30,78
"2011","Mid Sussex 004D","E01031739","Total",724,176,80,96,548,9,137,123,124,16,36,103
"2011","Mid Sussex 004E","E01031740","Total",545,128,70,58,417,8,105,75,107,16,24,82
"2011","Mid Sussex 005A","E01031721","Total",698,233,154,79,465,22,160,78,92,12,19,82
"2011","Mid Sussex 005B","E01031723","Total",551,118,61,57,433,7,101,71,107,15,26,106
"2011","Mid Sussex 005C","E01031724","Total",506,77,30,47,429,14,55,110,113,12,36,89
"2011","Mid Sussex 005D","E01031725","Total",588,118,64,54,470,15,113,87,125,20,36,74
"2011","Mid Sussex 006A","E01031694","Total",689,183,93,90,506,21,97,87,137,34,45,85
"2011","Mid Sussex 006B","E01031764","Total",596,157,97,60,439,13,108,100,105,19,27,67
"2011","Mid Sussex 006C","E01031765","Total",611,127,74,53,484,14,99,104,121,25,38,83
"2011","Mid Sussex 006D","E01031766","Total",833,189,78,111,644,16,147,139,162,18,46,116
"2011","Mid Sussex 007A","E01031692","Total",897,260,90,170,637,39,95,156,175,33,58,81
"2011","Mid Sussex 007B","E01031693","Total",755,207,118,89,548,12,121,126,144,28,39,78
"2011","Mid Sussex 007C","E01031697","Total",488,122,60,62,366,11,69,83,100,17,27,59
"2011","Mid Sussex 007D","E01031727","Total",644,137,65,72,507,11,132,120,107,23,30,84
"2011","Mid Sussex 008A","E01031758","Total",507,79,32,47,428,11,76,91,93,19,35,103
"2011","Mid Sussex 008B","E01031760","Total",683,138,62,76,545,16,88,137,173,28,27,76
"2011","Mid Sussex 008C","E01031772","Total",724,227,140,87,497,29,125,95,139,19,21,69
"2011","Mid Sussex 008D","E01031773","Total",815,218,137,81,597,13,172,121,141,42,33,75
"2011","Mid Sussex 008E","E01031774","Total",661,142,95,47,519,8,154,127,105,25,23,77
"2011","Mid Sussex 008F","E01031775","Total",775,240,167,73,535,17,175,108,121,23,20,71
"2011","Mid Sussex 009A","E01031751","Total",1156,384,93,291,772,35,84,196,276,31,39,111
"2011","Mid Sussex 009B","E01031759","Total",710,216,93,123,494,9,107,105,148,18,35,72
"2011","Mid Sussex 009C","E01031761","Total",1103,573,227,346,530,19,72,77,265,10,37,50
"2011","Mid Sussex 009E","E01032837","Total",552,199,115,84,353,14,57,107,111,19,12,33
"2011","Mid Sussex 009F","E01032838","Total",562,140,10,130,422,32,25,134,176,17,14,24
"2011","Mid Sussex 009G","E01032839","Total",573,224,85,139,349,9,70,58,144,9,9,50
"2011","Mid Sussex 010A","E01031752","Total",558,166,70,96,392,36,56,87,84,34,33,62
"2011","Mid Sussex 010B","E01031753","Total",590,176,72,104,414,21,89,81,116,16,31,60
"2011","Mid Sussex 010C","E01031754","Total",646,179,96,83,467,17,73,121,117,10,39,90
"2011","Mid Sussex 010D","E01031755","Total",533,132,62,70,401,20,60,96,114,19,30,62
"2011","Mid Sussex 010E","E01031757","Total",701,259,97,162,442,33,79,105,119,24,21,61
"2011","Mid Sussex 011A","E01031726","Total",596,184,68,116,412,22,64,116,92,27,30,61
"2011","Mid Sussex 011B","E01031728","Total",840,241,137,104,599,16,159,127,145,39,30,83
"2011","Mid Sussex 011C","E01031749","Total",603,132,69,63,471,17,99,120,126,16,27,66
"2011","Mid Sussex 011D","E01031750","Total",637,200,68,132,437,30,77,101,110,16,28,75
"2011","Mid Sussex 011E","E01031756","Total",778,212,68,144,566,29,114,117,165,18,33,90
"2011","Mid Sussex 011F","E01031763","Total",695,136,80,56,559,11,158,111,126,24,34,95
"2011","Mid Sussex 012A","E01031699","Total",685,165,45,120,520,34,40,145,186,13,33,69
"2011","Mid Sussex 012B","E01031700","Total",607,81,26,55,526,26,51,171,136,23,44,75
"2011","Mid Sussex 012C","E01031701","Total",752,193,63,130,559,39,78,140,157,23,36,86
"2011","Mid Sussex 012D","E01031714","Total",564,137,82,55,427,19,71,100,87,22,37,91
"2011","Mid Sussex 013A","E01031704","Total",717,179,80,99,538,29,105,131,131,24,30,88
"2011","Mid Sussex 013B","E01031706","Total",669,146,92,54,523,10,125,100,119,22,37,110
"2011","Mid Sussex 013C","E01031711","Total",683,135,72,63,548,18,97,131,142,16,42,102
"2011","Mid Sussex 013D","E01031712","Total",639,199,89,110,440,44,69,98,127,13,32,57
"2011","Mid Sussex 013E","E01031713","Total",556,108,62,46,448,7,131,85,95,12,29,89
"2011","Mid Sussex 014A","E01031705","Total",658,215,89,126,443,26,51,98,131,26,32,79
"2011","Mid Sussex 014B","E01031707","Total",647,168,110,58,479,8,131,86,119,12,30,93
"2011","Mid Sussex 014C","E01031708","Total",751,298,100,198,453,18,51,105,154,13,33,79
"2011","Mid Sussex 014D","E01031709","Total",779,348,157,191,431,21,71,94,128,14,32,71
"2011","Mid Sussex 014E","E01031716","Total",476,105,42,63,371,40,65,92,77,26,30,41
"2011","Mid Sussex 014F","E01031717","Total",566,146,51,95,420,24,57,114,115,19,26,65
"2011","Mid Sussex 015A","E01031702","Total",527,59,32,27,468,7,116,74,100,17,31,123
"2011","Mid Sussex 015B","E01031703","Total",646,130,83,47,516,7,185,71,101,9,37,106
"2011","Mid Sussex 015C","E01031710","Total",592,135,85,50,457,14,135,87,93,13,25,90
"2011","Mid Sussex 015D","E01031715","Total",612,122,36,86,490,27,52,175,139,17,21,59
"2011","Mid Sussex 016A","E01031698","Total",624,129,51,78,495,15,88,96,139,25,40,92
"2011","Mid Sussex 016B","E01031767","Total",537,123,68,55,414,8,98,96,81,23,28,80
"2011","Mid Sussex 016C","E01031769","Total",707,195,77,118,512,38,73,157,122,20,47,55
"2011","Mid Sussex 016D","E01031770","Total",719,216,100,116,503,16,100,105,156,29,30,67
"2011","Mid Sussex 016E","E01031771","Total",605,131,46,85,474,37,57,115,123,30,46,66
"2011","Mid Sussex 017A","E01031744","Total",587,135,93,42,452,9,120,95,87,10,40,91
"2011","Mid Sussex 017B","E01031745","Total",788,227,159,68,561,22,158,119,147,21,14,80
"2011","Mid Sussex 017C","E01031746","Total",727,253,135,118,474,37,81,97,125,18,47,69
"2011","Mid Sussex 017D","E01031747","Total",670,218,155,63,452,14,164,76,107,10,24,57
"2011","Mid Sussex 017E","E01031748","Total",569,161,97,64,408,15,129,87,82,18,17,60
"2011","Mid Sussex 017F","E01031768","Total",683,220,163,57,463,12,148,95,96,20,21,71
"2011","Worthing 001A","E01031793","Total",604,160,115,45,444,10,138,63,138,14,18,63
"2011","Worthing 001B","E01031820","Total",796,217,149,68,579,8,272,63,112,12,29,83
"2011","Worthing 001C","E01031821","Total",771,264,169,95,507,23,135,110,135,12,20,72
"2011","Worthing 001D","E01031828","Total",538,104,63,41,434,8,141,66,119,9,29,62
"2011","Worthing 001E","E01031829","Total",621,125,78,47,496,12,156,63,124,11,38,92
"2011","Worthing 002A","E01031822","Total",657,170,107,63,487,25,134,84,105,12,39,88
"2011","Worthing 002B","E01031825","Total",784,261,151,110,523,16,200,62,145,9,26,65
"2011","Worthing 002C","E01031826","Total",613,208,83,125,405,26,77,86,111,9,23,73
"2011","Worthing 002D","E01031827","Total",650,239,103,136,411,32,84,79,107,18,31,60
"2011","Worthing 002E","E01031839","Total",762,270,127,143,492,39,81,125,128,18,27,74
"2011","Worthing 003A","E01031792","Total",621,217,121,96,404,22,99,81,104,17,25,56
"2011","Worthing 003B","E01031794","Total",660,245,177,68,415,15,159,52,102,11,18,58
"2011","Worthing 003C","E01031795","Total",647,227,91,136,420,42,30,107,122,27,25,67
"2011","Worthing 003D","E01031818","Total",758,138,53,85,620,46,71,126,157,34,56,130
"2011","Worthing 003E","E01031830","Total",654,160,75,85,494,51,111,81,112,29,36,74
"2011","Worthing 004A","E01031778","Total",677,247,105,142,430,23,92,81,109,16,36,73
"2011","Worthing 004B","E01031797","Total",512,114,59,55,398,15,91,76,93,13,37,73
"2011","Worthing 004C","E01031800","Total",629,160,94,66,469,29,92,135,96,22,31,64
"2011","Worthing 004D","E01031823","Total",533,89,54,35,444,6,111,99,91,17,46,74
"2011","Worthing 004E","E01031824","Total",511,107,67,40,404,16,87,84,81,22,32,82
"2011","Worthing 005A","E01031776","Total",690,233,90,143,457,39,50,134,131,17,28,58
"2011","Worthing 005B","E01031777","Total",725,245,110,135,480,29,70,132,122,19,36,72
"2011","Worthing 005C","E01031780","Total",553,104,52,52,449,18,55,113,95,24,44,100
"2011","Worthing 005D","E01031781","Total",632,134,70,64,498,41,72,121,112,26,40,86
"2011","Worthing 005E","E01031798","Total",695,268,68,200,427,16,61,91,139,14,42,64
"2011","Worthing 006A","E01031783","Total",614,189,103,86,425,27,83,77,83,29,48,78
"2011","Worthing 006B","E01031785","Total",647,206,92,114,441,36,89,84,124,14,25,69
"2011","Worthing 006C","E01031786","Total",626,159,65,94,467,32,90,92,120,20,30,83
"2011","Worthing 006D","E01031817","Total",640,177,40,137,463,34,45,105,137,21,53,68
"2011","Worthing 006E","E01031819","Total",474,116,21,95,358,52,31,73,73,25,44,60
"2011","Worthing 007A","E01031782","Total",776,230,152,78,546,21,218,77,111,13,19,87
"2011","Worthing 007B","E01031784","Total",780,212,109,103,568,44,129,106,142,18,38,91
"2011","Worthing 007C","E01031836","Total",772,291,89,202,481,51,80,106,131,22,32,59
"2011","Worthing 007D","E01031838","Total",659,195,63,132,464,30,95,96,122,15,28,78
"2011","Worthing 007E","E01031840","Total",771,249,119,130,522,27,115,106,155,15,25,79
"2011","Worthing 008A","E01031791","Total",1002,448,133,315,554,85,49,140,171,22,25,62
"2011","Worthing 008B","E01031796","Total",667,214,67,147,453,44,38,129,133,21,30,58
"2011","Worthing 008C","E01031799","Total",666,221,111,110,445,53,51,92,108,22,38,81
"2011","Worthing 008D","E01031801","Total",823,323,109,214,500,62,53,127,132,25,23,78
"2011","Worthing 008E","E01031837","Total",811,269,75,194,542,42,57,151,136,19,46,91
"2011","Worthing 009A","E01031779","Total",536,160,59,101,376,62,46,75,74,22,38,59
"2011","Worthing 009B","E01031831","Total",667,223,78,145,444,25,88,106,111,16,38,60
"2011","Worthing 009C","E01031832","Total",866,420,192,228,446,16,133,80,119,9,20,69
"2011","Worthing 009D","E01031833","Total",664,210,58,152,454,50,44,101,123,24,35,77
"2011","Worthing 009E","E01031834","Total",658,200,91,109,458,29,68,93,120,27,43,78
"2011","Worthing 010A","E01031790","Total",963,537,189,348,426,46,80,77,157,5,16,45
"2011","Worthing 010B","E01031807","Total",853,449,257,192,404,22,115,68,125,11,19,44
"2011","Worthing 010C","E01031809","Total",887,472,175,297,415,25,93,69,175,8,9,36
"2011","Worthing 010D","E01031810","Total",787,349,95,254,438,48,50,104,144,14,20,58
"2011","Worthing 010E","E01031811","Total",674,377,138,239,297,16,44,49,129,6,21,32
"2011","Worthing 011A","E01031787","Total",1086,605,173,432,481,57,68,79,193,12,17,55
"2011","Worthing 011B","E01031788","Total",1011,404,145,259,607,87,68,133,194,16,30,79
"2011","Worthing 011C","E01031789","Total",1025,518,160,358,507,38,78,96,195,13,20,67
"2011","Worthing 011D","E01031808","Total",856,555,142,413,301,33,37,54,130,3,11,33
"2011","Worthing 011E","E01031835","Total",967,471,114,357,496,37,81,82,207,5,15,69
"2011","Worthing 012A","E01031812","Total",813,372,208,164,441,16,145,60,140,5,16,59
"2011","Worthing 012B","E01031813","Total",799,312,119,193,487,37,91,111,114,22,38,74
"2011","Worthing 012C","E01031814","Total",729,273,141,132,456,17,134,68,131,10,23,73
"2011","Worthing 012D","E01031815","Total",790,349,206,143,441,14,145,62,132,2,23,63
"2011","Worthing 012E","E01031816","Total",652,188,82,106,464,36,58,136,120,16,29,69
"2011","Worthing 013A","E01031802","Total",836,323,238,85,513,11,246,50,129,12,18,47
"2011","Worthing 013B","E01031803","Total",648,158,117,41,490,11,172,74,99,10,35,89
"2011","Worthing 013C","E01031804","Total",732,216,149,67,516,18,196,66,115,16,35,70
"2011","Worthing 013D","E01031805","Total",802,291,222,69,511,16,227,66,105,12,22,63
"2011","Worthing 013E","E01031806","Total",722,253,133,120,469,41,94,97,98,23,33,83
"2011","Bath and North East Somerset 001A","E01014399","Total",660,144,75,69,516,32,121,95,124,15,24,105
"2011","Bath and North East Somerset 001B","E01014400","Total",865,317,157,160,548,18,113,89,161,28,43,96
"2011","Bath and North East Somerset 001C","E01014401","Total",651,164,94,70,487,50,104,83,91,17,41,101
"2011","Bath and North East Somerset 002A","E01014402","Total",731,219,116,103,512,47,110,92,129,13,36,85
"2011","Bath and North East Somerset 002B","E01014403","Total",833,401,278,123,432,10,121,80,100,15,24,82
"2011","Bath and North East Somerset 002C","E01014404","Total",743,235,125,110,508,69,107,118,111,15,25,63
"2011","Bath and North East Somerset 003A","E01014395","Total",519,112,78,34,407,8,137,47,97,13,25,80
"2011","Bath and North East Somerset 003B","E01014396","Total",656,242,141,101,414,44,96,78,99,12,23,62
"2011","Bath and North East Somerset 003C","E01014397","Total",510,106,80,26,404,6,107,71,81,20,39,80
"2011","Bath and North East Somerset 003D","E01014398","Total",639,202,106,96,437,19,126,76,100,13,24,79
"2011","Bath and North East Somerset 004A","E01014409","Total",747,312,143,169,435,40,77,96,114,19,19,70
"2011","Bath and North East Somerset 004B","E01014410","Total",733,163,73,90,570,48,132,118,141,24,29,78
"2011","Bath and North East Somerset 004C","E01014411","Total",932,306,119,187,626,32,116,144,197,18,34,85
"2011","Bath and North East Somerset 005A","E01014477","Total",636,182,122,60,454,11,142,80,97,12,21,91
"2011","Bath and North East Somerset 005B","E01014478","Total",469,123,67,56,346,50,53,71,59,13,28,72
"2011","Bath and North East Somerset 005C","E01014479","Total",650,238,140,98,412,13,120,67,117,14,24,57
"2011","Bath and North East Somerset 005D","E01014480","Total",551,195,108,87,356,24,61,77,93,19,26,56
"2011","Bath and North East Somerset 006A","E01014465","Total",669,196,54,142,473,44,70,115,154,7,22,61
"2011","Bath and North East Somerset 006B","E01014466","Total",576,203,33,170,373,49,43,84,109,14,17,57
"2011","Bath and North East Somerset 006C","E01014467","Total",827,344,65,279,483,17,79,89,208,11,14,65
"2011","Bath and North East Somerset 006D","E01014468","Total",756,316,72,244,440,26,45,66,203,10,8,82
"2011","Bath and North East Somerset 007A","E01014370","Total",1044,622,229,393,422,19,74,26,213,2,8,80
"2011","Bath and North East Somerset 007B","E01014371","Total",1084,568,176,392,516,15,89,49,286,6,6,65
"2011","Bath and North East Somerset 007C","E01014372","Total",1164,635,92,543,529,25,62,49,275,4,10,104
"2011","Bath and North East Somerset 007D","E01014412","Total",679,249,69,180,430,25,65,84,158,19,19,60
"2011","Bath and North East Somerset 007E","E01014413","Total",653,212,93,119,441,25,152,68,116,12,21,47
"2011","Bath and North East Somerset 007F","E01014414","Total",848,456,90,366,392,27,42,52,188,5,9,69
"2011","Bath and North East Somerset 008A","E01014427","Total",582,200,73,127,382,29,49,79,105,14,19,87
"2011","Bath and North East Somerset 008B","E01014428","Total",558,219,119,100,339,6,59,62,80,34,27,71
"2011","Bath and North East Somerset 008C","E01014429","Total",634,149,74,75,485,32,78,128,112,27,28,80
"2011","Bath and North East Somerset 008D","E01014430","Total",709,268,199,69,441,29,106,91,101,19,20,75
"2011","Bath and North East Somerset 009A","E01014405","Total",836,249,92,157,587,19,86,119,173,20,28,142
"2011","Bath and North East Somerset 009C","E01014407","Total",643,365,82,283,278,47,20,26,142,1,6,36
"2011","Bath and North East Somerset 009E","E01033080","Total",1187,587,105,482,600,27,57,63,302,9,10,132
"2011","Bath and North East Somerset 010A","E01014373","Total",656,188,90,98,468,44,74,111,117,14,23,85
"2011","Bath and North East Somerset 010B","E01014374","Total",642,221,145,76,421,19,116,80,106,19,22,59
"2011","Bath and North East Somerset 010C","E01014375","Total",515,112,54,58,403,7,114,62,108,12,30,70
"2011","Bath and North East Somerset 010D","E01014376","Total",633,148,82,66,485,9,159,88,114,10,27,78
"2011","Bath and North East Somerset 010E","E01014377","Total",656,211,126,85,445,15,165,68,105,15,22,55
"2011","Bath and North East Somerset 010G","E01033078","Total",706,187,89,98,519,22,123,92,136,26,42,78
"2011","Bath and North East Somerset 010H","E01033079","Total",471,120,61,59,351,14,71,58,96,26,26,60
"2011","Bath and North East Somerset 011A","E01014461","Total",461,112,58,54,349,42,38,59,97,12,25,76
"2011","Bath and North East Somerset 011B","E01014462","Total",617,174,64,110,443,88,54,85,101,22,35,58
"2011","Bath and North East Somerset 011C","E01014463","Total",589,209,81,128,380,67,82,40,73,14,32,72
"2011","Bath and North East Somerset 011D","E01014464","Total",606,268,63,205,338,76,27,56,86,15,21,57
"2011","Bath and North East Somerset 012A","E01014380","Total",517,147,91,56,370,14,140,58,79,11,17,51
"2011","Bath and North East Somerset 012B","E01014381","Total",660,265,166,99,395,12,114,66,120,9,14,60
"2011","Bath and North East Somerset 012C","E01014481","Total",562,197,38,159,365,11,35,53,138,6,11,111
"2011","Bath and North East Somerset 012D","E01014482","Total",510,135,71,64,375,7,102,77,102,14,23,50
"2011","Bath and North East Somerset 012E","E01014483","Total",640,219,73,146,421,30,63,69,152,8,12,87
"2011","Bath and North East Somerset 012F","E01014484","Total",611,200,48,152,411,2,48,46,119,8,21,167
"2011","Bath and North East Somerset 013A","E01014473","Total",577,121,53,68,456,15,57,71,107,11,10,185
"2011","Bath and North East Somerset 013B","E01014474","Total",492,146,56,90,346,21,38,46,106,5,17,113
"2011","Bath and North East Somerset 013C","E01014475","Total",623,178,67,111,445,11,59,55,116,7,11,186
"2011","Bath and North East Somerset 013D","E01014476","Total",524,112,52,60,412,19,54,54,81,7,12,185
"2011","Bath and North East Somerset 014A","E01014435","Total",525,105,52,53,420,5,52,47,80,9,11,216
"2011","Bath and North East Somerset 014B","E01014436","Total",616,191,105,86,425,19,57,58,99,9,21,162
"2011","Bath and North East Somerset 014C","E01014437","Total",637,227,88,139,410,49,58,68,109,13,25,88
"2011","Bath and North East Somerset 014D","E01014438","Total",499,129,41,88,370,37,51,65,73,11,29,104
"2011","Bath and North East Somerset 015A","E01014455","Total",567,191,97,94,376,25,67,71,87,12,31,83
"2011","Bath and North East Somerset 015B","E01014456","Total",625,159,91,68,466,27,93,79,116,23,29,99
"2011","Bath and North East Somerset 015C","E01014457","Total",613,190,84,106,423,14,100,52,147,7,24,79
"2011","Bath and North East Somerset 015D","E01014458","Total",522,135,64,71,387,72,49,63,60,29,39,75
"2011","Bath and North East Somerset 016A","E01014391","Total",611,157,86,71,454,12,112,70,135,14,28,83
"2011","Bath and North East Somerset 016B","E01014392","Total",426,105,52,53,321,11,94,37,82,14,21,62
"2011","Bath and North East Somerset 016C","E01014452","Total",658,201,147,54,457,3,158,81,97,12,26,80
"2011","Bath and North East Somerset 016D","E01014453","Total",503,110,79,31,393,10,129,64,81,15,28,66
"2011","Bath and North East Somerset 016E","E01014454","Total",519,92,60,32,427,5,108,85,100,18,34,77
"2011","Bath and North East Somerset 016F","E01014459","Total",612,181,94,87,431,23,114,83,92,22,20,77
"2011","Bath and North East Somerset 016G","E01014460","Total",501,128,65,63,373,7,112,66,101,9,17,61
"2011","Bath and North East Somerset 017A","E01014415","Total",771,168,61,107,603,16,87,148,177,30,22,123
"2011","Bath and North East Somerset 017B","E01014416","Total",726,214,123,91,512,19,121,107,138,15,29,83
"2011","Bath and North East Somerset 017C","E01014417","Total",743,191,101,90,552,10,149,102,135,15,37,104
"2011","Bath and North East Somerset 018A","E01014387","Total",505,138,86,52,367,22,78,66,85,20,20,76
"2011","Bath and North East Somerset 018B","E01014388","Total",546,153,89,64,393,13,115,63,95,20,28,59
"2011","Bath and North East Somerset 018C","E01014389","Total",620,242,162,80,378,24,87,65,81,15,29,77
"2011","Bath and North East Somerset 018D","E01014390","Total",665,222,66,156,443,91,48,91,101,24,23,65
"2011","Bath and North East Somerset 019A","E01014431","Total",511,135,68,67,376,24,67,75,98,7,22,83
"2011","Bath and North East Somerset 019B","E01014432","Total",543,172,80,92,371,30,80,49,84,13,29,86
"2011","Bath and North East Somerset 019C","E01014433","Total",553,147,41,106,406,60,33,102,107,15,27,62
"2011","Bath and North East Somerset 019D","E01014434","Total",757,178,82,96,579,34,108,95,159,17,24,142
"2011","Bath and North East Somerset 020A","E01014385","Total",508,97,48,49,411,22,88,74,85,16,41,85
"2011","Bath and North East Somerset 020B","E01014386","Total",454,99,51,48,355,11,82,71,82,12,35,62
"2011","Bath and North East Somerset 020C","E01014419","Total",483,115,49,66,368,17,71,73,92,23,40,52
"2011","Bath and North East Somerset 020D","E01014446","Total",448,99,48,51,349,6,81,60,90,8,29,75
"2011","Bath and North East Somerset 020E","E01014447","Total",499,108,62,46,391,6,93,65,92,14,33,88
"2011","Bath and North East Somerset 021A","E01014382","Total",944,203,116,87,741,22,217,115,141,32,67,147
"2011","Bath and North East Somerset 021B","E01014383","Total",424,107,55,52,317,9,86,58,80,11,24,49
"2011","Bath and North East Somerset 021C","E01014384","Total",546,127,71,56,419,27,106,68,86,16,41,75
"2011","Bath and North East Somerset 021D","E01014418","Total",565,134,62,72,431,21,100,68,108,21,31,82
"2011","Bath and North East Somerset 022A","E01014379","Total",841,196,87,109,645,21,168,125,164,22,48,97
"2011","Bath and North East Somerset 022B","E01014442","Total",705,151,62,89,554,33,96,132,164,20,38,71
"2011","Bath and North East Somerset 022C","E01014443","Total",658,170,65,105,488,30,94,92,129,13,32,98
"2011","Bath and North East Somerset 022D","E01014444","Total",588,123,37,86,465,25,64,134,135,20,27,60
"2011","Bath and North East Somerset 022E","E01014445","Total",681,234,115,119,447,42,70,98,91,21,42,83
"2011","Bath and North East Somerset 023A","E01014393","Total",511,98,51,47,413,14,78,93,131,15,18,64
"2011","Bath and North East Somerset 023B","E01014394","Total",675,155,98,57,520,24,97,113,147,11,35,93
"2011","Bath and North East Somerset 023C","E01014439","Total",713,212,131,81,501,23,119,110,112,20,32,85
"2011","Bath and North East Somerset 023D","E01014440","Total",761,189,65,124,572,30,83,132,157,27,33,110
"2011","Bath and North East Somerset 023E","E01014441","Total",711,190,91,99,521,28,140,93,152,12,20,76
"2011","Bath and North East Somerset 024A","E01014448","Total",679,222,100,122,457,43,97,77,106,21,39,74
"2011","Bath and North East Somerset 024B","E01014449","Total",568,111,30,81,457,47,55,121,125,17,26,66
"2011","Bath and North East Somerset 024C","E01014450","Total",533,133,72,61,400,58,63,60,96,27,28,68
"2011","Bath and North East Somerset 024D","E01014451","Total",520,131,34,97,389,31,64,62,119,16,24,73
"2011","Bath and North East Somerset 025A","E01014420","Total",691,228,66,162,463,32,75,119,136,20,26,55
"2011","Bath and North East Somerset 025B","E01014421","Total",528,91,54,37,437,21,87,95,92,13,41,88
"2011","Bath and North East Somerset 025C","E01014422","Total",622,136,87,49,486,29,129,80,125,14,28,81
"2011","Bath and North East Somerset 025D","E01014423","Total",614,194,82,112,420,38,75,83,126,13,22,63
"2011","Bath and North East Somerset 026A","E01014469","Total",490,129,78,51,361,14,79,70,66,21,38,73
"2011","Bath and North East Somerset 026B","E01014470","Total",618,102,38,64,516,49,64,116,149,20,27,91
"2011","Bath and North East Somerset 026C","E01014471","Total",645,180,60,120,465,27,67,111,146,15,30,69
"2011","Bath and North East Somerset 026D","E01014472","Total",546,99,58,41,447,39,75,88,121,9,33,82
"2011","Bath and North East Somerset 027A","E01014424","Total",664,119,77,42,545,19,139,109,135,16,33,94
"2011","Bath and North East Somerset 027B","E01014425","Total",829,208,123,85,621,39,176,106,127,17,40,116
"2011","Bath and North East Somerset 027C","E01014426","Total",637,215,138,77,422,31,111,62,99,12,25,82
"2011","Bournemouth 001A","E01015301","Total",671,202,122,80,469,15,150,73,115,13,27,76
"2011","Bournemouth 001B","E01015303","Total",661,201,96,105,460,19,125,65,110,17,30,94
"2011","Bournemouth 001C","E01015305","Total",624,173,110,63,451,37,93,79,83,21,40,98
"2011","Bournemouth 001D","E01015306","Total",732,237,128,109,495,57,112,78,106,21,39,82
"2011","Bournemouth 002A","E01015302","Total",842,249,132,117,593,45,173,93,146,8,27,101
"2011","Bournemouth 002B","E01015304","Total",782,271,156,115,511,66,110,104,116,16,19,80
"2011","Bournemouth 002C","E01015308","Total",718,195,61,134,523,56,75,117,144,15,31,85
"2011","Bournemouth 002D","E01015311","Total",685,197,143,54,488,4,245,27,135,4,11,62
"2011","Bournemouth 003A","E01015332","Total",701,238,141,97,463,23,148,67,107,19,30,69
"2011","Bournemouth 003B","E01015333","Total",677,168,106,62,509,25,138,90,125,14,24,93
"2011","Bournemouth 003C","E01015334","Total",678,212,130,82,466,32,137,63,103,21,31,79
"2011","Bournemouth 003D","E01015335","Total",703,185,92,93,518,28,120,86,119,15,37,113
"2011","Bournemouth 003E","E01015337","Total",727,227,93,134,500,32,79,112,141,17,36,83
"2011","Bournemouth 004A","E01015343","Total",639,194,114,80,445,30,89,93,104,19,42,68
"2011","Bournemouth 004B","E01015349","Total",656,207,94,113,449,37,82,92,132,26,32,48
"2011","Bournemouth 004C","E01015351","Total",606,173,52,121,433,35,49,98,124,24,32,71
"2011","Bournemouth 004D","E01015352","Total",643,187,61,126,456,44,55,139,123,20,28,47
"2011","Bournemouth 004E","E01015353","Total",494,145,64,81,349,24,81,75,84,14,21,50
"2011","Bournemouth 004F","E01015354","Total",712,174,72,102,538,43,80,137,148,19,39,72
"2011","Bournemouth 005A","E01015307","Total",598,200,87,113,398,51,68,73,96,13,37,60
"2011","Bournemouth 005B","E01015309","Total",585,155,54,101,430,72,63,84,92,12,34,73
"2011","Bournemouth 005C","E01015312","Total",519,153,73,80,366,48,77,68,75,19,27,52
"2011","Bournemouth 005D","E01015313","Total",518,144,66,78,374,38,51,64,71,19,50,81
"2011","Bournemouth 005E","E01015359","Total",756,313,129,184,443,20,89,75,133,14,34,78
"2011","Bournemouth 006A","E01015320","Total",671,170,84,86,501,21,87,105,126,21,37,104
"2011","Bournemouth 006B","E01015323","Total",593,127,61,66,466,23,76,97,108,27,38,97
"2011","Bournemouth 006C","E01015324","Total",659,201,79,122,458,39,57,99,135,14,30,84
"2011","Bournemouth 006D","E01015325","Total",648,139,59,80,509,22,75,129,118,25,36,104
"2011","Bournemouth 006E","E01015350","Total",617,176,116,60,441,10,129,75,96,22,40,69
"2011","Bournemouth 007A","E01015310","Total",606,150,57,93,456,46,65,80,104,20,38,103
"2011","Bournemouth 007B","E01015336","Total",674,181,75,106,493,22,104,81,140,15,31,100
"2011","Bournemouth 007C","E01015355","Total",707,189,90,99,518,33,114,99,133,14,35,90
"2011","Bournemouth 007D","E01015357","Total",697,243,126,117,454,31,92,81,117,19,33,81
"2011","Bournemouth 007E","E01015358","Total",733,198,100,98,535,34,96,89,108,25,43,140
"2011","Bournemouth 008A","E01015338","Total",828,328,185,143,500,45,118,106,96,20,44,71
"2011","Bournemouth 008B","E01015339","Total",674,226,101,125,448,36,90,77,104,18,41,82
"2011","Bournemouth 008C","E01015340","Total",723,209,135,74,514,14,180,79,126,12,20,83
"2011","Bournemouth 008D","E01015341","Total",541,119,60,59,422,54,51,79,93,21,49,75
"2011","Bournemouth 009A","E01015321","Total",747,250,123,127,497,22,59,104,114,20,44,134
"2011","Bournemouth 009B","E01015356","Total",684,186,73,113,498,38,77,84,101,15,45,138
"2011","Bournemouth 009C","E01015374","Total",875,268,61,207,607,62,30,96,165,8,23,223
"2011","Bournemouth 009D","E01015375","Total",703,207,77,130,496,23,55,73,120,10,23,192
"2011","Bournemouth 009E","E01015377","Total",608,143,44,99,465,33,45,79,123,16,24,145
"2011","Bournemouth 010A","E01015322","Total",670,176,89,87,494,21,87,105,110,21,35,115
"2011","Bournemouth 010B","E01015330","Total",771,272,112,160,499,35,89,97,132,24,27,95
"2011","Bournemouth 010C","E01015342","Total",615,130,71,59,485,20,117,85,115,17,35,96
"2011","Bournemouth 010D","E01015373","Total",673,193,54,139,480,38,31,105,142,15,29,120
"2011","Bournemouth 010E","E01015378","Total",612,119,39,80,493,25,42,91,115,24,38,158
"2011","Bournemouth 011A","E01015314","Total",615,153,94,59,462,12,113,87,114,21,39,76
"2011","Bournemouth 011B","E01015315","Total",733,147,86,61,586,2,140,104,128,25,50,137
"2011","Bournemouth 011C","E01015318","Total",715,211,83,128,504,29,85,117,148,17,26,82
"2011","Bournemouth 011D","E01015319","Total",626,227,42,185,399,18,68,93,110,21,27,62
"2011","Bournemouth 012A","E01015344","Total",719,170,88,82,549,12,163,80,141,16,23,114
"2011","Bournemouth 012B","E01015346","Total",678,248,79,169,430,19,64,74,108,19,30,116
"2011","Bournemouth 012C","E01015348","Total",767,226,97,129,541,13,160,61,142,11,36,118
"2011","Bournemouth 012D","E01015360","Total",601,103,39,64,498,24,58,73,127,19,34,163
"2011","Bournemouth 013A","E01015326","Total",815,262,70,192,553,28,47,100,204,16,34,124
"2011","Bournemouth 013B","E01015331","Total",1015,354,80,274,661,64,46,126,249,18,24,134
"2011","Bournemouth 013C","E01015345","Total",728,216,49,167,512,23,49,85,164,17,34,140
"2011","Bournemouth 013D","E01015376","Total",613,142,42,100,471,32,33,72,124,16,37,157
"2011","Bournemouth 014A","E01015316","Total",674,177,93,84,497,14,134,89,126,11,37,86
"2011","Bournemouth 014B","E01015317","Total",683,184,86,98,499,32,104,99,155,17,31,61
"2011","Bournemouth 014C","E01015361","Total",545,135,54,81,410,31,59,102,87,25,30,76
"2011","Bournemouth 014D","E01015362","Total",464,106,43,63,358,28,30,95,81,22,39,63
"2011","Bournemouth 014E","E01015363","Total",669,184,45,139,485,38,55,136,122,21,33,80
"2011","Bournemouth 015A","E01015292","Total",737,270,68,202,467,47,32,107,137,8,42,94
"2011","Bournemouth 015B","E01015293","Total",644,200,50,150,444,55,42,90,128,12,34,83
"2011","Bournemouth 015C","E01015294","Total",831,263,43,220,568,69,37,125,183,19,47,88
"2011","Bournemouth 015D","E01015327","Total",783,227,60,167,556,44,39,121,159,24,42,127
"2011","Bournemouth 015E","E01015329","Total",689,215,38,177,474,27,55,76,143,15,33,125
"2011","Bournemouth 016A","E01015272","Total",833,313,163,150,520,17,160,71,157,8,25,82
"2011","Bournemouth 016B","E01015273","Total",938,390,58,332,548,68,55,110,171,15,33,96
"2011","Bournemouth 016C","E01015275","Total",739,248,47,201,491,26,65,91,149,8,29,123
"2011","Bournemouth 016D","E01015276","Total",658,182,51,131,476,39,48,118,123,29,32,87
"2011","Bournemouth 016E","E01015277","Total",847,318,81,237,529,44,53,105,162,22,37,106
"2011","Bournemouth 017A","E01015283","Total",992,471,89,382,521,17,35,52,305,5,11,96
"2011","Bournemouth 017C","E01015286","Total",1086,558,273,285,528,24,130,76,207,3,17,71
"2011","Bournemouth 017D","E01015287","Total",1183,814,187,627,369,14,62,46,192,4,6,45
"2011","Bournemouth 017E","E01015328","Total",958,491,202,289,467,26,50,78,205,8,17,83
"2011","Bournemouth 017F","E01033242","Total",590,344,95,249,246,14,24,43,125,3,4,33
"2011","Bournemouth 017G","E01033285","Total",624,323,77,246,301,19,22,41,165,3,7,44
"2011","Bournemouth 018A","E01015274","Total",873,383,127,256,490,43,71,92,166,16,28,74
"2011","Bournemouth 018B","E01015297","Total",698,310,162,148,388,24,115,53,124,5,19,48
"2011","Bournemouth 018C","E01015364","Total",684,203,106,97,481,19,117,95,125,15,28,82
"2011","Bournemouth 018D","E01015365","Total",792,321,91,230,471,49,71,71,161,8,35,76
"2011","Bournemouth 018E","E01015366","Total",888,454,214,240,434,19,110,61,155,9,19,61
"2011","Bournemouth 019B","E01015279","Total",991,531,76,455,460,53,35,85,215,8,16,48
"2011","Bournemouth 019C","E01015280","Total",998,516,51,465,482,61,31,106,202,5,11,66
"2011","Bournemouth 019D","E01015281","Total",884,447,90,357,437,68,29,72,159,9,24,76
"2011","Bournemouth 019E","E01015282","Total",1174,736,84,652,438,37,19,87,216,8,22,49
"2011","Bournemouth 019F","E01033241","Total",679,395,91,304,284,20,40,40,149,2,6,27
"2011","Bournemouth 019G","E01033283","Total",715,386,132,254,329,8,70,43,182,1,1,24
"2011","Bournemouth 020A","E01015295","Total",650,173,115,58,477,8,179,66,121,8,25,70
"2011","Bournemouth 020B","E01015296","Total",985,525,248,277,460,39,115,51,181,11,13,50
"2011","Bournemouth 020C","E01015298","Total",794,296,199,97,498,10,241,53,113,7,13,61
"2011","Bournemouth 020D","E01015299","Total",732,194,105,89,538,26,137,102,144,18,23,88
"2011","Bournemouth 020E","E01015300","Total",679,197,111,86,482,11,116,95,141,23,21,75
"2011","Bournemouth 021A","E01015285","Total",1091,520,117,403,571,32,102,73,266,2,15,81
"2011","Bournemouth 021B","E01015288","Total",911,433,98,335,478,64,16,97,157,8,30,106
"2011","Bournemouth 021C","E01015289","Total",1018,531,150,381,487,15,74,69,236,4,17,72
"2011","Bournemouth 021D","E01015290","Total",887,435,99,336,452,22,61,71,205,5,5,83
"2011","Bournemouth 021E","E01015291","Total",1101,503,237,266,598,16,239,56,217,3,9,58
"2011","Bournemouth 023A","E01015371","Total",867,453,90,363,414,17,44,48,224,11,12,58
"2011","Bournemouth 023B","E01015372","Total",1111,694,371,323,417,20,97,47,200,3,6,44
"2011","Bournemouth 023C","E01033286","Total",611,286,85,201,325,13,73,42,161,3,7,26
"2011","Bournemouth 023D","E01033288","Total",615,291,107,184,324,7,81,41,167,5,1,22
"2011","Bournemouth 024A","E01015367","Total",1110,576,77,499,534,25,60,51,298,9,11,80
"2011","Bournemouth 024B","E01015368","Total",1019,518,240,278,501,12,222,50,173,0,7,37
"2011","Bournemouth 024C","E01015369","Total",958,468,215,253,490,19,157,62,205,3,3,41
"2011","Bournemouth 024D","E01015370","Total",811,343,77,266,468,19,77,57,233,6,11,65
"2011","Bristol 001A","E01014601","Total",687,218,103,115,469,39,97,77,125,18,29,84
"2011","Bristol 001B","E01014602","Total",825,295,101,194,530,102,71,109,118,21,38,71
"2011","Bristol 001C","E01014603","Total",960,311,95,216,649,63,98,127,213,19,41,88
"2011","Bristol 001E","E01014605","Total",810,358,120,238,452,108,80,81,109,11,27,36
"2011","Bristol 001G","E01032516","Total",830,222,83,139,608,59,131,84,191,16,33,94
"2011","Bristol 001H","E01032517","Total",694,245,122,123,449,62,75,60,124,21,42,65
"2011","Bristol 002A","E01014688","Total",644,155,70,85,489,74,56,89,114,31,41,84
"2011","Bristol 002B","E01014689","Total",637,226,90,136,411,87,47,46,75,51,40,65
"2011","Bristol 002C","E01014690","Total",792,242,112,130,550,57,68,119,116,37,56,97
"2011","Bristol 002D","E01014691","Total",853,338,224,114,515,55,93,84,117,25,41,100
"2011","Bristol 002E","E01014692","Total",606,134,32,102,472,64,52,86,113,31,39,87
"2011","Bristol 002F","E01014693","Total",651,213,76,137,438,27,102,76,142,4,15,72
"2011","Bristol 002G","E01014694","Total",667,212,87,125,455,36,70,88,110,18,47,86
"2011","Bristol 003A","E01014497","Total",670,203,83,120,467,72,77,81,111,26,22,78
"2011","Bristol 003B","E01014498","Total",658,171,62,109,487,95,67,122,98,13,29,63
"2011","Bristol 003C","E01014638","Total",788,352,162,190,436,81,69,68,116,20,24,58
"2011","Bristol 003D","E01014639","Total",625,185,56,129,440,132,38,99,86,16,30,39
"2011","Bristol 003E","E01014640","Total",590,181,70,111,409,51,58,81,92,13,36,78
"2011","Bristol 004A","E01014631","Total",520,171,107,64,349,19,71,53,100,12,23,71
"2011","Bristol 004B","E01014632","Total",618,165,77,88,453,28,76,76,122,17,37,97
"2011","Bristol 004C","E01014633","Total",663,189,86,103,474,49,78,99,116,18,30,84
"2011","Bristol 004D","E01014636","Total",635,182,66,116,453,90,73,83,111,12,26,58
"2011","Bristol 005A","E01014630","Total",885,274,75,199,611,79,58,84,180,17,28,165
"2011","Bristol 005B","E01014634","Total",694,190,55,135,504,19,55,72,165,14,19,160
"2011","Bristol 005C","E01014659","Total",880,298,63,235,582,102,39,100,181,33,34,93
"2011","Bristol 005D","E01014661","Total",600,135,51,84,465,47,48,77,116,29,51,97
"2011","Bristol 006A","E01014616","Total",684,266,176,90,418,8,106,97,109,19,22,57
"2011","Bristol 006B","E01014719","Total",628,207,92,115,421,18,82,96,135,15,15,60
"2011","Bristol 006C","E01014720","Total",777,313,169,144,464,41,97,106,127,8,19,66
"2011","Bristol 006D","E01014721","Total",647,192,104,88,455,13,97,105,148,10,23,59
"2011","Bristol 007A","E01014641","Total",625,179,83,96,446,16,122,69,122,9,32,76
"2011","Bristol 007B","E01014642","Total",608,183,84,99,425,27,83,77,107,20,35,76
"2011","Bristol 007C","E01014643","Total",547,174,86,88,373,43,57,56,80,21,40,76
"2011","Bristol 007D","E01014644","Total",613,161,86,75,452,35,59,86,138,17,44,73
"2011","Bristol 008A","E01014492","Total",741,308,146,162,433,52,95,66,132,12,19,57
"2011","Bristol 008B","E01014493","Total",609,179,80,99,430,38,58,80,111,15,40,88
"2011","Bristol 008C","E01014494","Total",623,154,76,78,469,14,98,84,155,9,34,75
"2011","Bristol 008D","E01014495","Total",733,223,112,111,510,37,124,83,147,12,28,79
"2011","Bristol 008E","E01014496","Total",680,219,66,153,461,36,48,93,137,23,49,75
"2011","Bristol 008F","E01014499","Total",609,144,59,85,465,41,60,76,130,22,50,86
"2011","Bristol 009A","E01014715","Total",616,123,74,49,493,8,92,153,109,26,20,85
"2011","Bristol 009B","E01014716","Total",614,141,101,40,473,6,145,124,95,23,20,60
"2011","Bristol 009C","E01014717","Total",637,246,210,36,391,9,111,97,76,20,23,55
"2011","Bristol 009D","E01014718","Total",637,211,111,100,426,10,99,95,137,10,15,60
"2011","Bristol 010A","E01014510","Total",740,178,56,122,562,47,44,128,147,27,18,151
"2011","Bristol 010B","E01014635","Total",769,198,64,134,571,42,82,102,173,8,20,144
"2011","Bristol 010C","E01014637","Total",530,153,48,105,377,13,31,67,127,10,19,110
"2011","Bristol 010D","E01014662","Total",631,186,68,118,445,36,52,87,116,17,23,114
"2011","Bristol 011A","E01014615","Total",609,136,84,52,473,12,134,121,80,16,28,82
"2011","Bristol 011B","E01014617","Total",522,86,44,42,436,13,87,108,98,12,20,98
"2011","Bristol 011C","E01014618","Total",624,156,106,50,468,11,117,113,101,27,28,71
"2011","Bristol 011D","E01014620","Total",634,215,137,78,419,14,103,102,95,26,22,57
"2011","Bristol 012A","E01014571","Total",663,219,80,139,444,42,61,69,114,14,34,110
"2011","Bristol 012B","E01014577","Total",640,196,77,119,444,28,77,72,133,18,32,84
"2011","Bristol 012C","E01014586","Total",719,264,143,121,455,40,124,66,135,11,15,64
"2011","Bristol 012D","E01014587","Total",608,240,127,113,368,37,71,55,92,20,20,73
"2011","Bristol 013A","E01014588","Total",747,301,141,160,446,31,92,63,116,10,27,107
"2011","Bristol 013B","E01014589","Total",630,238,99,139,392,88,52,62,76,21,30,63
"2011","Bristol 013C","E01014590","Total",728,281,128,153,447,38,58,59,126,15,34,117
"2011","Bristol 013D","E01014591","Total",800,280,141,139,520,22,119,98,150,16,24,91
"2011","Bristol 013E","E01014592","Total",694,228,110,118,466,38,64,87,143,19,26,89
"2011","Bristol 014A","E01014660","Total",667,245,126,119,422,44,75,68,86,18,41,90
"2011","Bristol 014B","E01014663","Total",616,213,80,133,403,63,57,57,90,11,32,93
"2011","Bristol 014C","E01014664","Total",664,218,92,126,446,30,77,52,134,25,52,76
"2011","Bristol 014D","E01014665","Total",779,195,85,110,584,86,84,83,140,29,56,106
"2011","Bristol 015A","E01014709","Total",596,242,118,124,354,11,119,33,121,6,17,47
"2011","Bristol 015B","E01014710","Total",529,196,81,115,333,10,82,54,128,10,12,37
"2011","Bristol 015C","E01014711","Total",527,118,72,46,409,16,125,86,98,8,13,63
"2011","Bristol 015D","E01014712","Total",500,136,77,59,364,16,88,102,66,21,28,43
"2011","Bristol 015E","E01014713","Total",565,164,74,90,401,11,113,82,104,9,20,62
"2011","Bristol 015F","E01014714","Total",524,109,62,47,415,10,106,99,94,19,25,62
"2011","Bristol 016A","E01014507","Total",673,183,53,130,490,19,33,125,179,12,17,105
"2011","Bristol 016B","E01014508","Total",510,108,25,83,402,25,20,90,107,9,23,128
"2011","Bristol 016C","E01014509","Total",855,254,36,218,601,31,20,124,234,19,26,147
"2011","Bristol 016D","E01014511","Total",517,106,37,69,411,15,25,127,117,26,24,77
"2011","Bristol 016E","E01014512","Total",587,165,76,89,422,9,33,119,137,16,24,84
"2011","Bristol 016F","E01014513","Total",619,169,77,92,450,15,56,124,119,30,26,80
"2011","Bristol 016G","E01014514","Total",817,253,62,191,564,28,37,122,214,15,15,133
"2011","Bristol 017A","E01014619","Total",602,178,58,120,424,19,71,97,123,23,22,69
"2011","Bristol 017B","E01014621","Total",581,169,66,103,412,26,39,114,114,24,26,69
"2011","Bristol 017C","E01014666","Total",660,142,67,75,518,21,71,147,110,39,34,96
"2011","Bristol 017D","E01014667","Total",625,161,40,121,464,23,41,130,130,22,29,89
"2011","Bristol 017E","E01014672","Total",962,436,123,313,526,21,65,91,219,9,19,102
"2011","Bristol 018A","E01014624","Total",667,167,70,97,500,72,69,86,113,28,48,84
"2011","Bristol 018D","E01014629","Total",544,137,59,78,407,61,51,81,76,20,50,68
"2011","Bristol 018E","E01032518","Total",737,253,98,155,484,70,56,95,101,35,61,66
"2011","Bristol 018F","E01032519","Total",500,152,64,88,348,27,54,71,119,12,27,38
"2011","Bristol 019A","E01014572","Total",796,304,45,259,492,45,42,112,159,22,33,79
"2011","Bristol 019B","E01014573","Total",803,304,69,235,499,24,57,81,181,24,35,97
"2011","Bristol 019C","E01014575","Total",656,257,57,200,399,48,43,76,94,26,40,72
"2011","Bristol 019D","E01014576","Total",833,260,83,177,573,72,82,110,166,20,39,84
"2011","Bristol 020A","E01014487","Total",819,256,27,229,563,17,29,76,218,19,31,173
"2011","Bristol 020B","E01014491","Total",764,222,37,185,542,26,23,116,198,22,34,123
"2011","Bristol 020C","E01014668","Total",620,166,35,131,454,19,28,108,125,30,33,111
"2011","Bristol 020D","E01014669","Total",621,192,22,170,429,22,36,70,163,17,27,94
"2011","Bristol 020E","E01014670","Total",596,190,27,163,406,9,23,70,142,23,38,101
"2011","Bristol 020F","E01014671","Total",663,243,48,195,420,14,20,68,175,15,21,107
"2011","Bristol 021A","E01014622","Total",625,190,68,122,435,43,61,77,118,21,30,85
"2011","Bristol 021B","E01014623","Total",642,180,77,103,462,44,55,88,128,16,42,89
"2011","Bristol 021C","E01014626","Total",913,355,128,227,558,83,74,97,167,28,32,77
"2011","Bristol 021D","E01014627","Total",903,260,82,178,643,74,87,108,213,18,43,100
"2011","Bristol 022A","E01014557","Total",589,156,45,111,433,7,29,62,151,8,34,142
"2011","Bristol 022B","E01014558","Total",775,284,42,242,491,9,12,27,247,1,13,182
"2011","Bristol 022C","E01014559","Total",816,273,63,210,543,8,58,72,199,9,30,167
"2011","Bristol 022D","E01014560","Total",778,296,45,251,482,21,37,53,235,3,13,120
"2011","Bristol 022E","E01014562","Total",655,204,20,184,451,14,18,56,158,4,9,192
"2011","Bristol 023A","E01014485","Total",828,300,87,213,528,70,36,101,184,12,29,96
"2011","Bristol 023B","E01014486","Total",1084,449,70,379,635,129,27,81,219,25,36,118
"2011","Bristol 023C","E01014488","Total",797,244,40,204,553,46,28,77,188,21,42,151
"2011","Bristol 023D","E01014489","Total",1140,486,45,441,654,76,23,75,284,13,27,156
"2011","Bristol 023F","E01033347","Total",608,292,22,270,316,44,2,28,185,6,6,45
"2011","Bristol 023G","E01033348","Total",537,277,6,271,260,63,3,21,97,8,24,44
"2011","Bristol 023H","E01033366","Total",575,191,22,169,384,124,22,58,77,29,33,41
"2011","Bristol 025A","E01014539","Total",784,274,54,220,510,13,52,60,192,8,21,164
"2011","Bristol 025C","E01014561","Total",774,272,50,222,502,14,27,65,256,9,22,109
"2011","Bristol 025D","E01014563","Total",802,289,20,269,513,18,12,44,280,12,15,132
"2011","Bristol 025E","E01033342","Total",887,577,19,558,310,18,7,34,182,5,6,58
"2011","Bristol 025F","E01033367","Total",666,353,31,322,313,41,12,33,156,6,15,50
"2011","Bristol 026A","E01014551","Total",813,325,27,298,488,19,17,40,261,2,7,142
"2011","Bristol 026B","E01014552","Total",775,274,44,230,501,14,29,47,226,7,16,162
"2011","Bristol 026C","E01014553","Total",759,271,61,210,488,8,20,50,226,14,9,161
"2011","Bristol 026D","E01014554","Total",832,354,51,303,478,6,20,60,264,5,11,112
"2011","Bristol 026E","E01014556","Total",859,389,118,271,470,14,43,71,217,6,11,108
"2011","Bristol 027A","E01014673","Total",817,315,87,228,502,64,69,105,157,15,28,64
"2011","Bristol 027B","E01014674","Total",647,170,67,103,477,40,65,84,140,17,32,99
"2011","Bristol 027C","E01014675","Total",662,223,75,148,439,41,71,90,122,10,32,73
"2011","Bristol 027D","E01014676","Total",669,224,133,91,445,34,71,105,107,13,29,86
"2011","Bristol 028A","E01014682","Total",647,190,70,120,457,40,62,103,145,20,26,61
"2011","Bristol 028B","E01014683","Total",840,419,157,262,421,50,52,84,124,12,25,74
"2011","Bristol 028C","E01014685","Total",623,178,49,129,445,59,62,83,108,27,34,72
"2011","Bristol 028D","E01014686","Total",704,225,84,141,479,63,79,93,122,17,31,74
"2011","Bristol 028E","E01014687","Total",704,251,100,151,453,44,76,93,120,19,27,74
"2011","Bristol 029A","E01014565","Total",778,317,111,206,461,73,46,75,149,16,31,71
"2011","Bristol 029B","E01014566","Total",819,329,71,258,490,60,42,94,192,16,20,66
"2011","Bristol 029C","E01014567","Total",894,314,50,264,580,75,38,123,233,14,22,75
"2011","Bristol 029D","E01014681","Total",1061,417,134,283,644,99,68,135,227,14,20,81
"2011","Bristol 029E","E01014684","Total",840,350,49,301,490,59,41,98,220,7,19,46
"2011","Bristol 030A","E01014544","Total",577,224,64,160,353,18,56,46,145,9,18,61
"2011","Bristol 030B","E01014545","Total",809,360,103,257,449,7,50,48,228,8,18,90
"2011","Bristol 030C","E01014546","Total",736,305,74,231,431,13,31,23,239,0,7,118
"2011","Bristol 030D","E01014547","Total",857,377,84,293,480,14,51,56,249,5,11,94
"2011","Bristol 032A","E01014538","Total",676,215,35,180,461,6,16,34,185,2,7,211
"2011","Bristol 032B","E01014540","Total",1164,515,41,474,649,41,36,41,302,17,18,194
"2011","Bristol 032C","E01014542","Total",865,371,69,302,494,10,15,28,212,11,4,214
"2011","Bristol 032E","E01033344","Total",646,273,30,243,373,21,15,29,147,1,3,157
"2011","Bristol 032F","E01033345","Total",661,327,14,313,334,2,16,16,185,1,8,106
"2011","Bristol 032G","E01033350","Total",635,346,56,290,289,1,25,23,191,2,9,38
"2011","Bristol 033A","E01014677","Total",662,217,41,176,445,22,53,76,195,7,22,70
"2011","Bristol 033B","E01014678","Total",674,192,74,118,482,39,100,81,138,13,32,79
"2011","Bristol 033C","E01014679","Total",662,201,70,131,461,33,81,104,136,10,28,69
"2011","Bristol 033D","E01014680","Total",515,121,56,65,394,21,73,81,101,18,39,61
"2011","Bristol 034A","E01014548","Total",832,359,68,291,473,31,49,67,205,11,19,91
"2011","Bristol 034B","E01014549","Total",550,232,59,173,318,15,37,37,129,11,11,78
"2011","Bristol 034C","E01014550","Total",895,315,56,259,580,20,63,80,274,5,11,127
"2011","Bristol 034D","E01014555","Total",711,351,57,294,360,9,18,25,231,3,5,69
"2011","Bristol 035A","E01014528","Total",686,212,44,168,474,26,61,109,184,12,19,63
"2011","Bristol 035B","E01014529","Total",596,183,57,126,413,54,28,81,130,13,30,77
"2011","Bristol 035C","E01014530","Total",684,249,51,198,435,37,50,77,203,9,15,44
"2011","Bristol 035D","E01014531","Total",754,249,54,195,505,39,50,92,209,15,28,72
"2011","Bristol 035E","E01014532","Total",631,174,59,115,457,33,52,105,157,8,32,70
"2011","Bristol 035F","E01014537","Total",756,256,104,152,500,43,70,102,124,22,40,99
"2011","Bristol 036A","E01014695","Total",852,385,151,234,467,41,80,77,156,7,22,84
"2011","Bristol 036B","E01014696","Total",695,211,44,167,484,26,32,138,166,12,17,93
"2011","Bristol 036C","E01014698","Total",857,301,76,225,556,27,38,124,242,8,16,101
"2011","Bristol 036D","E01014699","Total",706,282,69,213,424,51,30,75,182,2,8,76
"2011","Bristol 036E","E01014700","Total",652,175,73,102,477,16,69,73,151,16,28,124
"2011","Bristol 036F","E01014701","Total",712,197,32,165,515,20,32,104,226,14,14,105
"2011","Bristol 037A","E01014730","Total",883,445,71,374,438,47,27,64,223,12,15,50
"2011","Bristol 037B","E01014731","Total",775,312,45,267,463,38,21,82,222,5,11,84
"2011","Bristol 037C","E01014732","Total",799,281,24,257,518,60,21,110,226,18,11,72
"2011","Bristol 037D","E01014735","Total",755,212,53,159,543,29,73,104,212,11,21,93
"2011","Bristol 038A","E01014523","Total",548,149,88,61,399,24,104,74,97,14,22,64
"2011","Bristol 038B","E01014524","Total",591,142,81,61,449,26,93,94,112,13,28,83
"2011","Bristol 038C","E01014525","Total",651,145,58,87,506,39,62,117,177,12,31,68
"2011","Bristol 038D","E01014526","Total",672,211,60,151,461,79,77,83,118,20,17,67
"2011","Bristol 038E","E01014527","Total",660,269,128,141,391,31,79,73,118,10,16,64
"2011","Bristol 039A","E01014500","Total",686,214,85,129,472,32,55,99,165,7,26,88
"2011","Bristol 039B","E01014502","Total",750,231,108,123,519,35,87,101,150,11,34,101
"2011","Bristol 039E","E01033359","Total",704,364,13,351,340,26,11,36,217,3,11,36
"2011","Bristol 039F","E01033361","Total",717,375,139,236,342,22,57,21,159,3,7,73
"2011","Bristol 039G","E01033362","Total",685,366,111,255,319,21,17,34,208,1,6,32
"2011","Bristol 039H","E01033364","Total",780,289,88,201,491,24,48,81,247,4,12,75
"2011","Bristol 040A","E01014729","Total",585,161,49,112,424,62,36,61,140,24,37,64
"2011","Bristol 040B","E01014733","Total",741,201,34,167,540,52,24,99,227,13,21,104
"2011","Bristol 040C","E01014734","Total",678,203,49,154,475,40,31,123,167,10,12,92
"2011","Bristol 040D","E01014736","Total",827,263,106,157,564,41,76,112,185,16,38,96
"2011","Bristol 041A","E01014501","Total",756,231,136,95,525,30,138,82,137,17,29,92
"2011","Bristol 041B","E01014504","Total",656,187,58,129,469,23,49,93,184,6,19,95
"2011","Bristol 041C","E01014505","Total",824,241,70,171,583,36,51,90,285,7,15,99
"2011","Bristol 041D","E01014506","Total",599,128,91,37,471,15,88,107,99,16,35,111
"2011","Bristol 042A","E01014645","Total",688,233,127,106,455,29,96,76,109,14,38,93
"2011","Bristol 042B","E01014646","Total",633,172,84,88,461,22,94,86,102,23,40,94
"2011","Bristol 042C","E01014648","Total",675,201,68,133,474,31,51,110,161,17,25,79
"2011","Bristol 042D","E01014649","Total",670,179,66,113,491,24,66,128,145,12,39,77
"2011","Bristol 042E","E01014651","Total",676,210,62,148,466,27,62,117,126,19,23,92
"2011","Bristol 043A","E01014533","Total",619,190,48,142,429,10,58,98,141,13,31,78
"2011","Bristol 043B","E01014534","Total",650,151,26,125,499,36,48,111,166,20,26,92
"2011","Bristol 043C","E01014535","Total",757,173,80,93,584,37,101,110,146,27,40,123
"2011","Bristol 043D","E01014536","Total",672,269,126,143,403,39,76,70,109,15,24,70
"2011","Bristol 044A","E01014578","Total",645,144,70,74,501,66,68,94,121,18,44,90
"2011","Bristol 044B","E01014583","Total",529,141,56,85,388,64,44,58,78,28,49,67
"2011","Bristol 044C","E01014585","Total",711,186,84,102,525,129,48,93,101,48,44,62
"2011","Bristol 044D","E01014647","Total",613,160,59,101,453,46,50,85,88,44,50,90
"2011","Bristol 044E","E01014650","Total",620,153,81,72,467,31,79,92,116,17,39,93
"2011","Bristol 045A","E01014579","Total",546,139,66,73,407,60,65,87,73,22,32,68
"2011","Bristol 045B","E01014580","Total",666,244,92,152,422,71,64,63,102,21,25,76
"2011","Bristol 045C","E01014581","Total",641,207,74,133,434,86,57,73,93,24,36,65
"2011","Bristol 045D","E01014582","Total",520,122,48,74,398,56,39,67,93,28,33,82
"2011","Bristol 045E","E01014584","Total",468,78,40,38,390,54,34,73,80,28,53,68
"2011","Bristol 046A","E01014518","Total",720,216,98,118,504,38,67,106,160,14,24,95
"2011","Bristol 046B","E01014519","Total",552,173,101,72,379,29,77,61,91,18,37,66
"2011","Bristol 046C","E01014520","Total",652,172,104,68,480,14,140,64,116,8,37,101
"2011","Bristol 046D","E01014521","Total",510,122,67,55,388,28,82,73,84,15,29,77
"2011","Bristol 047A","E01014607","Total",541,122,47,75,419,33,87,68,108,20,26,77
"2011","Bristol 047B","E01014608","Total",719,240,91,149,479,79,59,84,111,18,50,78
"2011","Bristol 047C","E01014609","Total",704,199,83,116,505,67,71,109,123,15,33,87
"2011","Bristol 047D","E01014610","Total",715,303,156,147,412,57,66,70,131,10,24,54
"2011","Bristol 047E","E01014613","Total",659,187,71,116,472,42,110,74,127,10,20,89
"2011","Bristol 047F","E01014614","Total",498,118,71,47,380,14,85,64,97,13,36,71
"2011","Bristol 048A","E01014594","Total",640,208,86,122,432,106,52,89,76,21,18,70
"2011","Bristol 048B","E01014598","Total",616,150,92,58,466,22,131,64,119,16,27,87
"2011","Bristol 048C","E01014599","Total",533,142,65,77,391,24,77,88,103,15,26,58
"2011","Bristol 048D","E01014600","Total",585,172,122,50,413,42,79,63,111,19,30,69
"2011","Bristol 049A","E01014702","Total",599,140,62,78,459,28,119,83,104,14,29,82
"2011","Bristol 049B","E01014703","Total",676,288,88,200,388,53,55,69,107,10,31,63
"2011","Bristol 049C","E01014704","Total",742,191,70,121,551,59,87,97,146,20,51,91
"2011","Bristol 049D","E01014705","Total",616,189,143,46,427,18,146,61,84,10,25,83
"2011","Bristol 049E","E01014706","Total",624,266,122,144,358,43,84,67,96,11,13,44
"2011","Bristol 049F","E01014707","Total",626,136,90,46,490,22,145,75,84,8,46,110
"2011","Bristol 049G","E01014708","Total",708,157,87,70,551,35,117,94,123,19,42,121
"2011","Bristol 050A","E01014515","Total",618,182,108,74,436,57,87,63,89,15,34,91
"2011","Bristol 050B","E01014516","Total",636,226,97,129,410,103,64,64,82,13,28,56
"2011","Bristol 050C","E01014517","Total",495,140,58,82,355,49,41,59,89,16,32,69
"2011","Bristol 050D","E01014522","Total",732,249,110,139,483,104,78,95,109,16,23,58
"2011","Bristol 051A","E01014593","Total",572,139,41,98,433,106,53,76,73,29,40,56
"2011","Bristol 051B","E01014595","Total",642,242,85,157,400,51,84,76,82,19,19,69
"2011","Bristol 051C","E01014596","Total",603,175,86,89,428,54,87,66,72,25,47,77
"2011","Bristol 051D","E01014597","Total",618,248,83,165,370,48,83,54,84,14,35,52
"2011","Bristol 052A","E01014611","Total",560,145,99,46,415,13,125,59,108,8,22,80
"2011","Bristol 052B","E01014612","Total",625,162,102,60,463,38,112,70,120,12,33,78
"2011","Bristol 052C","E01014722","Total",622,146,82,64,476,23,97,75,130,10,26,115
"2011","Bristol 052D","E01014723","Total",533,104,50,54,429,31,104,68,87,14,23,102
"2011","Bristol 052E","E01014725","Total",607,128,79,49,479,19,129,63,120,13,29,106
"2011","Bristol 053B","E01014726","Total",675,213,63,150,462,95,59,68,105,33,30,72
"2011","Bristol 053C","E01014727","Total",631,189,83,106,442,97,68,82,75,20,37,63
"2011","Bristol 053E","E01032514","Total",899,335,106,229,564,170,69,97,108,34,32,54
"2011","Bristol 053F","E01032515","Total",629,212,99,113,417,56,97,62,98,11,27,66
"2011","Bristol 054A","E01033352","Total",678,296,24,272,382,39,5,37,234,10,4,53
"2011","Bristol 054B","E01033353","Total",713,410,67,343,303,32,25,15,184,2,3,42
"2011","Bristol 054C","E01033355","Total",606,323,22,301,283,10,13,21,191,1,1,46
"2011","Bristol 054D","E01033358","Total",689,294,62,232,395,116,24,49,110,39,17,40
"2011","Bristol 054E","E01033370","Total",694,415,101,314,279,43,26,35,134,7,10,24
"2011","Bristol 055A","E01014564","Total",736,223,69,154,513,72,38,74,140,36,55,98
"2011","Bristol 055B","E01014653","Total",1058,409,92,317,649,190,33,95,125,59,59,88
"2011","Bristol 055C","E01014655","Total",1063,485,94,391,578,106,45,88,158,34,55,92
"2011","Bristol 056A","E01014654","Total",879,295,59,236,584,111,49,88,115,49,72,100
"2011","Bristol 056B","E01014658","Total",842,265,68,197,577,187,36,95,103,50,53,53
"2011","Bristol 056C","E01033356","Total",693,329,102,227,364,92,35,55,104,23,22,33
"2011","Bristol 056D","E01033369","Total",601,232,94,138,369,95,36,55,66,35,24,58
"2011","Bristol 057A","E01014568","Total",1007,351,90,261,656,110,40,99,185,58,52,112
"2011","Bristol 057B","E01014569","Total",846,278,66,212,568,68,42,97,167,29,55,110
"2011","Bristol 057C","E01014570","Total",779,251,61,190,528,66,43,120,154,22,39,84
"2011","Bristol 057D","E01014574","Total",989,435,89,346,554,111,39,92,153,33,46,80
"2011","Cornwall 010A","E01018753","Total",686,161,80,81,525,18,139,82,145,14,37,90
"2011","Cornwall 010B","E01018754","Total",684,229,123,106,455,23,90,74,129,20,33,86
"2011","Cornwall 010C","E01018755","Total",654,180,95,85,474,16,135,81,125,10,26,81
"2011","Cornwall 010D","E01018756","Total",745,236,131,105,509,20,157,62,152,21,35,62
"2011","Cornwall 012A","E01018777","Total",865,203,102,101,662,11,181,97,212,20,34,107
"2011","Cornwall 012B","E01018782","Total",630,159,74,85,471,30,121,83,133,11,29,64
"2011","Cornwall 012C","E01018783","Total",674,168,81,87,506,24,138,68,149,17,36,74
"2011","Cornwall 012D","E01018784","Total",650,178,87,91,472,20,136,70,132,17,25,72
"2011","Cornwall 013A","E01018750","Total",953,240,124,116,713,48,160,124,192,27,53,109
"2011","Cornwall 013B","E01018751","Total",697,257,102,155,440,26,93,72,133,19,27,70
"2011","Cornwall 013C","E01018752","Total",858,206,90,116,652,42,152,120,184,22,43,89
"2011","Cornwall 013D","E01018779","Total",971,269,134,135,702,30,188,112,203,29,39,101
"2011","Cornwall 016A","E01018758","Total",1030,281,155,126,749,40,163,141,212,20,55,118
"2011","Cornwall 016B","E01018768","Total",781,182,63,119,599,56,88,139,160,20,55,81
"2011","Cornwall 016C","E01018769","Total",832,273,142,131,559,46,140,105,142,12,41,73
"2011","Cornwall 016D","E01018778","Total",736,179,97,82,557,21,143,80,181,20,35,77
"2011","Cornwall 017A","E01018767","Total",647,214,106,108,433,44,77,82,118,17,32,63
"2011","Cornwall 017B","E01018770","Total",552,183,100,83,369,36,81,63,92,13,30,54
"2011","Cornwall 017C","E01018771","Total",704,342,105,237,362,24,66,57,140,9,14,52
"2011","Cornwall 017D","E01018772","Total",705,205,115,90,500,15,156,78,132,12,31,76
"2011","Cornwall 022A","E01018764","Total",616,143,83,60,473,6,140,91,133,13,21,69
"2011","Cornwall 022B","E01018787","Total",604,113,40,73,491,18,83,116,145,26,27,76
"2011","Cornwall 022C","E01018795","Total",510,102,57,45,408,10,108,55,127,9,33,66
"2011","Cornwall 022D","E01018796","Total",498,117,38,79,381,22,59,100,112,9,22,57
"2011","Cornwall 023A","E01018757","Total",939,272,138,134,667,23,203,87,192,21,36,105
"2011","Cornwall 023B","E01018763","Total",447,104,43,61,343,12,53,69,106,14,28,61
"2011","Cornwall 023C","E01018765","Total",671,147,88,59,524,13,199,63,165,10,19,55
"2011","Cornwall 023D","E01018785","Total",822,196,107,89,626,24,146,110,184,22,41,99
"2011","Cornwall 025A","E01018786","Total",550,126,65,61,424,21,107,69,127,11,24,65
"2011","Cornwall 025B","E01018788","Total",723,312,203,109,411,29,134,59,97,7,16,69
"2011","Cornwall 025C","E01018790","Total",487,135,67,68,352,23,66,59,87,14,22,81
"2011","Cornwall 025D","E01018794","Total",612,174,84,90,438,23,86,87,134,8,24,76
"2011","Cornwall 026A","E01018789","Total",604,145,78,67,459,25,102,83,113,12,29,95
"2011","Cornwall 026B","E01018791","Total",531,166,83,83,365,13,95,53,92,10,33,69
"2011","Cornwall 026C","E01018792","Total",1183,322,137,185,861,45,163,211,241,19,52,130
"2011","Cornwall 026D","E01018793","Total",772,261,98,163,511,37,101,87,150,17,31,88
"2011","Cornwall 028A","E01018759","Total",629,145,68,77,484,19,130,66,137,17,26,89
"2011","Cornwall 028B","E01018760","Total",514,125,68,57,389,18,101,44,110,18,35,63
"2011","Cornwall 028C","E01018761","Total",695,209,144,65,486,16,200,49,112,12,27,70
"2011","Cornwall 028D","E01018766","Total",858,294,170,124,564,16,183,61,158,21,37,88
"2011","Cornwall 028E","E01018774","Total",673,271,130,141,402,23,94,57,116,16,28,68
"2011","Cornwall 029A","E01018797","Total",501,169,61,108,332,26,77,64,84,19,13,49
"2011","Cornwall 029B","E01018798","Total",665,217,112,105,448,22,106,70,119,13,26,92
"2011","Cornwall 029C","E01018799","Total",561,221,126,95,340,33,69,65,91,11,17,54
"2011","Cornwall 029D","E01018800","Total",656,143,68,75,513,43,84,126,143,17,34,66
"2011","Cornwall 034A","E01018780","Total",1002,271,131,140,731,54,183,133,199,21,42,99
"2011","Cornwall 034B","E01018781","Total",853,254,136,118,599,22,201,75,182,15,34,70
"2011","Cornwall 034E","E01033294","Total",1017,297,136,161,720,32,133,127,235,18,46,129
"2011","Cornwall 037A","E01018762","Total",549,161,83,78,388,14,104,52,128,13,19,58
"2011","Cornwall 037B","E01018773","Total",727,245,116,129,482,23,164,67,132,14,23,59
"2011","Cornwall 037C","E01018775","Total",636,209,116,93,427,11,145,59,88,17,22,85
"2011","Cornwall 037D","E01018776","Total",597,242,108,134,355,13,105,44,127,4,21,41
"2011","Cornwall 032A","E01018815","Total",836,221,70,151,615,35,93,136,177,26,45,103
"2011","Cornwall 032B","E01018831","Total",536,143,75,68,393,17,78,73,114,21,26,64
"2011","Cornwall 032C","E01018832","Total",553,124,61,63,429,9,102,69,130,12,28,79
"2011","Cornwall 032D","E01018847","Total",631,168,69,99,463,28,74,97,139,14,25,86
"2011","Cornwall 033A","E01018833","Total",591,147,82,65,444,19,109,75,94,18,43,86
"2011","Cornwall 033B","E01018842","Total",621,179,81,98,442,24,100,61,139,16,26,76
"2011","Cornwall 033C","E01018843","Total",534,124,67,57,410,14,105,58,111,8,29,85
"2011","Cornwall 033D","E01018844","Total",616,254,132,122,362,24,84,57,120,9,19,49
"2011","Cornwall 040A","E01018825","Total",667,186,75,111,481,26,94,103,137,17,31,73
"2011","Cornwall 040B","E01018826","Total",987,358,195,163,629,23,162,135,151,16,48,94
"2011","Cornwall 040C","E01018851","Total",672,248,163,85,424,21,102,71,139,8,23,60
"2011","Cornwall 040D","E01018852","Total",1078,290,156,134,788,43,204,135,204,30,47,125
"2011","Cornwall 042A","E01018823","Total",748,323,187,136,425,28,112,66,122,5,24,68
"2011","Cornwall 042B","E01018824","Total",1031,263,146,117,768,44,173,182,157,33,62,117
"2011","Cornwall 042C","E01018853","Total",1010,246,101,145,764,70,111,150,197,29,61,146
"2011","Cornwall 042D","E01018854","Total",598,200,104,96,398,41,68,77,95,14,25,78
"2011","Cornwall 043A","E01018819","Total",652,185,55,130,467,33,73,89,166,12,24,70
"2011","Cornwall 043B","E01018822","Total",516,128,76,52,388,15,97,56,101,19,24,76
"2011","Cornwall 043C","E01018855","Total",936,211,88,123,725,53,109,173,200,22,39,129
"2011","Cornwall 043D","E01018856","Total",638,213,107,106,425,23,92,51,134,10,30,85
"2011","Cornwall 043E","E01018857","Total",540,175,82,93,365,38,93,64,88,7,24,51
"2011","Cornwall 043F","E01018858","Total",632,204,125,79,428,20,141,74,91,15,22,65
"2011","Cornwall 044A","E01018807","Total",626,211,113,98,415,20,115,49,133,9,19,70
"2011","Cornwall 044B","E01018808","Total",656,219,100,119,437,22,81,86,133,17,26,72
"2011","Cornwall 044C","E01018809","Total",1141,635,295,340,506,50,80,90,197,8,20,61
"2011","Cornwall 044D","E01018810","Total",579,157,61,96,422,14,75,82,135,15,24,77
"2011","Cornwall 047A","E01018816","Total",736,181,124,57,555,4,226,80,115,19,26,85
"2011","Cornwall 047B","E01018817","Total",886,248,149,99,638,22,193,103,149,17,49,105
"2011","Cornwall 047C","E01018818","Total",721,203,150,53,518,13,208,64,96,18,30,89
"2011","Cornwall 047D","E01018820","Total",759,210,100,110,549,26,110,108,156,19,43,87
"2011","Cornwall 047E","E01018821","Total",492,115,44,71,377,18,70,63,109,16,31,70
"2011","Cornwall 048A","E01018845","Total",665,208,124,84,457,12,100,94,122,27,35,67
"2011","Cornwall 048B","E01018846","Total",606,181,87,94,425,13,125,62,124,10,23,68
"2011","Cornwall 048C","E01018848","Total",698,203,110,93,495,20,119,101,126,14,40,75
"2011","Cornwall 048D","E01018849","Total",941,370,226,144,571,22,209,51,164,17,33,75
"2011","Cornwall 048E","E01018850","Total",586,169,97,72,417,11,143,56,96,14,26,71
"2011","Cornwall 056A","E01018827","Total",656,189,119,70,467,13,170,57,111,6,31,79
"2011","Cornwall 056B","E01018828","Total",696,218,125,93,478,20,163,66,119,11,28,71
"2011","Cornwall 056C","E01018829","Total",539,110,45,65,429,17,103,64,118,10,37,80
"2011","Cornwall 056D","E01018830","Total",673,219,134,85,454,12,164,54,104,18,20,82
"2011","Cornwall 060A","E01018834","Total",718,165,73,92,553,30,125,115,123,20,39,101
"2011","Cornwall 060B","E01018835","Total",756,214,68,146,542,45,96,88,163,14,36,100
"2011","Cornwall 060C","E01018836","Total",758,313,106,207,445,61,47,63,130,13,31,100
"2011","Cornwall 060D","E01018837","Total",914,284,98,186,630,37,138,94,229,15,27,90
"2011","Cornwall 062A","E01018838","Total",625,184,100,84,441,22,101,62,85,16,39,116
"2011","Cornwall 062B","E01018839","Total",586,238,92,146,348,17,68,45,135,6,16,61
"2011","Cornwall 062C","E01018840","Total",689,234,79,155,455,21,62,53,137,9,20,153
"2011","Cornwall 062D","E01018841","Total",582,147,78,69,435,63,74,48,105,14,40,91
"2011","Cornwall 062E","E01018860","Total",826,273,170,103,553,48,127,92,111,21,54,100
"2011","Cornwall 063A","E01018803","Total",966,523,181,342,443,10,126,45,136,12,13,101
"2011","Cornwall 063B","E01018804","Total",742,250,79,171,492,20,38,63,144,12,20,195
"2011","Cornwall 063C","E01018805","Total",685,221,137,84,464,14,142,65,136,7,23,77
"2011","Cornwall 063D","E01018806","Total",641,213,103,110,428,25,57,64,116,10,17,139
"2011","Cornwall 064A","E01018811","Total",622,159,86,73,463,26,106,99,107,10,33,82
"2011","Cornwall 064B","E01018812","Total",594,186,92,94,408,32,63,93,118,14,21,67
"2011","Cornwall 064C","E01018813","Total",599,167,83,84,432,19,74,93,122,17,26,81
"2011","Cornwall 064D","E01018814","Total",597,154,80,74,443,30,93,84,97,7,35,97
"2011","Cornwall 064E","E01018859","Total",755,218,138,80,537,8,182,64,123,16,28,116
"2011","Cornwall 045A","E01018889","Total",548,135,77,58,413,15,84,75,114,12,36,77
"2011","Cornwall 045B","E01018890","Total",630,164,96,68,466,13,137,59,133,14,26,84
"2011","Cornwall 045C","E01018891","Total",589,156,68,88,433,49,103,69,128,7,17,60
"2011","Cornwall 045D","E01018892","Total",584,166,85,81,418,16,90,77,130,12,32,61
"2011","Cornwall 045E","E01018893","Total",618,212,134,78,406,21,109,63,96,14,24,79
"2011","Cornwall 046A","E01018908","Total",692,184,90,94,508,30,129,71,127,14,40,97
"2011","Cornwall 046B","E01018909","Total",695,204,87,117,491,39,75,127,146,15,26,63
"2011","Cornwall 046C","E01018910","Total",776,262,122,140,514,73,75,84,111,33,47,91
"2011","Cornwall 046D","E01018911","Total",835,388,160,228,447,36,78,90,146,13,28,56
"2011","Cornwall 049A","E01018912","Total",630,170,85,85,460,17,123,83,126,13,29,69
"2011","Cornwall 049B","E01018913","Total",777,272,76,196,505,37,61,134,150,12,40,71
"2011","Cornwall 049C","E01018914","Total",814,237,95,142,577,28,118,100,176,21,36,98
"2011","Cornwall 049D","E01018915","Total",872,241,123,118,631,56,137,110,183,20,40,85
"2011","Cornwall 050A","E01018916","Total",545,122,56,66,423,19,86,82,128,10,39,59
"2011","Cornwall 050B","E01018917","Total",597,164,92,72,433,15,110,86,118,12,26,66
"2011","Cornwall 050C","E01018918","Total",764,229,138,91,535,25,111,106,156,15,42,80
"2011","Cornwall 050D","E01018919","Total",611,182,100,82,429,15,120,67,124,12,20,71
"2011","Cornwall 051A","E01018894","Total",742,203,76,127,539,30,83,103,161,25,39,98
"2011","Cornwall 051B","E01018895","Total",678,156,63,93,522,21,107,95,142,18,44,95
"2011","Cornwall 051C","E01018896","Total",649,178,86,92,471,17,125,80,114,15,49,71
"2011","Cornwall 051D","E01018897","Total",641,228,65,163,413,32,63,78,128,12,30,70
"2011","Cornwall 051E","E01018898","Total",552,193,78,115,359,52,46,73,87,18,27,56
"2011","Cornwall 052A","E01018865","Total",819,245,74,171,574,59,111,105,158,26,44,71
"2011","Cornwall 052B","E01018866","Total",716,210,114,96,506,32,135,84,136,9,29,81
"2011","Cornwall 052C","E01018867","Total",795,220,105,115,575,72,92,99,148,25,46,93
"2011","Cornwall 052D","E01018868","Total",760,236,97,139,524,63,93,103,125,26,36,78
"2011","Cornwall 053A","E01018874","Total",587,172,103,69,415,16,141,59,96,11,25,67
"2011","Cornwall 053B","E01018875","Total",630,249,168,81,381,38,91,69,86,20,28,49
"2011","Cornwall 053C","E01018876","Total",575,148,67,81,427,26,89,77,113,15,32,75
"2011","Cornwall 053D","E01018877","Total",629,178,118,60,451,10,173,48,86,9,35,90
"2011","Cornwall 053E","E01018878","Total",702,319,155,164,383,46,66,62,99,15,23,72
"2011","Cornwall 055A","E01018869","Total",661,173,79,94,488,33,117,93,128,14,34,69
"2011","Cornwall 055B","E01018870","Total",492,130,56,74,362,52,38,70,71,26,40,65
"2011","Cornwall 055C","E01018871","Total",702,171,99,72,531,22,125,89,160,14,35,86
"2011","Cornwall 055D","E01018872","Total",532,143,56,87,389,23,94,72,91,11,25,73
"2011","Cornwall 055E","E01018873","Total",505,119,58,61,386,32,77,74,90,22,33,58
"2011","Cornwall 059A","E01018863","Total",660,160,74,86,500,28,88,114,125,19,37,89
"2011","Cornwall 059B","E01018864","Total",664,154,86,68,510,15,119,84,145,21,40,86
"2011","Cornwall 059C","E01018921","Total",872,205,103,102,667,25,151,110,194,17,56,114
"2011","Cornwall 059D","E01018922","Total",921,200,89,111,721,21,151,104,201,31,74,139
"2011","Cornwall 066A","E01018879","Total",799,231,149,82,568,8,213,73,141,12,17,104
"2011","Cornwall 066B","E01018880","Total",919,294,173,121,625,23,168,98,152,33,48,103
"2011","Cornwall 066C","E01018899","Total",618,165,98,67,453,17,126,61,122,13,30,84
"2011","Cornwall 066D","E01018900","Total",639,167,94,73,472,11,121,76,142,15,30,77
"2011","Cornwall 066E","E01018901","Total",699,207,107,100,492,16,146,82,117,16,48,67
"2011","Cornwall 071A","E01018882","Total",616,114,58,56,502,33,112,97,133,10,39,78
"2011","Cornwall 071B","E01018883","Total",651,151,78,73,500,24,108,95,140,21,33,79
"2011","Cornwall 071C","E01018884","Total",684,141,83,58,543,44,124,108,142,15,32,78
"2011","Cornwall 071D","E01018885","Total",680,229,106,123,451,38,100,77,140,9,25,62
"2011","Cornwall 071E","E01018886","Total",738,147,66,81,591,29,77,206,150,40,33,56
"2011","Cornwall 071F","E01018887","Total",643,167,61,106,476,51,70,100,126,28,36,65
"2011","Cornwall 071G","E01018888","Total",904,329,162,167,575,65,139,102,157,20,31,61
"2011","Cornwall 072A","E01018861","Total",613,170,90,80,443,10,111,77,113,13,31,88
"2011","Cornwall 072B","E01018862","Total",619,162,91,71,457,7,152,54,133,15,21,75
"2011","Cornwall 072C","E01018905","Total",570,160,93,67,410,18,106,52,111,16,27,80
"2011","Cornwall 072D","E01018906","Total",566,188,107,81,378,20,111,58,94,15,18,62
"2011","Cornwall 072E","E01018907","Total",589,215,116,99,374,23,111,55,103,14,25,43
"2011","Cornwall 073A","E01018881","Total",815,234,123,111,581,22,178,69,145,17,43,107
"2011","Cornwall 073B","E01018902","Total",512,127,73,54,385,14,100,81,107,9,14,60
"2011","Cornwall 073C","E01018903","Total",446,121,65,56,325,12,91,55,89,16,17,45
"2011","Cornwall 073D","E01018904","Total",942,278,174,104,664,28,206,81,183,28,38,100
"2011","Cornwall 073E","E01018920","Total",885,251,146,105,634,25,209,87,145,15,40,113
"2011","Cornwall 001A","E01018936","Total",713,270,117,153,443,19,112,74,131,9,36,62
"2011","Cornwall 001B","E01018937","Total",772,190,79,111,582,65,106,129,154,18,47,63
"2011","Cornwall 001C","E01018938","Total",812,321,214,107,491,27,163,72,126,13,26,64
"2011","Cornwall 001D","E01018959","Total",684,225,136,89,459,13,196,61,111,5,23,50
"2011","Cornwall 001E","E01018960","Total",796,205,102,103,591,40,141,112,159,24,38,77
"2011","Cornwall 001F","E01018961","Total",707,276,123,153,431,26,139,64,116,10,21,55
"2011","Cornwall 002A","E01018943","Total",897,227,108,119,670,14,177,115,190,27,43,104
"2011","Cornwall 002B","E01018951","Total",949,250,142,108,699,22,198,90,188,33,52,116
"2011","Cornwall 002C","E01018974","Total",1007,234,123,111,773,25,186,109,208,35,47,163
"2011","Cornwall 003A","E01018940","Total",691,207,101,106,484,19,147,77,125,14,29,73
"2011","Cornwall 003B","E01018941","Total",684,218,99,119,466,27,114,92,122,18,31,62
"2011","Cornwall 003C","E01018942","Total",692,238,111,127,454,25,148,55,120,14,27,65
"2011","Cornwall 003D","E01018969","Total",1011,296,161,135,715,23,223,96,210,21,32,110
"2011","Cornwall 004B","E01018953","Total",496,110,60,50,386,5,116,62,100,11,29,63
"2011","Cornwall 004C","E01018968","Total",1002,210,119,91,792,20,211,122,233,20,61,125
"2011","Cornwall 004D","E01033291","Total",660,156,81,75,504,17,156,65,125,17,38,86
"2011","Cornwall 004E","E01033292","Total",576,170,75,95,406,51,53,89,116,23,28,46
"2011","Cornwall 005A","E01018946","Total",678,221,132,89,457,15,135,70,123,19,20,75
"2011","Cornwall 005B","E01018947","Total",1179,320,121,199,859,73,128,190,254,43,53,118
"2011","Cornwall 005C","E01018948","Total",710,209,82,127,501,41,106,78,139,24,32,81
"2011","Cornwall 005D","E01018949","Total",523,123,53,70,400,46,45,90,88,32,41,58
"2011","Cornwall 005E","E01018950","Total",836,367,136,231,469,37,85,69,179,9,31,59
"2011","Cornwall 006A","E01018925","Total",916,246,109,137,670,14,199,96,185,19,46,111
"2011","Cornwall 006B","E01018952","Total",501,120,71,49,381,15,124,61,95,9,22,55
"2011","Cornwall 006C","E01018965","Total",995,263,146,117,732,20,218,100,195,25,51,123
"2011","Cornwall 006D","E01018966","Total",467,101,57,44,366,5,99,45,121,3,26,67
"2011","Cornwall 006E","E01018967","Total",535,128,65,63,407,9,90,65,126,20,28,69
"2011","Cornwall 007A","E01018924","Total",467,127,73,54,340,11,81,52,84,13,30,69
"2011","Cornwall 007B","E01018962","Total",930,298,163,135,632,21,186,107,163,17,34,104
"2011","Cornwall 007E","E01033289","Total",999,365,225,140,634,20,241,77,138,33,33,92
"2011","Cornwall 008A","E01018954","Total",476,104,47,57,372,29,56,91,98,22,27,49
"2011","Cornwall 008B","E01018955","Total",684,203,102,101,481,20,158,85,99,20,24,75
"2011","Cornwall 008C","E01018956","Total",474,136,85,51,338,8,126,40,69,12,23,60
"2011","Cornwall 008D","E01018957","Total",542,146,74,72,396,28,102,62,95,10,36,63
"2011","Cornwall 008E","E01018958","Total",634,258,148,110,376,15,112,50,95,11,29,64
"2011","Cornwall 009A","E01018970","Total",634,159,89,70,475,26,116,88,110,10,36,89
"2011","Cornwall 009B","E01018971","Total",851,282,178,104,569,30,176,105,125,12,41,80
"2011","Cornwall 009C","E01018972","Total",832,327,171,156,505,36,123,78,137,15,35,81
"2011","Cornwall 009D","E01018973","Total",638,219,112,107,419,36,101,72,104,12,21,73
"2011","Cornwall 011A","E01018923","Total",531,136,70,66,395,16,132,69,86,14,24,54
"2011","Cornwall 011B","E01018926","Total",1027,278,139,139,749,21,236,103,201,19,51,118
"2011","Cornwall 011C","E01018944","Total",455,91,46,45,364,12,86,53,91,12,27,83
"2011","Cornwall 011D","E01018945","Total",540,144,81,63,396,12,117,63,84,12,22,86
"2011","Cornwall 014A","E01018932","Total",703,203,76,127,500,47,96,86,147,10,37,77
"2011","Cornwall 014B","E01018933","Total",657,269,76,193,388,36,73,57,119,13,31,59
"2011","Cornwall 014C","E01018934","Total",811,179,98,81,632,20,163,108,159,21,45,116
"2011","Cornwall 014D","E01018935","Total",927,217,83,134,710,67,135,159,179,30,45,95
"2011","Cornwall 015A","E01018927","Total",648,197,101,96,451,26,78,85,119,25,39,79
"2011","Cornwall 015B","E01018928","Total",790,310,122,188,480,48,70,101,136,22,25,78
"2011","Cornwall 015C","E01018929","Total",539,162,88,74,377,22,99,68,92,10,29,57
"2011","Cornwall 015D","E01018930","Total",669,217,76,141,452,77,43,90,116,33,28,65
"2011","Cornwall 015E","E01018931","Total",502,121,75,46,381,19,120,64,82,13,22,61
"2011","Cornwall 054A","E01019008","Total",642,220,110,110,422,41,88,62,120,5,27,79
"2011","Cornwall 054B","E01019009","Total",606,157,67,90,449,38,76,90,97,27,39,82
"2011","Cornwall 054C","E01019010","Total",569,153,82,71,416,27,106,65,86,14,32,86
"2011","Cornwall 054D","E01019011","Total",628,182,93,89,446,16,147,58,130,5,24,66
"2011","Cornwall 054E","E01019012","Total",1000,525,235,290,475,22,155,58,150,4,22,64
"2011","Cornwall 057A","E01018978","Total",632,177,86,91,455,19,109,75,121,23,30,78
"2011","Cornwall 057B","E01018981","Total",907,297,162,135,610,20,170,107,157,12,43,101
"2011","Cornwall 057C","E01018982","Total",919,278,138,140,641,56,114,139,175,24,52,81
"2011","Cornwall 057D","E01018983","Total",682,194,105,89,488,20,164,68,116,13,28,79
"2011","Cornwall 057E","E01018984","Total",891,316,153,163,575,65,108,104,123,22,53,100
"2011","Cornwall 058A","E01018985","Total",995,278,140,138,717,41,213,100,202,11,42,108
"2011","Cornwall 058B","E01018986","Total",746,280,160,120,466,19,169,71,130,5,22,50
"2011","Cornwall 058C","E01018987","Total",915,251,120,131,664,15,183,112,185,17,40,112
"2011","Cornwall 061A","E01018975","Total",827,222,125,97,605,33,170,124,135,17,37,89
"2011","Cornwall 061B","E01018979","Total",542,138,51,87,404,20,95,66,107,15,34,67
"2011","Cornwall 061C","E01018980","Total",577,165,84,81,412,19,105,72,118,15,30,53
"2011","Cornwall 061D","E01018990","Total",859,331,189,142,528,33,183,78,127,17,21,69
"2011","Cornwall 061E","E01019007","Total",909,222,99,123,687,36,159,112,187,24,48,121
"2011","Cornwall 065A","E01018988","Total",669,191,109,82,478,29,118,79,138,9,26,79
"2011","Cornwall 065B","E01018989","Total",717,202,98,104,515,25,115,81,137,17,34,106
"2011","Cornwall 065C","E01018991","Total",680,211,110,101,469,38,103,71,139,8,34,76
"2011","Cornwall 065D","E01019006","Total",687,192,94,98,495,13,132,70,139,17,33,91
"2011","Cornwall 067A","E01018976","Total",976,306,185,121,670,32,191,110,200,18,28,91
"2011","Cornwall 067B","E01018977","Total",608,188,88,100,420,56,74,79,91,12,40,68
"2011","Cornwall 067C","E01018994","Total",776,275,162,113,501,31,164,61,136,14,25,70
"2011","Cornwall 067D","E01018996","Total",752,337,129,208,415,35,95,74,106,22,33,50
"2011","Cornwall 067E","E01018997","Total",573,162,70,92,411,61,52,86,80,21,52,59
"2011","Cornwall 068A","E01018995","Total",1048,500,199,301,548,62,118,69,162,19,34,84
"2011","Cornwall 068B","E01018998","Total",687,254,74,180,433,59,54,99,145,11,17,48
"2011","Cornwall 068C","E01018999","Total",797,419,185,234,378,38,61,71,133,5,19,51
"2011","Cornwall 068D","E01019001","Total",940,496,233,263,444,43,104,67,142,6,17,65
"2011","Cornwall 069A","E01018992","Total",727,236,107,129,491,26,113,65,159,14,27,87
"2011","Cornwall 069B","E01018993","Total",794,326,136,190,468,46,87,73,139,10,28,85
"2011","Cornwall 069C","E01019005","Total",908,277,132,145,631,27,160,103,186,25,36,94
"2011","Cornwall 070A","E01019000","Total",682,240,158,82,442,22,181,48,96,9,17,69
"2011","Cornwall 070B","E01019002","Total",705,268,143,125,437,25,156,55,108,9,14,70
"2011","Cornwall 070C","E01019003","Total",777,221,108,113,556,24,165,68,176,15,32,76
"2011","Cornwall 070D","E01019004","Total",756,281,136,145,475,66,111,65,117,16,28,72
"2011","Cornwall 018A","E01019048","Total",806,250,118,132,556,20,137,71,183,19,23,103
"2011","Cornwall 018B","E01019049","Total",752,209,77,132,543,29,106,112,166,17,39,74
"2011","Cornwall 018C","E01019050","Total",583,150,71,79,433,14,117,71,136,9,42,44
"2011","Cornwall 018D","E01019051","Total",712,236,136,100,476,47,108,98,105,7,26,85
"2011","Cornwall 019A","E01019060","Total",629,152,76,76,477,14,135,81,113,12,28,94
"2011","Cornwall 019B","E01019061","Total",718,189,76,113,529,27,119,116,141,17,37,72
"2011","Cornwall 019C","E01019062","Total",788,199,97,102,589,56,99,120,165,24,42,83
"2011","Cornwall 019D","E01019063","Total",799,174,72,102,625,38,117,124,189,15,40,102
"2011","Cornwall 019E","E01019064","Total",775,202,85,117,573,38,108,118,137,19,50,103
"2011","Cornwall 019F","E01019065","Total",523,120,57,63,403,27,82,74,98,19,29,74
"2011","Cornwall 020A","E01019028","Total",938,383,152,231,555,49,78,100,191,19,38,80
"2011","Cornwall 020B","E01019029","Total",687,307,131,176,380,32,47,66,139,9,16,71
"2011","Cornwall 020C","E01019030","Total",742,192,69,123,550,35,108,102,162,18,26,99
"2011","Cornwall 020D","E01019031","Total",724,261,104,157,463,27,121,84,151,10,25,45
"2011","Cornwall 021A","E01019018","Total",656,141,94,47,515,16,155,86,103,14,34,107
"2011","Cornwall 021B","E01019019","Total",638,223,116,107,415,22,115,46,112,10,37,73
"2011","Cornwall 021C","E01019020","Total",688,298,46,252,390,41,50,51,128,14,28,78
"2011","Cornwall 021D","E01019021","Total",651,174,91,83,477,30,120,77,132,10,33,75
"2011","Cornwall 021E","E01019022","Total",769,252,120,132,517,57,107,85,139,12,28,89
"2011","Cornwall 021F","E01019023","Total",630,119,36,83,511,59,59,118,143,18,27,87
"2011","Cornwall 024A","E01019052","Total",723,180,83,97,543,33,101,108,147,21,36,97
"2011","Cornwall 024B","E01019053","Total",842,227,81,146,615,33,137,120,183,22,34,86
"2011","Cornwall 024C","E01019054","Total",742,161,82,79,581,25,132,103,167,18,48,88
"2011","Cornwall 024D","E01019055","Total",577,133,74,59,444,40,74,83,111,23,35,78
"2011","Cornwall 027A","E01019035","Total",720,289,163,126,431,23,131,64,116,11,24,62
"2011","Cornwall 027B","E01019036","Total",720,184,80,104,536,14,150,78,164,14,32,84
"2011","Cornwall 027C","E01019037","Total",603,163,90,73,440,27,105,83,102,13,39,71
"2011","Cornwall 027D","E01019074","Total",721,177,63,114,544,38,90,112,155,21,52,76
"2011","Cornwall 027E","E01019075","Total",691,162,74,88,529,27,87,100,165,17,55,78
"2011","Cornwall 027F","E01019076","Total",737,173,67,106,564,55,105,112,126,33,50,83
"2011","Cornwall 030A","E01019069","Total",531,126,49,77,405,32,54,89,122,19,24,65
"2011","Cornwall 030B","E01019070","Total",863,258,111,147,605,44,130,96,167,28,51,89
"2011","Cornwall 030C","E01019071","Total",601,114,55,59,487,13,106,89,126,23,49,81
"2011","Cornwall 030D","E01019072","Total",610,160,89,71,450,30,83,88,103,23,44,79
"2011","Cornwall 030E","E01019073","Total",575,115,65,50,460,19,122,73,121,22,28,75
"2011","Cornwall 031A","E01019056","Total",610,169,92,77,441,71,58,89,87,27,49,60
"2011","Cornwall 031B","E01019057","Total",799,232,98,134,567,47,99,113,161,14,49,84
"2011","Cornwall 031C","E01019058","Total",749,196,88,108,553,27,118,118,143,22,37,88
"2011","Cornwall 031D","E01019059","Total",683,209,120,89,474,38,126,74,113,16,32,75
"2011","Cornwall 035A","E01019024","Total",604,170,96,74,434,30,97,71,116,12,33,75
"2011","Cornwall 035B","E01019025","Total",612,168,99,69,444,19,161,55,121,11,23,54
"2011","Cornwall 035C","E01019026","Total",644,203,135,68,441,15,132,63,110,17,33,71
"2011","Cornwall 035D","E01019027","Total",717,265,148,117,452,20,148,74,125,9,21,55
"2011","Cornwall 036A","E01019013","Total",932,254,138,116,678,46,181,129,146,23,53,100
"2011","Cornwall 036B","E01019014","Total",571,126,71,55,445,20,113,63,110,11,31,97
"2011","Cornwall 036C","E01019015","Total",591,150,60,90,441,16,103,86,101,15,30,90
"2011","Cornwall 036D","E01019016","Total",697,110,30,80,587,39,79,158,171,28,42,70
"2011","Cornwall 036E","E01019017","Total",1075,292,168,124,783,33,307,104,191,17,38,93
"2011","Cornwall 038A","E01019032","Total",611,160,77,83,451,22,110,77,130,12,32,68
"2011","Cornwall 038B","E01019034","Total",622,174,68,106,448,35,77,94,126,13,27,76
"2011","Cornwall 038C","E01019045","Total",871,221,92,129,650,40,124,132,192,15,56,91
"2011","Cornwall 038D","E01019047","Total",483,172,93,79,311,20,85,36,73,12,25,60
"2011","Cornwall 039A","E01019033","Total",694,330,147,183,364,42,77,60,94,21,18,52
"2011","Cornwall 039B","E01019041","Total",763,305,131,174,458,59,83,87,114,25,34,56
"2011","Cornwall 039C","E01019042","Total",749,258,101,157,491,46,88,79,135,16,38,89
"2011","Cornwall 039D","E01019043","Total",678,208,102,106,470,18,146,66,105,14,29,92
"2011","Cornwall 039E","E01019044","Total",721,239,154,85,482,19,178,68,117,4,21,75
"2011","Cornwall 039F","E01019046","Total",590,193,116,77,397,31,69,69,100,10,33,85
"2011","Cornwall 041A","E01019038","Total",549,221,120,101,328,9,124,46,90,8,17,34
"2011","Cornwall 041B","E01019039","Total",598,172,104,68,426,12,145,54,104,19,31,61
"2011","Cornwall 041C","E01019040","Total",546,155,75,80,391,21,120,38,113,13,24,62
"2011","Cornwall 041D","E01019066","Total",501,136,65,71,365,11,100,58,97,11,31,57
"2011","Cornwall 041E","E01019067","Total",493,150,91,59,343,9,114,51,93,9,25,42
"2011","Cornwall 041F","E01019068","Total",720,203,135,68,517,17,197,77,115,11,32,68
"2011","Isles of Scilly 001A","E01019077","Total",989,336,150,186,653,20,179,134,191,16,22,91
"2011","North Somerset 001B","E01014790","Total",624,166,97,69,458,16,129,81,124,14,28,66
"2011","North Somerset 001C","E01014795","Total",605,205,77,128,400,45,75,79,101,9,32,59
"2011","North Somerset 001D","E01014797","Total",740,222,114,108,518,28,113,93,133,18,35,98
"2011","North Somerset 001E","E01032675","Total",637,208,38,170,429,39,45,111,179,8,15,32
"2011","North Somerset 001F","E01032676","Total",726,321,74,247,405,22,84,68,187,7,16,21
"2011","North Somerset 001G","E01032681","Total",628,278,196,82,350,20,93,85,85,7,15,45
"2011","North Somerset 002A","E01014789","Total",615,189,99,90,426,7,159,52,117,14,20,57
"2011","North Somerset 002B","E01014793","Total",666,173,85,88,493,22,142,111,130,10,23,55
"2011","North Somerset 002C","E01014794","Total",745,187,128,59,558,12,202,82,151,12,22,77
"2011","North Somerset 002D","E01014798","Total",587,96,54,42,491,12,124,90,109,22,35,99
"2011","North Somerset 003B","E01014792","Total",891,330,201,129,561,26,165,84,169,21,27,69
"2011","North Somerset 003C","E01014796","Total",732,217,116,101,515,12,151,88,130,20,29,85
"2011","North Somerset 003D","E01032677","Total",573,167,45,122,406,50,20,145,132,15,19,25
"2011","North Somerset 003E","E01032678","Total",553,79,9,70,474,24,34,181,129,34,30,42
"2011","North Somerset 003F","E01032682","Total",425,102,37,65,323,39,42,106,72,10,17,37
"2011","North Somerset 004A","E01014766","Total",564,162,74,88,402,15,120,66,107,15,27,52
"2011","North Somerset 004B","E01014767","Total",572,140,87,53,432,4,164,68,88,13,15,80
"2011","North Somerset 004C","E01014786","Total",721,235,117,118,486,40,117,79,125,22,26,77
"2011","North Somerset 004D","E01014787","Total",814,222,103,119,592,27,137,133,164,18,31,82
"2011","North Somerset 005A","E01014752","Total",646,155,81,74,491,26,101,90,147,14,22,91
"2011","North Somerset 005B","E01014754","Total",636,293,129,164,343,22,100,42,141,3,11,24
"2011","North Somerset 005C","E01014758","Total",512,114,51,63,398,5,146,61,90,11,27,58
"2011","North Somerset 005D","E01014759","Total",596,142,116,26,454,6,171,67,107,12,21,70
"2011","North Somerset 006B","E01014849","Total",682,166,98,68,516,11,181,102,123,9,22,68
"2011","North Somerset 006C","E01014850","Total",822,193,96,97,629,21,138,150,165,33,40,82
"2011","North Somerset 006D","E01014851","Total",1080,289,121,168,791,56,151,239,211,30,28,76
"2011","North Somerset 006E","E01014852","Total",613,127,52,75,486,18,85,119,129,16,31,88
"2011","North Somerset 006F","E01032674","Total",948,162,59,103,786,50,112,264,218,37,34,71
"2011","North Somerset 006G","E01032680","Total",797,182,113,69,615,11,209,85,160,12,40,98
"2011","North Somerset 007A","E01014750","Total",742,278,115,163,464,29,92,90,157,18,26,52
"2011","North Somerset 007B","E01014751","Total",716,258,138,120,458,37,100,78,111,21,31,80
"2011","North Somerset 007C","E01014753","Total",810,285,138,147,525,44,100,120,144,18,25,74
"2011","North Somerset 007D","E01014755","Total",627,289,142,147,338,3,117,51,103,9,11,44
"2011","North Somerset 007E","E01014760","Total",626,168,95,73,458,15,135,76,116,14,32,70
"2011","North Somerset 008A","E01014780","Total",715,255,140,115,460,35,131,75,103,20,32,64
"2011","North Somerset 008B","E01014781","Total",789,323,203,120,466,33,145,83,109,16,23,57
"2011","North Somerset 008C","E01014782","Total",605,147,89,58,458,13,151,80,104,12,16,82
"2011","North Somerset 008D","E01014783","Total",729,273,115,158,456,26,90,68,147,13,35,77
"2011","North Somerset 008E","E01014784","Total",702,219,155,64,483,20,144,91,108,16,25,79
"2011","North Somerset 008F","E01014785","Total",587,106,79,27,481,9,154,56,132,8,27,95
"2011","North Somerset 009A","E01014775","Total",496,99,49,50,397,18,67,80,111,12,18,91
"2011","North Somerset 009B","E01014776","Total",498,89,40,49,409,15,77,84,95,19,25,94
"2011","North Somerset 009C","E01014777","Total",628,162,83,79,466,26,93,134,103,20,25,65
"2011","North Somerset 009D","E01014778","Total",536,92,67,25,444,7,141,57,121,10,19,89
"2011","North Somerset 009E","E01014779","Total",493,127,76,51,366,21,97,41,90,16,24,77
"2011","North Somerset 010A","E01014756","Total",768,297,95,202,471,35,103,84,125,15,34,75
"2011","North Somerset 010B","E01014757","Total",620,155,66,89,465,28,77,107,140,10,28,75
"2011","North Somerset 010C","E01014761","Total",729,233,104,129,496,28,99,102,145,15,23,84
"2011","North Somerset 010D","E01014762","Total",612,160,81,79,452,20,87,88,136,18,29,74
"2011","North Somerset 010E","E01014763","Total",719,176,54,122,543,44,57,140,143,24,45,90
"2011","North Somerset 011A","E01014737","Total",603,137,114,23,466,11,137,81,102,22,43,70
"2011","North Somerset 011B","E01014738","Total",566,121,68,53,445,33,86,113,90,20,35,68
"2011","North Somerset 011C","E01014739","Total",589,117,72,45,472,17,147,55,113,19,38,83
"2011","North Somerset 011D","E01014740","Total",530,115,54,61,415,26,94,100,88,14,31,62
"2011","North Somerset 012A","E01014855","Total",581,118,64,54,463,9,130,81,122,9,26,86
"2011","North Somerset 012B","E01014856","Total",590,121,60,61,469,27,91,97,112,19,36,87
"2011","North Somerset 012C","E01014857","Total",616,134,71,63,482,24,121,99,113,19,35,71
"2011","North Somerset 012D","E01014858","Total",714,183,42,141,531,29,79,105,187,19,39,73
"2011","North Somerset 012E","E01014859","Total",636,178,90,88,458,25,108,94,103,17,34,77
"2011","North Somerset 012F","E01014860","Total",624,185,93,92,439,28,89,77,102,17,30,96
"2011","North Somerset 013A","E01014847","Total",681,155,77,78,526,19,119,103,136,22,36,91
"2011","North Somerset 013B","E01014848","Total",522,131,58,73,391,12,95,66,96,10,30,82
"2011","North Somerset 013C","E01014853","Total",739,248,143,105,491,24,133,104,108,22,28,72
"2011","North Somerset 013D","E01014854","Total",549,115,59,56,434,7,137,65,98,19,32,76
"2011","North Somerset 014A","E01014764","Total",687,192,111,81,495,27,131,86,122,16,25,88
"2011","North Somerset 014B","E01014765","Total",735,154,80,74,581,28,154,92,147,24,37,99
"2011","North Somerset 014C","E01014773","Total",640,124,34,90,516,25,64,132,149,16,52,78
"2011","North Somerset 014D","E01014774","Total",694,191,100,91,503,20,128,60,160,16,32,87
"2011","North Somerset 015A","E01014821","Total",500,128,42,86,372,41,36,97,104,11,21,62
"2011","North Somerset 015B","E01014822","Total",542,75,26,49,467,23,74,129,122,15,34,70
"2011","North Somerset 015C","E01014823","Total",504,104,60,44,400,25,58,80,109,12,30,86
"2011","North Somerset 015D","E01014824","Total",644,182,90,92,462,25,102,85,144,15,20,71
"2011","North Somerset 015E","E01014825","Total",487,98,54,44,389,20,93,62,102,19,27,66
"2011","North Somerset 015F","E01014826","Total",630,171,56,115,459,52,43,129,112,14,37,72
"2011","North Somerset 015G","E01014827","Total",598,201,72,129,397,51,47,95,108,10,31,55
"2011","North Somerset 016A","E01014817","Total",695,199,107,92,496,26,174,88,122,10,27,49
"2011","North Somerset 016B","E01014820","Total",719,309,228,81,410,24,145,53,95,13,16,64
"2011","North Somerset 016C","E01014835","Total",650,251,160,91,399,39,85,67,91,20,31,66
"2011","North Somerset 016D","E01014836","Total",644,203,122,81,441,34,115,75,97,17,26,77
"2011","North Somerset 016E","E01014838","Total",594,154,96,58,440,41,114,62,103,18,39,63
"2011","North Somerset 016F","E01014840","Total",615,177,95,82,438,49,122,68,107,13,25,54
"2011","North Somerset 017A","E01014812","Total",675,219,133,86,456,24,145,69,128,11,26,53
"2011","North Somerset 017B","E01014813","Total",734,208,98,110,526,42,125,100,113,19,44,83
"2011","North Somerset 017C","E01014815","Total",587,187,78,109,400,36,77,77,104,16,29,61
"2011","North Somerset 017D","E01014816","Total",648,171,108,63,477,5,163,70,126,16,29,68
"2011","North Somerset 017E","E01014818","Total",750,189,121,68,561,10,178,84,156,16,28,89
"2011","North Somerset 017F","E01014819","Total",732,235,138,97,497,21,175,61,137,20,22,61
"2011","North Somerset 018A","E01014841","Total",978,534,147,387,444,28,102,38,210,5,9,52
"2011","North Somerset 018B","E01014842","Total",822,443,134,309,379,36,100,56,139,2,9,37
"2011","North Somerset 018C","E01014843","Total",670,297,110,187,373,23,109,44,124,8,8,57
"2011","North Somerset 018D","E01014844","Total",769,488,147,341,281,20,59,45,120,4,9,24
"2011","North Somerset 018E","E01014845","Total",577,196,106,90,381,11,127,60,103,7,19,54
"2011","North Somerset 018F","E01014846","Total",637,210,98,112,427,27,112,59,125,3,33,68
"2011","North Somerset 020A","E01014799","Total",801,405,91,314,396,50,62,75,123,8,28,50
"2011","North Somerset 020B","E01014800","Total",799,419,86,333,380,64,37,76,109,11,29,54
"2011","North Somerset 020C","E01014801","Total",793,471,210,261,322,23,114,36,72,8,18,51
"2011","North Somerset 020D","E01014802","Total",758,423,138,285,335,35,59,42,111,8,19,61
"2011","North Somerset 020E","E01014809","Total",772,290,75,215,482,54,93,98,125,19,36,57
"2011","North Somerset 020F","E01014811","Total",742,297,134,163,445,36,94,83,117,12,33,70
"2011","North Somerset 021A","E01014829","Total",793,265,102,163,528,75,70,99,155,18,39,72
"2011","North Somerset 021B","E01014830","Total",657,227,55,172,430,45,52,88,100,22,38,85
"2011","North Somerset 021C","E01014831","Total",582,228,61,167,354,81,32,75,72,17,24,53
"2011","North Somerset 021D","E01014832","Total",630,241,115,126,389,55,73,64,79,20,27,71
"2011","North Somerset 021E","E01014833","Total",645,225,85,140,420,74,66,85,88,18,25,64
"2011","North Somerset 022A","E01014804","Total",624,251,138,113,373,12,127,56,98,6,23,51
"2011","North Somerset 022B","E01014806","Total",780,429,185,244,351,38,98,54,92,10,20,39
"2011","North Somerset 022C","E01014807","Total",818,393,104,289,425,38,55,77,142,10,32,71
"2011","North Somerset 022D","E01014808","Total",588,147,73,74,441,27,108,86,95,13,30,82
"2011","North Somerset 023A","E01014744","Total",606,163,100,63,443,14,151,62,121,13,20,62
"2011","North Somerset 023B","E01014746","Total",597,159,92,67,438,39,113,68,107,22,27,62
"2011","North Somerset 023C","E01014769","Total",943,207,99,108,736,55,150,187,189,33,33,89
"2011","North Somerset 023D","E01014770","Total",632,159,110,49,473,10,189,47,135,12,14,66
"2011","North Somerset 023E","E01014771","Total",637,186,127,59,451,15,165,55,106,13,20,77
"2011","North Somerset 023F","E01014772","Total",614,168,104,64,446,10,161,62,127,6,22,58
"2011","North Somerset 024A","E01014741","Total",646,237,152,85,409,19,118,62,101,19,30,60
"2011","North Somerset 024B","E01014742","Total",613,153,108,45,460,6,159,68,108,14,31,74
"2011","North Somerset 024C","E01014745","Total",657,195,140,55,462,15,149,66,119,10,23,80
"2011","North Somerset 024D","E01014747","Total",587,153,85,68,434,11,121,75,125,16,25,61
"2011","North Somerset 024E","E01014748","Total",441,98,62,36,343,12,96,52,88,14,25,56
"2011","North Somerset 024F","E01014749","Total",507,77,41,36,430,21,91,81,119,17,27,74
"2011","North Somerset 025A","E01014803","Total",644,206,109,97,438,15,146,63,90,17,32,75
"2011","North Somerset 025B","E01014805","Total",688,176,125,51,512,5,254,47,118,7,18,63
"2011","North Somerset 025C","E01014828","Total",579,154,74,80,425,68,80,81,75,25,31,65
"2011","North Somerset 025D","E01014834","Total",621,202,103,99,419,68,88,65,92,18,20,68
"2011","North Somerset 026A","E01014839","Total",631,142,57,85,489,56,65,105,137,24,38,64
"2011","North Somerset 026B","E01032666","Total",482,110,50,60,372,19,82,67,107,10,29,58
"2011","North Somerset 026C","E01032667","Total",429,87,22,65,342,38,45,94,102,14,20,29
"2011","North Somerset 026D","E01032668","Total",602,155,11,144,447,61,25,140,130,25,25,41
"2011","North Somerset 026E","E01032672","Total",586,167,48,119,419,31,43,123,157,16,22,27
"2011","North Somerset 026F","E01032673","Total",622,255,117,138,367,40,83,66,113,12,16,37
"2011","North Somerset 027A","E01014810","Total",693,303,87,216,390,63,66,80,122,7,12,40
"2011","North Somerset 027B","E01032669","Total",561,94,6,88,467,66,18,143,162,29,21,28
"2011","North Somerset 027C","E01032670","Total",586,106,10,96,480,84,14,139,121,31,38,53
"2011","North Somerset 027D","E01032671","Total",496,90,8,82,406,55,24,152,84,26,33,32
"2011","North Somerset 027E","E01032679","Total",551,141,17,124,410,63,41,107,129,15,17,38
"2011","Plymouth 001A","E01015025","Total",655,149,99,50,506,11,174,61,132,9,28,91
"2011","Plymouth 001B","E01015097","Total",830,263,177,86,567,5,262,41,146,5,21,87
"2011","Plymouth 001C","E01015160","Total",624,127,80,47,497,18,154,82,129,12,28,74
"2011","Plymouth 001D","E01015164","Total",734,114,54,60,620,37,72,185,177,31,41,77
"2011","Plymouth 002A","E01015027","Total",647,133,58,75,514,16,96,102,153,23,33,91
"2011","Plymouth 002B","E01015159","Total",767,264,140,124,503,51,155,72,115,15,23,72
"2011","Plymouth 002C","E01015161","Total",640,172,88,84,468,50,125,72,94,18,30,79
"2011","Plymouth 002D","E01015162","Total",633,187,102,85,446,32,105,76,111,14,34,74
"2011","Plymouth 002E","E01015166","Total",821,249,92,157,572,84,92,110,167,23,28,68
"2011","Plymouth 003A","E01015023","Total",686,206,93,113,480,40,96,83,112,20,37,92
"2011","Plymouth 003B","E01015026","Total",769,312,95,217,457,66,68,102,122,20,12,67
"2011","Plymouth 003C","E01015028","Total",642,202,87,115,440,74,71,96,109,13,28,49
"2011","Plymouth 003D","E01015163","Total",593,140,77,63,453,41,125,72,99,13,28,75
"2011","Plymouth 003E","E01015165","Total",643,125,47,78,518,46,69,151,136,20,32,64
"2011","Plymouth 004A","E01015024","Total",648,178,51,127,470,33,70,90,177,11,19,70
"2011","Plymouth 004B","E01015082","Total",693,198,85,113,495,61,85,88,117,21,36,87
"2011","Plymouth 004C","E01015083","Total",687,279,82,197,408,37,83,65,110,12,35,66
"2011","Plymouth 004D","E01015084","Total",620,162,82,80,458,34,106,51,134,23,36,74
"2011","Plymouth 005A","E01015090","Total",567,108,36,72,459,26,89,68,145,12,17,102
"2011","Plymouth 005B","E01015091","Total",629,121,68,53,508,19,103,76,165,9,35,101
"2011","Plymouth 005C","E01015092","Total",483,167,48,119,316,26,52,47,93,15,23,60
"2011","Plymouth 005D","E01015093","Total",634,209,103,106,425,30,63,77,143,11,20,81
"2011","Plymouth 005E","E01015094","Total",596,170,106,64,426,40,68,79,114,14,39,72
"2011","Plymouth 006A","E01015085","Total",716,209,115,94,507,34,137,81,131,21,27,76
"2011","Plymouth 006B","E01015087","Total",560,115,58,57,445,43,64,83,86,31,61,77
"2011","Plymouth 006C","E01015088","Total",620,178,76,102,442,82,46,93,96,38,35,52
"2011","Plymouth 006D","E01015147","Total",503,117,69,48,386,24,97,47,96,10,31,81
"2011","Plymouth 006E","E01015148","Total",661,218,91,127,443,39,60,103,133,18,29,61
"2011","Plymouth 007A","E01015030","Total",757,328,115,213,429,62,76,68,122,18,27,56
"2011","Plymouth 007B","E01015070","Total",1078,311,106,205,767,62,105,182,226,26,39,127
"2011","Plymouth 007C","E01015081","Total",626,159,79,80,467,50,80,81,107,24,34,91
"2011","Plymouth 007D","E01015086","Total",621,211,120,91,410,43,96,61,109,12,24,65
"2011","Plymouth 007E","E01015089","Total",741,233,95,138,508,41,121,100,144,10,28,64
"2011","Plymouth 008A","E01015029","Total",716,129,57,72,587,75,79,145,144,37,44,63
"2011","Plymouth 008B","E01015064","Total",713,184,133,51,529,8,171,75,138,18,31,88
"2011","Plymouth 008C","E01015065","Total",635,211,156,55,424,16,100,101,100,22,29,56
"2011","Plymouth 008D","E01015071","Total",696,239,134,105,457,25,106,93,116,13,30,74
"2011","Plymouth 009A","E01015076","Total",628,165,74,91,463,29,80,89,150,11,27,77
"2011","Plymouth 009B","E01015142","Total",602,190,64,126,412,27,78,76,135,6,22,68
"2011","Plymouth 009C","E01015143","Total",612,178,80,98,434,32,101,76,121,11,19,74
"2011","Plymouth 009D","E01015144","Total",613,166,62,104,447,52,64,83,111,27,40,70
"2011","Plymouth 009E","E01015146","Total",676,158,36,122,518,85,43,110,130,43,33,74
"2011","Plymouth 009F","E01015149","Total",623,199,107,92,424,48,69,69,106,20,40,72
"2011","Plymouth 009G","E01015150","Total",638,225,119,106,413,14,120,65,104,11,28,71
"2011","Plymouth 010A","E01015063","Total",634,184,77,107,450,40,73,89,136,12,24,76
"2011","Plymouth 010B","E01015068","Total",628,116,63,53,512,30,94,113,136,25,36,78
"2011","Plymouth 010C","E01015069","Total",674,179,97,82,495,43,89,98,137,25,32,71
"2011","Plymouth 010D","E01015095","Total",645,202,102,100,443,24,117,76,123,11,20,72
"2011","Plymouth 010E","E01015096","Total",612,167,94,73,445,39,93,72,118,14,33,76
"2011","Plymouth 011A","E01015074","Total",667,224,114,110,443,51,88,64,121,18,38,63
"2011","Plymouth 011B","E01015077","Total",748,227,115,112,521,45,117,93,140,11,32,83
"2011","Plymouth 011C","E01015079","Total",628,170,97,73,458,30,112,72,116,17,32,79
"2011","Plymouth 011D","E01015102","Total",763,260,78,182,503,42,69,96,175,16,35,70
"2011","Plymouth 011E","E01015104","Total",592,114,67,47,478,22,88,108,112,22,35,91
"2011","Plymouth 012A","E01015035","Total",634,141,70,71,493,25,104,98,136,13,39,78
"2011","Plymouth 012B","E01015037","Total",601,188,106,82,413,36,104,71,98,13,25,66
"2011","Plymouth 012C","E01015058","Total",559,133,56,77,426,67,50,78,91,34,40,66
"2011","Plymouth 012D","E01015066","Total",605,122,57,65,483,29,91,89,138,16,31,89
"2011","Plymouth 012E","E01015067","Total",613,113,83,30,500,16,170,52,106,13,40,103
"2011","Plymouth 013A","E01015072","Total",607,137,70,67,470,38,75,68,116,28,50,95
"2011","Plymouth 013B","E01015073","Total",642,207,96,111,435,49,69,50,127,19,27,94
"2011","Plymouth 013C","E01015078","Total",484,144,83,61,340,31,52,49,67,30,34,77
"2011","Plymouth 013D","E01015080","Total",471,97,32,65,374,68,36,70,49,46,39,66
"2011","Plymouth 013E","E01015106","Total",531,129,71,58,402,29,68,60,137,13,20,75
"2011","Plymouth 014A","E01015039","Total",461,134,55,79,327,36,40,60,108,17,20,46
"2011","Plymouth 014B","E01015040","Total",589,160,49,111,429,44,54,78,98,21,48,86
"2011","Plymouth 014C","E01015041","Total",642,185,46,139,457,48,51,106,170,10,22,50
"2011","Plymouth 014D","E01015075","Total",648,214,107,107,434,57,80,75,119,19,28,56
"2011","Plymouth 014E","E01015145","Total",668,110,15,95,558,156,14,191,101,26,34,36
"2011","Plymouth 015A","E01015120","Total",608,127,78,49,481,28,104,91,124,18,33,83
"2011","Plymouth 015B","E01015121","Total",645,156,107,49,489,22,163,81,100,19,31,73
"2011","Plymouth 015C","E01015123","Total",721,240,137,103,481,27,159,84,116,10,25,60
"2011","Plymouth 015D","E01015124","Total",692,189,124,65,503,18,144,105,119,11,27,79
"2011","Plymouth 015E","E01015125","Total",620,119,62,57,501,21,119,94,119,15,33,100
"2011","Plymouth 016A","E01015033","Total",626,147,83,64,479,9,116,80,114,25,40,95
"2011","Plymouth 016B","E01015034","Total",516,117,49,68,399,8,89,78,103,19,34,68
"2011","Plymouth 016C","E01015036","Total",655,236,127,109,419,17,85,102,110,24,24,57
"2011","Plymouth 016D","E01015038","Total",712,169,69,100,543,30,91,100,177,15,40,90
"2011","Plymouth 016E","E01015101","Total",616,129,102,27,487,10,120,105,126,21,29,76
"2011","Plymouth 017A","E01015098","Total",647,194,89,105,453,25,52,102,149,22,34,69
"2011","Plymouth 017B","E01015099","Total",634,178,57,121,456,23,62,106,159,12,26,68
"2011","Plymouth 017C","E01015100","Total",612,181,49,132,431,28,50,92,129,11,30,91
"2011","Plymouth 017D","E01015103","Total",624,189,66,123,435,26,60,104,129,14,28,74
"2011","Plymouth 017E","E01015105","Total",621,153,69,84,468,19,63,107,167,16,30,66
"2011","Plymouth 018A","E01015107","Total",593,110,32,78,483,34,54,119,141,20,38,77
"2011","Plymouth 018B","E01015110","Total",609,81,26,55,528,21,97,85,168,20,34,103
"2011","Plymouth 018C","E01015111","Total",703,165,34,131,538,47,47,146,203,10,25,60
"2011","Plymouth 018D","E01015119","Total",639,86,30,56,553,32,71,131,163,23,40,93
"2011","Plymouth 019A","E01015112","Total",559,120,57,63,439,26,70,95,125,24,31,68
"2011","Plymouth 019B","E01015113","Total",627,142,83,59,485,20,128,99,125,13,29,71
"2011","Plymouth 019C","E01015114","Total",622,180,80,100,442,16,87,85,128,13,33,80
"2011","Plymouth 019D","E01015118","Total",676,166,95,71,510,20,118,142,107,14,30,79
"2011","Plymouth 019E","E01015122","Total",642,155,107,48,487,24,135,100,90,13,38,87
"2011","Plymouth 020A","E01015042","Total",650,219,49,170,431,43,45,92,144,14,30,63
"2011","Plymouth 020B","E01015044","Total",734,342,67,275,392,30,45,66,160,3,21,67
"2011","Plymouth 020C","E01015167","Total",683,191,41,150,492,43,50,101,178,14,26,80
"2011","Plymouth 020D","E01015168","Total",814,277,53,224,537,44,59,92,196,11,34,101
"2011","Plymouth 020E","E01015171","Total",809,354,80,274,455,36,44,82,189,10,22,72
"2011","Plymouth 021A","E01015055","Total",603,192,75,117,411,35,66,75,99,17,34,85
"2011","Plymouth 021B","E01015056","Total",746,275,100,175,471,27,94,75,164,12,17,82
"2011","Plymouth 021C","E01015057","Total",657,235,106,129,422,61,52,74,108,23,28,76
"2011","Plymouth 021D","E01015059","Total",639,161,45,116,478,41,63,88,154,19,38,75
"2011","Plymouth 021E","E01015060","Total",644,177,63,114,467,42,86,78,117,31,42,71
"2011","Plymouth 021F","E01015176","Total",588,162,74,88,426,17,70,68,116,17,36,102
"2011","Plymouth 022A","E01015108","Total",762,154,70,84,608,38,91,177,167,33,36,66
"2011","Plymouth 022B","E01015109","Total",641,195,57,138,446,36,53,75,154,7,33,88
"2011","Plymouth 022C","E01015115","Total",697,337,234,103,360,22,102,54,82,6,31,63
"2011","Plymouth 022D","E01015116","Total",603,119,72,47,484,24,104,104,123,6,33,90
"2011","Plymouth 022E","E01015117","Total",592,114,45,69,478,25,92,92,140,10,28,91
"2011","Plymouth 023A","E01015031","Total",673,227,34,193,446,16,50,55,185,12,19,109
"2011","Plymouth 023B","E01015032","Total",804,354,81,273,450,20,15,51,174,2,15,173
"2011","Plymouth 023C","E01015049","Total",594,196,45,151,398,13,37,43,126,8,11,160
"2011","Plymouth 023D","E01015050","Total",665,238,26,212,427,9,8,25,207,4,11,163
"2011","Plymouth 023E","E01015051","Total",521,127,35,92,394,10,49,28,117,5,12,173
"2011","Plymouth 024A","E01015169","Total",860,392,75,317,468,20,58,59,139,11,37,144
"2011","Plymouth 024B","E01015170","Total",748,268,99,169,480,46,63,100,173,8,26,64
"2011","Plymouth 024C","E01015173","Total",760,254,73,181,506,32,80,85,180,17,26,86
"2011","Plymouth 024D","E01015174","Total",681,172,75,97,509,23,103,92,158,21,26,86
"2011","Plymouth 025A","E01015061","Total",614,194,55,139,420,44,35,76,137,15,20,93
"2011","Plymouth 025B","E01015062","Total",711,208,38,170,503,21,36,41,151,10,18,226
"2011","Plymouth 025C","E01015175","Total",660,202,58,144,458,24,44,71,142,17,26,134
"2011","Plymouth 025D","E01015177","Total",727,199,51,148,528,30,72,82,168,11,40,125
"2011","Plymouth 025E","E01015178","Total",810,267,64,203,543,24,36,65,185,12,19,202
"2011","Plymouth 026A","E01015043","Total",675,236,54,182,439,83,36,88,121,17,28,66
"2011","Plymouth 026B","E01015045","Total",748,331,60,271,417,87,31,90,147,6,16,40
"2011","Plymouth 026C","E01015046","Total",931,448,152,296,483,65,59,96,111,42,45,65
"2011","Plymouth 026D","E01015047","Total",633,214,56,158,419,81,34,86,100,23,32,63
"2011","Plymouth 026E","E01015048","Total",592,298,56,242,294,58,25,57,82,17,20,35
"2011","Plymouth 027A","E01015053","Total",581,245,40,205,336,20,24,30,121,6,11,124
"2011","Plymouth 027B","E01015054","Total",528,189,49,140,339,10,17,20,114,6,8,164
"2011","Plymouth 027C","E01015152","Total",947,473,113,360,474,89,61,89,119,18,11,87
"2011","Plymouth 027E","E01015156","Total",758,453,130,323,305,19,58,34,154,1,8,31
"2011","Plymouth 027F","E01032657","Total",754,368,96,272,386,16,60,25,198,4,9,74
"2011","Plymouth 027G","E01032658","Total",808,494,144,350,314,31,30,26,184,6,8,29
"2011","Plymouth 028A","E01015052","Total",806,349,64,285,457,23,24,56,160,4,14,176
"2011","Plymouth 028B","E01015179","Total",659,224,57,167,435,30,37,53,158,10,14,133
"2011","Plymouth 028C","E01015180","Total",871,382,128,254,489,61,52,80,174,22,22,78
"2011","Plymouth 028D","E01015181","Total",985,435,78,357,550,49,48,82,214,12,27,118
"2011","Plymouth 028E","E01015182","Total",837,307,94,213,530,48,63,96,186,20,41,76
"2011","Plymouth 029A","E01015151","Total",914,436,81,355,478,45,38,68,161,17,14,135
"2011","Plymouth 029B","E01015153","Total",903,465,123,342,438,61,51,96,140,13,23,54
"2011","Plymouth 029C","E01015155","Total",934,509,118,391,425,67,46,90,130,20,20,52
"2011","Plymouth 029D","E01015157","Total",1193,649,133,516,544,37,66,78,277,6,20,60
"2011","Plymouth 029E","E01015158","Total",1334,766,220,546,568,34,116,45,304,8,8,53
"2011","Plymouth 029F","E01015172","Total",822,310,63,247,512,30,52,91,202,8,37,92
"2011","Plymouth 030A","E01015126","Total",637,159,126,33,478,14,203,75,101,10,15,60
"2011","Plymouth 030B","E01015127","Total",616,151,73,78,465,26,113,84,123,7,21,91
"2011","Plymouth 030C","E01015131","Total",643,142,100,42,501,9,190,71,123,5,25,78
"2011","Plymouth 030D","E01015132","Total",668,207,150,57,461,14,127,86,115,18,27,74
"2011","Plymouth 030E","E01015133","Total",649,140,100,40,509,16,175,65,109,15,28,101
"2011","Plymouth 031A","E01015135","Total",630,156,91,65,474,22,104,80,118,14,46,90
"2011","Plymouth 031B","E01015136","Total",628,179,115,64,449,27,104,77,93,19,36,93
"2011","Plymouth 031C","E01015137","Total",655,169,80,89,486,25,97,109,141,17,31,66
"2011","Plymouth 031D","E01015138","Total",699,233,95,138,466,11,132,86,124,12,25,76
"2011","Plymouth 031E","E01015139","Total",613,154,79,75,459,42,111,72,126,13,27,68
"2011","Plymouth 031F","E01015141","Total",746,157,102,55,589,16,173,98,138,33,36,95
"2011","Plymouth 032A","E01015128","Total",758,229,142,87,529,18,166,75,146,17,27,80
"2011","Plymouth 032B","E01015129","Total",674,229,63,166,445,63,41,113,136,13,22,57
"2011","Plymouth 032C","E01015130","Total",616,98,50,48,518,22,62,152,118,26,49,89
"2011","Plymouth 032D","E01015134","Total",678,227,150,77,451,26,114,93,99,25,23,71
"2011","Plymouth 032E","E01015140","Total",653,160,130,30,493,9,159,110,127,17,27,44
"2011","Poole 001A","E01015431","Total",441,77,39,38,364,13,89,65,94,8,20,75
"2011","Poole 001B","E01015432","Total",745,235,151,84,510,24,151,94,123,11,26,81
"2011","Poole 001C","E01015433","Total",603,108,65,43,495,5,165,68,114,13,33,97
"2011","Poole 001D","E01015434","Total",651,143,119,24,508,12,163,79,108,12,36,98
"2011","Poole 002A","E01015379","Total",480,88,45,43,392,25,60,71,88,26,53,69
"2011","Poole 002B","E01015435","Total",659,186,32,154,473,38,51,122,172,14,22,54
"2011","Poole 002C","E01015436","Total",532,117,60,57,415,15,90,76,104,15,25,90
"2011","Poole 002D","E01015437","Total",505,80,35,45,425,6,106,57,114,10,35,97
"2011","Poole 003A","E01015395","Total",625,221,166,55,404,14,145,55,90,10,28,62
"2011","Poole 003B","E01015396","Total",643,145,106,39,498,12,171,75,106,12,34,88
"2011","Poole 003C","E01015397","Total",528,69,33,36,459,11,81,113,95,20,52,87
"2011","Poole 003D","E01015398","Total",508,61,34,27,447,13,103,93,104,17,31,86
"2011","Poole 003E","E01015399","Total",628,187,145,42,441,7,143,66,90,10,45,80
"2011","Poole 003F","E01015400","Total",621,127,97,30,494,9,168,100,90,12,31,84
"2011","Poole 003G","E01015401","Total",644,161,121,40,483,12,169,85,89,8,37,83
"2011","Poole 004A","E01015412","Total",486,64,26,38,422,7,89,76,94,13,32,111
"2011","Poole 004B","E01015413","Total",635,194,85,109,441,35,63,104,133,15,22,69
"2011","Poole 004C","E01015414","Total",625,148,62,86,477,38,85,81,143,11,22,97
"2011","Poole 004D","E01015415","Total",541,184,54,130,357,46,23,73,108,20,19,68
"2011","Poole 004E","E01015416","Total",522,119,67,52,403,12,81,96,110,16,40,48
"2011","Poole 005A","E01015407","Total",622,146,74,72,476,24,132,80,110,9,27,94
"2011","Poole 005B","E01015408","Total",503,92,61,31,411,19,90,85,74,19,37,87
"2011","Poole 005C","E01015409","Total",589,172,59,113,417,50,31,96,101,28,40,71
"2011","Poole 005D","E01015410","Total",655,204,29,175,451,35,36,104,159,13,29,75
"2011","Poole 005E","E01015411","Total",529,103,41,62,426,28,71,90,100,11,30,96
"2011","Poole 006A","E01015417","Total",621,166,99,67,455,25,98,77,129,19,29,78
"2011","Poole 006B","E01015418","Total",694,239,101,138,455,23,83,103,146,14,28,58
"2011","Poole 006C","E01015419","Total",782,221,106,115,561,31,147,117,144,16,22,84
"2011","Poole 006D","E01015420","Total",646,161,109,52,485,36,107,103,117,19,31,72
"2011","Poole 006E","E01015421","Total",629,174,124,50,455,18,157,50,110,14,29,77
"2011","Poole 006F","E01015422","Total",614,159,34,125,455,29,39,122,162,12,19,72
"2011","Poole 007A","E01015380","Total",753,201,131,70,552,23,174,59,138,10,37,111
"2011","Poole 007B","E01015381","Total",652,154,78,76,498,40,115,82,112,23,36,90
"2011","Poole 007C","E01015382","Total",768,196,51,145,572,67,46,126,200,26,35,72
"2011","Poole 007D","E01015383","Total",685,212,127,85,473,16,162,52,142,6,10,85
"2011","Poole 007E","E01015384","Total",493,61,28,33,432,58,40,63,61,41,68,101
"2011","Poole 007F","E01015385","Total",788,283,169,114,505,44,130,68,113,22,39,89
"2011","Poole 008A","E01015438","Total",622,140,68,72,482,21,96,87,135,14,35,94
"2011","Poole 008B","E01015439","Total",755,260,119,141,495,26,65,103,151,15,41,94
"2011","Poole 008C","E01015441","Total",836,314,143,171,522,37,74,99,148,17,38,109
"2011","Poole 008D","E01015442","Total",799,260,154,106,539,46,99,121,103,25,47,98
"2011","Poole 008E","E01015443","Total",759,222,106,116,537,47,111,87,138,21,40,93
"2011","Poole 008F","E01015444","Total",687,162,72,90,525,30,87,105,132,25,41,105
"2011","Poole 009A","E01015386","Total",843,387,164,223,456,43,59,71,179,16,20,68
"2011","Poole 009B","E01015387","Total",666,194,105,89,472,26,105,88,148,7,22,76
"2011","Poole 009C","E01015388","Total",487,89,32,57,398,15,86,82,82,11,22,100
"2011","Poole 009D","E01015389","Total",675,208,79,129,467,13,87,86,191,10,20,60
"2011","Poole 010A","E01015390","Total",753,269,95,174,484,46,57,102,144,16,31,88
"2011","Poole 010B","E01015391","Total",619,153,73,80,466,15,97,73,151,17,32,81
"2011","Poole 010C","E01015392","Total",647,210,110,100,437,29,68,94,141,6,19,80
"2011","Poole 010D","E01015393","Total",520,135,37,98,385,27,48,81,126,23,20,60
"2011","Poole 010E","E01015394","Total",634,139,61,78,495,34,78,109,135,9,39,91
"2011","Poole 011A","E01015440","Total",842,235,105,130,607,47,119,100,182,17,42,100
"2011","Poole 011B","E01015447","Total",647,141,75,66,506,16,141,87,112,19,27,104
"2011","Poole 011C","E01015449","Total",707,216,105,111,491,47,78,85,117,15,58,91
"2011","Poole 011D","E01015456","Total",780,272,136,136,508,33,92,87,149,17,35,95
"2011","Poole 011E","E01015457","Total",805,322,159,163,483,20,148,73,149,14,20,59
"2011","Poole 012A","E01015445","Total",779,192,105,87,587,16,138,107,142,23,52,109
"2011","Poole 012B","E01015446","Total",646,203,125,78,443,18,90,85,84,17,55,94
"2011","Poole 012C","E01015448","Total",627,162,81,81,465,23,105,86,121,20,33,77
"2011","Poole 012D","E01015450","Total",669,148,81,67,521,28,101,101,113,18,40,120
"2011","Poole 012E","E01015451","Total",633,162,111,51,471,13,139,73,120,14,30,82
"2011","Poole 013A","E01015458","Total",651,167,104,63,484,12,171,92,119,16,19,55
"2011","Poole 013B","E01015460","Total",720,215,82,133,505,45,57,129,149,18,30,77
"2011","Poole 013C","E01015461","Total",642,206,70,136,436,29,48,111,123,17,38,70
"2011","Poole 013D","E01015462","Total",682,218,44,174,464,21,50,114,152,21,26,80
"2011","Poole 013E","E01015463","Total",733,279,110,169,454,14,83,104,162,14,23,54
"2011","Poole 013F","E01015464","Total",649,137,67,70,512,17,110,125,157,12,25,66
"2011","Poole 014A","E01015427","Total",647,174,35,139,473,33,42,135,137,29,38,59
"2011","Poole 014B","E01015428","Total",965,260,137,123,705,43,203,119,183,19,39,99
"2011","Poole 014C","E01015429","Total",675,178,93,85,497,42,90,96,114,23,43,89
"2011","Poole 014D","E01015430","Total",574,134,36,98,440,53,64,77,93,28,46,79
"2011","Poole 015A","E01015465","Total",770,260,86,174,510,35,66,104,163,13,33,96
"2011","Poole 015B","E01015466","Total",734,236,127,109,498,21,121,91,126,13,23,103
"2011","Poole 015D","E01015468","Total",933,426,259,167,507,42,117,98,160,11,23,56
"2011","Poole 015F","E01032659","Total",619,292,92,200,327,23,46,63,147,3,8,37
"2011","Poole 015G","E01032660","Total",657,218,47,171,439,39,44,93,188,9,19,47
"2011","Poole 015H","E01032661","Total",679,286,105,181,393,14,94,65,138,10,15,57
"2011","Poole 015I","E01032662","Total",633,329,157,172,304,28,75,45,104,7,9,36
"2011","Poole 016A","E01015423","Total",975,364,137,227,611,55,112,96,216,15,27,90
"2011","Poole 016B","E01015424","Total",610,181,78,103,429,37,85,72,129,11,23,72
"2011","Poole 016C","E01015425","Total",551,128,77,51,423,28,104,57,114,12,26,82
"2011","Poole 016D","E01015426","Total",550,149,74,75,401,28,78,59,112,21,24,79
"2011","Poole 017A","E01015452","Total",826,295,214,81,531,19,176,115,110,19,20,72
"2011","Poole 017B","E01015453","Total",980,433,161,272,547,48,87,108,232,10,16,46
"2011","Poole 017C","E01015454","Total",874,365,143,222,509,34,88,115,159,17,22,74
"2011","Poole 017D","E01015455","Total",906,319,204,115,587,34,188,112,146,11,27,69
"2011","Poole 017E","E01015459","Total",800,241,152,89,559,16,210,96,137,22,22,56
"2011","Poole 018A","E01015402","Total",795,320,177,143,475,18,156,59,149,17,13,63
"2011","Poole 018B","E01015403","Total",1095,579,399,180,516,15,304,25,135,3,2,32
"2011","Poole 018C","E01015404","Total",855,313,189,124,542,15,254,61,131,8,15,58
"2011","Poole 018D","E01015405","Total",766,197,93,104,569,5,207,82,180,9,21,65
"2011","Poole 018E","E01015406","Total",902,382,182,200,520,31,185,59,153,17,12,63
"2011","South Gloucestershire 001A","E01014985","Total",641,213,84,129,428,19,89,73,141,10,29,67
"2011","South Gloucestershire 001B","E01014986","Total",663,207,130,77,456,42,128,65,93,17,36,75
"2011","South Gloucestershire 001C","E01014987","Total",514,113,52,61,401,15,109,71,103,17,21,65
"2011","South Gloucestershire 001D","E01014988","Total",543,114,75,39,429,12,119,90,93,16,26,73
"2011","South Gloucestershire 001E","E01014989","Total",441,115,39,76,326,3,87,49,80,8,35,64
"2011","South Gloucestershire 002A","E01014990","Total",640,158,102,56,482,15,149,72,110,10,25,101
"2011","South Gloucestershire 002B","E01014991","Total",983,368,191,177,615,67,126,122,136,32,41,91
"2011","South Gloucestershire 002C","E01014992","Total",582,106,48,58,476,18,109,90,114,17,31,97
"2011","South Gloucestershire 002D","E01014993","Total",551,98,44,54,453,13,105,85,105,19,41,85
"2011","South Gloucestershire 003A","E01014884","Total",589,124,53,71,465,26,71,98,117,27,47,79
"2011","South Gloucestershire 003B","E01014885","Total",717,117,51,66,600,24,138,139,143,20,46,90
"2011","South Gloucestershire 003C","E01014929","Total",786,157,72,85,629,35,147,111,152,24,41,119
"2011","South Gloucestershire 003D","E01014930","Total",709,128,56,72,581,38,83,137,137,26,58,102
"2011","South Gloucestershire 004A","E01014863","Total",660,180,132,48,480,16,182,76,90,10,28,78
"2011","South Gloucestershire 004B","E01014864","Total",632,149,91,58,483,5,170,64,123,10,23,88
"2011","South Gloucestershire 004C","E01014962","Total",666,112,55,57,554,12,152,76,139,23,44,108
"2011","South Gloucestershire 004D","E01014963","Total",768,194,113,81,574,20,148,113,129,21,43,100
"2011","South Gloucestershire 005A","E01014861","Total",747,163,85,78,584,30,127,100,145,19,43,120
"2011","South Gloucestershire 005B","E01014862","Total",1065,179,99,80,886,67,173,193,230,36,49,138
"2011","South Gloucestershire 005C","E01014953","Total",807,172,78,94,635,35,124,132,145,39,49,111
"2011","South Gloucestershire 005D","E01014954","Total",700,215,76,139,485,36,98,96,153,13,21,68
"2011","South Gloucestershire 006A","E01015014","Total",537,81,28,53,456,11,74,112,116,18,31,94
"2011","South Gloucestershire 006B","E01015015","Total",575,158,17,141,417,29,25,93,141,12,40,77
"2011","South Gloucestershire 006C","E01015016","Total",455,61,35,26,394,7,102,75,87,11,35,77
"2011","South Gloucestershire 006D","E01015017","Total",585,175,97,78,410,19,88,65,112,14,36,76
"2011","South Gloucestershire 006E","E01015018","Total",571,108,58,50,463,21,100,84,103,19,44,92
"2011","South Gloucestershire 007A","E01015019","Total",758,225,66,159,533,65,61,99,159,17,43,89
"2011","South Gloucestershire 007B","E01015020","Total",650,215,62,153,435,52,67,81,99,32,38,66
"2011","South Gloucestershire 007C","E01015021","Total",636,142,65,77,494,14,93,109,138,12,36,92
"2011","South Gloucestershire 007D","E01015022","Total",675,207,47,160,468,32,67,101,146,12,33,77
"2011","South Gloucestershire 008A","E01014886","Total",836,301,168,133,535,32,162,80,117,24,32,88
"2011","South Gloucestershire 008B","E01014887","Total",614,156,65,91,458,10,124,79,147,13,18,67
"2011","South Gloucestershire 008C","E01014888","Total",618,164,95,69,454,7,148,73,121,17,29,59
"2011","South Gloucestershire 008D","E01014889","Total",613,107,53,54,506,24,121,109,120,15,29,88
"2011","South Gloucestershire 009A","E01014872","Total",723,247,9,238,476,40,20,123,197,17,27,52
"2011","South Gloucestershire 009B","E01014874","Total",601,170,20,150,431,28,29,145,134,22,28,45
"2011","South Gloucestershire 009C","E01014876","Total",746,230,17,213,516,52,18,175,186,21,26,38
"2011","South Gloucestershire 009D","E01014877","Total",601,143,27,116,458,30,28,154,129,20,34,63
"2011","South Gloucestershire 009E","E01014879","Total",757,253,89,164,504,23,78,122,154,22,26,79
"2011","South Gloucestershire 009F","E01014881","Total",717,128,10,118,589,33,11,213,194,23,50,65
"2011","South Gloucestershire 010A","E01015009","Total",616,213,144,69,403,26,117,64,82,19,31,64
"2011","South Gloucestershire 010B","E01015010","Total",527,117,44,73,410,27,85,88,88,17,21,84
"2011","South Gloucestershire 010C","E01015011","Total",659,205,90,115,454,40,89,67,125,8,33,92
"2011","South Gloucestershire 010D","E01015012","Total",526,140,89,51,386,11,117,61,94,16,15,72
"2011","South Gloucestershire 010E","E01015013","Total",514,97,36,61,417,44,55,93,103,22,33,67
"2011","South Gloucestershire 011A","E01014946","Total",639,165,65,100,474,48,83,74,118,20,32,99
"2011","South Gloucestershire 011B","E01014947","Total",632,168,123,45,464,8,186,44,98,10,38,80
"2011","South Gloucestershire 011C","E01014948","Total",804,327,135,192,477,69,82,92,125,22,34,53
"2011","South Gloucestershire 011D","E01014949","Total",544,113,38,75,431,34,54,90,106,17,29,101
"2011","South Gloucestershire 011E","E01014950","Total",601,171,61,110,430,24,65,103,127,15,26,70
"2011","South Gloucestershire 011F","E01014951","Total",586,186,49,137,400,52,58,85,107,13,26,59
"2011","South Gloucestershire 011G","E01014952","Total",708,186,77,109,522,18,127,75,139,7,34,122
"2011","South Gloucestershire 012A","E01014873","Total",558,99,16,83,459,17,45,120,140,17,36,84
"2011","South Gloucestershire 012B","E01014875","Total",794,252,25,227,542,49,25,166,198,18,27,59
"2011","South Gloucestershire 012C","E01014878","Total",853,208,29,179,645,42,35,212,229,22,39,66
"2011","South Gloucestershire 012D","E01014880","Total",715,154,15,139,561,52,27,196,171,23,33,59
"2011","South Gloucestershire 012E","E01014882","Total",834,197,22,175,637,79,40,172,191,23,49,83
"2011","South Gloucestershire 012F","E01014883","Total",535,152,30,122,383,19,52,113,126,10,20,43
"2011","South Gloucestershire 013A","E01014911","Total",548,106,74,32,442,11,150,61,91,18,37,74
"2011","South Gloucestershire 013B","E01014912","Total",735,145,71,74,590,24,143,126,154,14,44,85
"2011","South Gloucestershire 013C","E01014913","Total",655,128,72,56,527,25,150,107,114,16,35,80
"2011","South Gloucestershire 013D","E01014914","Total",639,146,92,54,493,34,94,108,91,21,46,99
"2011","South Gloucestershire 014A","E01014892","Total",679,188,62,126,491,53,41,130,143,20,24,80
"2011","South Gloucestershire 014B","E01014893","Total",620,175,59,116,445,36,76,92,111,23,37,70
"2011","South Gloucestershire 014C","E01014894","Total",490,90,26,64,400,28,55,90,94,19,30,84
"2011","South Gloucestershire 014D","E01014895","Total",526,92,19,73,434,30,46,96,125,20,43,74
"2011","South Gloucestershire 014E","E01014896","Total",478,91,22,69,387,27,28,105,102,27,36,62
"2011","South Gloucestershire 015A","E01014979","Total",667,196,73,123,471,27,71,105,160,9,33,66
"2011","South Gloucestershire 015B","E01014980","Total",641,144,53,91,497,16,83,115,130,12,34,107
"2011","South Gloucestershire 015C","E01014982","Total",632,184,65,119,448,22,71,115,121,16,33,70
"2011","South Gloucestershire 015D","E01014983","Total",648,191,71,120,457,54,73,91,123,16,28,72
"2011","South Gloucestershire 015E","E01014984","Total",608,176,95,81,432,27,88,80,99,19,25,94
"2011","South Gloucestershire 016A","E01014998","Total",643,172,116,56,471,24,155,84,78,15,36,79
"2011","South Gloucestershire 016B","E01014999","Total",629,126,82,44,503,21,163,102,90,16,32,79
"2011","South Gloucestershire 016C","E01015000","Total",654,210,124,86,444,26,104,79,100,19,36,80
"2011","South Gloucestershire 016D","E01015001","Total",628,120,77,43,508,24,134,102,93,18,34,103
"2011","South Gloucestershire 017A","E01014978","Total",589,122,40,82,467,22,46,142,139,16,32,70
"2011","South Gloucestershire 017B","E01014981","Total",1168,302,53,249,866,84,77,215,290,34,47,119
"2011","South Gloucestershire 017C","E01014996","Total",699,228,118,110,471,18,152,78,120,19,23,61
"2011","South Gloucestershire 017E","E01033331","Total",588,194,7,187,394,25,8,73,175,9,18,86
"2011","South Gloucestershire 017F","E01033333","Total",552,147,50,97,405,20,74,71,103,11,25,101
"2011","South Gloucestershire 018A","E01014904","Total",648,214,102,112,434,31,88,83,105,9,33,85
"2011","South Gloucestershire 018B","E01014905","Total",663,177,82,95,486,10,85,100,122,15,33,121
"2011","South Gloucestershire 018C","E01014906","Total",742,302,177,125,440,47,73,76,104,14,37,89
"2011","South Gloucestershire 018D","E01014907","Total",685,230,106,124,455,21,92,71,136,14,23,98
"2011","South Gloucestershire 018E","E01014908","Total",559,148,64,84,411,13,104,69,112,12,29,72
"2011","South Gloucestershire 018F","E01014909","Total",595,171,57,114,424,25,52,64,105,13,39,126
"2011","South Gloucestershire 018G","E01014910","Total",622,195,86,109,427,36,69,88,119,10,32,73
"2011","South Gloucestershire 019A","E01014867","Total",523,133,80,53,390,19,120,57,89,10,26,69
"2011","South Gloucestershire 019B","E01014868","Total",630,146,48,98,484,33,77,96,141,14,32,91
"2011","South Gloucestershire 019D","E01014994","Total",734,204,139,65,530,13,159,73,135,11,43,96
"2011","South Gloucestershire 019E","E01014995","Total",689,149,98,51,540,8,177,92,120,12,38,93
"2011","South Gloucestershire 019F","E01033338","Total",630,149,26,123,481,33,57,128,145,12,42,64
"2011","South Gloucestershire 019G","E01033339","Total",607,184,60,124,423,52,52,82,137,16,39,45
"2011","South Gloucestershire 020A","E01014901","Total",660,149,89,60,511,18,122,119,108,28,36,80
"2011","South Gloucestershire 020B","E01014902","Total",537,117,80,37,420,12,119,90,99,18,29,53
"2011","South Gloucestershire 020C","E01014903","Total",641,183,126,57,458,9,141,95,95,12,28,78
"2011","South Gloucestershire 020D","E01014965","Total",607,136,94,42,471,13,135,89,103,18,27,86
"2011","South Gloucestershire 021A","E01014964","Total",667,136,45,91,531,30,90,141,141,24,35,70
"2011","South Gloucestershire 021B","E01014966","Total",640,151,41,110,489,47,23,170,166,20,25,38
"2011","South Gloucestershire 021C","E01014967","Total",811,162,43,119,649,26,85,220,178,33,31,76
"2011","South Gloucestershire 021D","E01014969","Total",634,127,56,71,507,25,117,129,126,19,30,61
"2011","South Gloucestershire 021F","E01033334","Total",639,165,12,153,474,31,16,162,161,30,22,52
"2011","South Gloucestershire 021G","E01033336","Total",607,85,28,57,522,37,37,196,125,31,41,55
"2011","South Gloucestershire 022A","E01014897","Total",594,127,79,48,467,18,128,98,98,20,36,69
"2011","South Gloucestershire 022B","E01014898","Total",720,257,176,81,463,15,79,109,125,16,34,85
"2011","South Gloucestershire 022C","E01014899","Total",744,279,127,152,465,19,95,99,123,18,23,88
"2011","South Gloucestershire 022D","E01014900","Total",631,230,108,122,401,13,71,82,107,11,39,78
"2011","South Gloucestershire 023A","E01014959","Total",535,115,70,45,420,28,90,67,85,17,34,99
"2011","South Gloucestershire 023B","E01014960","Total",685,203,108,95,482,35,96,73,123,23,38,94
"2011","South Gloucestershire 023C","E01014961","Total",668,173,98,75,495,51,103,99,100,27,36,79
"2011","South Gloucestershire 023D","E01014968","Total",747,242,143,99,505,60,122,89,86,22,31,95
"2011","South Gloucestershire 024A","E01014865","Total",784,205,73,132,579,45,124,106,145,23,40,96
"2011","South Gloucestershire 024B","E01014869","Total",719,209,99,110,510,25,114,108,112,27,40,84
"2011","South Gloucestershire 024C","E01014870","Total",635,149,72,77,486,17,96,70,132,13,50,108
"2011","South Gloucestershire 024D","E01014871","Total",518,129,86,43,389,23,122,60,79,11,27,67
"2011","South Gloucestershire 024E","E01014890","Total",817,175,70,105,642,21,151,122,163,31,36,118
"2011","South Gloucestershire 024F","E01014891","Total",688,169,82,87,519,10,132,89,135,18,30,105
"2011","South Gloucestershire 025A","E01014955","Total",557,129,73,56,428,14,116,75,114,8,19,82
"2011","South Gloucestershire 025B","E01014956","Total",658,166,107,59,492,29,129,64,119,15,43,93
"2011","South Gloucestershire 025C","E01014957","Total",509,105,59,46,404,16,104,79,95,9,26,75
"2011","South Gloucestershire 025D","E01014974","Total",713,260,156,104,453,17,102,91,120,23,31,69
"2011","South Gloucestershire 025E","E01014977","Total",696,357,128,229,339,68,50,56,99,8,9,49
"2011","South Gloucestershire 026A","E01014922","Total",547,115,48,67,432,30,89,88,93,13,30,89
"2011","South Gloucestershire 026B","E01014923","Total",651,203,74,129,448,59,90,86,105,20,22,66
"2011","South Gloucestershire 026C","E01014924","Total",792,285,69,216,507,44,73,108,174,14,24,70
"2011","South Gloucestershire 026D","E01014973","Total",638,217,111,106,421,26,96,88,94,12,30,75
"2011","South Gloucestershire 026E","E01014975","Total",706,223,64,159,483,41,103,94,124,15,17,89
"2011","South Gloucestershire 026F","E01014976","Total",660,205,79,126,455,36,82,70,160,15,26,66
"2011","South Gloucestershire 027A","E01014925","Total",625,160,85,75,465,35,107,78,117,16,30,82
"2011","South Gloucestershire 027B","E01014926","Total",686,184,101,83,502,75,91,80,101,25,31,99
"2011","South Gloucestershire 027C","E01014927","Total",826,375,160,215,451,50,99,77,117,9,17,82
"2011","South Gloucestershire 027D","E01014928","Total",644,183,106,77,461,44,101,82,97,20,29,88
"2011","South Gloucestershire 027E","E01014958","Total",483,115,59,56,368,48,69,78,80,7,26,60
"2011","South Gloucestershire 028A","E01014915","Total",651,185,93,92,466,28,96,99,105,16,34,88
"2011","South Gloucestershire 028B","E01015003","Total",657,156,64,92,501,18,139,100,99,18,32,95
"2011","South Gloucestershire 028C","E01015005","Total",850,240,58,182,610,65,76,145,186,19,40,79
"2011","South Gloucestershire 028D","E01015007","Total",794,295,118,177,499,68,88,76,142,15,26,84
"2011","South Gloucestershire 028E","E01015008","Total",663,175,87,88,488,34,93,84,115,22,42,98
"2011","South Gloucestershire 029A","E01014943","Total",815,315,43,272,500,36,21,136,200,11,28,68
"2011","South Gloucestershire 029B","E01014944","Total",710,153,45,108,557,37,51,167,150,24,42,86
"2011","South Gloucestershire 029C","E01014972","Total",701,215,122,93,486,26,74,109,124,20,39,94
"2011","South Gloucestershire 029D","E01015002","Total",643,172,62,110,471,45,57,103,135,11,24,96
"2011","South Gloucestershire 029E","E01015004","Total",716,192,55,137,524,44,72,95,153,18,34,108
"2011","South Gloucestershire 029F","E01015006","Total",665,161,78,83,504,39,113,74,136,15,35,92
"2011","South Gloucestershire 030A","E01014936","Total",554,122,43,79,432,26,74,93,105,19,37,78
"2011","South Gloucestershire 030B","E01014938","Total",624,137,39,98,487,36,69,122,142,12,33,73
"2011","South Gloucestershire 030C","E01014939","Total",498,123,34,89,375,39,49,75,115,6,25,66
"2011","South Gloucestershire 030D","E01014940","Total",501,85,24,61,416,16,62,72,125,13,34,94
"2011","South Gloucestershire 030E","E01014941","Total",645,165,107,58,480,66,95,66,103,18,34,98
"2011","South Gloucestershire 030F","E01014942","Total",654,203,97,106,451,49,93,79,109,24,20,77
"2011","South Gloucestershire 030G","E01014945","Total",687,151,82,69,536,42,111,87,146,17,36,97
"2011","South Gloucestershire 031A","E01014916","Total",685,252,125,127,433,28,84,93,113,15,26,74
"2011","South Gloucestershire 031B","E01014917","Total",616,151,84,67,465,29,121,81,117,5,25,87
"2011","South Gloucestershire 031C","E01014918","Total",644,204,121,83,440,12,138,72,106,13,32,67
"2011","South Gloucestershire 031D","E01014919","Total",501,98,76,22,403,7,130,69,78,19,26,74
"2011","South Gloucestershire 031E","E01014920","Total",532,108,73,35,424,10,108,67,100,11,27,101
"2011","South Gloucestershire 031F","E01014921","Total",553,134,61,73,419,15,99,87,91,11,37,79
"2011","South Gloucestershire 032A","E01014866","Total",646,139,76,63,507,19,130,86,124,15,24,109
"2011","South Gloucestershire 032B","E01014931","Total",613,201,108,93,412,8,92,52,127,19,29,85
"2011","South Gloucestershire 032C","E01014932","Total",728,205,105,100,523,24,147,89,134,9,27,93
"2011","South Gloucestershire 032D","E01014933","Total",623,160,33,127,463,23,90,89,142,14,24,81
"2011","South Gloucestershire 032E","E01014934","Total",502,113,78,35,389,3,105,67,91,13,26,84
"2011","South Gloucestershire 032F","E01014935","Total",664,198,59,139,466,23,78,105,147,6,23,84
"2011","South Gloucestershire 032G","E01014937","Total",524,113,79,34,411,16,113,69,95,8,31,79
"2011","Swindon 001A","E01015519","Total",691,262,153,109,429,21,122,74,110,18,32,52
"2011","Swindon 001B","E01015520","Total",549,186,105,81,363,19,108,60,96,10,19,51
"2011","Swindon 001C","E01015521","Total",604,146,75,71,458,19,120,78,118,12,31,80
"2011","Swindon 001D","E01015522","Total",643,181,80,101,462,32,70,90,161,10,21,78
"2011","Swindon 001E","E01015523","Total",655,188,109,79,467,17,115,74,131,13,32,85
"2011","Swindon 001F","E01015524","Total",465,100,43,57,365,17,64,94,87,14,28,61
"2011","Swindon 003A","E01015543","Total",605,177,108,69,428,38,103,72,109,13,22,71
"2011","Swindon 003B","E01015544","Total",743,276,115,161,467,74,72,94,101,25,32,69
"2011","Swindon 003C","E01015545","Total",698,235,69,166,463,99,61,97,101,27,30,48
"2011","Swindon 003D","E01015546","Total",699,216,86,130,483,96,43,127,105,29,30,53
"2011","Swindon 004A","E01015513","Total",672,190,31,159,482,41,46,138,161,10,29,57
"2011","Swindon 004B","E01015514","Total",523,104,65,39,419,12,141,67,91,16,27,65
"2011","Swindon 004C","E01015515","Total",580,108,29,79,472,16,69,111,163,12,20,81
"2011","Swindon 004D","E01015516","Total",624,245,119,126,379,23,101,55,105,5,23,67
"2011","Swindon 004E","E01015517","Total",669,192,116,76,477,14,175,65,126,11,25,61
"2011","Swindon 005A","E01015555","Total",668,213,127,86,455,21,129,70,114,14,24,83
"2011","Swindon 005B","E01015556","Total",669,165,66,99,504,22,96,102,156,13,38,77
"2011","Swindon 005C","E01015557","Total",627,196,58,138,431,17,93,72,132,8,30,79
"2011","Swindon 005D","E01015558","Total",640,204,132,72,436,40,99,74,78,31,35,79
"2011","Swindon 005E","E01015559","Total",638,171,90,81,467,16,124,67,136,11,34,79
"2011","Swindon 005F","E01015560","Total",669,166,63,103,503,24,129,110,116,15,37,72
"2011","Swindon 006A","E01015526","Total",607,145,19,126,462,35,51,102,166,17,30,61
"2011","Swindon 006B","E01015528","Total",794,290,145,145,504,56,72,102,124,34,43,73
"2011","Swindon 006C","E01015529","Total",676,200,113,87,476,23,121,73,136,10,25,88
"2011","Swindon 006D","E01015530","Total",698,240,138,102,458,24,83,79,111,23,50,88
"2011","Swindon 007A","E01015506","Total",633,204,89,115,429,41,66,72,102,25,41,82
"2011","Swindon 007B","E01015507","Total",644,207,80,127,437,80,28,78,107,41,41,62
"2011","Swindon 007C","E01015527","Total",682,180,90,90,502,47,90,88,113,31,49,84
"2011","Swindon 007D","E01015580","Total",637,152,95,57,485,28,80,108,110,19,44,96
"2011","Swindon 008A","E01015473","Total",674,125,67,58,549,18,133,88,159,18,30,103
"2011","Swindon 008B","E01015474","Total",649,117,59,58,532,25,119,84,139,19,34,112
"2011","Swindon 008C","E01015547","Total",594,100,45,55,494,12,100,98,129,22,36,97
"2011","Swindon 008D","E01015548","Total",619,118,48,70,501,14,99,116,142,23,34,73
"2011","Swindon 009A","E01015549","Total",702,150,73,77,552,29,125,104,149,17,36,92
"2011","Swindon 009B","E01015550","Total",876,299,110,189,577,20,160,89,195,11,23,79
"2011","Swindon 009C","E01015551","Total",619,135,83,52,484,18,141,82,125,14,31,73
"2011","Swindon 009D","E01015552","Total",814,221,69,152,593,21,73,166,160,23,50,100
"2011","Swindon 009E","E01015553","Total",670,218,54,164,452,21,47,105,133,21,46,79
"2011","Swindon 009F","E01015554","Total",640,219,138,81,421,16,138,85,67,16,26,73
"2011","Swindon 010A","E01015508","Total",614,231,102,129,383,32,50,81,102,17,40,61
"2011","Swindon 010B","E01015509","Total",705,207,75,132,498,41,59,103,170,16,25,84
"2011","Swindon 010C","E01015510","Total",844,320,113,207,524,37,68,99,169,20,39,92
"2011","Swindon 010D","E01015511","Total",709,252,71,181,457,24,60,107,148,13,27,78
"2011","Swindon 011A","E01015562","Total",599,128,22,106,471,47,20,143,139,13,43,66
"2011","Swindon 011B","E01015563","Total",601,133,22,111,468,17,36,145,137,12,45,76
"2011","Swindon 011C","E01015565","Total",646,177,50,127,469,31,41,115,133,15,46,88
"2011","Swindon 011D","E01015566","Total",679,185,19,166,494,47,36,113,174,14,27,83
"2011","Swindon 012B","E01015578","Total",748,279,90,189,469,39,66,98,160,22,16,68
"2011","Swindon 012C","E01015579","Total",696,212,68,144,484,29,61,131,164,21,13,65
"2011","Swindon 012D","E01015581","Total",617,158,82,76,459,13,87,103,122,13,29,92
"2011","Swindon 012E","E01015582","Total",832,282,88,194,550,29,83,133,158,11,45,91
"2011","Swindon 012F","E01032708","Total",769,250,10,240,519,29,11,118,268,12,24,57
"2011","Swindon 012G","E01032716","Total",644,219,58,161,425,34,45,94,148,14,32,58
"2011","Swindon 013A","E01015481","Total",758,212,84,128,546,27,101,119,178,21,31,69
"2011","Swindon 013B","E01015482","Total",512,98,52,46,414,7,93,74,118,7,32,83
"2011","Swindon 013C","E01015483","Total",648,184,123,61,464,8,166,64,111,9,28,78
"2011","Swindon 013D","E01015484","Total",621,157,96,61,464,8,149,74,122,8,24,79
"2011","Swindon 013E","E01015485","Total",654,214,46,168,440,18,56,107,163,8,18,70
"2011","Swindon 013F","E01015486","Total",621,156,71,85,465,22,107,82,136,15,28,75
"2011","Swindon 014A","E01015561","Total",650,210,29,181,440,24,55,90,147,14,33,77
"2011","Swindon 014B","E01015564","Total",607,132,37,95,475,24,53,102,136,18,38,104
"2011","Swindon 014C","E01015567","Total",673,234,42,192,439,20,40,114,155,9,25,76
"2011","Swindon 014D","E01015568","Total",622,200,40,160,422,34,55,90,114,11,25,93
"2011","Swindon 015A","E01015475","Total",683,171,58,113,512,26,47,88,78,14,125,134
"2011","Swindon 015B","E01015476","Total",1198,621,103,518,577,35,50,116,248,5,42,81
"2011","Swindon 015C","E01015477","Total",713,266,85,181,447,35,34,109,159,8,25,77
"2011","Swindon 015D","E01015480","Total",751,212,42,170,539,21,32,104,106,30,121,125
"2011","Swindon 016A","E01015538","Total",841,354,130,224,487,65,74,104,121,22,30,71
"2011","Swindon 016B","E01015572","Total",523,178,45,133,345,43,46,62,75,20,38,61
"2011","Swindon 016C","E01015573","Total",936,388,127,261,548,77,61,125,118,35,57,75
"2011","Swindon 016D","E01015575","Total",489,165,48,117,324,53,60,49,61,19,24,58
"2011","Swindon 017A","E01015479","Total",661,202,34,168,459,29,45,87,143,22,39,94
"2011","Swindon 017B","E01015493","Total",712,221,69,152,491,19,66,100,137,20,58,91
"2011","Swindon 017C","E01015574","Total",644,159,68,91,485,29,97,103,111,20,38,87
"2011","Swindon 017D","E01015576","Total",681,221,146,75,460,15,137,66,98,16,40,88
"2011","Swindon 018A","E01015499","Total",463,66,12,54,397,8,33,85,129,8,34,100
"2011","Swindon 018B","E01015500","Total",653,181,51,130,472,43,33,99,177,17,31,72
"2011","Swindon 018C","E01015504","Total",516,87,19,68,429,28,27,116,127,9,37,85
"2011","Swindon 018D","E01015505","Total",668,203,22,181,465,64,24,115,172,14,22,54
"2011","Swindon 019A","E01015494","Total",811,289,58,231,522,19,37,100,224,10,36,96
"2011","Swindon 019C","E01015496","Total",816,325,45,280,491,32,35,93,244,9,18,60
"2011","Swindon 019D","E01015497","Total",711,296,47,249,415,34,35,88,141,15,29,73
"2011","Swindon 019E","E01032714","Total",670,325,44,281,345,14,17,69,181,5,13,46
"2011","Swindon 019F","E01032715","Total",540,285,65,220,255,19,20,40,132,7,6,31
"2011","Swindon 020A","E01015537","Total",707,179,79,100,528,76,79,97,121,25,43,87
"2011","Swindon 020B","E01015539","Total",630,148,66,82,482,43,80,87,114,35,34,89
"2011","Swindon 020C","E01015540","Total",736,232,76,156,504,56,68,95,122,26,49,88
"2011","Swindon 020D","E01015541","Total",749,238,102,136,511,79,75,82,110,20,56,89
"2011","Swindon 020E","E01015542","Total",623,210,105,105,413,69,61,58,94,20,35,76
"2011","Swindon 021A","E01015478","Total",657,217,76,141,440,25,46,98,158,17,29,67
"2011","Swindon 021B","E01015498","Total",783,241,37,204,542,24,67,129,202,11,26,83
"2011","Swindon 021D","E01015532","Total",636,215,52,163,421,24,48,105,147,18,20,59
"2011","Swindon 021E","E01032706","Total",710,279,10,269,431,25,12,91,232,8,21,42
"2011","Swindon 021F","E01032707","Total",736,175,73,102,561,6,89,136,174,29,32,95
"2011","Swindon 022A","E01015501","Total",523,84,25,59,439,24,56,69,139,18,38,95
"2011","Swindon 022B","E01015502","Total",640,200,81,119,440,44,46,95,116,25,37,77
"2011","Swindon 022C","E01015503","Total",613,253,110,143,360,41,51,57,106,19,26,60
"2011","Swindon 022D","E01015569","Total",643,209,62,147,434,31,61,83,113,21,29,96
"2011","Swindon 022E","E01015570","Total",771,364,144,220,407,52,53,71,130,6,40,55
"2011","Swindon 022F","E01015571","Total",648,164,66,98,484,27,98,76,130,19,45,89
"2011","Swindon 023A","E01015487","Total",608,92,58,34,516,21,102,86,138,14,35,120
"2011","Swindon 023B","E01015488","Total",654,244,90,154,410,34,75,75,122,13,26,65
"2011","Swindon 023C","E01015489","Total",549,108,44,64,441,20,95,70,117,15,40,84
"2011","Swindon 023D","E01015490","Total",543,138,40,98,405,35,57,74,137,13,24,65
"2011","Swindon 023E","E01015491","Total",721,304,117,187,417,46,73,70,116,20,28,64
"2011","Swindon 023F","E01015492","Total",540,116,46,70,424,54,48,72,116,20,33,81
"2011","Swindon 024A","E01015533","Total",673,191,123,68,482,7,176,85,106,3,36,69
"2011","Swindon 024B","E01015534","Total",1046,506,206,300,540,26,137,89,198,15,22,53
"2011","Swindon 024C","E01015535","Total",618,162,85,77,456,5,112,94,125,17,31,72
"2011","Swindon 024D","E01015536","Total",1012,246,93,153,766,47,152,163,238,32,35,99
"2011","Swindon 025A","E01015583","Total",860,152,46,106,708,38,90,177,207,40,47,109
"2011","Swindon 025B","E01015584","Total",646,204,123,81,442,6,177,68,90,6,32,63
"2011","Swindon 025C","E01015585","Total",661,170,67,103,491,25,91,110,130,21,35,79
"2011","Swindon 025D","E01015586","Total",631,162,112,50,469,12,170,67,105,9,27,79
"2011","Swindon 025E","E01015587","Total",865,325,195,130,540,22,145,85,131,23,33,101
"2011","Swindon 025F","E01015588","Total",740,156,86,70,584,30,141,106,150,22,39,96
"2011","Swindon 026A","E01015525","Total",664,176,21,155,488,20,56,143,165,16,24,64
"2011","Swindon 026B","E01032700","Total",583,80,5,75,503,24,16,207,170,28,21,37
"2011","Swindon 026C","E01032703","Total",555,92,3,89,463,36,21,177,156,17,19,37
"2011","Swindon 026D","E01032705","Total",582,142,4,138,440,47,8,156,144,24,27,34
"2011","Swindon 026E","E01032709","Total",545,127,5,122,418,38,14,153,144,14,22,33
"2011","Swindon 026F","E01032713","Total",622,90,4,86,532,33,9,211,172,30,26,51
"2011","Swindon 027A","E01032701","Total",543,161,7,154,382,30,18,120,163,14,13,24
"2011","Swindon 027B","E01032702","Total",573,142,25,117,431,27,41,157,126,23,19,38
"2011","Swindon 027C","E01032704","Total",584,143,5,138,441,54,11,145,160,19,17,35
"2011","Swindon 027D","E01032711","Total",603,184,7,177,419,33,14,129,184,10,17,32
"2011","Swindon 027E","E01032712","Total",589,156,8,148,433,51,8,136,168,17,13,40
"2011","Swindon 028A","E01015471","Total",675,167,36,131,508,23,54,169,164,14,36,48
"2011","Swindon 028B","E01015472","Total",1088,240,16,224,848,68,52,274,302,34,49,69
"2011","Swindon 028C","E01015512","Total",612,88,15,73,524,25,29,179,170,28,40,53
"2011","Swindon 028D","E01015518","Total",537,57,5,52,480,30,33,156,138,27,41,55
"2011","Swindon 028E","E01032710","Total",525,128,16,112,397,21,14,140,143,14,26,39
"2011","Torbay 001A","E01015262","Total",525,118,61,57,407,30,80,57,92,15,50,83
"2011","Torbay 001B","E01015263","Total",624,188,66,122,436,72,67,92,87,27,31,60
"2011","Torbay 001C","E01015264","Total",618,175,97,78,443,16,176,54,106,12,19,60
"2011","Torbay 001D","E01015265","Total",653,164,98,66,489,37,154,48,127,9,28,86
"2011","Torbay 001E","E01015266","Total",618,215,113,102,403,42,66,72,86,25,50,62
"2011","Torbay 002A","E01015236","Total",647,184,84,100,463,34,113,61,134,13,26,82
"2011","Torbay 002B","E01015237","Total",519,116,61,55,403,39,57,90,90,19,41,67
"2011","Torbay 002C","E01015238","Total",611,192,90,102,419,44,87,79,117,13,18,61
"2011","Torbay 002D","E01015239","Total",791,414,241,173,377,40,110,52,93,3,20,59
"2011","Torbay 003A","E01015249","Total",619,191,121,70,428,35,86,81,95,21,40,70
"2011","Torbay 003B","E01015250","Total",608,165,67,98,443,53,66,114,111,19,16,64
"2011","Torbay 003C","E01015251","Total",461,112,63,49,349,17,67,68,86,13,29,69
"2011","Torbay 003D","E01015252","Total",1001,238,64,174,763,119,107,183,219,23,37,75
"2011","Torbay 003E","E01015253","Total",645,144,39,105,501,62,52,126,158,22,27,54
"2011","Torbay 003F","E01015254","Total",610,160,110,50,450,19,146,66,115,12,22,70
"2011","Torbay 004A","E01015257","Total",566,171,68,103,395,47,56,69,110,17,34,62
"2011","Torbay 004B","E01015258","Total",885,334,89,245,551,56,100,89,164,11,40,91
"2011","Torbay 004C","E01015259","Total",585,175,70,105,410,53,47,88,98,10,35,79
"2011","Torbay 004D","E01015260","Total",783,386,120,266,397,48,57,62,138,8,26,58
"2011","Torbay 005A","E01015240","Total",790,408,235,173,382,32,132,40,121,5,8,44
"2011","Torbay 005B","E01015241","Total",627,217,115,102,410,35,89,66,89,21,41,69
"2011","Torbay 005C","E01015242","Total",518,160,61,99,358,45,58,72,73,11,30,69
"2011","Torbay 005D","E01015243","Total",594,194,123,71,400,16,131,54,95,10,16,78
"2011","Torbay 006A","E01015214","Total",630,218,63,155,412,56,42,74,134,13,30,63
"2011","Torbay 006B","E01015215","Total",608,168,75,93,440,33,83,105,106,10,37,66
"2011","Torbay 006C","E01015216","Total",625,199,50,149,426,56,56,85,120,16,22,71
"2011","Torbay 006D","E01015218","Total",586,189,75,114,397,33,76,70,105,18,33,62
"2011","Torbay 008A","E01015217","Total",778,370,99,271,408,76,47,62,139,16,18,50
"2011","Torbay 008B","E01015255","Total",823,450,67,383,373,47,40,58,152,8,10,58
"2011","Torbay 008C","E01015256","Total",1034,544,146,398,490,43,99,70,213,5,8,52
"2011","Torbay 008D","E01015261","Total",918,431,155,276,487,56,79,82,158,13,30,69
"2011","Torbay 010A","E01015267","Total",852,452,160,292,400,32,114,36,175,2,10,31
"2011","Torbay 010B","E01015268","Total",875,402,177,225,473,30,176,47,150,6,16,48
"2011","Torbay 010C","E01015269","Total",796,348,156,192,448,18,136,55,151,11,17,60
"2011","Torbay 010D","E01015270","Total",882,413,175,238,469,31,171,46,153,2,12,54
"2011","Torbay 010E","E01015271","Total",704,232,154,78,472,11,219,47,108,7,15,65
"2011","Torbay 011A","E01015224","Total",623,170,87,83,453,39,99,84,118,18,31,64
"2011","Torbay 011B","E01015225","Total",597,185,105,80,412,22,92,64,101,20,40,73
"2011","Torbay 011C","E01015226","Total",603,132,78,54,471,15,155,72,127,16,27,59
"2011","Torbay 011D","E01015227","Total",622,148,99,49,474,12,126,88,111,10,35,92
"2011","Torbay 011E","E01015228","Total",737,327,205,122,410,29,122,67,97,7,21,67
"2011","Torbay 011F","E01015230","Total",639,157,114,43,482,10,194,68,107,10,20,73
"2011","Torbay 012A","E01015202","Total",601,128,71,57,473,28,104,95,105,24,32,85
"2011","Torbay 012B","E01015203","Total",547,133,87,46,414,14,144,62,92,13,26,63
"2011","Torbay 012C","E01015204","Total",622,220,88,132,402,33,99,77,99,13,28,53
"2011","Torbay 012D","E01015205","Total",639,154,85,69,485,27,124,86,130,13,33,72
"2011","Torbay 012E","E01015206","Total",629,199,80,119,430,32,82,78,134,14,18,72
"2011","Torbay 013A","E01015190","Total",708,205,102,103,503,34,139,62,124,30,44,70
"2011","Torbay 013B","E01015191","Total",662,135,50,85,527,49,95,110,142,31,31,69
"2011","Torbay 013C","E01015192","Total",589,145,72,73,444,52,83,70,111,22,36,70
"2011","Torbay 013D","E01015193","Total",552,152,97,55,400,17,110,68,95,20,25,65
"2011","Torbay 013E","E01015194","Total",606,196,77,119,410,34,95,52,99,18,42,70
"2011","Torbay 013F","E01015195","Total",639,204,103,101,435,30,96,70,103,19,49,68
"2011","Torbay 013G","E01015196","Total",593,166,73,93,427,76,45,79,81,32,43,71
"2011","Torbay 014A","E01015229","Total",609,255,149,106,354,19,110,42,93,11,27,52
"2011","Torbay 014B","E01015231","Total",856,465,165,300,391,65,53,78,115,9,22,49
"2011","Torbay 014C","E01015232","Total",842,445,167,278,397,31,103,40,145,8,22,48
"2011","Torbay 014D","E01015233","Total",701,352,117,235,349,39,77,53,102,9,19,50
"2011","Torbay 014E","E01015234","Total",595,224,89,135,371,52,49,68,110,19,30,43
"2011","Torbay 014F","E01015235","Total",845,408,235,173,437,17,174,48,128,6,15,49
"2011","Torbay 015A","E01015219","Total",688,316,184,132,372,18,119,41,89,15,30,60
"2011","Torbay 015B","E01015220","Total",618,168,103,65,450,19,147,63,110,11,28,72
"2011","Torbay 015C","E01015221","Total",634,206,119,87,428,25,100,67,114,16,27,79
"2011","Torbay 015D","E01015222","Total",631,172,103,69,459,36,142,64,108,14,18,77
"2011","Torbay 015E","E01015223","Total",510,88,44,44,422,23,94,74,102,14,30,85
"2011","Torbay 016A","E01015197","Total",637,146,103,43,491,9,203,58,98,11,23,89
"2011","Torbay 016B","E01015198","Total",740,220,180,40,520,17,219,57,112,12,21,82
"2011","Torbay 016C","E01015199","Total",628,191,144,47,437,5,212,25,98,10,13,74
"2011","Torbay 016D","E01015200","Total",442,135,83,52,307,19,91,50,68,7,27,45
"2011","Torbay 016E","E01015201","Total",580,159,100,59,421,13,131,56,109,8,25,79
"2011","Torbay 017A","E01015183","Total",582,186,106,80,396,17,124,57,86,13,26,73
"2011","Torbay 017B","E01015184","Total",620,183,133,50,437,7,213,45,96,8,24,44
"2011","Torbay 017C","E01015185","Total",681,285,163,122,396,25,130,58,107,7,17,52
"2011","Torbay 017D","E01015186","Total",681,269,104,165,412,58,82,60,135,7,18,52
"2011","Torbay 017E","E01015187","Total",705,266,176,90,439,20,188,40,109,7,20,55
"2011","Torbay 017F","E01015188","Total",667,202,133,69,465,27,171,46,101,12,34,74
"2011","Torbay 017G","E01015189","Total",564,206,84,122,358,31,91,47,103,13,22,51
"2011","Torbay 018A","E01015244","Total",641,174,106,68,467,23,152,69,107,17,35,64
"2011","Torbay 018B","E01015245","Total",603,167,108,59,436,31,162,58,94,8,23,60
"2011","Torbay 018C","E01015246","Total",600,175,114,61,425,23,135,66,96,13,24,68
"2011","Torbay 018D","E01015247","Total",735,206,114,92,529,34,134,91,134,20,34,82
"2011","Torbay 018E","E01015248","Total",657,234,127,107,423,52,79,65,107,11,32,77
"2011","Torbay 019E","E01015207","Total",649,171,66,105,478,32,84,99,125,18,36,84
"2011","Torbay 019F","E01015208","Total",847,240,176,64,607,18,251,68,133,19,27,91
"2011","Torbay 019A","E01015209","Total",625,266,108,158,359,24,79,61,99,14,29,53
"2011","Torbay 019B","E01015210","Total",639,176,94,82,463,50,81,102,120,13,29,68
"2011","Torbay 019G","E01015211","Total",586,126,74,52,460,20,123,85,104,21,28,79
"2011","Torbay 019C","E01015212","Total",586,181,53,128,405,34,65,88,109,16,25,68
"2011","Torbay 019D","E01015213","Total",569,136,74,62,433,26,89,86,103,16,42,71
"2011","Wiltshire 012A","E01031841","Total",783,211,90,121,572,31,143,113,160,22,35,68
"2011","Wiltshire 012B","E01031868","Total",683,125,50,75,558,14,112,95,166,24,50,97
"2011","Wiltshire 012C","E01031873","Total",738,194,106,88,544,26,103,117,153,20,33,92
"2011","Wiltshire 012D","E01031874","Total",654,184,113,71,470,12,115,87,121,29,29,77
"2011","Wiltshire 012E","E01031884","Total",675,167,85,82,508,19,115,95,145,17,38,79
"2011","Wiltshire 019A","E01031861","Total",1024,302,174,128,722,40,168,115,197,27,37,138
"2011","Wiltshire 019B","E01031862","Total",722,274,127,147,448,52,72,99,109,16,22,78
"2011","Wiltshire 019C","E01031863","Total",576,236,84,152,340,14,94,52,115,10,18,37
"2011","Wiltshire 019D","E01031864","Total",522,102,54,48,420,4,97,103,99,16,32,69
"2011","Wiltshire 019E","E01031865","Total",571,207,136,71,364,27,112,53,74,14,14,70
"2011","Wiltshire 024A","E01031866","Total",687,186,80,106,501,15,121,90,153,13,31,78
"2011","Wiltshire 024B","E01031869","Total",850,302,177,125,548,53,126,97,143,16,35,78
"2011","Wiltshire 024C","E01031870","Total",810,263,118,145,547,23,129,97,177,18,31,72
"2011","Wiltshire 024D","E01031871","Total",712,192,81,111,520,31,123,110,140,15,32,69
"2011","Wiltshire 025A","E01031850","Total",938,362,173,189,576,38,133,111,199,8,20,67
"2011","Wiltshire 025B","E01031851","Total",630,179,56,123,451,58,74,76,110,23,26,84
"2011","Wiltshire 025C","E01031852","Total",824,192,98,94,632,29,157,135,142,25,49,95
"2011","Wiltshire 025E","E01032688","Total",501,90,27,63,411,51,47,104,112,26,26,45
"2011","Wiltshire 025F","E01032689","Total",532,116,57,59,416,35,77,94,103,17,27,63
"2011","Wiltshire 025G","E01032692","Total",509,135,26,109,374,39,43,99,133,7,18,35
"2011","Wiltshire 025H","E01032693","Total",571,143,36,107,428,43,66,93,134,27,26,39
"2011","Wiltshire 026A","E01031853","Total",657,219,81,138,438,32,116,65,113,12,23,77
"2011","Wiltshire 026B","E01031854","Total",1024,548,242,306,476,46,109,72,168,8,19,54
"2011","Wiltshire 026C","E01031855","Total",645,155,96,59,490,17,152,73,122,24,28,74
"2011","Wiltshire 026D","E01031856","Total",750,282,147,135,468,33,144,68,115,15,21,72
"2011","Wiltshire 028A","E01031845","Total",666,153,88,65,513,23,125,67,162,15,25,96
"2011","Wiltshire 028B","E01031846","Total",704,164,91,73,540,29,123,93,167,17,31,80
"2011","Wiltshire 028C","E01031848","Total",724,145,82,63,579,21,144,110,148,18,43,95
"2011","Wiltshire 028D","E01031872","Total",675,156,90,66,519,36,128,72,156,28,33,66
"2011","Wiltshire 028E","E01031876","Total",622,123,66,57,499,20,145,68,134,25,36,71
"2011","Wiltshire 029A","E01031843","Total",774,221,111,110,553,26,131,117,162,26,28,63
"2011","Wiltshire 029B","E01031847","Total",728,171,94,77,557,16,133,110,155,24,34,85
"2011","Wiltshire 029C","E01031849","Total",672,138,57,81,534,29,104,92,178,17,34,80
"2011","Wiltshire 029D","E01031877","Total",767,167,81,86,600,20,152,129,178,32,29,60
"2011","Wiltshire 034A","E01031844","Total",830,224,76,148,606,51,114,120,178,24,33,86
"2011","Wiltshire 034B","E01031857","Total",640,172,75,97,468,37,82,80,125,25,34,85
"2011","Wiltshire 034C","E01031858","Total",713,184,91,93,529,26,98,81,152,30,51,91
"2011","Wiltshire 034D","E01031883","Total",785,194,122,72,591,22,185,85,172,16,33,78
"2011","Wiltshire 038A","E01031842","Total",768,154,80,74,614,21,158,117,155,25,42,96
"2011","Wiltshire 038B","E01031867","Total",795,222,104,118,573,42,105,100,201,12,24,89
"2011","Wiltshire 038C","E01031882","Total",849,194,96,98,655,24,149,152,195,23,26,86
"2011","Wiltshire 041A","E01031859","Total",744,252,97,155,492,60,77,77,142,23,38,75
"2011","Wiltshire 041B","E01031860","Total",634,155,63,92,479,32,74,105,159,18,26,65
"2011","Wiltshire 041C","E01031878","Total",763,128,28,100,635,46,51,214,176,47,42,59
"2011","Wiltshire 041D","E01031879","Total",597,27,12,15,570,18,8,290,187,34,18,15
"2011","Wiltshire 041E","E01031880","Total",582,48,10,38,534,21,15,205,110,69,59,55
"2011","Wiltshire 041G","E01032697","Total",574,137,8,129,437,66,9,146,126,29,23,38
"2011","Wiltshire 041H","E01032698","Total",618,124,57,67,494,45,56,119,122,28,47,77
"2011","Wiltshire 001A","E01031887","Total",714,154,89,65,560,25,117,114,160,23,32,89
"2011","Wiltshire 001B","E01031934","Total",698,127,68,59,571,15,136,104,153,19,42,102
"2011","Wiltshire 001C","E01031935","Total",736,175,76,99,561,26,118,112,176,21,30,78
"2011","Wiltshire 001D","E01031936","Total",634,181,95,86,453,49,92,83,115,18,23,73
"2011","Wiltshire 002A","E01031885","Total",634,136,54,82,498,10,106,111,150,26,30,65
"2011","Wiltshire 002B","E01031947","Total",697,209,120,89,488,45,110,85,112,24,38,74
"2011","Wiltshire 002C","E01031948","Total",828,178,70,108,650,40,95,186,173,26,39,91
"2011","Wiltshire 002D","E01031949","Total",833,282,106,176,551,31,111,93,199,21,22,74
"2011","Wiltshire 003A","E01031954","Total",530,112,60,52,418,13,92,88,111,17,37,60
"2011","Wiltshire 003B","E01031955","Total",659,165,100,65,494,13,130,78,144,25,36,68
"2011","Wiltshire 003C","E01031956","Total",512,134,62,72,378,40,82,65,93,22,27,49
"2011","Wiltshire 003D","E01031962","Total",541,109,71,38,432,4,118,95,107,12,30,66
"2011","Wiltshire 004A","E01031886","Total",566,102,45,57,464,6,108,96,134,14,28,78
"2011","Wiltshire 004B","E01031892","Total",558,102,51,51,456,5,132,91,121,17,27,63
"2011","Wiltshire 004C","E01031893","Total",612,107,54,53,505,21,107,96,140,20,41,80
"2011","Wiltshire 004D","E01031894","Total",601,110,64,46,491,12,118,104,129,22,18,88
"2011","Wiltshire 005A","E01031957","Total",619,173,95,78,446,26,91,95,118,26,28,62
"2011","Wiltshire 005B","E01031958","Total",563,129,64,65,434,18,100,94,115,12,27,68
"2011","Wiltshire 005C","E01031959","Total",690,204,109,95,486,9,133,100,139,19,22,64
"2011","Wiltshire 005D","E01031960","Total",526,80,34,46,446,19,77,137,126,17,29,41
"2011","Wiltshire 006A","E01031963","Total",737,216,120,96,521,46,111,78,108,25,48,105
"2011","Wiltshire 006B","E01031964","Total",776,246,108,138,530,25,116,74,172,10,30,103
"2011","Wiltshire 006C","E01031967","Total",880,313,168,145,567,51,103,109,181,15,29,79
"2011","Wiltshire 006D","E01031969","Total",586,134,22,112,452,19,50,105,145,5,42,86
"2011","Wiltshire 007B","E01031944","Total",457,90,26,64,367,20,70,68,133,8,20,48
"2011","Wiltshire 007D","E01031946","Total",482,22,2,20,460,22,6,197,121,45,32,37
"2011","Wiltshire 007E","E01031961","Total",526,92,39,53,434,13,111,71,125,15,21,78
"2011","Wiltshire 007F","E01031965","Total",620,189,89,100,431,12,102,69,132,14,24,78
"2011","Wiltshire 007G","E01031966","Total",628,134,76,58,494,16,123,88,129,15,33,90
"2011","Wiltshire 007H","E01031968","Total",678,170,70,100,508,15,112,97,143,15,31,95
"2011","Wiltshire 007I","E01032699","Total",996,227,122,105,769,24,179,192,235,15,33,91
"2011","Wiltshire 008A","E01031939","Total",842,174,92,82,668,30,140,133,175,23,67,100
"2011","Wiltshire 008B","E01031940","Total",917,240,116,124,677,20,164,145,173,28,47,100
"2011","Wiltshire 008C","E01031950","Total",536,98,41,57,438,6,93,93,121,25,28,72
"2011","Wiltshire 008D","E01031951","Total",465,77,45,32,388,9,81,92,117,16,32,41
"2011","Wiltshire 009A","E01031907","Total",921,166,40,126,755,35,78,212,215,27,78,110
"2011","Wiltshire 009B","E01031910","Total",586,154,49,105,432,30,65,102,115,13,35,72
"2011","Wiltshire 009C","E01031914","Total",495,126,47,79,369,47,43,76,81,31,35,56
"2011","Wiltshire 009D","E01031915","Total",603,192,101,91,411,17,75,100,126,12,30,51
"2011","Wiltshire 009E","E01031919","Total",593,116,76,40,477,21,114,110,87,25,46,74
"2011","Wiltshire 009F","E01031920","Total",505,131,49,82,374,16,49,96,104,20,23,66
"2011","Wiltshire 010A","E01031905","Total",497,53,9,44,444,18,41,109,110,26,44,96
"2011","Wiltshire 010B","E01031906","Total",643,171,30,141,472,37,40,114,190,17,20,54
"2011","Wiltshire 010C","E01031908","Total",706,221,81,140,485,58,72,90,137,19,33,76
"2011","Wiltshire 010D","E01031909","Total",526,123,67,56,403,16,101,75,100,10,31,70
"2011","Wiltshire 010E","E01031925","Total",495,145,78,67,350,43,75,57,81,20,20,54
"2011","Wiltshire 010F","E01031926","Total",620,164,92,72,456,38,80,101,115,13,34,75
"2011","Wiltshire 010G","E01031927","Total",502,79,48,31,423,12,98,84,104,10,34,81
"2011","Wiltshire 011A","E01031911","Total",572,194,93,101,378,45,45,64,98,24,43,59
"2011","Wiltshire 011B","E01031912","Total",739,361,113,248,378,49,55,74,127,12,9,52
"2011","Wiltshire 011C","E01031913","Total",556,133,53,80,423,16,77,88,140,17,19,66
"2011","Wiltshire 011D","E01031917","Total",673,271,82,189,402,35,52,79,159,10,15,52
"2011","Wiltshire 011E","E01031918","Total",1138,366,205,161,772,41,248,133,209,23,36,82
"2011","Wiltshire 011F","E01031928","Total",613,227,108,119,386,65,66,61,92,11,29,62
"2011","Wiltshire 013A","E01031891","Total",883,162,77,85,721,30,158,122,210,21,54,126
"2011","Wiltshire 013B","E01031904","Total",808,156,80,76,652,29,142,119,161,33,55,113
"2011","Wiltshire 013C","E01031937","Total",444,85,55,30,359,11,81,64,116,12,19,56
"2011","Wiltshire 013D","E01031938","Total",568,120,57,63,448,20,87,101,132,22,29,57
"2011","Wiltshire 014A","E01031916","Total",538,139,80,59,399,27,75,76,98,8,31,84
"2011","Wiltshire 014B","E01031921","Total",533,96,33,63,437,20,31,134,117,18,30,87
"2011","Wiltshire 014C","E01031922","Total",594,226,38,188,368,15,24,92,150,13,18,56
"2011","Wiltshire 014D","E01031923","Total",536,109,30,79,427,16,55,110,127,15,32,72
"2011","Wiltshire 014E","E01031924","Total",666,175,33,142,491,32,26,155,158,15,43,62
"2011","Wiltshire 015A","E01031895","Total",628,150,85,65,478,29,104,93,114,26,42,70
"2011","Wiltshire 015B","E01031896","Total",571,224,90,134,347,53,71,60,83,12,14,54
"2011","Wiltshire 015C","E01031897","Total",842,176,52,124,666,49,108,177,174,32,40,86
"2011","Wiltshire 015D","E01031898","Total",656,179,74,105,477,41,72,102,153,21,26,62
"2011","Wiltshire 015F","E01032690","Total",659,128,15,113,531,41,28,163,170,44,43,42
"2011","Wiltshire 015G","E01032691","Total",595,138,55,83,457,34,53,134,122,27,27,60
"2011","Wiltshire 016A","E01031900","Total",1043,359,197,162,684,26,184,124,212,8,41,89
"2011","Wiltshire 016B","E01031901","Total",645,205,69,136,440,47,78,95,122,16,25,57
"2011","Wiltshire 016C","E01031902","Total",475,129,36,93,346,33,46,63,102,10,33,59
"2011","Wiltshire 016D","E01031903","Total",999,244,124,120,755,34,178,141,225,19,53,105
"2011","Wiltshire 017A","E01031888","Total",574,151,80,71,423,19,105,71,135,18,29,46
"2011","Wiltshire 017B","E01031889","Total",762,185,67,118,577,49,70,155,172,26,31,74
"2011","Wiltshire 017C","E01031890","Total",628,163,90,73,465,19,123,84,115,28,25,71
"2011","Wiltshire 017D","E01031929","Total",548,135,90,45,413,22,104,77,103,17,29,61
"2011","Wiltshire 017E","E01031930","Total",485,56,14,42,429,22,27,153,129,29,26,43
"2011","Wiltshire 018A","E01031931","Total",729,217,128,89,512,25,172,85,111,18,28,73
"2011","Wiltshire 018B","E01031932","Total",667,225,140,85,442,16,134,62,120,5,21,84
"2011","Wiltshire 018C","E01031933","Total",620,153,76,77,467,41,83,108,107,16,32,80
"2011","Wiltshire 018D","E01031941","Total",637,138,59,79,499,39,88,122,124,20,31,75
"2011","Wiltshire 018E","E01031942","Total",549,114,60,54,435,18,110,75,129,12,20,71
"2011","Wiltshire 018F","E01031952","Total",1094,392,180,212,702,85,140,95,199,31,41,111
"2011","Wiltshire 018G","E01031953","Total",1185,272,86,186,913,80,124,237,281,32,60,99
"2011","Wiltshire 045B","E01031988","Total",561,44,3,41,517,14,3,227,192,28,23,30
"2011","Wiltshire 045C","E01031998","Total",719,37,7,30,682,28,3,343,172,56,47,33
"2011","Wiltshire 045D","E01032026","Total",670,154,82,72,516,19,134,100,131,18,33,81
"2011","Wiltshire 045F","E01032696","Total",858,195,88,107,663,29,135,154,187,20,32,106
"2011","Wiltshire 046A","E01031989","Total",577,128,63,65,449,36,70,105,93,30,36,79
"2011","Wiltshire 046B","E01031996","Total",556,129,80,49,427,29,95,62,97,19,36,89
"2011","Wiltshire 046C","E01031997","Total",584,137,44,93,447,26,77,84,124,15,26,95
"2011","Wiltshire 046D","E01031999","Total",650,145,72,73,505,28,117,75,151,14,28,92
"2011","Wiltshire 048A","E01031974","Total",586,179,118,61,407,16,141,58,94,7,22,69
"2011","Wiltshire 048B","E01031975","Total",531,165,98,67,366,32,87,46,79,16,34,72
"2011","Wiltshire 048C","E01031976","Total",490,62,17,45,428,38,20,144,124,32,32,38
"2011","Wiltshire 048D","E01031977","Total",1083,205,55,150,878,71,90,242,244,31,76,124
"2011","Wiltshire 048E","E01031978","Total",693,142,33,109,551,62,40,149,168,20,34,78
"2011","Wiltshire 048F","E01031979","Total",881,270,115,155,611,37,116,108,188,14,34,114
"2011","Wiltshire 049A","E01032013","Total",829,199,109,90,630,23,186,113,159,22,42,85
"2011","Wiltshire 049B","E01032032","Total",662,121,67,54,541,17,169,85,145,13,34,78
"2011","Wiltshire 049C","E01032033","Total",609,134,61,73,475,19,113,93,158,9,25,58
"2011","Wiltshire 049D","E01032034","Total",583,128,87,41,455,19,112,94,123,18,23,66
"2011","Wiltshire 050A","E01032010","Total",931,265,148,117,666,18,201,95,203,31,35,83
"2011","Wiltshire 050B","E01032035","Total",686,172,117,55,514,15,201,63,143,16,23,53
"2011","Wiltshire 050C","E01032036","Total",638,172,99,73,466,22,135,73,123,23,18,72
"2011","Wiltshire 050D","E01032037","Total",698,260,135,125,438,38,124,64,113,21,18,60
"2011","Wiltshire 051A","E01031984","Total",602,105,41,64,497,24,66,144,140,20,39,64
"2011","Wiltshire 051B","E01031985","Total",524,139,73,66,385,38,66,98,93,12,28,50
"2011","Wiltshire 051C","E01031986","Total",603,229,124,105,374,37,95,59,102,15,9,57
"2011","Wiltshire 051D","E01032017","Total",609,147,97,50,462,13,128,84,102,21,27,87
"2011","Wiltshire 052A","E01031980","Total",600,137,49,88,463,42,48,96,127,20,43,87
"2011","Wiltshire 052B","E01031981","Total",619,138,63,75,481,70,58,76,98,30,51,98
"2011","Wiltshire 052C","E01031982","Total",567,126,66,60,441,30,75,77,107,20,42,90
"2011","Wiltshire 052D","E01031983","Total",723,197,60,137,526,103,57,110,115,28,34,79
"2011","Wiltshire 053A","E01032018","Total",634,119,74,45,515,11,141,77,134,18,34,100
"2011","Wiltshire 053B","E01032019","Total",623,222,147,75,401,38,80,72,90,17,31,73
"2011","Wiltshire 053C","E01032020","Total",634,192,111,81,442,21,105,71,116,22,33,74
"2011","Wiltshire 053D","E01032025","Total",626,167,86,81,459,16,93,84,129,14,25,98
"2011","Wiltshire 054A","E01031990","Total",809,185,103,82,624,22,171,112,157,28,39,95
"2011","Wiltshire 054B","E01032004","Total",999,271,150,121,728,37,213,117,199,30,40,92
"2011","Wiltshire 054C","E01032027","Total",612,171,96,75,441,14,139,70,130,6,18,64
"2011","Wiltshire 054D","E01032038","Total",639,209,133,76,430,10,145,58,123,13,12,69
"2011","Wiltshire 054E","E01032039","Total",674,262,121,141,412,32,79,97,138,12,10,44
"2011","Wiltshire 054F","E01032040","Total",625,162,79,83,463,44,112,72,115,19,28,73
"2011","Wiltshire 055A","E01032001","Total",609,154,54,100,455,20,84,106,116,14,29,86
"2011","Wiltshire 055B","E01032002","Total",600,198,71,127,402,24,54,84,145,13,17,65
"2011","Wiltshire 055C","E01032003","Total",734,331,152,179,403,22,66,72,155,10,15,63
"2011","Wiltshire 055D","E01032024","Total",1125,412,109,303,713,66,74,139,281,18,30,105
"2011","Wiltshire 056A","E01032014","Total",865,428,211,217,437,34,81,68,151,16,20,67
"2011","Wiltshire 056B","E01032015","Total",602,202,69,133,400,31,53,63,133,14,26,80
"2011","Wiltshire 056C","E01032016","Total",624,210,66,144,414,21,63,69,154,17,23,67
"2011","Wiltshire 056D","E01032021","Total",700,258,107,151,442,28,80,87,159,8,17,63
"2011","Wiltshire 057A","E01032000","Total",947,261,123,138,686,38,160,131,176,36,50,95
"2011","Wiltshire 057B","E01032011","Total",1022,233,104,129,789,80,123,174,231,35,45,101
"2011","Wiltshire 057C","E01032012","Total",759,188,134,54,571,13,225,90,115,17,29,82
"2011","Wiltshire 058A","E01032008","Total",668,235,140,95,433,22,112,75,100,19,37,68
"2011","Wiltshire 058B","E01032009","Total",836,278,180,98,558,10,193,80,136,21,33,85
"2011","Wiltshire 058C","E01032022","Total",931,488,280,208,443,30,104,51,170,12,11,65
"2011","Wiltshire 059A","E01032005","Total",532,139,80,59,393,15,85,91,103,10,28,61
"2011","Wiltshire 059B","E01032006","Total",510,107,52,55,403,16,86,101,112,11,27,50
"2011","Wiltshire 059C","E01032007","Total",543,139,45,94,404,35,44,107,112,18,26,62
"2011","Wiltshire 059D","E01032023","Total",840,375,207,168,465,61,86,88,117,21,20,72
"2011","Wiltshire 060A","E01031970","Total",658,140,79,61,518,16,137,96,143,13,31,82
"2011","Wiltshire 060B","E01031971","Total",512,140,65,75,372,22,83,56,118,13,29,51
"2011","Wiltshire 060C","E01031972","Total",598,120,71,49,478,23,119,86,124,18,34,74
"2011","Wiltshire 060D","E01032041","Total",784,153,97,56,631,8,199,100,157,23,44,100
"2011","Wiltshire 060E","E01032042","Total",677,143,82,61,534,22,118,94,138,30,54,78
"2011","Wiltshire 061A","E01031991","Total",845,240,123,117,605,25,182,92,179,18,24,85
"2011","Wiltshire 061B","E01032029","Total",605,175,100,75,430,13,119,67,128,20,30,53
"2011","Wiltshire 061C","E01032030","Total",718,261,147,114,457,37,125,77,115,15,27,61
"2011","Wiltshire 061D","E01032031","Total",490,123,73,50,367,6,140,42,105,13,13,48
"2011","Wiltshire 062A","E01031973","Total",720,139,73,66,581,11,164,95,151,31,43,86
"2011","Wiltshire 062B","E01031992","Total",623,132,89,43,491,9,144,73,140,15,29,81
"2011","Wiltshire 062C","E01031993","Total",625,166,109,57,459,25,141,76,100,23,26,68
"2011","Wiltshire 062D","E01031994","Total",512,108,61,47,404,29,87,71,92,16,25,84
"2011","Wiltshire 062E","E01031995","Total",721,207,111,96,514,29,144,92,137,22,20,70
"2011","Wiltshire 020A","E01032063","Total",776,185,86,99,591,58,131,109,139,23,45,86
"2011","Wiltshire 020B","E01032064","Total",508,123,48,75,385,34,59,72,96,28,39,57
"2011","Wiltshire 020C","E01032065","Total",646,164,90,74,482,40,97,100,120,22,33,70
"2011","Wiltshire 020D","E01032073","Total",571,131,43,88,440,48,49,96,132,26,27,62
"2011","Wiltshire 020E","E01032074","Total",532,158,85,73,374,10,146,39,102,3,19,55
"2011","Wiltshire 021A","E01032043","Total",513,123,70,53,390,15,112,70,108,16,22,47
"2011","Wiltshire 021B","E01032044","Total",555,128,89,39,427,10,137,65,107,12,31,65
"2011","Wiltshire 021C","E01032057","Total",492,124,70,54,368,10,88,72,97,12,20,69
"2011","Wiltshire 021D","E01032070","Total",685,216,111,105,469,28,110,72,134,16,30,79
"2011","Wiltshire 021E","E01032071","Total",889,148,69,79,741,32,162,143,198,27,65,114
"2011","Wiltshire 021F","E01032072","Total",738,110,31,79,628,56,63,154,158,30,61,106
"2011","Wiltshire 022A","E01032062","Total",766,361,154,207,405,40,59,75,122,23,27,59
"2011","Wiltshire 022B","E01032066","Total",626,172,67,105,454,38,82,111,113,21,34,55
"2011","Wiltshire 022C","E01032067","Total",653,166,85,81,487,24,142,84,116,17,30,74
"2011","Wiltshire 022D","E01032068","Total",707,327,195,132,380,34,91,69,100,8,23,55
"2011","Wiltshire 022E","E01032069","Total",499,93,49,44,406,26,92,58,105,17,28,80
"2011","Wiltshire 023A","E01032058","Total",595,166,85,81,429,18,103,82,125,18,31,52
"2011","Wiltshire 023B","E01032059","Total",728,168,95,73,560,16,158,112,125,20,43,86
"2011","Wiltshire 023C","E01032060","Total",701,223,148,75,478,18,173,76,104,14,23,70
"2011","Wiltshire 023D","E01032061","Total",514,145,81,64,369,12,112,61,101,15,22,46
"2011","Wiltshire 027A","E01032045","Total",604,133,74,59,471,19,140,89,111,23,27,62
"2011","Wiltshire 027B","E01032046","Total",708,236,137,99,472,33,113,104,118,14,22,68
"2011","Wiltshire 027C","E01032047","Total",608,170,115,55,438,18,142,78,91,12,23,74
"2011","Wiltshire 027D","E01032048","Total",754,239,135,104,515,38,123,101,131,17,36,69
"2011","Wiltshire 027E","E01032049","Total",701,228,123,105,473,18,123,81,132,16,31,72
"2011","Wiltshire 027F","E01032050","Total",911,384,184,200,527,14,159,86,168,13,15,72
"2011","Wiltshire 030A","E01032077","Total",671,131,61,70,540,22,120,99,159,13,33,94
"2011","Wiltshire 030B","E01032078","Total",1173,271,55,216,902,94,102,221,318,32,39,96
"2011","Wiltshire 030C","E01032079","Total",633,164,106,58,469,27,124,68,120,18,36,76
"2011","Wiltshire 030D","E01032080","Total",617,85,37,48,532,26,81,161,135,29,33,67
"2011","Wiltshire 031A","E01032085","Total",670,177,66,111,493,23,54,104,161,13,42,96
"2011","Wiltshire 031B","E01032086","Total",1172,528,131,397,644,84,57,137,216,16,49,85
"2011","Wiltshire 031C","E01032087","Total",936,290,146,144,646,35,165,110,158,19,46,113
"2011","Wiltshire 032A","E01032099","Total",1131,200,75,125,931,71,149,263,267,45,50,86
"2011","Wiltshire 032B","E01032100","Total",654,186,98,88,468,28,117,91,126,14,28,64
"2011","Wiltshire 032C","E01032101","Total",792,323,156,167,469,49,61,84,151,14,27,83
"2011","Wiltshire 032D","E01032102","Total",657,174,120,54,483,19,124,81,136,17,29,77
"2011","Wiltshire 033A","E01032096","Total",758,231,96,135,527,88,82,93,102,31,45,86
"2011","Wiltshire 033B","E01032097","Total",740,155,98,57,585,16,144,93,149,19,52,112
"2011","Wiltshire 033C","E01032098","Total",632,120,63,57,512,25,123,77,111,24,41,111
"2011","Wiltshire 035A","E01032092","Total",621,167,53,114,454,27,72,81,166,8,27,73
"2011","Wiltshire 035B","E01032093","Total",718,178,63,115,540,87,64,120,112,22,70,65
"2011","Wiltshire 035C","E01032094","Total",1009,339,108,231,670,83,79,151,184,37,47,89
"2011","Wiltshire 035D","E01032095","Total",669,127,49,78,542,40,91,112,151,27,26,95
"2011","Wiltshire 036A","E01032088","Total",632,157,99,58,475,29,119,75,116,23,31,82
"2011","Wiltshire 036B","E01032089","Total",655,204,52,152,451,29,43,108,177,12,23,59
"2011","Wiltshire 036C","E01032090","Total",616,180,88,92,436,21,91,94,110,17,28,75
"2011","Wiltshire 036D","E01032091","Total",544,166,53,113,378,44,77,76,97,13,21,50
"2011","Wiltshire 037A","E01032053","Total",583,125,72,53,458,23,126,67,121,20,35,66
"2011","Wiltshire 037B","E01032083","Total",916,196,92,104,720,31,179,132,192,33,47,106
"2011","Wiltshire 037C","E01032084","Total",1085,240,122,118,845,38,243,150,229,34,37,114
"2011","Wiltshire 039A","E01032052","Total",562,140,72,68,422,11,113,63,135,7,20,73
"2011","Wiltshire 039B","E01032054","Total",519,124,61,63,395,30,93,62,106,20,27,57
"2011","Wiltshire 039C","E01032055","Total",542,116,74,42,426,6,136,65,134,10,17,58
"2011","Wiltshire 039D","E01032056","Total",548,124,57,67,424,30,98,87,111,19,22,57
"2011","Wiltshire 039E","E01032121","Total",694,198,103,95,496,21,139,95,134,20,26,61
"2011","Wiltshire 040A","E01032115","Total",825,334,160,174,491,52,92,88,141,7,41,70
"2011","Wiltshire 040B","E01032116","Total",1063,251,113,138,812,54,163,177,222,33,48,115
"2011","Wiltshire 040C","E01032117","Total",1014,212,81,131,802,78,102,214,211,29,44,124
"2011","Wiltshire 040D","E01032118","Total",564,114,56,58,450,60,65,88,83,23,57,74
"2011","Wiltshire 040E","E01032119","Total",926,350,100,250,576,77,86,118,215,11,14,55
"2011","Wiltshire 040G","E01032694","Total",601,94,14,80,507,70,29,141,147,22,43,55
"2011","Wiltshire 040H","E01032695","Total",602,154,78,76,448,11,109,71,143,20,29,65
"2011","Wiltshire 042A","E01032104","Total",510,150,84,66,360,43,68,66,72,18,27,66
"2011","Wiltshire 042B","E01032105","Total",667,182,117,65,485,17,163,66,136,8,22,73
"2011","Wiltshire 042C","E01032107","Total",493,44,5,39,449,18,6,212,109,43,33,28
"2011","Wiltshire 042D","E01032108","Total",620,232,153,79,388,10,111,59,120,19,21,48
"2011","Wiltshire 043A","E01032110","Total",696,155,94,61,541,26,162,92,148,14,24,75
"2011","Wiltshire 043B","E01032111","Total",547,154,74,80,393,34,83,69,98,10,26,73
"2011","Wiltshire 043C","E01032112","Total",618,160,52,108,458,41,52,95,157,16,31,66
"2011","Wiltshire 043D","E01032113","Total",601,169,83,86,432,32,90,77,121,12,22,78
"2011","Wiltshire 044A","E01032103","Total",874,367,177,190,507,42,119,57,178,9,32,70
"2011","Wiltshire 044B","E01032106","Total",595,148,101,47,447,20,146,56,107,11,30,77
"2011","Wiltshire 044C","E01032109","Total",676,236,94,142,440,31,97,87,120,14,25,66
"2011","Wiltshire 044D","E01032114","Total",646,259,124,135,387,44,78,57,117,10,24,57
"2011","Wiltshire 047A","E01032051","Total",582,144,76,68,438,9,132,79,129,12,25,52
"2011","Wiltshire 047B","E01032075","Total",584,153,81,72,431,21,128,65,118,12,26,61
"2011","Wiltshire 047C","E01032076","Total",533,146,81,65,387,15,110,65,103,8,26,60
"2011","Wiltshire 047D","E01032081","Total",540,158,73,85,382,12,105,53,116,11,23,62
"2011","Wiltshire 047E","E01032082","Total",523,134,70,64,389,13,99,63,119,11,19,65
"2011","East Devon 001A","E01019902","Total",917,285,158,127,632,22,248,108,137,16,40,61
"2011","East Devon 001B","E01019938","Total",905,192,119,73,713,18,224,86,180,30,45,130
"2011","East Devon 001C","E01019967","Total",541,123,61,62,418,10,137,61,102,15,33,60
"2011","East Devon 002A","E01019927","Total",625,275,155,120,350,27,75,63,106,15,14,50
"2011","East Devon 002B","E01019932","Total",819,354,178,176,465,27,123,69,134,6,33,73
"2011","East Devon 002C","E01019933","Total",604,239,125,114,365,18,106,67,105,13,13,43
"2011","East Devon 002D","E01019934","Total",825,234,166,68,591,21,223,67,139,15,34,92
"2011","East Devon 003A","E01019928","Total",597,157,86,71,440,37,80,74,123,16,34,76
"2011","East Devon 003B","E01019929","Total",625,169,79,90,456,30,91,100,131,16,22,66
"2011","East Devon 003C","E01019930","Total",667,212,152,60,455,22,156,81,119,11,11,55
"2011","East Devon 003D","E01019931","Total",532,124,58,66,408,8,128,82,99,7,32,52
"2011","East Devon 004A","E01019925","Total",522,125,69,56,397,14,82,97,96,13,28,67
"2011","East Devon 004D","E01019959","Total",485,121,69,52,364,13,110,61,93,16,20,51
"2011","East Devon 004E","E01019960","Total",530,92,50,42,438,12,96,73,131,23,30,73
"2011","East Devon 004F","E01019962","Total",961,196,113,83,765,23,183,146,208,19,63,123
"2011","East Devon 004G","E01032628","Total",851,211,118,93,640,23,173,110,168,25,42,99
"2011","East Devon 005A","E01019886","Total",1112,304,163,141,808,44,237,124,187,40,55,121
"2011","East Devon 005B","E01019887","Total",654,222,121,101,432,40,116,69,116,16,30,45
"2011","East Devon 005C","E01019888","Total",817,369,199,170,448,22,134,61,149,6,19,57
"2011","East Devon 005D","E01019889","Total",657,192,121,71,465,14,172,65,95,20,32,67
"2011","East Devon 005E","E01019966","Total",471,124,86,38,347,11,133,45,74,14,19,51
"2011","East Devon 006A","E01019891","Total",574,125,62,63,449,16,93,79,125,8,34,94
"2011","East Devon 006B","E01019892","Total",617,161,78,83,456,17,94,92,121,19,36,77
"2011","East Devon 006C","E01019893","Total",728,165,76,89,563,20,139,104,148,28,49,75
"2011","East Devon 006D","E01019903","Total",891,253,139,114,638,17,185,88,177,32,39,100
"2011","East Devon 007A","E01019899","Total",629,220,141,79,409,27,131,55,91,15,27,63
"2011","East Devon 007B","E01019900","Total",812,220,161,59,592,14,259,72,124,20,30,73
"2011","East Devon 007C","E01019935","Total",563,153,104,49,410,10,165,38,98,12,20,67
"2011","East Devon 007D","E01019936","Total",507,149,93,56,358,16,135,39,90,11,23,44
"2011","East Devon 007E","E01019961","Total",1093,292,168,124,801,22,266,110,208,23,48,124
"2011","East Devon 008A","E01019939","Total",628,138,99,39,490,13,183,76,105,20,31,62
"2011","East Devon 008B","E01019940","Total",659,150,109,41,509,7,211,67,106,16,44,58
"2011","East Devon 008C","E01019942","Total",796,257,128,129,539,36,151,106,119,23,29,75
"2011","East Devon 008D","E01019943","Total",630,135,88,47,495,17,146,82,99,19,46,86
"2011","East Devon 008E","E01019944","Total",685,235,117,118,450,27,102,94,109,22,33,63
"2011","East Devon 009A","E01019890","Total",821,241,140,101,580,18,182,74,148,17,33,108
"2011","East Devon 009B","E01019901","Total",579,157,85,72,422,8,152,57,95,19,31,60
"2011","East Devon 009C","E01019951","Total",975,263,176,87,712,11,315,77,167,13,41,88
"2011","East Devon 010A","E01019946","Total",645,177,121,56,468,12,239,49,97,3,16,52
"2011","East Devon 010B","E01019947","Total",982,526,283,243,456,23,168,57,121,12,24,51
"2011","East Devon 010C","E01019948","Total",637,226,171,55,411,10,195,47,88,9,14,48
"2011","East Devon 010D","E01019949","Total",703,234,156,78,469,20,212,49,118,11,16,43
"2011","East Devon 010E","E01019950","Total",597,212,137,75,385,13,167,57,81,12,17,38
"2011","East Devon 011A","E01019952","Total",842,297,208,89,545,35,216,72,112,7,20,83
"2011","East Devon 011B","E01019953","Total",727,209,160,49,518,16,250,54,93,14,17,74
"2011","East Devon 011C","E01019954","Total",688,218,118,100,470,50,136,77,106,16,17,68
"2011","East Devon 011D","E01019955","Total",775,281,190,91,494,19,174,77,101,14,27,82
"2011","East Devon 012A","E01019956","Total",879,425,273,152,454,19,175,57,132,9,18,44
"2011","East Devon 012B","E01019957","Total",918,396,331,65,522,4,337,34,82,5,9,51
"2011","East Devon 012C","E01019958","Total",809,238,176,62,571,11,256,70,105,23,34,72
"2011","East Devon 013A","E01019937","Total",928,248,168,80,680,23,230,96,168,21,41,101
"2011","East Devon 013B","E01019945","Total",835,203,103,100,632,29,156,87,181,29,33,117
"2011","East Devon 013C","E01019963","Total",709,215,116,99,494,30,126,97,127,32,20,62
"2011","East Devon 014A","E01019898","Total",1023,251,148,103,772,20,261,100,198,18,45,130
"2011","East Devon 014B","E01019964","Total",428,89,56,33,339,9,114,50,83,12,17,54
"2011","East Devon 014C","E01019965","Total",773,221,139,82,552,32,154,125,138,19,26,58
"2011","East Devon 015A","E01019904","Total",603,193,113,80,410,26,118,72,89,23,20,62
"2011","East Devon 015B","E01019905","Total",743,112,61,51,631,14,146,113,162,22,59,115
"2011","East Devon 015C","E01019906","Total",658,192,99,93,466,28,119,91,126,9,18,75
"2011","East Devon 015D","E01019907","Total",675,181,131,50,494,19,183,81,119,12,26,54
"2011","East Devon 016A","E01019908","Total",709,160,40,120,549,52,58,151,162,19,35,72
"2011","East Devon 016B","E01019909","Total",813,243,174,69,570,6,213,84,131,19,36,81
"2011","East Devon 016C","E01019910","Total",668,155,92,63,513,15,133,89,140,14,37,85
"2011","East Devon 016D","E01019911","Total",783,283,194,89,500,10,224,57,119,6,16,68
"2011","East Devon 017A","E01019894","Total",786,325,243,82,461,6,269,42,99,5,12,28
"2011","East Devon 017B","E01019895","Total",656,198,148,50,458,9,222,54,89,15,17,52
"2011","East Devon 017C","E01019896","Total",757,269,192,77,488,10,234,53,102,14,29,46
"2011","East Devon 017D","E01019897","Total",697,242,146,96,455,41,99,109,106,15,22,63
"2011","East Devon 018A","E01019920","Total",626,173,68,105,453,49,79,82,122,16,23,82
"2011","East Devon 018B","E01019921","Total",635,133,85,48,502,24,131,93,130,18,28,78
"2011","East Devon 018C","E01019922","Total",643,240,144,96,403,26,104,65,82,17,34,75
"2011","East Devon 018D","E01019923","Total",534,152,83,69,382,27,103,58,97,12,28,57
"2011","East Devon 018E","E01019924","Total",605,128,46,82,477,52,60,93,135,17,35,85
"2011","East Devon 019A","E01019916","Total",952,404,146,258,548,72,49,99,221,19,21,67
"2011","East Devon 019B","E01019917","Total",650,194,90,104,456,31,66,105,134,10,33,77
"2011","East Devon 019C","E01019918","Total",948,430,111,319,518,43,111,74,187,10,24,69
"2011","East Devon 019D","E01019919","Total",778,261,117,144,517,58,78,96,162,10,35,78
"2011","East Devon 020A","E01019912","Total",855,385,228,157,470,25,148,76,129,6,19,67
"2011","East Devon 020B","E01019913","Total",794,351,256,95,443,4,248,29,97,8,19,38
"2011","East Devon 020C","E01019914","Total",948,302,175,127,646,54,151,88,168,34,49,102
"2011","East Devon 020D","E01019915","Total",753,263,182,81,490,14,197,65,98,13,36,67
"2011","Exeter 001C","E01019998","Total",608,165,78,87,443,14,83,94,149,14,27,62
"2011","Exeter 001D","E01019999","Total",503,128,66,62,375,7,87,53,90,17,26,95
"2011","Exeter 001E","E01020001","Total",601,173,64,109,428,13,106,59,148,6,24,72
"2011","Exeter 001F","E01033233","Total",969,275,131,144,694,18,242,75,171,13,30,145
"2011","Exeter 002A","E01019990","Total",607,208,64,144,399,73,58,77,98,13,12,68
"2011","Exeter 002B","E01019991","Total",620,179,65,114,441,65,63,102,96,14,33,68
"2011","Exeter 002C","E01019993","Total",497,118,41,77,379,13,75,69,116,3,25,78
"2011","Exeter 002D","E01020000","Total",604,238,114,124,366,23,72,67,90,18,29,67
"2011","Exeter 002E","E01020007","Total",507,142,24,118,365,14,15,47,69,4,17,199
"2011","Exeter 003A","E01019992","Total",616,163,81,82,453,24,90,87,123,17,26,86
"2011","Exeter 003B","E01020002","Total",638,184,95,89,454,53,99,84,97,12,27,82
"2011","Exeter 003C","E01020003","Total",695,178,126,52,517,26,168,83,110,17,30,83
"2011","Exeter 003D","E01020004","Total",631,164,88,76,467,22,101,105,134,8,25,72
"2011","Exeter 003E","E01020005","Total",704,169,83,86,535,52,115,90,112,32,57,77
"2011","Exeter 004A","E01019997","Total",620,224,42,182,396,14,21,47,127,5,10,172
"2011","Exeter 004B","E01020019","Total",558,194,76,118,364,10,27,12,79,5,14,217
"2011","Exeter 004C","E01020020","Total",599,246,31,215,353,14,28,40,108,4,12,147
"2011","Exeter 004D","E01020021","Total",536,152,33,119,384,14,60,36,107,8,10,149
"2011","Exeter 004E","E01020022","Total",673,292,53,239,381,29,21,41,124,5,11,150
"2011","Exeter 005A","E01019980","Total",738,226,55,171,512,63,40,112,183,16,36,62
"2011","Exeter 005B","E01019982","Total",727,222,27,195,505,54,28,106,219,20,26,52
"2011","Exeter 005C","E01019983","Total",626,166,84,82,460,26,119,70,123,14,29,79
"2011","Exeter 005D","E01019984","Total",549,112,36,76,437,19,65,97,138,12,24,82
"2011","Exeter 005E","E01019985","Total",579,167,68,99,412,66,43,88,97,22,25,71
"2011","Exeter 006A","E01019987","Total",648,276,102,174,372,18,64,72,114,6,20,78
"2011","Exeter 006B","E01019989","Total",528,175,76,99,353,29,40,81,125,11,15,52
"2011","Exeter 006C","E01020006","Total",785,194,76,118,591,38,65,101,163,25,43,156
"2011","Exeter 006D","E01020008","Total",607,170,41,129,437,16,20,57,92,6,23,223
"2011","Exeter 006E","E01020009","Total",615,189,48,141,426,12,49,103,125,18,21,98
"2011","Exeter 007A","E01019986","Total",627,175,93,82,452,14,91,94,125,18,25,85
"2011","Exeter 007B","E01020036","Total",655,232,136,96,423,34,80,89,97,19,23,81
"2011","Exeter 007C","E01020037","Total",602,193,97,96,409,63,79,69,93,19,24,62
"2011","Exeter 007D","E01020039","Total",839,284,164,120,555,68,107,128,128,16,30,78
"2011","Exeter 007E","E01020040","Total",582,195,92,103,387,17,80,82,101,8,26,73
"2011","Exeter 008A","E01019994","Total",659,293,88,205,366,26,27,51,121,10,11,120
"2011","Exeter 008B","E01019995","Total",816,495,183,312,321,49,38,32,108,5,11,78
"2011","Exeter 008C","E01020016","Total",1166,682,151,531,484,41,69,53,240,3,11,67
"2011","Exeter 008D","E01020017","Total",1009,464,70,394,545,58,36,74,230,8,17,122
"2011","Exeter 008E","E01020018","Total",1116,604,184,420,512,45,62,40,265,4,15,81
"2011","Exeter 009A","E01019996","Total",563,280,69,211,283,19,36,36,119,8,13,52
"2011","Exeter 009B","E01020023","Total",1004,350,136,214,654,36,126,154,197,20,29,92
"2011","Exeter 009C","E01020024","Total",667,237,113,124,430,17,100,100,115,20,22,56
"2011","Exeter 009D","E01020025","Total",759,339,84,255,420,32,33,79,201,7,14,54
"2011","Exeter 010A","E01019975","Total",500,108,55,53,392,39,54,79,85,23,36,76
"2011","Exeter 010B","E01020029","Total",661,182,73,109,479,21,69,105,130,15,35,104
"2011","Exeter 010C","E01020030","Total",889,349,124,225,540,58,51,115,201,10,17,88
"2011","Exeter 010D","E01020031","Total",645,159,67,92,486,34,79,104,139,14,36,80
"2011","Exeter 010E","E01020032","Total",622,220,61,159,402,18,61,61,133,13,31,85
"2011","Exeter 011A","E01020026","Total",742,179,111,68,563,17,144,107,162,6,35,92
"2011","Exeter 011B","E01020027","Total",695,214,86,128,481,35,80,85,147,14,21,99
"2011","Exeter 011D","E01020035","Total",669,160,83,77,509,35,100,107,163,15,26,63
"2011","Exeter 011E","E01020038","Total",606,150,72,78,456,20,92,82,133,12,33,84
"2011","Exeter 011F","E01033232","Total",619,155,24,131,464,36,34,133,178,9,27,47
"2011","Exeter 011G","E01033234","Total",608,160,35,125,448,35,55,107,150,20,24,57
"2011","Exeter 012A","E01019973","Total",616,182,101,81,434,23,116,71,94,14,36,80
"2011","Exeter 012B","E01019974","Total",648,208,101,107,440,15,119,75,124,15,20,72
"2011","Exeter 012C","E01019976","Total",555,161,104,57,394,10,132,68,92,11,23,58
"2011","Exeter 012D","E01019977","Total",612,173,106,67,439,21,98,76,109,13,41,81
"2011","Exeter 012E","E01019981","Total",599,162,57,105,437,52,64,86,112,16,33,74
"2011","Exeter 013A","E01019988","Total",645,233,146,87,412,22,105,93,77,16,23,76
"2011","Exeter 013B","E01020010","Total",742,217,94,123,525,53,71,109,135,44,42,71
"2011","Exeter 013C","E01020013","Total",558,176,62,114,382,22,73,61,128,14,26,58
"2011","Exeter 013D","E01020014","Total",651,216,89,127,435,54,49,72,105,19,46,90
"2011","Exeter 013E","E01020015","Total",717,200,65,135,517,74,46,96,132,34,46,89
"2011","Exeter 014A","E01019968","Total",703,219,141,78,484,21,142,87,133,11,14,76
"2011","Exeter 014B","E01019969","Total",612,236,102,134,376,16,81,54,125,16,23,61
"2011","Exeter 014C","E01019970","Total",529,141,66,75,388,26,55,101,110,10,25,61
"2011","Exeter 014D","E01019971","Total",801,317,66,251,484,42,44,65,244,7,17,65
"2011","Exeter 014E","E01019972","Total",602,182,39,143,420,49,45,86,137,10,28,65
"2011","Exeter 015A","E01020011","Total",514,127,81,46,387,12,107,50,95,12,28,83
"2011","Exeter 015B","E01020012","Total",621,192,83,109,429,45,57,73,118,15,39,82
"2011","Exeter 015C","E01020033","Total",739,248,175,73,491,21,182,71,98,23,35,61
"2011","Exeter 015E","E01033235","Total",711,367,233,134,344,15,103,64,115,5,9,33
"2011","Exeter 015F","E01033236","Total",559,250,138,112,309,12,115,35,100,9,10,28
"2011","Mid Devon 001A","E01020046","Total",625,130,60,70,495,20,107,85,139,23,35,86
"2011","Mid Devon 001B","E01020049","Total",547,115,62,53,432,10,127,60,125,14,20,76
"2011","Mid Devon 001C","E01020050","Total",953,265,140,125,688,31,222,99,212,15,31,78
"2011","Mid Devon 001D","E01020077","Total",622,117,64,53,505,12,120,100,117,20,42,94
"2011","Mid Devon 002A","E01020047","Total",956,292,179,113,664,33,186,116,188,22,31,88
"2011","Mid Devon 002B","E01020051","Total",826,217,137,80,609,13,239,76,158,15,33,75
"2011","Mid Devon 002C","E01020066","Total",1115,232,86,146,883,62,156,206,245,40,69,105
"2011","Mid Devon 002D","E01020080","Total",536,125,78,47,411,12,139,48,101,15,26,70
"2011","Mid Devon 003A","E01020063","Total",1049,309,193,116,740,32,163,163,195,27,48,112
"2011","Mid Devon 003B","E01020074","Total",876,201,96,105,675,21,164,124,177,28,49,112
"2011","Mid Devon 003C","E01020075","Total",790,198,100,98,592,35,156,102,141,17,51,90
"2011","Mid Devon 004A","E01020052","Total",867,365,146,219,502,42,103,99,161,20,29,48
"2011","Mid Devon 004B","E01020053","Total",606,161,80,81,445,31,110,74,110,34,25,61
"2011","Mid Devon 004C","E01020065","Total",758,216,82,134,542,53,102,111,148,27,23,78
"2011","Mid Devon 004D","E01020067","Total",784,218,97,121,566,66,84,127,133,43,45,68
"2011","Mid Devon 005A","E01020048","Total",965,361,116,245,604,60,82,117,203,15,31,96
"2011","Mid Devon 005B","E01020078","Total",653,290,149,141,363,27,62,68,94,18,27,67
"2011","Mid Devon 005C","E01020079","Total",603,209,118,91,394,27,86,86,108,17,23,47
"2011","Mid Devon 005D","E01020081","Total",513,107,67,40,406,27,111,74,87,22,23,62
"2011","Mid Devon 006A","E01020045","Total",665,138,91,47,527,26,124,89,147,17,37,87
"2011","Mid Devon 006B","E01020059","Total",825,185,92,93,640,21,145,129,159,40,46,100
"2011","Mid Devon 006C","E01020062","Total",643,141,85,56,502,19,138,80,132,15,41,77
"2011","Mid Devon 006D","E01020064","Total",725,193,93,100,532,25,102,128,129,21,47,80
"2011","Mid Devon 007A","E01020054","Total",840,183,74,109,657,29,122,162,180,20,40,104
"2011","Mid Devon 007B","E01020055","Total",789,252,128,124,537,38,88,102,156,26,31,96
"2011","Mid Devon 007C","E01020057","Total",757,250,116,134,507,34,90,104,140,20,34,85
"2011","Mid Devon 007D","E01020058","Total",837,237,100,137,600,21,148,133,169,13,48,68
"2011","Mid Devon 008A","E01020043","Total",831,219,96,123,612,50,132,129,152,35,38,76
"2011","Mid Devon 008B","E01020044","Total",671,175,105,70,496,12,122,89,134,24,33,82
"2011","Mid Devon 008C","E01020056","Total",803,184,97,87,619,16,143,124,154,26,42,114
"2011","Mid Devon 008D","E01020071","Total",839,261,143,118,578,29,147,104,151,29,27,91
"2011","Mid Devon 009A","E01020072","Total",676,145,71,74,531,23,137,77,154,23,33,84
"2011","Mid Devon 009B","E01020073","Total",715,206,128,78,509,14,153,57,133,17,33,102
"2011","Mid Devon 009C","E01020076","Total",699,178,91,87,521,20,113,91,158,24,32,83
"2011","Mid Devon 009D","E01020082","Total",481,117,62,55,364,18,89,49,102,12,23,71
"2011","Mid Devon 010A","E01020068","Total",655,180,85,95,475,13,138,78,127,19,22,78
"2011","Mid Devon 010B","E01020069","Total",597,133,66,67,464,15,102,76,124,28,37,82
"2011","Mid Devon 010C","E01020070","Total",760,170,93,77,590,17,166,83,147,31,44,102
"2011","Mid Devon 010D","E01020083","Total",910,185,83,102,725,34,147,153,191,27,66,107
"2011","Mid Devon 011A","E01020041","Total",916,267,82,185,649,59,109,129,179,29,37,107
"2011","Mid Devon 011B","E01020042","Total",726,207,99,108,519,22,141,94,133,15,28,86
"2011","Mid Devon 011C","E01020060","Total",888,416,223,193,472,36,119,73,161,12,18,53
"2011","Mid Devon 011D","E01020061","Total",866,245,121,124,621,44,137,126,154,19,39,102
"2011","North Devon 001A","E01020111","Total",667,262,111,151,405,63,75,66,103,12,30,56
"2011","North Devon 001B","E01020112","Total",799,397,129,268,402,43,61,80,143,10,26,39
"2011","North Devon 001C","E01020114","Total",502,144,57,87,358,23,70,74,95,11,30,55
"2011","North Devon 001D","E01020115","Total",523,141,76,65,382,19,107,64,102,8,21,61
"2011","North Devon 002A","E01020099","Total",600,146,102,44,454,21,151,49,130,12,35,56
"2011","North Devon 002B","E01020100","Total",464,137,82,55,327,10,105,45,71,5,29,62
"2011","North Devon 002C","E01020101","Total",642,207,103,104,435,25,118,61,97,17,34,83
"2011","North Devon 002D","E01020126","Total",715,240,114,126,475,15,157,67,149,8,30,49
"2011","North Devon 003A","E01020113","Total",644,272,87,185,372,53,80,60,92,15,26,46
"2011","North Devon 003B","E01020116","Total",685,208,99,109,477,27,92,86,126,17,40,89
"2011","North Devon 003C","E01020117","Total",670,180,99,81,490,17,135,76,147,13,23,79
"2011","North Devon 003D","E01020118","Total",542,140,54,86,402,43,63,82,97,22,37,58
"2011","North Devon 004A","E01020090","Total",676,137,85,52,539,14,157,79,126,25,29,109
"2011","North Devon 004B","E01020108","Total",964,264,113,151,700,30,207,107,173,26,49,108
"2011","North Devon 004C","E01020109","Total",620,189,95,94,431,11,113,82,109,12,40,64
"2011","North Devon 005A","E01020089","Total",960,236,129,107,724,40,173,151,186,15,38,121
"2011","North Devon 005B","E01020091","Total",574,172,97,75,402,11,117,76,91,13,21,73
"2011","North Devon 005C","E01020092","Total",634,173,134,39,461,10,193,62,92,7,27,70
"2011","North Devon 005D","E01020093","Total",708,312,175,137,396,28,96,76,101,19,20,56
"2011","North Devon 005E","E01020110","Total",841,176,109,67,665,34,113,193,175,51,33,66
"2011","North Devon 006A","E01020088","Total",819,172,85,87,647,25,164,107,162,35,45,109
"2011","North Devon 006B","E01020120","Total",737,155,84,71,582,16,154,114,132,23,51,92
"2011","North Devon 006C","E01020127","Total",717,136,61,75,581,12,148,80,154,24,63,100
"2011","North Devon 007A","E01020132","Total",827,283,170,113,544,24,134,95,157,20,33,81
"2011","North Devon 007B","E01020133","Total",624,158,66,92,466,21,94,84,147,21,29,70
"2011","North Devon 007C","E01020134","Total",495,161,67,94,334,31,56,67,91,15,24,50
"2011","North Devon 007D","E01020139","Total",625,219,119,100,406,29,74,62,109,18,19,95
"2011","North Devon 008A","E01020094","Total",1012,621,261,360,391,36,79,47,137,11,24,57
"2011","North Devon 008B","E01020095","Total",658,229,85,144,429,45,68,76,121,17,36,66
"2011","North Devon 008C","E01020140","Total",516,150,91,59,366,14,113,59,71,9,24,76
"2011","North Devon 008D","E01020141","Total",710,171,57,114,539,98,66,91,143,26,40,75
"2011","North Devon 009A","E01020096","Total",864,427,163,264,437,48,91,61,120,16,23,78
"2011","North Devon 009B","E01020123","Total",601,161,114,47,440,27,122,57,93,13,45,83
"2011","North Devon 009C","E01020124","Total",592,185,94,91,407,16,118,48,99,12,30,84
"2011","North Devon 009D","E01020125","Total",597,156,99,57,441,12,169,57,119,6,18,60
"2011","North Devon 010A","E01020102","Total",654,125,46,79,529,45,65,126,154,18,46,75
"2011","North Devon 010B","E01020103","Total",569,146,66,80,423,60,57,89,77,25,42,73
"2011","North Devon 010C","E01020104","Total",577,142,28,114,435,85,28,81,131,19,34,57
"2011","North Devon 010D","E01020128","Total",522,111,59,52,411,8,136,60,97,18,22,70
"2011","North Devon 010E","E01020129","Total",523,170,80,90,353,34,73,59,85,11,29,62
"2011","North Devon 010F","E01020130","Total",687,249,68,181,438,35,45,97,141,23,27,70
"2011","North Devon 011A","E01020105","Total",616,144,83,61,472,36,128,70,104,20,38,76
"2011","North Devon 011B","E01020106","Total",513,129,100,29,384,8,157,44,89,6,15,65
"2011","North Devon 011C","E01020107","Total",708,186,132,54,522,10,192,73,122,19,29,77
"2011","North Devon 011D","E01020119","Total",673,194,120,74,479,17,151,63,134,10,25,79
"2011","North Devon 012A","E01020084","Total",672,190,108,82,482,39,137,86,124,13,27,56
"2011","North Devon 012B","E01020085","Total",628,144,54,90,484,31,70,135,143,23,25,57
"2011","North Devon 012C","E01020086","Total",638,141,85,56,497,15,164,85,116,15,27,75
"2011","North Devon 012D","E01020121","Total",794,195,95,100,599,29,142,106,153,24,53,92
"2011","North Devon 012E","E01020122","Total",694,139,73,66,555,16,164,79,142,11,48,95
"2011","North Devon 013A","E01020097","Total",913,205,111,94,708,18,209,108,174,23,51,125
"2011","North Devon 013B","E01020131","Total",882,226,112,114,656,32,163,89,189,27,50,106
"2011","North Devon 013C","E01020135","Total",697,224,128,96,473,32,106,108,120,17,23,67
"2011","North Devon 013D","E01020136","Total",775,223,128,95,552,33,159,92,148,17,31,72
"2011","North Devon 013E","E01020137","Total",699,263,131,132,436,31,79,77,130,13,28,78
"2011","North Devon 014A","E01020087","Total",840,236,151,85,604,18,201,70,165,22,36,92
"2011","North Devon 014B","E01020098","Total",921,256,142,114,665,31,206,82,178,19,54,95
"2011","North Devon 014C","E01020138","Total",982,291,154,137,691,20,207,103,165,32,55,109
"2011","South Hams 001A","E01020144","Total",616,124,23,101,492,35,40,134,166,12,29,76
"2011","South Hams 001B","E01020145","Total",749,174,74,100,575,26,128,95,168,17,33,108
"2011","South Hams 001C","E01020146","Total",525,175,37,138,350,21,43,68,149,9,21,39
"2011","South Hams 001D","E01020149","Total",527,134,74,60,393,29,86,59,134,8,25,52
"2011","South Hams 002A","E01020148","Total",483,137,68,69,346,14,83,63,97,10,26,53
"2011","South Hams 002B","E01020157","Total",941,240,115,125,701,19,179,114,192,26,62,109
"2011","South Hams 002C","E01020160","Total",754,161,80,81,593,29,123,112,171,24,42,92
"2011","South Hams 002D","E01020176","Total",505,160,85,75,345,14,92,46,102,13,26,52
"2011","South Hams 002E","E01020177","Total",602,199,116,83,403,21,102,63,92,22,25,78
"2011","South Hams 003A","E01020180","Total",834,278,142,136,556,48,121,87,138,24,36,102
"2011","South Hams 003B","E01020181","Total",778,263,175,88,515,35,143,81,124,18,36,78
"2011","South Hams 003C","E01020182","Total",624,176,73,103,448,53,64,84,131,15,26,75
"2011","South Hams 003D","E01020183","Total",766,388,164,224,378,33,85,64,121,7,14,54
"2011","South Hams 003E","E01020184","Total",846,400,201,199,446,33,98,76,135,8,35,61
"2011","South Hams 004A","E01020153","Total",615,213,115,98,402,12,147,34,135,9,18,47
"2011","South Hams 004B","E01020156","Total",836,234,143,91,602,20,205,88,151,25,31,82
"2011","South Hams 004C","E01020170","Total",942,254,175,79,688,24,199,115,181,11,41,117
"2011","South Hams 004D","E01020188","Total",837,220,104,116,617,21,163,78,187,20,50,98
"2011","South Hams 005A","E01020161","Total",1074,369,234,135,705,45,168,153,172,25,49,93
"2011","South Hams 005B","E01020162","Total",644,121,45,76,523,37,81,120,135,14,32,104
"2011","South Hams 005C","E01020163","Total",679,128,64,64,551,30,90,138,129,21,43,100
"2011","South Hams 005D","E01020164","Total",643,181,89,92,462,28,73,104,129,16,34,78
"2011","South Hams 005E","E01020165","Total",621,146,47,99,475,48,58,116,136,18,22,77
"2011","South Hams 005F","E01020166","Total",577,118,58,60,459,17,99,98,124,10,30,81
"2011","South Hams 005G","E01020167","Total",503,85,48,37,418,23,66,98,94,19,35,83
"2011","South Hams 006A","E01020142","Total",973,270,135,135,703,21,181,124,204,35,39,99
"2011","South Hams 006B","E01020143","Total",933,240,106,134,693,33,144,108,210,28,44,126
"2011","South Hams 006C","E01020150","Total",749,239,119,120,510,22,137,89,120,18,35,89
"2011","South Hams 007A","E01020151","Total",796,269,157,112,527,10,205,61,169,8,11,63
"2011","South Hams 007B","E01020152","Total",857,427,235,192,430,16,158,32,171,2,8,43
"2011","South Hams 007C","E01020154","Total",500,103,51,52,397,42,62,80,86,16,36,75
"2011","South Hams 007D","E01020155","Total",482,184,66,118,298,28,67,50,77,14,21,41
"2011","South Hams 008A","E01020147","Total",869,241,115,126,628,12,191,89,194,13,29,100
"2011","South Hams 008B","E01020158","Total",745,219,129,90,526,21,140,103,138,16,33,75
"2011","South Hams 008C","E01020159","Total",597,164,74,90,433,17,106,68,116,24,31,71
"2011","South Hams 008D","E01020190","Total",900,256,153,103,644,28,201,107,157,27,41,83
"2011","South Hams 009A","E01020171","Total",853,256,143,113,597,15,244,61,151,19,29,78
"2011","South Hams 009B","E01020185","Total",594,160,102,58,434,8,153,70,113,7,21,62
"2011","South Hams 009C","E01020186","Total",691,187,124,63,504,11,220,44,143,8,18,60
"2011","South Hams 009D","E01020187","Total",736,203,96,107,533,31,136,110,135,21,27,73
"2011","South Hams 010A","E01020168","Total",924,271,179,92,653,27,231,106,148,16,29,96
"2011","South Hams 010B","E01020169","Total",1067,369,171,198,698,52,140,142,213,18,38,95
"2011","South Hams 010C","E01020189","Total",989,417,219,198,572,39,148,85,150,15,54,81
"2011","South Hams 011A","E01020174","Total",724,232,135,97,492,14,185,54,135,12,30,62
"2011","South Hams 011B","E01020175","Total",926,294,195,99,632,16,281,60,149,17,39,70
"2011","South Hams 011C","E01020178","Total",900,260,174,86,640,28,272,68,144,18,26,84
"2011","South Hams 012A","E01020172","Total",855,294,173,121,561,20,194,74,173,12,26,62
"2011","South Hams 012B","E01020173","Total",800,334,188,146,466,24,184,38,132,13,18,57
"2011","South Hams 012C","E01020179","Total",877,275,185,90,602,18,240,62,162,14,35,71
"2011","Teignbridge 001A","E01020243","Total",498,125,68,57,373,13,87,58,117,13,27,58
"2011","Teignbridge 001B","E01020262","Total",506,119,58,61,387,7,120,43,104,9,29,75
"2011","Teignbridge 001C","E01020263","Total",691,212,142,70,479,11,206,50,108,17,24,63
"2011","Teignbridge 001D","E01020274","Total",536,129,46,83,407,7,106,65,114,20,27,68
"2011","Teignbridge 002A","E01020240","Total",671,208,135,73,463,16,109,91,138,14,23,72
"2011","Teignbridge 002B","E01020241","Total",738,185,74,111,553,27,116,107,179,23,31,70
"2011","Teignbridge 002C","E01020242","Total",587,132,62,70,455,19,95,130,121,10,25,55
"2011","Teignbridge 002D","E01020244","Total",640,224,133,91,416,26,85,78,124,17,36,50
"2011","Teignbridge 002E","E01020245","Total",696,178,92,86,518,14,123,93,156,11,35,86
"2011","Teignbridge 003A","E01020205","Total",612,150,77,73,462,6,150,66,139,13,31,57
"2011","Teignbridge 003B","E01020258","Total",727,209,107,102,518,24,133,89,130,13,29,100
"2011","Teignbridge 003C","E01020259","Total",491,135,62,73,356,8,104,46,113,8,22,55
"2011","Teignbridge 003D","E01020273","Total",595,146,80,66,449,14,132,76,123,21,26,57
"2011","Teignbridge 004A","E01020203","Total",794,272,195,77,522,6,211,92,118,21,12,62
"2011","Teignbridge 004B","E01020206","Total",710,237,129,108,473,32,114,92,146,15,22,52
"2011","Teignbridge 004C","E01020220","Total",542,144,75,69,398,23,79,74,106,13,26,77
"2011","Teignbridge 004D","E01020221","Total",710,168,65,103,542,26,105,111,148,26,28,98
"2011","Teignbridge 004E","E01020222","Total",539,161,62,99,378,19,76,92,99,14,19,59
"2011","Teignbridge 004F","E01020223","Total",743,191,81,110,552,19,141,98,162,20,40,72
"2011","Teignbridge 005A","E01020229","Total",750,223,129,94,527,22,193,59,124,11,28,90
"2011","Teignbridge 005B","E01020230","Total",740,227,110,117,513,22,129,67,157,15,26,97
"2011","Teignbridge 005C","E01020231","Total",639,192,124,68,447,13,146,81,101,13,33,60
"2011","Teignbridge 005D","E01020232","Total",630,152,82,70,478,31,82,101,108,26,53,77
"2011","Teignbridge 006A","E01020228","Total",945,488,255,233,457,41,145,48,147,8,16,52
"2011","Teignbridge 006B","E01020233","Total",832,261,167,94,571,18,243,59,149,7,24,71
"2011","Teignbridge 006C","E01020234","Total",598,166,84,82,432,32,97,68,97,17,32,89
"2011","Teignbridge 006D","E01020235","Total",841,326,181,145,515,38,176,72,113,9,29,78
"2011","Teignbridge 007A","E01020202","Total",734,231,163,68,503,12,240,54,106,19,17,55
"2011","Teignbridge 007B","E01020204","Total",624,143,33,110,481,39,52,135,146,18,28,63
"2011","Teignbridge 007C","E01020236","Total",539,133,91,42,406,7,128,60,105,14,32,60
"2011","Teignbridge 007D","E01020237","Total",637,138,78,60,499,22,115,93,128,15,33,93
"2011","Teignbridge 008A","E01020265","Total",749,176,109,67,573,21,184,93,149,10,27,89
"2011","Teignbridge 008B","E01020266","Total",671,155,77,78,516,20,124,90,142,19,29,92
"2011","Teignbridge 008C","E01020267","Total",646,188,94,94,458,18,132,69,132,13,34,60
"2011","Teignbridge 008D","E01020268","Total",641,167,114,53,474,9,211,56,114,6,20,58
"2011","Teignbridge 008E","E01020270","Total",716,200,92,108,516,31,138,87,140,20,24,76
"2011","Teignbridge 009A","E01020250","Total",695,205,136,69,490,15,128,90,126,11,28,92
"2011","Teignbridge 009B","E01020252","Total",639,221,100,121,418,42,88,88,128,12,15,45
"2011","Teignbridge 009C","E01020253","Total",593,138,41,97,455,39,61,141,102,13,34,65
"2011","Teignbridge 009D","E01020254","Total",557,144,84,60,413,39,85,55,114,14,35,71
"2011","Teignbridge 009E","E01020255","Total",568,158,98,60,410,25,108,71,97,13,25,71
"2011","Teignbridge 009F","E01020257","Total",501,117,65,52,384,13,97,67,95,13,25,74
"2011","Teignbridge 010A","E01020264","Total",677,298,143,155,379,34,97,42,120,8,22,56
"2011","Teignbridge 010B","E01020269","Total",1158,682,332,350,476,40,170,54,144,4,11,53
"2011","Teignbridge 010C","E01020271","Total",674,240,120,120,434,51,64,73,116,20,36,74
"2011","Teignbridge 010D","E01020272","Total",759,202,81,121,557,72,87,119,115,31,43,90
"2011","Teignbridge 011A","E01020200","Total",521,161,85,76,360,11,125,43,104,6,10,61
"2011","Teignbridge 011B","E01020201","Total",695,218,125,93,477,14,190,48,140,21,10,54
"2011","Teignbridge 011C","E01020251","Total",576,127,44,83,449,17,93,85,125,18,37,74
"2011","Teignbridge 011D","E01020260","Total",628,219,125,94,409,23,173,39,107,14,14,39
"2011","Teignbridge 011E","E01020261","Total",526,145,84,61,381,10,117,58,109,13,28,46
"2011","Teignbridge 012A","E01020208","Total",523,152,90,62,371,37,69,65,82,19,26,73
"2011","Teignbridge 012B","E01020209","Total",627,183,97,86,444,34,85,100,126,6,32,61
"2011","Teignbridge 012C","E01020210","Total",499,109,66,43,390,7,102,48,115,7,24,87
"2011","Teignbridge 012D","E01020219","Total",845,219,82,137,626,51,97,128,176,23,48,103
"2011","Teignbridge 013A","E01020191","Total",431,115,51,64,316,9,79,52,105,5,22,44
"2011","Teignbridge 013B","E01020194","Total",589,122,60,62,467,29,106,95,109,7,31,90
"2011","Teignbridge 013C","E01020207","Total",427,89,41,48,338,28,61,65,93,8,25,58
"2011","Teignbridge 013D","E01020256","Total",602,169,81,88,433,27,111,91,133,10,18,43
"2011","Teignbridge 014A","E01020211","Total",675,244,115,129,431,51,52,91,114,21,28,74
"2011","Teignbridge 014B","E01020217","Total",879,431,202,229,448,52,82,89,139,7,18,61
"2011","Teignbridge 014C","E01020218","Total",746,330,127,203,416,45,50,83,140,8,27,63
"2011","Teignbridge 014D","E01020224","Total",521,149,48,101,372,39,37,90,108,18,18,62
"2011","Teignbridge 015A","E01020216","Total",675,206,88,118,469,65,67,89,105,25,40,78
"2011","Teignbridge 015B","E01020225","Total",603,256,85,171,347,46,40,68,100,14,25,54
"2011","Teignbridge 015C","E01020226","Total",469,112,54,58,357,9,93,57,91,11,25,71
"2011","Teignbridge 015D","E01020227","Total",643,243,159,84,400,26,94,74,93,13,28,72
"2011","Teignbridge 016A","E01020212","Total",497,127,60,67,370,27,74,69,94,16,30,60
"2011","Teignbridge 016B","E01020213","Total",637,175,92,83,462,30,121,67,133,11,28,72
"2011","Teignbridge 016C","E01020214","Total",674,181,122,59,493,11,136,75,130,17,31,93
"2011","Teignbridge 016D","E01020215","Total",575,120,77,43,455,4,166,61,102,8,35,79
"2011","Teignbridge 017A","E01020195","Total",716,184,92,92,532,28,140,77,122,23,52,90
"2011","Teignbridge 017B","E01020196","Total",794,301,125,176,493,43,116,84,136,17,27,70
"2011","Teignbridge 017C","E01020197","Total",543,140,87,53,403,10,121,56,111,10,19,76
"2011","Teignbridge 017D","E01020198","Total",618,208,88,120,410,55,67,82,98,16,25,67
"2011","Teignbridge 017E","E01020199","Total",711,223,88,135,488,46,98,95,130,25,25,69
"2011","Teignbridge 018A","E01020246","Total",460,108,47,61,352,15,74,66,105,8,16,68
"2011","Teignbridge 018B","E01020247","Total",689,219,123,96,470,29,125,67,101,25,37,86
"2011","Teignbridge 018C","E01020248","Total",701,171,88,83,530,13,158,88,149,13,31,78
"2011","Teignbridge 018D","E01020249","Total",612,185,124,61,427,12,149,58,104,10,27,67
"2011","Teignbridge 019A","E01020192","Total",648,147,84,63,501,10,170,80,123,20,29,69
"2011","Teignbridge 019B","E01020193","Total",571,135,66,69,436,15,101,84,103,22,36,75
"2011","Teignbridge 019C","E01020238","Total",538,174,96,78,364,14,104,67,87,14,21,57
"2011","Teignbridge 019D","E01020239","Total",540,129,87,42,411,12,137,62,105,16,21,58
"2011","Torridge 001A","E01020275","Total",672,273,143,130,399,38,99,53,126,9,15,59
"2011","Torridge 001B","E01020276","Total",682,190,118,72,492,15,184,71,116,21,20,65
"2011","Torridge 001C","E01020297","Total",765,292,173,119,473,59,123,86,121,10,22,52
"2011","Torridge 001D","E01020299","Total",908,336,165,171,572,22,199,74,173,7,20,77
"2011","Torridge 002A","E01020298","Total",940,305,206,99,635,25,257,98,150,12,22,71
"2011","Torridge 002B","E01020300","Total",738,183,103,80,555,22,187,64,154,8,26,94
"2011","Torridge 002C","E01020310","Total",1089,446,187,259,643,35,256,64,177,9,22,80
"2011","Torridge 003A","E01020280","Total",1166,581,142,439,585,78,75,121,213,12,31,55
"2011","Torridge 003B","E01020281","Total",794,187,103,84,607,26,154,106,169,13,37,102
"2011","Torridge 003C","E01020282","Total",802,359,196,163,443,34,114,73,107,19,25,71
"2011","Torridge 004A","E01020277","Total",859,287,134,153,572,64,108,105,131,42,45,77
"2011","Torridge 004B","E01020278","Total",637,117,53,64,520,19,108,103,144,10,38,98
"2011","Torridge 004C","E01020279","Total",993,260,86,174,733,63,122,136,242,30,46,94
"2011","Torridge 004D","E01020283","Total",653,211,112,99,442,31,135,60,118,8,26,64
"2011","Torridge 004E","E01020284","Total",827,252,73,179,575,51,103,124,152,24,39,82
"2011","Torridge 004F","E01020285","Total",824,230,106,124,594,68,89,122,145,24,50,96
"2011","Torridge 005A","E01020288","Total",709,205,86,119,504,20,152,62,129,24,31,86
"2011","Torridge 005B","E01020292","Total",646,198,109,89,448,17,131,65,114,13,35,73
"2011","Torridge 005C","E01020295","Total",669,157,102,55,512,14,156,73,122,18,44,85
"2011","Torridge 005D","E01020296","Total",616,131,66,65,485,16,150,64,121,20,37,77
"2011","Torridge 006A","E01020304","Total",739,233,130,103,506,35,124,91,118,17,38,83
"2011","Torridge 006B","E01020305","Total",524,217,81,136,307,30,66,49,92,7,22,41
"2011","Torridge 006C","E01020306","Total",521,133,74,59,388,20,93,86,95,14,19,61
"2011","Torridge 006D","E01020307","Total",654,177,91,86,477,48,94,101,89,29,38,78
"2011","Torridge 007A","E01020287","Total",650,175,83,92,475,14,149,56,122,9,36,89
"2011","Torridge 007B","E01020303","Total",754,230,138,92,524,17,171,61,154,15,34,72
"2011","Torridge 007C","E01020308","Total",703,159,85,74,544,8,144,80,162,12,44,94
"2011","Torridge 007D","E01020311","Total",940,271,140,131,669,19,206,108,205,23,34,74
"2011","Torridge 008A","E01020291","Total",640,167,70,97,473,19,125,68,102,16,41,102
"2011","Torridge 008B","E01020293","Total",938,263,121,142,675,31,162,111,184,25,55,107
"2011","Torridge 008C","E01020294","Total",761,244,156,88,517,28,145,100,137,15,24,68
"2011","Torridge 008D","E01020302","Total",680,140,69,71,540,18,146,69,132,28,38,109
"2011","Torridge 008E","E01020309","Total",663,122,75,47,541,11,144,70,140,19,49,108
"2011","Torridge 009A","E01020286","Total",670,162,77,85,508,15,144,84,118,25,32,90
"2011","Torridge 009B","E01020289","Total",659,151,86,65,508,9,162,48,152,12,38,87
"2011","Torridge 009C","E01020290","Total",711,182,100,82,529,13,157,71,147,18,42,81
"2011","Torridge 009D","E01020301","Total",790,176,88,88,614,14,175,80,161,28,54,102
"2011","West Devon 001A","E01020320","Total",706,171,94,77,535,11,186,53,136,21,35,93
"2011","West Devon 001B","E01020321","Total",905,240,114,126,665,26,160,111,191,30,51,96
"2011","West Devon 001C","E01020322","Total",798,148,78,70,650,13,198,73,166,27,63,110
"2011","West Devon 001D","E01020326","Total",863,237,132,105,626,33,122,125,190,23,35,98
"2011","West Devon 002A","E01020327","Total",807,216,102,114,591,24,174,117,168,21,24,63
"2011","West Devon 002B","E01020328","Total",934,251,93,158,683,59,91,173,185,32,46,97
"2011","West Devon 002C","E01020329","Total",671,197,105,92,474,16,138,54,142,14,32,78
"2011","West Devon 002D","E01020330","Total",830,322,164,158,508,37,127,91,113,23,38,79
"2011","West Devon 003A","E01020318","Total",685,231,128,103,454,23,161,72,107,12,22,57
"2011","West Devon 003B","E01020319","Total",679,167,89,78,512,20,127,77,148,15,36,89
"2011","West Devon 003C","E01020323","Total",642,146,86,60,496,20,91,78,167,25,25,90
"2011","West Devon 003D","E01020339","Total",704,173,94,79,531,22,124,81,160,14,47,83
"2011","West Devon 004A","E01020314","Total",662,153,81,72,509,14,161,74,137,15,40,68
"2011","West Devon 004B","E01020325","Total",643,125,55,70,518,22,128,84,131,22,35,96
"2011","West Devon 004C","E01020331","Total",628,150,77,73,478,23,111,75,133,21,39,76
"2011","West Devon 004D","E01020340","Total",706,178,92,86,528,16,144,79,138,18,43,90
"2011","West Devon 005A","E01020332","Total",932,442,170,272,490,22,104,61,168,20,37,78
"2011","West Devon 005B","E01020333","Total",811,191,107,84,620,29,168,104,176,21,34,88
"2011","West Devon 005C","E01020334","Total",840,277,123,154,563,47,124,90,177,20,39,66
"2011","West Devon 005D","E01020335","Total",668,206,135,71,462,14,183,51,88,17,25,84
"2011","West Devon 005E","E01020336","Total",606,145,102,43,461,5,189,53,108,13,28,65
"2011","West Devon 005F","E01020337","Total",581,243,128,115,338,18,80,69,92,9,21,49
"2011","West Devon 005G","E01020338","Total",1029,319,154,165,710,65,140,165,185,24,34,97
"2011","West Devon 006A","E01020317","Total",648,162,91,71,486,13,171,71,135,14,17,65
"2011","West Devon 006B","E01020324","Total",661,188,113,75,473,11,137,59,136,11,33,86
"2011","West Devon 006C","E01020341","Total",668,146,79,67,522,12,173,68,145,15,29,80
"2011","West Devon 006D","E01020342","Total",653,191,89,102,462,29,96,88,129,20,33,67
"2011","West Devon 007A","E01020312","Total",714,184,112,72,530,14,173,57,177,12,24,73
"2011","West Devon 007B","E01020313","Total",632,203,94,109,429,29,102,77,118,16,23,64
"2011","West Devon 007C","E01020315","Total",645,219,109,110,426,21,100,73,116,24,25,67
"2011","West Devon 007D","E01020316","Total",774,193,118,75,581,17,166,104,139,24,37,94
"2011","Christchurch 001A","E01020343","Total",641,170,113,57,471,8,137,65,111,12,30,108
"2011","Christchurch 001B","E01020344","Total",562,123,37,86,439,25,60,104,113,21,38,78
"2011","Christchurch 001C","E01020345","Total",528,136,79,57,392,15,114,57,108,5,21,72
"2011","Christchurch 001D","E01020365","Total",709,201,143,58,508,11,198,68,109,9,29,84
"2011","Christchurch 002A","E01020351","Total",511,106,66,40,405,9,111,83,85,17,38,62
"2011","Christchurch 002B","E01020352","Total",518,120,84,36,398,16,98,85,72,20,35,72
"2011","Christchurch 002C","E01020353","Total",674,196,123,73,478,33,120,87,90,19,53,76
"2011","Christchurch 002D","E01020359","Total",496,109,56,53,387,24,67,92,88,19,34,63
"2011","Christchurch 002E","E01020366","Total",906,240,166,74,666,5,251,113,120,24,50,103
"2011","Christchurch 003A","E01020349","Total",1046,568,457,111,478,13,272,36,97,6,13,41
"2011","Christchurch 003B","E01020350","Total",919,342,285,57,577,10,349,32,109,9,20,48
"2011","Christchurch 003C","E01020357","Total",867,206,128,78,661,24,200,106,131,22,52,126
"2011","Christchurch 003D","E01020358","Total",671,166,130,36,505,10,225,68,86,12,31,73
"2011","Christchurch 004A","E01020369","Total",630,217,163,54,413,18,164,41,96,11,19,64
"2011","Christchurch 004B","E01020370","Total",649,193,99,94,456,17,110,100,111,12,28,78
"2011","Christchurch 004C","E01020371","Total",742,224,182,42,518,5,271,45,85,14,22,76
"2011","Christchurch 004D","E01020372","Total",606,206,131,75,400,12,178,47,88,10,22,43
"2011","Christchurch 005A","E01020346","Total",704,251,146,105,453,29,101,84,97,21,32,89
"2011","Christchurch 005B","E01020347","Total",740,287,97,190,453,45,59,83,129,19,40,78
"2011","Christchurch 005C","E01020348","Total",633,166,81,85,467,33,77,77,96,34,51,99
"2011","Christchurch 005D","E01020363","Total",499,143,47,96,356,28,51,76,112,14,34,41
"2011","Christchurch 006A","E01020360","Total",654,212,128,84,442,24,89,102,105,23,35,64
"2011","Christchurch 006B","E01020361","Total",647,153,66,87,494,33,93,125,130,18,37,58
"2011","Christchurch 006C","E01020364","Total",773,292,150,142,481,31,132,97,128,7,27,59
"2011","Christchurch 006D","E01020367","Total",913,332,190,142,581,29,202,85,144,12,29,80
"2011","Christchurch 006E","E01020368","Total",1145,479,306,173,666,31,174,124,171,21,39,106
"2011","Christchurch 007A","E01020354","Total",719,266,148,118,453,28,144,79,102,12,17,71
"2011","Christchurch 007B","E01020355","Total",913,270,208,62,643,7,326,60,138,13,25,74
"2011","Christchurch 007C","E01020356","Total",782,276,201,75,506,9,234,58,121,6,19,59
"2011","Christchurch 007D","E01020362","Total",678,206,154,52,472,12,193,60,101,7,30,69
"2011","East Dorset 001A","E01020373","Total",495,93,51,42,402,25,61,98,106,27,28,57
"2011","East Dorset 001B","E01020374","Total",646,132,96,36,514,13,153,89,144,12,25,78
"2011","East Dorset 001C","E01020389","Total",851,179,96,83,672,18,146,112,177,32,54,133
"2011","East Dorset 001D","E01020397","Total",613,163,97,66,450,8,107,88,136,14,23,74
"2011","East Dorset 002A","E01020416","Total",674,217,65,152,457,44,71,121,143,10,20,48
"2011","East Dorset 002B","E01020417","Total",447,98,58,40,349,13,90,70,96,8,21,51
"2011","East Dorset 002C","E01020418","Total",673,173,147,26,500,4,234,67,100,8,24,63
"2011","East Dorset 002D","E01020419","Total",776,146,100,46,630,20,191,135,159,14,35,76
"2011","East Dorset 002E","E01020420","Total",526,102,60,42,424,11,128,91,88,19,28,59
"2011","East Dorset 003A","E01020411","Total",422,76,40,36,346,22,87,60,79,18,19,61
"2011","East Dorset 003B","E01020412","Total",567,126,69,57,441,40,67,89,114,28,40,63
"2011","East Dorset 003C","E01020413","Total",571,93,63,30,478,9,143,129,92,13,31,61
"2011","East Dorset 003D","E01020414","Total",808,192,120,72,616,28,166,146,121,22,41,92
"2011","East Dorset 003E","E01020415","Total",597,95,64,31,502,11,148,96,103,15,29,100
"2011","East Dorset 004A","E01020403","Total",628,148,96,52,480,5,183,40,121,12,37,82
"2011","East Dorset 004B","E01020404","Total",689,149,102,47,540,13,226,54,135,8,24,80
"2011","East Dorset 004C","E01020405","Total",675,172,108,64,503,5,205,55,133,4,31,70
"2011","East Dorset 004D","E01020406","Total",1048,220,160,60,828,8,410,61,184,15,23,127
"2011","East Dorset 005A","E01020396","Total",450,93,44,49,357,9,101,62,101,12,13,59
"2011","East Dorset 005B","E01020398","Total",913,174,101,73,739,10,218,102,187,31,49,142
"2011","East Dorset 005C","E01020409","Total",482,91,48,43,391,8,81,69,118,18,28,69
"2011","East Dorset 005D","E01020410","Total",528,132,76,56,396,17,75,63,113,17,32,79
"2011","East Dorset 006A","E01020421","Total",529,98,74,24,431,17,138,81,93,13,24,65
"2011","East Dorset 006B","E01020422","Total",867,358,274,84,509,19,250,56,112,7,6,59
"2011","East Dorset 006C","E01020423","Total",637,146,103,43,491,18,195,61,101,5,23,88
"2011","East Dorset 006D","E01020424","Total",643,171,117,54,472,18,185,59,115,5,25,65
"2011","East Dorset 006E","E01020425","Total",816,268,197,71,548,21,253,74,106,11,15,68
"2011","East Dorset 007A","E01020377","Total",631,104,58,46,527,15,131,113,119,15,34,100
"2011","East Dorset 007B","E01020379","Total",642,172,108,64,470,18,155,67,115,17,27,71
"2011","East Dorset 007C","E01020380","Total",447,95,57,38,352,3,99,56,97,11,25,61
"2011","East Dorset 007D","E01020381","Total",503,94,65,29,409,6,137,61,102,11,31,61
"2011","East Dorset 008A","E01020390","Total",732,280,212,68,452,16,236,34,101,8,8,49
"2011","East Dorset 008B","E01020391","Total",668,169,122,47,499,8,224,50,119,10,18,70
"2011","East Dorset 008C","E01020392","Total",786,360,264,96,426,8,189,52,91,5,25,56
"2011","East Dorset 008D","E01020393","Total",563,115,28,87,448,50,29,104,94,34,43,94
"2011","East Dorset 008E","E01020394","Total",820,272,206,66,548,25,222,54,125,19,28,75
"2011","East Dorset 009A","E01020375","Total",642,197,122,75,445,11,144,82,112,6,16,74
"2011","East Dorset 009B","E01020376","Total",483,121,87,34,362,15,128,39,83,6,19,72
"2011","East Dorset 009C","E01020378","Total",634,142,74,68,492,22,129,85,118,15,22,101
"2011","East Dorset 009D","E01020407","Total",518,119,90,29,399,9,151,53,91,14,17,64
"2011","East Dorset 009E","E01020408","Total",480,114,72,42,366,13,112,39,106,7,24,65
"2011","East Dorset 010A","E01020426","Total",806,247,155,92,559,32,198,90,130,12,30,67
"2011","East Dorset 010B","E01020427","Total",725,246,143,103,479,37,121,97,94,26,23,81
"2011","East Dorset 010C","E01020428","Total",1095,561,341,220,534,37,161,79,175,10,21,51
"2011","East Dorset 010D","E01020429","Total",796,334,167,167,462,35,82,95,131,20,24,75
"2011","East Dorset 011A","E01020395","Total",904,325,250,75,579,7,299,41,121,8,18,85
"2011","East Dorset 011B","E01020399","Total",1014,235,148,87,779,24,214,158,175,22,52,134
"2011","East Dorset 011C","E01020400","Total",671,145,103,42,526,5,211,55,107,8,47,93
"2011","East Dorset 011D","E01020401","Total",722,221,172,49,501,5,254,51,78,9,28,76
"2011","East Dorset 011E","E01020402","Total",633,129,87,42,504,7,169,74,106,17,25,106
"2011","East Dorset 012A","E01020382","Total",628,152,69,83,476,25,94,88,134,14,36,85
"2011","East Dorset 012B","E01020383","Total",741,169,109,60,572,9,198,94,111,16,41,103
"2011","East Dorset 012C","E01020384","Total",638,105,51,54,533,37,80,141,105,20,45,105
"2011","East Dorset 012D","E01020385","Total",481,112,47,65,369,22,72,73,77,23,27,75
"2011","East Dorset 012E","E01020386","Total",477,91,53,38,386,14,100,71,97,16,22,66
"2011","East Dorset 012F","E01020387","Total",470,102,80,22,368,4,120,57,90,11,21,65
"2011","East Dorset 012G","E01020388","Total",643,187,87,100,456,42,89,94,105,19,33,74
"2011","North Dorset 001A","E01020443","Total",1106,373,140,233,733,61,96,137,246,33,43,117
"2011","North Dorset 001B","E01020447","Total",846,310,218,92,536,21,196,77,126,14,22,80
"2011","North Dorset 001C","E01020463","Total",756,246,141,105,510,15,149,93,130,24,30,69
"2011","North Dorset 001D","E01020464","Total",691,219,133,86,472,18,167,83,114,13,21,56
"2011","North Dorset 002A","E01020440","Total",826,187,103,84,639,13,209,78,183,19,32,105
"2011","North Dorset 002B","E01020450","Total",956,226,116,110,730,39,156,154,210,30,40,101
"2011","North Dorset 002D","E01020462","Total",767,193,102,91,574,10,191,74,149,21,47,82
"2011","North Dorset 002E","E01033156","Total",656,126,45,81,530,29,80,147,148,35,29,62
"2011","North Dorset 002F","E01033158","Total",564,154,91,63,410,13,119,81,98,13,23,63
"2011","North Dorset 003A","E01020454","Total",968,400,225,175,568,37,128,101,146,24,44,88
"2011","North Dorset 003B","E01020455","Total",780,203,89,114,577,25,118,149,150,23,33,79
"2011","North Dorset 003C","E01020456","Total",761,218,68,150,543,36,99,106,158,27,30,87
"2011","North Dorset 003D","E01020457","Total",726,273,161,112,453,15,159,68,127,8,13,63
"2011","North Dorset 004A","E01020433","Total",745,177,83,94,568,23,165,99,133,16,35,97
"2011","North Dorset 004B","E01020434","Total",788,246,165,81,542,26,169,86,119,22,27,93
"2011","North Dorset 004C","E01020449","Total",905,268,182,86,637,13,248,72,141,29,32,102
"2011","North Dorset 004D","E01020458","Total",940,239,135,104,701,26,210,106,200,24,41,94
"2011","North Dorset 004E","E01020459","Total",1167,396,203,193,771,54,188,134,211,34,53,97
"2011","North Dorset 005A","E01020444","Total",752,196,102,94,556,32,140,81,156,21,23,103
"2011","North Dorset 005B","E01020445","Total",513,156,88,68,357,12,122,63,89,18,18,35
"2011","North Dorset 005C","E01020446","Total",652,177,116,61,475,15,171,66,122,15,23,63
"2011","North Dorset 005D","E01020460","Total",842,207,120,87,635,13,214,83,160,22,37,106
"2011","North Dorset 006A","E01020442","Total",888,224,111,113,664,21,199,114,186,18,25,101
"2011","North Dorset 006B","E01020452","Total",826,239,108,131,587,22,124,110,166,32,34,99
"2011","North Dorset 006C","E01020453","Total",716,159,82,77,557,20,149,92,161,11,38,86
"2011","North Dorset 006E","E01033154","Total",469,27,6,21,442,16,14,217,111,38,17,29
"2011","North Dorset 006F","E01033159","Total",429,74,41,33,355,10,71,79,112,22,15,46
"2011","North Dorset 007A","E01020435","Total",782,219,89,130,563,20,89,98,207,16,28,105
"2011","North Dorset 007B","E01020436","Total",809,164,47,117,645,28,102,144,200,29,59,83
"2011","North Dorset 007C","E01020437","Total",774,178,101,77,596,28,152,89,157,24,41,105
"2011","North Dorset 007D","E01020438","Total",1086,563,248,315,523,44,133,81,180,8,18,59
"2011","North Dorset 007E","E01020439","Total",987,327,155,172,660,34,119,152,185,28,32,110
"2011","North Dorset 008A","E01020430","Total",618,140,75,65,478,15,150,68,138,19,30,58
"2011","North Dorset 008B","E01020431","Total",438,109,52,57,329,7,85,57,100,16,22,42
"2011","North Dorset 008C","E01020432","Total",539,139,68,71,400,9,111,65,117,12,26,60
"2011","North Dorset 008D","E01020441","Total",786,176,90,86,610,23,155,97,181,22,32,100
"2011","North Dorset 008E","E01020448","Total",816,167,83,84,649,25,183,95,190,20,40,96
"2011","Purbeck 001A","E01020465","Total",883,262,144,118,621,30,148,106,198,14,30,95
"2011","Purbeck 001B","E01020469","Total",840,269,149,120,571,36,118,110,149,30,42,86
"2011","Purbeck 001C","E01020470","Total",740,129,81,48,611,12,191,91,176,14,41,86
"2011","Purbeck 002A","E01020471","Total",537,123,50,73,414,37,50,96,99,30,38,64
"2011","Purbeck 002B","E01020472","Total",604,172,104,68,432,39,95,77,106,10,30,75
"2011","Purbeck 002C","E01020473","Total",640,160,84,76,480,32,119,70,144,13,21,81
"2011","Purbeck 002D","E01020474","Total",746,198,123,75,548,13,173,80,142,15,29,96
"2011","Purbeck 002E","E01020475","Total",845,210,122,88,635,27,151,130,139,19,39,130
"2011","Purbeck 003A","E01020476","Total",544,137,81,56,407,10,130,61,109,5,25,67
"2011","Purbeck 003B","E01020477","Total",589,108,67,41,481,26,112,89,92,21,37,104
"2011","Purbeck 003C","E01020485","Total",745,310,205,105,435,36,144,46,123,2,21,63
"2011","Purbeck 003D","E01020486","Total",643,235,144,91,408,16,144,63,100,6,22,57
"2011","Purbeck 003E","E01020487","Total",516,113,53,60,403,15,91,56,99,18,38,86
"2011","Purbeck 003F","E01020488","Total",653,202,111,91,451,16,118,89,126,13,21,68
"2011","Purbeck 004A","E01020489","Total",581,157,73,84,424,9,113,83,99,16,31,73
"2011","Purbeck 004B","E01020490","Total",717,205,108,97,512,14,145,77,147,19,24,86
"2011","Purbeck 004C","E01020491","Total",669,179,87,92,490,26,120,84,131,20,27,82
"2011","Purbeck 004D","E01020492","Total",538,176,122,54,362,14,117,52,95,7,17,60
"2011","Purbeck 004E","E01020493","Total",808,124,40,84,684,52,50,203,171,62,54,92
"2011","Purbeck 005A","E01020466","Total",794,241,151,90,553,12,191,66,132,21,34,97
"2011","Purbeck 005B","E01020467","Total",781,205,112,93,576,21,184,86,157,18,32,78
"2011","Purbeck 005C","E01020468","Total",666,183,101,82,483,11,189,45,128,20,21,69
"2011","Purbeck 006A","E01020478","Total",477,149,99,50,328,11,96,56,86,9,25,45
"2011","Purbeck 006B","E01020479","Total",648,317,210,107,331,10,145,39,89,7,7,34
"2011","Purbeck 006C","E01020480","Total",730,262,179,83,468,8,236,36,100,10,21,57
"2011","Purbeck 006D","E01020481","Total",748,281,118,163,467,15,146,55,156,7,27,61
"2011","Purbeck 006E","E01020482","Total",778,297,169,128,481,22,121,80,140,14,26,78
"2011","Purbeck 006F","E01020483","Total",498,114,52,62,384,20,86,61,88,20,28,81
"2011","Purbeck 006G","E01020484","Total",625,181,114,67,444,26,136,61,101,14,30,76
"2011","West Dorset 001A","E01020542","Total",665,264,163,101,401,13,146,63,108,3,18,50
"2011","West Dorset 001B","E01020543","Total",614,182,97,85,432,53,104,89,95,18,24,49
"2011","West Dorset 001C","E01020544","Total",821,436,276,160,385,20,144,54,90,15,14,48
"2011","West Dorset 001E","E01020546","Total",582,321,164,157,261,14,88,35,77,6,13,28
"2011","West Dorset 001F","E01020547","Total",510,169,90,79,341,22,75,69,90,11,23,51
"2011","West Dorset 001H","E01032642","Total",1021,342,224,118,679,23,271,92,154,13,43,83
"2011","West Dorset 002A","E01020497","Total",811,198,132,66,613,15,195,102,145,24,41,91
"2011","West Dorset 002B","E01020508","Total",840,208,117,91,632,17,226,81,155,14,38,101
"2011","West Dorset 002C","E01020541","Total",863,214,114,100,649,15,209,106,160,29,33,97
"2011","West Dorset 002D","E01020550","Total",712,202,131,71,510,10,174,71,132,14,25,84
"2011","West Dorset 003A","E01020494","Total",490,126,79,47,364,11,106,66,93,14,25,49
"2011","West Dorset 003B","E01020495","Total",665,214,126,88,451,25,170,68,102,14,17,55
"2011","West Dorset 003C","E01020496","Total",792,327,207,120,465,30,181,50,99,22,24,59
"2011","West Dorset 003D","E01020506","Total",771,220,124,96,551,14,191,73,151,11,37,74
"2011","West Dorset 003E","E01020530","Total",785,188,97,91,597,13,194,76,173,19,35,87
"2011","West Dorset 003F","E01020534","Total",905,239,114,125,666,26,161,103,230,31,31,84
"2011","West Dorset 004A","E01020509","Total",1146,273,166,107,873,26,265,165,204,32,58,123
"2011","West Dorset 004B","E01020510","Total",901,309,160,149,592,37,170,89,146,25,28,97
"2011","West Dorset 004C","E01020529","Total",974,260,109,151,714,27,210,125,193,24,36,99
"2011","West Dorset 004D","E01020539","Total",856,226,115,111,630,11,155,117,188,21,35,103
"2011","West Dorset 004E","E01020540","Total",1048,261,149,112,787,25,202,155,228,21,51,105
"2011","West Dorset 005A","E01020511","Total",815,296,189,107,519,19,223,68,112,13,28,56
"2011","West Dorset 005B","E01020532","Total",835,342,195,147,493,19,221,50,139,5,16,43
"2011","West Dorset 005C","E01020533","Total",935,321,202,119,614,46,189,92,143,23,43,78
"2011","West Dorset 005D","E01020535","Total",753,203,114,89,550,11,183,74,148,23,32,79
"2011","West Dorset 006A","E01020498","Total",933,303,174,129,630,24,209,93,167,23,26,88
"2011","West Dorset 006B","E01020499","Total",619,222,104,118,397,34,69,77,105,28,25,59
"2011","West Dorset 006C","E01020500","Total",850,403,192,211,447,22,138,68,115,10,20,74
"2011","West Dorset 006D","E01020501","Total",599,163,95,68,436,16,144,60,103,15,33,65
"2011","West Dorset 007A","E01020507","Total",912,279,182,97,633,16,254,60,181,19,27,76
"2011","West Dorset 007B","E01020517","Total",811,228,131,97,583,20,220,60,147,18,21,97
"2011","West Dorset 007C","E01020531","Total",762,229,129,100,533,17,152,76,156,21,21,90
"2011","West Dorset 007D","E01020536","Total",881,228,118,110,653,25,171,113,174,36,41,93
"2011","West Dorset 008A","E01020502","Total",819,333,153,180,486,45,102,96,142,8,28,65
"2011","West Dorset 008B","E01020503","Total",902,401,226,175,501,38,142,89,141,10,14,67
"2011","West Dorset 008C","E01020504","Total",1092,365,205,160,727,13,320,65,188,10,19,112
"2011","West Dorset 009C","E01020526","Total",509,115,71,44,394,20,104,59,83,24,32,72
"2011","West Dorset 009D","E01020527","Total",584,174,50,124,410,26,65,79,95,20,39,86
"2011","West Dorset 009E","E01020528","Total",853,268,124,144,585,42,136,118,134,25,33,97
"2011","West Dorset 009F","E01032641","Total",694,210,62,148,484,42,104,85,143,17,34,59
"2011","West Dorset 009G","E01032643","Total",704,246,92,154,458,33,80,96,143,11,30,65
"2011","West Dorset 009H","E01032644","Total",669,415,241,174,254,23,75,17,104,4,3,28
"2011","West Dorset 009I","E01032645","Total",560,298,177,121,262,17,59,49,91,6,9,31
"2011","West Dorset 010A","E01020518","Total",746,319,167,152,427,32,75,81,139,15,28,57
"2011","West Dorset 010B","E01020519","Total",809,289,153,136,520,42,105,109,140,30,32,62
"2011","West Dorset 010C","E01020520","Total",657,221,131,90,436,10,126,74,124,12,19,71
"2011","West Dorset 010D","E01020523","Total",514,124,54,70,390,11,74,77,108,13,35,72
"2011","West Dorset 010E","E01020524","Total",629,157,103,54,472,11,154,72,106,22,21,86
"2011","West Dorset 010F","E01020525","Total",521,94,69,25,427,13,124,76,94,13,39,68
"2011","West Dorset 011A","E01020505","Total",807,187,110,77,620,15,181,98,170,18,34,104
"2011","West Dorset 011B","E01020537","Total",807,200,112,88,607,28,181,94,165,18,25,96
"2011","West Dorset 011C","E01020538","Total",813,206,102,104,607,25,170,114,163,16,32,87
"2011","West Dorset 011D","E01020549","Total",896,243,129,114,653,32,163,94,220,19,30,95
"2011","West Dorset 012A","E01020512","Total",938,249,126,123,689,20,228,94,194,22,35,96
"2011","West Dorset 012B","E01020513","Total",676,208,127,81,468,21,143,84,91,29,25,75
"2011","West Dorset 012C","E01020514","Total",531,124,55,69,407,17,96,78,126,18,14,58
"2011","West Dorset 012D","E01020515","Total",505,127,72,55,378,23,107,58,101,20,22,47
"2011","West Dorset 012E","E01020516","Total",674,192,109,83,482,27,142,69,116,12,21,95
"2011","Weymouth and Portland 001A","E01020551","Total",836,287,88,199,549,68,77,110,153,16,46,79
"2011","Weymouth and Portland 001B","E01020552","Total",739,225,84,141,514,77,69,88,107,39,46,88
"2011","Weymouth and Portland 001C","E01020570","Total",705,207,102,105,498,11,147,76,141,12,25,86
"2011","Weymouth and Portland 001D","E01020571","Total",896,288,107,181,608,58,90,135,174,22,42,87
"2011","Weymouth and Portland 002A","E01020557","Total",754,230,166,64,524,13,241,56,136,6,10,62
"2011","Weymouth and Portland 002B","E01020558","Total",787,206,127,79,581,18,205,70,159,17,25,87
"2011","Weymouth and Portland 002C","E01020559","Total",739,178,140,38,561,7,244,49,153,11,17,80
"2011","Weymouth and Portland 002D","E01020560","Total",820,179,90,89,641,15,188,119,162,10,31,116
"2011","Weymouth and Portland 002E","E01020561","Total",812,327,176,151,485,35,88,92,142,24,34,70
"2011","Weymouth and Portland 003A","E01020574","Total",766,179,90,89,587,46,134,96,139,12,56,104
"2011","Weymouth and Portland 003B","E01020575","Total",730,286,138,148,444,50,78,75,96,27,46,72
"2011","Weymouth and Portland 003C","E01020576","Total",779,221,162,59,558,24,197,82,134,11,22,88
"2011","Weymouth and Portland 003D","E01020579","Total",829,220,132,88,609,16,180,85,166,21,44,97
"2011","Weymouth and Portland 003E","E01020580","Total",605,141,86,55,464,21,123,70,138,7,39,66
"2011","Weymouth and Portland 004A","E01020553","Total",579,230,61,169,349,32,52,58,119,9,18,61
"2011","Weymouth and Portland 004B","E01020554","Total",991,520,157,363,471,51,89,69,181,8,13,60
"2011","Weymouth and Portland 004C","E01020555","Total",669,271,74,197,398,36,60,67,147,10,12,66
"2011","Weymouth and Portland 004D","E01020556","Total",744,381,142,239,363,20,92,39,133,8,13,58
"2011","Weymouth and Portland 004E","E01020581","Total",992,392,180,212,600,34,211,71,154,15,24,91
"2011","Weymouth and Portland 004F","E01020582","Total",768,326,140,186,442,51,80,68,129,19,27,68
"2011","Weymouth and Portland 005A","E01020572","Total",850,267,77,190,583,54,92,114,165,18,35,105
"2011","Weymouth and Portland 005B","E01020573","Total",869,355,164,191,514,41,104,82,147,13,34,93
"2011","Weymouth and Portland 005C","E01020577","Total",640,146,72,74,494,40,92,96,116,20,32,98
"2011","Weymouth and Portland 005D","E01020578","Total",940,324,201,123,616,42,173,95,149,17,29,111
"2011","Weymouth and Portland 006A","E01020583","Total",800,184,95,89,616,22,161,82,189,26,40,96
"2011","Weymouth and Portland 006B","E01020584","Total",719,222,70,152,497,17,94,104,137,24,28,93
"2011","Weymouth and Portland 006C","E01020585","Total",603,122,69,53,481,48,86,97,108,16,38,88
"2011","Weymouth and Portland 007A","E01020586","Total",533,138,75,63,395,22,100,60,94,9,38,72
"2011","Weymouth and Portland 007B","E01020587","Total",675,243,113,130,432,51,97,84,102,25,22,51
"2011","Weymouth and Portland 007C","E01020588","Total",545,122,64,58,423,20,109,71,112,19,28,64
"2011","Weymouth and Portland 007D","E01020589","Total",646,183,94,89,463,32,92,90,130,17,21,81
"2011","Weymouth and Portland 008A","E01020563","Total",516,149,87,62,367,24,73,62,114,21,22,51
"2011","Weymouth and Portland 008D","E01020569","Total",640,227,100,127,413,69,55,66,106,15,37,65
"2011","Weymouth and Portland 008E","E01033200","Total",938,336,101,235,602,52,120,83,181,20,53,93
"2011","Weymouth and Portland 009A","E01020562","Total",876,285,136,149,591,34,118,103,142,28,44,122
"2011","Weymouth and Portland 009B","E01020564","Total",659,163,60,103,496,65,80,102,118,30,25,76
"2011","Weymouth and Portland 009C","E01020565","Total",646,169,82,87,477,40,108,74,140,13,28,74
"2011","Weymouth and Portland 009D","E01020566","Total",900,209,96,113,691,26,189,98,211,26,40,101
"2011","Cheltenham 001A","E01022163","Total",605,137,38,99,468,31,64,77,135,17,34,110
"2011","Cheltenham 001B","E01022164","Total",597,197,60,137,400,35,43,80,133,17,23,69
"2011","Cheltenham 001C","E01022165","Total",709,244,65,179,465,14,104,96,167,5,25,54
"2011","Cheltenham 001D","E01022166","Total",540,126,53,73,414,21,73,87,113,8,26,86
"2011","Cheltenham 002A","E01022143","Total",667,187,114,73,480,10,152,81,139,10,24,64
"2011","Cheltenham 002B","E01022144","Total",536,183,124,59,353,7,117,65,94,5,11,54
"2011","Cheltenham 002C","E01022145","Total",512,133,83,50,379,11,95,84,92,13,25,59
"2011","Cheltenham 002D","E01022146","Total",626,193,111,82,433,7,149,64,131,9,19,54
"2011","Cheltenham 003A","E01022122","Total",572,209,81,128,363,58,50,83,94,20,28,30
"2011","Cheltenham 003B","E01022160","Total",879,287,119,168,592,88,30,133,188,31,28,94
"2011","Cheltenham 003C","E01022161","Total",631,186,37,149,445,43,55,86,154,17,27,63
"2011","Cheltenham 003D","E01022162","Total",689,208,101,107,481,31,123,76,118,13,18,102
"2011","Cheltenham 004A","E01022139","Total",526,165,93,72,361,10,125,48,100,3,12,63
"2011","Cheltenham 004B","E01022151","Total",640,209,43,166,431,35,37,47,158,4,11,139
"2011","Cheltenham 004C","E01022152","Total",434,178,73,105,256,25,32,43,52,10,23,71
"2011","Cheltenham 004D","E01022153","Total",658,237,14,223,421,16,16,53,167,7,20,142
"2011","Cheltenham 004E","E01022154","Total",700,183,43,140,517,29,35,60,150,9,16,218
"2011","Cheltenham 005A","E01022120","Total",691,269,67,202,422,61,58,91,93,22,32,65
"2011","Cheltenham 005B","E01022121","Total",732,233,51,182,499,79,51,116,121,38,32,62
"2011","Cheltenham 005C","E01022147","Total",768,333,64,269,435,73,56,79,119,15,28,65
"2011","Cheltenham 005D","E01022157","Total",643,189,54,135,454,52,51,119,121,14,21,76
"2011","Cheltenham 005E","E01022159","Total",603,169,56,113,434,44,71,85,100,20,41,73
"2011","Cheltenham 006A","E01022131","Total",572,214,111,103,358,40,63,71,88,17,21,58
"2011","Cheltenham 006B","E01022132","Total",596,187,89,98,409,35,73,81,97,20,34,69
"2011","Cheltenham 006C","E01022133","Total",508,109,33,76,399,37,38,68,91,30,57,78
"2011","Cheltenham 006D","E01022134","Total",767,331,133,198,436,35,83,68,143,8,23,76
"2011","Cheltenham 007A","E01022148","Total",648,194,101,93,454,13,83,84,142,20,28,84
"2011","Cheltenham 007B","E01022149","Total",525,131,55,76,394,23,47,54,104,24,48,94
"2011","Cheltenham 007C","E01022150","Total",657,208,64,144,449,34,60,71,163,14,27,80
"2011","Cheltenham 007D","E01022155","Total",612,183,69,114,429,21,98,79,99,13,21,98
"2011","Cheltenham 007E","E01022156","Total",657,244,46,198,413,36,35,87,124,20,22,89
"2011","Cheltenham 007F","E01022158","Total",1048,396,73,323,652,23,38,111,319,6,10,145
"2011","Cheltenham 008A","E01022100","Total",770,243,62,181,527,16,81,128,168,16,23,95
"2011","Cheltenham 008B","E01022101","Total",857,333,100,233,524,22,61,113,207,10,19,92
"2011","Cheltenham 008C","E01022102","Total",1038,571,59,512,467,22,16,53,283,5,16,72
"2011","Cheltenham 008D","E01022140","Total",570,216,108,108,354,10,88,64,119,13,16,44
"2011","Cheltenham 008E","E01022141","Total",787,379,66,313,408,9,75,53,213,7,8,43
"2011","Cheltenham 008F","E01022142","Total",772,355,107,248,417,13,34,57,219,10,9,75
"2011","Cheltenham 009A","E01022116","Total",554,263,81,182,291,14,47,42,130,6,11,41
"2011","Cheltenham 009B","E01022117","Total",967,521,97,424,446,9,80,31,266,1,7,52
"2011","Cheltenham 009C","E01022119","Total",577,185,57,128,392,19,42,103,139,5,21,63
"2011","Cheltenham 009D","E01022124","Total",761,477,128,349,284,10,44,21,172,6,3,28
"2011","Cheltenham 009E","E01022125","Total",592,230,82,148,362,11,78,56,145,10,18,44
"2011","Cheltenham 009F","E01022126","Total",943,565,96,469,378,11,52,19,251,1,4,40
"2011","Cheltenham 009G","E01022127","Total",678,357,70,287,321,5,30,31,183,9,10,53
"2011","Cheltenham 010A","E01022106","Total",747,189,93,96,558,15,141,122,156,15,26,83
"2011","Cheltenham 010B","E01022107","Total",656,175,79,96,481,17,113,103,130,14,33,71
"2011","Cheltenham 010C","E01022108","Total",734,180,88,92,554,17,140,109,118,19,37,114
"2011","Cheltenham 010D","E01022123","Total",988,316,83,233,672,39,105,134,230,16,38,110
"2011","Cheltenham 011A","E01022135","Total",624,209,126,83,415,16,104,82,117,20,19,57
"2011","Cheltenham 011B","E01022136","Total",742,344,179,165,398,18,86,68,155,16,15,40
"2011","Cheltenham 011C","E01022137","Total",879,396,151,245,483,23,76,70,227,13,15,59
"2011","Cheltenham 011D","E01022138","Total",776,292,106,186,484,17,112,84,182,18,16,55
"2011","Cheltenham 011E","E01022174","Total",597,182,101,81,415,13,120,84,94,13,26,65
"2011","Cheltenham 012A","E01022103","Total",1001,250,79,171,751,32,132,170,253,34,33,97
"2011","Cheltenham 012B","E01022104","Total",721,225,92,133,496,35,92,97,154,23,34,61
"2011","Cheltenham 012C","E01022105","Total",584,142,82,60,442,14,120,105,88,21,26,68
"2011","Cheltenham 012D","E01022109","Total",606,149,94,55,457,12,125,101,94,15,34,76
"2011","Cheltenham 012E","E01022110","Total",616,229,130,99,387,33,55,112,100,19,22,46
"2011","Cheltenham 012F","E01022111","Total",589,178,92,86,411,20,82,101,102,30,33,43
"2011","Cheltenham 012G","E01022112","Total",469,97,47,50,372,17,72,93,78,11,37,64
"2011","Cheltenham 013A","E01022167","Total",509,103,73,30,406,11,117,86,102,11,23,56
"2011","Cheltenham 013B","E01022168","Total",476,130,80,50,346,12,100,74,80,7,27,46
"2011","Cheltenham 013C","E01022169","Total",667,228,112,116,439,25,65,111,131,17,28,62
"2011","Cheltenham 013D","E01022170","Total",628,200,83,117,428,24,64,99,119,18,41,63
"2011","Cheltenham 013E","E01022171","Total",551,137,30,107,414,19,28,125,146,11,26,59
"2011","Cheltenham 013F","E01022172","Total",711,249,158,91,462,18,167,78,126,5,16,52
"2011","Cheltenham 013G","E01022173","Total",613,207,94,113,406,39,103,60,113,12,17,62
"2011","Cheltenham 014A","E01022113","Total",714,207,157,50,507,8,172,101,97,19,35,75
"2011","Cheltenham 014B","E01022114","Total",662,179,113,66,483,13,153,101,120,20,30,46
"2011","Cheltenham 014C","E01022115","Total",807,337,133,204,470,17,109,89,154,15,22,64
"2011","Cheltenham 014D","E01022118","Total",572,159,86,73,413,17,68,120,92,16,34,66
"2011","Cheltenham 015A","E01022128","Total",670,175,107,68,495,8,133,118,121,26,31,58
"2011","Cheltenham 015B","E01022129","Total",874,250,144,106,624,19,165,147,151,38,40,64
"2011","Cheltenham 015C","E01022130","Total",732,274,122,152,458,14,71,123,166,15,20,49
"2011","Cotswold 001A","E01022179","Total",905,277,135,142,628,27,178,117,164,27,34,81
"2011","Cotswold 001B","E01022182","Total",689,188,126,62,501,19,186,67,130,13,22,64
"2011","Cotswold 001C","E01022183","Total",694,236,141,95,458,15,167,66,113,17,21,59
"2011","Cotswold 001D","E01022184","Total",674,207,122,85,467,9,164,65,122,17,22,68
"2011","Cotswold 001E","E01022185","Total",627,174,111,63,453,17,149,85,105,12,27,58
"2011","Cotswold 002A","E01022177","Total",966,373,231,142,593,20,181,80,164,19,34,95
"2011","Cotswold 002B","E01022178","Total",595,185,96,89,410,12,119,69,112,16,30,52
"2011","Cotswold 002C","E01022205","Total",841,277,156,121,564,17,159,97,169,21,23,78
"2011","Cotswold 002D","E01022211","Total",931,406,209,197,525,26,163,100,142,18,23,53
"2011","Cotswold 002E","E01022212","Total",722,199,118,81,523,14,148,98,140,16,33,74
"2011","Cotswold 003A","E01022180","Total",923,289,162,127,634,32,159,128,170,16,42,87
"2011","Cotswold 003B","E01022181","Total",782,280,193,87,502,6,186,69,141,15,16,69
"2011","Cotswold 003C","E01022214","Total",848,196,64,132,652,28,121,164,181,27,48,83
"2011","Cotswold 003D","E01022222","Total",875,270,116,154,605,11,193,97,170,19,28,87
"2011","Cotswold 004A","E01022186","Total",721,187,84,103,534,13,135,104,146,23,28,85
"2011","Cotswold 004B","E01022187","Total",732,167,94,73,565,11,141,89,164,31,41,88
"2011","Cotswold 004C","E01022201","Total",749,178,80,98,571,13,137,88,166,23,38,106
"2011","Cotswold 004D","E01022216","Total",788,201,82,119,587,15,128,122,188,26,26,82
"2011","Cotswold 005A","E01022175","Total",818,224,104,120,594,17,154,90,193,19,34,87
"2011","Cotswold 005B","E01022207","Total",751,182,99,83,569,10,137,103,166,29,29,95
"2011","Cotswold 005C","E01022213","Total",787,229,122,107,558,21,141,119,159,20,29,69
"2011","Cotswold 005D","E01022215","Total",815,257,103,154,558,12,144,82,188,30,20,82
"2011","Cotswold 006A","E01022188","Total",601,215,84,131,386,29,68,77,97,18,28,69
"2011","Cotswold 006B","E01022189","Total",512,105,60,45,407,6,76,72,101,21,40,91
"2011","Cotswold 006C","E01022190","Total",529,107,40,67,422,30,48,90,117,10,27,100
"2011","Cotswold 006D","E01022196","Total",731,198,107,91,533,25,121,106,128,24,43,86
"2011","Cotswold 006E","E01022197","Total",776,179,98,81,597,18,144,113,172,19,37,94
"2011","Cotswold 007A","E01022194","Total",995,583,329,254,412,23,116,47,139,9,15,63
"2011","Cotswold 007B","E01022195","Total",641,241,138,103,400,22,115,62,125,10,13,53
"2011","Cotswold 007C","E01022199","Total",860,359,156,203,501,17,106,90,180,8,27,73
"2011","Cotswold 007D","E01022200","Total",607,271,100,171,336,39,56,82,97,14,7,41
"2011","Cotswold 008A","E01022191","Total",653,231,88,143,422,36,61,93,151,7,14,60
"2011","Cotswold 008B","E01022192","Total",532,162,75,87,370,23,52,50,103,27,39,76
"2011","Cotswold 008C","E01022193","Total",417,81,50,31,336,7,94,56,85,9,30,55
"2011","Cotswold 008D","E01022198","Total",563,166,67,99,397,11,66,67,140,16,32,65
"2011","Cotswold 008E","E01022225","Total",633,161,89,72,472,17,114,116,112,19,26,68
"2011","Cotswold 009A","E01022202","Total",429,83,47,36,346,5,77,76,97,13,22,56
"2011","Cotswold 009B","E01022203","Total",642,212,151,61,430,12,150,58,97,15,24,74
"2011","Cotswold 009C","E01022204","Total",611,168,95,73,443,27,74,89,128,15,36,74
"2011","Cotswold 009D","E01022208","Total",671,162,84,78,509,15,154,82,129,20,42,67
"2011","Cotswold 009E","E01022209","Total",447,81,39,42,366,11,58,84,119,9,17,68
"2011","Cotswold 009F","E01022210","Total",651,257,139,118,394,25,141,52,97,6,16,57
"2011","Cotswold 010A","E01022221","Total",782,180,80,100,602,29,133,120,139,29,43,109
"2011","Cotswold 010B","E01022223","Total",1020,278,121,157,742,36,164,143,225,26,55,93
"2011","Cotswold 010C","E01022224","Total",686,175,86,89,511,12,147,82,153,10,28,79
"2011","Cotswold 011A","E01022176","Total",815,222,79,143,593,17,127,121,169,24,36,99
"2011","Cotswold 011B","E01022206","Total",796,204,87,117,592,10,151,100,179,26,32,94
"2011","Cotswold 011C","E01022217","Total",561,156,77,79,405,15,97,87,117,12,23,54
"2011","Cotswold 011D","E01022218","Total",525,123,64,59,402,26,84,81,100,24,25,62
"2011","Cotswold 011E","E01022219","Total",522,125,69,56,397,5,105,91,110,10,21,55
"2011","Cotswold 011F","E01022220","Total",795,292,161,131,503,15,161,92,166,10,12,47
"2011","Forest of Dean 001A","E01022233","Total",785,195,100,95,590,11,157,92,155,20,45,110
"2011","Forest of Dean 001B","E01022235","Total",735,184,114,70,551,16,173,82,145,19,37,79
"2011","Forest of Dean 001C","E01022247","Total",673,156,87,69,517,19,138,72,130,17,43,98
"2011","Forest of Dean 001D","E01022270","Total",749,159,91,68,590,23,147,104,163,25,42,86
"2011","Forest of Dean 001E","E01022271","Total",703,162,77,85,541,6,158,74,162,20,29,92
"2011","Forest of Dean 002A","E01022261","Total",781,186,102,84,595,27,144,113,144,27,45,95
"2011","Forest of Dean 002B","E01022262","Total",861,318,163,155,543,38,93,81,191,20,32,88
"2011","Forest of Dean 002C","E01022267","Total",660,173,103,70,487,10,146,52,137,13,35,94
"2011","Forest of Dean 003A","E01022251","Total",629,191,107,84,438,24,92,67,134,17,39,65
"2011","Forest of Dean 003B","E01022252","Total",710,172,93,79,538,10,130,91,148,20,40,99
"2011","Forest of Dean 003C","E01022258","Total",470,147,65,82,323,26,60,68,71,14,24,60
"2011","Forest of Dean 003D","E01022259","Total",640,124,63,61,516,18,112,94,144,14,40,94
"2011","Forest of Dean 003E","E01022260","Total",752,195,85,110,557,29,108,107,157,19,39,98
"2011","Forest of Dean 004A","E01022236","Total",898,257,114,143,641,29,128,113,205,23,47,96
"2011","Forest of Dean 004B","E01022237","Total",628,186,92,94,442,42,74,76,114,19,36,81
"2011","Forest of Dean 004C","E01022238","Total",607,231,125,106,376,48,82,72,97,15,20,42
"2011","Forest of Dean 004D","E01022239","Total",691,188,95,93,503,22,113,87,142,17,39,83
"2011","Forest of Dean 004E","E01022240","Total",930,327,134,193,603,46,107,104,199,18,46,83
"2011","Forest of Dean 004F","E01022249","Total",817,190,99,91,627,14,161,102,175,22,48,105
"2011","Forest of Dean 004G","E01022250","Total",762,188,100,88,574,33,117,97,186,22,30,89
"2011","Forest of Dean 005A","E01022228","Total",686,163,83,80,523,15,132,72,149,18,46,91
"2011","Forest of Dean 005B","E01022230","Total",689,154,87,67,535,11,146,90,139,24,30,95
"2011","Forest of Dean 005C","E01022265","Total",704,223,105,118,481,16,127,79,129,21,37,72
"2011","Forest of Dean 005D","E01022266","Total",526,105,58,47,421,7,108,75,102,11,35,83
"2011","Forest of Dean 006A","E01022234","Total",639,159,78,81,480,7,145,59,127,15,35,92
"2011","Forest of Dean 006B","E01022253","Total",713,188,80,108,525,24,124,93,157,24,35,68
"2011","Forest of Dean 006C","E01022263","Total",778,189,90,99,589,19,158,86,176,19,38,93
"2011","Forest of Dean 007A","E01022229","Total",677,166,103,63,511,22,128,85,119,22,32,103
"2011","Forest of Dean 007B","E01022241","Total",819,362,183,179,457,10,139,77,139,14,25,53
"2011","Forest of Dean 007C","E01022242","Total",592,163,79,84,429,16,102,78,102,22,39,70
"2011","Forest of Dean 007D","E01022243","Total",532,160,72,88,372,29,76,79,86,16,24,62
"2011","Forest of Dean 007E","E01022244","Total",616,158,88,70,458,29,91,91,136,14,32,65
"2011","Forest of Dean 007F","E01022245","Total",594,184,65,119,410,39,77,66,121,13,20,74
"2011","Forest of Dean 007G","E01022246","Total",532,122,63,59,410,15,100,74,108,20,22,71
"2011","Forest of Dean 008A","E01022231","Total",692,201,99,102,491,20,94,99,134,24,36,84
"2011","Forest of Dean 008B","E01022232","Total",643,160,65,95,483,29,116,87,128,15,38,70
"2011","Forest of Dean 008C","E01022264","Total",613,148,66,82,465,12,111,79,122,16,29,96
"2011","Forest of Dean 008D","E01022268","Total",674,166,102,64,508,16,125,89,146,12,29,91
"2011","Forest of Dean 008E","E01022269","Total",801,162,78,84,639,22,170,109,182,19,44,93
"2011","Forest of Dean 009A","E01022226","Total",690,228,115,113,462,37,111,94,106,19,31,64
"2011","Forest of Dean 009B","E01022227","Total",682,201,105,96,481,9,148,78,116,14,36,80
"2011","Forest of Dean 009C","E01022254","Total",757,216,102,114,541,37,86,103,139,26,45,105
"2011","Forest of Dean 009D","E01022255","Total",622,152,65,87,470,13,93,109,118,14,45,78
"2011","Forest of Dean 009E","E01022256","Total",742,293,158,135,449,35,118,65,110,16,37,68
"2011","Forest of Dean 009F","E01022257","Total",770,180,107,73,590,21,151,101,151,15,47,104
"2011","Forest of Dean 010A","E01022248","Total",711,158,78,80,553,15,154,82,152,19,32,99
"2011","Forest of Dean 010B","E01022272","Total",564,160,105,55,404,24,102,77,106,8,20,67
"2011","Forest of Dean 010C","E01022273","Total",457,72,48,24,385,16,75,108,92,27,32,35
"2011","Forest of Dean 010D","E01022274","Total",496,113,48,65,383,12,92,70,118,9,25,57
"2011","Forest of Dean 010E","E01022275","Total",675,191,116,75,484,9,129,99,137,20,23,67
"2011","Gloucester 001A","E01022313","Total",702,185,71,114,517,30,94,106,143,24,31,89
"2011","Gloucester 001B","E01022315","Total",628,150,85,65,478,13,116,91,119,15,30,94
"2011","Gloucester 001C","E01022316","Total",676,194,84,110,482,25,69,113,145,9,34,87
"2011","Gloucester 001D","E01022317","Total",610,130,79,51,480,16,93,99,113,19,48,92
"2011","Gloucester 001E","E01022318","Total",656,160,117,43,496,14,134,88,123,13,29,95
"2011","Gloucester 002A","E01022309","Total",618,204,85,119,414,21,75,71,107,13,42,85
"2011","Gloucester 002B","E01022310","Total",742,246,98,148,496,28,89,79,149,10,35,106
"2011","Gloucester 002C","E01022311","Total",1000,591,207,384,409,40,53,76,146,7,22,65
"2011","Gloucester 002D","E01022312","Total",958,362,107,255,596,29,66,108,238,18,39,98
"2011","Gloucester 002E","E01022314","Total",647,164,111,53,483,10,166,68,130,14,27,68
"2011","Gloucester 003A","E01022295","Total",590,144,100,44,446,21,123,85,91,14,33,79
"2011","Gloucester 003B","E01022296","Total",597,171,74,97,426,44,57,107,101,19,28,70
"2011","Gloucester 003C","E01022297","Total",496,85,55,30,411,7,90,68,122,17,33,74
"2011","Gloucester 003D","E01022298","Total",602,135,55,80,467,21,52,101,145,15,38,95
"2011","Gloucester 004A","E01022332","Total",671,247,61,186,424,29,40,82,131,14,47,81
"2011","Gloucester 004B","E01022347","Total",919,501,39,462,418,34,27,37,224,5,20,71
"2011","Gloucester 004C","E01022348","Total",1113,333,84,249,780,46,122,147,263,38,49,115
"2011","Gloucester 004E","E01032932","Total",628,373,198,175,255,6,80,34,79,8,14,34
"2011","Gloucester 004F","E01032937","Total",604,374,72,302,230,13,21,24,104,2,18,48
"2011","Gloucester 005A","E01022288","Total",705,228,62,166,477,65,36,122,116,32,45,61
"2011","Gloucester 005B","E01022289","Total",625,213,89,124,412,44,46,71,87,35,46,83
"2011","Gloucester 005C","E01022290","Total",529,148,55,93,381,37,54,96,81,29,30,54
"2011","Gloucester 005D","E01022291","Total",635,181,45,136,454,64,36,90,95,31,73,65
"2011","Gloucester 005E","E01022292","Total",493,139,41,98,354,17,35,56,74,24,65,83
"2011","Gloucester 006A","E01022283","Total",635,161,91,70,474,10,131,89,118,11,31,84
"2011","Gloucester 006B","E01022303","Total",622,204,122,82,418,23,108,65,100,17,37,68
"2011","Gloucester 006C","E01022304","Total",765,281,172,109,484,19,162,87,130,7,21,58
"2011","Gloucester 006D","E01022305","Total",589,165,105,60,424,11,129,85,85,9,27,78
"2011","Gloucester 006E","E01022308","Total",649,180,119,61,469,16,158,79,121,4,20,71
"2011","Gloucester 007A","E01022278","Total",638,132,44,88,506,29,86,112,146,11,33,89
"2011","Gloucester 007B","E01022279","Total",569,106,57,49,463,21,76,117,115,14,32,88
"2011","Gloucester 007C","E01022282","Total",1043,193,28,165,850,58,83,267,216,35,69,122
"2011","Gloucester 007D","E01022284","Total",511,134,52,82,377,31,55,80,95,12,37,67
"2011","Gloucester 007E","E01022285","Total",497,107,47,60,390,38,62,60,68,31,50,81
"2011","Gloucester 007F","E01022286","Total",611,156,52,104,455,39,49,92,116,19,45,95
"2011","Gloucester 007G","E01022287","Total",711,220,106,114,491,19,104,98,126,24,39,81
"2011","Gloucester 008A","E01022293","Total",633,213,46,167,420,35,52,60,102,25,48,98
"2011","Gloucester 008B","E01022294","Total",634,183,56,127,451,51,44,94,135,24,27,76
"2011","Gloucester 008C","E01022323","Total",633,126,47,79,507,77,50,92,104,39,56,89
"2011","Gloucester 008D","E01022328","Total",501,123,72,51,378,24,51,71,87,19,41,85
"2011","Gloucester 008E","E01022329","Total",599,161,56,105,438,50,44,81,108,47,37,71
"2011","Gloucester 009A","E01022326","Total",555,154,35,119,401,54,43,82,126,15,30,51
"2011","Gloucester 009B","E01022327","Total",618,149,56,93,469,34,64,93,140,23,39,76
"2011","Gloucester 009C","E01022330","Total",587,154,41,113,433,27,47,104,134,20,39,62
"2011","Gloucester 009D","E01022331","Total",496,117,56,61,379,14,48,77,72,25,43,100
"2011","Gloucester 009E","E01022333","Total",641,254,82,172,387,64,71,49,85,14,35,69
"2011","Gloucester 009F","E01022334","Total",650,172,110,62,478,10,121,82,110,27,31,97
"2011","Gloucester 010A","E01022276","Total",685,162,93,69,523,21,124,96,139,13,32,98
"2011","Gloucester 010B","E01022277","Total",659,206,104,102,453,17,93,87,132,17,25,82
"2011","Gloucester 010C","E01022280","Total",685,201,21,180,484,42,30,119,192,8,20,73
"2011","Gloucester 010D","E01022281","Total",690,125,47,78,565,26,81,138,165,17,41,97
"2011","Gloucester 010E","E01022306","Total",584,155,47,108,429,23,63,108,135,10,31,59
"2011","Gloucester 010F","E01022307","Total",638,128,29,99,510,42,47,133,157,20,33,78
"2011","Gloucester 011A","E01022319","Total",703,305,70,235,398,99,57,80,95,14,17,36
"2011","Gloucester 011B","E01022320","Total",626,198,74,124,428,40,75,88,96,11,30,88
"2011","Gloucester 011C","E01022321","Total",609,161,63,98,448,26,75,79,121,25,42,80
"2011","Gloucester 011D","E01022322","Total",609,243,126,117,366,36,79,60,88,10,26,67
"2011","Gloucester 011E","E01022324","Total",649,199,95,104,450,59,73,69,130,9,27,83
"2011","Gloucester 011F","E01022325","Total",586,190,96,94,396,19,89,51,97,20,27,93
"2011","Gloucester 012A","E01022343","Total",510,121,65,56,389,13,112,60,99,15,32,58
"2011","Gloucester 012B","E01022344","Total",625,164,99,65,461,18,107,59,131,21,45,80
"2011","Gloucester 012C","E01022345","Total",630,167,94,73,463,16,125,65,119,16,35,87
"2011","Gloucester 012D","E01022346","Total",658,226,91,135,432,53,58,78,119,28,31,65
"2011","Gloucester 013A","E01022299","Total",629,165,84,81,464,28,142,67,123,10,24,70
"2011","Gloucester 013B","E01022300","Total",635,181,102,79,454,16,165,64,115,12,16,66
"2011","Gloucester 013C","E01022301","Total",660,204,96,108,456,38,90,87,114,31,33,63
"2011","Gloucester 013D","E01022302","Total",625,136,84,52,489,27,128,87,98,13,44,92
"2011","Gloucester 014A","E01022339","Total",660,110,33,77,550,36,57,155,187,20,29,66
"2011","Gloucester 014B","E01022340","Total",622,184,22,162,438,37,21,111,163,14,30,62
"2011","Gloucester 014C","E01022341","Total",853,213,56,157,640,45,62,158,201,24,48,102
"2011","Gloucester 014D","E01022342","Total",677,156,13,143,521,39,28,165,177,16,39,57
"2011","Gloucester 015A","E01022335","Total",612,160,82,78,452,22,76,82,124,21,37,90
"2011","Gloucester 015B","E01022336","Total",496,124,63,61,372,22,88,76,98,7,26,55
"2011","Gloucester 015D","E01022338","Total",630,216,43,173,414,48,27,118,167,14,14,26
"2011","Gloucester 015E","E01032933","Total",535,83,7,76,452,38,7,152,141,28,38,48
"2011","Gloucester 015F","E01032934","Total",573,153,53,100,420,27,54,89,118,14,34,84
"2011","Gloucester 015G","E01032935","Total",556,72,4,68,484,28,11,186,145,25,36,53
"2011","Gloucester 015H","E01032936","Total",623,84,3,81,539,68,6,185,135,59,44,42
"2011","Stroud 001A","E01022378","Total",739,155,38,117,584,22,81,145,199,18,35,84
"2011","Stroud 001B","E01022379","Total",665,237,67,170,428,40,45,87,159,11,31,55
"2011","Stroud 001C","E01022380","Total",606,124,59,65,482,17,119,76,132,22,41,75
"2011","Stroud 001D","E01022412","Total",1163,261,139,122,902,45,203,147,275,33,61,138
"2011","Stroud 002A","E01022354","Total",936,234,131,103,702,10,225,123,185,19,34,106
"2011","Stroud 002B","E01022390","Total",594,230,165,65,364,21,122,70,88,12,11,40
"2011","Stroud 002C","E01022391","Total",640,154,100,54,486,15,179,65,131,14,29,53
"2011","Stroud 002D","E01022392","Total",658,168,88,80,490,9,157,64,127,24,31,78
"2011","Stroud 003A","E01022376","Total",736,198,118,80,538,17,111,100,154,19,35,102
"2011","Stroud 003B","E01022396","Total",667,134,63,71,533,11,115,111,146,20,34,96
"2011","Stroud 003C","E01022397","Total",717,140,71,69,577,11,111,116,152,37,43,107
"2011","Stroud 003D","E01022398","Total",449,92,52,40,357,10,100,50,83,14,34,66
"2011","Stroud 004A","E01022355","Total",641,143,69,74,498,26,101,97,113,29,38,94
"2011","Stroud 004B","E01022356","Total",952,296,122,174,656,47,70,144,206,34,36,119
"2011","Stroud 004C","E01022357","Total",778,216,107,109,562,23,138,114,160,17,38,72
"2011","Stroud 004D","E01022358","Total",656,210,136,74,446,15,106,84,97,31,39,74
"2011","Stroud 004E","E01022377","Total",987,345,139,206,642,48,158,121,166,18,42,89
"2011","Stroud 004F","E01022389","Total",717,142,76,66,575,12,155,112,164,14,38,80
"2011","Stroud 005A","E01022400","Total",789,230,120,110,559,19,117,110,175,17,36,85
"2011","Stroud 005B","E01022401","Total",596,168,68,100,428,23,82,85,124,21,27,66
"2011","Stroud 005C","E01022402","Total",648,170,69,101,478,26,54,99,144,21,33,101
"2011","Stroud 005D","E01022403","Total",609,209,130,79,400,24,103,57,97,22,31,66
"2011","Stroud 005E","E01022404","Total",551,158,62,96,393,13,79,61,130,8,23,79
"2011","Stroud 006A","E01022365","Total",1005,421,146,275,584,32,91,106,202,22,29,102
"2011","Stroud 006B","E01022399","Total",917,307,83,224,610,48,86,113,177,29,57,100
"2011","Stroud 006C","E01022410","Total",986,369,129,240,617,64,85,123,193,17,36,99
"2011","Stroud 006D","E01022411","Total",950,315,158,157,635,27,109,135,178,19,52,115
"2011","Stroud 006E","E01022414","Total",1109,386,92,294,723,46,98,159,244,26,45,105
"2011","Stroud 007A","E01022393","Total",619,155,86,69,464,7,151,89,113,18,26,60
"2011","Stroud 007B","E01022394","Total",672,216,55,161,456,21,47,103,164,22,32,67
"2011","Stroud 007C","E01022395","Total",635,145,76,69,490,14,127,97,128,14,25,85
"2011","Stroud 007D","E01022408","Total",435,93,36,57,342,4,72,70,100,18,22,56
"2011","Stroud 007E","E01022409","Total",499,104,35,69,395,16,78,85,104,13,31,68
"2011","Stroud 008A","E01022366","Total",676,122,72,50,554,17,117,143,137,38,40,62
"2011","Stroud 008B","E01022367","Total",674,151,86,65,523,14,137,120,126,20,36,70
"2011","Stroud 008C","E01022368","Total",587,143,92,51,444,3,118,76,132,14,29,72
"2011","Stroud 008D","E01022369","Total",744,246,76,170,498,60,46,131,157,21,29,54
"2011","Stroud 009A","E01022370","Total",534,132,70,62,402,16,93,74,119,12,23,65
"2011","Stroud 009B","E01022371","Total",413,68,35,33,345,7,103,41,87,10,29,68
"2011","Stroud 009C","E01022405","Total",625,200,124,76,425,23,115,82,95,16,25,69
"2011","Stroud 009D","E01022406","Total",521,135,78,57,386,9,90,64,126,12,24,61
"2011","Stroud 009E","E01022407","Total",547,134,80,54,413,11,113,52,112,14,33,78
"2011","Stroud 010A","E01022350","Total",888,203,136,67,685,20,239,104,150,29,50,93
"2011","Stroud 010B","E01022382","Total",662,159,120,39,503,10,178,76,124,21,22,72
"2011","Stroud 010C","E01022383","Total",593,208,146,62,385,24,125,57,80,22,21,56
"2011","Stroud 010D","E01022384","Total",617,172,92,80,445,13,145,65,127,15,25,55
"2011","Stroud 011A","E01022359","Total",638,177,112,65,461,16,112,83,117,16,37,80
"2011","Stroud 011B","E01022360","Total",567,103,52,51,464,7,128,87,144,10,30,58
"2011","Stroud 011C","E01022361","Total",603,249,149,100,354,11,92,78,89,11,14,59
"2011","Stroud 011D","E01022362","Total",512,146,97,49,366,8,104,60,102,9,26,57
"2011","Stroud 011E","E01022363","Total",765,217,93,124,548,28,115,108,163,14,27,93
"2011","Stroud 011F","E01022364","Total",488,150,89,61,338,27,72,52,98,13,28,48
"2011","Stroud 012A","E01022351","Total",592,155,81,74,437,14,80,74,135,21,24,89
"2011","Stroud 012B","E01022352","Total",578,181,96,85,397,9,96,63,113,20,28,68
"2011","Stroud 012C","E01022353","Total",643,203,95,108,440,20,92,81,139,15,25,68
"2011","Stroud 012D","E01022413","Total",727,151,75,76,576,14,144,95,144,22,52,105
"2011","Stroud 013A","E01022385","Total",663,183,103,80,480,27,104,84,116,24,39,86
"2011","Stroud 013B","E01022386","Total",746,275,152,123,471,9,114,63,171,17,33,64
"2011","Stroud 013C","E01022387","Total",722,237,96,141,485,44,70,91,155,14,31,80
"2011","Stroud 013D","E01022388","Total",696,172,68,104,524,27,104,130,121,23,35,84
"2011","Stroud 014A","E01022372","Total",755,228,79,149,527,14,120,113,155,23,29,73
"2011","Stroud 014B","E01022373","Total",737,209,79,130,528,27,105,119,148,17,30,82
"2011","Stroud 014C","E01022374","Total",932,357,153,204,575,46,124,111,179,24,18,73
"2011","Stroud 014D","E01022375","Total",485,111,28,83,374,60,28,78,89,25,28,66
"2011","Stroud 015A","E01022381","Total",784,155,68,87,629,26,120,148,154,38,44,99
"2011","Stroud 015B","E01022415","Total",628,140,66,74,488,13,137,70,130,22,42,74
"2011","Stroud 015C","E01022416","Total",585,153,74,79,432,17,77,103,107,24,36,68
"2011","Stroud 015D","E01022417","Total",727,195,110,85,532,22,117,95,146,17,32,103
"2011","Stroud 015E","E01022418","Total",819,327,181,146,492,19,114,99,138,23,20,79
"2011","Tewkesbury 001B","E01022450","Total",885,287,100,187,598,41,73,150,191,21,46,76
"2011","Tewkesbury 001C","E01022451","Total",636,154,71,83,482,20,83,86,167,26,27,73
"2011","Tewkesbury 001D","E01022452","Total",534,87,22,65,447,15,62,103,125,20,37,85
"2011","Tewkesbury 001E","E01022455","Total",812,163,86,77,649,10,171,92,187,17,42,130
"2011","Tewkesbury 001F","E01032938","Total",608,137,38,99,471,27,48,126,174,13,30,53
"2011","Tewkesbury 001G","E01032939","Total",584,93,20,73,491,35,42,159,131,25,38,61
"2011","Tewkesbury 001H","E01032940","Total",541,96,12,84,445,29,20,163,164,20,21,28
"2011","Tewkesbury 002A","E01022456","Total",539,121,50,71,418,16,88,82,124,19,25,64
"2011","Tewkesbury 002B","E01022457","Total",600,213,95,118,387,29,81,67,90,13,25,82
"2011","Tewkesbury 002C","E01022458","Total",668,279,114,165,389,54,53,95,101,20,23,43
"2011","Tewkesbury 002D","E01022459","Total",850,442,181,261,408,16,83,40,197,5,9,58
"2011","Tewkesbury 002E","E01022460","Total",832,327,164,163,505,15,101,98,176,15,19,81
"2011","Tewkesbury 002F","E01022461","Total",635,202,122,80,433,14,155,73,94,10,27,60
"2011","Tewkesbury 002G","E01022462","Total",695,137,81,56,558,9,172,85,165,15,30,82
"2011","Tewkesbury 003A","E01022449","Total",848,198,107,91,650,12,199,97,195,22,43,82
"2011","Tewkesbury 003B","E01022463","Total",718,255,129,126,463,11,155,61,134,13,23,66
"2011","Tewkesbury 003C","E01022464","Total",743,266,172,94,477,28,154,83,110,17,24,61
"2011","Tewkesbury 003D","E01022465","Total",627,126,72,54,501,12,142,93,128,14,38,74
"2011","Tewkesbury 003E","E01022466","Total",748,199,112,87,549,18,160,111,141,22,29,68
"2011","Tewkesbury 004A","E01022434","Total",852,178,122,56,674,8,198,132,175,25,37,99
"2011","Tewkesbury 004B","E01022441","Total",667,170,47,123,497,20,111,73,174,13,21,85
"2011","Tewkesbury 004C","E01022445","Total",564,110,56,54,454,9,113,72,145,15,26,74
"2011","Tewkesbury 004D","E01022453","Total",648,125,80,45,523,7,184,98,102,7,38,87
"2011","Tewkesbury 005A","E01022432","Total",950,331,179,152,619,24,193,109,150,21,31,91
"2011","Tewkesbury 005B","E01022433","Total",854,166,98,68,688,30,194,118,179,38,34,95
"2011","Tewkesbury 005C","E01022435","Total",958,259,176,83,699,48,170,129,148,29,51,124
"2011","Tewkesbury 005D","E01022436","Total",914,321,207,114,593,27,180,110,162,19,30,65
"2011","Tewkesbury 005E","E01022437","Total",584,172,92,80,412,19,76,99,103,25,22,68
"2011","Tewkesbury 005F","E01022438","Total",604,180,59,121,424,23,58,117,146,7,16,57
"2011","Tewkesbury 005G","E01022439","Total",710,249,67,182,461,42,52,139,145,13,22,48
"2011","Tewkesbury 006A","E01022440","Total",735,274,106,168,461,17,104,71,155,14,26,74
"2011","Tewkesbury 006B","E01022442","Total",618,121,52,69,497,4,126,81,152,3,39,92
"2011","Tewkesbury 006C","E01022443","Total",548,115,64,51,433,8,101,79,126,11,30,78
"2011","Tewkesbury 006D","E01022444","Total",579,107,60,47,472,9,120,70,139,26,28,80
"2011","Tewkesbury 007A","E01022425","Total",499,124,67,57,375,6,88,77,98,12,33,61
"2011","Tewkesbury 007B","E01022426","Total",642,169,130,39,473,8,186,63,98,13,29,76
"2011","Tewkesbury 007C","E01022427","Total",643,216,120,96,427,25,93,79,124,15,22,69
"2011","Tewkesbury 007D","E01022428","Total",797,271,103,168,526,48,83,122,133,29,41,70
"2011","Tewkesbury 007E","E01022429","Total",672,196,77,119,476,21,106,97,124,13,37,78
"2011","Tewkesbury 007F","E01022430","Total",632,169,107,62,463,10,142,73,121,16,21,80
"2011","Tewkesbury 007G","E01022431","Total",893,281,70,211,612,19,77,165,201,16,45,89
"2011","Tewkesbury 007H","E01022447","Total",473,73,22,51,400,16,15,172,123,24,18,32
"2011","Tewkesbury 008A","E01022420","Total",910,274,152,122,636,12,214,79,147,23,53,108
"2011","Tewkesbury 008B","E01022448","Total",580,158,108,50,422,23,128,66,99,13,33,60
"2011","Tewkesbury 008C","E01022454","Total",861,271,179,92,590,31,172,98,146,18,31,94
"2011","Tewkesbury 009A","E01022421","Total",735,227,80,147,508,39,96,95,151,19,32,76
"2011","Tewkesbury 009B","E01022422","Total",642,130,40,90,512,14,85,119,153,20,37,84
"2011","Tewkesbury 009C","E01022423","Total",839,235,123,112,604,30,150,102,168,12,45,97
"2011","Tewkesbury 009D","E01022424","Total",658,174,80,94,484,43,104,83,111,20,42,81
"2011","Tewkesbury 009E","E01022446","Total",762,230,102,128,532,27,87,132,188,23,19,56
"2011","Mendip 001A","E01029022","Total",584,175,92,83,409,13,101,75,111,22,27,60
"2011","Mendip 001B","E01029023","Total",481,110,53,57,371,9,97,65,95,21,28,56
"2011","Mendip 001C","E01029044","Total",570,173,47,126,397,42,45,91,117,11,27,64
"2011","Mendip 001D","E01029053","Total",953,250,104,146,703,32,173,104,189,29,62,114
"2011","Mendip 001E","E01029057","Total",830,186,96,90,644,22,166,118,166,34,36,102
"2011","Mendip 002A","E01029024","Total",823,187,85,102,636,20,140,128,149,27,44,128
"2011","Mendip 002B","E01029025","Total",544,156,76,80,388,11,78,75,99,16,30,79
"2011","Mendip 002C","E01029026","Total",417,106,49,57,311,18,74,55,92,7,21,44
"2011","Mendip 002D","E01029068","Total",485,127,59,68,358,23,88,65,84,14,28,56
"2011","Mendip 002E","E01029069","Total",445,110,57,53,335,9,78,53,111,10,30,44
"2011","Mendip 003A","E01029030","Total",784,166,66,100,618,31,109,132,186,23,26,111
"2011","Mendip 003B","E01029031","Total",676,162,92,70,514,32,128,97,134,14,31,78
"2011","Mendip 003C","E01029032","Total",497,144,107,37,353,6,154,44,88,6,9,46
"2011","Mendip 003D","E01029033","Total",628,176,75,101,452,37,68,97,146,16,25,63
"2011","Mendip 003E","E01029034","Total",582,178,58,120,404,23,71,75,125,16,18,76
"2011","Mendip 004A","E01029036","Total",713,265,74,191,448,38,57,87,133,27,34,72
"2011","Mendip 004B","E01029041","Total",950,414,173,241,536,52,94,102,160,23,35,70
"2011","Mendip 004C","E01029042","Total",673,250,86,164,423,50,57,88,115,22,32,59
"2011","Mendip 004D","E01029043","Total",620,169,51,118,451,35,66,93,134,13,33,77
"2011","Mendip 004E","E01029045","Total",657,184,76,108,473,28,88,81,136,22,31,87
"2011","Mendip 005A","E01029052","Total",862,219,119,100,643,19,186,100,161,28,38,111
"2011","Mendip 005B","E01029060","Total",764,164,86,78,600,20,165,90,157,37,37,94
"2011","Mendip 005C","E01029061","Total",930,250,126,124,680,29,179,130,168,24,55,95
"2011","Mendip 005D","E01029083","Total",543,179,133,46,364,8,140,43,88,14,16,55
"2011","Mendip 006A","E01029018","Total",921,210,115,95,711,25,160,141,193,27,50,115
"2011","Mendip 006B","E01029056","Total",963,269,114,155,694,25,153,125,209,31,42,109
"2011","Mendip 006C","E01029064","Total",633,204,79,125,429,20,84,99,142,9,26,49
"2011","Mendip 006D","E01029084","Total",670,224,127,97,446,29,117,76,101,15,27,81
"2011","Mendip 007A","E01029029","Total",708,223,113,110,485,56,96,93,105,18,30,87
"2011","Mendip 007B","E01029035","Total",623,163,64,99,460,24,64,119,137,24,34,58
"2011","Mendip 007C","E01029037","Total",597,199,66,133,398,27,53,85,122,24,24,63
"2011","Mendip 007D","E01029038","Total",568,145,49,96,423,56,48,78,129,18,40,54
"2011","Mendip 007E","E01029039","Total",635,179,112,67,456,18,118,82,110,11,32,85
"2011","Mendip 007F","E01029040","Total",717,218,91,127,499,41,99,112,134,16,19,78
"2011","Mendip 008A","E01029078","Total",929,441,274,167,488,24,157,71,137,19,21,59
"2011","Mendip 008B","E01029079","Total",763,315,141,174,448,38,96,65,147,11,31,60
"2011","Mendip 008C","E01029080","Total",634,191,107,84,443,24,115,68,101,14,37,84
"2011","Mendip 008D","E01029081","Total",728,276,150,126,452,28,99,72,142,12,29,70
"2011","Mendip 008E","E01029082","Total",645,223,142,81,422,18,161,67,91,11,16,58
"2011","Mendip 009A","E01029062","Total",685,303,44,259,382,58,26,77,133,15,31,42
"2011","Mendip 009B","E01029063","Total",995,215,60,155,780,58,102,173,261,34,42,110
"2011","Mendip 009C","E01029065","Total",660,155,57,98,505,24,80,112,134,17,41,97
"2011","Mendip 009D","E01029066","Total",739,225,94,131,514,32,90,82,150,25,42,93
"2011","Mendip 009E","E01029067","Total",665,230,128,102,435,29,113,72,110,11,30,70
"2011","Mendip 010A","E01029020","Total",592,159,78,81,433,25,92,75,129,20,36,56
"2011","Mendip 010B","E01029021","Total",488,102,61,41,386,9,80,63,112,24,27,71
"2011","Mendip 010C","E01029027","Total",490,133,69,64,357,13,109,49,91,9,36,50
"2011","Mendip 010D","E01029028","Total",552,212,116,96,340,9,85,73,102,9,15,47
"2011","Mendip 010E","E01029058","Total",946,244,140,104,702,31,167,120,193,39,42,110
"2011","Mendip 011A","E01029046","Total",771,449,136,313,322,35,46,65,122,11,20,23
"2011","Mendip 011D","E01029050","Total",965,276,115,161,689,50,145,114,191,20,56,113
"2011","Mendip 011E","E01029051","Total",707,215,100,115,492,22,128,57,149,16,29,91
"2011","Mendip 011F","E01032627","Total",967,331,135,196,636,58,155,95,177,17,36,98
"2011","Mendip 012A","E01029047","Total",626,170,52,118,456,40,84,75,137,15,32,73
"2011","Mendip 012B","E01029054","Total",624,140,68,72,484,26,104,83,127,27,26,91
"2011","Mendip 012C","E01029055","Total",499,103,50,53,396,18,91,89,107,21,20,50
"2011","Mendip 012D","E01029074","Total",513,109,65,44,404,15,118,69,87,12,31,72
"2011","Mendip 012E","E01029076","Total",823,167,96,71,656,24,150,127,173,31,47,104
"2011","Mendip 013A","E01029019","Total",973,258,147,111,715,30,179,117,187,30,50,122
"2011","Mendip 013B","E01029059","Total",872,216,103,113,656,21,175,99,172,27,50,112
"2011","Mendip 013C","E01029077","Total",828,163,73,90,665,15,184,109,170,25,50,112
"2011","Mendip 014A","E01029070","Total",825,305,107,198,520,42,72,106,181,30,33,56
"2011","Mendip 014B","E01029071","Total",683,231,96,135,452,64,83,89,112,15,27,62
"2011","Mendip 014C","E01029072","Total",767,303,142,161,464,62,81,91,119,14,34,63
"2011","Mendip 014D","E01029073","Total",545,198,113,85,347,32,71,76,73,16,27,52
"2011","Mendip 014E","E01029075","Total",612,217,125,92,395,19,124,60,89,13,18,72
"2011","Sedgemoor 001A","E01029085","Total",878,263,115,148,615,34,117,130,193,16,37,88
"2011","Sedgemoor 001B","E01029126","Total",658,184,95,89,474,14,102,90,143,14,19,92
"2011","Sedgemoor 001C","E01029127","Total",782,359,226,133,423,34,130,63,106,15,19,56
"2011","Sedgemoor 001D","E01029128","Total",754,174,99,75,580,11,137,120,152,23,42,95
"2011","Sedgemoor 001E","E01029129","Total",719,133,73,60,586,16,141,126,129,22,59,93
"2011","Sedgemoor 002C","E01029089","Total",846,142,81,61,704,29,153,143,162,28,61,128
"2011","Sedgemoor 002D","E01029113","Total",736,228,171,57,508,17,198,69,117,14,32,61
"2011","Sedgemoor 002E","E01029115","Total",734,197,136,61,537,19,173,102,130,15,25,73
"2011","Sedgemoor 002F","E01029140","Total",1140,235,110,125,905,41,207,165,239,39,56,158
"2011","Sedgemoor 002G","E01032633","Total",967,276,152,124,691,24,240,71,198,14,39,105
"2011","Sedgemoor 003A","E01029086","Total",864,149,79,70,715,21,203,112,172,29,56,122
"2011","Sedgemoor 003B","E01029147","Total",679,128,79,49,551,11,153,98,130,24,41,94
"2011","Sedgemoor 003C","E01029148","Total",651,183,107,76,468,15,120,83,101,22,44,83
"2011","Sedgemoor 003D","E01029149","Total",554,136,86,50,418,9,89,79,100,16,47,78
"2011","Sedgemoor 004A","E01029114","Total",710,229,157,72,481,9,214,48,112,7,28,63
"2011","Sedgemoor 004B","E01029116","Total",817,409,187,222,408,28,128,46,126,6,25,49
"2011","Sedgemoor 004C","E01029117","Total",791,341,164,177,450,31,125,61,128,8,23,74
"2011","Sedgemoor 004D","E01029119","Total",764,324,227,97,440,33,109,67,123,13,28,67
"2011","Sedgemoor 004E","E01029120","Total",658,172,92,80,486,49,103,101,140,10,25,58
"2011","Sedgemoor 005A","E01029118","Total",717,156,96,60,561,25,129,113,138,29,45,82
"2011","Sedgemoor 005B","E01029131","Total",936,336,92,244,600,99,70,124,194,21,31,61
"2011","Sedgemoor 005C","E01029132","Total",636,216,116,100,420,52,70,74,91,25,31,77
"2011","Sedgemoor 005D","E01029133","Total",597,193,122,71,404,7,129,61,105,10,25,67
"2011","Sedgemoor 005E","E01029134","Total",857,249,147,102,608,35,198,73,163,10,36,93
"2011","Sedgemoor 006A","E01029135","Total",716,178,115,63,538,13,163,67,161,15,34,85
"2011","Sedgemoor 006B","E01029136","Total",809,191,109,82,618,25,140,114,163,17,45,114
"2011","Sedgemoor 006C","E01029145","Total",843,209,127,82,634,21,172,109,176,27,38,91
"2011","Sedgemoor 006D","E01029152","Total",941,281,174,107,660,37,188,101,176,24,26,108
"2011","Sedgemoor 007A","E01029121","Total",535,112,58,54,423,10,113,57,134,12,34,63
"2011","Sedgemoor 007B","E01029122","Total",589,129,72,57,460,21,127,75,120,12,24,81
"2011","Sedgemoor 007C","E01029123","Total",488,173,117,56,315,13,81,57,81,17,18,48
"2011","Sedgemoor 007D","E01029124","Total",792,242,153,89,550,20,171,84,151,22,23,79
"2011","Sedgemoor 007E","E01029125","Total",568,130,69,61,438,11,124,75,116,15,28,69
"2011","Sedgemoor 008A","E01029093","Total",728,236,73,163,492,61,60,118,159,14,23,57
"2011","Sedgemoor 008B","E01029096","Total",597,155,61,94,442,45,59,98,125,12,30,73
"2011","Sedgemoor 008C","E01029106","Total",617,152,57,95,465,69,78,55,110,34,48,71
"2011","Sedgemoor 008D","E01029107","Total",633,177,99,78,456,39,105,76,105,22,30,79
"2011","Sedgemoor 008E","E01029109","Total",517,120,54,66,397,40,47,78,89,28,44,71
"2011","Sedgemoor 009A","E01029094","Total",722,230,52,178,492,50,67,93,162,17,32,71
"2011","Sedgemoor 009B","E01029095","Total",741,305,95,210,436,47,49,79,152,11,25,73
"2011","Sedgemoor 009C","E01029110","Total",999,381,104,277,618,50,76,129,210,27,32,94
"2011","Sedgemoor 009D","E01029111","Total",966,216,75,141,750,63,84,186,213,42,61,101
"2011","Sedgemoor 009E","E01029112","Total",1007,492,191,301,515,36,105,65,190,7,19,93
"2011","Sedgemoor 010A","E01029090","Total",656,179,92,87,477,28,95,90,143,16,33,72
"2011","Sedgemoor 010B","E01029091","Total",740,239,60,179,501,31,56,125,195,14,22,58
"2011","Sedgemoor 010C","E01029092","Total",615,145,36,109,470,30,57,96,140,19,44,84
"2011","Sedgemoor 010D","E01029108","Total",944,283,136,147,661,34,175,112,202,16,29,93
"2011","Sedgemoor 011A","E01029102","Total",626,186,89,97,440,28,82,81,123,11,37,78
"2011","Sedgemoor 011B","E01029103","Total",629,153,106,47,476,13,151,80,113,12,30,77
"2011","Sedgemoor 011C","E01029104","Total",618,148,98,50,470,13,113,92,109,17,36,90
"2011","Sedgemoor 011E","E01032631","Total",543,124,30,94,419,48,40,118,125,21,26,41
"2011","Sedgemoor 011F","E01032632","Total",491,93,52,41,398,13,71,83,116,17,29,69
"2011","Sedgemoor 011G","E01032634","Total",501,110,60,50,391,6,115,62,103,13,31,61
"2011","Sedgemoor 012A","E01029130","Total",862,193,103,90,669,18,175,110,192,17,30,127
"2011","Sedgemoor 012B","E01029137","Total",631,125,70,55,506,10,142,70,142,18,38,86
"2011","Sedgemoor 012C","E01029138","Total",584,141,85,56,443,18,106,85,117,14,32,71
"2011","Sedgemoor 012D","E01029139","Total",607,141,80,61,466,16,131,75,106,17,43,78
"2011","Sedgemoor 012E","E01029150","Total",514,92,51,41,422,7,114,64,122,12,30,73
"2011","Sedgemoor 012F","E01029151","Total",560,140,87,53,420,15,152,60,99,11,19,64
"2011","Sedgemoor 013A","E01029097","Total",596,173,57,116,423,59,50,103,111,18,31,51
"2011","Sedgemoor 013B","E01029098","Total",638,251,75,176,387,26,65,72,118,13,29,64
"2011","Sedgemoor 013C","E01029099","Total",507,137,74,63,370,15,70,70,96,29,29,61
"2011","Sedgemoor 013D","E01029100","Total",491,102,36,66,389,38,42,63,97,35,45,69
"2011","Sedgemoor 013E","E01029105","Total",728,338,210,128,390,34,85,73,97,23,23,55
"2011","Sedgemoor 014A","E01029101","Total",462,109,47,62,353,27,74,67,88,18,21,58
"2011","Sedgemoor 014C","E01029142","Total",642,169,97,72,473,19,150,76,113,22,20,73
"2011","Sedgemoor 014D","E01029143","Total",630,204,127,77,426,32,116,66,109,14,27,62
"2011","Sedgemoor 014E","E01029144","Total",498,108,53,55,390,7,88,71,97,14,33,80
"2011","Sedgemoor 014F","E01032629","Total",624,134,60,74,490,34,84,88,169,22,17,76
"2011","Sedgemoor 014G","E01032630","Total",611,106,19,87,505,32,44,134,181,23,34,57
"2011","South Somerset 001A","E01029157","Total",577,227,128,99,350,28,78,62,112,11,21,38
"2011","South Somerset 001B","E01029158","Total",505,101,39,62,404,27,88,90,85,25,37,52
"2011","South Somerset 001C","E01029221","Total",1017,271,134,137,746,26,212,118,213,27,46,104
"2011","South Somerset 002A","E01029166","Total",946,236,125,111,710,21,204,103,184,32,54,112
"2011","South Somerset 002B","E01029167","Total",740,303,166,137,437,40,101,73,111,22,20,70
"2011","South Somerset 002C","E01029168","Total",742,254,158,96,488,25,151,79,121,18,24,70
"2011","South Somerset 002D","E01029210","Total",639,134,71,63,505,17,115,92,129,19,34,99
"2011","South Somerset 002E","E01029211","Total",593,138,80,58,455,14,126,77,132,16,19,71
"2011","South Somerset 003A","E01029224","Total",702,178,105,73,524,11,164,64,143,15,35,92
"2011","South Somerset 003B","E01029225","Total",933,258,139,119,675,42,197,112,166,23,38,97
"2011","South Somerset 003C","E01029226","Total",809,324,181,143,485,41,149,77,113,16,26,63
"2011","South Somerset 004A","E01029200","Total",640,237,104,133,403,23,91,68,118,12,34,57
"2011","South Somerset 004B","E01029201","Total",611,175,89,86,436,26,132,58,103,12,30,75
"2011","South Somerset 004C","E01029222","Total",646,138,86,52,508,18,115,86,145,30,36,78
"2011","South Somerset 004D","E01029223","Total",513,114,65,49,399,14,129,59,98,13,19,67
"2011","South Somerset 005A","E01029155","Total",789,199,110,89,590,6,218,74,172,11,25,84
"2011","South Somerset 005B","E01029227","Total",658,173,103,70,485,27,102,85,139,22,38,72
"2011","South Somerset 005C","E01029228","Total",719,183,114,69,536,34,123,102,180,19,27,51
"2011","South Somerset 005D","E01029229","Total",948,369,179,190,579,36,107,111,200,18,40,67
"2011","South Somerset 006A","E01029164","Total",613,187,121,66,426,11,127,73,99,22,34,60
"2011","South Somerset 006B","E01029165","Total",522,125,74,51,397,12,137,53,111,13,24,47
"2011","South Somerset 006C","E01029198","Total",486,90,28,62,396,26,26,138,125,26,30,25
"2011","South Somerset 006D","E01029199","Total",881,249,116,133,632,36,151,92,179,14,24,136
"2011","South Somerset 007A","E01029187","Total",443,120,80,40,323,20,90,57,84,10,16,46
"2011","South Somerset 007B","E01029188","Total",654,160,117,43,494,13,168,79,123,16,26,69
"2011","South Somerset 007C","E01029196","Total",619,145,90,55,474,23,124,80,119,20,23,85
"2011","South Somerset 007D","E01029197","Total",537,135,82,53,402,10,99,70,116,14,23,70
"2011","South Somerset 008A","E01029154","Total",773,192,70,122,581,29,144,103,157,21,30,97
"2011","South Somerset 008B","E01029156","Total",816,235,107,128,581,34,143,103,173,21,28,79
"2011","South Somerset 008C","E01029206","Total",645,213,125,88,432,24,99,61,116,16,33,83
"2011","South Somerset 008D","E01029207","Total",606,192,87,105,414,16,113,60,126,17,23,59
"2011","South Somerset 009A","E01029202","Total",557,203,115,88,354,19,90,54,105,8,31,47
"2011","South Somerset 009B","E01029203","Total",645,155,77,78,490,13,127,77,143,21,27,82
"2011","South Somerset 009C","E01029204","Total",537,144,76,68,393,15,125,72,99,13,18,51
"2011","South Somerset 009D","E01029205","Total",765,217,97,120,548,39,112,104,139,25,40,89
"2011","South Somerset 010A","E01029163","Total",946,238,130,108,708,26,185,100,202,23,47,125
"2011","South Somerset 010B","E01029216","Total",660,194,115,79,466,13,157,57,128,21,30,60
"2011","South Somerset 010C","E01029217","Total",679,194,105,89,485,6,145,85,140,14,32,63
"2011","South Somerset 010D","E01029218","Total",880,295,193,102,585,51,171,100,155,19,22,67
"2011","South Somerset 011A","E01029238","Total",651,181,79,102,470,52,76,91,126,18,28,79
"2011","South Somerset 011B","E01029252","Total",601,139,61,78,462,19,95,106,132,13,23,74
"2011","South Somerset 011C","E01029253","Total",704,216,85,131,488,48,87,105,157,7,23,61
"2011","South Somerset 011D","E01029254","Total",593,139,97,42,454,9,160,63,110,17,28,67
"2011","South Somerset 012A","E01029160","Total",960,171,27,144,789,46,68,244,236,40,57,98
"2011","South Somerset 012B","E01029248","Total",641,165,82,83,476,41,72,97,126,24,37,79
"2011","South Somerset 012C","E01029250","Total",549,131,72,59,418,7,132,59,102,15,27,76
"2011","South Somerset 012D","E01029251","Total",556,135,79,56,421,11,143,62,106,9,27,63
"2011","South Somerset 013A","E01029161","Total",660,166,34,132,494,43,38,118,163,17,33,82
"2011","South Somerset 013B","E01029162","Total",754,324,108,216,430,17,75,86,184,10,14,44
"2011","South Somerset 013C","E01029247","Total",626,174,66,108,452,64,49,109,84,38,38,70
"2011","South Somerset 013D","E01029255","Total",600,151,84,67,449,23,105,104,120,11,22,64
"2011","South Somerset 014A","E01029231","Total",676,217,92,125,459,31,88,83,125,22,23,87
"2011","South Somerset 014B","E01029233","Total",571,174,67,107,397,37,65,82,84,23,33,73
"2011","South Somerset 014C","E01029235","Total",625,206,96,110,419,31,105,69,99,21,35,59
"2011","South Somerset 014D","E01029236","Total",613,197,77,120,416,54,69,80,82,30,36,65
"2011","South Somerset 014E","E01029237","Total",664,227,107,120,437,60,70,87,114,10,29,67
"2011","South Somerset 015A","E01029232","Total",620,193,43,150,427,34,30,117,130,9,36,71
"2011","South Somerset 015B","E01029234","Total",995,536,176,360,459,28,90,73,184,12,23,49
"2011","South Somerset 015C","E01029239","Total",700,310,104,206,390,43,64,80,100,20,24,59
"2011","South Somerset 015D","E01029240","Total",624,173,48,125,451,23,54,117,142,18,30,67
"2011","South Somerset 016A","E01029241","Total",813,251,75,176,562,51,60,149,181,22,29,70
"2011","South Somerset 016B","E01029245","Total",925,238,87,151,687,34,131,154,199,27,42,100
"2011","South Somerset 016C","E01029246","Total",612,180,89,91,432,12,117,72,114,15,24,78
"2011","South Somerset 016D","E01029249","Total",635,224,129,95,411,44,98,72,93,8,26,70
"2011","South Somerset 017A","E01029189","Total",481,140,87,53,341,21,83,66,73,15,26,57
"2011","South Somerset 017B","E01029190","Total",584,187,104,83,397,7,132,72,110,10,14,52
"2011","South Somerset 017C","E01029191","Total",548,167,102,65,381,22,107,75,90,11,24,52
"2011","South Somerset 017D","E01029192","Total",621,180,77,103,441,22,103,75,119,22,34,66
"2011","South Somerset 017E","E01029212","Total",479,134,74,60,345,8,118,48,96,7,23,45
"2011","South Somerset 017F","E01029213","Total",552,148,92,56,404,10,124,75,97,15,28,55
"2011","South Somerset 017G","E01029214","Total",483,110,52,58,373,15,100,51,108,14,23,62
"2011","South Somerset 017H","E01029215","Total",506,167,98,69,339,23,93,55,82,16,19,51
"2011","South Somerset 018A","E01029159","Total",634,163,36,127,471,15,56,130,162,13,39,56
"2011","South Somerset 018B","E01029242","Total",631,174,52,122,457,28,73,94,141,11,29,81
"2011","South Somerset 018C","E01029243","Total",775,281,184,97,494,16,177,57,128,11,26,79
"2011","South Somerset 018D","E01029244","Total",619,130,54,76,489,9,118,92,142,21,18,89
"2011","South Somerset 019A","E01029193","Total",911,326,164,162,585,52,151,98,165,21,29,69
"2011","South Somerset 019B","E01029194","Total",1080,291,150,141,789,57,209,162,202,27,32,100
"2011","South Somerset 019C","E01029195","Total",704,247,145,102,457,24,136,89,106,10,23,69
"2011","South Somerset 019D","E01029208","Total",488,140,97,43,348,18,97,55,105,8,16,49
"2011","South Somerset 019E","E01029209","Total",564,126,80,46,438,16,155,63,109,8,25,62
"2011","South Somerset 020A","E01029178","Total",642,159,94,65,483,8,162,70,125,16,24,78
"2011","South Somerset 020B","E01029179","Total",504,147,73,74,357,18,101,59,101,14,20,44
"2011","South Somerset 020C","E01029180","Total",591,125,78,47,466,13,124,85,127,9,29,79
"2011","South Somerset 020D","E01029181","Total",620,193,100,93,427,19,134,60,130,12,17,55
"2011","South Somerset 021A","E01029182","Total",618,144,85,59,474,12,143,72,120,15,35,77
"2011","South Somerset 021B","E01029183","Total",602,147,78,69,455,26,104,82,119,20,43,61
"2011","South Somerset 021C","E01029184","Total",831,243,121,122,588,27,205,85,164,17,23,67
"2011","South Somerset 021D","E01029185","Total",812,318,120,198,494,30,118,94,169,10,30,43
"2011","South Somerset 021E","E01029186","Total",722,320,192,128,402,28,100,61,108,9,27,69
"2011","South Somerset 022A","E01029169","Total",621,128,62,66,493,35,111,87,139,18,35,68
"2011","South Somerset 022B","E01029172","Total",624,146,89,57,478,14,134,87,126,18,36,63
"2011","South Somerset 022C","E01029173","Total",522,136,54,82,386,41,64,91,106,12,30,42
"2011","South Somerset 022D","E01029176","Total",556,163,84,79,393,8,109,66,111,12,21,66
"2011","South Somerset 022E","E01029177","Total",526,199,102,97,327,28,63,63,89,21,13,50
"2011","South Somerset 023A","E01029170","Total",493,170,68,102,323,28,68,69,78,14,21,45
"2011","South Somerset 023B","E01029171","Total",995,396,207,189,599,26,161,100,160,12,26,114
"2011","South Somerset 023C","E01029174","Total",501,157,107,50,344,12,126,36,84,10,17,59
"2011","South Somerset 023D","E01029175","Total",944,356,175,181,588,56,117,130,138,30,46,71
"2011","South Somerset 024A","E01029153","Total",1067,311,168,143,756,23,235,105,219,24,29,121
"2011","South Somerset 024B","E01029219","Total",583,122,71,51,461,9,152,48,110,22,39,81
"2011","South Somerset 024C","E01029220","Total",525,152,104,48,373,13,107,55,95,15,27,61
"2011","South Somerset 024D","E01029230","Total",983,235,138,97,748,14,241,100,200,21,48,124
"2011","Taunton Deane 001A","E01029258","Total",605,144,69,75,461,24,106,94,119,13,30,75
"2011","Taunton Deane 001B","E01029259","Total",610,190,108,82,420,23,100,90,92,17,29,69
"2011","Taunton Deane 001C","E01029260","Total",863,174,56,118,689,64,71,222,167,48,38,79
"2011","Taunton Deane 001D","E01029268","Total",658,153,72,81,505,20,144,89,126,18,34,74
"2011","Taunton Deane 002A","E01029276","Total",584,200,105,95,384,7,100,70,107,14,27,59
"2011","Taunton Deane 002B","E01029278","Total",540,127,67,60,413,9,127,61,99,16,34,67
"2011","Taunton Deane 002C","E01029290","Total",632,192,80,112,440,27,85,79,139,11,32,67
"2011","Taunton Deane 002D","E01029306","Total",617,146,102,44,471,11,133,80,123,12,43,69
"2011","Taunton Deane 002E","E01029319","Total",582,98,18,80,484,42,32,137,169,15,30,59
"2011","Taunton Deane 003A","E01029267","Total",744,243,134,109,501,29,144,92,93,25,38,80
"2011","Taunton Deane 003B","E01029320","Total",704,238,109,129,466,42,102,79,132,20,27,64
"2011","Taunton Deane 003C","E01029321","Total",972,253,132,121,719,34,194,117,178,26,49,121
"2011","Taunton Deane 004A","E01029297","Total",606,243,124,119,363,39,64,51,109,8,34,58
"2011","Taunton Deane 004B","E01029298","Total",610,168,92,76,442,43,77,96,96,23,34,73
"2011","Taunton Deane 004C","E01029304","Total",658,227,125,102,431,44,75,64,108,25,36,79
"2011","Taunton Deane 004D","E01029305","Total",599,171,83,88,428,33,98,82,92,11,25,87
"2011","Taunton Deane 004E","E01029307","Total",610,211,110,101,399,38,80,86,64,28,36,67
"2011","Taunton Deane 005A","E01029271","Total",769,218,128,90,551,13,155,104,153,13,32,81
"2011","Taunton Deane 005B","E01029273","Total",497,123,76,47,374,24,98,75,76,27,24,50
"2011","Taunton Deane 005C","E01029274","Total",647,159,105,54,488,15,154,70,129,12,29,79
"2011","Taunton Deane 005D","E01029275","Total",565,175,117,58,390,17,133,47,93,10,28,62
"2011","Taunton Deane 005E","E01029279","Total",601,143,81,62,458,24,110,103,115,13,25,68
"2011","Taunton Deane 006A","E01029282","Total",639,208,44,164,431,33,33,112,176,8,18,51
"2011","Taunton Deane 006B","E01029291","Total",763,285,104,181,478,57,104,58,155,16,18,70
"2011","Taunton Deane 006C","E01029294","Total",716,170,59,111,546,45,69,136,155,13,37,91
"2011","Taunton Deane 006D","E01029317","Total",523,146,81,65,377,20,77,87,84,14,28,67
"2011","Taunton Deane 006E","E01029318","Total",623,150,88,62,473,9,142,81,117,8,29,87
"2011","Taunton Deane 007A","E01029285","Total",1066,350,86,264,716,40,62,145,301,15,30,123
"2011","Taunton Deane 007B","E01029287","Total",678,219,34,185,459,37,29,102,187,4,27,73
"2011","Taunton Deane 007C","E01029288","Total",655,208,74,134,447,24,81,122,127,14,21,58
"2011","Taunton Deane 007D","E01029289","Total",897,370,139,231,527,32,72,107,189,25,19,83
"2011","Taunton Deane 007E","E01029299","Total",718,319,149,170,399,27,80,63,131,12,24,62
"2011","Taunton Deane 007F","E01029300","Total",666,177,56,121,489,40,57,113,182,9,26,62
"2011","Taunton Deane 008A","E01029256","Total",625,193,118,75,432,12,138,61,114,14,28,65
"2011","Taunton Deane 008B","E01029257","Total",867,230,133,97,637,51,137,116,159,22,46,106
"2011","Taunton Deane 008D","E01029277","Total",473,148,49,99,325,31,47,85,105,4,13,40
"2011","Taunton Deane 008E","E01032651","Total",536,109,33,76,427,16,77,78,162,10,21,63
"2011","Taunton Deane 008F","E01032652","Total",490,122,44,78,368,29,80,75,106,12,22,44
"2011","Taunton Deane 009A","E01029280","Total",690,230,109,121,460,42,83,91,115,17,35,77
"2011","Taunton Deane 009B","E01029281","Total",758,275,93,182,483,38,85,90,146,8,42,74
"2011","Taunton Deane 009C","E01029283","Total",769,208,82,126,561,44,89,105,183,15,32,93
"2011","Taunton Deane 009D","E01029292","Total",630,234,90,144,396,69,57,60,105,16,29,60
"2011","Taunton Deane 009E","E01029293","Total",611,146,59,87,465,123,32,108,73,43,33,53
"2011","Taunton Deane 010A","E01029266","Total",586,231,134,97,355,22,101,53,111,4,15,49
"2011","Taunton Deane 010B","E01029284","Total",881,473,188,285,408,21,78,43,193,4,9,60
"2011","Taunton Deane 010C","E01029286","Total",710,253,82,171,457,45,36,114,167,7,29,59
"2011","Taunton Deane 010D","E01029301","Total",1016,493,273,220,523,25,162,88,160,12,21,55
"2011","Taunton Deane 010E","E01029303","Total",836,242,176,66,594,19,223,104,131,18,26,73
"2011","Taunton Deane 011A","E01029263","Total",593,156,65,91,437,27,77,108,122,12,28,63
"2011","Taunton Deane 011B","E01029264","Total",575,153,109,44,422,10,145,64,102,17,22,62
"2011","Taunton Deane 011C","E01029265","Total",611,164,90,74,447,11,144,66,99,13,26,88
"2011","Taunton Deane 011D","E01029302","Total",716,229,168,61,487,13,156,85,91,23,32,87
"2011","Taunton Deane 011E","E01029308","Total",860,251,176,75,609,20,207,113,119,29,45,76
"2011","Taunton Deane 012A","E01029309","Total",899,311,139,172,588,65,101,112,167,25,28,90
"2011","Taunton Deane 012B","E01029311","Total",593,194,108,86,399,36,86,67,90,15,41,64
"2011","Taunton Deane 012C","E01029312","Total",600,181,109,72,419,21,75,88,111,21,29,74
"2011","Taunton Deane 012D","E01029313","Total",560,168,51,117,392,24,59,105,107,19,27,51
"2011","Taunton Deane 012E","E01029316","Total",789,337,178,159,452,37,101,96,122,12,22,62
"2011","Taunton Deane 013A","E01029262","Total",971,222,134,88,749,15,190,111,227,24,59,123
"2011","Taunton Deane 013B","E01029269","Total",859,202,98,104,657,19,159,106,207,20,42,104
"2011","Taunton Deane 013C","E01029310","Total",785,197,139,58,588,16,219,89,137,14,27,86
"2011","Taunton Deane 013D","E01029314","Total",1059,279,118,161,780,71,153,160,188,38,53,117
"2011","Taunton Deane 013E","E01029315","Total",648,179,130,49,469,19,161,82,98,16,26,67
"2011","Taunton Deane 014A","E01029261","Total",846,181,95,86,665,10,178,101,186,27,52,111
"2011","Taunton Deane 014B","E01029270","Total",921,234,122,112,687,18,190,97,210,24,46,102
"2011","Taunton Deane 014C","E01029295","Total",699,176,68,108,523,18,121,94,159,11,41,79
"2011","Taunton Deane 014D","E01029296","Total",628,182,121,61,446,6,124,88,108,14,28,78
"2011","West Somerset 001B","E01029324","Total",687,216,124,92,471,28,101,84,123,27,27,81
"2011","West Somerset 001C","E01029329","Total",735,315,185,130,420,19,119,72,81,15,43,71
"2011","West Somerset 001D","E01029330","Total",993,405,219,186,588,24,239,51,161,14,25,74
"2011","West Somerset 001F","E01032636","Total",925,360,221,139,565,28,170,87,155,18,34,73
"2011","West Somerset 002A","E01029322","Total",625,214,118,96,411,29,129,56,113,19,26,39
"2011","West Somerset 002B","E01029331","Total",722,241,179,62,481,15,244,39,98,7,20,58
"2011","West Somerset 002C","E01029333","Total",557,204,102,102,353,22,112,72,79,12,13,43
"2011","West Somerset 002D","E01029336","Total",983,329,215,114,654,16,246,82,177,21,28,84
"2011","West Somerset 003A","E01029326","Total",539,174,112,62,365,8,130,40,98,7,24,58
"2011","West Somerset 003B","E01029334","Total",530,182,100,82,348,12,130,39,93,12,18,44
"2011","West Somerset 003C","E01029339","Total",671,232,116,116,439,33,88,63,127,23,32,73
"2011","West Somerset 003E","E01029341","Total",619,235,111,124,384,22,116,63,94,7,26,56
"2011","West Somerset 003G","E01032635","Total",895,251,141,110,644,28,180,106,147,23,45,115
"2011","West Somerset 004A","E01029327","Total",875,212,118,94,663,12,207,83,207,31,32,91
"2011","West Somerset 004B","E01029335","Total",497,134,71,63,363,20,110,42,115,5,15,56
"2011","West Somerset 004C","E01029337","Total",931,242,144,98,689,22,222,83,194,27,43,98
"2011","West Somerset 004D","E01029342","Total",530,170,106,64,360,1,166,40,82,8,14,49
"2011","West Somerset 004E","E01029343","Total",686,213,134,79,473,22,142,57,137,22,30,63
"2011","West Somerset 005A","E01029325","Total",887,301,181,120,586,9,225,64,159,13,34,82
"2011","West Somerset 005B","E01029328","Total",971,387,252,135,584,24,211,76,154,12,28,79
"2011","West Somerset 005C","E01029338","Total",765,195,92,103,570,23,176,64,154,18,32,103
"2011","Isle of Anglesey 001A","W01000003","Total",1131,430,193,237,701,54,147,123,158,29,56,134
"2011","Isle of Anglesey 001B","W01000004","Total",555,154,94,60,401,22,133,50,83,14,37,62
"2011","Isle of Anglesey 001C","W01000018","Total",646,235,120,115,411,34,126,60,94,13,26,58
"2011","Isle of Anglesey 001D","W01000028","Total",802,220,91,129,582,28,123,106,153,26,43,103
"2011","Isle of Anglesey 001E","W01000031","Total",659,195,90,105,464,17,113,85,106,20,24,99
"2011","Isle of Anglesey 002A","W01000010","Total",899,318,186,132,581,24,215,76,133,15,32,86
"2011","Isle of Anglesey 002B","W01000020","Total",558,156,98,58,402,11,111,43,100,17,33,87
"2011","Isle of Anglesey 002C","W01000021","Total",968,273,153,120,695,23,196,100,166,16,58,136
"2011","Isle of Anglesey 002D","W01000032","Total",491,161,98,63,330,18,117,35,74,12,21,53
"2011","Isle of Anglesey 003A","W01000016","Total",579,259,60,199,320,47,45,56,83,12,26,51
"2011","Isle of Anglesey 003B","W01000017","Total",642,193,73,120,449,32,76,82,118,21,41,79
"2011","Isle of Anglesey 003C","W01000029","Total",718,296,135,161,422,55,73,78,111,25,15,65
"2011","Isle of Anglesey 003D","W01000030","Total",997,347,121,226,650,92,109,127,147,20,47,108
"2011","Isle of Anglesey 003E","W01000033","Total",697,284,122,162,413,51,82,72,96,13,36,63
"2011","Isle of Anglesey 003F","W01000036","Total",522,232,85,147,290,38,45,52,70,12,28,45
"2011","Isle of Anglesey 003G","W01000037","Total",518,190,73,117,328,15,81,63,66,16,27,60
"2011","Isle of Anglesey 004A","W01000022","Total",689,183,103,80,506,19,132,62,143,29,40,81
"2011","Isle of Anglesey 004B","W01000034","Total",520,156,78,78,364,23,95,70,91,10,17,58
"2011","Isle of Anglesey 004C","W01000039","Total",472,142,85,57,330,9,112,51,77,8,12,61
"2011","Isle of Anglesey 004D","W01000040","Total",537,178,101,77,359,17,132,39,87,7,25,52
"2011","Isle of Anglesey 004E","W01000043","Total",528,172,91,81,356,26,89,60,79,18,24,60
"2011","Isle of Anglesey 004F","W01000044","Total",495,133,67,66,362,9,112,50,89,14,30,58
"2011","Isle of Anglesey 005A","W01000005","Total",980,387,189,198,593,35,198,74,167,22,26,71
"2011","Isle of Anglesey 005B","W01000013","Total",942,237,136,101,705,27,198,114,161,33,37,135
"2011","Isle of Anglesey 005C","W01000019","Total",691,219,120,99,472,17,197,41,110,11,36,60
"2011","Isle of Anglesey 005D","W01000026","Total",580,207,116,91,373,12,133,49,95,10,16,58
"2011","Isle of Anglesey 005E","W01000035","Total",804,245,116,129,559,17,137,102,139,24,40,100
"2011","Isle of Anglesey 006A","W01000006","Total",654,186,86,100,468,19,107,67,116,22,26,111
"2011","Isle of Anglesey 006B","W01000012","Total",665,212,128,84,453,14,131,81,108,16,21,82
"2011","Isle of Anglesey 006C","W01000014","Total",891,276,146,130,615,42,111,143,164,22,36,97
"2011","Isle of Anglesey 006D","W01000041","Total",637,199,97,102,438,88,50,74,88,33,31,74
"2011","Isle of Anglesey 007A","W01000001","Total",559,229,119,110,330,15,105,45,86,6,15,58
"2011","Isle of Anglesey 007B","W01000002","Total",559,182,88,94,377,17,95,65,88,15,27,70
"2011","Isle of Anglesey 007C","W01000009","Total",778,219,103,116,559,37,116,80,142,30,56,98
"2011","Isle of Anglesey 007D","W01000023","Total",599,176,85,91,423,22,89,72,108,18,26,88
"2011","Isle of Anglesey 007E","W01000024","Total",508,104,29,75,404,38,33,143,103,32,26,29
"2011","Isle of Anglesey 008A","W01000008","Total",617,169,81,88,448,20,113,98,98,11,27,81
"2011","Isle of Anglesey 008B","W01000011","Total",609,263,145,118,346,18,67,44,110,3,19,85
"2011","Isle of Anglesey 008C","W01000015","Total",653,173,103,70,480,22,133,69,115,16,35,90
"2011","Isle of Anglesey 008D","W01000042","Total",910,286,135,151,624,30,116,132,146,25,40,135
"2011","Isle of Anglesey 009A","W01000007","Total",717,212,92,120,505,22,119,77,131,16,37,103
"2011","Isle of Anglesey 009B","W01000025","Total",859,239,112,127,620,30,136,121,160,16,41,116
"2011","Isle of Anglesey 009C","W01000027","Total",773,245,92,153,528,26,120,107,123,22,30,100
"2011","Isle of Anglesey 009D","W01000038","Total",986,316,167,149,670,40,177,102,154,26,47,124
"2011","Gwynedd 001A","W01000062","Total",553,185,45,140,368,11,20,25,108,22,12,170
"2011","Gwynedd 001B","W01000076","Total",439,165,60,105,274,10,49,31,69,9,19,87
"2011","Gwynedd 001C","W01000077","Total",586,216,92,124,370,30,54,40,91,7,15,133
"2011","Gwynedd 001D","W01000091","Total",510,208,51,157,302,46,35,45,71,15,21,69
"2011","Gwynedd 001E","W01000092","Total",697,212,77,135,485,3,40,25,96,6,28,287
"2011","Gwynedd 002A","W01000064","Total",693,152,77,75,541,32,95,102,110,40,49,113
"2011","Gwynedd 002B","W01000072","Total",700,199,107,92,501,26,114,72,93,19,55,122
"2011","Gwynedd 002C","W01000075","Total",622,200,94,106,422,41,50,77,106,9,29,110
"2011","Gwynedd 002D","W01000090","Total",519,125,59,66,394,64,55,68,71,26,44,66
"2011","Gwynedd 002E","W01000102","Total",477,156,62,94,321,5,62,72,70,18,27,67
"2011","Gwynedd 003A","W01000050","Total",580,166,83,83,414,27,76,67,119,25,34,66
"2011","Gwynedd 003B","W01000071","Total",1016,361,110,251,655,53,79,153,168,36,51,115
"2011","Gwynedd 003C","W01000096","Total",513,145,67,78,368,34,69,83,81,15,23,63
"2011","Gwynedd 003D","W01000097","Total",529,204,68,136,325,26,52,55,111,12,14,55
"2011","Gwynedd 003E","W01000115","Total",908,237,98,139,671,41,134,129,173,32,48,114
"2011","Gwynedd 004A","W01000052","Total",461,106,56,50,355,20,69,68,84,16,33,65
"2011","Gwynedd 004B","W01000053","Total",497,150,53,97,347,15,62,59,87,21,31,72
"2011","Gwynedd 004C","W01000087","Total",756,197,108,89,559,36,98,118,131,34,41,101
"2011","Gwynedd 004D","W01000119","Total",1006,358,133,225,648,29,108,135,205,24,39,108
"2011","Gwynedd 005A","W01000063","Total",802,259,113,146,543,59,73,119,133,30,40,89
"2011","Gwynedd 005B","W01000081","Total",896,332,157,175,564,25,113,119,149,13,47,98
"2011","Gwynedd 005C","W01000099","Total",724,207,91,116,517,29,85,99,135,21,49,99
"2011","Gwynedd 005D","W01000103","Total",527,167,71,96,360,16,69,61,101,17,27,69
"2011","Gwynedd 006A","W01000059","Total",954,393,149,244,561,78,124,93,104,23,41,98
"2011","Gwynedd 006B","W01000093","Total",1037,417,199,218,620,22,184,85,156,24,40,109
"2011","Gwynedd 006C","W01000098","Total",925,276,102,174,649,115,86,120,129,37,58,104
"2011","Gwynedd 006D","W01000110","Total",592,136,66,70,456,30,68,81,118,22,41,96
"2011","Gwynedd 007A","W01000054","Total",472,136,73,63,336,17,86,64,72,9,29,59
"2011","Gwynedd 007B","W01000088","Total",817,230,132,98,587,32,119,123,140,29,40,104
"2011","Gwynedd 007C","W01000111","Total",763,346,156,190,417,47,70,80,110,12,30,68
"2011","Gwynedd 007D","W01000118","Total",715,225,98,127,490,31,100,85,126,33,34,81
"2011","Gwynedd 008A","W01000073","Total",729,227,125,102,502,20,118,97,132,15,34,86
"2011","Gwynedd 008B","W01000086","Total",952,287,139,148,665,48,152,98,167,40,48,112
"2011","Gwynedd 008C","W01000104","Total",793,278,117,161,515,51,124,72,110,26,43,89
"2011","Gwynedd 008D","W01000112","Total",861,307,132,175,554,47,109,96,162,32,41,67
"2011","Gwynedd 009A","W01000056","Total",869,356,141,215,513,49,95,94,125,21,45,84
"2011","Gwynedd 009B","W01000065","Total",584,271,109,162,313,26,64,41,110,13,26,33
"2011","Gwynedd 009C","W01000113","Total",830,304,138,166,526,48,123,84,115,23,42,91
"2011","Gwynedd 009D","W01000114","Total",714,244,118,126,470,27,143,62,111,27,29,71
"2011","Gwynedd 010A","W01000066","Total",513,155,81,74,358,13,104,45,85,20,24,67
"2011","Gwynedd 010B","W01000100","Total",466,162,72,90,304,20,82,44,65,17,24,52
"2011","Gwynedd 010C","W01000105","Total",779,297,126,171,482,43,108,79,104,34,31,83
"2011","Gwynedd 010D","W01000106","Total",872,368,189,179,504,10,205,67,121,9,25,67
"2011","Gwynedd 010E","W01000107","Total",588,226,125,101,362,26,97,64,82,7,22,64
"2011","Gwynedd 011A","W01000047","Total",586,198,111,87,388,19,96,59,89,25,28,72
"2011","Gwynedd 011B","W01000061","Total",801,300,167,133,501,18,177,62,106,23,32,83
"2011","Gwynedd 011C","W01000078","Total",722,250,130,120,472,31,89,83,113,18,43,95
"2011","Gwynedd 011D","W01000089","Total",849,243,131,112,606,23,147,89,144,42,58,103
"2011","Gwynedd 012A","W01000070","Total",543,164,79,85,379,8,105,54,82,23,28,79
"2011","Gwynedd 012B","W01000094","Total",574,221,124,97,353,17,102,57,82,13,22,60
"2011","Gwynedd 012C","W01000095","Total",618,225,111,114,393,27,111,70,77,19,38,51
"2011","Gwynedd 012D","W01000108","Total",1048,432,178,254,616,55,129,128,156,33,33,82
"2011","Gwynedd 012E","W01000109","Total",871,349,166,183,522,39,132,87,114,23,38,89
"2011","Gwynedd 013A","W01000069","Total",751,292,184,108,459,21,162,55,115,10,28,68
"2011","Gwynedd 013B","W01000074","Total",946,363,177,186,583,27,193,65,163,23,30,82
"2011","Gwynedd 013C","W01000079","Total",528,208,124,84,320,15,120,39,75,12,22,37
"2011","Gwynedd 013D","W01000101","Total",656,227,131,96,429,34,96,74,100,24,37,64
"2011","Gwynedd 014C","W01000080","Total",915,395,232,163,520,23,194,64,138,10,32,59
"2011","Gwynedd 014D","W01000084","Total",556,205,119,86,351,18,110,44,81,14,26,58
"2011","Gwynedd 014E","W01001932","Total",1227,409,215,194,818,26,187,121,190,51,80,163
"2011","Gwynedd 015A","W01000051","Total",936,385,192,193,551,42,125,93,133,22,39,97
"2011","Gwynedd 015B","W01000060","Total",624,220,91,129,404,34,91,68,120,12,25,54
"2011","Gwynedd 015C","W01000082","Total",436,109,48,61,327,21,65,51,90,19,18,63
"2011","Gwynedd 015D","W01000083","Total",560,184,77,107,376,13,100,54,89,26,25,69
"2011","Gwynedd 016A","W01000048","Total",625,233,139,94,392,35,99,62,92,11,32,61
"2011","Gwynedd 016B","W01000049","Total",620,327,105,222,293,37,56,43,95,15,14,33
"2011","Gwynedd 016C","W01000057","Total",635,216,115,101,419,9,120,58,104,17,31,80
"2011","Gwynedd 016D","W01000067","Total",592,263,95,168,329,17,94,52,93,8,15,50
"2011","Gwynedd 016E","W01000068","Total",688,289,162,127,399,35,84,69,110,21,25,55
"2011","Gwynedd 017C","W01000085","Total",978,368,176,192,610,27,222,62,156,23,28,92
"2011","Gwynedd 017D","W01000116","Total",864,357,211,146,507,21,238,55,110,13,19,51
"2011","Gwynedd 017E","W01000117","Total",737,297,152,145,440,45,105,65,121,23,22,59
"2011","Gwynedd 017F","W01001933","Total",1151,471,240,231,680,12,250,94,188,15,32,89
"2011","Conwy 001A","W01000132","Total",708,311,113,198,397,35,103,44,100,14,21,80
"2011","Conwy 001B","W01000146","Total",1016,465,117,348,551,41,105,75,195,10,30,95
"2011","Conwy 001C","W01000147","Total",760,336,207,129,424,20,155,55,104,8,25,57
"2011","Conwy 001D","W01000169","Total",916,469,219,250,447,32,91,58,148,8,25,85
"2011","Conwy 001E","W01000186","Total",828,379,222,157,449,58,103,59,109,15,40,65
"2011","Conwy 002A","W01000133","Total",873,312,215,97,561,13,243,64,106,18,32,85
"2011","Conwy 002B","W01000168","Total",757,237,115,122,520,48,100,100,121,22,48,81
"2011","Conwy 002C","W01000187","Total",633,216,61,155,417,87,45,73,72,34,40,66
"2011","Conwy 002D","W01000188","Total",780,225,140,85,555,26,182,90,123,15,28,91
"2011","Conwy 003A","W01000154","Total",610,194,121,73,416,18,131,72,100,11,21,63
"2011","Conwy 003B","W01000173","Total",652,205,100,105,447,31,86,100,144,12,20,54
"2011","Conwy 003C","W01000174","Total",745,216,137,79,529,23,153,96,127,20,36,74
"2011","Conwy 003D","W01000175","Total",799,248,185,63,551,20,255,62,114,12,17,71
"2011","Conwy 004A","W01000155","Total",673,256,152,104,417,15,155,52,96,12,32,55
"2011","Conwy 004B","W01000156","Total",819,386,251,135,433,14,167,50,118,8,14,62
"2011","Conwy 004C","W01000157","Total",731,335,159,176,396,33,89,77,95,19,21,62
"2011","Conwy 004D","W01000158","Total",779,272,199,73,507,22,241,51,93,11,15,74
"2011","Conwy 005A","W01000149","Total",677,206,125,81,471,30,140,62,124,11,30,74
"2011","Conwy 005B","W01000150","Total",632,161,91,70,471,22,134,76,102,25,35,77
"2011","Conwy 005C","W01000151","Total",621,148,69,79,473,51,87,95,105,29,40,66
"2011","Conwy 005D","W01000152","Total",614,167,93,74,447,30,119,81,99,17,31,70
"2011","Conwy 005E","W01000184","Total",1062,323,177,146,739,46,242,76,184,20,44,127
"2011","Conwy 006A","W01000135","Total",1009,343,232,111,666,18,303,87,133,9,27,89
"2011","Conwy 006B","W01000136","Total",852,321,154,167,531,22,158,85,134,24,29,79
"2011","Conwy 006C","W01000165","Total",865,254,161,93,611,30,199,86,136,15,41,104
"2011","Conwy 006D","W01000166","Total",813,237,123,114,576,49,129,116,127,24,45,86
"2011","Conwy 007A","W01000139","Total",691,215,115,100,476,29,96,104,93,21,47,86
"2011","Conwy 007B","W01000143","Total",649,198,79,119,451,48,67,85,114,14,39,84
"2011","Conwy 007C","W01000144","Total",712,331,79,252,381,46,37,66,120,25,25,62
"2011","Conwy 007D","W01000182","Total",950,489,222,267,461,42,139,60,125,14,29,52
"2011","Conwy 008A","W01000138","Total",886,349,186,163,537,44,150,83,137,21,29,73
"2011","Conwy 008B","W01000145","Total",578,193,84,109,385,44,77,76,109,15,17,47
"2011","Conwy 008C","W01000180","Total",599,116,57,59,483,22,110,84,91,20,59,97
"2011","Conwy 008D","W01000181","Total",610,132,43,89,478,35,59,110,136,23,37,78
"2011","Conwy 008E","W01000183","Total",585,228,124,104,357,23,108,55,68,11,34,58
"2011","Conwy 009A","W01000126","Total",743,224,95,129,519,36,99,98,148,15,39,84
"2011","Conwy 009B","W01000127","Total",578,162,64,98,416,42,110,64,92,23,22,63
"2011","Conwy 009C","W01000128","Total",677,272,132,140,405,28,96,61,93,12,36,79
"2011","Conwy 009D","W01000153","Total",713,222,112,110,491,19,129,87,148,11,26,71
"2011","Conwy 009E","W01000163","Total",503,115,32,83,388,50,55,70,85,30,33,65
"2011","Conwy 009F","W01000164","Total",549,126,43,83,423,44,55,79,112,23,38,72
"2011","Conwy 010B","W01000140","Total",651,215,115,100,436,32,102,80,104,16,30,72
"2011","Conwy 010C","W01000141","Total",802,285,222,63,517,19,250,55,119,12,9,53
"2011","Conwy 010D","W01000142","Total",715,189,135,54,526,12,214,60,111,11,33,85
"2011","Conwy 010E","W01000178","Total",839,318,155,163,521,74,117,77,104,19,50,80
"2011","Conwy 010F","W01000179","Total",775,262,168,94,513,13,209,57,122,9,31,72
"2011","Conwy 010G","W01001927","Total",582,151,87,64,431,26,144,66,98,18,24,55
"2011","Conwy 010H","W01001928","Total",622,275,107,168,347,25,114,38,124,8,6,32
"2011","Conwy 011C","W01000167","Total",815,240,125,115,575,54,128,100,142,29,34,88
"2011","Conwy 011D","W01000176","Total",718,263,114,149,455,46,66,101,106,15,38,83
"2011","Conwy 011E","W01000177","Total",489,95,58,37,394,28,97,60,84,12,26,87
"2011","Conwy 011F","W01001926","Total",1001,301,139,162,700,35,216,100,182,18,38,111
"2011","Conwy 012A","W01000124","Total",887,265,150,115,622,22,193,98,144,18,41,106
"2011","Conwy 012B","W01000129","Total",497,185,83,102,312,24,71,52,84,10,20,51
"2011","Conwy 012C","W01000130","Total",767,311,131,180,456,29,128,77,121,9,22,70
"2011","Conwy 012D","W01000131","Total",604,168,90,78,436,30,97,72,101,12,42,82
"2011","Conwy 013A","W01000123","Total",744,252,115,137,492,22,99,87,144,23,41,76
"2011","Conwy 013B","W01000125","Total",690,236,151,85,454,20,114,73,130,10,24,83
"2011","Conwy 013C","W01000170","Total",783,221,104,117,562,28,139,107,138,13,34,103
"2011","Conwy 013D","W01000171","Total",690,248,97,151,442,22,100,88,110,7,43,72
"2011","Conwy 013E","W01000172","Total",595,212,73,139,383,57,50,72,113,10,23,58
"2011","Conwy 014A","W01000122","Total",882,245,115,130,637,21,147,93,175,18,55,128
"2011","Conwy 014B","W01000159","Total",564,144,64,80,420,7,98,75,105,16,36,83
"2011","Conwy 014C","W01000162","Total",762,198,88,110,564,6,125,88,150,40,47,108
"2011","Conwy 014D","W01000190","Total",599,178,86,92,421,4,101,72,119,21,28,76
"2011","Conwy 015A","W01000121","Total",548,187,81,106,361,22,94,66,96,11,18,54
"2011","Conwy 015B","W01000134","Total",988,373,204,169,615,70,151,90,162,22,38,82
"2011","Conwy 015C","W01000137","Total",630,162,76,86,468,14,121,75,106,19,44,89
"2011","Conwy 015D","W01000148","Total",484,126,48,78,358,44,57,55,82,16,36,68
"2011","Conwy 015E","W01000185","Total",563,188,85,103,375,16,100,51,109,15,26,58
"2011","Conwy 015F","W01000189","Total",644,210,77,133,434,13,89,58,132,14,30,98
"2011","Denbighshire 001A","W01000218","Total",686,242,128,114,444,31,99,74,105,14,37,84
"2011","Denbighshire 001B","W01000219","Total",1058,287,149,138,771,73,143,175,185,40,51,104
"2011","Denbighshire 001C","W01000220","Total",878,341,235,106,537,17,269,40,130,0,13,68
"2011","Denbighshire 002A","W01000213","Total",588,210,127,83,378,65,78,40,71,20,38,66
"2011","Denbighshire 002B","W01000214","Total",475,131,66,65,344,34,75,65,74,15,31,50
"2011","Denbighshire 002C","W01000215","Total",582,139,98,41,443,8,142,71,83,16,42,81
"2011","Denbighshire 002D","W01000216","Total",572,163,64,99,409,32,69,88,94,14,33,79
"2011","Denbighshire 003A","W01000212","Total",919,242,155,87,677,26,202,107,151,20,51,120
"2011","Denbighshire 003B","W01000221","Total",672,254,126,128,418,50,119,60,108,12,15,54
"2011","Denbighshire 003C","W01000222","Total",800,286,184,102,514,21,176,65,125,12,34,81
"2011","Denbighshire 004A","W01000226","Total",709,234,136,98,475,23,172,53,110,13,39,65
"2011","Denbighshire 004B","W01000227","Total",732,288,187,101,444,27,145,61,87,12,37,75
"2011","Denbighshire 004C","W01000228","Total",534,220,82,138,314,31,86,28,77,17,24,51
"2011","Denbighshire 004D","W01000239","Total",897,473,109,364,424,53,65,75,113,21,41,56
"2011","Denbighshire 004E","W01000240","Total",720,429,89,340,291,56,26,33,104,11,25,36
"2011","Denbighshire 004F","W01000241","Total",492,146,46,100,346,45,45,50,72,24,55,55
"2011","Denbighshire 006A","W01000236","Total",774,261,113,148,513,85,69,78,113,28,55,85
"2011","Denbighshire 006B","W01000237","Total",639,146,78,68,493,90,49,76,95,50,56,77
"2011","Denbighshire 006C","W01000238","Total",645,157,68,89,488,35,70,88,118,26,54,97
"2011","Denbighshire 008A","W01000200","Total",524,124,63,61,400,20,82,75,112,16,29,66
"2011","Denbighshire 008B","W01000201","Total",660,211,80,131,449,51,83,113,102,21,21,58
"2011","Denbighshire 008C","W01000217","Total",862,238,125,113,624,55,151,97,147,37,42,95
"2011","Denbighshire 008D","W01000248","Total",663,159,64,95,504,13,109,89,149,20,40,84
"2011","Denbighshire 009A","W01000191","Total",881,202,75,127,679,54,130,137,193,31,34,100
"2011","Denbighshire 009B","W01000223","Total",580,156,86,70,424,19,109,72,115,7,32,70
"2011","Denbighshire 009C","W01000224","Total",610,202,127,75,408,21,112,54,88,19,35,79
"2011","Denbighshire 009D","W01000225","Total",718,245,101,144,473,48,117,102,114,10,22,60
"2011","Denbighshire 010A","W01000245","Total",737,235,135,100,502,24,130,93,133,18,27,77
"2011","Denbighshire 010B","W01000246","Total",711,220,98,122,491,23,116,90,135,19,36,72
"2011","Denbighshire 010C","W01000247","Total",815,242,121,121,573,30,162,85,135,24,37,100
"2011","Denbighshire 011A","W01000194","Total",951,365,94,271,586,65,94,110,177,15,32,93
"2011","Denbighshire 011B","W01000198","Total",639,209,98,111,430,66,65,76,109,30,19,65
"2011","Denbighshire 011C","W01000199","Total",715,218,98,120,497,31,97,81,130,19,36,103
"2011","Denbighshire 012A","W01000195","Total",622,193,121,72,429,15,133,72,96,10,29,74
"2011","Denbighshire 012B","W01000196","Total",563,111,41,70,452,23,47,91,145,22,41,83
"2011","Denbighshire 012C","W01000197","Total",697,215,115,100,482,19,87,99,120,28,39,90
"2011","Denbighshire 012D","W01000211","Total",749,178,96,82,571,15,138,89,151,26,42,110
"2011","Denbighshire 013A","W01000203","Total",986,236,124,112,750,20,179,128,218,32,55,118
"2011","Denbighshire 013B","W01000204","Total",622,181,79,102,441,9,135,58,114,14,29,82
"2011","Denbighshire 013C","W01000206","Total",852,210,112,98,642,21,154,122,162,34,47,102
"2011","Denbighshire 014A","W01000242","Total",881,347,170,177,534,55,111,97,139,17,47,68
"2011","Denbighshire 014B","W01000243","Total",792,299,145,154,493,38,117,91,136,16,25,70
"2011","Denbighshire 014C","W01000244","Total",733,191,127,64,542,18,151,117,127,19,28,82
"2011","Denbighshire 015A","W01000193","Total",572,190,79,111,382,24,67,64,104,16,29,78
"2011","Denbighshire 015B","W01000202","Total",654,144,74,70,510,14,111,100,124,32,35,94
"2011","Denbighshire 015C","W01000207","Total",946,250,111,139,696,23,162,113,204,19,49,126
"2011","Denbighshire 016A","W01000192","Total",451,142,66,76,309,14,86,49,84,7,12,57
"2011","Denbighshire 016B","W01000205","Total",489,148,79,69,341,13,86,46,99,12,21,64
"2011","Denbighshire 016C","W01000208","Total",561,229,74,155,332,16,77,48,103,6,26,56
"2011","Denbighshire 016D","W01000209","Total",678,235,130,105,443,28,111,56,114,18,37,79
"2011","Denbighshire 016E","W01000210","Total",607,191,79,112,416,23,130,61,107,8,18,69
"2011","Denbighshire 017E","W01000229","Total",772,255,147,108,517,37,163,55,151,20,12,79
"2011","Denbighshire 017F","W01000230","Total",888,262,144,118,626,28,200,101,137,8,37,115
"2011","Denbighshire 017A","W01000231","Total",615,181,113,68,434,30,96,78,102,14,36,78
"2011","Denbighshire 017B","W01000232","Total",680,182,97,85,498,30,105,91,131,23,35,83
"2011","Denbighshire 017C","W01000233","Total",568,161,86,75,407,20,103,68,115,8,30,63
"2011","Denbighshire 017G","W01000234","Total",567,150,77,73,417,65,57,78,93,16,39,69
"2011","Denbighshire 017D","W01000235","Total",563,158,56,102,405,34,65,88,101,10,34,73
"2011","Flintshire 001A","W01000287","Total",828,294,143,151,534,41,143,63,132,17,46,92
"2011","Flintshire 001B","W01000298","Total",675,208,114,94,467,25,119,68,122,29,30,74
"2011","Flintshire 001C","W01000338","Total",788,212,116,96,576,21,129,100,154,18,36,118
"2011","Flintshire 002A","W01000306","Total",972,241,108,133,731,62,134,115,204,35,60,121
"2011","Flintshire 002B","W01000320","Total",762,210,124,86,552,38,111,97,141,20,49,96
"2011","Flintshire 002C","W01000340","Total",957,223,116,107,734,29,171,128,200,27,42,137
"2011","Flintshire 003A","W01000253","Total",784,196,94,102,588,45,116,92,147,21,56,111
"2011","Flintshire 003B","W01000254","Total",920,270,123,147,650,78,111,118,154,23,53,113
"2011","Flintshire 003C","W01000296","Total",638,214,87,127,424,45,85,74,87,23,21,89
"2011","Flintshire 003D","W01000297","Total",500,123,25,98,377,56,28,92,102,19,18,62
"2011","Flintshire 003E","W01000304","Total",896,364,178,186,532,77,93,97,113,22,43,87
"2011","Flintshire 003F","W01000305","Total",753,241,103,138,512,37,93,96,130,18,36,102
"2011","Flintshire 004A","W01000288","Total",1027,402,192,210,625,89,118,98,135,30,46,109
"2011","Flintshire 004B","W01000290","Total",633,283,164,119,350,33,88,48,92,14,24,51
"2011","Flintshire 004C","W01000292","Total",546,123,55,68,423,56,52,79,83,25,47,81
"2011","Flintshire 004D","W01000293","Total",656,193,73,120,463,36,63,87,132,17,42,86
"2011","Flintshire 005A","W01000289","Total",493,78,31,47,415,23,61,79,88,13,49,102
"2011","Flintshire 005B","W01000291","Total",573,131,38,93,442,47,64,110,116,7,24,74
"2011","Flintshire 005C","W01000294","Total",709,117,58,59,592,20,96,116,147,22,43,148
"2011","Flintshire 005D","W01000295","Total",625,137,73,64,488,33,100,97,111,18,36,93
"2011","Flintshire 006A","W01000258","Total",918,241,138,103,677,22,170,99,188,21,52,125
"2011","Flintshire 006B","W01000270","Total",521,113,52,61,408,8,75,65,130,15,22,93
"2011","Flintshire 006C","W01000271","Total",569,182,90,92,387,21,89,68,109,16,17,67
"2011","Flintshire 006D","W01000272","Total",767,157,88,69,610,11,165,97,183,15,35,104
"2011","Flintshire 006E","W01000301","Total",731,181,96,85,550,26,107,89,154,14,42,118
"2011","Flintshire 007A","W01000273","Total",645,163,76,87,482,51,88,59,124,26,26,108
"2011","Flintshire 007B","W01000274","Total",837,354,151,203,483,70,74,86,118,31,36,68
"2011","Flintshire 007C","W01000275","Total",496,116,52,64,380,24,61,64,103,12,34,82
"2011","Flintshire 007D","W01000278","Total",618,199,61,138,419,69,37,83,95,22,35,78
"2011","Flintshire 008A","W01000276","Total",517,84,8,76,433,44,15,115,139,23,31,66
"2011","Flintshire 008B","W01000277","Total",522,90,23,67,432,24,42,108,139,16,27,76
"2011","Flintshire 008C","W01000279","Total",515,121,69,52,394,14,125,53,80,11,25,86
"2011","Flintshire 008D","W01000281","Total",515,122,50,72,393,24,81,68,118,7,30,65
"2011","Flintshire 008E","W01000283","Total",931,237,106,131,694,35,149,130,168,20,62,130
"2011","Flintshire 009A","W01000332","Total",645,168,43,125,477,30,68,97,157,23,30,72
"2011","Flintshire 009B","W01000333","Total",614,206,99,107,408,63,45,78,93,15,30,84
"2011","Flintshire 009C","W01000334","Total",871,304,88,216,567,47,104,94,148,19,46,109
"2011","Flintshire 009D","W01000335","Total",491,189,103,86,302,25,63,40,74,17,26,57
"2011","Flintshire 009E","W01000336","Total",575,169,94,75,406,64,46,69,79,31,39,78
"2011","Flintshire 009F","W01000337","Total",954,328,126,202,626,43,114,115,172,19,46,117
"2011","Flintshire 010A","W01000252","Total",723,170,107,63,553,13,196,78,141,7,29,89
"2011","Flintshire 010B","W01000280","Total",566,116,51,65,450,17,82,85,134,11,34,87
"2011","Flintshire 010C","W01000282","Total",561,42,7,35,519,22,27,188,110,24,56,92
"2011","Flintshire 010D","W01000325","Total",644,141,85,56,503,19,118,81,150,14,34,87
"2011","Flintshire 011A","W01000311","Total",748,222,123,99,526,27,108,92,124,19,41,115
"2011","Flintshire 011B","W01000312","Total",775,256,106,150,519,43,118,98,138,14,35,73
"2011","Flintshire 011C","W01000328","Total",930,310,121,189,620,54,100,97,182,17,54,116
"2011","Flintshire 012A","W01000264","Total",655,154,52,102,501,39,68,111,115,35,46,87
"2011","Flintshire 012B","W01000265","Total",596,173,82,91,423,16,106,64,138,13,21,65
"2011","Flintshire 012C","W01000323","Total",665,171,85,86,494,22,123,92,129,20,19,89
"2011","Flintshire 012D","W01000324","Total",608,126,60,66,482,22,109,99,121,16,35,80
"2011","Flintshire 013A","W01000251","Total",597,164,85,79,433,40,61,85,96,16,42,93
"2011","Flintshire 013B","W01000268","Total",681,141,85,56,540,24,102,137,124,24,40,89
"2011","Flintshire 013C","W01000284","Total",668,146,67,79,522,18,94,134,129,19,42,86
"2011","Flintshire 013D","W01000285","Total",608,112,56,56,496,18,128,83,150,15,22,80
"2011","Flintshire 013E","W01000286","Total",882,219,59,160,663,25,74,203,193,29,50,89
"2011","Flintshire 013F","W01000302","Total",830,242,154,88,588,22,176,94,139,29,29,99
"2011","Flintshire 014A","W01000249","Total",510,112,58,54,398,21,74,77,115,9,28,74
"2011","Flintshire 014B","W01000250","Total",647,148,86,62,499,14,133,80,122,18,43,89
"2011","Flintshire 014C","W01000261","Total",644,170,83,87,474,27,101,76,125,17,31,97
"2011","Flintshire 014D","W01000321","Total",685,141,69,72,544,16,116,114,159,10,34,95
"2011","Flintshire 014E","W01000322","Total",563,131,84,47,432,19,116,72,128,14,22,61
"2011","Flintshire 015A","W01000255","Total",955,234,126,108,721,50,152,120,194,23,54,128
"2011","Flintshire 015B","W01000256","Total",660,187,64,123,473,45,52,100,155,16,36,69
"2011","Flintshire 015C","W01000257","Total",900,212,86,126,688,28,126,146,212,13,39,124
"2011","Flintshire 015D","W01000329","Total",605,193,83,110,412,68,52,80,113,14,24,61
"2011","Flintshire 015E","W01000330","Total",913,286,125,161,627,82,64,117,194,36,48,86
"2011","Flintshire 015F","W01000331","Total",635,140,71,69,495,20,60,91,156,6,54,108
"2011","Flintshire 016A","W01000313","Total",650,181,97,84,469,36,82,96,120,26,36,73
"2011","Flintshire 016B","W01000314","Total",562,238,137,101,324,28,80,41,90,12,20,53
"2011","Flintshire 016C","W01000315","Total",898,286,173,113,612,50,170,91,148,18,45,90
"2011","Flintshire 016D","W01000316","Total",516,116,68,48,400,18,107,84,79,13,24,75
"2011","Flintshire 016E","W01000317","Total",508,65,35,30,443,11,82,100,108,22,27,93
"2011","Flintshire 016F","W01000318","Total",453,124,71,53,329,48,38,72,62,22,28,59
"2011","Flintshire 016G","W01000319","Total",726,310,102,208,416,18,90,92,130,13,26,47
"2011","Flintshire 017A","W01000259","Total",751,293,136,157,458,31,99,77,139,15,37,60
"2011","Flintshire 017B","W01000260","Total",763,190,91,99,573,36,120,111,153,11,48,94
"2011","Flintshire 017C","W01000262","Total",652,210,79,131,442,68,56,77,127,20,31,63
"2011","Flintshire 017D","W01000263","Total",639,233,95,138,406,45,51,66,99,25,34,86
"2011","Flintshire 017E","W01000266","Total",599,186,84,102,413,27,102,82,106,8,20,68
"2011","Flintshire 017F","W01000267","Total",694,199,94,105,495,31,112,105,132,18,23,74
"2011","Flintshire 018A","W01000303","Total",660,126,63,63,534,19,104,113,140,24,41,93
"2011","Flintshire 018B","W01000326","Total",686,158,82,76,528,18,111,102,143,17,38,99
"2011","Flintshire 018C","W01000327","Total",878,192,81,111,686,20,148,135,168,21,50,144
"2011","Flintshire 019A","W01000299","Total",842,204,110,94,638,22,196,97,165,18,39,101
"2011","Flintshire 019B","W01000300","Total",743,200,98,102,543,22,135,74,162,16,41,93
"2011","Flintshire 019C","W01000309","Total",906,270,112,158,636,51,113,124,165,21,54,108
"2011","Flintshire 019D","W01000339","Total",678,172,83,89,506,26,128,80,118,18,35,101
"2011","Flintshire 020A","W01000269","Total",735,252,135,117,483,50,109,73,126,10,30,85
"2011","Flintshire 020B","W01000307","Total",524,108,49,59,416,9,85,87,104,21,21,89
"2011","Flintshire 020C","W01000308","Total",510,133,84,49,377,23,74,77,88,13,29,73
"2011","Flintshire 020D","W01000310","Total",767,188,93,95,579,30,140,102,153,14,36,104
"2011","Wrexham 003A","W01000374","Total",604,188,96,92,416,31,84,69,106,19,34,73
"2011","Wrexham 003B","W01000375","Total",822,222,73,149,600,42,54,182,194,23,28,77
"2011","Wrexham 003C","W01000376","Total",555,109,49,60,446,23,86,97,115,9,31,85
"2011","Wrexham 003D","W01000391","Total",610,153,71,82,457,27,97,79,126,12,22,94
"2011","Wrexham 003E","W01000392","Total",696,206,106,100,490,56,71,102,106,35,41,79
"2011","Wrexham 004A","W01000377","Total",602,133,46,87,469,18,75,114,125,17,41,79
"2011","Wrexham 004B","W01000378","Total",532,118,41,77,414,77,54,84,95,23,35,46
"2011","Wrexham 004C","W01000379","Total",708,250,105,145,458,49,69,84,121,17,42,76
"2011","Wrexham 004D","W01000380","Total",489,106,34,72,383,12,44,83,130,9,32,73
"2011","Wrexham 005A","W01000351","Total",882,217,94,123,665,54,96,133,186,27,40,129
"2011","Wrexham 005B","W01000373","Total",753,209,90,119,544,72,83,114,107,19,46,103
"2011","Wrexham 005C","W01000400","Total",742,240,91,149,502,44,79,114,152,16,29,68
"2011","Wrexham 005D","W01000401","Total",794,271,96,175,523,52,68,129,146,21,46,61
"2011","Wrexham 006A","W01000347","Total",1047,282,61,221,765,52,70,203,265,31,38,106
"2011","Wrexham 006B","W01000348","Total",622,196,82,114,426,71,66,86,91,20,35,57
"2011","Wrexham 006C","W01000362","Total",622,164,74,90,458,55,56,93,111,16,41,86
"2011","Wrexham 006D","W01000363","Total",689,252,149,103,437,31,89,90,109,13,22,83
"2011","Wrexham 006E","W01000364","Total",688,195,75,120,493,24,95,102,137,12,36,87
"2011","Wrexham 007A","W01000343","Total",463,119,82,37,344,8,123,52,69,8,18,66
"2011","Wrexham 007B","W01000344","Total",586,151,92,59,435,7,153,72,107,7,18,71
"2011","Wrexham 007C","W01000415","Total",683,213,123,90,470,19,122,83,135,7,27,77
"2011","Wrexham 007D","W01000416","Total",508,112,41,71,396,10,53,77,123,14,31,88
"2011","Wrexham 008A","W01000368","Total",918,267,151,116,651,25,204,131,158,10,36,87
"2011","Wrexham 008B","W01000371","Total",527,180,63,117,347,21,44,68,107,11,19,77
"2011","Wrexham 008C","W01000372","Total",598,263,93,170,335,23,49,53,116,10,14,70
"2011","Wrexham 008D","W01000387","Total",508,103,56,47,405,10,114,84,86,10,29,72
"2011","Wrexham 008E","W01000388","Total",470,146,76,70,324,12,83,64,71,10,19,65
"2011","Wrexham 008F","W01000422","Total",944,310,159,151,634,43,167,107,158,10,40,109
"2011","Wrexham 009A","W01000341","Total",684,213,116,97,471,36,93,82,110,14,40,96
"2011","Wrexham 009B","W01000342","Total",727,277,156,121,450,51,90,79,106,13,32,79
"2011","Wrexham 009C","W01000393","Total",828,237,135,102,591,30,136,96,143,22,48,116
"2011","Wrexham 010A","W01000352","Total",408,116,56,60,292,32,64,46,59,5,32,54
"2011","Wrexham 010B","W01000353","Total",552,178,55,123,374,52,36,78,77,25,38,68
"2011","Wrexham 010C","W01000413","Total",553,167,31,136,386,117,34,73,50,34,34,44
"2011","Wrexham 010D","W01000414","Total",515,134,51,83,381,88,36,80,79,18,22,58
"2011","Wrexham 010E","W01000425","Total",910,260,97,163,650,129,79,126,105,37,59,115
"2011","Wrexham 011A","W01000349","Total",840,290,89,201,550,39,85,131,166,13,36,80
"2011","Wrexham 011B","W01000350","Total",716,276,48,228,440,49,33,76,145,7,23,107
"2011","Wrexham 011C","W01000365","Total",822,178,87,91,644,30,129,90,157,18,44,176
"2011","Wrexham 011D","W01000402","Total",1137,380,105,275,757,58,78,133,237,15,45,191
"2011","Wrexham 012A","W01000381","Total",534,234,118,116,300,17,62,53,73,6,30,59
"2011","Wrexham 012B","W01000382","Total",545,267,72,195,278,35,31,51,79,14,15,53
"2011","Wrexham 012D","W01000423","Total",886,240,48,192,646,83,49,189,157,33,49,86
"2011","Wrexham 012E","W01000424","Total",556,176,70,106,380,25,53,66,116,11,24,85
"2011","Wrexham 012F","W01001929","Total",621,226,81,145,395,46,34,68,155,3,15,74
"2011","Wrexham 012G","W01001931","Total",639,255,89,166,384,39,57,59,127,5,26,71
"2011","Wrexham 013A","W01000398","Total",571,174,68,106,397,20,85,60,112,19,28,73
"2011","Wrexham 013B","W01000399","Total",465,101,48,53,364,4,79,68,108,15,31,59
"2011","Wrexham 013C","W01000406","Total",880,230,93,137,650,78,85,126,161,37,60,103
"2011","Wrexham 013D","W01000408","Total",506,151,85,66,355,26,62,73,102,19,24,49
"2011","Wrexham 014A","W01000366","Total",619,195,94,101,424,38,60,81,120,18,40,67
"2011","Wrexham 014B","W01000367","Total",543,151,66,85,392,18,53,97,111,15,26,72
"2011","Wrexham 014C","W01000385","Total",750,174,76,98,576,32,145,111,155,15,26,92
"2011","Wrexham 014D","W01000410","Total",724,216,91,125,508,32,107,108,139,16,27,79
"2011","Wrexham 015A","W01000386","Total",661,233,87,146,428,35,55,91,116,22,45,64
"2011","Wrexham 015B","W01000405","Total",919,273,124,149,646,91,87,128,148,37,55,100
"2011","Wrexham 015C","W01000411","Total",796,357,169,188,439,71,73,88,119,12,26,50
"2011","Wrexham 015D","W01000412","Total",703,213,87,126,490,35,83,109,144,8,34,77
"2011","Wrexham 016A","W01000394","Total",506,113,42,71,393,7,60,81,122,7,35,81
"2011","Wrexham 016B","W01000395","Total",475,128,69,59,347,24,79,54,98,11,22,59
"2011","Wrexham 016C","W01000407","Total",596,158,69,89,438,13,98,95,140,13,21,58
"2011","Wrexham 016D","W01000419","Total",619,189,78,111,430,39,54,112,98,24,33,70
"2011","Wrexham 016E","W01000420","Total",630,207,75,132,423,37,77,85,123,12,23,66
"2011","Wrexham 017A","W01000354","Total",719,177,89,88,542,25,135,89,132,16,41,104
"2011","Wrexham 017B","W01000355","Total",770,319,157,162,451,43,93,66,123,23,29,74
"2011","Wrexham 017C","W01000356","Total",645,136,64,72,509,47,84,93,99,26,55,105
"2011","Wrexham 017D","W01000389","Total",869,244,125,119,625,34,138,136,155,20,43,99
"2011","Wrexham 017E","W01000409","Total",815,253,89,164,562,122,61,137,101,40,36,65
"2011","Wrexham 018A","W01000345","Total",684,182,97,85,502,24,130,89,128,12,31,88
"2011","Wrexham 018B","W01000346","Total",632,118,72,46,514,20,124,86,129,25,38,92
"2011","Wrexham 018C","W01000403","Total",555,138,85,53,417,17,99,69,116,8,31,77
"2011","Wrexham 018D","W01000404","Total",826,228,117,111,598,32,122,117,162,26,46,93
"2011","Wrexham 019C","W01000359","Total",507,132,53,79,375,24,68,77,119,8,25,54
"2011","Wrexham 019D","W01000360","Total",532,173,94,79,359,29,86,48,74,25,26,71
"2011","Wrexham 019E","W01000361","Total",893,296,131,165,597,44,111,110,165,29,43,95
"2011","Wrexham 019F","W01001930","Total",907,249,122,127,658,25,155,114,177,20,48,119
"2011","Wrexham 020F","W01000369","Total",594,189,129,60,405,15,136,67,101,10,20,56
"2011","Wrexham 020G","W01000370","Total",630,219,102,117,411,20,107,76,110,14,19,65
"2011","Wrexham 020A","W01000383","Total",922,174,64,110,748,29,88,200,211,35,63,122
"2011","Wrexham 020B","W01000384","Total",485,155,98,57,330,6,86,58,84,15,17,64
"2011","Wrexham 020C","W01000390","Total",670,175,89,86,495,19,103,85,136,11,41,100
"2011","Wrexham 020H","W01000396","Total",500,101,49,52,399,15,92,81,101,15,22,73
"2011","Wrexham 020I","W01000397","Total",412,65,33,32,347,7,94,66,87,12,19,62
"2011","Wrexham 020D","W01000417","Total",640,138,71,67,502,9,114,116,126,10,36,91
"2011","Wrexham 020E","W01000418","Total",724,214,110,104,510,21,124,100,138,23,27,77
"2011","Powys 001A","W01000461","Total",675,224,100,124,451,34,102,81,116,21,25,72
"2011","Powys 001D","W01000470","Total",828,274,163,111,554,23,152,75,159,19,36,90
"2011","Powys 001E","W01000475","Total",975,234,123,111,741,25,214,94,182,26,62,138
"2011","Powys 001F","W01001906","Total",843,249,127,122,594,17,179,81,158,24,48,87
"2011","Powys 001G","W01001907","Total",572,144,80,64,428,15,99,66,108,19,44,77
"2011","Powys 002A","W01000444","Total",1005,292,175,117,713,27,205,116,180,23,58,104
"2011","Powys 002B","W01000457","Total",867,182,94,88,685,23,164,125,174,41,51,107
"2011","Powys 002C","W01000458","Total",769,205,106,99,564,24,146,108,152,20,28,86
"2011","Powys 003A","W01000498","Total",734,322,141,181,412,49,77,74,101,23,29,59
"2011","Powys 003B","W01000499","Total",555,223,98,125,332,26,57,69,87,13,28,52
"2011","Powys 003C","W01000500","Total",655,201,95,106,454,26,86,83,115,16,35,93
"2011","Powys 003D","W01000501","Total",1011,362,202,160,649,37,155,117,175,26,46,93
"2011","Powys 004A","W01000442","Total",890,275,139,136,615,20,144,101,177,26,38,109
"2011","Powys 004B","W01000452","Total",825,205,105,100,620,21,190,80,164,28,37,100
"2011","Powys 004C","W01000473","Total",1033,392,183,209,641,53,131,119,189,21,38,90
"2011","Powys 005A","W01000428","Total",593,175,108,67,418,15,115,57,116,14,28,73
"2011","Powys 005B","W01000441","Total",598,147,73,74,451,19,136,88,110,14,36,48
"2011","Powys 005C","W01000476","Total",603,218,115,103,385,18,116,61,93,14,34,49
"2011","Powys 005D","W01000497","Total",556,108,59,49,448,24,111,85,110,19,32,67
"2011","Powys 006A","W01000433","Total",1032,312,167,145,720,37,206,104,185,19,46,123
"2011","Powys 006B","W01000460","Total",728,192,88,104,536,37,116,90,125,22,50,96
"2011","Powys 006C","W01000488","Total",892,200,99,101,692,19,156,106,216,33,45,117
"2011","Powys 007A","W01000434","Total",695,183,102,81,512,16,150,82,122,26,32,84
"2011","Powys 007B","W01000439","Total",816,194,92,102,622,23,148,104,186,22,52,87
"2011","Powys 007C","W01000447","Total",838,202,132,70,636,28,170,94,159,29,51,105
"2011","Powys 008A","W01000480","Total",970,376,138,238,594,81,103,90,188,20,28,84
"2011","Powys 008B","W01000481","Total",1093,422,196,226,671,37,162,116,208,21,35,92
"2011","Powys 008C","W01000482","Total",817,278,119,159,539,39,125,82,130,27,40,96
"2011","Powys 009A","W01000478","Total",719,232,49,183,487,84,51,106,110,40,31,65
"2011","Powys 009B","W01000479","Total",614,181,87,94,433,66,67,80,110,23,32,55
"2011","Powys 009C","W01000483","Total",802,267,90,177,535,91,86,107,96,35,46,74
"2011","Powys 010A","W01000429","Total",951,237,109,128,714,21,212,105,163,30,59,124
"2011","Powys 010B","W01000453","Total",587,152,82,70,435,7,115,69,115,22,26,81
"2011","Powys 010C","W01000466","Total",621,194,125,69,427,29,113,89,90,17,27,62
"2011","Powys 010D","W01000467","Total",795,358,166,192,437,42,101,58,139,8,20,69
"2011","Powys 011A","W01000427","Total",604,161,91,70,443,18,130,71,116,15,32,61
"2011","Powys 011B","W01000448","Total",639,204,124,80,435,41,107,76,104,12,23,72
"2011","Powys 011C","W01000449","Total",753,270,113,157,483,26,140,74,129,18,26,70
"2011","Powys 011D","W01000464","Total",534,128,55,73,406,8,134,51,111,17,19,66
"2011","Powys 011E","W01000484","Total",678,172,97,75,506,17,161,54,145,18,37,74
"2011","Powys 011F","W01000485","Total",740,246,150,96,494,15,186,59,115,8,33,78
"2011","Powys 011G","W01000486","Total",501,153,82,71,348,37,77,61,84,16,25,48
"2011","Powys 012A","W01000438","Total",608,198,125,73,410,20,158,35,113,13,17,54
"2011","Powys 012B","W01000451","Total",483,144,84,60,339,10,96,54,82,22,20,55
"2011","Powys 012C","W01000472","Total",511,144,76,68,367,15,127,49,88,11,27,50
"2011","Powys 012D","W01000477","Total",621,145,75,70,476,18,157,49,119,22,31,80
"2011","Powys 012E","W01000487","Total",987,380,195,185,607,59,174,74,167,27,21,85
"2011","Powys 013A","W01000454","Total",671,378,157,221,293,29,85,38,77,7,22,35
"2011","Powys 013B","W01000455","Total",901,284,117,167,617,44,143,123,157,29,39,82
"2011","Powys 013C","W01000456","Total",1011,418,201,217,593,53,198,74,144,17,34,73
"2011","Powys 014A","W01000431","Total",586,208,81,127,378,41,46,73,109,20,33,56
"2011","Powys 014B","W01000432","Total",532,168,98,70,364,16,107,50,91,16,36,48
"2011","Powys 014C","W01000450","Total",597,155,85,70,442,22,127,65,127,13,32,56
"2011","Powys 014D","W01000459","Total",519,146,73,73,373,16,99,57,108,18,28,47
"2011","Powys 014E","W01000471","Total",838,271,121,150,567,39,175,64,135,22,31,101
"2011","Powys 015A","W01000430","Total",554,165,82,83,389,25,104,49,96,18,34,63
"2011","Powys 015B","W01000443","Total",1009,290,157,133,719,21,208,112,197,27,44,110
"2011","Powys 015C","W01000445","Total",623,163,74,89,460,21,114,71,115,18,36,85
"2011","Powys 015D","W01000446","Total",828,382,173,209,446,55,97,65,132,14,17,66
"2011","Powys 015E","W01000494","Total",737,236,118,118,501,32,112,90,122,21,38,86
"2011","Powys 017A","W01000489","Total",742,290,130,160,452,42,88,101,127,10,27,57
"2011","Powys 017D","W01000492","Total",823,395,172,223,428,46,79,71,139,9,26,58
"2011","Powys 017E","W01000493","Total",595,139,89,50,456,23,117,100,103,16,37,60
"2011","Powys 017F","W01001901","Total",884,310,199,111,574,37,147,106,144,19,35,86
"2011","Powys 017G","W01001902","Total",591,150,61,89,441,71,64,78,113,26,24,65
"2011","Powys 018E","W01000465","Total",426,98,59,39,328,10,99,45,88,10,21,55
"2011","Powys 018F","W01001903","Total",937,317,191,126,620,33,164,89,162,18,36,118
"2011","Powys 018G","W01001904","Total",727,185,101,84,542,31,139,97,150,24,28,73
"2011","Powys 018H","W01001905","Total",880,223,106,117,657,24,189,97,165,22,56,104
"2011","Powys 020A","W01000440","Total",546,132,67,65,414,9,110,64,92,18,36,85
"2011","Powys 020B","W01000474","Total",750,225,104,121,525,17,122,103,147,15,31,90
"2011","Powys 020C","W01000503","Total",432,88,48,40,344,14,92,55,90,8,19,66
"2011","Powys 020D","W01001897","Total",837,258,137,121,579,24,145,107,171,17,35,80
"2011","Powys 021A","W01000426","Total",643,211,104,107,432,24,106,70,114,12,29,77
"2011","Powys 021B","W01000496","Total",895,268,154,114,627,38,151,95,154,17,55,117
"2011","Powys 021C","W01000502","Total",957,337,192,145,620,35,191,102,130,13,32,117
"2011","Powys 021D","W01000504","Total",546,205,83,122,341,58,58,63,78,4,28,52
"2011","Powys 021E","W01000505","Total",646,225,125,100,421,30,94,67,108,8,31,83
"2011","Powys 021F","W01001899","Total",866,282,148,134,584,61,124,92,138,14,35,120
"2011","Ceredigion 001C","W01000523","Total",834,244,107,137,590,31,136,111,164,19,42,87
"2011","Ceredigion 001D","W01000548","Total",764,217,110,107,547,38,124,116,123,27,35,84
"2011","Ceredigion 001E","W01000549","Total",744,221,98,123,523,19,106,99,128,26,37,108
"2011","Ceredigion 001F","W01001937","Total",949,327,133,194,622,36,169,103,150,22,38,104
"2011","Ceredigion 002A","W01000512","Total",604,231,89,142,373,5,67,44,119,13,18,107
"2011","Ceredigion 002B","W01000513","Total",1022,437,55,382,585,11,33,36,230,4,13,258
"2011","Ceredigion 002D","W01000517","Total",589,248,83,165,341,4,26,25,105,9,11,161
"2011","Ceredigion 002F","W01001934","Total",1106,462,160,302,644,25,134,67,174,15,20,209
"2011","Ceredigion 003A","W01000515","Total",608,193,83,110,415,46,61,86,103,14,31,74
"2011","Ceredigion 003B","W01000516","Total",674,174,70,104,500,39,89,97,116,26,40,93
"2011","Ceredigion 003C","W01000518","Total",627,285,149,136,342,13,65,48,105,9,16,86
"2011","Ceredigion 003E","W01001935","Total",469,160,62,98,309,16,41,51,93,11,19,78
"2011","Ceredigion 003F","W01001936","Total",462,121,38,83,341,24,77,44,79,16,17,84
"2011","Ceredigion 005A","W01000506","Total",732,337,175,162,395,9,136,58,107,10,18,57
"2011","Ceredigion 005B","W01000524","Total",831,236,121,115,595,29,147,98,143,19,43,116
"2011","Ceredigion 005C","W01000538","Total",654,177,75,102,477,15,111,84,127,17,43,80
"2011","Ceredigion 005D","W01000539","Total",506,131,68,63,375,17,103,47,88,9,31,80
"2011","Ceredigion 005E","W01000540","Total",534,180,101,79,354,19,107,49,85,19,12,63
"2011","Ceredigion 007A","W01000529","Total",664,176,90,86,488,26,124,73,117,26,45,77
"2011","Ceredigion 007B","W01000532","Total",838,216,123,93,622,12,205,83,149,21,40,112
"2011","Ceredigion 007C","W01000544","Total",517,206,100,106,311,24,82,41,90,14,15,45
"2011","Ceredigion 007D","W01000545","Total",902,256,135,121,646,19,205,67,169,15,52,119
"2011","Ceredigion 008A","W01000527","Total",461,189,83,106,272,23,60,50,64,7,14,54
"2011","Ceredigion 008B","W01000528","Total",641,206,100,106,435,43,110,66,94,13,30,79
"2011","Ceredigion 008C","W01000535","Total",885,257,140,117,628,31,174,89,159,30,41,104
"2011","Ceredigion 008D","W01000537","Total",664,216,107,109,448,27,131,56,107,18,28,81
"2011","Ceredigion 008E","W01000541","Total",781,225,102,123,556,41,138,84,135,16,38,104
"2011","Ceredigion 009A","W01000507","Total",554,180,112,68,374,13,128,41,94,11,29,58
"2011","Ceredigion 009B","W01000508","Total",538,181,95,86,357,28,86,60,95,8,21,59
"2011","Ceredigion 009C","W01000509","Total",802,269,168,101,533,31,167,73,109,23,34,96
"2011","Ceredigion 009D","W01000510","Total",643,332,192,140,311,34,68,45,84,16,18,46
"2011","Ceredigion 009E","W01000511","Total",560,267,54,213,293,41,33,58,68,16,26,51
"2011","Ceredigion 009F","W01000546","Total",532,172,99,73,360,9,119,46,105,11,17,53
"2011","Ceredigion 009G","W01000547","Total",536,186,90,96,350,15,101,48,88,16,25,57
"2011","Ceredigion 010A","W01000519","Total",720,205,127,78,515,21,149,57,136,20,23,109
"2011","Ceredigion 010B","W01000522","Total",553,159,81,78,394,8,113,55,95,11,31,81
"2011","Ceredigion 010C","W01000531","Total",800,251,124,127,549,32,138,83,147,25,34,90
"2011","Ceredigion 010D","W01000533","Total",660,247,126,121,413,33,100,62,109,21,28,60
"2011","Ceredigion 010E","W01000551","Total",575,170,86,84,405,20,111,50,110,16,25,73
"2011","Ceredigion 011A","W01000525","Total",500,138,84,54,362,14,130,47,78,12,15,66
"2011","Ceredigion 011B","W01000534","Total",655,186,97,89,469,19,120,94,112,27,34,63
"2011","Ceredigion 011E","W01000536","Total",663,215,102,113,448,20,140,60,102,23,23,80
"2011","Ceredigion 011F","W01000542","Total",937,271,135,136,666,23,158,110,170,28,53,124
"2011","Ceredigion 011C","W01000543","Total",880,257,120,137,623,31,142,112,179,24,41,94
"2011","Ceredigion 011G","W01000550","Total",565,224,121,103,341,26,89,49,75,13,26,63
"2011","Ceredigion 011D","W01000552","Total",827,218,108,110,609,27,127,119,156,32,51,97
"2011","Pembrokeshire 001A","W01000558","Total",887,269,106,163,618,55,144,106,153,24,39,97
"2011","Pembrokeshire 001B","W01000559","Total",611,169,94,75,442,11,115,49,125,23,36,83
"2011","Pembrokeshire 001C","W01000560","Total",521,134,63,71,387,25,100,49,103,11,26,73
"2011","Pembrokeshire 001D","W01000561","Total",502,133,66,67,369,21,86,62,70,17,32,81
"2011","Pembrokeshire 001E","W01000613","Total",1016,339,159,180,677,57,192,74,172,30,37,115
"2011","Pembrokeshire 002A","W01000562","Total",736,200,104,96,536,29,159,60,132,21,32,103
"2011","Pembrokeshire 002B","W01000565","Total",891,351,201,150,540,38,171,70,138,18,33,72
"2011","Pembrokeshire 002C","W01000566","Total",736,291,141,150,445,41,132,58,97,17,31,69
"2011","Pembrokeshire 002D","W01000567","Total",901,318,138,180,583,57,130,91,146,28,46,85
"2011","Pembrokeshire 002E","W01000597","Total",583,241,133,108,342,29,123,39,77,17,18,39
"2011","Pembrokeshire 002F","W01000617","Total",615,183,91,92,432,23,86,59,125,38,31,70
"2011","Pembrokeshire 003A","W01000579","Total",985,267,141,126,718,51,190,123,165,38,54,97
"2011","Pembrokeshire 003B","W01000581","Total",648,179,89,90,469,15,138,66,130,15,33,72
"2011","Pembrokeshire 003C","W01000612","Total",851,317,175,142,534,30,157,93,137,11,31,75
"2011","Pembrokeshire 003D","W01000618","Total",646,173,83,90,473,34,132,72,114,17,38,66
"2011","Pembrokeshire 004A","W01000582","Total",711,201,95,106,510,26,136,71,129,21,34,93
"2011","Pembrokeshire 004B","W01000583","Total",592,149,81,68,443,33,111,87,81,16,39,76
"2011","Pembrokeshire 004C","W01000611","Total",730,180,106,74,550,12,178,82,136,6,34,102
"2011","Pembrokeshire 004D","W01000623","Total",774,177,98,79,597,39,147,104,128,24,49,106
"2011","Pembrokeshire 005A","W01000568","Total",1193,574,156,418,619,89,89,97,185,16,43,100
"2011","Pembrokeshire 005B","W01000569","Total",526,134,65,69,392,33,59,112,82,23,28,55
"2011","Pembrokeshire 005C","W01000570","Total",610,155,25,130,455,132,30,98,103,29,23,40
"2011","Pembrokeshire 005D","W01000572","Total",789,278,148,130,511,33,104,104,128,16,43,83
"2011","Pembrokeshire 006A","W01000571","Total",1013,345,205,140,668,57,173,96,154,25,45,118
"2011","Pembrokeshire 006B","W01000573","Total",1119,361,159,202,758,79,151,151,207,24,41,105
"2011","Pembrokeshire 006C","W01000586","Total",888,229,117,112,659,63,118,105,170,28,61,114
"2011","Pembrokeshire 007A","W01000577","Total",634,151,86,65,483,25,117,65,106,20,39,111
"2011","Pembrokeshire 007B","W01000585","Total",540,119,57,62,421,19,96,57,110,11,32,96
"2011","Pembrokeshire 007C","W01000595","Total",908,355,191,164,553,64,136,85,125,17,34,92
"2011","Pembrokeshire 007D","W01000596","Total",620,159,83,76,461,29,110,76,130,16,33,67
"2011","Pembrokeshire 008A","W01000555","Total",579,139,71,68,440,25,107,49,121,10,29,99
"2011","Pembrokeshire 008B","W01000556","Total",509,142,89,53,367,20,118,43,94,7,20,65
"2011","Pembrokeshire 008C","W01000575","Total",985,266,142,124,719,46,149,124,183,34,56,127
"2011","Pembrokeshire 008D","W01000614","Total",612,171,92,79,441,25,118,54,122,12,28,82
"2011","Pembrokeshire 008E","W01000622","Total",637,177,92,85,460,34,111,64,127,25,29,70
"2011","Pembrokeshire 009A","W01000554","Total",752,173,74,99,579,23,151,94,168,22,42,79
"2011","Pembrokeshire 009B","W01000580","Total",961,249,112,137,712,34,175,134,173,25,67,104
"2011","Pembrokeshire 009C","W01000598","Total",1023,338,172,166,685,59,162,119,180,18,34,113
"2011","Pembrokeshire 009D","W01000599","Total",897,216,110,106,681,66,154,112,170,31,41,107
"2011","Pembrokeshire 010A","W01000587","Total",1003,444,206,238,559,44,138,96,142,11,39,89
"2011","Pembrokeshire 010B","W01000588","Total",931,282,104,178,649,93,116,139,145,29,39,88
"2011","Pembrokeshire 010C","W01000593","Total",1163,328,176,152,835,59,193,128,200,48,53,154
"2011","Pembrokeshire 011A","W01000553","Total",546,135,69,66,411,19,124,45,114,8,25,76
"2011","Pembrokeshire 011B","W01000563","Total",484,115,47,68,369,27,89,43,95,15,26,74
"2011","Pembrokeshire 011C","W01000564","Total",523,144,91,53,379,30,111,59,82,8,20,69
"2011","Pembrokeshire 011D","W01000576","Total",955,274,189,85,681,34,216,93,143,34,63,98
"2011","Pembrokeshire 011E","W01000615","Total",671,196,126,70,475,28,165,65,102,13,31,71
"2011","Pembrokeshire 011F","W01000616","Total",529,194,104,90,335,15,127,48,73,9,16,47
"2011","Pembrokeshire 012A","W01000589","Total",525,185,103,82,340,46,65,63,80,13,19,54
"2011","Pembrokeshire 012B","W01000590","Total",547,213,128,85,334,13,109,38,92,8,13,61
"2011","Pembrokeshire 012C","W01000591","Total",489,128,59,69,361,27,75,59,83,12,30,75
"2011","Pembrokeshire 012D","W01000592","Total",497,107,51,56,390,48,63,56,82,26,39,76
"2011","Pembrokeshire 012E","W01000594","Total",989,327,127,200,662,93,133,114,152,30,46,94
"2011","Pembrokeshire 013A","W01000600","Total",786,338,132,206,448,51,77,75,122,13,36,74
"2011","Pembrokeshire 013B","W01000601","Total",642,184,79,105,458,80,92,66,95,36,30,59
"2011","Pembrokeshire 013C","W01000602","Total",581,187,72,115,394,50,104,53,90,11,19,67
"2011","Pembrokeshire 013D","W01000603","Total",827,273,99,174,554,78,81,93,149,26,44,83
"2011","Pembrokeshire 013E","W01000604","Total",624,157,67,90,467,63,88,75,110,23,38,70
"2011","Pembrokeshire 013F","W01000605","Total",711,171,71,100,540,35,94,88,135,28,52,108
"2011","Pembrokeshire 014A","W01000557","Total",612,144,72,72,468,28,95,87,111,18,46,83
"2011","Pembrokeshire 014B","W01000578","Total",740,216,127,89,524,16,176,70,124,22,25,91
"2011","Pembrokeshire 014C","W01000584","Total",876,232,102,130,644,40,183,83,158,37,49,94
"2011","Pembrokeshire 014D","W01000609","Total",1090,291,176,115,799,38,294,104,193,19,44,107
"2011","Pembrokeshire 015A","W01000574","Total",791,210,100,110,581,24,158,92,138,17,43,109
"2011","Pembrokeshire 015B","W01000606","Total",707,214,82,132,493,114,73,85,117,15,30,59
"2011","Pembrokeshire 015C","W01000607","Total",848,275,126,149,573,94,96,103,116,25,43,96
"2011","Pembrokeshire 015D","W01000608","Total",700,280,100,180,420,55,103,50,112,11,29,60
"2011","Pembrokeshire 016A","W01000610","Total",751,231,122,109,520,36,169,75,122,11,27,80
"2011","Pembrokeshire 016B","W01000619","Total",969,340,193,147,629,46,174,99,161,17,47,85
"2011","Pembrokeshire 016C","W01000620","Total",595,327,137,190,268,27,72,33,92,2,16,26
"2011","Pembrokeshire 016D","W01000621","Total",689,248,131,117,441,58,94,68,117,12,22,70
"2011","Carmarthenshire 001A","W01000685","Total",682,201,74,127,481,47,103,66,128,19,32,86
"2011","Carmarthenshire 001B","W01000686","Total",531,140,71,69,391,20,107,55,91,19,20,79
"2011","Carmarthenshire 001C","W01000701","Total",678,204,106,98,474,47,115,90,116,15,33,58
"2011","Carmarthenshire 001D","W01000702","Total",515,153,70,83,362,42,75,62,70,17,24,72
"2011","Carmarthenshire 002A","W01000647","Total",630,162,75,87,468,20,135,57,119,20,39,78
"2011","Carmarthenshire 002B","W01000650","Total",716,196,101,95,520,26,129,58,165,13,29,100
"2011","Carmarthenshire 002C","W01000678","Total",615,223,157,66,392,28,117,51,90,12,27,67
"2011","Carmarthenshire 002D","W01000679","Total",555,202,93,109,353,27,84,56,93,9,25,59
"2011","Carmarthenshire 003A","W01000646","Total",960,290,134,156,670,55,177,92,195,19,47,85
"2011","Carmarthenshire 003B","W01000688","Total",772,231,129,102,541,46,126,89,123,30,33,94
"2011","Carmarthenshire 003C","W01000689","Total",707,188,100,88,519,17,158,82,140,11,43,68
"2011","Carmarthenshire 003D","W01000728","Total",835,192,102,90,643,13,172,91,149,24,47,147
"2011","Carmarthenshire 004A","W01000676","Total",684,222,113,109,462,27,117,68,111,15,29,95
"2011","Carmarthenshire 004B","W01000677","Total",702,321,148,173,381,69,84,47,83,16,17,65
"2011","Carmarthenshire 004C","W01000687","Total",817,246,146,100,571,21,159,79,142,34,35,101
"2011","Carmarthenshire 004D","W01000709","Total",921,206,109,97,715,32,212,98,180,27,56,110
"2011","Carmarthenshire 005A","W01000624","Total",946,234,133,101,712,35,183,119,155,29,48,143
"2011","Carmarthenshire 005B","W01000682","Total",560,148,88,60,412,18,91,69,106,23,39,66
"2011","Carmarthenshire 005C","W01000683","Total",452,113,49,64,339,13,81,44,103,10,24,64
"2011","Carmarthenshire 005D","W01000684","Total",774,173,94,79,601,39,151,76,164,25,42,104
"2011","Carmarthenshire 006A","W01000643","Total",699,220,88,132,479,56,80,98,114,24,44,63
"2011","Carmarthenshire 006B","W01000644","Total",565,147,52,95,418,53,58,96,105,20,26,60
"2011","Carmarthenshire 006C","W01000645","Total",742,258,136,122,484,56,88,87,109,23,36,85
"2011","Carmarthenshire 006D","W01000648","Total",566,127,55,72,439,8,111,67,104,19,43,87
"2011","Carmarthenshire 006E","W01000649","Total",649,167,104,63,482,7,137,67,120,20,31,100
"2011","Carmarthenshire 007A","W01000637","Total",641,236,125,111,405,50,64,72,97,17,32,73
"2011","Carmarthenshire 007B","W01000638","Total",484,142,51,91,342,50,42,69,80,19,23,59
"2011","Carmarthenshire 007C","W01000639","Total",638,243,93,150,395,41,86,62,102,11,28,65
"2011","Carmarthenshire 007D","W01000640","Total",504,124,77,47,380,13,107,49,116,7,16,72
"2011","Carmarthenshire 008A","W01000641","Total",1162,624,268,356,538,56,115,78,169,16,18,86
"2011","Carmarthenshire 008B","W01000642","Total",720,215,108,107,505,30,120,81,122,14,22,116
"2011","Carmarthenshire 008C","W01000693","Total",505,173,116,57,332,37,106,45,64,10,18,52
"2011","Carmarthenshire 008D","W01000694","Total",558,131,62,69,427,17,139,60,106,9,25,71
"2011","Carmarthenshire 010A","W01000656","Total",906,264,104,160,642,67,135,102,151,23,49,115
"2011","Carmarthenshire 010B","W01000657","Total",502,173,98,75,329,32,71,47,93,5,22,59
"2011","Carmarthenshire 010C","W01000658","Total",545,152,62,90,393,38,77,73,97,12,26,70
"2011","Carmarthenshire 010D","W01000718","Total",627,199,94,105,428,54,77,60,114,16,35,72
"2011","Carmarthenshire 010E","W01000719","Total",629,175,101,74,454,30,94,69,119,17,39,86
"2011","Carmarthenshire 011A","W01000680","Total",853,224,144,80,629,37,163,106,158,17,47,101
"2011","Carmarthenshire 011B","W01000681","Total",857,271,131,140,586,68,118,103,135,29,31,102
"2011","Carmarthenshire 011C","W01000724","Total",762,200,92,108,562,39,120,121,123,24,37,98
"2011","Carmarthenshire 011D","W01000725","Total",915,278,156,122,637,29,152,115,164,22,42,113
"2011","Carmarthenshire 012A","W01000675","Total",848,233,125,108,615,19,160,87,162,22,48,117
"2011","Carmarthenshire 012B","W01000695","Total",675,202,112,90,473,31,100,70,140,14,35,83
"2011","Carmarthenshire 012C","W01000696","Total",670,202,103,99,468,26,114,69,105,13,36,105
"2011","Carmarthenshire 012D","W01000722","Total",542,138,82,56,404,7,127,51,90,7,27,95
"2011","Carmarthenshire 012E","W01000723","Total",616,196,101,95,420,18,114,61,118,9,39,61
"2011","Carmarthenshire 013A","W01000625","Total",521,185,93,92,336,53,62,72,48,6,30,65
"2011","Carmarthenshire 013B","W01000626","Total",725,320,150,170,405,38,102,80,97,15,19,54
"2011","Carmarthenshire 013C","W01000627","Total",896,242,104,138,654,63,136,120,164,30,40,101
"2011","Carmarthenshire 013D","W01000714","Total",647,223,90,133,424,39,86,77,113,14,30,65
"2011","Carmarthenshire 013E","W01000715","Total",555,151,71,80,404,21,107,67,97,13,28,71
"2011","Carmarthenshire 015A","W01000697","Total",805,242,110,132,563,46,127,97,147,13,37,96
"2011","Carmarthenshire 015B","W01000698","Total",768,181,99,82,587,44,117,108,140,28,39,111
"2011","Carmarthenshire 015C","W01000699","Total",600,124,60,64,476,12,97,100,118,13,33,103
"2011","Carmarthenshire 015D","W01000712","Total",634,170,71,99,464,28,93,102,127,15,33,66
"2011","Carmarthenshire 015E","W01000713","Total",574,151,66,85,423,30,89,81,95,13,36,79
"2011","Carmarthenshire 016A","W01000662","Total",921,256,151,105,665,45,142,117,170,12,49,130
"2011","Carmarthenshire 016B","W01000663","Total",998,301,176,125,697,35,162,125,185,17,42,131
"2011","Carmarthenshire 016C","W01000664","Total",737,196,109,87,541,29,127,107,125,12,44,97
"2011","Carmarthenshire 016D","W01000716","Total",544,141,76,65,403,20,100,59,82,17,33,92
"2011","Carmarthenshire 016E","W01000717","Total",645,213,123,90,432,23,91,77,120,20,28,73
"2011","Carmarthenshire 017A","W01000665","Total",727,158,70,88,569,16,111,117,163,14,29,119
"2011","Carmarthenshire 017B","W01000666","Total",643,218,103,115,425,43,67,92,111,17,20,75
"2011","Carmarthenshire 017C","W01000731","Total",1039,280,140,140,759,57,139,143,223,18,47,132
"2011","Carmarthenshire 018A","W01000670","Total",733,248,117,131,485,52,107,72,120,13,41,80
"2011","Carmarthenshire 018B","W01000671","Total",774,207,111,96,567,40,138,108,123,25,44,89
"2011","Carmarthenshire 018C","W01000729","Total",546,158,95,63,388,32,71,61,104,15,27,78
"2011","Carmarthenshire 018D","W01000730","Total",522,129,59,70,393,20,86,52,105,20,32,78
"2011","Carmarthenshire 019A","W01000690","Total",754,216,129,87,538,39,121,100,139,15,39,85
"2011","Carmarthenshire 019B","W01000691","Total",682,168,103,65,514,29,141,82,122,16,30,94
"2011","Carmarthenshire 019C","W01000692","Total",648,166,73,93,482,34,85,118,126,26,30,63
"2011","Carmarthenshire 019D","W01000726","Total",630,131,85,46,499,14,113,78,139,12,35,108
"2011","Carmarthenshire 019E","W01000727","Total",479,140,80,60,339,18,120,51,87,2,15,46
"2011","Carmarthenshire 020A","W01000651","Total",700,223,98,125,477,41,89,91,114,18,31,93
"2011","Carmarthenshire 020B","W01000652","Total",793,236,126,110,557,80,108,88,111,29,45,96
"2011","Carmarthenshire 020C","W01000655","Total",827,233,106,127,594,78,107,106,128,28,56,91
"2011","Carmarthenshire 021A","W01000632","Total",618,180,88,92,438,40,108,78,88,18,27,79
"2011","Carmarthenshire 021B","W01000633","Total",703,296,172,124,407,38,105,51,109,8,37,59
"2011","Carmarthenshire 021C","W01000634","Total",653,217,150,67,436,23,160,61,91,7,24,70
"2011","Carmarthenshire 021D","W01000710","Total",899,193,105,88,706,35,193,148,136,30,39,125
"2011","Carmarthenshire 021E","W01000711","Total",908,291,155,136,617,63,157,76,150,25,39,107
"2011","Carmarthenshire 022A","W01000703","Total",818,305,120,185,513,82,75,97,106,16,46,91
"2011","Carmarthenshire 022B","W01000704","Total",719,225,129,96,494,24,139,85,97,16,31,102
"2011","Carmarthenshire 022C","W01000705","Total",834,267,137,130,567,91,107,76,120,20,56,97
"2011","Carmarthenshire 023A","W01000653","Total",642,207,109,98,435,29,113,74,98,11,27,83
"2011","Carmarthenshire 023B","W01000654","Total",788,299,120,179,489,52,85,86,127,12,33,94
"2011","Carmarthenshire 023C","W01000667","Total",625,182,105,77,443,30,113,94,102,13,22,69
"2011","Carmarthenshire 023F","W01001925","Total",980,262,118,144,718,59,169,105,185,24,49,127
"2011","Carmarthenshire 024A","W01000628","Total",617,161,75,86,456,28,88,84,106,11,42,97
"2011","Carmarthenshire 024B","W01000629","Total",761,254,118,136,507,62,94,77,123,16,41,94
"2011","Carmarthenshire 024C","W01000630","Total",666,182,70,112,484,58,73,90,116,17,39,91
"2011","Carmarthenshire 024D","W01000631","Total",783,261,114,147,522,92,91,95,97,20,29,98
"2011","Carmarthenshire 025A","W01000635","Total",916,230,87,143,686,42,104,149,197,20,62,112
"2011","Carmarthenshire 025B","W01000636","Total",789,204,107,97,585,75,100,114,134,21,42,99
"2011","Carmarthenshire 025C","W01000706","Total",683,170,72,98,513,64,88,89,131,20,37,84
"2011","Carmarthenshire 025D","W01000707","Total",615,177,72,105,438,71,77,75,92,24,30,69
"2011","Carmarthenshire 025E","W01000708","Total",613,203,77,126,410,87,67,62,87,17,30,60
"2011","Carmarthenshire 026A","W01000659","Total",650,206,76,130,444,74,62,76,92,19,41,80
"2011","Carmarthenshire 026B","W01000660","Total",747,311,119,192,436,61,86,55,119,19,31,65
"2011","Carmarthenshire 026D","W01000732","Total",623,214,89,125,409,48,69,51,120,9,31,81
"2011","Carmarthenshire 026E","W01000733","Total",654,329,121,208,325,50,47,50,87,14,21,56
"2011","Carmarthenshire 026F","W01000734","Total",651,255,81,174,396,72,42,69,106,17,36,54
"2011","Carmarthenshire 026G","W01001923","Total",603,232,51,181,371,40,43,60,138,14,20,56
"2011","Carmarthenshire 026H","W01001924","Total",623,263,104,159,360,68,51,57,88,15,36,45
"2011","Carmarthenshire 027E","W01000672","Total",681,179,87,92,502,19,121,72,144,16,37,93
"2011","Carmarthenshire 027F","W01000673","Total",544,170,82,88,374,28,99,53,94,12,20,68
"2011","Carmarthenshire 027A","W01000674","Total",831,191,97,94,640,33,151,85,152,19,56,144
"2011","Carmarthenshire 027G","W01000700","Total",883,250,131,119,633,25,176,90,167,11,48,116
"2011","Carmarthenshire 027B","W01000720","Total",696,233,113,120,463,13,104,72,130,17,29,98
"2011","Carmarthenshire 027C","W01000721","Total",536,127,78,49,409,30,81,78,94,18,33,75
"2011","Carmarthenshire 027D","W01000735","Total",978,278,147,131,700,43,170,114,180,33,54,106
"2011","Swansea 001A","W01000845","Total",819,196,83,113,623,36,115,151,153,18,44,106
"2011","Swansea 001B","W01000846","Total",815,326,117,209,489,54,69,108,141,16,42,59
"2011","Swansea 001C","W01000847","Total",522,135,76,59,387,27,92,65,75,14,30,84
"2011","Swansea 001D","W01000848","Total",505,148,80,68,357,42,67,63,84,24,23,54
"2011","Swansea 002A","W01000750","Total",717,270,147,123,447,39,97,69,113,17,40,72
"2011","Swansea 002B","W01000751","Total",626,169,83,86,457,17,143,73,114,9,14,87
"2011","Swansea 002C","W01000752","Total",641,193,62,131,448,76,56,79,110,14,48,65
"2011","Swansea 002D","W01000753","Total",602,186,75,111,416,48,62,81,96,16,26,87
"2011","Swansea 002E","W01000754","Total",681,221,94,127,460,38,84,84,109,19,41,85
"2011","Swansea 002F","W01000803","Total",767,212,93,119,555,22,120,98,128,23,41,123
"2011","Swansea 003A","W01000806","Total",631,155,73,82,476,39,108,90,102,12,34,91
"2011","Swansea 003B","W01000807","Total",562,117,38,79,445,23,65,66,127,10,29,125
"2011","Swansea 003C","W01000808","Total",625,176,97,79,449,25,131,66,90,7,29,101
"2011","Swansea 003D","W01000810","Total",667,306,131,175,361,70,56,54,75,17,31,58
"2011","Swansea 003E","W01000815","Total",671,159,70,89,512,21,123,84,138,13,23,110
"2011","Swansea 003F","W01000816","Total",712,186,52,134,526,35,84,129,131,14,39,94
"2011","Swansea 004A","W01000791","Total",636,186,44,142,450,26,51,124,127,13,28,81
"2011","Swansea 004B","W01000792","Total",686,177,72,105,509,21,121,115,106,9,37,100
"2011","Swansea 004C","W01000793","Total",766,195,53,142,571,33,61,188,166,18,31,74
"2011","Swansea 004D","W01000837","Total",641,132,54,78,509,14,107,120,131,24,31,82
"2011","Swansea 004E","W01000838","Total",559,188,84,104,371,50,70,71,86,15,21,58
"2011","Swansea 005A","W01000773","Total",1184,425,150,275,759,79,87,183,221,44,43,102
"2011","Swansea 005B","W01000774","Total",740,267,158,109,473,41,102,91,111,18,28,82
"2011","Swansea 005C","W01000841","Total",635,200,104,96,435,21,96,79,99,15,23,102
"2011","Swansea 005D","W01000842","Total",590,180,86,94,410,20,88,69,93,12,31,97
"2011","Swansea 005E","W01000843","Total",563,136,54,82,427,36,85,86,94,15,26,85
"2011","Swansea 005F","W01000844","Total",489,131,51,80,358,55,56,63,79,17,23,65
"2011","Swansea 006A","W01000795","Total",685,180,59,121,505,33,76,125,163,17,29,62
"2011","Swansea 006B","W01000796","Total",1063,222,48,174,841,66,73,243,261,29,59,110
"2011","Swansea 006C","W01000800","Total",604,136,63,73,468,19,77,102,139,10,37,84
"2011","Swansea 006D","W01000801","Total",635,197,76,121,438,51,72,73,89,21,36,96
"2011","Swansea 007A","W01000784","Total",586,189,116,73,397,32,80,69,106,14,21,75
"2011","Swansea 007B","W01000785","Total",528,117,68,49,411,14,98,77,86,11,31,94
"2011","Swansea 007C","W01000786","Total",573,144,74,70,429,19,102,64,113,13,28,90
"2011","Swansea 007D","W01000802","Total",1010,313,114,199,697,61,110,144,183,24,54,121
"2011","Swansea 007E","W01000877","Total",644,157,70,87,487,21,120,87,110,18,30,101
"2011","Swansea 007F","W01000878","Total",526,157,93,64,369,32,86,60,78,8,27,78
"2011","Swansea 008A","W01000809","Total",692,235,59,176,457,54,56,83,133,17,35,79
"2011","Swansea 008B","W01000811","Total",684,203,55,148,481,81,77,74,111,15,26,97
"2011","Swansea 008C","W01000812","Total",689,303,116,187,386,54,53,66,103,15,27,68
"2011","Swansea 008D","W01000813","Total",676,178,78,100,498,34,120,93,103,12,34,102
"2011","Swansea 008E","W01000814","Total",675,231,56,175,444,81,50,82,118,18,27,68
"2011","Swansea 009A","W01000817","Total",842,360,112,248,482,88,71,76,112,30,26,79
"2011","Swansea 009B","W01000818","Total",671,185,86,99,486,67,111,74,109,18,30,77
"2011","Swansea 009C","W01000819","Total",626,154,93,61,472,9,156,72,107,4,29,95
"2011","Swansea 009D","W01000820","Total",605,195,79,116,410,26,92,65,102,9,36,80
"2011","Swansea 009E","W01000821","Total",673,236,104,132,437,39,87,74,111,11,25,90
"2011","Swansea 009F","W01000822","Total",594,193,118,75,401,17,139,44,100,10,14,77
"2011","Swansea 010A","W01000794","Total",921,263,57,206,658,54,66,168,210,18,42,100
"2011","Swansea 010B","W01000797","Total",652,168,72,96,484,29,124,70,129,16,31,85
"2011","Swansea 010C","W01000798","Total",627,171,88,83,456,19,133,67,117,10,25,85
"2011","Swansea 010D","W01000799","Total",782,200,52,148,582,118,45,123,148,30,37,81
"2011","Swansea 011A","W01000830","Total",687,221,52,169,466,119,41,82,92,31,47,54
"2011","Swansea 011B","W01000832","Total",763,353,101,252,410,58,54,78,83,22,38,77
"2011","Swansea 011C","W01000833","Total",767,274,79,195,493,118,59,88,95,34,28,71
"2011","Swansea 011D","W01000834","Total",602,160,79,81,442,77,71,72,76,31,38,77
"2011","Swansea 011E","W01000836","Total",934,264,39,225,670,115,52,173,162,42,41,85
"2011","Swansea 012A","W01000759","Total",655,188,110,78,467,13,110,89,142,9,24,80
"2011","Swansea 012B","W01000777","Total",785,227,124,103,558,35,142,105,135,11,35,95
"2011","Swansea 012C","W01000778","Total",770,196,68,128,574,55,89,142,132,10,45,101
"2011","Swansea 012D","W01000779","Total",597,140,68,72,457,41,76,87,101,24,41,87
"2011","Swansea 013A","W01000760","Total",728,214,77,137,514,57,82,105,143,13,31,83
"2011","Swansea 013B","W01000761","Total",652,189,71,118,463,45,69,92,128,22,34,73
"2011","Swansea 013C","W01000762","Total",617,162,58,104,455,49,76,69,83,26,39,113
"2011","Swansea 013D","W01000831","Total",825,274,108,166,551,135,93,101,99,10,30,83
"2011","Swansea 013E","W01000835","Total",594,185,84,101,409,66,82,64,71,32,19,75
"2011","Swansea 014A","W01000738","Total",753,241,90,151,512,73,76,86,122,27,37,91
"2011","Swansea 014B","W01000739","Total",863,344,55,289,519,62,50,82,186,21,42,76
"2011","Swansea 014C","W01000740","Total",658,157,82,75,501,18,130,78,134,10,42,89
"2011","Swansea 014D","W01000741","Total",706,244,143,101,462,63,102,68,99,14,33,83
"2011","Swansea 015A","W01000763","Total",620,167,62,105,453,57,60,85,105,18,33,95
"2011","Swansea 015B","W01000764","Total",680,190,66,124,490,45,70,98,130,20,32,95
"2011","Swansea 015C","W01000765","Total",748,247,111,136,501,52,92,86,140,12,31,88
"2011","Swansea 015D","W01000766","Total",641,164,72,92,477,52,77,88,111,16,41,92
"2011","Swansea 015E","W01000767","Total",757,355,173,182,402,40,85,58,96,15,30,78
"2011","Swansea 016A","W01000742","Total",800,400,105,295,400,66,60,69,105,12,28,60
"2011","Swansea 016B","W01000744","Total",755,303,78,225,452,75,56,61,167,6,15,72
"2011","Swansea 016C","W01000787","Total",678,209,50,159,469,56,67,92,136,7,26,85
"2011","Swansea 016D","W01000788","Total",658,226,80,146,432,66,55,79,121,8,20,83
"2011","Swansea 016E","W01000789","Total",640,216,56,160,424,65,52,77,116,11,26,77
"2011","Swansea 016F","W01000790","Total",748,255,81,174,493,62,77,72,129,22,46,85
"2011","Swansea 017A","W01000755","Total",868,285,112,173,583,63,121,113,125,20,39,102
"2011","Swansea 017B","W01000756","Total",751,313,78,235,438,57,67,87,106,16,40,65
"2011","Swansea 017C","W01000757","Total",718,266,160,106,452,26,129,76,113,7,22,79
"2011","Swansea 017D","W01000758","Total",839,272,104,168,567,37,111,119,147,22,33,98
"2011","Swansea 018A","W01000772","Total",615,135,77,58,480,23,102,83,101,26,36,109
"2011","Swansea 018B","W01000828","Total",732,184,112,72,548,15,156,92,124,19,26,116
"2011","Swansea 018C","W01000829","Total",828,255,127,128,573,34,120,96,151,17,38,117
"2011","Swansea 019A","W01000862","Total",706,241,45,196,465,154,16,112,84,13,31,55
"2011","Swansea 019B","W01000863","Total",753,301,118,183,452,123,52,82,97,16,27,55
"2011","Swansea 019C","W01000864","Total",706,227,61,166,479,125,40,106,85,23,36,64
"2011","Swansea 019D","W01000865","Total",591,197,97,100,394,61,71,51,87,17,34,73
"2011","Swansea 019E","W01000866","Total",524,159,76,83,365,75,49,53,87,16,24,61
"2011","Swansea 019F","W01000867","Total",570,181,66,115,389,68,53,59,102,15,26,66
"2011","Swansea 020A","W01000768","Total",611,184,88,96,427,22,111,80,96,13,29,76
"2011","Swansea 020B","W01000769","Total",591,149,84,65,442,19,129,77,97,23,25,72
"2011","Swansea 020C","W01000770","Total",638,125,67,58,513,23,137,99,116,18,29,91
"2011","Swansea 020D","W01000771","Total",533,116,68,48,417,19,118,76,79,10,33,82
"2011","Swansea 021A","W01000849","Total",807,246,105,141,561,96,75,120,128,11,37,94
"2011","Swansea 021B","W01000850","Total",1195,553,147,406,642,57,102,72,255,16,37,103
"2011","Swansea 021C","W01000851","Total",682,211,76,135,471,52,72,77,134,9,34,93
"2011","Swansea 021D","W01000852","Total",637,190,85,105,447,39,77,75,110,12,47,87
"2011","Swansea 022A","W01000853","Total",607,156,75,81,451,17,110,88,104,16,28,88
"2011","Swansea 022B","W01000854","Total",529,125,47,78,404,20,55,95,117,13,27,77
"2011","Swansea 022C","W01000855","Total",645,175,100,75,470,12,146,87,104,12,25,84
"2011","Swansea 022D","W01000856","Total",997,589,247,342,408,52,94,60,99,17,25,61
"2011","Swansea 022E","W01000857","Total",900,431,278,153,469,26,133,78,108,17,32,75
"2011","Swansea 023B","W01000781","Total",708,174,124,50,534,15,180,87,104,20,43,85
"2011","Swansea 023C","W01000782","Total",516,167,99,68,349,16,111,52,94,8,11,57
"2011","Swansea 023E","W01001956","Total",803,276,122,154,527,34,113,90,131,12,36,111
"2011","Swansea 024A","W01000747","Total",743,311,67,244,432,15,27,44,118,11,31,186
"2011","Swansea 024B","W01000868","Total",482,113,52,61,369,10,77,75,123,7,20,57
"2011","Swansea 024C","W01000869","Total",727,332,82,250,395,15,71,42,133,11,26,97
"2011","Swansea 024D","W01000870","Total",640,239,47,192,401,24,46,59,124,7,18,123
"2011","Swansea 024E","W01000872","Total",615,197,106,91,418,23,81,83,123,18,16,74
"2011","Swansea 024F","W01000874","Total",709,212,94,118,497,12,54,55,96,5,33,242
"2011","Swansea 025B","W01000745","Total",1072,532,78,454,540,30,56,58,193,12,32,159
"2011","Swansea 025C","W01000746","Total",800,340,75,265,460,33,52,34,178,7,17,139
"2011","Swansea 025E","W01001938","Total",807,517,75,442,290,4,40,19,200,0,1,26
"2011","Swansea 025F","W01001955","Total",1153,888,205,683,265,8,47,19,161,0,2,28
"2011","Swansea 025G","W01001957","Total",411,197,60,137,214,16,43,29,67,5,11,43
"2011","Swansea 025H","W01001958","Total",836,499,95,404,337,6,36,32,222,2,3,36
"2011","Swansea 026A","W01000749","Total",894,419,231,188,475,30,93,63,116,12,27,134
"2011","Swansea 026B","W01000871","Total",714,277,55,222,437,14,43,26,139,9,22,184
"2011","Swansea 026C","W01000873","Total",593,198,29,169,395,9,27,10,141,2,22,184
"2011","Swansea 026D","W01000875","Total",771,310,93,217,461,8,45,26,115,10,16,241
"2011","Swansea 026E","W01000876","Total",637,148,41,107,489,14,45,45,91,7,19,268
"2011","Swansea 027A","W01000858","Total",687,190,83,107,497,11,85,83,158,15,27,118
"2011","Swansea 027B","W01000859","Total",679,233,145,88,446,3,192,55,86,4,26,80
"2011","Swansea 027C","W01000860","Total",631,152,101,51,479,9,170,57,109,13,28,93
"2011","Swansea 027D","W01000861","Total",451,193,119,74,258,5,76,42,69,3,13,50
"2011","Swansea 028A","W01000736","Total",763,216,147,69,547,24,182,102,108,14,21,96
"2011","Swansea 028B","W01000737","Total",700,249,144,105,451,20,146,73,108,14,21,69
"2011","Swansea 028C","W01000804","Total",730,290,185,105,440,13,167,85,99,15,21,40
"2011","Swansea 028D","W01000805","Total",479,97,65,32,382,10,112,65,88,10,42,55
"2011","Swansea 029A","W01000879","Total",767,212,111,101,555,14,172,102,134,13,38,82
"2011","Swansea 029B","W01000880","Total",759,279,187,92,480,18,167,75,106,12,15,87
"2011","Swansea 029C","W01000881","Total",710,350,167,183,360,33,87,47,104,18,15,56
"2011","Swansea 029D","W01000882","Total",826,302,164,138,524,86,124,98,103,12,26,75
"2011","Swansea 030A","W01000775","Total",738,178,94,84,560,34,138,89,127,17,44,111
"2011","Swansea 030B","W01000776","Total",733,175,94,81,558,15,160,97,133,26,37,90
"2011","Swansea 030C","W01000839","Total",460,148,91,57,312,15,117,63,48,14,20,35
"2011","Swansea 030D","W01000840","Total",706,169,104,65,537,13,205,91,97,20,23,88
"2011","Swansea 031A","W01000823","Total",738,188,132,56,550,7,193,88,119,22,34,87
"2011","Swansea 031B","W01000824","Total",765,313,155,158,452,25,146,71,124,15,19,52
"2011","Swansea 031C","W01000825","Total",718,275,120,155,443,28,112,69,135,7,22,70
"2011","Swansea 031D","W01000826","Total",642,232,121,111,410,13,135,65,95,14,16,72
"2011","Swansea 031E","W01000827","Total",615,208,99,109,407,14,95,69,117,20,18,74
"2011","Neath Port Talbot 002A","W01000918","Total",842,273,138,135,569,37,106,117,140,10,38,121
"2011","Neath Port Talbot 002B","W01000944","Total",524,158,77,81,366,27,85,66,89,11,17,71
"2011","Neath Port Talbot 002C","W01000965","Total",866,228,123,105,638,53,130,117,140,21,40,137
"2011","Neath Port Talbot 003A","W01000893","Total",817,203,106,97,614,42,125,100,142,12,51,142
"2011","Neath Port Talbot 003B","W01000925","Total",657,201,99,102,456,46,85,72,98,30,31,94
"2011","Neath Port Talbot 003C","W01000926","Total",862,268,136,132,594,48,173,95,133,9,30,106
"2011","Neath Port Talbot 004A","W01000888","Total",933,228,105,123,705,49,101,157,194,13,52,139
"2011","Neath Port Talbot 004B","W01000946","Total",616,157,77,80,459,30,88,83,103,14,40,101
"2011","Neath Port Talbot 004C","W01000947","Total",866,255,104,151,611,83,89,112,146,28,40,113
"2011","Neath Port Talbot 004D","W01000948","Total",842,331,151,180,511,28,104,83,146,7,41,102
"2011","Neath Port Talbot 004E","W01000955","Total",526,140,75,65,386,18,92,77,78,11,29,81
"2011","Neath Port Talbot 004F","W01000956","Total",522,136,98,38,386,10,105,64,108,9,14,76
"2011","Neath Port Talbot 004G","W01000971","Total",599,165,80,85,434,34,77,73,114,12,30,94
"2011","Neath Port Talbot 005A","W01000887","Total",953,211,84,127,742,59,120,170,186,23,52,132
"2011","Neath Port Talbot 005B","W01000953","Total",727,207,98,109,520,35,107,92,124,18,44,100
"2011","Neath Port Talbot 005C","W01000954","Total",633,198,101,97,435,33,89,69,124,8,31,81
"2011","Neath Port Talbot 005D","W01000970","Total",500,158,92,66,342,22,60,66,83,10,23,78
"2011","Neath Port Talbot 006A","W01000902","Total",438,108,66,42,330,12,105,44,75,7,19,68
"2011","Neath Port Talbot 006B","W01000903","Total",491,123,81,42,368,5,104,52,103,7,19,78
"2011","Neath Port Talbot 006C","W01000904","Total",640,139,50,89,501,29,91,132,152,14,24,59
"2011","Neath Port Talbot 006D","W01000905","Total",627,148,60,88,479,52,73,100,112,16,33,93
"2011","Neath Port Talbot 006E","W01000908","Total",744,226,135,91,518,15,154,100,110,16,33,90
"2011","Neath Port Talbot 007A","W01000906","Total",461,107,63,44,354,12,125,36,80,3,20,78
"2011","Neath Port Talbot 007B","W01000907","Total",762,245,114,131,517,62,111,108,97,14,39,86
"2011","Neath Port Talbot 007C","W01000922","Total",721,234,108,126,487,44,87,100,113,16,37,90
"2011","Neath Port Talbot 007D","W01000923","Total",651,171,86,85,480,30,123,64,134,14,25,90
"2011","Neath Port Talbot 008A","W01000934","Total",628,248,81,167,380,40,66,73,117,12,16,56
"2011","Neath Port Talbot 008B","W01000935","Total",842,411,144,267,431,37,99,50,120,6,27,92
"2011","Neath Port Talbot 008C","W01000938","Total",611,219,137,82,392,12,119,56,76,10,25,94
"2011","Neath Port Talbot 008D","W01000939","Total",690,373,160,213,317,21,72,48,107,4,17,48
"2011","Neath Port Talbot 008E","W01000940","Total",596,201,91,110,395,52,69,68,110,14,14,68
"2011","Neath Port Talbot 009A","W01000909","Total",494,131,66,65,363,20,85,48,97,10,26,77
"2011","Neath Port Talbot 009B","W01000910","Total",640,165,75,90,475,11,102,79,153,10,24,96
"2011","Neath Port Talbot 009C","W01000911","Total",490,82,42,40,408,11,74,94,113,6,26,84
"2011","Neath Port Talbot 009D","W01000969","Total",515,119,58,61,396,13,82,72,90,7,34,98
"2011","Neath Port Talbot 010A","W01000912","Total",537,187,102,85,350,32,71,55,90,6,23,73
"2011","Neath Port Talbot 010B","W01000913","Total",528,188,86,102,340,19,72,51,98,10,24,66
"2011","Neath Port Talbot 010C","W01000914","Total",647,182,70,112,465,47,68,95,114,17,34,90
"2011","Neath Port Talbot 010D","W01000915","Total",496,116,55,61,380,26,80,82,86,16,20,70
"2011","Neath Port Talbot 010E","W01000916","Total",479,120,56,64,359,19,61,83,96,13,23,64
"2011","Neath Port Talbot 010F","W01000917","Total",1086,241,114,127,845,40,131,174,265,17,55,163
"2011","Neath Port Talbot 011A","W01000920","Total",518,141,62,79,377,29,70,63,81,14,29,91
"2011","Neath Port Talbot 011B","W01000921","Total",666,215,93,122,451,62,92,58,101,17,48,73
"2011","Neath Port Talbot 011C","W01000924","Total",463,127,60,67,336,37,73,47,69,9,30,71
"2011","Neath Port Talbot 011D","W01000930","Total",617,213,106,107,404,52,77,57,92,13,28,85
"2011","Neath Port Talbot 012A","W01000936","Total",628,171,64,107,457,55,52,92,125,23,28,82
"2011","Neath Port Talbot 012B","W01000941","Total",639,207,79,128,432,46,61,88,104,22,37,74
"2011","Neath Port Talbot 012C","W01000942","Total",782,235,98,137,547,68,72,121,116,20,43,107
"2011","Neath Port Talbot 012D","W01000943","Total",614,125,71,54,489,18,119,110,105,12,36,89
"2011","Neath Port Talbot 013A","W01000894","Total",615,205,115,90,410,26,108,63,97,14,33,69
"2011","Neath Port Talbot 013B","W01000895","Total",783,349,136,213,434,40,67,90,144,9,18,66
"2011","Neath Port Talbot 013C","W01000896","Total",646,125,53,72,521,74,84,87,111,21,47,97
"2011","Neath Port Talbot 013D","W01000897","Total",594,188,91,97,406,23,96,73,109,13,20,72
"2011","Neath Port Talbot 013E","W01000937","Total",950,372,109,263,578,50,88,116,163,26,40,95
"2011","Neath Port Talbot 014A","W01000898","Total",636,187,85,102,449,31,84,90,117,14,28,85
"2011","Neath Port Talbot 014B","W01000899","Total",694,161,77,84,533,25,107,110,139,14,42,96
"2011","Neath Port Talbot 014C","W01000900","Total",787,294,128,166,493,52,95,82,131,8,31,94
"2011","Neath Port Talbot 014D","W01000901","Total",733,206,96,110,527,53,103,96,134,11,33,97
"2011","Neath Port Talbot 014E","W01000945","Total",492,137,66,71,355,23,59,67,101,14,17,74
"2011","Neath Port Talbot 015A","W01000889","Total",795,238,102,136,557,18,139,97,146,14,29,114
"2011","Neath Port Talbot 015B","W01000890","Total",675,141,79,62,534,12,128,106,129,11,37,111
"2011","Neath Port Talbot 015C","W01000891","Total",640,207,115,92,433,54,72,68,93,15,39,92
"2011","Neath Port Talbot 015D","W01000892","Total",814,205,116,89,609,20,183,110,147,9,33,107
"2011","Neath Port Talbot 016A","W01000883","Total",619,162,68,94,457,19,87,60,146,5,24,116
"2011","Neath Port Talbot 016B","W01000958","Total",650,176,78,98,474,69,63,68,109,23,44,98
"2011","Neath Port Talbot 016C","W01000961","Total",726,237,139,98,489,64,116,63,94,18,32,102
"2011","Neath Port Talbot 016D","W01000962","Total",606,139,64,75,467,68,56,72,102,20,43,106
"2011","Neath Port Talbot 016E","W01000963","Total",776,269,162,107,507,57,100,72,106,17,55,100
"2011","Neath Port Talbot 016F","W01000964","Total",774,243,125,118,531,68,126,70,122,18,35,92
"2011","Neath Port Talbot 017A","W01000884","Total",527,160,60,100,367,39,62,67,81,18,20,80
"2011","Neath Port Talbot 017B","W01000885","Total",623,256,115,141,367,37,66,71,87,23,17,66
"2011","Neath Port Talbot 017C","W01000886","Total",689,265,69,196,424,39,58,77,121,19,25,85
"2011","Neath Port Talbot 017D","W01000957","Total",852,375,175,200,477,55,119,63,109,5,28,98
"2011","Neath Port Talbot 017E","W01000959","Total",760,215,87,128,545,35,101,103,134,11,41,120
"2011","Neath Port Talbot 017F","W01000960","Total",783,277,123,154,506,51,90,86,131,8,37,103
"2011","Neath Port Talbot 018A","W01000949","Total",572,149,70,79,423,21,99,65,108,6,32,92
"2011","Neath Port Talbot 018B","W01000950","Total",676,213,86,127,463,36,68,84,129,16,31,99
"2011","Neath Port Talbot 018C","W01000951","Total",650,219,74,145,431,27,60,73,103,21,39,108
"2011","Neath Port Talbot 018D","W01000952","Total",484,145,71,74,339,11,49,67,98,11,32,71
"2011","Neath Port Talbot 018E","W01000966","Total",637,196,98,98,441,29,104,80,111,9,24,84
"2011","Neath Port Talbot 019A","W01000932","Total",491,183,78,105,308,19,81,43,73,4,26,62
"2011","Neath Port Talbot 019B","W01000933","Total",741,124,41,83,617,23,96,174,160,20,55,89
"2011","Neath Port Talbot 019C","W01000967","Total",681,253,89,164,428,54,79,63,106,14,26,86
"2011","Neath Port Talbot 019D","W01000968","Total",803,181,73,108,622,56,121,117,169,15,33,111
"2011","Neath Port Talbot 020A","W01000919","Total",504,141,63,78,363,16,72,72,107,10,20,66
"2011","Neath Port Talbot 020B","W01000927","Total",704,198,64,134,506,41,82,95,145,20,31,92
"2011","Neath Port Talbot 020C","W01000928","Total",698,226,105,121,472,38,92,81,120,9,42,90
"2011","Neath Port Talbot 020D","W01000929","Total",562,169,72,97,393,38,72,70,98,18,27,70
"2011","Neath Port Talbot 020E","W01000931","Total",560,161,74,87,399,26,76,76,104,20,32,65
"2011","Neath Port Talbot 020F","W01000973","Total",681,264,138,126,417,38,80,72,105,17,30,75
"2011","Neath Port Talbot 020G","W01001900","Total",684,213,90,123,471,56,85,87,129,15,31,68
"2011","Bridgend 001A","W01000991","Total",475,135,58,77,340,48,54,44,81,17,33,63
"2011","Bridgend 001B","W01000992","Total",636,193,89,104,443,65,66,75,91,13,41,92
"2011","Bridgend 001C","W01000993","Total",625,166,72,94,459,61,64,92,106,14,37,85
"2011","Bridgend 001D","W01000994","Total",576,149,52,97,427,58,70,71,100,20,30,78
"2011","Bridgend 001E","W01000995","Total",654,211,101,110,443,44,97,77,110,11,30,74
"2011","Bridgend 002A","W01001014","Total",779,303,154,149,476,38,89,100,126,9,29,85
"2011","Bridgend 002B","W01001015","Total",594,147,72,75,447,41,76,72,110,18,38,92
"2011","Bridgend 002C","W01001017","Total",601,154,83,71,447,23,84,92,101,14,36,97
"2011","Bridgend 002D","W01001018","Total",634,209,74,135,425,35,70,76,135,9,29,71
"2011","Bridgend 002E","W01001020","Total",615,180,55,125,435,52,61,74,112,19,31,86
"2011","Bridgend 003A","W01000976","Total",450,106,52,54,344,38,56,63,83,14,24,66
"2011","Bridgend 003B","W01000977","Total",579,145,71,74,434,23,80,67,129,21,29,85
"2011","Bridgend 003C","W01001024","Total",507,161,66,95,346,34,60,59,90,8,27,68
"2011","Bridgend 003D","W01001025","Total",519,156,68,88,363,30,66,64,92,9,32,70
"2011","Bridgend 003E","W01001033","Total",735,214,99,115,521,44,97,117,125,17,38,83
"2011","Bridgend 003F","W01001034","Total",659,257,104,153,402,33,68,69,121,8,30,73
"2011","Bridgend 004A","W01000975","Total",884,207,100,107,677,76,107,122,162,34,56,120
"2011","Bridgend 004B","W01000978","Total",774,242,119,123,532,45,85,102,142,20,41,97
"2011","Bridgend 004C","W01001009","Total",497,107,36,71,390,21,78,59,104,18,31,79
"2011","Bridgend 004D","W01001042","Total",573,166,63,103,407,43,64,91,110,12,27,60
"2011","Bridgend 004E","W01001043","Total",502,145,63,82,357,20,67,78,95,11,22,64
"2011","Bridgend 005A","W01001012","Total",584,103,37,66,481,20,83,120,106,20,48,84
"2011","Bridgend 005B","W01001013","Total",636,183,113,70,453,29,103,73,108,9,29,102
"2011","Bridgend 005C","W01001016","Total",744,204,115,89,540,32,169,74,123,7,32,103
"2011","Bridgend 005D","W01001019","Total",621,171,90,81,450,38,88,73,98,14,35,104
"2011","Bridgend 006A","W01000974","Total",900,259,110,149,641,56,108,110,192,12,32,131
"2011","Bridgend 006B","W01001057","Total",665,225,73,152,440,49,69,85,135,10,22,70
"2011","Bridgend 006C","W01001058","Total",772,177,78,99,595,49,94,136,159,13,51,93
"2011","Bridgend 007A","W01000986","Total",573,163,49,114,410,42,45,96,127,6,28,66
"2011","Bridgend 007B","W01000987","Total",962,263,102,161,699,95,109,134,187,25,53,96
"2011","Bridgend 007C","W01001055","Total",514,156,67,89,358,37,73,48,78,21,25,76
"2011","Bridgend 007D","W01001056","Total",507,132,74,58,375,15,88,45,82,7,31,107
"2011","Bridgend 008A","W01000996","Total",638,181,89,92,457,27,102,76,111,11,26,104
"2011","Bridgend 008B","W01001048","Total",607,174,67,107,433,30,81,82,124,10,26,80
"2011","Bridgend 008C","W01001049","Total",530,141,70,71,389,43,74,59,72,16,37,88
"2011","Bridgend 008D","W01001050","Total",669,198,104,94,471,49,72,70,133,9,40,98
"2011","Bridgend 008E","W01001051","Total",727,179,60,119,548,80,79,118,116,18,44,93
"2011","Bridgend 008F","W01001052","Total",612,224,110,114,388,37,67,68,99,18,24,75
"2011","Bridgend 009A","W01001004","Total",488,162,79,83,326,17,81,51,81,12,23,61
"2011","Bridgend 009B","W01001005","Total",740,214,118,96,526,30,116,93,159,15,34,79
"2011","Bridgend 009C","W01001006","Total",946,171,97,74,775,30,190,130,194,21,66,144
"2011","Bridgend 009D","W01001007","Total",700,147,73,74,553,48,89,111,158,24,26,97
"2011","Bridgend 009E","W01001039","Total",678,174,64,110,504,17,93,100,128,23,40,103
"2011","Bridgend 009F","W01001040","Total",611,140,65,75,471,18,93,85,138,22,36,79
"2011","Bridgend 010A","W01000999","Total",614,180,105,75,434,48,105,58,102,16,20,85
"2011","Bridgend 010B","W01001000","Total",726,196,93,103,530,38,97,98,153,17,31,96
"2011","Bridgend 010C","W01001001","Total",623,165,82,83,458,43,118,75,107,15,23,77
"2011","Bridgend 010D","W01001002","Total",1060,323,73,250,737,123,67,147,233,29,40,98
"2011","Bridgend 011A","W01000998","Total",513,110,38,72,403,24,77,85,129,9,20,59
"2011","Bridgend 011B","W01001008","Total",910,197,119,78,713,24,212,121,165,11,43,137
"2011","Bridgend 011C","W01001038","Total",927,286,156,130,641,44,125,131,163,32,42,104
"2011","Bridgend 012A","W01000997","Total",690,188,110,78,502,16,166,68,126,11,38,77
"2011","Bridgend 012B","W01001010","Total",510,149,45,104,361,43,41,52,99,18,32,76
"2011","Bridgend 012C","W01001011","Total",578,157,64,93,421,27,65,94,112,17,26,80
"2011","Bridgend 012D","W01001026","Total",838,272,161,111,566,45,103,91,131,20,60,116
"2011","Bridgend 013A","W01000989","Total",574,126,72,54,448,14,113,73,106,12,39,91
"2011","Bridgend 013B","W01001037","Total",671,183,109,74,488,14,133,81,125,10,33,92
"2011","Bridgend 013C","W01001041","Total",926,152,83,69,774,36,182,146,192,16,58,144
"2011","Bridgend 014A","W01001021","Total",764,315,140,175,449,18,81,102,137,9,26,76
"2011","Bridgend 014B","W01001022","Total",623,222,98,124,401,59,82,48,97,24,26,65
"2011","Bridgend 014C","W01001023","Total",815,326,141,185,489,36,89,64,147,10,38,105
"2011","Bridgend 014D","W01001028","Total",823,239,102,137,584,21,145,97,167,12,34,108
"2011","Bridgend 014E","W01001035","Total",745,274,116,158,471,55,69,85,138,14,29,81
"2011","Bridgend 015A","W01000979","Total",694,166,38,128,528,66,45,108,162,24,35,88
"2011","Bridgend 015B","W01000983","Total",638,150,34,116,488,39,44,130,161,12,26,76
"2011","Bridgend 015C","W01000985","Total",512,87,17,70,425,16,33,106,114,10,48,98
"2011","Bridgend 015D","W01001003","Total",583,148,92,56,435,8,159,44,115,8,28,73
"2011","Bridgend 016A","W01000980","Total",555,123,39,84,432,33,50,71,128,12,34,104
"2011","Bridgend 016B","W01000981","Total",489,145,38,107,344,77,23,72,81,16,20,55
"2011","Bridgend 016C","W01000982","Total",627,154,64,90,473,31,96,77,130,6,23,110
"2011","Bridgend 016D","W01000984","Total",931,264,66,198,667,76,69,145,220,23,42,92
"2011","Bridgend 017B","W01000990","Total",660,221,106,115,439,48,84,69,90,21,36,91
"2011","Bridgend 017C","W01001027","Total",720,232,156,76,488,25,148,78,107,14,24,92
"2011","Bridgend 017D","W01001036","Total",646,174,114,60,472,17,101,77,114,10,36,117
"2011","Bridgend 017E","W01001918","Total",536,61,8,53,475,24,28,194,109,27,43,50
"2011","Bridgend 017F","W01001919","Total",531,90,11,79,441,28,31,147,140,21,23,51
"2011","Bridgend 017G","W01001920","Total",443,64,13,51,379,17,34,112,108,17,32,59
"2011","Bridgend 017H","W01001921","Total",576,105,14,91,471,56,37,153,105,25,38,57
"2011","Bridgend 018A","W01001031","Total",628,156,97,59,472,10,138,80,113,10,28,93
"2011","Bridgend 018B","W01001032","Total",818,268,195,73,550,31,175,92,112,16,28,96
"2011","Bridgend 018C","W01001046","Total",873,381,213,168,492,61,114,59,129,11,31,87
"2011","Bridgend 018D","W01001047","Total",757,264,138,126,493,21,152,84,102,17,39,78
"2011","Bridgend 018E","W01001053","Total",465,142,98,44,323,10,122,41,64,7,19,60
"2011","Bridgend 018F","W01001054","Total",532,161,107,54,371,2,152,46,64,11,28,68
"2011","Bridgend 019A","W01001029","Total",798,247,144,103,551,18,156,82,159,13,27,96
"2011","Bridgend 019B","W01001030","Total",765,206,131,75,559,18,148,103,143,19,30,98
"2011","Bridgend 019C","W01001044","Total",771,276,160,116,495,46,127,71,109,18,28,96
"2011","Bridgend 019D","W01001045","Total",745,233,104,129,512,42,95,88,128,18,37,104
"2011","The Vale of Glamorgan 001A","W01001105","Total",1024,188,113,75,836,23,206,170,185,31,64,157
"2011","The Vale of Glamorgan 001B","W01001127","Total",535,134,71,63,401,15,117,64,127,8,16,54
"2011","The Vale of Glamorgan 001C","W01001128","Total",599,139,76,63,460,12,111,77,117,16,24,103
"2011","The Vale of Glamorgan 002A","W01001082","Total",754,285,177,108,469,16,175,57,124,9,23,65
"2011","The Vale of Glamorgan 002B","W01001083","Total",659,134,86,48,525,5,162,82,132,23,33,88
"2011","The Vale of Glamorgan 002C","W01001084","Total",721,233,129,104,488,21,155,79,129,13,23,68
"2011","The Vale of Glamorgan 002D","W01001085","Total",581,111,52,59,470,4,112,108,103,15,33,95
"2011","The Vale of Glamorgan 003A","W01001113","Total",913,203,98,105,710,20,187,148,159,37,57,102
"2011","The Vale of Glamorgan 003B","W01001119","Total",678,141,61,80,537,22,104,106,144,27,44,90
"2011","The Vale of Glamorgan 003C","W01001135","Total",600,123,66,57,477,10,129,87,117,20,31,83
"2011","The Vale of Glamorgan 003D","W01001136","Total",497,125,76,49,372,9,120,60,90,10,19,64
"2011","The Vale of Glamorgan 004A","W01001075","Total",496,140,72,68,356,17,67,87,82,12,31,60
"2011","The Vale of Glamorgan 004B","W01001076","Total",625,184,57,127,441,57,50,91,128,16,21,78
"2011","The Vale of Glamorgan 004C","W01001077","Total",616,202,116,86,414,24,111,61,82,16,30,90
"2011","The Vale of Glamorgan 004D","W01001078","Total",510,127,79,48,383,24,75,88,79,11,31,75
"2011","The Vale of Glamorgan 004E","W01001104","Total",864,245,116,129,619,34,156,105,171,9,45,99
"2011","The Vale of Glamorgan 004F","W01001129","Total",517,120,83,37,397,25,71,82,69,20,40,90
"2011","The Vale of Glamorgan 005A","W01001116","Total",833,286,169,117,547,16,146,101,128,23,42,91
"2011","The Vale of Glamorgan 005B","W01001123","Total",850,391,152,239,459,28,114,70,155,7,21,64
"2011","The Vale of Glamorgan 005C","W01001124","Total",683,278,69,209,405,28,58,86,112,16,29,76
"2011","The Vale of Glamorgan 005D","W01001125","Total",618,221,103,118,397,31,67,90,86,22,23,78
"2011","The Vale of Glamorgan 005E","W01001126","Total",1036,450,74,376,586,37,77,77,302,10,22,61
"2011","The Vale of Glamorgan 005F","W01001130","Total",534,161,73,88,373,21,63,89,87,18,25,70
"2011","The Vale of Glamorgan 006A","W01001086","Total",644,168,95,73,476,17,138,78,119,17,22,85
"2011","The Vale of Glamorgan 006B","W01001087","Total",657,177,114,63,480,26,147,71,93,16,32,95
"2011","The Vale of Glamorgan 006C","W01001088","Total",813,261,173,88,552,52,152,70,120,23,42,93
"2011","The Vale of Glamorgan 006D","W01001089","Total",604,155,90,65,449,19,108,81,104,13,32,92
"2011","The Vale of Glamorgan 006E","W01001090","Total",615,142,88,54,473,25,130,81,110,14,29,84
"2011","The Vale of Glamorgan 007A","W01001081","Total",670,227,87,140,443,74,70,81,92,16,43,67
"2011","The Vale of Glamorgan 007B","W01001092","Total",673,173,79,94,500,56,93,87,96,19,46,103
"2011","The Vale of Glamorgan 007C","W01001094","Total",531,116,36,80,415,73,56,84,96,14,32,60
"2011","The Vale of Glamorgan 007D","W01001095","Total",667,243,95,148,424,84,50,79,95,28,29,59
"2011","The Vale of Glamorgan 007E","W01001096","Total",636,218,123,95,418,27,99,73,106,12,29,72
"2011","The Vale of Glamorgan 007F","W01001097","Total",607,129,58,71,478,76,65,66,84,28,70,89
"2011","The Vale of Glamorgan 008A","W01001114","Total",661,171,132,39,490,7,151,89,104,16,35,88
"2011","The Vale of Glamorgan 008B","W01001115","Total",872,235,154,81,637,35,149,156,111,36,49,101
"2011","The Vale of Glamorgan 008C","W01001131","Total",760,260,127,133,500,48,81,120,127,15,48,61
"2011","The Vale of Glamorgan 008D","W01001132","Total",585,172,78,94,413,26,65,91,118,13,29,71
"2011","The Vale of Glamorgan 008E","W01001133","Total",904,271,125,146,633,15,213,85,154,20,37,109
"2011","The Vale of Glamorgan 008F","W01001134","Total",536,187,82,105,349,14,83,71,109,8,19,45
"2011","The Vale of Glamorgan 009A","W01001067","Total",648,266,123,143,382,35,77,64,97,13,28,68
"2011","The Vale of Glamorgan 009B","W01001068","Total",731,200,39,161,531,59,48,132,159,19,36,78
"2011","The Vale of Glamorgan 009C","W01001070","Total",539,222,34,188,317,39,23,65,115,18,21,36
"2011","The Vale of Glamorgan 009D","W01001071","Total",667,190,77,113,477,56,71,98,120,15,32,85
"2011","The Vale of Glamorgan 009E","W01001072","Total",1001,157,41,116,844,56,103,221,224,22,67,151
"2011","The Vale of Glamorgan 010A","W01001091","Total",724,187,107,80,537,25,146,76,127,8,38,117
"2011","The Vale of Glamorgan 010B","W01001098","Total",467,112,66,46,355,13,96,50,100,5,23,68
"2011","The Vale of Glamorgan 010C","W01001100","Total",636,173,117,56,463,13,103,85,119,16,31,96
"2011","The Vale of Glamorgan 010D","W01001103","Total",520,125,56,69,395,22,90,62,103,14,33,71
"2011","The Vale of Glamorgan 011A","W01001106","Total",582,125,78,47,457,15,118,68,101,13,26,116
"2011","The Vale of Glamorgan 011B","W01001107","Total",712,215,140,75,497,19,173,65,117,8,27,88
"2011","The Vale of Glamorgan 011C","W01001109","Total",625,177,115,62,448,19,125,80,97,14,36,77
"2011","The Vale of Glamorgan 011D","W01001110","Total",529,148,66,82,381,19,97,63,103,16,29,54
"2011","The Vale of Glamorgan 011E","W01001111","Total",594,142,73,69,452,51,101,66,88,23,32,91
"2011","The Vale of Glamorgan 011F","W01001112","Total",595,141,41,100,454,41,69,124,120,14,27,59
"2011","The Vale of Glamorgan 012A","W01001063","Total",711,192,54,138,519,70,62,101,132,24,32,98
"2011","The Vale of Glamorgan 012B","W01001065","Total",642,180,91,89,462,51,66,82,114,22,46,81
"2011","The Vale of Glamorgan 012C","W01001069","Total",686,269,64,205,417,78,51,81,106,20,20,61
"2011","The Vale of Glamorgan 012E","W01001079","Total",695,222,65,157,473,83,54,103,113,21,26,73
"2011","The Vale of Glamorgan 012F","W01001080","Total",648,171,75,96,477,57,56,87,131,19,40,87
"2011","The Vale of Glamorgan 012G","W01001910","Total",734,267,36,231,467,79,27,111,133,18,31,68
"2011","The Vale of Glamorgan 012H","W01001911","Total",508,154,49,105,354,62,42,60,93,22,16,59
"2011","The Vale of Glamorgan 013A","W01001062","Total",544,168,64,104,376,22,66,83,74,15,37,79
"2011","The Vale of Glamorgan 013B","W01001064","Total",640,266,90,176,374,67,59,61,94,13,25,55
"2011","The Vale of Glamorgan 013C","W01001093","Total",788,288,141,147,500,64,76,71,141,24,30,94
"2011","The Vale of Glamorgan 013D","W01001099","Total",600,226,131,95,374,36,62,82,84,19,29,62
"2011","The Vale of Glamorgan 013E","W01001101","Total",694,259,72,187,435,60,58,89,126,20,26,56
"2011","The Vale of Glamorgan 013F","W01001102","Total",668,229,71,158,439,64,49,106,119,19,30,52
"2011","The Vale of Glamorgan 014A","W01001108","Total",728,202,50,152,526,43,70,129,175,23,24,62
"2011","The Vale of Glamorgan 014B","W01001117","Total",585,124,68,56,461,21,105,89,126,10,26,84
"2011","The Vale of Glamorgan 014C","W01001118","Total",959,251,101,150,708,40,117,156,183,29,68,115
"2011","The Vale of Glamorgan 014D","W01001120","Total",589,145,61,84,444,25,88,81,138,9,27,76
"2011","The Vale of Glamorgan 014E","W01001121","Total",644,189,93,96,455,24,111,70,121,21,39,69
"2011","The Vale of Glamorgan 014F","W01001122","Total",802,154,37,117,648,70,42,201,138,51,57,89
"2011","The Vale of Glamorgan 015A","W01001059","Total",614,212,126,86,402,12,103,63,119,9,30,66
"2011","The Vale of Glamorgan 015B","W01001060","Total",659,201,131,70,458,15,139,73,118,9,23,81
"2011","The Vale of Glamorgan 015C","W01001061","Total",926,305,91,214,621,73,83,115,184,25,49,92
"2011","The Vale of Glamorgan 015D","W01001066","Total",688,221,88,133,467,59,61,98,128,17,36,68
"2011","The Vale of Glamorgan 015E","W01001073","Total",1005,450,131,319,555,78,55,98,200,21,34,69
"2011","Cardiff 001A","W01001777","Total",610,145,93,52,465,9,154,75,86,20,36,85
"2011","Cardiff 001B","W01001778","Total",700,98,57,41,602,11,172,106,121,21,61,110
"2011","Cardiff 001C","W01001794","Total",626,186,51,135,440,47,43,101,149,14,23,63
"2011","Cardiff 001D","W01001799","Total",520,165,100,65,355,6,124,58,80,17,30,40
"2011","Cardiff 002A","W01001793","Total",567,125,16,109,442,36,37,109,138,17,33,72
"2011","Cardiff 002B","W01001795","Total",644,179,41,138,465,30,49,126,137,18,31,74
"2011","Cardiff 002C","W01001796","Total",653,186,64,122,467,34,80,88,148,11,30,76
"2011","Cardiff 002D","W01001798","Total",624,188,76,112,436,22,83,95,97,13,37,89
"2011","Cardiff 003A","W01001841","Total",740,133,30,103,607,44,48,155,159,27,60,114
"2011","Cardiff 003B","W01001842","Total",726,172,28,144,554,46,37,166,197,19,29,60
"2011","Cardiff 003C","W01001843","Total",808,145,25,120,663,31,49,204,195,32,49,103
"2011","Cardiff 003D","W01001844","Total",841,213,36,177,628,63,60,153,207,20,56,69
"2011","Cardiff 004A","W01001849","Total",651,162,92,70,489,11,139,79,107,17,43,93
"2011","Cardiff 004B","W01001852","Total",723,169,112,57,554,8,144,118,113,22,50,99
"2011","Cardiff 004C","W01001853","Total",749,257,192,65,492,19,192,72,107,6,29,67
"2011","Cardiff 004D","W01001854","Total",834,358,261,97,476,16,190,80,111,11,16,52
"2011","Cardiff 005A","W01001791","Total",734,257,139,118,477,35,124,69,116,24,36,73
"2011","Cardiff 005B","W01001792","Total",705,254,84,170,451,42,66,78,112,33,42,78
"2011","Cardiff 005C","W01001797","Total",607,166,109,57,441,18,88,79,113,17,25,101
"2011","Cardiff 005D","W01001800","Total",665,235,136,99,430,60,68,79,93,19,41,70
"2011","Cardiff 005F","W01001949","Total",635,264,63,201,371,28,29,101,155,10,14,34
"2011","Cardiff 005G","W01001953","Total",643,219,97,122,424,35,61,95,104,13,27,89
"2011","Cardiff 006A","W01001820","Total",508,147,51,96,361,31,56,86,96,10,26,56
"2011","Cardiff 006C","W01001846","Total",641,116,51,65,525,41,48,161,132,22,37,84
"2011","Cardiff 006D","W01001847","Total",637,118,85,33,519,13,163,73,125,15,29,101
"2011","Cardiff 006E","W01001948","Total",637,110,26,84,527,54,33,164,177,10,33,56
"2011","Cardiff 006F","W01001954","Total",637,187,121,66,450,9,107,96,100,14,34,90
"2011","Cardiff 007A","W01001802","Total",684,213,124,89,471,33,102,62,106,16,41,111
"2011","Cardiff 007B","W01001807","Total",591,155,60,95,436,82,52,74,72,28,45,83
"2011","Cardiff 007C","W01001808","Total",638,175,74,101,463,111,47,83,80,21,42,79
"2011","Cardiff 007D","W01001840","Total",755,219,82,137,536,36,71,89,176,19,40,105
"2011","Cardiff 008A","W01001730","Total",647,193,137,56,454,5,143,68,100,20,37,81
"2011","Cardiff 008B","W01001731","Total",534,102,60,42,432,15,100,95,77,16,48,81
"2011","Cardiff 008C","W01001736","Total",601,169,121,48,432,10,123,82,100,18,27,72
"2011","Cardiff 008D","W01001815","Total",511,94,40,54,417,23,61,83,112,16,40,82
"2011","Cardiff 009A","W01001811","Total",540,120,27,93,420,83,47,75,88,34,37,56
"2011","Cardiff 009B","W01001816","Total",1065,320,32,288,745,118,50,187,229,30,54,77
"2011","Cardiff 009C","W01001817","Total",553,136,62,74,417,38,55,74,103,14,41,92
"2011","Cardiff 009D","W01001818","Total",625,186,46,140,439,48,46,96,126,23,30,70
"2011","Cardiff 010A","W01001888","Total",694,186,65,121,508,37,75,110,143,24,38,81
"2011","Cardiff 010B","W01001893","Total",793,242,89,153,551,48,71,118,148,13,47,106
"2011","Cardiff 010C","W01001894","Total",651,172,94,78,479,14,105,108,100,16,37,99
"2011","Cardiff 010D","W01001895","Total",851,469,201,268,382,37,77,84,104,14,16,50
"2011","Cardiff 011A","W01001877","Total",721,186,52,134,535,35,64,122,178,14,34,88
"2011","Cardiff 011B","W01001878","Total",630,185,40,145,445,52,45,93,137,18,29,71
"2011","Cardiff 011C","W01001882","Total",739,173,44,129,566,72,43,133,192,18,41,67
"2011","Cardiff 011D","W01001885","Total",786,210,43,167,576,86,49,134,141,42,47,77
"2011","Cardiff 012A","W01001773","Total",991,263,98,165,728,37,105,190,182,39,53,122
"2011","Cardiff 012B","W01001848","Total",618,160,99,61,458,19,100,116,124,11,18,70
"2011","Cardiff 012C","W01001850","Total",790,188,126,62,602,9,171,123,123,23,42,111
"2011","Cardiff 012D","W01001851","Total",697,271,136,135,426,14,127,82,95,17,22,69
"2011","Cardiff 013A","W01001879","Total",817,280,105,175,537,97,63,128,122,29,42,56
"2011","Cardiff 013B","W01001880","Total",573,130,20,110,443,112,24,99,94,32,35,47
"2011","Cardiff 013C","W01001881","Total",645,229,78,151,416,67,50,73,120,13,29,64
"2011","Cardiff 013D","W01001884","Total",527,117,16,101,410,151,15,65,76,29,31,43
"2011","Cardiff 014A","W01001727","Total",462,112,46,66,350,19,73,64,92,10,27,65
"2011","Cardiff 014B","W01001728","Total",582,110,45,65,472,23,107,104,103,16,30,89
"2011","Cardiff 014C","W01001729","Total",808,141,42,99,667,48,84,157,176,25,52,125
"2011","Cardiff 014D","W01001819","Total",912,184,76,108,728,27,162,150,176,18,56,139
"2011","Cardiff 015A","W01001803","Total",712,280,163,117,432,49,75,62,93,16,40,97
"2011","Cardiff 015B","W01001804","Total",643,194,80,114,449,54,74,69,101,21,46,84
"2011","Cardiff 015C","W01001805","Total",645,233,75,158,412,68,52,73,88,17,28,86
"2011","Cardiff 015D","W01001806","Total",799,322,140,182,477,35,130,70,106,12,32,92
"2011","Cardiff 016A","W01001866","Total",606,219,115,104,387,40,70,66,81,11,42,77
"2011","Cardiff 016B","W01001867","Total",545,143,60,83,402,72,51,55,76,34,44,70
"2011","Cardiff 016C","W01001883","Total",675,246,72,174,429,65,82,58,68,23,55,78
"2011","Cardiff 016D","W01001886","Total",516,174,40,134,342,70,46,59,58,15,28,66
"2011","Cardiff 017A","W01001809","Total",538,159,52,107,379,19,66,71,88,15,37,83
"2011","Cardiff 017B","W01001810","Total",635,165,43,122,470,59,59,95,108,32,48,69
"2011","Cardiff 017C","W01001812","Total",484,98,41,57,386,52,63,61,72,15,47,76
"2011","Cardiff 017D","W01001813","Total",698,299,84,215,399,64,54,83,71,20,36,71
"2011","Cardiff 017E","W01001814","Total",672,260,68,192,412,39,73,79,115,14,26,66
"2011","Cardiff 018A","W01001769","Total",617,130,88,42,487,8,88,119,113,16,38,105
"2011","Cardiff 018B","W01001770","Total",476,193,102,91,283,5,70,48,77,6,19,58
"2011","Cardiff 018C","W01001771","Total",688,171,75,96,517,19,104,122,150,13,38,71
"2011","Cardiff 018D","W01001774","Total",541,113,70,43,428,2,91,115,102,17,26,75
"2011","Cardiff 019A","W01001732","Total",667,187,109,78,480,18,116,98,110,17,41,80
"2011","Cardiff 019B","W01001733","Total",586,205,109,96,381,19,89,52,85,18,39,79
"2011","Cardiff 019C","W01001734","Total",592,139,85,54,453,7,115,91,94,19,43,84
"2011","Cardiff 019D","W01001735","Total",608,155,101,54,453,23,94,95,86,15,41,99
"2011","Cardiff 020A","W01001887","Total",613,150,73,77,463,6,96,108,94,21,38,100
"2011","Cardiff 020B","W01001889","Total",747,297,144,153,450,28,115,77,119,11,23,77
"2011","Cardiff 020C","W01001891","Total",762,284,153,131,478,34,114,85,102,18,28,97
"2011","Cardiff 020D","W01001892","Total",599,164,107,57,435,13,115,70,86,11,39,101
"2011","Cardiff 020E","W01001896","Total",628,166,99,67,462,10,93,118,113,11,33,84
"2011","Cardiff 021A","W01001772","Total",603,157,102,55,446,14,129,95,95,8,27,78
"2011","Cardiff 021B","W01001775","Total",693,226,75,151,467,18,67,105,135,13,34,95
"2011","Cardiff 021C","W01001776","Total",515,116,66,50,399,8,71,95,83,14,33,95
"2011","Cardiff 021D","W01001890","Total",608,171,72,99,437,25,88,72,126,13,28,85
"2011","Cardiff 022A","W01001863","Total",637,174,89,85,463,33,74,80,118,15,43,100
"2011","Cardiff 022B","W01001864","Total",623,160,107,53,463,22,106,76,107,12,38,102
"2011","Cardiff 022C","W01001865","Total",515,118,67,51,397,22,58,69,103,12,34,99
"2011","Cardiff 022D","W01001868","Total",609,177,89,88,432,59,71,60,106,18,44,74
"2011","Cardiff 023A","W01001785","Total",482,146,77,69,336,47,50,59,74,18,35,53
"2011","Cardiff 023B","W01001786","Total",628,157,75,82,471,46,69,86,133,21,35,81
"2011","Cardiff 023C","W01001787","Total",556,127,46,81,429,39,66,62,105,15,50,92
"2011","Cardiff 023D","W01001788","Total",608,236,79,157,372,35,61,67,78,19,47,65
"2011","Cardiff 023E","W01001789","Total",730,270,81,189,460,41,59,94,176,13,26,51
"2011","Cardiff 023F","W01001790","Total",500,152,84,68,348,39,58,64,74,12,27,74
"2011","Cardiff 024A","W01001821","Total",548,234,142,92,314,12,75,49,92,17,27,42
"2011","Cardiff 024B","W01001826","Total",561,133,88,45,428,14,131,55,97,13,38,80
"2011","Cardiff 024C","W01001827","Total",619,134,76,58,485,20,124,83,106,23,48,81
"2011","Cardiff 024D","W01001828","Total",637,153,106,47,484,6,123,60,132,13,47,103
"2011","Cardiff 025A","W01001755","Total",536,124,35,89,412,10,30,60,117,13,16,166
"2011","Cardiff 025B","W01001756","Total",667,197,63,134,470,30,50,73,119,21,32,145
"2011","Cardiff 025C","W01001757","Total",571,168,58,110,403,17,28,72,110,20,34,122
"2011","Cardiff 025D","W01001758","Total",652,160,55,105,492,12,39,46,138,12,29,216
"2011","Cardiff 026A","W01001779","Total",653,222,106,116,431,16,105,77,105,10,25,93
"2011","Cardiff 026B","W01001780","Total",628,196,90,106,432,19,71,85,147,12,25,73
"2011","Cardiff 026C","W01001781","Total",829,372,165,207,457,17,94,96,139,19,34,58
"2011","Cardiff 026D","W01001782","Total",591,158,74,84,433,16,94,83,106,18,24,92
"2011","Cardiff 026E","W01001783","Total",508,129,52,77,379,18,51,91,99,12,32,76
"2011","Cardiff 026F","W01001784","Total",585,192,72,120,393,15,80,73,87,12,26,100
"2011","Cardiff 027A","W01001747","Total",812,336,109,227,476,37,74,94,164,12,24,71
"2011","Cardiff 027B","W01001748","Total",650,212,107,105,438,58,63,84,95,19,36,83
"2011","Cardiff 027C","W01001749","Total",699,270,127,143,429,48,78,77,108,13,29,76
"2011","Cardiff 027D","W01001751","Total",802,345,83,262,457,111,61,66,98,15,32,74
"2011","Cardiff 028A","W01001718","Total",577,152,33,119,425,15,13,37,95,9,14,242
"2011","Cardiff 028B","W01001719","Total",534,116,47,69,418,7,48,41,92,10,18,202
"2011","Cardiff 028C","W01001720","Total",590,133,33,100,457,7,21,17,107,6,12,287
"2011","Cardiff 028D","W01001722","Total",514,134,30,104,380,10,11,22,73,3,11,250
"2011","Cardiff 028E","W01001726","Total",524,117,25,92,407,6,17,18,92,4,22,248
"2011","Cardiff 029A","W01001822","Total",739,246,101,145,493,30,90,81,159,20,24,89
"2011","Cardiff 029B","W01001823","Total",521,139,49,90,382,14,44,108,94,14,29,79
"2011","Cardiff 029C","W01001824","Total",693,293,45,248,400,13,29,66,150,14,29,99
"2011","Cardiff 029D","W01001825","Total",774,274,69,205,500,35,58,107,182,15,31,72
"2011","Cardiff 030A","W01001831","Total",620,179,36,143,441,22,20,54,150,6,18,171
"2011","Cardiff 030B","W01001836","Total",580,177,17,160,403,23,20,54,138,13,48,107
"2011","Cardiff 030C","W01001837","Total",510,187,36,151,323,18,25,25,70,5,16,164
"2011","Cardiff 030D","W01001838","Total",640,164,34,130,476,14,22,55,141,20,32,192
"2011","Cardiff 030E","W01001839","Total",613,180,50,130,433,18,25,41,128,10,22,189
"2011","Cardiff 031A","W01001750","Total",841,432,217,215,409,50,81,61,94,12,27,84
"2011","Cardiff 031B","W01001752","Total",673,167,94,73,506,27,103,89,129,15,36,107
"2011","Cardiff 031C","W01001753","Total",642,173,41,132,469,74,69,86,90,28,48,74
"2011","Cardiff 031D","W01001754","Total",829,350,170,180,479,29,97,88,135,11,47,72
"2011","Cardiff 032A","W01001721","Total",594,239,65,174,355,16,29,12,106,5,9,178
"2011","Cardiff 032C","W01001724","Total",549,89,21,68,460,9,20,12,75,1,4,339
"2011","Cardiff 032D","W01001725","Total",589,150,10,140,439,8,13,13,72,5,6,322
"2011","Cardiff 032E","W01001922","Total",424,123,10,113,301,13,8,7,57,1,6,209
"2011","Cardiff 032F","W01001939","Total",627,358,22,336,269,1,11,41,175,4,3,34
"2011","Cardiff 032G","W01001941","Total",670,364,7,357,306,2,3,33,222,8,0,38
"2011","Cardiff 033A","W01001829","Total",663,201,27,174,462,13,24,45,142,9,27,202
"2011","Cardiff 033B","W01001830","Total",883,458,21,437,425,26,15,37,239,6,16,86
"2011","Cardiff 033C","W01001832","Total",741,278,13,265,463,14,11,15,239,2,4,178
"2011","Cardiff 033D","W01001833","Total",716,280,49,231,436,40,39,84,155,8,26,84
"2011","Cardiff 033E","W01001834","Total",691,240,47,193,451,25,41,52,133,10,24,166
"2011","Cardiff 033F","W01001835","Total",908,580,140,440,328,13,36,32,152,4,9,82
"2011","Cardiff 034A","W01001858","Total",869,412,94,318,457,20,45,79,215,8,20,70
"2011","Cardiff 034B","W01001859","Total",722,332,58,274,390,25,28,63,187,14,12,61
"2011","Cardiff 034C","W01001860","Total",799,296,78,218,503,22,55,91,214,13,31,77
"2011","Cardiff 034D","W01001861","Total",757,294,43,251,463,10,28,86,219,20,25,75
"2011","Cardiff 035A","W01001714","Total",612,174,75,99,438,13,79,109,95,24,34,84
"2011","Cardiff 035B","W01001715","Total",765,330,102,228,435,17,47,83,177,14,25,72
"2011","Cardiff 035C","W01001716","Total",543,159,61,98,384,30,59,97,99,12,14,73
"2011","Cardiff 035D","W01001717","Total",768,304,98,206,464,42,60,76,169,12,25,80
"2011","Cardiff 036A","W01001694","Total",878,375,61,314,503,54,29,95,167,29,46,83
"2011","Cardiff 036B","W01001695","Total",845,433,48,385,412,64,18,66,165,20,23,56
"2011","Cardiff 036C","W01001696","Total",683,261,61,200,422,75,36,48,131,17,34,81
"2011","Cardiff 036D","W01001697","Total",762,315,76,239,447,25,43,67,164,16,32,100
"2011","Cardiff 036E","W01001698","Total",896,408,25,383,488,40,28,67,208,17,32,96
"2011","Cardiff 037A","W01001870","Total",580,168,54,114,412,38,39,76,136,13,30,80
"2011","Cardiff 037B","W01001871","Total",679,233,89,144,446,86,46,79,107,29,37,62
"2011","Cardiff 037C","W01001875","Total",1140,374,46,328,766,124,31,167,249,42,46,107
"2011","Cardiff 037D","W01001876","Total",678,244,96,148,434,88,55,83,93,21,27,67
"2011","Cardiff 038A","W01001869","Total",623,223,66,157,400,40,46,61,142,6,28,77
"2011","Cardiff 038B","W01001872","Total",662,242,85,157,420,41,47,65,114,13,46,94
"2011","Cardiff 038C","W01001873","Total",778,310,82,228,468,56,45,89,150,15,37,76
"2011","Cardiff 038D","W01001874","Total",723,364,82,282,359,82,26,70,94,16,23,48
"2011","Cardiff 039A","W01001737","Total",653,225,93,132,428,87,47,66,76,29,53,70
"2011","Cardiff 039B","W01001738","Total",525,114,39,75,411,106,46,73,72,37,27,50
"2011","Cardiff 039C","W01001739","Total",523,119,30,89,404,99,43,69,68,29,30,66
"2011","Cardiff 039D","W01001740","Total",682,249,102,147,433,98,64,65,79,14,36,77
"2011","Cardiff 039E","W01001741","Total",613,136,47,89,477,162,39,85,63,25,36,67
"2011","Cardiff 040A","W01001709","Total",721,190,51,139,531,40,44,99,158,27,42,121
"2011","Cardiff 040B","W01001710","Total",701,245,56,189,456,27,67,95,137,11,34,85
"2011","Cardiff 040C","W01001711","Total",720,248,107,141,472,59,86,72,121,23,31,80
"2011","Cardiff 040D","W01001712","Total",679,273,69,204,406,25,36,74,162,13,17,79
"2011","Cardiff 040E","W01001713","Total",745,254,65,189,491,32,47,92,181,17,36,86
"2011","Cardiff 041A","W01001704","Total",631,209,94,115,422,89,51,69,86,24,41,62
"2011","Cardiff 041B","W01001706","Total",540,183,63,120,357,43,75,50,76,11,32,70
"2011","Cardiff 041C","W01001707","Total",803,227,84,143,576,114,71,84,119,40,52,96
"2011","Cardiff 041D","W01001746","Total",663,217,66,151,446,79,60,86,127,14,27,53
"2011","Cardiff 042A","W01001855","Total",685,229,51,178,456,43,45,77,116,34,65,76
"2011","Cardiff 042B","W01001856","Total",776,379,48,331,397,9,18,52,149,22,70,77
"2011","Cardiff 042C","W01001857","Total",843,389,118,271,454,49,56,69,138,38,38,66
"2011","Cardiff 042D","W01001862","Total",707,307,47,260,400,22,30,56,114,26,58,94
"2011","Cardiff 043A","W01001742","Total",640,192,69,123,448,133,59,78,81,17,34,46
"2011","Cardiff 043B","W01001743","Total",605,158,65,93,447,24,105,74,111,14,30,89
"2011","Cardiff 043C","W01001744","Total",740,288,147,141,452,103,67,77,100,10,27,68
"2011","Cardiff 043D","W01001745","Total",556,150,67,83,406,27,91,78,91,16,36,67
"2011","Cardiff 044A","W01001764","Total",603,179,50,129,424,48,30,68,88,41,60,89
"2011","Cardiff 044B","W01001765","Total",521,172,42,130,349,29,41,63,71,27,59,59
"2011","Cardiff 044C","W01001766","Total",685,245,67,178,440,66,50,76,98,43,43,64
"2011","Cardiff 044D","W01001767","Total",691,224,59,165,467,64,33,87,166,19,37,61
"2011","Cardiff 044E","W01001768","Total",539,156,30,126,383,33,34,66,72,49,69,60
"2011","Cardiff 045A","W01001702","Total",745,207,65,142,538,64,59,107,137,23,60,88
"2011","Cardiff 045B","W01001703","Total",503,134,42,92,369,60,44,64,82,17,38,64
"2011","Cardiff 045C","W01001705","Total",718,209,56,153,509,88,70,86,125,21,40,79
"2011","Cardiff 045D","W01001708","Total",737,337,69,268,400,83,47,64,99,14,36,57
"2011","Cardiff 046A","W01001759","Total",674,212,48,164,462,35,61,81,157,21,37,70
"2011","Cardiff 046B","W01001760","Total",670,206,73,133,464,34,69,85,113,20,57,86
"2011","Cardiff 046C","W01001761","Total",724,284,76,208,440,47,60,76,99,27,53,78
"2011","Cardiff 046D","W01001762","Total",736,303,60,243,433,50,33,73,111,33,52,81
"2011","Cardiff 048A","W01001940","Total",728,416,14,402,312,5,14,42,236,1,0,14
"2011","Cardiff 048B","W01001943","Total",635,304,21,283,331,12,10,33,245,4,9,18
"2011","Cardiff 048C","W01001944","Total",580,236,6,230,344,10,7,27,277,4,8,11
"2011","Cardiff 048D","W01001945","Total",838,453,11,442,385,11,9,36,301,0,2,26
"2011","Cardiff 048E","W01001947","Total",873,416,14,402,457,22,12,76,300,5,4,38
"2011","Cardiff 049A","W01001699","Total",1000,500,144,356,500,37,52,51,183,47,65,65
"2011","Cardiff 049B","W01001942","Total",647,307,50,257,340,22,33,44,144,13,28,56
"2011","Cardiff 049C","W01001946","Total",707,356,67,289,351,44,27,53,147,12,20,48
"2011","Cardiff 049D","W01001950","Total",609,268,36,232,341,2,23,48,224,4,6,34
"2011","Cardiff 049E","W01001951","Total",548,230,11,219,318,17,6,37,204,5,6,43
"2011","Cardiff 049F","W01001952","Total",621,270,27,243,351,21,11,29,248,5,13,24
"2011","Rhondda Cynon Taf 001A","W01001186","Total",685,125,48,77,560,46,82,136,158,17,42,79
"2011","Rhondda Cynon Taf 001B","W01001187","Total",574,149,62,87,425,28,84,67,114,15,26,91
"2011","Rhondda Cynon Taf 001C","W01001188","Total",497,188,103,85,309,37,69,43,72,8,19,61
"2011","Rhondda Cynon Taf 001D","W01001221","Total",602,160,80,80,442,63,88,60,91,27,31,82
"2011","Rhondda Cynon Taf 001E","W01001222","Total",649,209,96,113,440,78,53,71,87,25,37,89
"2011","Rhondda Cynon Taf 001F","W01001233","Total",735,205,110,95,530,33,128,76,141,10,45,97
"2011","Rhondda Cynon Taf 002A","W01001148","Total",750,261,122,139,489,52,84,109,120,11,38,75
"2011","Rhondda Cynon Taf 002B","W01001152","Total",671,170,87,83,501,42,130,82,114,13,32,88
"2011","Rhondda Cynon Taf 002C","W01001153","Total",636,195,86,109,441,59,87,86,89,12,26,82
"2011","Rhondda Cynon Taf 002D","W01001155","Total",665,234,103,131,431,47,87,67,114,6,30,80
"2011","Rhondda Cynon Taf 003A","W01001149","Total",619,194,100,94,425,40,69,66,107,14,32,97
"2011","Rhondda Cynon Taf 003B","W01001150","Total",797,321,112,209,476,61,84,78,149,12,30,62
"2011","Rhondda Cynon Taf 003C","W01001151","Total",713,188,112,76,525,15,160,95,118,12,32,93
"2011","Rhondda Cynon Taf 003D","W01001154","Total",678,268,105,163,410,64,84,64,93,10,19,76
"2011","Rhondda Cynon Taf 003E","W01001156","Total",549,75,25,50,474,16,47,131,111,16,41,112
"2011","Rhondda Cynon Taf 004A","W01001147","Total",792,265,133,132,527,40,111,102,125,13,30,106
"2011","Rhondda Cynon Taf 004B","W01001168","Total",638,197,111,86,441,37,106,73,105,17,29,74
"2011","Rhondda Cynon Taf 004C","W01001169","Total",761,267,78,189,494,72,63,98,122,25,35,79
"2011","Rhondda Cynon Taf 004D","W01001170","Total",527,139,74,65,388,13,105,66,95,7,31,71
"2011","Rhondda Cynon Taf 005A","W01001137","Total",1064,349,142,207,715,76,128,130,199,18,46,118
"2011","Rhondda Cynon Taf 005B","W01001138","Total",636,246,103,143,390,59,58,73,92,14,30,64
"2011","Rhondda Cynon Taf 005C","W01001139","Total",611,175,77,98,436,35,71,108,89,9,36,88
"2011","Rhondda Cynon Taf 005D","W01001140","Total",637,208,86,122,429,52,89,71,97,9,33,78
"2011","Rhondda Cynon Taf 005E","W01001141","Total",677,218,93,125,459,61,86,86,85,13,37,91
"2011","Rhondda Cynon Taf 005F","W01001142","Total",704,254,116,138,450,59,82,77,96,17,47,72
"2011","Rhondda Cynon Taf 006A","W01001204","Total",584,177,72,105,407,53,69,81,106,10,19,69
"2011","Rhondda Cynon Taf 006B","W01001205","Total",728,245,120,125,483,56,97,69,135,9,35,82
"2011","Rhondda Cynon Taf 006C","W01001206","Total",635,225,120,105,410,36,84,68,90,14,36,82
"2011","Rhondda Cynon Taf 006D","W01001207","Total",585,180,57,123,405,49,64,67,96,17,27,85
"2011","Rhondda Cynon Taf 006E","W01001208","Total",750,285,121,164,465,61,104,74,101,13,32,80
"2011","Rhondda Cynon Taf 007A","W01001265","Total",667,228,112,116,439,40,83,71,95,15,42,93
"2011","Rhondda Cynon Taf 007B","W01001266","Total",636,264,121,143,372,51,75,66,92,7,27,54
"2011","Rhondda Cynon Taf 007C","W01001267","Total",634,206,106,100,428,34,92,64,109,17,32,80
"2011","Rhondda Cynon Taf 007D","W01001268","Total",636,217,108,109,419,54,85,56,89,12,37,86
"2011","Rhondda Cynon Taf 008A","W01001209","Total",567,165,61,104,402,63,59,68,83,19,45,65
"2011","Rhondda Cynon Taf 008B","W01001210","Total",625,184,110,74,441,57,78,68,100,13,27,98
"2011","Rhondda Cynon Taf 008C","W01001211","Total",650,184,81,103,466,46,81,90,110,16,39,84
"2011","Rhondda Cynon Taf 008D","W01001212","Total",585,183,79,104,402,56,59,68,92,14,33,80
"2011","Rhondda Cynon Taf 009A","W01001175","Total",620,204,117,87,416,31,77,81,103,12,28,84
"2011","Rhondda Cynon Taf 009B","W01001177","Total",587,208,83,125,379,42,66,74,91,4,27,75
"2011","Rhondda Cynon Taf 009C","W01001202","Total",839,317,150,167,522,74,103,83,126,13,30,93
"2011","Rhondda Cynon Taf 009D","W01001203","Total",594,176,75,101,418,60,76,64,92,16,24,86
"2011","Rhondda Cynon Taf 010A","W01001269","Total",626,221,113,108,405,35,97,59,78,13,33,90
"2011","Rhondda Cynon Taf 010B","W01001270","Total",622,211,101,110,411,31,90,62,97,11,27,93
"2011","Rhondda Cynon Taf 010C","W01001271","Total",724,248,100,148,476,67,68,64,139,19,42,77
"2011","Rhondda Cynon Taf 010D","W01001272","Total",632,166,81,85,466,56,99,84,76,16,35,100
"2011","Rhondda Cynon Taf 010E","W01001273","Total",758,251,137,114,507,47,110,68,128,14,33,107
"2011","Rhondda Cynon Taf 011A","W01001213","Total",618,209,111,98,409,49,90,71,102,10,29,58
"2011","Rhondda Cynon Taf 011B","W01001214","Total",531,121,71,50,410,24,84,67,97,16,27,95
"2011","Rhondda Cynon Taf 011C","W01001215","Total",519,243,88,155,276,24,60,50,65,12,17,48
"2011","Rhondda Cynon Taf 011D","W01001216","Total",654,200,81,119,454,46,75,80,114,10,34,95
"2011","Rhondda Cynon Taf 012A","W01001143","Total",633,146,74,72,487,40,86,94,106,14,33,114
"2011","Rhondda Cynon Taf 012B","W01001144","Total",668,191,75,116,477,70,64,76,120,31,34,82
"2011","Rhondda Cynon Taf 012C","W01001145","Total",753,232,112,120,521,58,79,104,126,19,42,93
"2011","Rhondda Cynon Taf 012D","W01001146","Total",640,217,102,115,423,40,73,79,116,14,25,76
"2011","Rhondda Cynon Taf 013A","W01001176","Total",620,174,72,102,446,41,91,99,91,9,30,85
"2011","Rhondda Cynon Taf 013B","W01001274","Total",577,208,61,147,369,81,56,56,65,15,31,65
"2011","Rhondda Cynon Taf 013C","W01001275","Total",792,254,121,133,538,80,103,77,127,26,34,91
"2011","Rhondda Cynon Taf 013D","W01001276","Total",668,280,99,181,388,46,75,59,95,9,35,69
"2011","Rhondda Cynon Taf 014A","W01001200","Total",420,117,61,56,303,28,53,49,69,9,27,68
"2011","Rhondda Cynon Taf 014B","W01001201","Total",537,200,98,102,337,30,67,55,71,15,35,64
"2011","Rhondda Cynon Taf 014C","W01001260","Total",476,146,70,76,330,49,59,55,81,9,20,57
"2011","Rhondda Cynon Taf 014D","W01001285","Total",605,206,103,103,399,20,82,64,107,5,39,82
"2011","Rhondda Cynon Taf 014E","W01001286","Total",643,170,88,82,473,49,94,65,121,12,38,94
"2011","Rhondda Cynon Taf 014F","W01001287","Total",623,183,79,104,440,35,84,71,106,14,40,90
"2011","Rhondda Cynon Taf 014G","W01001288","Total",640,228,90,138,412,51,60,61,109,9,38,84
"2011","Rhondda Cynon Taf 015A","W01001180","Total",648,218,73,145,430,69,53,81,106,18,28,75
"2011","Rhondda Cynon Taf 015B","W01001181","Total",606,184,76,108,422,36,67,80,114,8,35,82
"2011","Rhondda Cynon Taf 015C","W01001282","Total",867,274,141,133,593,69,111,109,127,21,41,115
"2011","Rhondda Cynon Taf 015D","W01001283","Total",639,177,91,86,462,35,97,77,109,11,38,95
"2011","Rhondda Cynon Taf 015E","W01001284","Total",423,76,31,45,347,20,32,93,75,17,34,76
"2011","Rhondda Cynon Taf 016A","W01001166","Total",553,176,75,101,377,39,67,62,77,14,33,85
"2011","Rhondda Cynon Taf 016B","W01001167","Total",632,179,88,91,453,66,94,72,98,17,31,75
"2011","Rhondda Cynon Taf 016C","W01001247","Total",755,257,132,125,498,44,94,109,114,14,33,90
"2011","Rhondda Cynon Taf 016D","W01001248","Total",864,250,108,142,614,59,102,127,143,17,43,123
"2011","Rhondda Cynon Taf 017A","W01001171","Total",581,197,90,107,384,35,75,63,104,6,22,79
"2011","Rhondda Cynon Taf 017B","W01001229","Total",648,226,93,133,422,39,65,77,104,13,28,96
"2011","Rhondda Cynon Taf 017C","W01001230","Total",612,152,77,75,460,30,88,103,107,10,38,84
"2011","Rhondda Cynon Taf 017D","W01001231","Total",696,245,101,144,451,57,82,76,94,10,36,96
"2011","Rhondda Cynon Taf 017E","W01001280","Total",752,290,123,167,462,50,94,83,95,13,29,98
"2011","Rhondda Cynon Taf 017F","W01001281","Total",741,223,99,124,518,44,126,88,120,18,29,93
"2011","Rhondda Cynon Taf 018A","W01001217","Total",483,138,65,73,345,32,47,62,73,18,34,79
"2011","Rhondda Cynon Taf 018B","W01001218","Total",643,184,77,107,459,46,66,86,113,8,38,102
"2011","Rhondda Cynon Taf 018C","W01001219","Total",624,266,146,120,358,55,52,61,85,4,26,75
"2011","Rhondda Cynon Taf 018D","W01001220","Total",623,173,90,83,450,49,83,78,101,17,36,86
"2011","Rhondda Cynon Taf 018E","W01001259","Total",684,186,109,77,498,42,92,102,113,16,41,92
"2011","Rhondda Cynon Taf 018F","W01001261","Total",541,157,69,88,384,29,77,72,88,8,21,89
"2011","Rhondda Cynon Taf 019A","W01001164","Total",656,186,66,120,470,57,78,93,114,19,33,76
"2011","Rhondda Cynon Taf 019B","W01001165","Total",554,147,63,84,407,46,57,76,112,13,24,79
"2011","Rhondda Cynon Taf 019C","W01001256","Total",522,153,62,91,369,37,67,62,110,13,20,60
"2011","Rhondda Cynon Taf 019D","W01001257","Total",520,129,57,72,391,23,90,59,98,7,28,86
"2011","Rhondda Cynon Taf 019E","W01001258","Total",636,278,111,167,358,33,69,70,104,10,21,51
"2011","Rhondda Cynon Taf 020A","W01001172","Total",642,204,99,105,438,48,77,76,100,18,36,83
"2011","Rhondda Cynon Taf 020B","W01001173","Total",612,208,78,130,404,50,82,49,83,12,42,86
"2011","Rhondda Cynon Taf 020C","W01001174","Total",624,203,90,113,421,76,69,70,92,17,21,76
"2011","Rhondda Cynon Taf 020D","W01001232","Total",609,206,66,140,403,32,66,69,108,8,35,85
"2011","Rhondda Cynon Taf 021A","W01001182","Total",594,156,60,96,438,42,64,85,110,21,33,83
"2011","Rhondda Cynon Taf 021B","W01001183","Total",500,229,84,145,271,27,25,46,94,8,11,60
"2011","Rhondda Cynon Taf 021C","W01001227","Total",543,121,54,67,422,24,92,71,107,13,27,88
"2011","Rhondda Cynon Taf 021D","W01001228","Total",662,208,114,94,454,14,118,71,121,11,37,82
"2011","Rhondda Cynon Taf 021E","W01001234","Total",632,176,71,105,456,30,82,82,137,10,27,88
"2011","Rhondda Cynon Taf 021F","W01001235","Total",718,256,130,126,462,55,79,85,121,20,29,73
"2011","Rhondda Cynon Taf 021G","W01001236","Total",645,180,99,81,465,43,103,97,105,15,21,81
"2011","Rhondda Cynon Taf 022A","W01001185","Total",762,283,122,161,479,58,90,84,120,12,33,82
"2011","Rhondda Cynon Taf 022B","W01001237","Total",633,215,123,92,418,43,76,77,89,16,36,81
"2011","Rhondda Cynon Taf 022C","W01001238","Total",672,190,53,137,482,115,58,67,85,25,48,84
"2011","Rhondda Cynon Taf 022D","W01001262","Total",546,156,44,112,390,33,40,48,122,9,20,118
"2011","Rhondda Cynon Taf 022E","W01001263","Total",600,134,55,79,466,19,45,29,90,10,21,252
"2011","Rhondda Cynon Taf 022F","W01001264","Total",519,138,43,95,381,10,36,36,88,6,12,193
"2011","Rhondda Cynon Taf 023A","W01001178","Total",723,226,108,118,497,47,80,90,111,18,52,99
"2011","Rhondda Cynon Taf 023B","W01001179","Total",728,203,97,106,525,81,85,77,117,7,52,106
"2011","Rhondda Cynon Taf 023C","W01001253","Total",596,175,73,102,421,47,65,85,95,13,35,81
"2011","Rhondda Cynon Taf 023E","W01001255","Total",691,198,80,118,493,68,74,80,134,21,40,76
"2011","Rhondda Cynon Taf 023F","W01001914","Total",577,55,12,43,522,23,35,194,99,23,48,100
"2011","Rhondda Cynon Taf 023G","W01001917","Total",606,156,93,63,450,39,88,78,95,20,38,92
"2011","Rhondda Cynon Taf 024A","W01001249","Total",645,228,114,114,417,38,80,59,111,9,29,91
"2011","Rhondda Cynon Taf 024B","W01001250","Total",562,121,68,53,441,25,104,62,97,15,41,97
"2011","Rhondda Cynon Taf 024C","W01001251","Total",675,203,78,125,472,92,64,85,114,19,29,69
"2011","Rhondda Cynon Taf 024D","W01001252","Total",619,137,56,81,482,28,74,99,137,9,41,94
"2011","Rhondda Cynon Taf 025A","W01001162","Total",763,266,104,162,497,70,85,97,113,18,36,78
"2011","Rhondda Cynon Taf 025B","W01001244","Total",612,161,106,55,451,13,157,57,105,9,23,87
"2011","Rhondda Cynon Taf 025C","W01001245","Total",518,92,52,40,426,15,106,62,114,14,26,89
"2011","Rhondda Cynon Taf 025D","W01001246","Total",625,177,108,69,448,28,141,61,109,12,21,76
"2011","Rhondda Cynon Taf 026A","W01001184","Total",864,265,137,128,599,33,142,90,163,16,43,112
"2011","Rhondda Cynon Taf 026B","W01001239","Total",633,225,102,123,408,62,76,62,98,15,29,66
"2011","Rhondda Cynon Taf 026C","W01001240","Total",845,268,72,196,577,35,102,109,189,8,43,91
"2011","Rhondda Cynon Taf 026D","W01001241","Total",756,240,82,158,516,38,90,93,156,17,43,79
"2011","Rhondda Cynon Taf 027B","W01001196","Total",630,129,30,99,501,45,64,96,156,13,37,90
"2011","Rhondda Cynon Taf 027C","W01001197","Total",481,81,49,32,400,5,92,81,96,15,24,87
"2011","Rhondda Cynon Taf 027D","W01001198","Total",662,156,49,107,506,32,76,106,173,13,27,79
"2011","Rhondda Cynon Taf 027E","W01001199","Total",694,139,58,81,555,36,95,122,166,18,39,79
"2011","Rhondda Cynon Taf 027F","W01001915","Total",609,109,38,71,500,22,39,173,103,34,43,86
"2011","Rhondda Cynon Taf 027G","W01001916","Total",547,85,6,79,462,34,31,159,121,16,37,64
"2011","Rhondda Cynon Taf 028A","W01001157","Total",591,151,51,100,440,33,70,91,131,7,23,85
"2011","Rhondda Cynon Taf 028B","W01001158","Total",614,167,58,109,447,32,71,81,127,14,32,90
"2011","Rhondda Cynon Taf 028C","W01001159","Total",509,124,17,107,385,38,31,93,108,11,35,69
"2011","Rhondda Cynon Taf 028D","W01001277","Total",456,69,22,47,387,17,70,75,106,13,27,79
"2011","Rhondda Cynon Taf 028E","W01001278","Total",464,137,54,83,327,40,56,64,59,22,38,48
"2011","Rhondda Cynon Taf 028F","W01001279","Total",532,172,98,74,360,72,67,43,84,13,22,59
"2011","Rhondda Cynon Taf 029A","W01001160","Total",664,140,67,73,524,25,106,93,165,13,25,97
"2011","Rhondda Cynon Taf 029B","W01001161","Total",898,235,86,149,663,39,80,155,193,29,56,111
"2011","Rhondda Cynon Taf 029C","W01001189","Total",686,186,71,115,500,69,61,112,128,21,27,82
"2011","Rhondda Cynon Taf 029D","W01001190","Total",1018,241,83,158,777,44,113,191,215,24,65,125
"2011","Rhondda Cynon Taf 030A","W01001193","Total",489,111,55,56,378,11,93,72,81,12,26,83
"2011","Rhondda Cynon Taf 030B","W01001194","Total",878,184,61,123,694,30,113,208,198,14,32,99
"2011","Rhondda Cynon Taf 030C","W01001195","Total",685,230,89,141,455,42,82,87,127,14,19,84
"2011","Rhondda Cynon Taf 030D","W01001242","Total",569,158,91,67,411,15,128,78,83,11,21,75
"2011","Rhondda Cynon Taf 030E","W01001243","Total",672,278,121,157,394,58,78,70,104,8,17,59
"2011","Rhondda Cynon Taf 031A","W01001191","Total",1011,229,62,167,782,39,91,228,250,26,46,102
"2011","Rhondda Cynon Taf 031B","W01001192","Total",626,178,85,93,448,58,81,92,95,15,31,76
"2011","Rhondda Cynon Taf 031C","W01001223","Total",702,192,85,107,510,26,143,100,129,12,29,71
"2011","Rhondda Cynon Taf 031D","W01001224","Total",779,133,50,83,646,25,71,246,164,27,40,73
"2011","Rhondda Cynon Taf 031E","W01001225","Total",653,139,57,82,514,13,125,115,147,13,29,72
"2011","Rhondda Cynon Taf 031F","W01001226","Total",722,212,95,117,510,45,76,116,140,30,24,79
"2011","Merthyr Tydfil 002A","W01001295","Total",683,204,109,95,479,77,70,77,110,14,30,101
"2011","Merthyr Tydfil 002B","W01001296","Total",651,119,46,73,532,32,98,83,126,12,52,129
"2011","Merthyr Tydfil 002C","W01001297","Total",775,201,68,133,574,66,64,104,142,19,49,130
"2011","Merthyr Tydfil 002D","W01001298","Total",780,239,112,127,541,74,83,90,145,9,41,99
"2011","Merthyr Tydfil 002E","W01001310","Total",659,166,87,79,493,38,87,89,111,17,30,121
"2011","Merthyr Tydfil 002F","W01001311","Total",500,149,72,77,351,50,46,69,68,6,30,82
"2011","Merthyr Tydfil 003A","W01001291","Total",679,130,41,89,549,40,51,121,160,22,42,113
"2011","Merthyr Tydfil 003B","W01001294","Total",649,101,50,51,548,17,131,92,147,11,45,105
"2011","Merthyr Tydfil 003C","W01001305","Total",517,108,61,47,409,30,88,48,107,10,33,93
"2011","Merthyr Tydfil 003D","W01001306","Total",644,166,82,84,478,26,68,88,138,13,33,112
"2011","Merthyr Tydfil 003E","W01001324","Total",896,292,133,159,604,35,148,93,155,21,38,114
"2011","Merthyr Tydfil 004A","W01001292","Total",692,165,75,90,527,77,57,83,137,21,48,104
"2011","Merthyr Tydfil 004B","W01001293","Total",734,225,129,96,509,52,102,79,140,4,43,89
"2011","Merthyr Tydfil 004C","W01001307","Total",731,333,164,169,398,35,79,54,112,7,31,80
"2011","Merthyr Tydfil 004D","W01001315","Total",809,340,137,203,469,62,82,55,111,7,40,112
"2011","Merthyr Tydfil 005A","W01001314","Total",895,237,110,127,658,54,127,142,147,22,51,115
"2011","Merthyr Tydfil 005B","W01001316","Total",1162,312,102,210,850,50,117,197,217,29,64,176
"2011","Merthyr Tydfil 005C","W01001317","Total",677,188,91,97,489,33,112,71,98,18,29,128
"2011","Merthyr Tydfil 005D","W01001318","Total",646,182,82,100,464,26,96,82,113,13,33,101
"2011","Merthyr Tydfil 006A","W01001289","Total",619,202,97,105,417,22,71,66,126,17,33,82
"2011","Merthyr Tydfil 006B","W01001302","Total",472,137,60,77,335,43,45,48,77,10,28,84
"2011","Merthyr Tydfil 006C","W01001303","Total",506,158,57,101,348,71,42,41,70,10,35,79
"2011","Merthyr Tydfil 006D","W01001304","Total",614,157,78,79,457,42,87,81,88,12,35,112
"2011","Merthyr Tydfil 006E","W01001312","Total",643,222,126,96,421,49,87,62,101,7,44,71
"2011","Merthyr Tydfil 006F","W01001313","Total",658,196,81,115,462,42,81,79,107,9,42,102
"2011","Merthyr Tydfil 007A","W01001290","Total",768,190,86,104,578,64,87,93,140,16,49,129
"2011","Merthyr Tydfil 007B","W01001319","Total",646,117,55,62,529,21,93,97,150,17,35,116
"2011","Merthyr Tydfil 007C","W01001320","Total",603,118,53,65,485,31,79,93,122,13,38,109
"2011","Merthyr Tydfil 007D","W01001321","Total",632,159,78,81,473,61,77,83,99,17,45,91
"2011","Merthyr Tydfil 007E","W01001322","Total",667,186,69,117,481,39,74,94,133,12,37,92
"2011","Merthyr Tydfil 008A","W01001299","Total",686,201,95,106,485,95,61,72,113,22,42,80
"2011","Merthyr Tydfil 008B","W01001300","Total",654,141,63,78,513,76,78,82,88,28,47,114
"2011","Merthyr Tydfil 008C","W01001301","Total",751,169,95,74,582,94,104,112,95,19,42,116
"2011","Merthyr Tydfil 008D","W01001308","Total",445,76,31,45,369,65,45,58,45,16,58,82
"2011","Merthyr Tydfil 008E","W01001309","Total",496,115,60,55,381,58,58,53,67,16,35,94
"2011","Merthyr Tydfil 008F","W01001898","Total",625,158,91,67,467,37,96,71,102,13,39,109
"2011","Caerphilly 001A","W01001374","Total",591,150,72,78,441,37,77,78,93,15,38,103
"2011","Caerphilly 001B","W01001375","Total",685,257,107,150,428,40,69,69,127,11,33,79
"2011","Caerphilly 001C","W01001376","Total",665,214,101,113,451,77,78,69,98,23,29,77
"2011","Caerphilly 001D","W01001406","Total",841,265,99,166,576,47,104,106,137,9,34,139
"2011","Caerphilly 001E","W01001428","Total",543,147,57,90,396,82,57,61,90,15,29,62
"2011","Caerphilly 001F","W01001429","Total",532,172,72,100,360,27,64,74,108,9,18,60
"2011","Caerphilly 002A","W01001360","Total",544,142,63,79,402,24,80,77,91,16,41,73
"2011","Caerphilly 002B","W01001361","Total",497,133,63,70,364,39,58,62,64,15,42,84
"2011","Caerphilly 002C","W01001384","Total",698,198,88,110,500,47,77,114,120,10,31,101
"2011","Caerphilly 002D","W01001385","Total",693,241,105,136,452,55,93,82,100,6,42,74
"2011","Caerphilly 002E","W01001386","Total",719,221,108,113,498,60,81,95,102,32,46,82
"2011","Caerphilly 003A","W01001325","Total",624,149,77,72,475,47,76,90,124,17,41,80
"2011","Caerphilly 003B","W01001326","Total",887,279,115,164,608,91,75,101,148,21,48,124
"2011","Caerphilly 003C","W01001362","Total",921,304,165,139,617,48,136,102,144,14,43,130
"2011","Caerphilly 004A","W01001336","Total",614,162,78,84,452,31,97,73,107,9,35,100
"2011","Caerphilly 004B","W01001337","Total",657,180,85,95,477,44,77,91,123,10,45,87
"2011","Caerphilly 004C","W01001338","Total",774,263,109,154,511,62,71,84,136,17,36,105
"2011","Caerphilly 004D","W01001339","Total",600,171,74,97,429,83,57,72,95,18,25,79
"2011","Caerphilly 005A","W01001334","Total",592,158,57,101,434,53,74,74,81,26,43,83
"2011","Caerphilly 005B","W01001335","Total",517,118,38,80,399,30,76,68,108,16,29,72
"2011","Caerphilly 005C","W01001347","Total",602,159,96,63,443,26,102,78,106,8,37,86
"2011","Caerphilly 005D","W01001351","Total",652,172,72,100,480,10,114,78,135,13,23,107
"2011","Caerphilly 006A","W01001356","Total",485,98,59,39,387,19,90,72,75,13,41,77
"2011","Caerphilly 006B","W01001357","Total",661,162,80,82,499,31,92,90,125,12,43,106
"2011","Caerphilly 006C","W01001358","Total",650,152,94,58,498,77,97,68,120,15,28,93
"2011","Caerphilly 006D","W01001359","Total",650,197,73,124,453,27,78,94,118,13,28,95
"2011","Caerphilly 006E","W01001390","Total",672,111,48,63,561,34,73,142,145,19,45,103
"2011","Caerphilly 006F","W01001391","Total",672,171,103,68,501,39,94,96,119,18,40,95
"2011","Caerphilly 007A","W01001352","Total",754,188,107,81,566,60,87,99,139,16,54,111
"2011","Caerphilly 007B","W01001353","Total",738,258,148,110,480,38,112,56,134,14,33,93
"2011","Caerphilly 007C","W01001387","Total",542,174,74,100,368,30,72,60,82,23,27,74
"2011","Caerphilly 007D","W01001388","Total",723,149,58,91,574,92,79,120,114,22,44,103
"2011","Caerphilly 007E","W01001389","Total",457,116,61,55,341,20,68,87,66,12,24,64
"2011","Caerphilly 008A","W01001414","Total",647,163,54,109,484,53,71,92,127,25,33,83
"2011","Caerphilly 008B","W01001415","Total",719,169,81,88,550,51,85,97,140,26,53,98
"2011","Caerphilly 008C","W01001416","Total",647,181,98,83,466,19,123,73,118,8,32,93
"2011","Caerphilly 008D","W01001417","Total",578,105,31,74,473,36,73,95,119,16,36,98
"2011","Caerphilly 008E","W01001418","Total",623,176,86,90,447,41,82,77,115,15,32,85
"2011","Caerphilly 009A","W01001348","Total",734,192,118,74,542,69,82,115,119,29,38,90
"2011","Caerphilly 009B","W01001349","Total",685,107,38,69,578,28,56,171,121,28,63,111
"2011","Caerphilly 009C","W01001350","Total",766,215,105,110,551,52,109,96,134,10,40,110
"2011","Caerphilly 009D","W01001392","Total",755,179,95,84,576,33,130,121,144,12,27,109
"2011","Caerphilly 010A","W01001380","Total",771,203,113,90,568,45,103,111,155,17,36,101
"2011","Caerphilly 010B","W01001381","Total",624,163,81,82,461,51,70,80,112,22,40,86
"2011","Caerphilly 010C","W01001382","Total",685,197,108,89,488,14,127,83,125,21,28,90
"2011","Caerphilly 010D","W01001383","Total",663,219,93,126,444,48,96,76,106,15,29,74
"2011","Caerphilly 011A","W01001401","Total",848,250,150,100,598,43,128,97,155,15,38,122
"2011","Caerphilly 011B","W01001402","Total",679,156,75,81,523,81,85,92,112,28,33,92
"2011","Caerphilly 011C","W01001403","Total",680,200,70,130,480,29,75,120,129,12,36,79
"2011","Caerphilly 011D","W01001404","Total",584,117,72,45,467,10,129,81,113,11,16,107
"2011","Caerphilly 011E","W01001405","Total",744,199,120,79,545,56,84,115,111,24,45,110
"2011","Caerphilly 012A","W01001363","Total",565,105,49,56,460,39,59,92,117,16,40,97
"2011","Caerphilly 012B","W01001364","Total",689,149,61,88,540,61,62,95,121,45,61,95
"2011","Caerphilly 012C","W01001365","Total",842,218,92,126,624,62,82,110,157,25,67,121
"2011","Caerphilly 012D","W01001369","Total",943,249,130,119,694,34,145,126,180,23,45,141
"2011","Caerphilly 013A","W01001377","Total",672,166,77,89,506,34,129,84,134,9,28,88
"2011","Caerphilly 013B","W01001378","Total",681,228,127,101,453,40,103,79,93,15,35,88
"2011","Caerphilly 013C","W01001379","Total",625,146,68,78,479,30,99,117,121,14,24,74
"2011","Caerphilly 013D","W01001432","Total",952,267,104,163,685,66,97,149,216,18,48,91
"2011","Caerphilly 013E","W01001433","Total",635,214,102,112,421,29,105,79,101,15,21,71
"2011","Caerphilly 013F","W01001434","Total",549,100,52,48,449,19,69,118,120,12,36,75
"2011","Caerphilly 014A","W01001327","Total",947,261,75,186,686,49,100,149,224,18,29,117
"2011","Caerphilly 014B","W01001328","Total",641,159,75,84,482,42,79,98,121,27,36,79
"2011","Caerphilly 014C","W01001329","Total",654,188,91,97,466,47,91,74,108,22,43,81
"2011","Caerphilly 014D","W01001354","Total",706,181,81,100,525,36,84,111,167,17,30,80
"2011","Caerphilly 015A","W01001355","Total",811,343,177,166,468,31,125,75,123,10,28,76
"2011","Caerphilly 015B","W01001430","Total",983,286,125,161,697,71,99,138,194,24,49,122
"2011","Caerphilly 015C","W01001431","Total",642,159,73,86,483,27,86,86,136,14,41,93
"2011","Caerphilly 016A","W01001407","Total",617,157,33,124,460,43,75,86,139,7,22,88
"2011","Caerphilly 016B","W01001408","Total",606,155,59,96,451,67,72,69,107,30,39,67
"2011","Caerphilly 016C","W01001409","Total",697,163,87,76,534,32,114,93,124,18,38,115
"2011","Caerphilly 016D","W01001410","Total",823,257,85,172,566,43,117,97,149,13,40,107
"2011","Caerphilly 017A","W01001411","Total",784,276,130,146,508,20,121,90,150,6,34,87
"2011","Caerphilly 017B","W01001412","Total",831,331,131,200,500,29,93,82,168,13,32,83
"2011","Caerphilly 017C","W01001413","Total",749,221,122,99,528,34,95,94,108,17,52,128
"2011","Caerphilly 018A","W01001330","Total",620,187,89,98,433,32,80,90,106,19,31,75
"2011","Caerphilly 018B","W01001331","Total",728,211,60,151,517,60,58,101,146,23,52,77
"2011","Caerphilly 018C","W01001332","Total",806,236,87,149,570,83,83,108,117,27,42,110
"2011","Caerphilly 018D","W01001333","Total",624,143,37,106,481,66,52,95,122,18,40,88
"2011","Caerphilly 019A","W01001366","Total",697,161,64,97,536,35,95,95,155,19,39,98
"2011","Caerphilly 019B","W01001367","Total",634,170,73,97,464,54,70,83,118,10,36,93
"2011","Caerphilly 019C","W01001368","Total",640,182,70,112,458,54,65,84,105,19,48,83
"2011","Caerphilly 019D","W01001393","Total",545,125,62,63,420,41,92,77,97,10,26,77
"2011","Caerphilly 019E","W01001397","Total",677,156,51,105,521,38,74,112,126,20,43,108
"2011","Caerphilly 019F","W01001400","Total",567,136,50,86,431,75,48,87,85,19,35,82
"2011","Caerphilly 020A","W01001340","Total",694,135,75,60,559,18,94,106,142,22,54,123
"2011","Caerphilly 020B","W01001341","Total",794,267,120,147,527,49,105,88,125,20,38,102
"2011","Caerphilly 020C","W01001344","Total",689,175,99,76,514,38,115,75,113,19,42,112
"2011","Caerphilly 020D","W01001346","Total",660,191,99,92,469,42,120,89,98,15,36,69
"2011","Caerphilly 021A","W01001342","Total",496,136,55,81,360,17,80,82,88,11,25,57
"2011","Caerphilly 021B","W01001343","Total",497,127,54,73,370,14,78,70,107,17,30,54
"2011","Caerphilly 021C","W01001345","Total",590,127,27,100,463,111,51,88,94,32,34,53
"2011","Caerphilly 021D","W01001419","Total",632,137,49,88,495,24,89,92,160,16,38,76
"2011","Caerphilly 022A","W01001371","Total",624,197,87,110,427,61,51,73,112,16,32,82
"2011","Caerphilly 022B","W01001372","Total",805,182,71,111,623,54,110,132,185,22,44,76
"2011","Caerphilly 022C","W01001373","Total",703,175,79,96,528,47,83,104,150,13,33,98
"2011","Caerphilly 022D","W01001420","Total",562,149,56,93,413,38,72,82,118,8,32,63
"2011","Caerphilly 022E","W01001421","Total",710,268,95,173,442,116,49,57,103,29,28,60
"2011","Caerphilly 022F","W01001422","Total",673,198,91,107,475,71,124,58,85,19,37,81
"2011","Caerphilly 023A","W01001370","Total",773,251,135,116,522,33,126,73,143,14,29,104
"2011","Caerphilly 023B","W01001394","Total",507,75,28,47,432,24,56,105,108,18,30,91
"2011","Caerphilly 023C","W01001395","Total",616,171,110,61,445,30,104,64,104,16,35,92
"2011","Caerphilly 023D","W01001396","Total",656,177,68,109,479,73,66,104,99,23,46,68
"2011","Caerphilly 023E","W01001399","Total",548,135,69,66,413,20,87,58,112,21,24,91
"2011","Caerphilly 024A","W01001398","Total",963,198,26,172,765,52,46,236,265,33,45,88
"2011","Caerphilly 024B","W01001423","Total",632,154,93,61,478,18,143,73,135,9,22,78
"2011","Caerphilly 024C","W01001424","Total",659,225,132,93,434,36,100,72,103,7,36,80
"2011","Caerphilly 024D","W01001425","Total",715,227,118,109,488,22,102,90,127,20,29,98
"2011","Caerphilly 024E","W01001426","Total",532,93,44,49,439,9,108,93,100,12,31,86
"2011","Caerphilly 024F","W01001427","Total",683,118,20,98,565,37,31,183,176,26,38,74
"2011","Blaenau Gwent 001A","W01001440","Total",604,181,90,91,423,43,82,71,113,9,35,70
"2011","Blaenau Gwent 001B","W01001441","Total",503,148,59,89,355,38,50,61,97,18,24,67
"2011","Blaenau Gwent 001C","W01001442","Total",504,115,52,63,389,27,89,65,82,11,35,80
"2011","Blaenau Gwent 001D","W01001470","Total",633,156,83,73,477,29,133,82,94,6,31,102
"2011","Blaenau Gwent 001E","W01001471","Total",767,252,103,149,515,66,83,84,135,21,42,84
"2011","Blaenau Gwent 002A","W01001446","Total",485,121,58,63,364,15,70,74,100,7,25,73
"2011","Blaenau Gwent 002B","W01001447","Total",622,157,46,111,465,64,67,72,97,21,53,91
"2011","Blaenau Gwent 002C","W01001448","Total",624,264,93,171,360,31,79,61,105,12,14,58
"2011","Blaenau Gwent 002D","W01001449","Total",726,307,124,183,419,39,89,82,107,8,23,71
"2011","Blaenau Gwent 003A","W01001472","Total",634,189,113,76,445,20,97,101,95,5,40,87
"2011","Blaenau Gwent 003B","W01001473","Total",603,181,77,104,422,75,74,51,92,19,35,76
"2011","Blaenau Gwent 003C","W01001474","Total",673,207,98,109,466,32,98,73,115,14,36,98
"2011","Blaenau Gwent 003D","W01001475","Total",513,143,61,82,370,25,65,76,91,9,29,75
"2011","Blaenau Gwent 003E","W01001480","Total",635,186,109,77,449,54,92,52,101,13,36,101
"2011","Blaenau Gwent 004A","W01001438","Total",670,250,168,82,420,26,89,60,102,10,32,101
"2011","Blaenau Gwent 004B","W01001439","Total",680,145,82,63,535,20,108,93,125,12,50,127
"2011","Blaenau Gwent 004C","W01001456","Total",552,162,63,99,390,33,79,66,97,14,28,73
"2011","Blaenau Gwent 004D","W01001457","Total",743,251,103,148,492,66,57,73,120,18,52,106
"2011","Blaenau Gwent 004E","W01001458","Total",638,161,85,76,477,30,88,94,107,12,38,108
"2011","Blaenau Gwent 005A","W01001443","Total",646,253,117,136,393,41,63,59,119,6,28,77
"2011","Blaenau Gwent 005B","W01001444","Total",796,208,108,100,588,50,104,97,145,30,48,114
"2011","Blaenau Gwent 005C","W01001445","Total",633,174,96,78,459,48,93,86,91,17,33,91
"2011","Blaenau Gwent 005D","W01001467","Total",798,220,99,121,578,53,107,98,148,30,50,92
"2011","Blaenau Gwent 005E","W01001468","Total",582,160,61,99,422,41,80,68,99,15,37,82
"2011","Blaenau Gwent 005F","W01001469","Total",504,118,44,74,386,43,55,62,82,21,38,85
"2011","Blaenau Gwent 006A","W01001462","Total",662,219,118,101,443,44,83,85,97,12,36,86
"2011","Blaenau Gwent 006B","W01001463","Total",868,263,104,159,605,56,129,116,171,9,31,93
"2011","Blaenau Gwent 006C","W01001478","Total",662,205,95,110,457,44,82,82,120,6,26,97
"2011","Blaenau Gwent 006D","W01001479","Total",706,268,118,150,438,78,75,71,98,12,31,73
"2011","Blaenau Gwent 006E","W01001481","Total",775,356,124,232,419,45,85,63,106,11,21,88
"2011","Blaenau Gwent 007A","W01001450","Total",570,176,85,91,394,32,77,72,92,7,31,83
"2011","Blaenau Gwent 007B","W01001451","Total",656,239,116,123,417,46,81,85,96,15,28,66
"2011","Blaenau Gwent 007C","W01001452","Total",624,144,59,85,480,18,61,106,144,18,39,94
"2011","Blaenau Gwent 007D","W01001459","Total",448,129,52,77,319,41,44,58,78,16,32,50
"2011","Blaenau Gwent 007E","W01001460","Total",764,266,76,190,498,45,71,96,150,13,45,78
"2011","Blaenau Gwent 007F","W01001461","Total",634,228,107,121,406,38,66,80,102,13,26,81
"2011","Blaenau Gwent 008A","W01001435","Total",632,187,63,124,445,62,74,74,101,9,29,96
"2011","Blaenau Gwent 008B","W01001436","Total",646,258,112,146,388,37,75,71,91,14,24,76
"2011","Blaenau Gwent 008C","W01001437","Total",658,179,74,105,479,34,88,88,120,18,33,98
"2011","Blaenau Gwent 008D","W01001453","Total",648,196,97,99,452,41,76,73,107,26,42,87
"2011","Blaenau Gwent 008E","W01001454","Total",609,183,84,99,426,34,83,63,108,12,33,93
"2011","Blaenau Gwent 008F","W01001455","Total",792,292,150,142,500,49,98,113,110,8,25,97
"2011","Blaenau Gwent 009A","W01001464","Total",689,249,109,140,440,52,73,69,109,16,32,89
"2011","Blaenau Gwent 009B","W01001465","Total",698,213,85,128,485,43,96,90,128,15,21,92
"2011","Blaenau Gwent 009C","W01001466","Total",787,274,122,152,513,55,100,67,138,7,39,107
"2011","Blaenau Gwent 009D","W01001476","Total",486,186,80,106,300,36,50,45,77,6,18,68
"2011","Blaenau Gwent 009E","W01001477","Total",634,189,88,101,445,30,74,86,135,13,28,79
"2011","Torfaen 001A","W01001487","Total",662,213,99,114,449,28,92,89,98,17,42,83
"2011","Torfaen 001B","W01001488","Total",683,234,97,137,449,42,84,98,103,22,34,66
"2011","Torfaen 001C","W01001489","Total",702,224,113,111,478,39,94,79,137,24,25,80
"2011","Torfaen 001D","W01001490","Total",598,211,103,108,387,31,82,84,98,12,27,53
"2011","Torfaen 002A","W01001482","Total",497,122,57,65,375,38,74,63,89,18,26,67
"2011","Torfaen 002B","W01001483","Total",564,150,81,69,414,53,69,91,86,21,27,67
"2011","Torfaen 002C","W01001484","Total",695,155,74,81,540,25,112,105,144,25,42,87
"2011","Torfaen 002D","W01001485","Total",529,168,107,61,361,40,70,74,81,12,24,60
"2011","Torfaen 002E","W01001486","Total",653,206,77,129,447,42,72,94,110,19,33,77
"2011","Torfaen 003A","W01001525","Total",602,127,75,52,475,41,94,67,110,16,55,92
"2011","Torfaen 003B","W01001529","Total",917,327,118,209,590,34,104,134,154,14,42,108
"2011","Torfaen 003C","W01001530","Total",698,159,60,99,539,90,63,94,110,31,54,97
"2011","Torfaen 003D","W01001531","Total",706,201,102,99,505,46,80,80,109,35,45,110
"2011","Torfaen 004A","W01001491","Total",802,258,127,131,544,55,96,115,151,14,37,76
"2011","Torfaen 004B","W01001496","Total",585,142,69,73,443,51,67,67,109,11,45,93
"2011","Torfaen 004C","W01001523","Total",638,187,61,126,451,33,75,85,116,9,34,99
"2011","Torfaen 004D","W01001524","Total",829,288,135,153,541,28,110,101,158,13,41,90
"2011","Torfaen 004E","W01001540","Total",532,143,71,72,389,18,57,79,114,13,29,79
"2011","Torfaen 004F","W01001541","Total",459,108,45,63,351,22,64,59,108,9,27,62
"2011","Torfaen 005A","W01001510","Total",670,214,106,108,456,41,109,86,103,12,32,73
"2011","Torfaen 005B","W01001511","Total",719,227,109,118,492,40,119,90,109,15,29,90
"2011","Torfaen 005C","W01001512","Total",607,155,96,59,452,13,142,65,115,6,23,88
"2011","Torfaen 005D","W01001513","Total",636,150,78,72,486,10,128,94,122,8,35,89
"2011","Torfaen 006A","W01001514","Total",495,129,66,63,366,18,83,66,95,14,14,76
"2011","Torfaen 006B","W01001515","Total",630,183,64,119,447,48,78,99,109,10,34,69
"2011","Torfaen 006C","W01001516","Total",619,184,82,102,435,25,97,83,98,13,34,85
"2011","Torfaen 006D","W01001517","Total",822,245,83,162,577,46,72,157,147,16,48,91
"2011","Torfaen 006E","W01001518","Total",477,114,66,48,363,15,110,58,86,10,18,66
"2011","Torfaen 007A","W01001519","Total",627,241,71,170,386,53,60,70,85,11,30,77
"2011","Torfaen 007B","W01001520","Total",729,177,68,109,552,52,97,92,150,13,58,90
"2011","Torfaen 007C","W01001521","Total",611,158,60,98,453,46,86,74,119,12,28,88
"2011","Torfaen 007D","W01001522","Total",759,284,168,116,475,52,82,82,97,19,46,97
"2011","Torfaen 007E","W01001537","Total",507,116,71,45,391,14,87,66,102,7,30,85
"2011","Torfaen 008A","W01001493","Total",905,316,147,169,589,40,137,103,172,14,32,91
"2011","Torfaen 008B","W01001494","Total",654,193,124,69,461,25,140,61,93,17,33,92
"2011","Torfaen 008C","W01001495","Total",850,301,211,90,549,23,171,88,131,11,34,91
"2011","Torfaen 008D","W01001507","Total",905,289,182,107,616,53,166,116,137,11,42,91
"2011","Torfaen 009A","W01001501","Total",510,101,33,68,409,53,36,101,92,17,31,79
"2011","Torfaen 009B","W01001503","Total",505,108,44,64,397,51,55,87,78,21,41,64
"2011","Torfaen 009C","W01001536","Total",471,129,33,96,342,67,28,72,67,18,29,61
"2011","Torfaen 009D","W01001538","Total",569,187,91,96,382,56,61,71,78,15,31,70
"2011","Torfaen 009E","W01001539","Total",598,150,68,82,448,46,83,76,115,23,35,70
"2011","Torfaen 010A","W01001506","Total",688,338,114,224,350,25,70,53,98,5,47,52
"2011","Torfaen 010B","W01001526","Total",574,171,65,106,403,59,73,55,99,19,30,68
"2011","Torfaen 010C","W01001527","Total",638,299,181,118,339,28,67,57,112,8,9,58
"2011","Torfaen 010D","W01001528","Total",484,144,63,81,340,24,91,61,74,12,26,52
"2011","Torfaen 010E","W01001532","Total",743,245,115,130,498,56,85,92,124,20,46,75
"2011","Torfaen 011A","W01001497","Total",613,173,98,75,440,50,92,69,78,19,40,92
"2011","Torfaen 011B","W01001498","Total",488,131,61,70,357,41,77,56,73,14,32,64
"2011","Torfaen 011C","W01001499","Total",513,136,35,101,377,28,34,82,136,6,28,63
"2011","Torfaen 011D","W01001500","Total",497,82,14,68,415,16,43,92,135,4,41,84
"2011","Torfaen 011E","W01001502","Total",500,86,30,56,414,26,65,72,114,16,43,78
"2011","Torfaen 012A","W01001492","Total",928,194,71,123,734,43,131,150,188,25,68,129
"2011","Torfaen 012B","W01001533","Total",611,98,32,66,513,16,61,130,149,18,45,94
"2011","Torfaen 012C","W01001534","Total",638,180,76,104,458,20,85,91,133,15,28,86
"2011","Torfaen 012D","W01001535","Total",576,142,50,92,434,32,71,80,135,9,21,86
"2011","Torfaen 013A","W01001504","Total",862,278,155,123,584,41,121,105,131,30,53,103
"2011","Torfaen 013B","W01001505","Total",800,183,94,89,617,23,122,138,159,19,42,114
"2011","Torfaen 013C","W01001508","Total",527,169,111,58,358,12,120,39,74,8,35,70
"2011","Torfaen 013D","W01001509","Total",618,140,92,48,478,22,123,86,112,7,30,98
"2011","Monmouthshire 001A","W01001545","Total",632,202,139,63,430,11,155,52,99,13,25,75
"2011","Monmouthshire 001B","W01001548","Total",857,194,97,97,663,23,152,111,180,29,48,120
"2011","Monmouthshire 001C","W01001557","Total",911,400,176,224,511,47,97,95,152,13,33,74
"2011","Monmouthshire 001D","W01001571","Total",508,115,67,48,393,16,101,48,104,11,30,83
"2011","Monmouthshire 001E","W01001579","Total",745,316,149,167,429,26,134,62,115,6,17,69
"2011","Monmouthshire 002A","W01001546","Total",645,219,98,121,426,40,61,89,113,24,40,59
"2011","Monmouthshire 002C","W01001558","Total",697,257,152,105,440,22,114,86,93,11,29,85
"2011","Monmouthshire 002E","W01001580","Total",809,278,144,134,531,30,125,94,144,27,29,82
"2011","Monmouthshire 002F","W01001909","Total",1165,367,199,168,798,74,163,148,194,32,60,127
"2011","Monmouthshire 003A","W01001561","Total",651,172,107,65,479,11,184,53,131,8,22,70
"2011","Monmouthshire 003B","W01001562","Total",604,180,66,114,424,26,75,78,117,10,28,90
"2011","Monmouthshire 003C","W01001563","Total",461,168,95,73,293,23,68,38,65,8,23,68
"2011","Monmouthshire 003D","W01001564","Total",999,295,173,122,704,38,207,118,157,26,54,104
"2011","Monmouthshire 003E","W01001569","Total",622,161,82,79,461,23,139,68,103,14,24,90
"2011","Monmouthshire 004A","W01001552","Total",635,128,90,38,507,15,167,70,106,23,31,95
"2011","Monmouthshire 004B","W01001553","Total",1113,276,115,161,837,56,161,206,211,31,68,104
"2011","Monmouthshire 004C","W01001554","Total",712,316,154,162,396,43,110,57,106,14,16,50
"2011","Monmouthshire 004D","W01001576","Total",490,163,62,101,327,33,58,72,94,8,14,48
"2011","Monmouthshire 004E","W01001577","Total",610,285,160,125,325,25,77,66,81,12,15,49
"2011","Monmouthshire 004F","W01001599","Total",960,314,168,146,646,38,177,100,163,23,42,103
"2011","Monmouthshire 005A","W01001566","Total",489,97,48,49,392,14,105,52,105,15,30,71
"2011","Monmouthshire 005B","W01001567","Total",433,117,60,57,316,12,82,36,93,4,29,60
"2011","Monmouthshire 005C","W01001568","Total",697,136,70,66,561,17,134,89,151,15,47,108
"2011","Monmouthshire 005D","W01001575","Total",500,101,60,41,399,6,99,59,113,25,22,75
"2011","Monmouthshire 005E","W01001581","Total",852,254,178,76,598,18,165,100,153,15,36,111
"2011","Monmouthshire 006A","W01001555","Total",484,101,61,40,383,9,105,62,93,9,35,70
"2011","Monmouthshire 006B","W01001556","Total",509,146,75,71,363,19,79,70,104,16,25,50
"2011","Monmouthshire 006C","W01001560","Total",514,90,34,56,424,16,114,54,109,8,37,86
"2011","Monmouthshire 006D","W01001565","Total",719,159,79,80,560,12,138,80,134,20,61,115
"2011","Monmouthshire 006E","W01001596","Total",495,220,156,64,275,28,91,42,70,6,11,27
"2011","Monmouthshire 006F","W01001597","Total",660,211,89,122,449,31,108,94,96,13,28,79
"2011","Monmouthshire 007A","W01001549","Total",598,126,66,60,472,8,127,69,131,16,47,74
"2011","Monmouthshire 007B","W01001583","Total",659,139,85,54,520,5,150,85,137,27,20,96
"2011","Monmouthshire 007C","W01001585","Total",509,105,64,41,404,8,100,101,93,13,23,66
"2011","Monmouthshire 007D","W01001586","Total",950,181,79,102,769,36,146,200,201,39,56,91
"2011","Monmouthshire 007E","W01001594","Total",537,100,60,40,437,17,95,68,129,19,37,72
"2011","Monmouthshire 007F","W01001595","Total",527,103,60,43,424,11,123,65,114,18,35,58
"2011","Monmouthshire 008A","W01001559","Total",559,145,84,61,414,21,130,67,85,17,28,66
"2011","Monmouthshire 008B","W01001584","Total",778,193,95,98,585,40,99,111,163,27,40,105
"2011","Monmouthshire 008C","W01001587","Total",964,467,183,284,497,52,63,96,185,15,23,63
"2011","Monmouthshire 008D","W01001592","Total",679,191,78,113,488,74,56,93,117,34,39,75
"2011","Monmouthshire 008E","W01001593","Total",729,196,77,119,533,44,86,99,152,18,42,92
"2011","Monmouthshire 009A","W01001542","Total",728,169,77,92,559,15,142,96,147,19,36,104
"2011","Monmouthshire 009B","W01001543","Total",553,103,55,48,450,12,96,86,110,23,38,85
"2011","Monmouthshire 009C","W01001578","Total",884,215,145,70,669,17,149,103,188,22,48,142
"2011","Monmouthshire 009D","W01001590","Total",868,169,96,73,699,13,182,125,169,14,58,138
"2011","Monmouthshire 010C","W01001551","Total",466,112,81,31,354,26,78,77,74,11,26,62
"2011","Monmouthshire 010D","W01001588","Total",731,184,116,68,547,7,165,91,133,12,37,102
"2011","Monmouthshire 010E","W01001589","Total",655,209,77,132,446,25,91,80,119,9,23,99
"2011","Monmouthshire 010F","W01001598","Total",672,169,86,83,503,48,94,93,117,16,39,96
"2011","Monmouthshire 010G","W01001908","Total",934,265,172,93,669,52,157,104,167,14,39,136
"2011","Monmouthshire 011A","W01001572","Total",618,131,83,48,487,24,102,120,100,23,36,82
"2011","Monmouthshire 011B","W01001573","Total",560,87,50,37,473,13,84,88,129,16,51,92
"2011","Monmouthshire 011C","W01001574","Total",617,137,39,98,480,23,74,115,160,8,29,71
"2011","Monmouthshire 011D","W01001582","Total",698,156,80,76,542,42,80,122,127,20,52,99
"2011","Monmouthshire 011E","W01001591","Total",582,102,24,78,480,19,62,139,127,20,35,78
"2011","Newport 001A","W01001623","Total",654,227,107,120,427,28,83,88,119,9,18,82
"2011","Newport 001B","W01001624","Total",501,115,35,80,386,36,59,92,99,14,25,61
"2011","Newport 001C","W01001625","Total",560,156,80,76,404,20,97,63,113,14,28,69
"2011","Newport 001D","W01001626","Total",577,133,77,56,444,29,120,62,97,7,32,97
"2011","Newport 001E","W01001627","Total",630,140,71,69,490,23,121,77,110,14,32,113
"2011","Newport 001F","W01001628","Total",511,203,120,83,308,37,75,49,58,7,28,54
"2011","Newport 002A","W01001651","Total",637,155,103,52,482,13,128,78,116,11,36,100
"2011","Newport 002B","W01001652","Total",791,312,129,183,479,89,73,86,95,19,44,73
"2011","Newport 002C","W01001653","Total",608,137,80,57,471,22,132,90,105,14,25,83
"2011","Newport 002D","W01001654","Total",676,162,81,81,514,33,114,111,123,14,33,86
"2011","Newport 002E","W01001655","Total",651,143,79,64,508,24,108,86,137,15,39,99
"2011","Newport 003A","W01001617","Total",582,205,76,129,377,69,71,67,72,15,32,51
"2011","Newport 003B","W01001618","Total",494,157,63,94,337,44,77,42,70,12,22,70
"2011","Newport 003C","W01001619","Total",599,205,45,160,394,66,68,64,78,17,39,62
"2011","Newport 003D","W01001620","Total",482,139,60,79,343,42,53,72,79,10,35,52
"2011","Newport 003E","W01001621","Total",614,216,97,119,398,48,77,64,93,11,37,68
"2011","Newport 003F","W01001622","Total",535,164,35,129,371,34,75,66,87,17,27,65
"2011","Newport 004A","W01001639","Total",719,128,54,74,591,28,91,157,160,20,57,78
"2011","Newport 004B","W01001640","Total",495,123,87,36,372,6,113,48,97,3,31,74
"2011","Newport 004C","W01001641","Total",537,110,63,47,427,4,115,74,124,11,28,71
"2011","Newport 004D","W01001649","Total",608,144,76,68,464,30,112,73,110,13,33,93
"2011","Newport 004E","W01001650","Total",615,166,64,102,449,39,64,72,134,27,32,81
"2011","Newport 005A","W01001614","Total",778,387,195,192,391,54,78,68,94,9,35,53
"2011","Newport 005B","W01001615","Total",604,148,88,60,456,51,71,94,105,24,37,74
"2011","Newport 005C","W01001616","Total",633,191,97,94,442,18,97,73,122,10,38,84
"2011","Newport 005D","W01001678","Total",700,231,57,174,469,43,75,84,122,21,40,84
"2011","Newport 006A","W01001601","Total",638,215,42,173,423,79,45,71,108,19,29,72
"2011","Newport 006B","W01001681","Total",660,287,101,186,373,76,50,50,108,9,21,59
"2011","Newport 006C","W01001682","Total",599,218,119,99,381,48,70,61,108,9,23,62
"2011","Newport 006D","W01001683","Total",485,140,57,83,345,46,54,57,102,10,20,56
"2011","Newport 006E","W01001684","Total",637,205,54,151,432,41,39,80,160,16,16,80
"2011","Newport 007A","W01001675","Total",619,182,61,121,437,47,56,87,92,17,41,97
"2011","Newport 007B","W01001676","Total",720,237,54,183,483,73,53,104,137,19,27,70
"2011","Newport 007C","W01001677","Total",653,194,96,98,459,45,105,92,109,12,26,70
"2011","Newport 007D","W01001679","Total",457,107,71,36,350,17,66,54,87,11,40,75
"2011","Newport 007E","W01001680","Total",506,125,55,70,381,47,35,64,113,14,31,77
"2011","Newport 008A","W01001606","Total",517,135,90,45,382,20,90,65,76,13,32,86
"2011","Newport 008B","W01001608","Total",638,166,80,86,472,35,105,80,112,13,52,75
"2011","Newport 008C","W01001663","Total",689,251,135,116,438,47,130,46,80,12,39,84
"2011","Newport 008D","W01001665","Total",743,257,149,108,486,47,137,71,118,12,30,71
"2011","Newport 009A","W01001669","Total",528,88,46,42,440,5,97,77,115,15,34,97
"2011","Newport 009B","W01001670","Total",862,146,55,91,716,34,117,215,158,32,63,97
"2011","Newport 009C","W01001672","Total",733,226,140,86,507,40,85,121,117,30,36,78
"2011","Newport 009D","W01001673","Total",644,171,95,76,473,16,151,72,117,11,23,83
"2011","Newport 009E","W01001674","Total",619,152,97,55,467,38,111,81,104,12,38,83
"2011","Newport 010A","W01001664","Total",647,248,137,111,399,56,95,63,73,16,25,71
"2011","Newport 010B","W01001666","Total",623,216,119,97,407,56,79,73,71,25,37,66
"2011","Newport 010C","W01001667","Total",521,130,60,70,391,70,58,66,71,22,34,70
"2011","Newport 010D","W01001668","Total",482,143,64,79,339,49,74,50,62,21,24,59
"2011","Newport 011A","W01001611","Total",531,155,57,98,376,36,51,89,84,15,38,63
"2011","Newport 011B","W01001612","Total",651,214,96,118,437,32,68,71,118,14,32,102
"2011","Newport 011C","W01001613","Total",616,163,67,96,453,25,77,101,104,19,50,77
"2011","Newport 011D","W01001691","Total",657,244,80,164,413,65,62,46,115,19,35,71
"2011","Newport 011E","W01001692","Total",834,302,65,237,532,67,56,107,138,20,52,92
"2011","Newport 012A","W01001600","Total",669,185,101,84,484,17,139,91,118,19,26,74
"2011","Newport 012B","W01001602","Total",676,197,121,76,479,11,132,100,131,14,22,69
"2011","Newport 012C","W01001603","Total",569,218,61,157,351,11,46,68,97,19,31,79
"2011","Newport 012D","W01001604","Total",620,158,108,50,462,15,137,97,92,18,27,76
"2011","Newport 013A","W01001642","Total",779,291,89,202,488,86,46,97,138,20,30,71
"2011","Newport 013B","W01001643","Total",566,151,38,113,415,87,29,86,82,29,46,56
"2011","Newport 013C","W01001644","Total",1136,331,54,277,805,119,61,180,255,30,51,109
"2011","Newport 013D","W01001690","Total",946,321,71,250,625,82,58,137,166,27,65,90
"2011","Newport 013E","W01001693","Total",647,260,41,219,387,21,35,60,87,22,75,87
"2011","Newport 014A","W01001605","Total",625,286,99,187,339,24,57,60,94,12,26,66
"2011","Newport 014B","W01001685","Total",773,330,97,233,443,48,46,76,122,17,28,106
"2011","Newport 014C","W01001686","Total",554,188,54,134,366,21,46,58,118,17,41,65
"2011","Newport 014D","W01001687","Total",879,453,80,373,426,26,44,63,169,15,34,75
"2011","Newport 015A","W01001607","Total",497,101,29,72,396,72,23,86,71,32,47,65
"2011","Newport 015B","W01001609","Total",567,142,49,93,425,101,27,73,94,25,40,65
"2011","Newport 015C","W01001610","Total",507,117,65,52,390,24,69,77,96,20,38,66
"2011","Newport 015D","W01001645","Total",513,94,45,49,419,53,51,71,118,26,38,62
"2011","Newport 015E","W01001646","Total",623,181,90,91,442,70,92,61,80,23,42,74
"2011","Newport 015F","W01001647","Total",633,167,96,71,466,20,141,60,109,8,41,87
"2011","Newport 015G","W01001648","Total",637,177,110,67,460,47,97,81,101,14,40,80
"2011","Newport 016A","W01001635","Total",596,203,81,122,393,15,74,114,94,13,19,64
"2011","Newport 016B","W01001637","Total",700,191,115,76,509,44,101,106,115,20,52,71
"2011","Newport 016C","W01001638","Total",468,98,61,37,370,13,86,82,74,13,33,69
"2011","Newport 016D","W01001671","Total",841,331,134,197,510,62,94,104,137,11,21,81
"2011","Newport 017A","W01001629","Total",634,207,125,82,427,20,138,47,118,13,20,71
"2011","Newport 017B","W01001630","Total",788,386,228,158,402,44,111,46,108,11,20,62
"2011","Newport 017C","W01001631","Total",617,179,77,102,438,26,90,108,114,10,14,76
"2011","Newport 017D","W01001632","Total",585,191,98,93,394,48,56,72,89,13,32,84
"2011","Newport 018A","W01001659","Total",782,366,127,239,416,65,34,71,94,39,56,57
"2011","Newport 018B","W01001660","Total",616,214,59,155,402,40,50,71,95,19,56,71
"2011","Newport 018C","W01001661","Total",945,310,57,253,635,72,27,83,150,49,64,190
"2011","Newport 018D","W01001662","Total",614,308,128,180,306,30,36,45,81,23,53,38
"2011","Newport 019A","W01001633","Total",609,177,68,109,432,81,50,80,92,28,42,59
"2011","Newport 019B","W01001634","Total",611,167,71,96,444,54,67,78,91,31,41,82
"2011","Newport 019C","W01001688","Total",1080,276,33,243,804,108,46,199,263,41,43,104
"2011","Newport 019D","W01001689","Total",777,304,216,88,473,96,82,71,84,30,52,58
"2011","Newport 020A","W01001636","Total",696,126,39,87,570,29,60,200,132,22,43,84
"2011","Newport 020C","W01001657","Total",547,79,30,49,468,15,69,130,126,12,38,78
"2011","Newport 020D","W01001658","Total",697,139,72,67,558,30,86,143,136,25,53,85
"2011","Newport 020E","W01001912","Total",648,179,69,110,469,22,107,89,147,13,28,63
"2011","Newport 020F","W01001913","Total",605,156,15,141,449,30,28,135,164,15,21,56
