"date","geography","geography code","Rural Urban","Household Composition: All categories: Household composition (alternative child and adult defintions); measures: Value","Household Composition: One person household: Total; measures: Value","Household Composition: One person household: One person aged 65 and over; measures: Value","Household Composition: One person household: One person aged under 65; measures: Value","Household Composition: Other households: Total; measures: Value","Household Composition: Other households: No adults or one adult and one or more children; measures: Value","Household Composition: Other households: One adult aged 16 to 64 and one aged 65 and over and no children or two adults aged 65 and over and no children; measures: Value","Household Composition: Other households: Two adults and one or two children; measures: Value","Household Composition: Other households: Two adults aged 16 to 64 and no children; measures: Value","Household Composition: Other households: Two adults and three or more children; measures: Value","Household Composition: Other households: Three or more adults and one or more children; measures: Value","Household Composition: Other households: Three or more adults and no children; measures: Value"
"2011","Darlington 001B","E01012334","Total",2466,192,85,107,2274,93,258,720,430,222,229,322
"2011","Darlington 001C","E01012335","Total",1383,176,98,78,1207,35,266,318,232,66,100,190
"2011","Darlington 001D","E01012366","Total",2008,199,92,107,1809,89,334,315,398,59,189,425
"2011","Darlington 001E","E01033481","Total",1350,131,17,114,1219,82,56,485,298,67,102,129
"2011","Darlington 001F","E01033482","Total",1621,160,36,124,1461,80,90,532,292,119,135,213
"2011","Darlington 002C","E01012323","Total",1563,177,53,124,1386,96,146,389,276,96,170,213
"2011","Darlington 002D","E01012324","Total",1399,181,82,99,1218,84,212,312,238,55,118,199
"2011","Darlington 002E","E01032545","Total",1257,132,51,81,1125,85,116,289,200,74,104,257
"2011","Darlington 002F","E01032546","Total",1775,131,72,59,1644,59,222,422,316,68,209,348
"2011","Darlington 003A","E01012328","Total",1571,288,89,199,1283,138,168,267,342,102,90,176
"2011","Darlington 003B","E01012329","Total",1770,169,93,76,1601,42,294,341,404,58,96,366
"2011","Darlington 003C","E01012330","Total",1145,89,41,48,1056,47,128,264,214,51,116,236
"2011","Darlington 003D","E01012331","Total",1223,98,40,58,1125,89,134,250,254,77,79,242
"2011","Darlington 004A","E01012349","Total",1502,416,140,276,1086,227,68,209,232,63,154,133
"2011","Darlington 004B","E01012350","Total",1517,328,120,208,1189,140,152,325,260,42,71,199
"2011","Darlington 004C","E01012351","Total",1438,118,41,77,1320,75,112,300,224,82,175,352
"2011","Darlington 004D","E01012352","Total",1516,380,120,260,1136,184,114,281,264,41,79,173
"2011","Darlington 005A","E01012325","Total",1435,201,74,127,1234,90,176,205,344,68,98,253
"2011","Darlington 005B","E01012326","Total",1116,154,103,51,962,90,144,195,190,54,114,175
"2011","Darlington 005C","E01012332","Total",1330,196,93,103,1134,115,152,181,222,120,125,219
"2011","Darlington 005D","E01012333","Total",1405,150,75,75,1255,98,164,260,230,77,164,262
"2011","Darlington 006A","E01012309","Total",1858,168,71,97,1690,82,160,486,386,117,166,293
"2011","Darlington 006B","E01012310","Total",1956,269,139,130,1687,110,212,368,352,130,152,363
"2011","Darlington 006C","E01012311","Total",1567,168,86,82,1399,95,164,301,214,123,197,305
"2011","Darlington 006D","E01012312","Total",1351,274,138,136,1077,173,78,210,160,156,140,160
"2011","Darlington 006E","E01012313","Total",1393,256,136,120,1137,129,166,307,202,73,90,170
"2011","Darlington 006F","E01012314","Total",1364,191,89,102,1173,154,152,253,158,101,156,199
"2011","Darlington 007A","E01012362","Total",1376,300,60,240,1076,173,98,274,270,61,54,146
"2011","Darlington 007B","E01012363","Total",1334,284,61,223,1050,139,110,230,286,68,44,173
"2011","Darlington 007C","E01012364","Total",1451,301,85,216,1150,138,100,292,328,25,54,213
"2011","Darlington 007D","E01012365","Total",1251,142,77,65,1109,51,158,276,224,41,94,265
"2011","Darlington 008B","E01012353","Total",1612,296,43,253,1316,185,84,318,350,87,128,164
"2011","Darlington 008C","E01012354","Total",1570,351,47,304,1219,153,58,181,274,101,301,151
"2011","Darlington 008D","E01012355","Total",1439,293,98,195,1146,129,114,222,340,70,129,142
"2011","Darlington 008E","E01033483","Total",993,315,82,233,678,73,32,129,180,92,61,111
"2011","Darlington 008F","E01033484","Total",1143,421,140,281,722,80,60,135,234,30,52,131
"2011","Darlington 009A","E01012307","Total",1848,347,130,217,1501,172,162,365,300,95,153,254
"2011","Darlington 009B","E01012327","Total",1575,180,68,112,1395,254,118,284,184,196,210,149
"2011","Darlington 009C","E01012342","Total",1730,294,152,142,1436,235,206,223,288,114,133,237
"2011","Darlington 009D","E01012343","Total",2004,252,149,103,1752,152,296,343,332,88,182,359
"2011","Darlington 010A","E01012315","Total",1646,178,112,66,1468,55,216,424,264,117,120,272
"2011","Darlington 010B","E01012316","Total",2443,460,142,318,1983,71,250,533,464,124,227,314
"2011","Darlington 010C","E01012360","Total",1702,272,169,103,1430,56,316,346,238,119,142,213
"2011","Darlington 011A","E01012336","Total",1681,198,148,50,1483,15,312,372,226,76,143,339
"2011","Darlington 011B","E01012337","Total",1682,158,98,60,1524,23,344,302,260,108,158,329
"2011","Darlington 011C","E01012347","Total",1722,214,140,74,1508,43,324,353,266,75,135,312
"2011","Darlington 011D","E01012348","Total",1986,272,197,75,1714,68,556,372,226,86,141,265
"2011","Darlington 011E","E01012361","Total",1897,167,115,52,1730,52,360,451,336,104,125,302
"2011","Darlington 012A","E01012304","Total",1191,349,151,198,842,139,88,121,198,40,165,91
"2011","Darlington 012B","E01012305","Total",1231,245,62,183,986,172,72,184,288,42,73,155
"2011","Darlington 012C","E01012306","Total",1415,167,63,104,1248,92,142,236,266,78,169,265
"2011","Darlington 012D","E01012340","Total",2349,342,127,215,2007,223,208,529,422,131,218,276
"2011","Darlington 012E","E01012341","Total",1759,302,124,178,1457,256,160,279,228,95,202,237
"2011","Darlington 013A","E01012317","Total",1370,186,88,98,1184,73,254,259,232,61,104,201
"2011","Darlington 013B","E01012318","Total",2297,353,103,250,1944,341,144,491,348,126,240,254
"2011","Darlington 013C","E01012319","Total",2811,258,110,148,2553,311,250,681,418,215,265,413
"2011","Darlington 014A","E01012356","Total",1558,280,88,192,1278,121,114,326,316,78,116,207
"2011","Darlington 014B","E01012357","Total",1447,180,50,130,1267,136,90,238,246,96,219,242
"2011","Darlington 014C","E01012358","Total",1655,208,80,128,1447,97,162,366,274,138,135,275
"2011","Darlington 014D","E01012359","Total",1586,229,70,159,1357,319,98,300,168,184,133,155
"2011","Darlington 015A","E01012338","Total",1908,251,120,131,1657,115,272,344,370,116,210,230
"2011","Darlington 015B","E01012339","Total",1719,198,121,77,1521,56,340,342,268,60,144,311
"2011","Darlington 015C","E01012344","Total",1337,185,71,114,1152,85,128,257,296,57,127,202
"2011","Darlington 015D","E01012345","Total",1291,149,71,78,1142,28,240,256,260,38,91,229
"2011","Darlington 015E","E01012346","Total",1823,132,38,94,1691,102,132,579,312,95,177,294
"2011","County Durham 002A","E01020613","Total",1392,91,50,41,1301,29,232,321,218,92,129,280
"2011","County Durham 002B","E01020614","Total",1429,228,134,94,1201,102,246,302,196,21,125,209
"2011","County Durham 002C","E01020622","Total",1657,131,42,89,1526,63,140,385,370,71,102,395
"2011","County Durham 002D","E01020623","Total",1503,162,34,128,1341,56,84,352,322,62,145,320
"2011","County Durham 005A","E01020606","Total",1492,312,107,205,1180,131,170,222,272,48,124,213
"2011","County Durham 005B","E01020615","Total",1727,250,133,117,1477,126,160,404,230,57,181,319
"2011","County Durham 005C","E01020616","Total",1671,272,90,182,1399,202,112,340,330,51,153,211
"2011","County Durham 005D","E01020617","Total",1812,260,112,148,1552,74,220,352,412,64,73,357
"2011","County Durham 007A","E01020596","Total",1679,271,142,129,1408,160,178,338,222,100,147,263
"2011","County Durham 007B","E01020597","Total",1495,166,89,77,1329,60,304,270,264,59,115,257
"2011","County Durham 007C","E01020598","Total",1770,289,129,160,1481,65,294,406,294,41,136,245
"2011","County Durham 007D","E01020611","Total",1346,125,73,52,1221,43,276,267,250,25,124,236
"2011","County Durham 007E","E01020612","Total",1626,145,108,37,1481,33,342,324,254,57,162,309
"2011","County Durham 011A","E01020592","Total",1514,223,78,145,1291,226,100,318,166,68,184,229
"2011","County Durham 011B","E01020593","Total",1227,266,88,178,961,76,138,219,260,27,73,168
"2011","County Durham 011C","E01020599","Total",1685,442,198,244,1243,114,172,308,198,62,101,288
"2011","County Durham 011D","E01020601","Total",1550,181,92,89,1369,43,146,413,266,20,198,283
"2011","County Durham 011E","E01020602","Total",1744,396,222,174,1348,101,256,257,252,102,126,254
"2011","County Durham 011F","E01020618","Total",1558,243,104,139,1315,118,154,316,244,15,186,282
"2011","County Durham 013A","E01020594","Total",1625,269,83,186,1356,108,168,299,378,48,100,255
"2011","County Durham 013B","E01020595","Total",1681,241,122,119,1440,66,270,338,290,73,104,299
"2011","County Durham 013C","E01020600","Total",1515,161,99,62,1354,28,310,302,218,58,143,295
"2011","County Durham 013D","E01020603","Total",1843,94,47,47,1749,29,192,524,256,65,251,432
"2011","County Durham 013E","E01020605","Total",1757,213,67,146,1544,63,158,480,372,56,104,311
"2011","County Durham 015A","E01020590","Total",1335,120,61,59,1215,94,188,262,282,40,85,264
"2011","County Durham 015B","E01020591","Total",1437,208,80,128,1229,121,176,229,234,88,140,241
"2011","County Durham 015C","E01020608","Total",1786,220,115,105,1566,121,172,540,234,68,156,275
"2011","County Durham 015D","E01020609","Total",1403,139,74,65,1264,95,298,258,206,77,95,235
"2011","County Durham 015E","E01020610","Total",1498,151,68,83,1347,95,180,347,290,55,121,259
"2011","County Durham 019A","E01020604","Total",1420,193,79,114,1227,64,168,304,264,25,152,250
"2011","County Durham 019B","E01020607","Total",1545,222,95,127,1323,75,194,296,272,67,104,315
"2011","County Durham 019C","E01020619","Total",1540,187,99,88,1353,62,164,356,300,87,107,277
"2011","County Durham 019D","E01020620","Total",1575,188,69,119,1387,99,162,321,250,124,161,270
"2011","County Durham 019E","E01020621","Total",1856,262,93,169,1594,153,220,352,382,53,142,292
"2011","County Durham 001A","E01020634","Total",1517,171,76,95,1346,62,204,356,310,48,97,269
"2011","County Durham 001B","E01020635","Total",1379,162,74,88,1217,42,176,263,308,57,93,278
"2011","County Durham 001C","E01020636","Total",1698,280,141,139,1418,133,208,332,340,73,96,236
"2011","County Durham 001D","E01020654","Total",1717,199,77,122,1518,104,222,377,352,62,109,292
"2011","County Durham 001E","E01020676","Total",1514,225,77,148,1289,79,166,242,312,57,156,277
"2011","County Durham 003A","E01020627","Total",1538,223,90,133,1315,52,172,307,314,98,111,261
"2011","County Durham 003B","E01020628","Total",1637,194,104,90,1443,61,260,376,342,43,130,231
"2011","County Durham 003C","E01020629","Total",1500,164,75,89,1336,97,174,367,222,86,128,262
"2011","County Durham 003D","E01020655","Total",1925,206,80,126,1719,73,256,452,428,69,170,271
"2011","County Durham 003E","E01020656","Total",1392,244,104,140,1148,89,234,195,242,54,87,247
"2011","County Durham 003F","E01020657","Total",1494,118,47,71,1376,70,188,340,302,35,159,282
"2011","County Durham 004A","E01020661","Total",1763,282,103,179,1481,164,182,354,322,84,123,252
"2011","County Durham 004B","E01020662","Total",1792,242,106,136,1550,91,198,398,298,66,188,311
"2011","County Durham 004C","E01020663","Total",1842,249,111,138,1593,81,264,403,360,59,115,311
"2011","County Durham 004D","E01020674","Total",1586,252,119,133,1334,122,192,315,302,74,121,208
"2011","County Durham 004E","E01020678","Total",1369,140,70,70,1229,121,154,235,252,42,129,296
"2011","County Durham 006A","E01020626","Total",1539,295,151,144,1244,115,214,231,244,86,122,232
"2011","County Durham 006B","E01020638","Total",1562,221,101,120,1341,100,228,244,246,80,143,300
"2011","County Durham 006C","E01020639","Total",1500,233,87,146,1267,149,130,281,216,127,133,231
"2011","County Durham 006D","E01020653","Total",1540,234,103,131,1306,137,188,252,216,82,168,263
"2011","County Durham 006E","E01020677","Total",1522,210,110,100,1312,92,216,264,226,97,112,305
"2011","County Durham 008A","E01020647","Total",2142,200,39,161,1942,273,112,566,342,169,209,271
"2011","County Durham 008B","E01020648","Total",1879,223,74,149,1656,216,162,378,264,143,212,281
"2011","County Durham 008C","E01020649","Total",1547,223,82,141,1324,149,122,304,290,98,129,232
"2011","County Durham 008D","E01020673","Total",1577,324,120,204,1253,157,166,201,296,52,151,230
"2011","County Durham 008E","E01020675","Total",1625,320,155,165,1305,127,186,260,276,51,157,248
"2011","County Durham 009A","E01020624","Total",1542,245,75,170,1297,129,144,275,262,83,122,282
"2011","County Durham 009B","E01020625","Total",1574,203,80,123,1371,133,158,280,268,103,165,264
"2011","County Durham 009C","E01020670","Total",1559,269,146,123,1290,116,242,245,276,66,119,226
"2011","County Durham 009D","E01020671","Total",1346,218,66,152,1128,178,128,178,210,83,129,222
"2011","County Durham 009E","E01020672","Total",1671,254,78,176,1417,147,156,234,346,68,172,294
"2011","County Durham 010A","E01020632","Total",1766,270,89,181,1496,108,168,377,336,62,142,303
"2011","County Durham 010B","E01020640","Total",2354,279,80,199,2075,139,156,628,422,71,252,407
"2011","County Durham 010C","E01020641","Total",2112,342,163,179,1770,140,238,424,324,104,208,332
"2011","County Durham 010D","E01020642","Total",1378,205,104,101,1173,69,186,319,218,32,117,232
"2011","County Durham 010E","E01020643","Total",2157,402,151,251,1755,178,180,474,418,76,105,324
"2011","County Durham 010F","E01020667","Total",1537,326,156,170,1211,91,230,228,350,31,113,168
"2011","County Durham 012A","E01020650","Total",2183,238,86,152,1945,222,192,513,390,104,175,349
"2011","County Durham 012B","E01020651","Total",1711,271,133,138,1440,106,314,336,226,45,154,259
"2011","County Durham 012C","E01020652","Total",1953,274,157,117,1679,144,198,442,286,64,225,320
"2011","County Durham 012D","E01020668","Total",1487,232,97,135,1255,155,138,223,272,66,129,272
"2011","County Durham 012E","E01020669","Total",1436,196,72,124,1240,99,138,285,252,48,125,293
"2011","County Durham 014A","E01020630","Total",1388,164,70,94,1224,126,164,318,192,59,125,240
"2011","County Durham 014B","E01020631","Total",1649,310,173,137,1339,114,184,299,252,107,122,261
"2011","County Durham 014C","E01020637","Total",1657,208,109,99,1449,59,260,326,264,77,143,320
"2011","County Durham 014D","E01020644","Total",2447,298,74,224,2149,247,138,543,496,135,258,332
"2011","County Durham 014E","E01020645","Total",1466,231,105,126,1235,187,146,275,192,72,188,175
"2011","County Durham 020A","E01020633","Total",1564,204,84,120,1360,99,174,287,326,88,94,292
"2011","County Durham 020B","E01020664","Total",1410,221,123,98,1189,38,248,224,306,53,111,209
"2011","County Durham 020C","E01020665","Total",1355,238,114,124,1117,99,204,262,210,35,90,217
"2011","County Durham 020D","E01020666","Total",1456,154,91,63,1302,26,318,305,258,55,125,215
"2011","County Durham 024A","E01020646","Total",1586,214,98,116,1372,62,156,398,254,78,128,296
"2011","County Durham 024B","E01020658","Total",1734,304,145,159,1430,201,132,378,336,58,119,206
"2011","County Durham 024C","E01020659","Total",1574,170,62,108,1404,69,162,403,286,61,121,302
"2011","County Durham 024D","E01020660","Total",1564,209,107,102,1355,97,204,277,258,52,170,297
"2011","County Durham 022A","E01020709","Total",1408,131,36,95,1277,39,148,374,274,62,128,252
"2011","County Durham 022B","E01020717","Total",1614,230,128,102,1384,32,346,238,312,26,121,309
"2011","County Durham 022C","E01020718","Total",1323,207,111,96,1116,35,218,243,226,54,99,241
"2011","County Durham 022D","E01020719","Total",1236,133,41,92,1103,50,142,294,262,30,108,217
"2011","County Durham 022E","E01020721","Total",1182,105,25,80,1077,25,114,265,256,35,100,282
"2011","County Durham 023A","E01020708","Total",1160,151,62,89,1009,39,204,242,254,42,65,163
"2011","County Durham 023B","E01020710","Total",1579,256,75,181,1323,74,174,325,346,50,107,247
"2011","County Durham 023C","E01020711","Total",1689,282,146,136,1407,88,208,292,304,104,139,272
"2011","County Durham 023D","E01020720","Total",1414,293,145,148,1121,86,178,304,206,75,77,195
"2011","County Durham 026A","E01020679","Total",1561,251,108,143,1310,128,156,347,248,72,117,242
"2011","County Durham 026B","E01020680","Total",1607,149,73,76,1458,42,242,415,288,57,92,322
"2011","County Durham 026C","E01020681","Total",1467,245,106,139,1222,108,172,292,258,45,108,239
"2011","County Durham 026D","E01020714","Total",1551,166,65,101,1385,56,224,307,372,21,105,300
"2011","County Durham 026E","E01020716","Total",1709,240,91,149,1469,178,146,296,262,140,197,250
"2011","County Durham 027A","E01020725","Total",1534,171,73,98,1363,76,182,398,296,65,124,222
"2011","County Durham 027B","E01020726","Total",1193,134,52,82,1059,67,182,251,268,19,61,211
"2011","County Durham 027C","E01020727","Total",1087,238,89,149,849,87,132,169,154,73,89,145
"2011","County Durham 027D","E01020729","Total",2118,290,88,202,1828,199,188,428,418,114,207,274
"2011","County Durham 027E","E01020730","Total",1685,304,164,140,1381,114,232,297,260,61,144,273
"2011","County Durham 027F","E01020731","Total",1455,161,57,104,1294,72,170,326,314,72,99,241
"2011","County Durham 028A","E01020682","Total",1884,181,125,56,1703,53,458,291,346,52,143,360
"2011","County Durham 028B","E01020683","Total",1596,142,47,95,1454,53,260,363,266,72,148,292
"2011","County Durham 028C","E01020690","Total",1290,197,117,80,1093,59,318,172,230,16,79,219
"2011","County Durham 028D","E01020691","Total",1332,216,116,100,1116,88,134,267,226,33,98,270
"2011","County Durham 028E","E01020692","Total",1390,181,90,91,1209,17,332,189,294,25,86,266
"2011","County Durham 029A","E01020693","Total",1321,225,72,153,1096,70,162,184,286,66,77,251
"2011","County Durham 029B","E01020722","Total",2008,281,117,164,1727,140,182,247,368,131,131,528
"2011","County Durham 029C","E01020723","Total",1729,281,94,187,1448,67,148,154,318,60,104,597
"2011","County Durham 029D","E01020724","Total",1613,214,59,155,1399,230,100,285,220,99,205,260
"2011","County Durham 030A","E01020703","Total",1963,209,85,124,1754,25,68,71,268,5,42,1275
"2011","County Durham 030D","E01033164","Total",1004,161,61,100,843,6,66,30,208,10,35,488
"2011","County Durham 030E","E01033195","Total",954,127,43,84,827,6,138,93,164,20,13,393
"2011","County Durham 030F","E01033197","Total",1131,119,69,50,1012,8,88,11,104,16,34,751
"2011","County Durham 030G","E01033221","Total",992,162,75,87,830,9,92,33,142,28,41,485
"2011","County Durham 033A","E01020684","Total",2310,291,85,206,2019,158,164,529,416,105,224,423
"2011","County Durham 033B","E01020702","Total",2034,199,72,127,1835,27,230,408,394,124,141,511
"2011","County Durham 033C","E01020704","Total",1768,90,37,53,1678,7,142,175,174,87,154,939
"2011","County Durham 033D","E01020712","Total",1610,180,67,113,1430,25,182,332,300,63,145,383
"2011","County Durham 033E","E01020713","Total",2028,158,68,90,1870,29,220,557,348,132,132,452
"2011","County Durham 031A","E01020705","Total",1450,290,143,147,1160,105,172,221,254,55,109,244
"2011","County Durham 031B","E01020706","Total",1840,276,111,165,1564,81,260,344,352,70,126,331
"2011","County Durham 031C","E01020715","Total",2393,335,103,232,2058,179,186,491,492,155,129,426
"2011","County Durham 038A","E01020685","Total",1633,195,103,92,1438,65,214,308,312,63,140,336
"2011","County Durham 038B","E01020686","Total",1564,355,131,224,1209,128,186,241,262,107,122,163
"2011","County Durham 038C","E01020687","Total",1427,284,132,152,1143,63,172,269,302,22,87,228
"2011","County Durham 038D","E01020688","Total",1529,213,63,150,1316,144,118,372,296,62,91,233
"2011","County Durham 038E","E01020689","Total",1437,224,85,139,1213,158,138,228,212,116,124,237
"2011","County Durham 041A","E01020694","Total",1451,251,120,131,1200,99,164,248,276,68,107,238
"2011","County Durham 041B","E01020696","Total",1276,225,94,131,1051,49,152,212,272,48,139,179
"2011","County Durham 041C","E01020697","Total",1509,169,56,113,1340,85,122,351,266,107,107,302
"2011","County Durham 041D","E01020732","Total",1732,197,88,109,1535,61,262,397,272,92,150,301
"2011","County Durham 044A","E01020695","Total",1782,247,101,146,1535,113,210,358,364,77,147,266
"2011","County Durham 044B","E01020698","Total",1594,152,45,107,1442,38,156,491,290,92,98,277
"2011","County Durham 044C","E01020699","Total",1172,160,70,90,1012,112,140,205,186,82,117,170
"2011","County Durham 044D","E01020700","Total",1563,251,117,134,1312,90,188,277,238,69,192,258
"2011","County Durham 044E","E01020701","Total",1345,188,107,81,1157,55,156,307,238,52,99,250
"2011","County Durham 016A","E01020750","Total",1247,126,75,51,1121,33,188,194,224,25,135,322
"2011","County Durham 016B","E01020781","Total",1064,165,100,65,899,53,150,158,200,20,137,181
"2011","County Durham 016D","E01020786","Total",1606,130,65,65,1476,33,250,340,294,20,144,395
"2011","County Durham 016E","E01020787","Total",1803,281,141,140,1522,143,150,294,312,60,250,313
"2011","County Durham 016F","E01033163","Total",1972,198,64,134,1774,74,130,684,420,118,107,241
"2011","County Durham 016G","E01033202","Total",1166,163,75,88,1003,103,150,258,164,26,95,207
"2011","County Durham 017A","E01020740","Total",1399,131,53,78,1268,68,130,329,208,72,116,345
"2011","County Durham 017B","E01020741","Total",1240,159,41,118,1081,107,82,222,204,48,119,299
"2011","County Durham 017C","E01020742","Total",1656,203,74,129,1453,166,124,342,302,87,142,290
"2011","County Durham 017D","E01020782","Total",1100,163,86,77,937,66,144,147,220,21,97,242
"2011","County Durham 017E","E01020783","Total",1347,185,93,92,1162,93,162,249,204,44,112,298
"2011","County Durham 017F","E01020784","Total",1450,357,170,187,1093,98,134,175,200,71,137,278
"2011","County Durham 018A","E01020743","Total",1418,149,52,97,1269,199,80,345,168,114,150,213
"2011","County Durham 018B","E01020747","Total",1248,130,44,86,1118,218,80,193,126,104,149,248
"2011","County Durham 018C","E01020748","Total",1285,130,44,86,1155,112,98,237,164,87,173,284
"2011","County Durham 018D","E01020749","Total",1388,320,182,138,1068,72,322,175,224,21,62,192
"2011","County Durham 018E","E01020773","Total",1385,241,106,135,1144,81,158,232,250,31,148,244
"2011","County Durham 018F","E01020775","Total",1712,287,135,152,1425,198,184,298,248,80,151,266
"2011","County Durham 021C","E01020776","Total",1806,233,143,90,1573,58,286,328,290,45,178,388
"2011","County Durham 021D","E01033161","Total",1507,155,56,99,1352,120,118,371,234,36,171,302
"2011","County Durham 021E","E01033198","Total",1470,174,58,116,1296,136,120,245,286,22,44,443
"2011","County Durham 021F","E01033205","Total",1494,160,58,102,1334,84,166,354,262,52,141,275
"2011","County Durham 021G","E01033206","Total",1525,202,84,118,1323,152,120,332,218,77,173,251
"2011","County Durham 025A","E01020751","Total",1862,247,75,172,1615,171,206,330,298,124,146,340
"2011","County Durham 025B","E01020752","Total",1199,207,77,130,992,232,110,157,208,43,57,185
"2011","County Durham 025C","E01020754","Total",1323,224,133,91,1099,52,210,292,244,21,81,199
"2011","County Durham 025D","E01020756","Total",1348,110,42,68,1238,65,196,287,252,50,145,243
"2011","County Durham 032A","E01020745","Total",1298,198,83,115,1100,119,142,219,220,72,115,213
"2011","County Durham 032B","E01020753","Total",1876,327,169,158,1549,136,176,426,248,57,184,322
"2011","County Durham 032C","E01020757","Total",1089,143,62,81,946,110,72,221,184,74,104,181
"2011","County Durham 032D","E01020758","Total",1441,198,67,131,1243,207,110,294,200,103,108,221
"2011","County Durham 032E","E01020759","Total",1115,143,39,104,972,171,86,176,122,77,147,193
"2011","County Durham 032F","E01020765","Total",1713,221,72,149,1492,180,102,330,250,78,220,332
"2011","County Durham 034A","E01020760","Total",1621,198,112,86,1423,58,216,329,246,87,179,308
"2011","County Durham 034B","E01020761","Total",1291,180,60,120,1111,93,104,246,174,81,155,258
"2011","County Durham 034C","E01020762","Total",1420,252,116,136,1168,182,136,255,170,102,152,171
"2011","County Durham 034D","E01020763","Total",1812,284,103,181,1528,121,178,348,322,90,157,312
"2011","County Durham 036A","E01020764","Total",1370,280,88,192,1090,147,158,169,222,70,102,222
"2011","County Durham 036B","E01020766","Total",1427,242,144,98,1185,66,262,250,252,47,63,245
"2011","County Durham 036C","E01020767","Total",1914,336,121,215,1578,231,160,309,266,66,225,321
"2011","County Durham 036D","E01020768","Total",1591,162,76,86,1429,144,196,336,226,82,175,270
"2011","County Durham 035A","E01020733","Total",1251,121,57,64,1130,127,92,236,208,63,173,231
"2011","County Durham 035B","E01020734","Total",1225,131,62,69,1094,165,98,262,176,41,105,247
"2011","County Durham 035C","E01020735","Total",1416,207,116,91,1209,69,162,336,196,52,152,242
"2011","County Durham 035D","E01020770","Total",1228,132,58,74,1096,96,102,261,170,67,136,264
"2011","County Durham 035E","E01020771","Total",1049,148,66,82,901,77,128,178,140,53,153,172
"2011","County Durham 035F","E01020780","Total",1167,152,73,79,1015,96,148,189,166,74,148,194
"2011","County Durham 037A","E01020746","Total",1101,142,72,70,959,45,178,188,164,43,105,236
"2011","County Durham 037B","E01020769","Total",1268,92,43,49,1176,75,122,254,180,105,189,251
"2011","County Durham 037C","E01020777","Total",1467,267,113,154,1200,141,136,227,184,80,134,298
"2011","County Durham 037D","E01020778","Total",1196,107,40,67,1089,47,186,175,264,36,130,251
"2011","County Durham 037E","E01020779","Total",1657,103,35,68,1554,41,216,345,320,41,166,425
"2011","County Durham 039A","E01020736","Total",1204,155,65,90,1049,79,140,235,198,82,125,190
"2011","County Durham 039B","E01020737","Total",1355,155,86,69,1200,74,192,245,262,55,125,247
"2011","County Durham 039C","E01020738","Total",1013,166,89,77,847,46,186,160,168,11,60,216
"2011","County Durham 039D","E01020739","Total",1325,297,137,160,1028,107,176,226,222,73,82,142
"2011","County Durham 039E","E01020744","Total",1007,128,68,60,879,64,182,166,142,31,69,225
"2011","County Durham 040A","E01020788","Total",1530,206,97,109,1324,132,154,235,244,74,179,306
"2011","County Durham 040B","E01020789","Total",1398,205,105,100,1193,91,176,279,236,68,79,264
"2011","County Durham 040C","E01020790","Total",1328,195,72,123,1133,134,168,264,162,93,103,209
"2011","County Durham 040D","E01020791","Total",1299,196,92,104,1103,85,156,225,186,39,137,275
"2011","County Durham 040E","E01020792","Total",1431,186,75,111,1245,70,130,272,242,105,164,262
"2011","County Durham 043A","E01020772","Total",1993,227,98,129,1766,65,246,450,362,88,173,382
"2011","County Durham 043B","E01020793","Total",1707,254,119,135,1453,143,144,288,276,110,161,331
"2011","County Durham 043C","E01020794","Total",1780,173,89,84,1607,73,176,480,324,56,145,353
"2011","County Durham 043D","E01020795","Total",1770,220,74,146,1550,156,140,404,316,112,138,284
"2011","County Durham 047A","E01020817","Total",1279,127,43,84,1152,26,138,275,262,20,74,357
"2011","County Durham 047B","E01020818","Total",1477,220,121,99,1257,100,210,268,232,74,119,254
"2011","County Durham 047C","E01020819","Total",1078,187,111,76,891,105,124,181,158,40,93,190
"2011","County Durham 047D","E01020837","Total",1734,154,70,84,1580,46,296,409,378,40,125,286
"2011","County Durham 047E","E01020843","Total",1613,204,109,95,1409,51,214,382,344,51,142,225
"2011","County Durham 048A","E01020809","Total",1435,211,95,116,1224,121,140,288,180,72,142,281
"2011","County Durham 048B","E01020810","Total",1310,152,63,89,1158,68,130,241,212,73,151,283
"2011","County Durham 048C","E01020811","Total",1278,162,78,84,1116,102,144,258,220,87,119,186
"2011","County Durham 048D","E01020812","Total",1523,189,100,89,1334,78,204,287,256,72,139,298
"2011","County Durham 048E","E01020827","Total",1805,222,109,113,1583,113,202,350,312,105,161,340
"2011","County Durham 049A","E01020806","Total",1416,196,96,100,1220,94,180,256,228,80,151,231
"2011","County Durham 049B","E01020807","Total",1323,297,55,242,1026,144,106,197,214,47,107,211
"2011","County Durham 049C","E01020820","Total",1516,292,151,141,1224,105,208,282,212,91,191,135
"2011","County Durham 049D","E01020842","Total",2013,334,103,231,1679,183,170,379,292,147,184,324
"2011","County Durham 050A","E01020797","Total",2467,447,177,270,2020,179,372,396,412,102,160,399
"2011","County Durham 050B","E01020798","Total",1484,297,170,127,1187,98,260,239,202,56,97,235
"2011","County Durham 050C","E01020799","Total",1470,246,110,136,1224,77,142,307,256,65,124,253
"2011","County Durham 050D","E01020808","Total",1371,233,110,123,1138,55,228,187,234,42,103,289
"2011","County Durham 052A","E01020821","Total",1870,160,63,97,1710,93,212,491,304,103,188,319
"2011","County Durham 052B","E01020822","Total",1834,192,83,109,1642,41,252,372,416,68,149,344
"2011","County Durham 052C","E01020823","Total",1764,321,178,143,1443,158,190,307,322,71,123,272
"2011","County Durham 052D","E01020835","Total",1626,196,65,131,1430,124,120,375,296,59,150,306
"2011","County Durham 052E","E01020836","Total",1964,351,141,210,1613,146,202,397,352,98,166,252
"2011","County Durham 053B","E01020803","Total",1939,230,82,148,1709,90,204,404,336,71,203,401
"2011","County Durham 053D","E01020805","Total",1981,364,190,174,1617,193,272,385,276,114,150,227
"2011","County Durham 053E","E01033203","Total",2805,381,120,261,2424,218,300,608,484,105,253,456
"2011","County Durham 054A","E01020796","Total",1275,160,84,76,1115,43,150,278,252,46,105,241
"2011","County Durham 054B","E01020828","Total",1600,121,61,60,1479,36,310,301,320,71,141,300
"2011","County Durham 054C","E01020829","Total",2436,260,92,168,2176,89,322,742,440,119,154,310
"2011","County Durham 054D","E01020830","Total",1510,270,179,91,1240,60,258,267,256,47,124,228
"2011","County Durham 059A","E01020801","Total",1544,231,108,123,1313,109,172,288,304,51,103,286
"2011","County Durham 059B","E01020802","Total",1989,371,172,199,1618,161,186,434,310,109,105,313
"2011","County Durham 059C","E01020838","Total",1730,289,114,175,1441,113,218,300,298,89,98,325
"2011","County Durham 059D","E01020839","Total",1637,305,165,140,1332,131,214,256,220,68,109,334
"2011","County Durham 059E","E01020840","Total",1576,246,98,148,1330,150,204,258,246,73,181,218
"2011","County Durham 059F","E01020841","Total",1763,335,129,206,1428,240,128,283,280,111,148,238
"2011","County Durham 060A","E01020813","Total",1245,89,31,58,1156,38,170,297,272,81,106,192
"2011","County Durham 060B","E01020814","Total",1412,174,57,117,1238,79,82,329,304,68,148,228
"2011","County Durham 060C","E01020815","Total",1218,99,34,65,1119,83,188,215,248,64,99,222
"2011","County Durham 060D","E01020848","Total",1113,154,56,98,959,68,144,219,240,66,80,142
"2011","County Durham 060E","E01020850","Total",1926,83,10,73,1843,72,124,621,342,97,228,359
"2011","County Durham 060F","E01020851","Total",1421,163,66,97,1258,50,258,270,280,38,122,240
"2011","County Durham 061A","E01020816","Total",1472,161,50,111,1311,189,104,322,196,179,172,149
"2011","County Durham 061B","E01020844","Total",1584,207,81,126,1377,198,168,383,218,115,126,169
"2011","County Durham 061C","E01020847","Total",1568,154,44,110,1414,212,98,305,222,172,216,189
"2011","County Durham 061D","E01020849","Total",1215,169,36,133,1046,171,66,181,186,85,139,218
"2011","County Durham 062A","E01020825","Total",1564,258,141,117,1306,72,202,260,240,64,203,265
"2011","County Durham 062B","E01020831","Total",1399,233,129,104,1166,138,170,239,224,81,101,213
"2011","County Durham 062C","E01020833","Total",1195,124,70,54,1071,86,184,226,162,48,125,240
"2011","County Durham 062D","E01020834","Total",1283,213,93,120,1070,157,156,226,198,76,59,198
"2011","County Durham 063A","E01020824","Total",1544,300,165,135,1244,108,226,299,258,52,89,212
"2011","County Durham 063B","E01020826","Total",1510,213,122,91,1297,75,212,227,222,96,138,327
"2011","County Durham 063C","E01020832","Total",1392,193,114,79,1199,62,264,213,232,55,105,268
"2011","County Durham 063D","E01020845","Total",1351,207,108,99,1144,137,168,197,248,30,100,264
"2011","County Durham 063E","E01020846","Total",1237,120,61,59,1117,53,220,198,224,22,132,268
"2011","County Durham 064A","E01020856","Total",1530,254,110,144,1276,91,222,288,280,68,99,228
"2011","County Durham 064B","E01020858","Total",1028,164,85,79,864,55,128,209,178,50,90,154
"2011","County Durham 064C","E01020859","Total",1208,147,68,79,1061,50,188,208,234,40,137,204
"2011","County Durham 064D","E01020860","Total",1008,172,55,117,836,107,80,159,210,31,100,149
"2011","County Durham 064E","E01020861","Total",1169,188,94,94,981,44,188,205,196,20,128,200
"2011","County Durham 064F","E01020862","Total",2391,318,164,154,2073,81,434,421,502,138,152,345
"2011","County Durham 064G","E01020864","Total",2068,263,126,137,1805,52,280,387,432,118,137,399
"2011","County Durham 064H","E01020867","Total",2206,271,153,118,1935,125,300,419,366,190,199,336
"2011","County Durham 065A","E01020857","Total",1520,152,78,74,1368,96,234,268,276,103,162,229
"2011","County Durham 065B","E01020863","Total",1385,124,51,73,1261,31,204,310,286,32,104,294
"2011","County Durham 065C","E01020865","Total",1324,226,116,110,1098,41,248,223,266,50,90,180
"2011","County Durham 065D","E01020866","Total",996,163,69,94,833,30,162,133,184,41,69,214
"2011","County Durham 066A","E01020852","Total",1494,382,192,190,1112,61,278,215,268,36,102,152
"2011","County Durham 066B","E01020853","Total",1426,210,111,99,1216,53,216,282,226,62,106,271
"2011","County Durham 066C","E01020854","Total",2118,333,130,203,1785,87,302,409,398,76,163,350
"2011","County Durham 066D","E01020855","Total",1202,163,109,54,1039,58,256,178,200,38,117,192
"2011","County Durham 042A","E01020889","Total",1478,237,114,123,1241,25,242,251,308,65,112,238
"2011","County Durham 042B","E01020890","Total",1733,263,128,135,1470,82,256,344,294,76,115,303
"2011","County Durham 042C","E01020891","Total",1612,245,112,133,1367,72,258,238,304,36,137,322
"2011","County Durham 042D","E01020905","Total",1530,241,129,112,1289,90,244,298,264,56,124,213
"2011","County Durham 042E","E01020906","Total",1663,183,84,99,1480,48,284,339,310,72,177,250
"2011","County Durham 045A","E01020876","Total",1733,250,124,126,1483,115,182,444,280,68,109,285
"2011","County Durham 045B","E01020878","Total",1721,233,101,132,1488,136,166,361,212,149,177,287
"2011","County Durham 045C","E01020887","Total",1881,235,105,130,1646,93,208,392,356,87,147,363
"2011","County Durham 045D","E01020892","Total",1104,173,85,88,931,55,148,189,154,57,116,212
"2011","County Durham 045E","E01020894","Total",1219,162,73,89,1057,90,120,251,176,137,102,181
"2011","County Durham 045F","E01020898","Total",1531,301,132,169,1230,183,156,217,214,133,131,196
"2011","County Durham 046A","E01020877","Total",1502,261,94,167,1241,117,204,237,314,26,102,241
"2011","County Durham 046B","E01020879","Total",2146,296,124,172,1850,107,298,465,436,108,140,296
"2011","County Durham 046C","E01020893","Total",1637,228,85,143,1409,107,162,334,332,65,120,289
"2011","County Durham 046D","E01020899","Total",1292,231,101,130,1061,70,182,211,290,26,59,223
"2011","County Durham 046E","E01020903","Total",1157,151,51,100,1006,45,124,304,230,47,88,168
"2011","County Durham 046F","E01020904","Total",1755,222,84,138,1533,93,188,448,312,79,154,259
"2011","County Durham 051A","E01020873","Total",1453,240,107,133,1213,202,142,223,244,68,115,219
"2011","County Durham 051B","E01020875","Total",1301,152,64,88,1149,72,138,225,286,52,142,234
"2011","County Durham 051C","E01020900","Total",1407,147,63,84,1260,63,152,348,232,84,127,254
"2011","County Durham 051D","E01020901","Total",1300,275,132,143,1025,92,170,213,206,58,101,185
"2011","County Durham 051E","E01020902","Total",1448,222,90,132,1226,191,158,230,214,76,133,224
"2011","County Durham 055A","E01020868","Total",1756,334,151,183,1422,84,212,319,392,51,106,258
"2011","County Durham 055B","E01020869","Total",1360,232,71,161,1128,98,116,264,228,34,134,254
"2011","County Durham 055C","E01020874","Total",1438,215,71,144,1223,114,156,260,216,53,164,260
"2011","County Durham 055D","E01020880","Total",1561,234,81,153,1327,161,88,253,280,78,141,326
"2011","County Durham 055E","E01020881","Total",1290,165,57,108,1125,67,196,280,220,46,98,218
"2011","County Durham 056A","E01020870","Total",1360,140,91,49,1220,23,364,227,202,30,131,243
"2011","County Durham 056B","E01020871","Total",1411,202,69,133,1209,136,202,244,198,79,135,215
"2011","County Durham 056C","E01020872","Total",1692,305,152,153,1387,105,218,327,308,107,84,238
"2011","County Durham 056D","E01020883","Total",1711,139,52,87,1572,47,204,453,306,41,177,344
"2011","County Durham 056E","E01020886","Total",1257,175,62,113,1082,114,124,251,238,82,96,177
"2011","County Durham 057A","E01020882","Total",1460,193,76,117,1267,110,162,225,254,57,139,320
"2011","County Durham 057B","E01020888","Total",1957,227,91,136,1730,100,184,451,394,77,205,319
"2011","County Durham 057C","E01020895","Total",1457,260,91,169,1197,163,112,271,272,58,89,232
"2011","County Durham 057D","E01020896","Total",1380,198,87,111,1182,97,242,206,198,90,127,222
"2011","County Durham 057E","E01020897","Total",2443,306,113,193,2137,282,170,558,516,138,200,273
"2011","County Durham 058A","E01020884","Total",1365,222,98,124,1143,107,184,237,230,45,107,233
"2011","County Durham 058B","E01020885","Total",1143,197,92,105,946,73,166,205,180,56,95,171
"2011","County Durham 058C","E01020907","Total",1608,229,96,133,1379,173,136,265,240,69,213,283
"2011","County Durham 058D","E01020908","Total",1404,178,57,121,1226,146,110,276,214,60,144,276
"2011","County Durham 058E","E01020909","Total",1681,285,97,188,1396,340,82,291,208,149,122,204
"2011","Hartlepool 001A","E01011954","Total",2171,301,120,181,1870,212,204,517,296,88,194,359
"2011","Hartlepool 001B","E01011969","Total",1373,138,76,62,1235,40,272,253,256,47,91,276
"2011","Hartlepool 001C","E01011970","Total",1156,80,33,47,1076,49,126,246,224,35,158,238
"2011","Hartlepool 001D","E01011971","Total",1452,86,20,66,1366,64,86,494,222,126,207,167
"2011","Hartlepool 001F","E01033465","Total",1754,141,37,104,1613,89,98,455,396,104,182,289
"2011","Hartlepool 001G","E01033467","Total",1178,284,188,96,894,107,164,210,164,63,61,125
"2011","Hartlepool 002A","E01011952","Total",1581,241,113,128,1340,163,148,298,224,98,206,203
"2011","Hartlepool 002B","E01011953","Total",1886,268,95,173,1618,252,112,332,264,149,244,265
"2011","Hartlepool 002C","E01011991","Total",1821,286,130,156,1535,85,216,265,254,92,256,367
"2011","Hartlepool 002D","E01011992","Total",1582,233,77,156,1349,184,114,326,292,75,129,229
"2011","Hartlepool 002E","E01011993","Total",1775,372,144,228,1403,192,154,299,214,88,175,281
"2011","Hartlepool 002F","E01011994","Total",1478,279,107,172,1199,194,134,242,196,124,126,183
"2011","Hartlepool 003A","E01011955","Total",1357,224,58,166,1133,169,98,219,190,96,135,226
"2011","Hartlepool 003C","E01011957","Total",1317,174,55,119,1143,107,114,263,226,48,192,193
"2011","Hartlepool 003G","E01032540","Total",999,124,51,73,875,73,98,262,198,18,83,143
"2011","Hartlepool 003H","E01032541","Total",2138,366,204,162,1772,164,268,455,254,74,192,365
"2011","Hartlepool 003I","E01033466","Total",1982,312,117,195,1670,280,164,313,254,118,210,331
"2011","Hartlepool 005A","E01011973","Total",1320,304,67,237,1016,207,64,168,208,124,86,159
"2011","Hartlepool 005B","E01011974","Total",1684,489,82,407,1195,119,80,145,414,80,142,215
"2011","Hartlepool 005C","E01011975","Total",1324,301,81,220,1023,138,88,261,238,67,40,191
"2011","Hartlepool 005D","E01011976","Total",1026,200,59,141,826,109,80,144,184,71,102,136
"2011","Hartlepool 006A","E01011965","Total",1621,115,67,48,1506,40,242,384,236,83,194,327
"2011","Hartlepool 006B","E01011966","Total",1363,231,89,142,1132,78,152,235,250,45,120,252
"2011","Hartlepool 006C","E01011983","Total",1666,104,59,45,1562,24,230,360,252,125,212,359
"2011","Hartlepool 006D","E01012002","Total",1378,181,99,82,1197,86,168,288,238,32,115,270
"2011","Hartlepool 007A","E01011951","Total",1391,296,72,224,1095,225,76,224,226,48,133,163
"2011","Hartlepool 007B","E01011964","Total",1440,174,66,108,1266,63,108,197,152,140,339,267
"2011","Hartlepool 007C","E01011967","Total",1461,125,49,76,1336,102,92,264,204,104,226,344
"2011","Hartlepool 007D","E01011999","Total",2128,413,143,270,1715,276,130,293,302,167,265,282
"2011","Hartlepool 007E","E01012000","Total",1357,467,133,334,890,155,142,155,192,78,77,91
"2011","Hartlepool 008A","E01011950","Total",1435,365,84,281,1070,180,92,205,266,26,105,196
"2011","Hartlepool 008B","E01011986","Total",1274,122,63,59,1152,85,148,232,236,36,157,258
"2011","Hartlepool 008C","E01011987","Total",1399,208,68,140,1191,137,130,282,258,64,96,224
"2011","Hartlepool 008D","E01012001","Total",1949,361,127,234,1588,231,132,371,312,86,179,277
"2011","Hartlepool 009A","E01011949","Total",1942,203,96,107,1739,215,194,362,270,120,237,341
"2011","Hartlepool 009B","E01011980","Total",1701,354,177,177,1347,163,192,314,186,85,135,272
"2011","Hartlepool 009C","E01011981","Total",1613,250,143,107,1363,190,156,255,194,87,236,245
"2011","Hartlepool 009D","E01011984","Total",1250,190,151,39,1060,42,234,196,206,37,98,247
"2011","Hartlepool 010A","E01011985","Total",1126,141,63,78,985,49,158,242,222,45,55,214
"2011","Hartlepool 010B","E01011988","Total",1852,330,161,169,1522,142,170,380,296,96,142,296
"2011","Hartlepool 010C","E01011989","Total",1877,302,125,177,1575,232,158,281,282,151,208,263
"2011","Hartlepool 010D","E01011990","Total",1718,204,107,97,1514,113,136,339,304,84,210,328
"2011","Hartlepool 011A","E01011995","Total",1429,129,86,43,1300,36,260,248,198,95,179,284
"2011","Hartlepool 011B","E01011996","Total",1420,227,107,120,1193,83,188,230,268,42,125,257
"2011","Hartlepool 011C","E01011997","Total",2041,162,78,84,1879,119,218,466,366,116,179,415
"2011","Hartlepool 011D","E01011998","Total",1436,190,135,55,1246,56,206,250,252,72,128,282
"2011","Hartlepool 012A","E01011961","Total",1442,179,75,104,1263,145,200,281,178,64,154,241
"2011","Hartlepool 012B","E01011962","Total",1456,180,92,88,1276,141,168,294,174,122,116,261
"2011","Hartlepool 012C","E01011977","Total",1748,221,61,160,1527,294,102,293,264,68,196,310
"2011","Hartlepool 012D","E01011978","Total",1508,385,136,249,1123,294,86,181,162,113,122,165
"2011","Hartlepool 012E","E01011979","Total",1521,185,60,125,1336,223,98,311,194,86,170,254
"2011","Hartlepool 014A","E01011959","Total",2023,191,106,85,1832,50,258,406,358,118,246,396
"2011","Hartlepool 014B","E01011960","Total",1394,147,103,44,1247,25,310,215,228,21,158,290
"2011","Hartlepool 014C","E01011963","Total",1418,196,115,81,1222,51,260,241,256,36,122,256
"2011","Hartlepool 014D","E01011968","Total",2096,277,155,122,1819,119,312,317,432,69,215,355
"2011","Hartlepool 014E","E01011982","Total",1300,112,72,40,1188,20,264,284,192,55,131,242
"2011","Hartlepool 014F","E01012003","Total",1541,172,82,90,1369,45,266,250,244,84,171,309
"2011","Hartlepool 014G","E01012005","Total",2023,100,25,75,1923,68,102,740,298,62,308,345
"2011","Middlesbrough 001A","E01012068","Total",1883,287,33,254,1596,143,42,212,322,162,141,574
"2011","Middlesbrough 001D","E01012092","Total",1623,246,77,169,1377,130,52,198,168,135,267,427
"2011","Middlesbrough 001E","E01012093","Total",1975,214,42,172,1761,146,28,224,260,348,308,447
"2011","Middlesbrough 001F","E01012094","Total",2571,304,64,240,2267,151,70,326,368,278,498,576
"2011","Middlesbrough 001G","E01033468","Total",2525,710,174,536,1815,129,102,254,302,248,316,464
"2011","Middlesbrough 002A","E01012058","Total",1625,292,68,224,1333,211,86,246,350,77,140,223
"2011","Middlesbrough 002B","E01012059","Total",1497,299,114,185,1198,174,122,226,244,62,155,215
"2011","Middlesbrough 002C","E01012060","Total",1683,214,87,127,1469,323,82,311,200,153,161,239
"2011","Middlesbrough 002D","E01012061","Total",1463,211,97,114,1252,214,108,212,202,181,131,204
"2011","Middlesbrough 003A","E01012036","Total",1534,192,42,150,1342,127,60,160,206,73,263,453
"2011","Middlesbrough 003B","E01012037","Total",1540,253,74,179,1287,214,66,276,220,76,151,284
"2011","Middlesbrough 003C","E01012038","Total",1506,234,51,183,1272,187,92,254,228,99,150,262
"2011","Middlesbrough 003D","E01012039","Total",1510,217,56,161,1293,65,44,154,234,93,101,602
"2011","Middlesbrough 003E","E01012040","Total",1466,198,41,157,1268,160,50,266,252,107,143,290
"2011","Middlesbrough 003F","E01012041","Total",1027,367,137,230,660,100,86,81,172,16,75,130
"2011","Middlesbrough 004A","E01012074","Total",1550,191,107,84,1359,189,100,277,198,103,236,256
"2011","Middlesbrough 004B","E01012075","Total",1557,163,72,91,1394,294,130,314,130,86,148,292
"2011","Middlesbrough 004C","E01012076","Total",1551,154,81,73,1397,374,88,246,174,115,183,217
"2011","Middlesbrough 004D","E01012077","Total",1363,213,108,105,1150,133,150,148,170,71,174,304
"2011","Middlesbrough 004E","E01012088","Total",1411,141,77,64,1270,223,80,239,118,175,191,244
"2011","Middlesbrough 005A","E01012078","Total",1450,242,45,197,1208,164,62,204,280,87,147,264
"2011","Middlesbrough 005B","E01012079","Total",1387,114,57,57,1273,63,124,237,174,147,225,303
"2011","Middlesbrough 005C","E01012080","Total",1269,151,62,89,1118,62,116,176,166,109,200,289
"2011","Middlesbrough 005D","E01012081","Total",1681,229,84,145,1452,83,114,239,236,176,305,299
"2011","Middlesbrough 006A","E01012026","Total",1571,157,75,82,1414,79,128,267,252,137,199,352
"2011","Middlesbrough 006B","E01012027","Total",1691,335,110,225,1356,196,92,290,270,99,170,239
"2011","Middlesbrough 006E","E01033469","Total",1998,236,90,146,1762,257,158,379,238,128,242,360
"2011","Middlesbrough 007A","E01012015","Total",1501,295,153,142,1206,115,158,215,192,68,149,309
"2011","Middlesbrough 007B","E01012016","Total",1650,323,112,211,1327,228,134,285,234,95,122,229
"2011","Middlesbrough 007C","E01012017","Total",1573,224,130,94,1349,104,282,200,252,46,139,326
"2011","Middlesbrough 007D","E01012089","Total",1549,177,69,108,1372,228,94,195,164,139,269,283
"2011","Middlesbrough 007E","E01012090","Total",1546,322,72,250,1224,175,72,229,208,96,231,213
"2011","Middlesbrough 007F","E01012091","Total",1740,152,59,93,1588,310,86,272,190,218,297,215
"2011","Middlesbrough 008A","E01012011","Total",1861,211,85,126,1650,287,176,294,224,71,326,272
"2011","Middlesbrough 008B","E01012012","Total",1791,136,67,69,1655,106,144,324,174,135,378,394
"2011","Middlesbrough 008C","E01012013","Total",1307,157,66,91,1150,107,94,268,202,100,125,254
"2011","Middlesbrough 008D","E01012014","Total",1544,133,52,81,1411,219,100,292,262,103,185,250
"2011","Middlesbrough 009A","E01012053","Total",1680,154,74,80,1526,36,172,278,198,164,295,383
"2011","Middlesbrough 009B","E01012054","Total",1760,130,53,77,1630,84,124,316,194,183,331,398
"2011","Middlesbrough 009C","E01012055","Total",1928,176,92,84,1752,48,218,290,290,106,394,406
"2011","Middlesbrough 009D","E01012056","Total",2304,301,62,239,2003,219,102,433,460,196,199,394
"2011","Middlesbrough 009E","E01012057","Total",1953,190,71,119,1763,99,150,394,298,176,284,362
"2011","Middlesbrough 010A","E01012082","Total",1576,164,85,79,1412,230,108,231,184,106,178,375
"2011","Middlesbrough 010B","E01012083","Total",1555,147,70,77,1408,249,106,339,202,73,181,258
"2011","Middlesbrough 010C","E01012084","Total",1650,230,109,121,1420,285,94,248,182,83,241,287
"2011","Middlesbrough 010D","E01012085","Total",1443,140,50,90,1303,222,128,245,198,74,189,247
"2011","Middlesbrough 011A","E01012018","Total",1379,291,78,213,1088,126,108,210,240,51,155,198
"2011","Middlesbrough 011B","E01012019","Total",1296,209,92,117,1087,252,112,224,150,100,129,120
"2011","Middlesbrough 011C","E01012020","Total",1558,192,80,112,1366,162,118,298,156,147,199,286
"2011","Middlesbrough 011D","E01012021","Total",1380,143,62,81,1237,203,94,260,164,100,246,170
"2011","Middlesbrough 012A","E01012007","Total",1485,214,147,67,1271,48,284,199,190,87,166,297
"2011","Middlesbrough 012B","E01012008","Total",1421,116,68,48,1305,72,142,297,182,87,218,307
"2011","Middlesbrough 012C","E01012009","Total",1757,229,94,135,1528,62,180,391,340,64,217,274
"2011","Middlesbrough 012D","E01012010","Total",1358,116,74,42,1242,28,208,205,198,94,178,331
"2011","Middlesbrough 013A","E01012046","Total",1727,297,191,106,1430,61,328,181,240,75,171,374
"2011","Middlesbrough 013B","E01012047","Total",1610,126,85,41,1484,66,186,318,136,163,292,323
"2011","Middlesbrough 013C","E01012048","Total",1734,184,133,51,1550,39,312,241,238,114,237,369
"2011","Middlesbrough 014A","E01012049","Total",1414,197,86,111,1217,62,158,245,260,54,133,305
"2011","Middlesbrough 014B","E01012050","Total",1472,214,122,92,1258,211,108,307,158,91,117,266
"2011","Middlesbrough 014C","E01012051","Total",1364,133,62,71,1231,181,114,215,162,103,213,243
"2011","Middlesbrough 014D","E01012052","Total",1293,153,62,91,1140,61,144,188,212,67,184,284
"2011","Middlesbrough 015A","E01012022","Total",1518,165,69,96,1353,60,106,294,286,48,170,389
"2011","Middlesbrough 015B","E01012023","Total",1372,228,156,72,1144,34,426,91,228,30,98,237
"2011","Middlesbrough 015C","E01012024","Total",1525,162,100,62,1363,96,258,268,202,39,137,363
"2011","Middlesbrough 015D","E01012025","Total",1297,114,64,50,1183,26,160,248,194,50,176,329
"2011","Middlesbrough 017A","E01012065","Total",1662,204,115,89,1458,86,352,349,286,62,91,232
"2011","Middlesbrough 017B","E01012066","Total",2001,105,21,84,1896,79,100,621,316,128,269,383
"2011","Middlesbrough 017C","E01012067","Total",1602,208,142,66,1394,30,350,253,264,65,126,306
"2011","Middlesbrough 018A","E01012042","Total",1449,341,118,223,1108,125,126,237,226,67,122,205
"2011","Middlesbrough 018B","E01012043","Total",1452,164,96,68,1288,58,254,244,206,50,172,304
"2011","Middlesbrough 018C","E01012044","Total",1574,189,38,151,1385,245,86,297,200,164,197,196
"2011","Middlesbrough 018D","E01012045","Total",1471,185,75,110,1286,256,58,278,200,115,174,205
"2011","Middlesbrough 018G","E01032552","Total",1585,155,51,104,1430,123,72,372,260,121,179,303
"2011","Middlesbrough 018H","E01032553","Total",1214,208,115,93,1006,23,268,204,240,30,69,172
"2011","Middlesbrough 019A","E01012030","Total",1466,193,106,87,1273,44,124,327,250,66,172,290
"2011","Middlesbrough 019B","E01012031","Total",1559,305,108,197,1254,93,176,300,298,70,101,216
"2011","Middlesbrough 019C","E01012032","Total",1735,84,18,66,1651,66,82,496,290,117,240,360
"2011","Middlesbrough 019D","E01012033","Total",1224,326,136,190,898,98,108,152,188,31,105,216
"2011","Middlesbrough 019E","E01012034","Total",1501,94,30,64,1407,91,90,319,258,98,248,303
"2011","Middlesbrough 019F","E01012035","Total",1341,243,128,115,1098,84,134,191,198,73,169,249
"2011","Middlesbrough 020A","E01012062","Total",1477,140,84,56,1337,59,250,253,242,77,171,285
"2011","Middlesbrough 020B","E01012063","Total",1413,181,119,62,1232,42,220,285,288,57,87,253
"2011","Middlesbrough 020C","E01012064","Total",1835,216,85,131,1619,94,196,342,324,147,192,324
"2011","Middlesbrough 020D","E01012071","Total",1472,84,65,19,1388,18,322,253,214,81,203,297
"2011","Middlesbrough 020E","E01012073","Total",1424,143,72,71,1281,34,260,254,212,79,149,293
"2011","Middlesbrough 020F","E01032593","Total",1921,131,87,44,1790,34,266,410,260,105,258,457
"2011","Northumberland 004A","E01027356","Total",1708,226,123,103,1482,22,392,265,338,66,111,288
"2011","Northumberland 004B","E01027357","Total",1228,103,68,35,1125,13,248,206,228,80,141,209
"2011","Northumberland 004C","E01027366","Total",1494,208,105,103,1286,48,330,192,328,66,148,174
"2011","Northumberland 004D","E01027367","Total",1740,135,67,68,1605,76,202,606,262,135,150,174
"2011","Northumberland 005A","E01027358","Total",1980,434,218,216,1546,57,256,334,360,50,127,362
"2011","Northumberland 005B","E01027359","Total",2270,276,112,164,1994,187,188,432,320,247,255,365
"2011","Northumberland 005D","E01033715","Total",1031,291,124,167,740,47,162,158,186,15,72,100
"2011","Northumberland 005E","E01033717","Total",1383,212,73,139,1171,51,160,324,288,52,157,139
"2011","Northumberland 006A","E01027361","Total",2067,350,162,188,1717,118,230,352,372,69,188,388
"2011","Northumberland 006B","E01027362","Total",1259,197,114,83,1062,70,164,253,228,61,92,194
"2011","Northumberland 006C","E01027363","Total",1197,138,88,50,1059,133,158,215,174,89,102,188
"2011","Northumberland 006D","E01027364","Total",2050,243,114,129,1807,94,344,360,358,67,218,366
"2011","Northumberland 006E","E01027370","Total",1837,159,101,58,1678,44,310,284,408,71,184,377
"2011","Northumberland 006F","E01027371","Total",1834,195,98,97,1639,75,230,450,308,163,155,258
"2011","Northumberland 006G","E01027372","Total",2094,263,137,126,1831,39,476,311,480,68,113,344
"2011","Northumberland 007A","E01027365","Total",2166,264,137,127,1902,49,412,334,416,117,229,345
"2011","Northumberland 007B","E01027368","Total",1743,228,116,112,1515,47,258,346,404,88,133,239
"2011","Northumberland 007C","E01027369","Total",1542,218,135,83,1324,29,406,269,296,79,63,182
"2011","Northumberland 007D","E01027373","Total",1987,238,107,131,1749,43,362,297,494,139,187,227
"2011","Northumberland 001A","E01027376","Total",1690,209,120,89,1481,102,208,412,312,101,118,228
"2011","Northumberland 001B","E01027377","Total",1646,427,193,234,1219,52,266,194,362,65,82,198
"2011","Northumberland 001C","E01027385","Total",1266,105,46,59,1161,144,122,278,166,92,144,215
"2011","Northumberland 001D","E01027387","Total",1710,357,146,211,1353,101,240,262,328,74,127,221
"2011","Northumberland 001E","E01027388","Total",1446,188,91,97,1258,145,128,310,258,42,136,239
"2011","Northumberland 001F","E01027389","Total",1582,205,84,121,1377,55,186,365,302,83,160,226
"2011","Northumberland 002A","E01027378","Total",1022,115,62,53,907,19,220,242,190,56,90,90
"2011","Northumberland 002B","E01027379","Total",1374,158,85,73,1216,30,310,252,284,45,124,171
"2011","Northumberland 002C","E01027380","Total",1412,207,119,88,1205,53,230,234,282,61,145,200
"2011","Northumberland 002D","E01027382","Total",1647,251,138,113,1396,54,340,280,346,51,127,198
"2011","Northumberland 002E","E01027386","Total",1354,147,84,63,1207,63,236,256,276,61,164,151
"2011","Northumberland 003A","E01027374","Total",2047,315,172,143,1732,67,380,283,432,101,179,290
"2011","Northumberland 003B","E01027375","Total",1757,233,95,138,1524,52,292,319,406,47,126,282
"2011","Northumberland 003C","E01027381","Total",1848,250,108,142,1598,36,350,318,400,87,149,258
"2011","Northumberland 003D","E01027383","Total",1342,254,153,101,1088,34,288,231,222,50,80,183
"2011","Northumberland 003E","E01027384","Total",1441,263,137,126,1178,44,330,182,278,55,105,184
"2011","Northumberland 003F","E01027390","Total",1961,362,219,143,1599,75,398,293,322,51,141,319
"2011","Northumberland 022A","E01027392","Total",1652,330,144,186,1322,163,166,238,224,157,159,215
"2011","Northumberland 022B","E01027393","Total",1539,178,87,91,1361,145,122,348,208,185,192,161
"2011","Northumberland 022C","E01027416","Total",1525,333,127,206,1192,207,110,346,214,94,89,132
"2011","Northumberland 022D","E01027424","Total",1955,252,89,163,1703,183,178,364,288,149,209,332
"2011","Northumberland 023A","E01027414","Total",1439,215,53,162,1224,108,142,262,252,68,160,232
"2011","Northumberland 023B","E01027415","Total",1573,335,105,230,1238,150,132,267,282,67,90,250
"2011","Northumberland 023C","E01027431","Total",1707,403,114,289,1304,183,150,326,326,48,70,201
"2011","Northumberland 023D","E01027441","Total",2011,319,149,170,1692,104,206,469,372,84,155,302
"2011","Northumberland 023E","E01027442","Total",1579,384,176,208,1195,53,108,282,310,38,147,257
"2011","Northumberland 024A","E01027391","Total",1466,127,60,67,1339,121,148,336,276,98,179,181
"2011","Northumberland 024B","E01027422","Total",1845,304,132,172,1541,133,204,388,280,160,179,197
"2011","Northumberland 024C","E01027423","Total",1515,179,103,76,1336,81,206,272,246,111,167,253
"2011","Northumberland 024D","E01027429","Total",1841,347,182,165,1494,192,186,359,304,82,115,256
"2011","Northumberland 024E","E01027430","Total",1629,211,113,98,1418,135,226,327,234,86,138,272
"2011","Northumberland 025A","E01027425","Total",2279,194,78,116,2085,83,254,504,436,136,260,412
"2011","Northumberland 025B","E01027426","Total",1542,91,22,69,1451,214,90,287,202,197,258,203
"2011","Northumberland 025C","E01027427","Total",1646,346,132,214,1300,186,212,238,262,80,97,225
"2011","Northumberland 025D","E01027428","Total",1543,135,53,82,1408,70,158,277,306,83,191,323
"2011","Northumberland 026A","E01027437","Total",1817,149,68,81,1668,58,256,370,410,47,175,352
"2011","Northumberland 026B","E01027438","Total",1488,143,49,94,1345,79,176,330,264,52,147,297
"2011","Northumberland 026C","E01027439","Total",1954,118,42,76,1836,68,192,581,386,87,174,348
"2011","Northumberland 026D","E01027440","Total",1418,114,66,48,1304,34,210,328,324,37,78,293
"2011","Northumberland 027A","E01027400","Total",1360,64,12,52,1296,57,56,629,226,20,150,158
"2011","Northumberland 027B","E01027401","Total",1500,48,12,36,1452,35,132,577,288,65,125,230
"2011","Northumberland 027C","E01027402","Total",1334,62,14,48,1272,36,112,399,240,46,166,273
"2011","Northumberland 027D","E01027403","Total",1186,75,29,46,1111,27,140,328,318,25,99,174
"2011","Northumberland 029A","E01027398","Total",2301,214,61,153,2087,191,134,463,404,274,275,346
"2011","Northumberland 029B","E01027409","Total",1469,290,133,157,1179,56,284,241,276,37,111,174
"2011","Northumberland 029C","E01027411","Total",1273,236,123,113,1037,89,200,207,240,56,81,164
"2011","Northumberland 029D","E01027412","Total",1527,176,58,118,1351,159,120,322,238,150,144,218
"2011","Northumberland 029E","E01027413","Total",1872,225,80,145,1647,155,210,361,384,91,125,321
"2011","Northumberland 028A","E01027395","Total",1428,258,117,141,1170,107,110,267,296,87,123,180
"2011","Northumberland 028B","E01027396","Total",1392,142,56,86,1250,103,132,298,254,107,161,195
"2011","Northumberland 028C","E01027397","Total",1404,206,135,71,1198,123,188,285,224,46,135,197
"2011","Northumberland 028D","E01027399","Total",1508,100,17,83,1408,42,78,417,392,62,130,287
"2011","Northumberland 028E","E01027404","Total",1461,124,31,93,1337,60,104,336,400,46,149,242
"2011","Northumberland 028F","E01027405","Total",1448,140,58,82,1308,40,222,280,380,15,122,249
"2011","Northumberland 030A","E01027417","Total",1508,199,129,70,1309,41,350,274,258,42,121,223
"2011","Northumberland 030B","E01027418","Total",1841,204,91,113,1637,84,168,480,378,60,116,351
"2011","Northumberland 030C","E01027419","Total",1546,297,171,126,1249,55,278,243,274,30,130,239
"2011","Northumberland 030D","E01027420","Total",1381,148,101,47,1233,46,230,239,292,50,66,310
"2011","Northumberland 030E","E01027421","Total",1470,266,136,130,1204,88,252,273,256,38,82,215
"2011","Northumberland 031A","E01027394","Total",1153,160,59,101,993,43,172,220,244,11,64,239
"2011","Northumberland 031B","E01027406","Total",1284,187,101,86,1097,17,274,183,260,24,73,266
"2011","Northumberland 031C","E01027407","Total",1277,198,72,126,1079,39,186,190,310,15,78,261
"2011","Northumberland 031D","E01027408","Total",1289,250,112,138,1039,101,210,181,224,36,92,195
"2011","Northumberland 031E","E01027410","Total",1614,131,68,63,1483,31,276,375,304,82,141,274
"2011","Northumberland 032A","E01027432","Total",1536,323,97,226,1213,75,180,277,304,88,66,223
"2011","Northumberland 032B","E01027433","Total",1678,270,97,173,1408,111,168,371,314,72,131,241
"2011","Northumberland 032C","E01027434","Total",1400,191,82,109,1209,90,222,269,216,61,76,275
"2011","Northumberland 032D","E01027435","Total",1431,223,88,135,1208,66,194,246,294,74,97,237
"2011","Northumberland 032E","E01027436","Total",1559,185,77,108,1374,73,230,328,262,66,173,242
"2011","Northumberland 008A","E01027443","Total",1483,223,105,118,1260,143,174,314,256,81,114,178
"2011","Northumberland 008B","E01027444","Total",1353,134,61,73,1219,36,196,269,296,86,109,227
"2011","Northumberland 008C","E01027445","Total",1585,161,69,92,1424,57,238,284,334,78,138,295
"2011","Northumberland 008D","E01027446","Total",1367,105,61,44,1262,19,244,237,320,41,106,295
"2011","Northumberland 008E","E01027451","Total",1847,277,139,138,1570,192,168,351,286,130,169,274
"2011","Northumberland 008F","E01027474","Total",1884,267,107,160,1617,156,188,425,374,114,118,242
"2011","Northumberland 008G","E01027475","Total",1392,157,83,74,1235,44,272,228,352,48,113,178
"2011","Northumberland 011A","E01027457","Total",1259,159,69,90,1100,42,164,271,230,81,92,220
"2011","Northumberland 011B","E01027462","Total",1873,351,157,194,1522,108,188,423,280,112,153,258
"2011","Northumberland 011C","E01027463","Total",1706,160,62,98,1546,60,168,492,312,78,100,336
"2011","Northumberland 015A","E01027447","Total",1768,200,83,117,1568,50,236,333,394,120,158,277
"2011","Northumberland 015B","E01027448","Total",1908,153,68,85,1755,51,294,339,354,179,214,324
"2011","Northumberland 015C","E01027450","Total",1645,142,66,76,1503,45,286,375,358,66,159,214
"2011","Northumberland 015D","E01027473","Total",1749,191,104,87,1558,50,276,399,354,93,132,254
"2011","Northumberland 016A","E01027452","Total",1367,230,81,149,1137,57,192,233,268,52,105,230
"2011","Northumberland 016B","E01027453","Total",1424,497,283,214,927,38,214,198,198,74,40,165
"2011","Northumberland 016E","E01027461","Total",1339,202,98,104,1137,159,190,160,202,81,114,231
"2011","Northumberland 016F","E01033718","Total",2084,403,216,187,1681,158,254,352,340,97,156,324
"2011","Northumberland 018A","E01027455","Total",1520,136,86,50,1384,25,300,379,236,67,102,275
"2011","Northumberland 018B","E01027456","Total",1341,73,50,23,1268,11,278,262,206,53,153,305
"2011","Northumberland 018C","E01027458","Total",1556,146,90,56,1410,41,272,285,290,77,179,266
"2011","Northumberland 018D","E01027460","Total",1682,196,107,89,1486,46,302,402,276,80,112,268
"2011","Northumberland 033A","E01027464","Total",1353,240,166,74,1113,28,272,201,176,46,128,262
"2011","Northumberland 033B","E01027465","Total",1485,188,119,69,1297,42,236,280,212,57,175,295
"2011","Northumberland 033C","E01027466","Total",1164,185,115,70,979,73,162,212,142,58,113,219
"2011","Northumberland 033F","E01033714","Total",2391,215,128,87,2176,37,528,412,298,177,309,415
"2011","Northumberland 034A","E01027449","Total",1563,184,119,65,1379,42,326,288,198,68,138,319
"2011","Northumberland 034B","E01027468","Total",1268,87,70,17,1181,15,318,180,172,92,118,286
"2011","Northumberland 034C","E01027469","Total",1464,71,51,20,1393,6,284,312,152,85,253,301
"2011","Northumberland 034D","E01027471","Total",1673,94,60,34,1579,24,356,341,220,115,177,346
"2011","Northumberland 034E","E01027472","Total",1571,135,61,74,1436,43,194,369,268,140,169,253
"2011","Northumberland 019A","E01027479","Total",2310,286,161,125,2024,69,376,447,430,170,166,366
"2011","Northumberland 019B","E01027480","Total",1219,137,50,87,1082,28,180,225,212,56,106,275
"2011","Northumberland 019C","E01027503","Total",1741,204,95,109,1537,30,320,309,422,51,132,273
"2011","Northumberland 019D","E01027511","Total",1105,130,67,63,975,23,188,177,252,49,55,231
"2011","Northumberland 037A","E01027484","Total",2205,241,120,121,1964,65,412,424,380,94,216,373
"2011","Northumberland 037B","E01027485","Total",1488,252,122,130,1236,78,228,250,230,122,79,249
"2011","Northumberland 037C","E01027486","Total",1148,176,92,84,972,67,144,207,192,50,89,223
"2011","Northumberland 037D","E01027487","Total",1146,173,91,82,973,46,158,217,228,66,73,185
"2011","Northumberland 037E","E01027512","Total",1041,135,50,85,906,26,154,171,212,43,78,222
"2011","Northumberland 036A","E01027483","Total",1268,147,58,89,1121,31,170,269,278,66,69,238
"2011","Northumberland 036B","E01027496","Total",1222,154,86,68,1068,58,178,279,180,69,95,209
"2011","Northumberland 036C","E01027508","Total",1086,130,61,69,956,27,124,241,254,56,71,183
"2011","Northumberland 036D","E01027513","Total",1891,230,128,102,1661,61,296,374,348,143,178,261
"2011","Northumberland 035A","E01027476","Total",2300,465,197,268,1835,102,326,420,446,89,118,334
"2011","Northumberland 035B","E01027489","Total",1605,145,69,76,1460,69,216,311,254,91,168,351
"2011","Northumberland 035C","E01027490","Total",1807,277,145,132,1530,125,224,379,266,106,155,275
"2011","Northumberland 035D","E01027491","Total",1557,145,86,59,1412,23,314,256,238,108,170,303
"2011","Northumberland 035E","E01027492","Total",1867,206,105,101,1661,51,276,476,234,151,185,288
"2011","Northumberland 035F","E01027493","Total",1464,236,112,124,1228,132,192,271,216,68,106,243
"2011","Northumberland 035G","E01027494","Total",2157,355,188,167,1802,89,368,398,360,56,161,370
"2011","Northumberland 038A","E01027497","Total",2688,167,57,110,2521,149,202,817,466,205,224,458
"2011","Northumberland 038B","E01027498","Total",2633,371,160,211,2262,223,294,613,394,164,169,405
"2011","Northumberland 038C","E01027499","Total",1465,168,99,69,1297,44,248,247,216,100,133,309
"2011","Northumberland 038D","E01027500","Total",1651,280,134,146,1371,118,186,280,282,112,148,245
"2011","Northumberland 038E","E01027501","Total",1093,120,53,67,973,32,144,239,212,51,61,234
"2011","Northumberland 038F","E01027502","Total",1228,90,39,51,1138,37,118,254,250,46,161,272
"2011","Northumberland 039A","E01027481","Total",1604,310,171,139,1294,46,286,261,276,88,112,225
"2011","Northumberland 039B","E01027482","Total",1515,209,133,76,1306,28,268,231,268,57,138,316
"2011","Northumberland 039C","E01027504","Total",1831,190,91,99,1641,27,418,344,324,78,138,312
"2011","Northumberland 039D","E01027506","Total",1132,104,38,66,1028,22,166,232,228,83,114,183
"2011","Northumberland 039E","E01027507","Total",1386,87,52,35,1299,6,242,291,220,92,143,305
"2011","Northumberland 039F","E01027509","Total",1340,181,114,67,1159,27,248,299,238,55,73,219
"2011","Northumberland 040A","E01027477","Total",1193,136,64,72,1057,21,184,190,240,58,114,250
"2011","Northumberland 040B","E01027478","Total",1063,182,107,75,881,17,182,159,182,62,88,191
"2011","Northumberland 040C","E01027488","Total",2154,250,114,136,1904,91,304,398,448,104,214,345
"2011","Northumberland 040D","E01027495","Total",1075,116,49,67,959,32,212,188,160,85,116,166
"2011","Northumberland 040E","E01027505","Total",1348,118,66,52,1230,31,184,259,278,88,130,260
"2011","Northumberland 040F","E01027510","Total",1161,134,62,72,1027,48,164,278,224,45,89,179
"2011","Northumberland 009A","E01027541","Total",1744,281,111,170,1463,135,254,231,346,83,114,300
"2011","Northumberland 009B","E01027542","Total",1811,307,160,147,1504,227,244,289,250,121,147,226
"2011","Northumberland 009C","E01027543","Total",1344,144,73,71,1200,115,116,280,216,150,131,192
"2011","Northumberland 009D","E01027544","Total",1343,218,100,118,1125,73,224,176,208,60,111,273
"2011","Northumberland 010A","E01027528","Total",1279,240,64,176,1039,124,104,229,220,38,133,191
"2011","Northumberland 010B","E01027529","Total",1142,132,49,83,1010,39,100,211,200,66,115,279
"2011","Northumberland 010C","E01027539","Total",1672,275,92,183,1397,200,164,285,270,86,155,237
"2011","Northumberland 010D","E01027545","Total",2049,307,108,199,1742,257,164,435,346,106,123,311
"2011","Northumberland 010E","E01027546","Total",1734,314,88,226,1420,201,142,346,282,99,114,236
"2011","Northumberland 013A","E01027533","Total",1709,429,156,273,1280,148,218,311,250,92,102,159
"2011","Northumberland 013B","E01027540","Total",1859,289,109,180,1570,215,116,370,328,81,190,270
"2011","Northumberland 013E","E01027549","Total",1566,91,22,69,1475,72,86,466,282,83,158,328
"2011","Northumberland 013F","E01033716","Total",2374,323,144,179,2051,125,362,412,366,159,248,379
"2011","Northumberland 012A","E01027524","Total",1402,183,77,106,1219,105,182,275,278,31,122,226
"2011","Northumberland 012B","E01027525","Total",1670,395,217,178,1275,62,218,296,272,61,151,215
"2011","Northumberland 012C","E01027526","Total",1271,96,51,45,1175,17,190,253,272,32,137,274
"2011","Northumberland 012D","E01027527","Total",1317,215,100,115,1102,127,116,262,222,76,88,211
"2011","Northumberland 012E","E01027536","Total",1462,144,70,74,1318,101,162,235,246,38,131,405
"2011","Northumberland 014A","E01027532","Total",1890,211,75,136,1679,76,232,423,436,32,125,355
"2011","Northumberland 014B","E01027537","Total",1377,214,115,99,1163,72,212,216,210,75,135,243
"2011","Northumberland 014C","E01027538","Total",1800,140,66,74,1660,45,214,470,304,61,185,381
"2011","Northumberland 017A","E01027530","Total",1442,180,57,123,1262,151,138,324,262,108,102,177
"2011","Northumberland 017B","E01027531","Total",1686,202,67,135,1484,99,142,393,344,116,169,221
"2011","Northumberland 017C","E01027534","Total",1909,316,153,163,1593,199,270,355,356,106,132,175
"2011","Northumberland 017D","E01027535","Total",1434,149,96,53,1285,40,370,237,300,41,108,189
"2011","Northumberland 017E","E01027553","Total",1596,223,110,113,1373,84,184,278,346,46,124,311
"2011","Northumberland 017F","E01027554","Total",1336,164,98,66,1172,66,306,220,234,36,78,232
"2011","Northumberland 020A","E01027515","Total",1430,260,105,155,1170,91,140,252,280,72,106,229
"2011","Northumberland 020B","E01027517","Total",1890,307,107,200,1583,71,172,429,382,85,107,337
"2011","Northumberland 020C","E01027518","Total",1469,218,115,103,1251,169,126,268,216,92,147,233
"2011","Northumberland 020D","E01027519","Total",1429,220,86,134,1209,161,108,326,182,93,140,199
"2011","Northumberland 020E","E01027550","Total",1288,197,101,96,1091,109,218,243,202,45,81,193
"2011","Northumberland 020F","E01027551","Total",1437,207,83,124,1230,120,144,258,228,117,149,214
"2011","Northumberland 020G","E01027552","Total",1232,225,79,146,1007,70,126,204,266,50,104,187
"2011","Northumberland 021A","E01027514","Total",1591,188,115,73,1403,67,280,291,282,71,109,303
"2011","Northumberland 021B","E01027516","Total",1156,152,97,55,1004,53,148,212,186,50,111,244
"2011","Northumberland 021C","E01027520","Total",1512,116,52,64,1396,33,192,342,264,96,177,292
"2011","Northumberland 021D","E01027521","Total",1703,91,19,72,1612,51,144,587,282,107,200,241
"2011","Northumberland 021E","E01027522","Total",1285,233,105,128,1052,121,166,224,210,38,88,205
"2011","Northumberland 021F","E01027523","Total",1152,188,83,105,964,98,130,209,174,42,78,233
"2011","Redcar and Cleveland 001A","E01012100","Total",1560,499,96,403,1061,141,88,194,264,29,163,182
"2011","Redcar and Cleveland 001B","E01012101","Total",1442,295,136,159,1147,91,156,211,266,46,120,257
"2011","Redcar and Cleveland 001C","E01012102","Total",2206,351,83,268,1855,310,148,486,432,103,116,260
"2011","Redcar and Cleveland 001D","E01012184","Total",1447,197,97,100,1250,109,136,317,218,82,119,269
"2011","Redcar and Cleveland 002A","E01012105","Total",1375,171,111,60,1204,80,126,279,154,69,181,315
"2011","Redcar and Cleveland 002B","E01012142","Total",1681,217,131,86,1464,73,246,367,212,96,168,302
"2011","Redcar and Cleveland 002C","E01012143","Total",1278,184,72,112,1094,215,82,211,116,108,167,195
"2011","Redcar and Cleveland 002D","E01012144","Total",1377,174,85,89,1203,75,188,197,268,41,137,297
"2011","Redcar and Cleveland 003C","E01012106","Total",1369,184,106,78,1185,72,216,236,194,60,155,252
"2011","Redcar and Cleveland 003D","E01012107","Total",1404,280,170,110,1124,103,138,236,190,79,151,227
"2011","Redcar and Cleveland 003E","E01032560","Total",1060,114,70,44,946,24,214,183,142,47,102,234
"2011","Redcar and Cleveland 003F","E01032561","Total",1538,188,60,128,1350,261,90,301,246,65,154,233
"2011","Redcar and Cleveland 004A","E01012176","Total",1432,200,132,68,1232,28,276,288,238,36,91,275
"2011","Redcar and Cleveland 004B","E01012177","Total",1486,150,62,88,1336,42,146,425,256,56,165,246
"2011","Redcar and Cleveland 004C","E01012178","Total",1424,164,84,80,1260,75,162,286,242,72,155,268
"2011","Redcar and Cleveland 004D","E01012179","Total",1438,178,90,88,1260,72,228,314,228,62,147,209
"2011","Redcar and Cleveland 004E","E01012180","Total",1792,73,19,54,1719,62,106,586,228,59,300,378
"2011","Redcar and Cleveland 004F","E01012185","Total",1465,176,97,79,1289,130,150,305,248,77,104,275
"2011","Redcar and Cleveland 004G","E01012186","Total",1642,239,141,98,1403,61,226,318,296,63,143,296
"2011","Redcar and Cleveland 005A","E01012127","Total",1018,258,95,163,760,121,68,161,136,77,100,97
"2011","Redcar and Cleveland 005B","E01012128","Total",1119,224,121,103,895,116,104,155,190,70,138,122
"2011","Redcar and Cleveland 005C","E01012129","Total",2132,172,92,80,1960,92,296,446,374,84,302,366
"2011","Redcar and Cleveland 005D","E01012130","Total",1284,163,81,82,1121,58,208,199,266,30,109,251
"2011","Redcar and Cleveland 005E","E01012131","Total",1362,288,164,124,1074,169,172,152,118,120,154,189
"2011","Redcar and Cleveland 006A","E01012138","Total",2691,190,85,105,2501,129,262,873,390,134,289,424
"2011","Redcar and Cleveland 006B","E01012139","Total",1942,131,70,61,1811,38,350,372,336,101,189,425
"2011","Redcar and Cleveland 006C","E01012140","Total",1329,184,78,106,1145,97,224,240,258,68,80,178
"2011","Redcar and Cleveland 006D","E01012141","Total",1099,130,86,44,969,40,240,171,148,36,126,208
"2011","Redcar and Cleveland 006E","E01012154","Total",1271,175,118,57,1096,35,304,189,200,15,114,239
"2011","Redcar and Cleveland 006F","E01012155","Total",1472,344,187,157,1128,90,232,241,218,43,80,224
"2011","Redcar and Cleveland 006G","E01012156","Total",1738,181,117,64,1557,46,360,298,220,109,144,380
"2011","Redcar and Cleveland 006H","E01012157","Total",1604,278,151,127,1326,77,258,273,226,66,132,294
"2011","Redcar and Cleveland 007A","E01012158","Total",1390,180,124,56,1210,34,338,283,228,31,90,206
"2011","Redcar and Cleveland 007B","E01012159","Total",1564,557,172,385,1007,96,144,179,332,47,78,131
"2011","Redcar and Cleveland 007C","E01012160","Total",1384,192,103,89,1192,66,150,278,230,40,151,277
"2011","Redcar and Cleveland 007D","E01012161","Total",1379,257,108,149,1122,102,162,268,220,89,110,171
"2011","Redcar and Cleveland 009A","E01012113","Total",1429,144,59,85,1285,237,76,322,166,135,138,211
"2011","Redcar and Cleveland 009B","E01012114","Total",1396,237,59,178,1159,257,66,282,226,68,115,145
"2011","Redcar and Cleveland 009E","E01012175","Total",1426,218,100,118,1208,236,106,251,180,61,161,213
"2011","Redcar and Cleveland 009F","E01033471","Total",2263,211,64,147,2052,430,96,444,278,152,309,343
"2011","Redcar and Cleveland 010A","E01012095","Total",1339,89,49,40,1250,60,208,330,270,67,99,216
"2011","Redcar and Cleveland 010B","E01012097","Total",1174,127,82,45,1047,47,252,145,198,71,130,204
"2011","Redcar and Cleveland 010C","E01012098","Total",1302,137,43,94,1165,59,152,319,242,52,133,208
"2011","Redcar and Cleveland 010D","E01012099","Total",1559,237,79,158,1322,168,106,306,250,123,156,213
"2011","Redcar and Cleveland 011A","E01012108","Total",1462,174,82,92,1288,192,152,229,178,63,203,271
"2011","Redcar and Cleveland 011B","E01012109","Total",1313,193,66,127,1120,110,132,213,270,30,82,283
"2011","Redcar and Cleveland 011C","E01012110","Total",1393,198,62,136,1195,84,96,283,290,26,86,330
"2011","Redcar and Cleveland 011D","E01012111","Total",1247,300,192,108,947,68,130,207,176,16,122,228
"2011","Redcar and Cleveland 011E","E01012171","Total",1435,236,141,95,1199,126,212,205,184,36,151,285
"2011","Redcar and Cleveland 011F","E01012172","Total",1383,179,116,63,1204,59,250,245,224,61,93,272
"2011","Redcar and Cleveland 012A","E01012162","Total",1464,175,61,114,1289,103,132,353,260,114,139,188
"2011","Redcar and Cleveland 012B","E01012163","Total",2181,148,66,82,2033,58,244,509,358,140,256,468
"2011","Redcar and Cleveland 012C","E01012164","Total",1594,227,93,134,1367,109,226,268,346,61,83,274
"2011","Redcar and Cleveland 012D","E01012165","Total",2203,320,147,173,1883,207,224,472,368,163,181,268
"2011","Redcar and Cleveland 013A","E01012096","Total",1606,250,87,163,1356,147,142,317,214,124,212,200
"2011","Redcar and Cleveland 013D","E01012136","Total",1367,217,71,146,1150,95,150,227,294,51,160,173
"2011","Redcar and Cleveland 013E","E01033473","Total",2122,304,138,166,1818,235,208,347,282,159,245,342
"2011","Redcar and Cleveland 015A","E01012112","Total",1466,405,129,276,1061,178,110,178,218,89,130,158
"2011","Redcar and Cleveland 015B","E01012145","Total",1457,227,107,120,1230,96,146,274,254,48,150,262
"2011","Redcar and Cleveland 015C","E01012147","Total",1595,154,81,73,1441,50,264,346,260,52,102,367
"2011","Redcar and Cleveland 015D","E01012149","Total",1203,110,65,45,1093,28,202,230,180,32,124,297
"2011","Redcar and Cleveland 016A","E01012132","Total",2003,294,143,151,1709,143,338,303,308,74,194,349
"2011","Redcar and Cleveland 016B","E01012134","Total",1447,248,144,104,1199,37,228,218,282,72,112,250
"2011","Redcar and Cleveland 016C","E01012137","Total",1364,126,57,69,1238,64,192,219,212,74,180,297
"2011","Redcar and Cleveland 016D","E01012181","Total",1679,213,91,122,1466,136,144,388,250,73,202,273
"2011","Redcar and Cleveland 018A","E01012117","Total",1358,393,196,197,965,98,192,191,274,15,43,152
"2011","Redcar and Cleveland 018B","E01012118","Total",1358,249,120,129,1109,107,128,218,266,41,130,219
"2011","Redcar and Cleveland 018C","E01012119","Total",2096,241,122,119,1855,195,178,477,316,116,191,382
"2011","Redcar and Cleveland 018D","E01012121","Total",1354,251,108,143,1103,102,124,234,166,82,179,216
"2011","Redcar and Cleveland 019E","E01032548","Total",1566,170,125,45,1396,24,444,254,266,62,118,228
"2011","Redcar and Cleveland 019F","E01032549","Total",1599,138,67,71,1461,40,260,315,268,92,134,352
"2011","Redcar and Cleveland 019G","E01033472","Total",2528,278,102,176,2250,227,208,584,454,90,247,440
"2011","Redcar and Cleveland 020A","E01012120","Total",1314,196,115,81,1118,40,326,196,222,25,92,217
"2011","Redcar and Cleveland 020B","E01012124","Total",1432,131,76,55,1301,33,314,271,278,26,129,250
"2011","Redcar and Cleveland 020C","E01012182","Total",1377,145,89,56,1232,13,280,221,240,70,105,303
"2011","Redcar and Cleveland 020D","E01012183","Total",1541,127,56,71,1414,30,138,406,328,63,185,264
"2011","Redcar and Cleveland 021A","E01012148","Total",1411,281,79,202,1130,141,116,202,208,76,160,227
"2011","Redcar and Cleveland 021B","E01012150","Total",1532,256,99,157,1276,217,172,219,192,50,142,284
"2011","Redcar and Cleveland 021C","E01012151","Total",1471,186,121,65,1285,38,308,243,178,30,152,336
"2011","Redcar and Cleveland 021D","E01012152","Total",1563,173,102,71,1390,56,238,285,292,53,113,353
"2011","Redcar and Cleveland 021E","E01032594","Total",1376,211,140,71,1165,47,272,236,200,66,110,234
"2011","Redcar and Cleveland 022A","E01012146","Total",1243,100,57,43,1143,28,258,173,212,75,87,310
"2011","Redcar and Cleveland 022B","E01012167","Total",1478,143,61,82,1335,126,134,317,186,61,169,342
"2011","Redcar and Cleveland 022C","E01012168","Total",1920,242,122,120,1678,165,138,403,300,85,235,352
"2011","Redcar and Cleveland 022D","E01012170","Total",1323,194,82,112,1129,220,78,188,182,115,145,201
"2011","Redcar and Cleveland 022E","E01012173","Total",1163,149,97,52,1014,42,204,161,174,41,124,268
"2011","Redcar and Cleveland 022F","E01012174","Total",1110,122,86,36,988,30,226,174,140,25,129,264
"2011","Redcar and Cleveland 022G","E01033470","Total",1750,323,101,222,1427,187,130,247,246,55,237,325
"2011","Stockton-on-Tees 001A","E01012242","Total",1519,153,87,66,1366,35,224,289,222,78,150,368
"2011","Stockton-on-Tees 001B","E01012243","Total",1567,176,58,118,1391,59,134,387,302,46,168,295
"2011","Stockton-on-Tees 001C","E01012244","Total",1445,160,72,88,1285,67,162,261,274,51,150,320
"2011","Stockton-on-Tees 001D","E01012246","Total",1451,98,25,73,1353,47,126,316,320,42,150,352
"2011","Stockton-on-Tees 001E","E01012296","Total",1312,205,104,101,1107,42,150,258,232,56,125,244
"2011","Stockton-on-Tees 001F","E01012297","Total",2644,141,44,97,2503,74,212,689,470,145,335,578
"2011","Stockton-on-Tees 002A","E01012197","Total",2027,192,78,114,1835,242,156,474,290,149,228,296
"2011","Stockton-on-Tees 002B","E01012256","Total",1321,187,117,70,1134,50,340,157,202,30,59,296
"2011","Stockton-on-Tees 002C","E01012257","Total",1433,175,121,54,1258,50,270,264,204,61,122,287
"2011","Stockton-on-Tees 002D","E01012275","Total",1544,157,87,70,1387,156,166,261,192,79,213,320
"2011","Stockton-on-Tees 002E","E01012276","Total",1603,382,180,202,1221,100,196,232,278,63,90,262
"2011","Stockton-on-Tees 002F","E01012277","Total",1653,205,115,90,1448,166,158,346,230,94,145,309
"2011","Stockton-on-Tees 003A","E01012196","Total",1670,173,97,76,1497,139,140,334,230,85,180,389
"2011","Stockton-on-Tees 003B","E01012198","Total",1475,183,63,120,1292,161,112,245,198,108,214,254
"2011","Stockton-on-Tees 003C","E01012214","Total",1654,134,58,76,1520,166,198,327,214,114,245,256
"2011","Stockton-on-Tees 003D","E01012215","Total",1238,149,58,91,1089,143,98,193,132,151,135,237
"2011","Stockton-on-Tees 003E","E01012216","Total",1302,130,54,76,1172,152,136,247,126,84,158,269
"2011","Stockton-on-Tees 003F","E01012245","Total",1605,255,86,169,1350,152,210,274,224,111,135,244
"2011","Stockton-on-Tees 004A","E01012278","Total",1300,103,43,60,1197,134,110,267,208,84,171,223
"2011","Stockton-on-Tees 004B","E01012279","Total",1718,113,36,77,1605,108,94,409,256,179,192,367
"2011","Stockton-on-Tees 004C","E01012280","Total",1569,154,93,61,1415,78,248,247,250,131,154,307
"2011","Stockton-on-Tees 004D","E01012281","Total",1309,280,156,124,1029,148,122,192,180,95,129,163
"2011","Stockton-on-Tees 005A","E01012255","Total",1423,165,116,49,1258,19,418,169,178,37,143,294
"2011","Stockton-on-Tees 005B","E01012269","Total",1621,154,73,81,1467,25,252,362,256,79,172,321
"2011","Stockton-on-Tees 005D","E01012294","Total",1175,101,50,51,1074,14,192,214,218,88,128,220
"2011","Stockton-on-Tees 005E","E01012295","Total",1210,116,52,64,1094,79,114,295,222,81,95,208
"2011","Stockton-on-Tees 005F","E01033476","Total",1639,64,16,48,1575,41,120,521,342,88,214,249
"2011","Stockton-on-Tees 005G","E01033480","Total",1636,73,28,45,1563,28,242,310,320,55,191,417
"2011","Stockton-on-Tees 006A","E01012210","Total",1584,115,52,63,1469,44,230,273,294,79,146,403
"2011","Stockton-on-Tees 006B","E01012211","Total",1840,169,80,89,1671,70,188,496,340,94,160,323
"2011","Stockton-on-Tees 006C","E01012212","Total",1469,198,88,110,1271,32,242,266,338,44,77,272
"2011","Stockton-on-Tees 006D","E01012213","Total",1393,311,226,85,1082,42,286,147,242,45,86,234
"2011","Stockton-on-Tees 007A","E01012192","Total",1583,268,118,150,1315,93,224,237,270,76,158,257
"2011","Stockton-on-Tees 007B","E01012193","Total",1538,139,64,75,1399,169,112,317,240,88,218,255
"2011","Stockton-on-Tees 007C","E01012260","Total",1651,314,154,160,1337,44,264,251,306,95,103,274
"2011","Stockton-on-Tees 007D","E01012261","Total",1509,232,76,156,1277,74,154,389,308,66,82,204
"2011","Stockton-on-Tees 008A","E01012247","Total",1277,141,77,64,1136,122,74,206,192,93,209,240
"2011","Stockton-on-Tees 008B","E01012249","Total",1554,193,119,74,1361,176,126,244,202,97,185,331
"2011","Stockton-on-Tees 008C","E01012271","Total",1496,142,51,91,1354,209,68,284,208,171,207,207
"2011","Stockton-on-Tees 008D","E01012272","Total",1065,153,78,75,912,16,232,125,170,15,125,229
"2011","Stockton-on-Tees 008E","E01012273","Total",1582,180,64,116,1402,225,86,288,198,126,194,285
"2011","Stockton-on-Tees 008F","E01012274","Total",1340,108,48,60,1232,98,110,270,162,93,239,260
"2011","Stockton-on-Tees 009D","E01012248","Total",1428,212,104,108,1216,102,184,213,230,88,165,234
"2011","Stockton-on-Tees 009E","E01012250","Total",1427,236,104,132,1191,146,140,222,170,116,159,238
"2011","Stockton-on-Tees 009F","E01032542","Total",1120,121,65,56,999,144,46,251,186,114,149,109
"2011","Stockton-on-Tees 009G","E01032543","Total",2213,227,100,127,1986,309,160,379,280,183,257,418
"2011","Stockton-on-Tees 009H","E01032544","Total",1981,153,38,115,1828,198,60,564,314,113,231,348
"2011","Stockton-on-Tees 010A","E01012194","Total",1491,178,53,125,1313,168,124,382,262,84,110,183
"2011","Stockton-on-Tees 010B","E01012195","Total",1563,248,91,157,1315,253,84,281,196,122,186,193
"2011","Stockton-on-Tees 010C","E01012258","Total",1116,219,97,122,897,117,108,153,168,81,143,127
"2011","Stockton-on-Tees 010D","E01012259","Total",1771,230,96,134,1541,111,172,359,330,86,163,320
"2011","Stockton-on-Tees 010E","E01012268","Total",1601,295,80,215,1306,200,96,275,270,74,168,223
"2011","Stockton-on-Tees 011A","E01012187","Total",1387,86,29,57,1301,68,146,293,260,64,164,306
"2011","Stockton-on-Tees 011B","E01012188","Total",1205,104,39,65,1101,38,116,279,226,46,98,298
"2011","Stockton-on-Tees 011C","E01012189","Total",1398,181,118,63,1217,36,264,223,234,48,128,284
"2011","Stockton-on-Tees 011D","E01012205","Total",1402,185,86,99,1217,49,226,282,268,32,105,255
"2011","Stockton-on-Tees 012A","E01012219","Total",1775,145,72,73,1630,84,176,356,270,77,213,454
"2011","Stockton-on-Tees 012B","E01012251","Total",1663,152,49,103,1511,190,98,339,230,170,236,248
"2011","Stockton-on-Tees 012C","E01012252","Total",1539,199,80,119,1340,307,52,304,176,121,179,201
"2011","Stockton-on-Tees 012D","E01012253","Total",1262,129,65,64,1133,81,120,222,108,68,234,300
"2011","Stockton-on-Tees 012E","E01012254","Total",1439,230,41,189,1209,273,62,201,222,71,185,195
"2011","Stockton-on-Tees 013A","E01012204","Total",1303,170,108,62,1133,31,320,152,274,21,78,257
"2011","Stockton-on-Tees 013B","E01012206","Total",1458,290,193,97,1168,87,218,200,240,42,118,263
"2011","Stockton-on-Tees 013C","E01012207","Total",1911,200,125,75,1711,42,286,407,274,161,219,322
"2011","Stockton-on-Tees 013D","E01012208","Total",1648,138,82,56,1510,38,208,326,234,69,220,415
"2011","Stockton-on-Tees 014A","E01012262","Total",1883,277,57,220,1606,246,90,326,312,134,230,268
"2011","Stockton-on-Tees 014C","E01012264","Total",2355,340,94,246,2015,180,134,474,478,166,201,382
"2011","Stockton-on-Tees 014E","E01012266","Total",2290,562,154,408,1728,323,136,363,290,178,197,241
"2011","Stockton-on-Tees 014F","E01012267","Total",1669,426,166,260,1243,144,126,193,270,89,151,270
"2011","Stockton-on-Tees 014G","E01033477","Total",2438,599,111,488,1839,118,76,235,332,196,454,428
"2011","Stockton-on-Tees 015A","E01012190","Total",1493,141,57,84,1352,65,202,314,284,55,119,313
"2011","Stockton-on-Tees 015B","E01012191","Total",1576,253,173,80,1323,79,254,187,182,99,191,331
"2011","Stockton-on-Tees 015C","E01012224","Total",1781,188,122,66,1593,51,344,380,292,78,126,322
"2011","Stockton-on-Tees 015D","E01012225","Total",1531,163,102,61,1368,45,278,224,214,49,185,373
"2011","Stockton-on-Tees 015E","E01012226","Total",1381,136,78,58,1245,29,292,228,240,20,156,280
"2011","Stockton-on-Tees 016A","E01012209","Total",1690,174,94,80,1516,41,200,309,246,72,271,377
"2011","Stockton-on-Tees 016B","E01012217","Total",1513,336,74,262,1177,155,94,300,256,58,150,164
"2011","Stockton-on-Tees 016C","E01012218","Total",1565,147,86,61,1418,78,192,312,202,90,212,332
"2011","Stockton-on-Tees 016D","E01012223","Total",1528,129,80,49,1399,53,284,309,244,91,130,288
"2011","Stockton-on-Tees 017A","E01012286","Total",1443,230,53,177,1213,219,76,256,256,81,84,241
"2011","Stockton-on-Tees 017B","E01012287","Total",1734,471,100,371,1263,130,62,180,434,40,79,338
"2011","Stockton-on-Tees 017C","E01012288","Total",1473,199,82,117,1274,216,92,269,190,66,185,256
"2011","Stockton-on-Tees 017D","E01012289","Total",1245,163,81,82,1082,93,90,182,176,97,178,266
"2011","Stockton-on-Tees 018A","E01012238","Total",1545,180,88,92,1365,158,124,243,234,104,192,310
"2011","Stockton-on-Tees 018B","E01012239","Total",1994,181,71,110,1813,278,84,447,344,181,241,238
"2011","Stockton-on-Tees 018C","E01012240","Total",1786,191,96,95,1595,125,190,307,340,74,215,344
"2011","Stockton-on-Tees 018D","E01012241","Total",1489,123,57,66,1366,55,176,302,296,42,134,361
"2011","Stockton-on-Tees 019A","E01012290","Total",1759,265,170,95,1494,65,382,261,280,52,151,303
"2011","Stockton-on-Tees 019B","E01012291","Total",1772,167,93,74,1605,174,152,361,248,127,207,336
"2011","Stockton-on-Tees 019C","E01012292","Total",2316,391,136,255,1925,189,166,461,404,133,278,294
"2011","Stockton-on-Tees 020A","E01012282","Total",1299,131,47,84,1168,163,130,240,182,46,143,264
"2011","Stockton-on-Tees 020B","E01012283","Total",1328,158,60,98,1170,209,100,201,190,106,150,214
"2011","Stockton-on-Tees 020C","E01012284","Total",1482,179,93,86,1303,129,252,238,228,93,159,204
"2011","Stockton-on-Tees 020D","E01012285","Total",1317,199,90,109,1118,73,186,146,280,58,113,262
"2011","Stockton-on-Tees 021A","E01012199","Total",1446,135,63,72,1311,42,250,265,258,53,145,298
"2011","Stockton-on-Tees 021B","E01012200","Total",2005,231,125,106,1774,85,318,378,400,114,135,344
"2011","Stockton-on-Tees 021C","E01012201","Total",1795,157,106,51,1638,74,358,443,206,99,151,307
"2011","Stockton-on-Tees 021D","E01012202","Total",1423,195,80,115,1228,68,142,292,260,99,149,218
"2011","Stockton-on-Tees 021E","E01012203","Total",1797,129,48,81,1668,97,124,549,302,61,193,342
"2011","Stockton-on-Tees 021F","E01012270","Total",1361,178,89,89,1183,67,150,292,212,51,179,232
"2011","Stockton-on-Tees 022A","E01012228","Total",1421,106,32,74,1315,52,86,456,218,72,176,255
"2011","Stockton-on-Tees 022B","E01012230","Total",1588,109,27,82,1479,103,94,393,284,115,206,284
"2011","Stockton-on-Tees 022C","E01012233","Total",1437,102,56,46,1335,29,194,351,260,77,159,265
"2011","Stockton-on-Tees 022D","E01012236","Total",1351,117,37,80,1234,53,126,292,256,77,150,280
"2011","Stockton-on-Tees 022E","E01012237","Total",1363,63,28,35,1300,33,122,274,242,85,210,334
"2011","Stockton-on-Tees 023A","E01012227","Total",1546,118,20,98,1428,132,38,543,286,125,158,146
"2011","Stockton-on-Tees 023C","E01012231","Total",2022,101,15,86,1921,114,46,794,266,176,299,226
"2011","Stockton-on-Tees 023D","E01012232","Total",1431,99,21,78,1332,92,58,427,284,108,155,208
"2011","Stockton-on-Tees 023E","E01012234","Total",1694,74,17,57,1620,50,74,519,256,128,293,300
"2011","Stockton-on-Tees 023F","E01033474","Total",1608,117,7,110,1491,112,16,647,358,122,119,117
"2011","Stockton-on-Tees 023G","E01033475","Total",1840,53,4,49,1787,77,20,777,230,170,327,186
"2011","Stockton-on-Tees 023H","E01033478","Total",1891,47,6,41,1844,43,54,785,174,183,312,293
"2011","Stockton-on-Tees 023I","E01033479","Total",1803,70,15,55,1733,82,90,645,260,159,246,251
"2011","Stockton-on-Tees 024A","E01012235","Total",1099,82,46,36,1017,11,240,177,224,59,112,194
"2011","Stockton-on-Tees 024B","E01012298","Total",1393,81,40,41,1312,13,234,272,238,62,142,351
"2011","Stockton-on-Tees 024C","E01012299","Total",1481,287,75,212,1194,104,160,254,314,93,73,196
"2011","Stockton-on-Tees 024D","E01012300","Total",1516,284,171,113,1232,85,254,275,236,40,123,219
"2011","Stockton-on-Tees 024E","E01012301","Total",1368,119,49,70,1249,41,158,317,278,46,134,275
"2011","Stockton-on-Tees 024F","E01012302","Total",1179,102,39,63,1077,48,146,219,248,45,131,240
"2011","Stockton-on-Tees 024G","E01012303","Total",1381,162,58,104,1219,61,138,266,310,56,98,290
"2011","Gateshead 001A","E01008246","Total",1458,199,87,112,1259,119,144,353,212,91,146,194
"2011","Gateshead 001B","E01008247","Total",1616,293,143,150,1323,96,240,282,202,56,175,272
"2011","Gateshead 001C","E01008248","Total",1751,148,58,90,1603,48,170,474,404,68,138,301
"2011","Gateshead 001D","E01008249","Total",1525,191,125,66,1334,34,402,248,298,37,52,263
"2011","Gateshead 001E","E01008250","Total",1469,133,59,74,1336,108,144,328,242,75,171,268
"2011","Gateshead 002A","E01008195","Total",2065,253,108,145,1812,128,152,474,388,170,173,327
"2011","Gateshead 002B","E01008197","Total",1486,219,80,139,1267,47,176,310,322,48,64,300
"2011","Gateshead 002C","E01008198","Total",1387,182,110,72,1205,115,190,224,194,129,123,230
"2011","Gateshead 002D","E01008199","Total",1323,229,74,155,1094,71,154,262,258,47,63,239
"2011","Gateshead 002E","E01008200","Total",1336,120,48,72,1216,52,182,320,242,31,88,301
"2011","Gateshead 002F","E01008245","Total",1437,167,109,58,1270,40,248,301,248,35,121,277
"2011","Gateshead 003A","E01008214","Total",1638,253,101,152,1385,247,122,295,264,40,179,238
"2011","Gateshead 003B","E01008215","Total",1586,399,81,318,1187,161,76,203,310,100,120,217
"2011","Gateshead 003C","E01008243","Total",1525,238,136,102,1287,70,252,267,312,16,108,262
"2011","Gateshead 003D","E01008244","Total",2064,362,93,269,1702,173,160,426,468,51,117,307
"2011","Gateshead 004A","E01008178","Total",1706,142,29,113,1564,219,82,381,388,143,117,234
"2011","Gateshead 004B","E01008180","Total",1519,181,84,97,1338,189,164,301,166,119,128,271
"2011","Gateshead 004C","E01008182","Total",1636,262,112,150,1374,146,122,428,286,70,107,215
"2011","Gateshead 004D","E01008277","Total",1531,199,124,75,1332,46,284,266,190,85,178,283
"2011","Gateshead 004E","E01008280","Total",1855,366,155,211,1489,132,168,352,250,91,186,310
"2011","Gateshead 005A","E01008177","Total",1364,188,77,111,1176,82,150,250,264,57,131,242
"2011","Gateshead 005B","E01008179","Total",1224,143,48,95,1081,60,94,318,244,40,152,173
"2011","Gateshead 005C","E01008181","Total",1477,153,83,70,1324,90,228,298,298,43,122,245
"2011","Gateshead 005D","E01008276","Total",1459,301,167,134,1158,83,180,298,282,23,98,194
"2011","Gateshead 005E","E01008279","Total",1425,204,109,95,1221,11,312,183,206,34,163,312
"2011","Gateshead 007A","E01008209","Total",2088,349,116,233,1739,175,156,383,496,46,207,276
"2011","Gateshead 007B","E01008210","Total",1370,203,77,126,1167,114,96,264,268,78,164,183
"2011","Gateshead 007C","E01008258","Total",2320,466,95,371,1854,259,72,470,580,63,178,232
"2011","Gateshead 007D","E01008259","Total",1894,555,148,407,1339,132,122,291,320,69,154,251
"2011","Gateshead 008A","E01008167","Total",1601,255,70,185,1346,113,90,282,340,95,163,263
"2011","Gateshead 008B","E01008169","Total",1593,101,20,81,1492,54,46,152,98,377,588,177
"2011","Gateshead 008C","E01008170","Total",1980,426,127,299,1554,121,120,331,428,72,173,309
"2011","Gateshead 008D","E01008171","Total",1172,249,56,193,923,121,48,186,202,133,73,160
"2011","Gateshead 008E","E01008257","Total",1372,270,120,150,1102,81,158,186,208,70,126,273
"2011","Gateshead 009A","E01008262","Total",1724,276,80,196,1448,140,84,351,364,90,159,260
"2011","Gateshead 009B","E01008263","Total",1523,199,69,130,1324,205,122,322,246,71,131,227
"2011","Gateshead 009C","E01008264","Total",1419,139,95,44,1280,10,262,383,200,30,142,253
"2011","Gateshead 009D","E01008265","Total",1479,165,64,101,1314,147,138,313,228,75,163,250
"2011","Gateshead 009E","E01008266","Total",1366,217,129,88,1149,31,210,256,272,65,97,218
"2011","Gateshead 010A","E01008251","Total",1748,421,83,338,1327,94,106,303,426,48,102,248
"2011","Gateshead 010B","E01008252","Total",1749,284,69,215,1465,108,102,201,288,240,322,204
"2011","Gateshead 010C","E01008253","Total",1713,328,45,283,1385,155,54,263,416,81,170,246
"2011","Gateshead 010D","E01008254","Total",1352,279,59,220,1073,125,62,284,264,47,67,224
"2011","Gateshead 010E","E01008255","Total",1706,228,119,109,1478,101,202,327,282,55,190,321
"2011","Gateshead 011A","E01008165","Total",1399,183,42,141,1216,149,112,188,212,87,169,299
"2011","Gateshead 011B","E01008201","Total",1596,189,76,113,1407,173,110,273,168,159,277,247
"2011","Gateshead 011C","E01008202","Total",1869,215,58,157,1654,194,124,474,348,73,147,294
"2011","Gateshead 011D","E01008204","Total",1550,278,96,182,1272,217,128,244,246,71,124,242
"2011","Gateshead 012A","E01008212","Total",1381,282,95,187,1099,169,126,253,250,47,52,202
"2011","Gateshead 012B","E01008213","Total",1483,190,122,68,1293,79,210,251,200,63,172,318
"2011","Gateshead 012C","E01008216","Total",1515,314,154,160,1201,134,170,217,246,70,115,249
"2011","Gateshead 012D","E01008228","Total",1191,195,100,95,996,128,108,196,178,42,110,234
"2011","Gateshead 013A","E01008206","Total",1748,217,101,116,1531,91,210,412,222,87,161,348
"2011","Gateshead 013B","E01008207","Total",1457,112,66,46,1345,43,198,296,300,54,145,309
"2011","Gateshead 013C","E01008208","Total",1647,256,108,148,1391,125,170,299,254,95,174,274
"2011","Gateshead 013D","E01008211","Total",1710,196,81,115,1514,101,196,282,330,53,189,363
"2011","Gateshead 014A","E01008283","Total",1311,168,56,112,1143,22,182,218,316,22,87,296
"2011","Gateshead 014B","E01008284","Total",1471,153,66,87,1318,105,178,285,236,88,104,322
"2011","Gateshead 014C","E01008286","Total",1492,193,108,85,1299,121,188,293,256,37,156,248
"2011","Gateshead 014D","E01008287","Total",2071,198,101,97,1873,79,84,649,384,111,246,320
"2011","Gateshead 015A","E01008231","Total",1590,185,88,97,1405,198,156,331,258,69,100,293
"2011","Gateshead 015B","E01008240","Total",1514,164,96,68,1350,89,196,344,236,71,144,270
"2011","Gateshead 015C","E01008241","Total",1637,193,129,64,1444,115,248,320,256,58,178,269
"2011","Gateshead 015D","E01008242","Total",1670,213,111,102,1457,168,156,381,188,103,170,291
"2011","Gateshead 015E","E01008281","Total",1501,206,135,71,1295,140,156,291,232,87,144,245
"2011","Gateshead 015F","E01008282","Total",1487,229,95,134,1258,145,154,271,196,91,152,249
"2011","Gateshead 016A","E01008219","Total",1661,232,84,148,1429,111,142,420,256,47,149,304
"2011","Gateshead 016B","E01008235","Total",1466,142,73,69,1324,49,228,292,288,39,129,299
"2011","Gateshead 016C","E01008236","Total",1476,321,157,164,1155,86,210,259,264,26,101,209
"2011","Gateshead 016D","E01008237","Total",1554,97,56,41,1457,28,194,439,252,75,184,285
"2011","Gateshead 016E","E01008238","Total",1552,207,79,128,1345,46,112,374,334,98,148,233
"2011","Gateshead 017A","E01008267","Total",1469,244,161,83,1225,50,320,246,204,86,104,215
"2011","Gateshead 017B","E01008269","Total",1489,154,94,60,1335,18,308,342,244,71,93,259
"2011","Gateshead 017C","E01008270","Total",1330,152,110,42,1178,25,340,257,220,45,64,227
"2011","Gateshead 017D","E01008271","Total",1410,144,66,78,1266,38,224,310,268,57,60,309
"2011","Gateshead 017E","E01008275","Total",1505,138,82,56,1367,44,270,303,288,55,110,297
"2011","Gateshead 018A","E01008229","Total",1365,195,135,60,1170,50,272,214,212,41,61,320
"2011","Gateshead 018B","E01008230","Total",1376,242,113,129,1134,59,130,315,210,41,166,213
"2011","Gateshead 018C","E01008232","Total",1388,167,81,86,1221,181,158,291,172,83,119,217
"2011","Gateshead 018D","E01008233","Total",1374,168,52,116,1206,24,174,266,290,27,103,322
"2011","Gateshead 018E","E01008285","Total",1439,239,103,136,1200,189,130,212,224,71,135,239
"2011","Gateshead 019A","E01008256","Total",1771,217,117,100,1554,83,192,385,326,57,145,366
"2011","Gateshead 019B","E01008260","Total",1532,136,56,80,1396,35,128,434,308,51,131,309
"2011","Gateshead 019C","E01008261","Total",1460,220,98,122,1240,141,144,281,166,72,130,306
"2011","Gateshead 019D","E01008268","Total",1477,162,82,80,1315,79,198,334,232,78,89,305
"2011","Gateshead 019E","E01008272","Total",1414,198,132,66,1216,51,294,304,216,38,59,254
"2011","Gateshead 019F","E01008273","Total",1473,177,59,118,1296,83,118,359,254,64,124,294
"2011","Gateshead 019G","E01008274","Total",1452,186,64,122,1266,147,140,301,230,61,142,245
"2011","Gateshead 020A","E01008193","Total",1175,122,84,38,1053,27,172,258,196,39,114,247
"2011","Gateshead 020B","E01008194","Total",1390,159,98,61,1231,25,230,284,236,55,118,283
"2011","Gateshead 020C","E01008234","Total",2097,424,217,207,1673,47,282,452,350,73,112,357
"2011","Gateshead 020D","E01008239","Total",1490,158,68,90,1332,32,170,356,292,53,119,310
"2011","Gateshead 021A","E01008218","Total",1600,326,180,146,1274,119,152,237,228,66,186,286
"2011","Gateshead 021B","E01008220","Total",1284,254,82,172,1030,229,90,143,108,117,176,167
"2011","Gateshead 021C","E01008221","Total",1730,220,92,128,1510,147,140,352,222,119,235,295
"2011","Gateshead 021D","E01008225","Total",1691,265,114,151,1426,94,242,303,326,45,82,334
"2011","Gateshead 021E","E01008227","Total",1692,168,30,138,1524,302,74,293,220,144,256,235
"2011","Gateshead 022A","E01008184","Total",1406,166,90,76,1240,23,340,293,250,46,83,205
"2011","Gateshead 022B","E01008185","Total",1411,167,102,65,1244,105,182,261,174,94,192,236
"2011","Gateshead 022C","E01008188","Total",1458,156,101,55,1302,74,210,302,236,55,198,227
"2011","Gateshead 022D","E01008278","Total",1424,130,82,48,1294,19,300,258,214,45,142,316
"2011","Gateshead 023A","E01008189","Total",1381,256,98,158,1125,74,192,220,180,92,130,237
"2011","Gateshead 023B","E01008190","Total",1295,127,85,42,1168,36,290,242,196,41,133,230
"2011","Gateshead 023C","E01008191","Total",1484,381,132,249,1103,104,152,255,164,76,124,228
"2011","Gateshead 023D","E01008192","Total",1433,254,102,152,1179,70,204,224,218,64,150,249
"2011","Gateshead 023E","E01008217","Total",1557,237,121,116,1320,124,258,273,246,65,128,226
"2011","Gateshead 024A","E01008183","Total",1478,194,82,112,1284,142,144,332,256,88,97,225
"2011","Gateshead 024B","E01008186","Total",1965,361,98,263,1604,177,168,315,364,105,141,334
"2011","Gateshead 024C","E01008187","Total",1674,287,175,112,1387,89,236,268,276,77,182,259
"2011","Gateshead 024D","E01008196","Total",1862,234,104,130,1628,87,250,359,324,50,143,415
"2011","Gateshead 025A","E01008222","Total",1521,202,71,131,1319,133,138,324,226,96,162,240
"2011","Gateshead 025B","E01008223","Total",1782,274,131,143,1508,211,124,369,280,125,161,238
"2011","Gateshead 025C","E01008224","Total",1817,217,121,96,1600,68,288,338,332,73,198,303
"2011","Gateshead 025D","E01008226","Total",1477,204,95,109,1273,77,224,270,248,31,146,277
"2011","Gateshead 026A","E01008172","Total",1703,232,156,76,1471,91,330,284,270,61,134,301
"2011","Gateshead 026B","E01008173","Total",1557,147,68,79,1410,159,112,331,208,76,226,298
"2011","Gateshead 026C","E01008174","Total",2084,288,159,129,1796,130,232,436,292,142,203,361
"2011","Gateshead 026D","E01008175","Total",1408,252,72,180,1156,105,138,279,276,33,127,198
"2011","Gateshead 026E","E01008176","Total",1496,118,65,53,1378,63,260,313,256,28,120,338
"2011","Gateshead 027A","E01008162","Total",2377,474,100,374,1903,150,96,427,656,16,147,411
"2011","Gateshead 027B","E01008164","Total",1239,285,49,236,954,97,44,158,342,69,120,124
"2011","Gateshead 027C","E01008166","Total",1559,641,119,522,918,40,76,110,476,53,27,136
"2011","Gateshead 027D","E01008168","Total",1911,521,120,401,1390,86,104,124,682,28,80,286
"2011","Gateshead 028A","E01008163","Total",1818,237,81,156,1581,106,84,254,236,347,299,255
"2011","Gateshead 028B","E01008203","Total",1733,361,86,275,1372,132,98,300,396,59,87,300
"2011","Gateshead 028C","E01008205","Total",1513,212,129,83,1301,34,184,363,274,61,91,294
"2011","Newcastle upon Tyne 001A","E01008294","Total",1488,178,52,126,1310,53,90,307,278,84,161,337
"2011","Newcastle upon Tyne 001B","E01008306","Total",1636,194,113,81,1442,77,258,267,322,82,132,304
"2011","Newcastle upon Tyne 001C","E01008307","Total",1007,205,100,105,802,120,82,167,182,35,58,158
"2011","Newcastle upon Tyne 001D","E01008308","Total",1395,186,83,103,1209,94,142,293,258,56,123,243
"2011","Newcastle upon Tyne 001E","E01008311","Total",1677,174,47,127,1503,26,142,490,280,62,171,332
"2011","Newcastle upon Tyne 001F","E01008312","Total",1264,127,30,97,1137,57,84,348,202,110,95,241
"2011","Newcastle upon Tyne 001G","E01008313","Total",1217,111,28,83,1106,38,94,267,214,97,121,275
"2011","Newcastle upon Tyne 002A","E01008309","Total",1802,164,115,49,1638,40,316,495,220,137,136,294
"2011","Newcastle upon Tyne 002C","E01008352","Total",1484,183,82,101,1301,82,156,280,204,111,213,255
"2011","Newcastle upon Tyne 002D","E01008357","Total",1637,177,105,72,1460,30,254,343,270,82,192,289
"2011","Newcastle upon Tyne 002E","E01008358","Total",1477,312,117,195,1165,82,178,287,352,38,121,107
"2011","Newcastle upon Tyne 002F","E01033550","Total",2056,100,44,56,1956,42,64,888,288,227,206,241
"2011","Newcastle upon Tyne 002G","E01033551","Total",1751,181,105,76,1570,17,288,401,286,87,157,334
"2011","Newcastle upon Tyne 003A","E01008336","Total",1366,283,112,171,1083,123,184,219,190,50,123,194
"2011","Newcastle upon Tyne 003B","E01008337","Total",1406,171,78,93,1235,162,150,251,160,102,178,232
"2011","Newcastle upon Tyne 003C","E01008338","Total",1259,133,49,84,1126,97,86,219,200,88,220,216
"2011","Newcastle upon Tyne 003D","E01008339","Total",1443,278,128,150,1165,127,86,203,214,74,209,252
"2011","Newcastle upon Tyne 003E","E01008340","Total",1477,224,48,176,1253,229,58,300,158,94,197,217
"2011","Newcastle upon Tyne 003F","E01008341","Total",1387,219,90,129,1168,115,132,255,202,70,181,213
"2011","Newcastle upon Tyne 003G","E01008342","Total",1388,317,168,149,1071,35,204,232,250,10,95,245
"2011","Newcastle upon Tyne 004A","E01008293","Total",1446,206,67,139,1240,88,108,289,260,62,148,285
"2011","Newcastle upon Tyne 004B","E01008456","Total",1498,228,130,98,1270,179,160,276,192,47,142,274
"2011","Newcastle upon Tyne 004C","E01008457","Total",1522,354,134,220,1168,155,112,275,266,46,82,232
"2011","Newcastle upon Tyne 004D","E01008458","Total",1628,195,102,93,1433,37,272,298,256,101,184,285
"2011","Newcastle upon Tyne 004E","E01008459","Total",1915,176,68,108,1739,378,116,391,214,166,239,235
"2011","Newcastle upon Tyne 004F","E01008460","Total",1550,159,72,87,1391,185,176,258,160,108,258,246
"2011","Newcastle upon Tyne 005A","E01008351","Total",1419,192,93,99,1227,61,178,337,226,53,131,241
"2011","Newcastle upon Tyne 005B","E01008354","Total",1708,266,98,168,1442,81,128,359,360,116,142,256
"2011","Newcastle upon Tyne 005C","E01008418","Total",1978,279,109,170,1699,20,212,481,406,124,172,284
"2011","Newcastle upon Tyne 005D","E01008420","Total",1305,149,64,85,1156,39,168,295,248,88,106,212
"2011","Newcastle upon Tyne 005E","E01008422","Total",1613,155,69,86,1458,29,120,376,312,52,119,450
"2011","Newcastle upon Tyne 005F","E01008424","Total",1565,303,96,207,1262,52,66,249,436,62,85,312
"2011","Newcastle upon Tyne 006A","E01008353","Total",1533,235,108,127,1298,109,198,314,248,61,149,219
"2011","Newcastle upon Tyne 006B","E01008355","Total",1544,312,169,143,1232,42,102,340,332,61,125,230
"2011","Newcastle upon Tyne 006C","E01008356","Total",1377,198,60,138,1179,56,114,265,210,67,166,301
"2011","Newcastle upon Tyne 006D","E01008378","Total",1452,116,84,32,1336,20,182,258,170,149,250,307
"2011","Newcastle upon Tyne 006E","E01008419","Total",1493,191,55,136,1302,26,98,408,312,120,110,228
"2011","Newcastle upon Tyne 006F","E01008421","Total",1521,204,77,127,1317,33,136,421,328,121,103,175
"2011","Newcastle upon Tyne 006G","E01008423","Total",1346,120,68,52,1226,17,212,339,174,120,147,217
"2011","Newcastle upon Tyne 007A","E01008317","Total",1528,142,78,64,1386,27,162,409,228,133,171,256
"2011","Newcastle upon Tyne 007B","E01008319","Total",1870,126,37,89,1744,47,118,589,260,107,211,412
"2011","Newcastle upon Tyne 007C","E01008320","Total",1462,172,82,90,1290,48,184,244,244,74,219,277
"2011","Newcastle upon Tyne 007D","E01008321","Total",1689,197,78,119,1492,39,182,383,370,109,160,249
"2011","Newcastle upon Tyne 007E","E01008322","Total",1528,124,66,58,1404,31,144,388,230,103,164,344
"2011","Newcastle upon Tyne 007F","E01008323","Total",1449,262,88,174,1187,59,88,270,370,46,113,241
"2011","Newcastle upon Tyne 008A","E01008295","Total",1588,148,51,97,1440,259,122,306,166,154,225,208
"2011","Newcastle upon Tyne 008B","E01008374","Total",1580,164,87,77,1416,66,126,347,252,60,214,351
"2011","Newcastle upon Tyne 008C","E01008375","Total",1514,304,106,198,1210,129,108,315,238,94,119,207
"2011","Newcastle upon Tyne 008D","E01008376","Total",1197,106,54,52,1091,18,102,292,210,91,135,243
"2011","Newcastle upon Tyne 008E","E01008377","Total",2163,210,52,158,1953,226,88,502,378,204,283,272
"2011","Newcastle upon Tyne 008F","E01008379","Total",1527,273,134,139,1254,97,194,241,222,135,166,199
"2011","Newcastle upon Tyne 008G","E01008380","Total",1702,295,77,218,1407,237,56,294,188,146,258,228
"2011","Newcastle upon Tyne 011A","E01008296","Total",1409,263,100,163,1146,97,208,213,234,44,93,257
"2011","Newcastle upon Tyne 011B","E01008297","Total",1380,266,120,146,1114,118,140,187,168,103,189,209
"2011","Newcastle upon Tyne 011C","E01008298","Total",1507,146,87,59,1361,91,140,399,172,122,185,252
"2011","Newcastle upon Tyne 011D","E01008299","Total",1342,163,84,79,1179,125,96,199,160,142,217,240
"2011","Newcastle upon Tyne 012A","E01008314","Total",1077,142,58,84,935,41,132,220,180,25,96,241
"2011","Newcastle upon Tyne 012B","E01008315","Total",1556,168,79,89,1388,66,142,350,222,70,195,343
"2011","Newcastle upon Tyne 012C","E01008316","Total",1609,157,67,90,1452,52,170,363,254,40,176,397
"2011","Newcastle upon Tyne 012D","E01008318","Total",1405,226,135,91,1179,78,126,223,226,68,149,309
"2011","Newcastle upon Tyne 012E","E01008363","Total",1595,279,131,148,1316,49,250,216,426,35,75,265
"2011","Newcastle upon Tyne 012F","E01008365","Total",1679,96,43,53,1583,16,86,429,214,130,211,497
"2011","Newcastle upon Tyne 013A","E01008366","Total",2077,139,40,99,1938,4,62,129,240,25,80,1398
"2011","Newcastle upon Tyne 013B","E01008369","Total",1977,171,32,139,1806,6,52,147,328,36,101,1136
"2011","Newcastle upon Tyne 013C","E01008371","Total",1365,187,100,87,1178,11,158,220,184,67,198,340
"2011","Newcastle upon Tyne 013D","E01008372","Total",1902,240,60,180,1662,7,42,54,326,28,61,1144
"2011","Newcastle upon Tyne 013E","E01008373","Total",2348,142,26,116,2206,14,20,63,336,6,24,1743
"2011","Newcastle upon Tyne 014A","E01008400","Total",1317,346,161,185,971,117,146,191,202,58,104,153
"2011","Newcastle upon Tyne 014B","E01008401","Total",1441,178,101,77,1263,108,176,285,174,58,169,293
"2011","Newcastle upon Tyne 014C","E01008402","Total",1476,181,71,110,1295,119,202,301,250,27,113,283
"2011","Newcastle upon Tyne 014D","E01008403","Total",1440,145,78,67,1295,74,314,253,228,36,96,294
"2011","Newcastle upon Tyne 014E","E01008404","Total",1647,322,72,250,1325,111,94,378,354,56,124,208
"2011","Newcastle upon Tyne 014F","E01008405","Total",1417,224,103,121,1193,153,106,288,212,51,114,269
"2011","Newcastle upon Tyne 014G","E01008443","Total",1433,152,84,68,1281,38,208,354,230,51,125,275
"2011","Newcastle upon Tyne 015A","E01008324","Total",1322,141,86,55,1181,163,188,249,174,100,109,198
"2011","Newcastle upon Tyne 015B","E01008325","Total",1420,258,142,116,1162,148,216,166,148,124,157,203
"2011","Newcastle upon Tyne 015C","E01008326","Total",1444,147,82,65,1297,60,166,317,188,42,162,362
"2011","Newcastle upon Tyne 015D","E01008327","Total",1295,226,101,125,1069,204,122,173,136,94,169,171
"2011","Newcastle upon Tyne 015E","E01008328","Total",1267,165,129,36,1102,24,274,196,200,20,134,254
"2011","Newcastle upon Tyne 015F","E01008329","Total",1462,182,77,105,1280,110,168,247,206,73,151,325
"2011","Newcastle upon Tyne 015G","E01008330","Total",1385,191,90,101,1194,215,156,332,196,62,88,145
"2011","Newcastle upon Tyne 016A","E01008300","Total",1612,207,84,123,1405,195,102,341,208,129,202,228
"2011","Newcastle upon Tyne 016B","E01008450","Total",1480,139,74,65,1341,216,108,286,184,128,172,247
"2011","Newcastle upon Tyne 016C","E01008451","Total",1788,308,88,220,1480,147,126,325,372,83,169,258
"2011","Newcastle upon Tyne 016D","E01008452","Total",1424,105,74,31,1319,22,122,217,192,128,323,315
"2011","Newcastle upon Tyne 017A","E01008367","Total",2041,253,41,212,1788,4,48,129,454,11,86,1056
"2011","Newcastle upon Tyne 017B","E01008368","Total",1780,152,29,123,1628,0,50,97,200,22,34,1225
"2011","Newcastle upon Tyne 017C","E01008370","Total",1656,370,102,268,1286,22,124,130,368,36,69,537
"2011","Newcastle upon Tyne 017D","E01008409","Total",1684,251,83,168,1433,31,54,187,368,25,43,725
"2011","Newcastle upon Tyne 017E","E01008411","Total",1774,232,64,168,1542,28,38,42,364,5,48,1017
"2011","Newcastle upon Tyne 018A","E01008303","Total",1955,618,227,391,1337,143,150,194,204,53,101,492
"2011","Newcastle upon Tyne 018B","E01008359","Total",1600,165,33,132,1435,50,30,129,252,30,63,881
"2011","Newcastle upon Tyne 018C","E01008360","Total",1547,272,35,237,1275,36,58,148,566,21,40,406
"2011","Newcastle upon Tyne 018D","E01008361","Total",1593,195,22,173,1398,58,36,121,434,55,53,641
"2011","Newcastle upon Tyne 018E","E01008362","Total",1795,255,81,174,1540,38,44,96,336,27,52,947
"2011","Newcastle upon Tyne 018F","E01008364","Total",1651,199,30,169,1452,42,40,155,480,30,42,663
"2011","Newcastle upon Tyne 019A","E01008343","Total",1547,161,91,70,1386,76,164,350,166,92,207,331
"2011","Newcastle upon Tyne 019B","E01008344","Total",1597,238,120,118,1359,134,166,291,234,114,140,280
"2011","Newcastle upon Tyne 019C","E01008345","Total",1591,392,146,246,1199,217,142,273,266,47,61,193
"2011","Newcastle upon Tyne 019D","E01008346","Total",1308,174,61,113,1134,66,60,183,156,61,128,480
"2011","Newcastle upon Tyne 019E","E01008347","Total",1408,150,71,79,1258,33,128,239,214,120,244,280
"2011","Newcastle upon Tyne 019F","E01008348","Total",1177,95,43,52,1082,82,72,203,104,166,203,252
"2011","Newcastle upon Tyne 019G","E01008349","Total",1565,108,53,55,1457,48,66,229,108,258,407,341
"2011","Newcastle upon Tyne 019H","E01008350","Total",1301,178,86,92,1123,105,114,325,186,51,148,194
"2011","Newcastle upon Tyne 020A","E01008430","Total",1354,217,92,125,1137,134,114,195,234,49,144,267
"2011","Newcastle upon Tyne 020B","E01008431","Total",1353,202,79,123,1151,84,138,251,228,43,100,307
"2011","Newcastle upon Tyne 020C","E01008433","Total",1373,217,149,68,1156,30,222,223,204,26,101,350
"2011","Newcastle upon Tyne 020D","E01008434","Total",1477,157,110,47,1320,19,180,264,202,25,259,371
"2011","Newcastle upon Tyne 020E","E01008435","Total",1474,185,78,107,1289,167,138,312,186,74,148,264
"2011","Newcastle upon Tyne 020F","E01008436","Total",1489,419,119,300,1070,123,94,238,192,63,132,228
"2011","Newcastle upon Tyne 021A","E01008381","Total",1375,223,58,165,1152,51,130,336,308,30,70,227
"2011","Newcastle upon Tyne 021B","E01008382","Total",1287,144,74,70,1143,209,86,154,148,99,251,196
"2011","Newcastle upon Tyne 021C","E01008383","Total",1494,194,88,106,1300,228,126,300,216,86,126,218
"2011","Newcastle upon Tyne 021D","E01008384","Total",1387,175,104,71,1212,91,194,274,180,57,126,290
"2011","Newcastle upon Tyne 021E","E01008385","Total",1398,240,72,168,1158,146,92,245,246,64,115,250
"2011","Newcastle upon Tyne 021F","E01008386","Total",1364,138,78,60,1226,89,186,282,220,51,154,244
"2011","Newcastle upon Tyne 021G","E01008387","Total",1364,197,65,132,1167,58,178,250,286,58,139,198
"2011","Newcastle upon Tyne 022B","E01008396","Total",1747,234,33,201,1513,90,36,331,252,238,257,309
"2011","Newcastle upon Tyne 022C","E01008398","Total",1695,497,66,431,1198,122,46,222,226,149,223,210
"2011","Newcastle upon Tyne 022D","E01008449","Total",1755,135,19,116,1620,56,12,202,224,145,276,705
"2011","Newcastle upon Tyne 022E","E01008453","Total",1619,126,56,70,1493,24,122,253,196,160,317,421
"2011","Newcastle upon Tyne 022G","E01008455","Total",1646,121,41,80,1525,64,50,226,142,227,478,338
"2011","Newcastle upon Tyne 022H","E01033556","Total",2512,321,87,234,2191,61,60,202,352,125,294,1097
"2011","Newcastle upon Tyne 023A","E01008406","Total",1415,426,134,292,989,96,92,133,230,60,72,306
"2011","Newcastle upon Tyne 023B","E01008407","Total",1827,304,78,226,1523,55,54,64,292,22,32,1004
"2011","Newcastle upon Tyne 023D","E01008410","Total",1720,232,89,143,1488,58,100,173,276,42,76,763
"2011","Newcastle upon Tyne 023E","E01008412","Total",1657,152,37,115,1505,42,58,198,376,26,63,742
"2011","Newcastle upon Tyne 023F","E01008413","Total",1473,244,42,202,1229,54,28,112,200,31,27,777
"2011","Newcastle upon Tyne 023G","E01033548","Total",1091,382,66,316,709,34,66,109,332,0,31,137
"2011","Newcastle upon Tyne 023H","E01033553","Total",1278,364,34,330,914,38,16,35,306,6,11,502
"2011","Newcastle upon Tyne 024A","E01008394","Total",1439,142,16,126,1297,8,10,25,132,11,18,1093
"2011","Newcastle upon Tyne 024B","E01008395","Total",1269,476,183,293,793,47,110,118,220,25,49,224
"2011","Newcastle upon Tyne 024C","E01008397","Total",919,300,26,274,619,14,18,24,276,5,6,276
"2011","Newcastle upon Tyne 024D","E01008399","Total",1896,332,109,223,1564,178,100,275,174,212,277,348
"2011","Newcastle upon Tyne 024E","E01008439","Total",1708,393,87,306,1315,255,68,276,182,102,237,195
"2011","Newcastle upon Tyne 024G","E01033543","Total",1195,428,7,421,767,8,12,34,454,9,0,250
"2011","Newcastle upon Tyne 024H","E01033545","Total",1133,460,16,444,673,6,18,44,472,5,6,122
"2011","Newcastle upon Tyne 024I","E01033554","Total",1291,404,43,361,887,15,38,80,372,31,35,316
"2011","Newcastle upon Tyne 025B","E01008415","Total",1214,154,58,96,1060,183,92,235,180,57,128,185
"2011","Newcastle upon Tyne 025C","E01008416","Total",1690,214,102,112,1476,70,166,335,284,58,184,379
"2011","Newcastle upon Tyne 025E","E01033547","Total",2096,372,178,194,1724,312,156,344,248,120,244,300
"2011","Newcastle upon Tyne 026A","E01008301","Total",1776,384,66,318,1392,156,80,200,504,52,111,289
"2011","Newcastle upon Tyne 026B","E01008302","Total",1580,328,110,218,1252,205,124,269,260,56,106,232
"2011","Newcastle upon Tyne 026C","E01008304","Total",1866,652,120,532,1214,223,82,174,292,116,155,172
"2011","Newcastle upon Tyne 026D","E01008305","Total",2099,355,114,241,1744,347,98,287,320,230,237,225
"2011","Newcastle upon Tyne 026E","E01008391","Total",1485,150,55,95,1335,216,100,262,186,128,192,251
"2011","Newcastle upon Tyne 026F","E01008392","Total",1535,318,76,242,1217,127,110,253,316,73,102,236
"2011","Newcastle upon Tyne 026G","E01008432","Total",1344,235,112,123,1109,75,172,212,200,40,128,282
"2011","Newcastle upon Tyne 027A","E01008288","Total",1321,234,108,126,1087,96,114,207,248,104,60,258
"2011","Newcastle upon Tyne 027B","E01008289","Total",1503,184,88,96,1319,196,118,215,166,97,204,323
"2011","Newcastle upon Tyne 027C","E01008290","Total",1277,193,59,134,1084,174,88,170,142,81,187,242
"2011","Newcastle upon Tyne 027D","E01008291","Total",2133,344,106,238,1789,339,88,293,256,249,294,270
"2011","Newcastle upon Tyne 027E","E01008292","Total",1342,141,77,64,1201,40,160,276,238,79,128,280
"2011","Newcastle upon Tyne 028A","E01008388","Total",1801,312,131,181,1489,290,162,339,250,83,169,196
"2011","Newcastle upon Tyne 028B","E01008389","Total",1739,280,121,159,1459,303,100,306,234,110,149,257
"2011","Newcastle upon Tyne 028C","E01008426","Total",1654,168,69,99,1486,308,102,329,138,95,187,327
"2011","Newcastle upon Tyne 028D","E01008429","Total",1374,228,110,118,1146,180,122,224,158,68,146,248
"2011","Newcastle upon Tyne 029A","E01008331","Total",1882,151,18,133,1731,147,18,336,142,206,538,344
"2011","Newcastle upon Tyne 029B","E01008332","Total",2271,344,109,235,1927,188,94,451,214,288,343,349
"2011","Newcastle upon Tyne 029C","E01008333","Total",1615,158,47,111,1457,54,56,214,144,273,441,275
"2011","Newcastle upon Tyne 029D","E01008334","Total",2040,279,83,196,1761,124,100,422,294,194,279,348
"2011","Newcastle upon Tyne 029E","E01008335","Total",2075,163,49,114,1912,108,90,316,196,354,519,329
"2011","Newcastle upon Tyne 029F","E01008437","Total",1115,294,95,199,821,108,68,168,168,108,60,141
"2011","Newcastle upon Tyne 029G","E01008438","Total",1630,453,95,358,1177,145,88,188,260,84,194,218
"2011","Newcastle upon Tyne 030A","E01008390","Total",1792,302,98,204,1490,378,100,324,216,144,113,215
"2011","Newcastle upon Tyne 030B","E01008425","Total",1737,635,161,474,1102,135,130,176,278,44,171,168
"2011","Newcastle upon Tyne 030C","E01008427","Total",1172,251,66,185,921,151,102,128,186,80,72,202
"2011","Newcastle upon Tyne 030D","E01008428","Total",1230,182,65,117,1048,151,118,213,172,62,155,177
"2011","Newcastle upon Tyne 031A","E01008441","Total",1649,277,170,107,1372,124,188,281,274,64,131,310
"2011","Newcastle upon Tyne 031B","E01008442","Total",1374,177,115,62,1197,39,280,268,218,31,129,232
"2011","Newcastle upon Tyne 031C","E01008444","Total",1541,166,99,67,1375,67,262,293,240,46,171,296
"2011","Newcastle upon Tyne 031D","E01008445","Total",1875,237,122,115,1638,109,214,357,246,57,239,416
"2011","Newcastle upon Tyne 031E","E01008446","Total",1417,163,118,45,1254,27,348,240,228,20,126,265
"2011","Newcastle upon Tyne 031F","E01008447","Total",1317,200,149,51,1117,24,262,232,172,30,107,290
"2011","Newcastle upon Tyne 031G","E01008448","Total",1482,140,67,73,1342,20,232,293,270,39,99,389
"2011","North Tyneside 001A","E01008547","Total",1384,155,100,55,1229,26,348,242,166,101,144,202
"2011","North Tyneside 001B","E01008548","Total",1294,89,52,37,1205,15,304,232,188,26,113,327
"2011","North Tyneside 001C","E01008549","Total",1486,209,139,70,1277,40,330,293,196,26,128,264
"2011","North Tyneside 001D","E01008551","Total",1458,199,144,55,1259,24,304,321,232,47,122,209
"2011","North Tyneside 002A","E01008478","Total",1565,319,133,186,1246,167,174,268,244,52,127,214
"2011","North Tyneside 002B","E01008480","Total",1504,246,102,144,1258,132,200,288,286,46,116,190
"2011","North Tyneside 002C","E01008504","Total",1528,127,55,72,1401,37,232,325,328,55,140,284
"2011","North Tyneside 002D","E01008578","Total",1396,160,55,105,1236,93,142,288,266,56,149,242
"2011","North Tyneside 002E","E01008583","Total",1461,177,71,106,1284,116,96,349,252,71,150,250
"2011","North Tyneside 003A","E01008520","Total",1363,163,90,73,1200,51,152,307,218,95,134,243
"2011","North Tyneside 003B","E01008523","Total",1317,80,42,38,1237,48,136,354,180,125,163,231
"2011","North Tyneside 003C","E01008546","Total",1477,134,93,41,1343,39,262,396,208,81,134,223
"2011","North Tyneside 003D","E01008550","Total",1622,150,65,85,1472,53,140,461,242,115,159,302
"2011","North Tyneside 004A","E01008577","Total",1365,250,142,108,1115,95,212,261,210,38,121,178
"2011","North Tyneside 004B","E01008579","Total",1497,229,162,67,1268,52,386,242,250,26,73,239
"2011","North Tyneside 004C","E01008580","Total",1389,174,76,98,1215,58,168,354,260,49,106,220
"2011","North Tyneside 004D","E01008581","Total",1322,217,143,74,1105,27,330,194,254,15,97,188
"2011","North Tyneside 004E","E01008582","Total",1349,238,108,130,1111,87,118,268,242,89,86,221
"2011","North Tyneside 005A","E01008517","Total",1593,120,65,55,1473,58,188,521,162,110,146,288
"2011","North Tyneside 005B","E01008519","Total",1361,261,107,154,1100,64,142,266,230,25,169,204
"2011","North Tyneside 005C","E01008521","Total",1446,240,118,122,1206,63,224,258,264,62,73,262
"2011","North Tyneside 005D","E01008522","Total",1597,155,89,66,1442,35,226,427,264,86,122,282
"2011","North Tyneside 006A","E01008584","Total",1427,275,54,221,1152,115,64,249,260,54,131,279
"2011","North Tyneside 006B","E01008585","Total",1563,188,54,134,1375,106,104,374,290,95,169,237
"2011","North Tyneside 006C","E01008587","Total",1310,259,88,171,1051,47,90,260,314,42,103,195
"2011","North Tyneside 006D","E01008588","Total",1535,231,55,176,1304,94,92,338,288,58,154,280
"2011","North Tyneside 006E","E01008589","Total",1446,111,52,59,1335,26,158,435,214,55,131,316
"2011","North Tyneside 007A","E01008518","Total",1610,301,156,145,1309,67,228,365,268,35,94,252
"2011","North Tyneside 007B","E01008564","Total",1424,173,92,81,1251,46,202,295,268,36,100,304
"2011","North Tyneside 007C","E01008565","Total",2026,238,76,162,1788,188,148,504,420,91,157,280
"2011","North Tyneside 007D","E01008567","Total",1382,165,51,114,1217,204,96,292,220,86,110,209
"2011","North Tyneside 008A","E01008475","Total",1656,153,46,107,1503,73,122,537,356,20,136,259
"2011","North Tyneside 008B","E01008476","Total",1698,291,123,168,1407,234,138,289,248,101,111,286
"2011","North Tyneside 008C","E01008477","Total",1642,171,70,101,1471,222,140,360,174,110,156,309
"2011","North Tyneside 008D","E01008479","Total",1356,218,78,140,1138,47,156,270,312,31,100,222
"2011","North Tyneside 009A","E01008552","Total",1620,242,124,118,1378,60,216,363,314,36,156,233
"2011","North Tyneside 009B","E01008553","Total",1795,303,120,183,1492,155,186,356,288,80,154,273
"2011","North Tyneside 009C","E01008554","Total",1690,159,70,89,1531,141,158,339,258,102,227,306
"2011","North Tyneside 009D","E01008555","Total",1629,198,122,76,1431,142,164,313,198,145,191,278
"2011","North Tyneside 009E","E01008586","Total",1526,236,126,110,1290,69,130,374,256,114,124,223
"2011","North Tyneside 010A","E01008495","Total",1723,197,123,74,1526,51,280,397,218,67,120,393
"2011","North Tyneside 010B","E01008496","Total",1483,363,163,200,1120,53,138,259,302,51,119,198
"2011","North Tyneside 010C","E01008497","Total",1451,184,134,50,1267,41,266,373,228,20,90,249
"2011","North Tyneside 010D","E01008498","Total",1509,229,187,42,1280,26,426,243,192,45,111,237
"2011","North Tyneside 011B","E01008568","Total",1479,199,120,79,1280,81,276,267,262,37,93,264
"2011","North Tyneside 011C","E01008569","Total",1460,199,102,97,1261,217,162,315,218,59,110,180
"2011","North Tyneside 011D","E01008570","Total",1337,172,61,111,1165,63,110,371,324,55,107,135
"2011","North Tyneside 011E","E01032647","Total",1719,101,5,96,1618,63,52,646,458,97,127,175
"2011","North Tyneside 011F","E01032648","Total",1530,213,67,146,1317,167,78,357,254,155,120,186
"2011","North Tyneside 012A","E01008500","Total",1555,250,95,155,1305,45,194,356,290,68,118,234
"2011","North Tyneside 012B","E01008505","Total",1668,299,102,197,1369,69,224,382,296,61,125,212
"2011","North Tyneside 012C","E01008506","Total",1390,182,87,95,1208,116,134,246,252,38,152,270
"2011","North Tyneside 012D","E01008507","Total",1502,143,59,84,1359,43,154,377,296,58,129,302
"2011","North Tyneside 013A","E01008493","Total",1503,168,110,58,1335,63,226,315,248,55,157,271
"2011","North Tyneside 013B","E01008494","Total",1519,277,162,115,1242,124,212,294,232,49,95,236
"2011","North Tyneside 013C","E01008556","Total",1924,266,153,113,1658,69,286,393,272,62,259,317
"2011","North Tyneside 013D","E01008557","Total",1630,90,54,36,1540,22,232,339,248,67,208,424
"2011","North Tyneside 014A","E01008470","Total",1349,222,105,117,1127,124,152,247,250,26,85,243
"2011","North Tyneside 014B","E01008499","Total",1679,213,94,119,1466,125,194,422,266,82,154,223
"2011","North Tyneside 014C","E01008502","Total",1630,186,92,94,1444,134,182,313,282,126,99,308
"2011","North Tyneside 014D","E01008516","Total",1313,238,135,103,1075,35,272,268,210,25,89,176
"2011","North Tyneside 015A","E01008488","Total",1423,225,78,147,1198,146,134,272,240,71,138,197
"2011","North Tyneside 015B","E01008489","Total",1728,254,121,133,1474,232,160,346,186,94,222,234
"2011","North Tyneside 015C","E01008490","Total",1552,285,124,161,1267,65,278,238,272,42,120,252
"2011","North Tyneside 015D","E01008491","Total",1578,145,55,90,1433,173,134,330,214,101,198,283
"2011","North Tyneside 016A","E01008558","Total",1527,413,150,263,1114,75,184,250,360,25,67,153
"2011","North Tyneside 016B","E01008560","Total",1681,360,144,216,1321,57,170,335,384,75,71,229
"2011","North Tyneside 016C","E01008561","Total",1582,423,149,274,1159,124,164,217,362,26,96,170
"2011","North Tyneside 016D","E01008562","Total",1460,184,88,96,1276,59,224,298,232,55,127,281
"2011","North Tyneside 017A","E01008525","Total",1489,269,137,132,1220,46,222,345,266,45,93,203
"2011","North Tyneside 017B","E01008527","Total",1475,297,88,209,1178,73,162,240,336,31,83,253
"2011","North Tyneside 017C","E01008559","Total",1502,359,106,253,1143,70,78,337,358,36,68,196
"2011","North Tyneside 017D","E01008563","Total",1448,130,94,36,1318,52,252,331,216,81,131,255
"2011","North Tyneside 018A","E01008469","Total",1456,322,119,203,1134,50,218,236,282,40,68,240
"2011","North Tyneside 018B","E01008472","Total",1494,212,137,75,1282,47,222,366,236,55,125,231
"2011","North Tyneside 018C","E01008473","Total",1236,142,70,72,1094,37,154,282,232,72,89,228
"2011","North Tyneside 018D","E01008501","Total",2091,135,32,103,1956,102,92,751,364,128,206,313
"2011","North Tyneside 018E","E01008503","Total",1588,324,117,207,1264,134,146,314,252,78,126,214
"2011","North Tyneside 019A","E01008471","Total",1629,170,87,83,1459,132,154,327,242,98,157,349
"2011","North Tyneside 019B","E01008474","Total",1454,196,71,125,1258,162,86,252,200,79,196,283
"2011","North Tyneside 019C","E01008513","Total",2235,442,180,262,1793,203,170,420,576,57,124,243
"2011","North Tyneside 019D","E01008514","Total",1807,228,128,100,1579,179,156,333,306,62,253,290
"2011","North Tyneside 019F","E01032649","Total",1095,268,89,179,827,85,78,191,360,40,12,61
"2011","North Tyneside 019G","E01032650","Total",1038,297,72,225,741,95,86,138,254,10,54,104
"2011","North Tyneside 020A","E01008486","Total",1415,226,107,119,1189,171,166,295,208,17,70,262
"2011","North Tyneside 020B","E01008487","Total",1429,260,105,155,1169,122,208,157,228,48,105,301
"2011","North Tyneside 020C","E01008526","Total",1464,133,66,67,1331,43,204,358,292,45,113,276
"2011","North Tyneside 020D","E01008530","Total",1575,291,168,123,1284,49,316,250,258,35,107,269
"2011","North Tyneside 021A","E01008461","Total",1428,203,75,128,1225,149,136,269,224,54,199,194
"2011","North Tyneside 021B","E01008466","Total",1326,112,39,73,1214,33,148,241,308,20,95,369
"2011","North Tyneside 021C","E01008467","Total",1409,196,61,135,1213,118,104,324,244,25,86,312
"2011","North Tyneside 021D","E01008468","Total",1436,193,58,135,1243,140,118,329,246,40,150,220
"2011","North Tyneside 022A","E01008483","Total",1561,282,55,227,1279,155,96,321,340,20,90,257
"2011","North Tyneside 022B","E01008524","Total",1674,724,212,512,950,89,170,150,334,15,32,160
"2011","North Tyneside 022C","E01008528","Total",1381,193,50,143,1188,91,144,247,320,55,114,217
"2011","North Tyneside 022D","E01008529","Total",1566,281,110,171,1285,64,178,271,316,70,126,260
"2011","North Tyneside 023A","E01008481","Total",1480,168,86,82,1312,182,148,295,164,49,161,313
"2011","North Tyneside 023B","E01008482","Total",1615,373,117,256,1242,218,128,276,240,67,126,187
"2011","North Tyneside 023C","E01008484","Total",1342,242,49,193,1100,191,84,214,248,98,83,182
"2011","North Tyneside 023D","E01008485","Total",1545,208,57,151,1337,340,82,284,148,131,174,178
"2011","North Tyneside 023E","E01008492","Total",1724,243,85,158,1481,199,140,311,268,42,236,285
"2011","North Tyneside 024A","E01008462","Total",1198,191,93,98,1007,86,104,248,192,46,115,216
"2011","North Tyneside 024B","E01008463","Total",1334,197,101,96,1137,100,168,216,236,27,110,280
"2011","North Tyneside 024C","E01008464","Total",1383,207,90,117,1176,85,212,256,288,56,81,198
"2011","North Tyneside 024D","E01008465","Total",1427,193,106,87,1234,67,218,298,214,55,105,277
"2011","North Tyneside 025A","E01008531","Total",1439,180,55,125,1259,42,130,243,294,45,114,391
"2011","North Tyneside 025B","E01008532","Total",1526,221,109,112,1305,178,156,309,270,80,117,195
"2011","North Tyneside 025C","E01008534","Total",1372,183,77,106,1189,61,160,221,284,15,127,321
"2011","North Tyneside 025D","E01008538","Total",1251,135,33,102,1116,49,98,269,196,10,132,362
"2011","North Tyneside 026A","E01008508","Total",1556,144,71,73,1412,137,134,317,228,86,178,332
"2011","North Tyneside 026B","E01008509","Total",1627,282,124,158,1345,155,138,292,248,122,116,274
"2011","North Tyneside 026C","E01008510","Total",1559,283,99,184,1276,128,178,314,278,57,80,241
"2011","North Tyneside 026D","E01008512","Total",1520,328,132,196,1192,126,132,224,290,52,177,191
"2011","North Tyneside 027A","E01008539","Total",1428,271,46,225,1157,89,68,354,432,30,57,127
"2011","North Tyneside 027B","E01008540","Total",1633,275,66,209,1358,266,118,349,194,101,91,239
"2011","North Tyneside 027C","E01008541","Total",1579,350,136,214,1229,183,116,310,264,52,125,179
"2011","North Tyneside 027D","E01008544","Total",1614,575,142,433,1039,166,88,256,248,58,63,160
"2011","North Tyneside 027E","E01008545","Total",1234,345,85,260,889,139,92,225,182,56,83,112
"2011","North Tyneside 028A","E01008511","Total",1684,269,108,161,1415,176,138,346,300,96,121,238
"2011","North Tyneside 028B","E01008542","Total",1579,253,123,130,1326,301,116,314,212,91,101,191
"2011","North Tyneside 028C","E01008543","Total",2152,280,45,235,1872,298,78,522,422,106,176,270
"2011","North Tyneside 028D","E01008571","Total",1722,376,172,204,1346,166,142,308,330,57,118,225
"2011","North Tyneside 029A","E01008572","Total",1651,486,75,411,1165,167,86,254,324,55,94,185
"2011","North Tyneside 029B","E01008573","Total",1604,387,65,322,1217,199,62,208,348,70,81,249
"2011","North Tyneside 029C","E01008574","Total",1593,199,100,99,1394,58,188,324,294,90,134,306
"2011","North Tyneside 029D","E01008576","Total",2079,208,68,140,1871,211,136,485,374,106,267,292
"2011","North Tyneside 030A","E01008533","Total",1489,189,102,87,1300,147,136,244,218,123,148,284
"2011","North Tyneside 030B","E01008535","Total",1473,183,82,101,1290,65,192,271,310,37,115,300
"2011","North Tyneside 030C","E01008536","Total",1432,362,78,284,1070,79,88,250,288,43,119,203
"2011","North Tyneside 030D","E01008537","Total",1310,283,112,171,1027,58,134,256,242,31,91,215
"2011","North Tyneside 030E","E01008575","Total",1294,322,92,230,972,94,88,195,320,56,89,130
"2011","South Tyneside 001A","E01008595","Total",1555,352,82,270,1203,146,132,245,350,62,87,181
"2011","South Tyneside 001B","E01008596","Total",1424,233,86,147,1191,169,76,173,100,196,296,181
"2011","South Tyneside 001C","E01008597","Total",2265,354,74,280,1911,149,176,476,486,59,212,353
"2011","South Tyneside 001D","E01008598","Total",1534,225,58,167,1309,115,134,209,248,118,230,255
"2011","South Tyneside 001E","E01008599","Total",1473,324,151,173,1149,141,178,157,196,80,160,237
"2011","South Tyneside 002A","E01008664","Total",1435,343,72,271,1092,118,58,235,198,62,158,263
"2011","South Tyneside 002B","E01008665","Total",1428,364,65,299,1064,138,82,232,260,51,93,208
"2011","South Tyneside 002C","E01008666","Total",1394,469,134,335,925,179,76,196,172,62,59,181
"2011","South Tyneside 002D","E01008667","Total",1570,464,150,314,1106,180,192,163,278,59,32,202
"2011","South Tyneside 002E","E01008668","Total",1515,422,123,299,1093,137,104,214,216,76,102,244
"2011","South Tyneside 003A","E01008673","Total",1199,153,67,86,1046,39,146,232,194,46,125,264
"2011","South Tyneside 003B","E01008675","Total",1423,343,94,249,1080,104,116,275,324,44,63,154
"2011","South Tyneside 003C","E01008676","Total",1173,203,52,151,970,62,76,237,218,35,146,196
"2011","South Tyneside 003D","E01008677","Total",1252,207,96,111,1045,57,182,225,194,5,123,259
"2011","South Tyneside 003E","E01008678","Total",1225,274,84,190,951,70,102,171,264,35,96,213
"2011","South Tyneside 004A","E01008647","Total",1460,188,128,60,1272,28,286,257,224,25,138,314
"2011","South Tyneside 004B","E01008648","Total",1369,231,133,98,1138,37,288,167,242,47,66,291
"2011","South Tyneside 004C","E01008649","Total",1624,245,143,102,1379,132,170,259,188,93,232,305
"2011","South Tyneside 004D","E01008651","Total",1852,217,71,146,1635,407,126,385,190,98,158,271
"2011","South Tyneside 005A","E01008679","Total",1303,240,96,144,1063,78,154,182,220,50,126,253
"2011","South Tyneside 005B","E01008680","Total",1425,143,96,47,1282,23,246,276,224,68,111,334
"2011","South Tyneside 005C","E01008682","Total",1238,159,75,84,1079,174,130,213,110,75,183,194
"2011","South Tyneside 005D","E01008683","Total",1409,308,74,234,1101,134,94,194,316,42,91,230
"2011","South Tyneside 006A","E01008635","Total",1370,210,137,73,1160,83,240,203,182,47,129,276
"2011","South Tyneside 006B","E01008650","Total",1419,142,86,56,1277,63,174,304,254,40,107,335
"2011","South Tyneside 006C","E01008674","Total",1266,97,51,46,1169,32,192,216,198,66,135,330
"2011","South Tyneside 006D","E01008681","Total",1402,196,127,69,1206,22,258,225,226,30,159,286
"2011","South Tyneside 007A","E01008600","Total",1318,246,55,191,1072,148,82,213,216,71,112,230
"2011","South Tyneside 007B","E01008604","Total",1538,359,94,265,1179,148,108,243,222,78,168,212
"2011","South Tyneside 007C","E01008660","Total",1413,234,67,167,1179,50,132,259,276,46,117,299
"2011","South Tyneside 007D","E01008661","Total",1099,177,71,106,922,88,144,166,184,21,99,220
"2011","South Tyneside 008A","E01008633","Total",1423,186,97,89,1237,190,116,218,180,96,146,291
"2011","South Tyneside 008B","E01008634","Total",1318,266,162,104,1052,134,126,233,148,47,143,221
"2011","South Tyneside 008C","E01008636","Total",1426,177,107,70,1249,94,168,256,156,51,184,340
"2011","South Tyneside 008D","E01008637","Total",1454,199,118,81,1255,83,158,278,198,52,190,296
"2011","South Tyneside 009A","E01008639","Total",1933,240,66,174,1693,258,102,428,396,62,182,265
"2011","South Tyneside 009B","E01008652","Total",1059,205,69,136,854,77,116,154,174,31,114,188
"2011","South Tyneside 009C","E01008653","Total",1273,134,64,70,1139,141,94,282,184,55,147,236
"2011","South Tyneside 009D","E01008654","Total",1227,251,47,204,976,72,76,257,226,41,59,245
"2011","South Tyneside 009E","E01008655","Total",1435,245,122,123,1190,113,142,198,220,52,189,276
"2011","South Tyneside 009F","E01008657","Total",1362,163,76,87,1199,49,170,293,186,46,150,305
"2011","South Tyneside 010A","E01008638","Total",1405,191,27,164,1214,98,50,429,242,46,166,183
"2011","South Tyneside 010B","E01008640","Total",1948,313,109,204,1635,126,142,443,352,86,152,334
"2011","South Tyneside 010C","E01008641","Total",1511,414,170,244,1097,135,138,213,262,62,130,157
"2011","South Tyneside 010D","E01008642","Total",1380,134,58,76,1246,51,182,224,242,55,140,352
"2011","South Tyneside 011A","E01008590","Total",1501,303,121,182,1198,143,148,253,256,41,87,270
"2011","South Tyneside 011B","E01008591","Total",1411,370,65,305,1041,203,100,194,234,15,83,212
"2011","South Tyneside 011C","E01008592","Total",1381,286,62,224,1095,150,100,234,244,30,95,242
"2011","South Tyneside 011D","E01008594","Total",1720,216,101,115,1504,191,156,337,242,92,154,332
"2011","South Tyneside 012A","E01008601","Total",1482,209,107,102,1273,155,132,216,198,130,157,285
"2011","South Tyneside 012B","E01008669","Total",1377,261,111,150,1116,158,128,156,200,69,164,241
"2011","South Tyneside 012C","E01008671","Total",1194,326,71,255,868,120,94,164,178,43,69,200
"2011","South Tyneside 012D","E01008672","Total",1316,188,89,99,1128,76,152,203,226,43,142,286
"2011","South Tyneside 013A","E01008622","Total",1605,185,116,69,1420,61,310,210,270,60,108,401
"2011","South Tyneside 013C","E01008625","Total",1470,302,141,161,1168,182,184,229,182,69,95,227
"2011","South Tyneside 013E","E01033074","Total",2115,238,118,120,1877,179,232,375,300,65,265,461
"2011","South Tyneside 014A","E01008602","Total",1458,188,84,104,1270,185,132,270,200,66,128,289
"2011","South Tyneside 014B","E01008603","Total",1294,302,96,206,992,108,114,154,180,42,156,238
"2011","South Tyneside 014C","E01008608","Total",1141,190,96,94,951,198,164,219,126,10,74,160
"2011","South Tyneside 014D","E01008670","Total",1511,304,150,154,1207,135,172,262,232,35,131,240
"2011","South Tyneside 015A","E01008643","Total",1430,178,90,88,1252,63,148,316,250,41,123,311
"2011","South Tyneside 015B","E01008644","Total",1503,319,181,138,1184,128,196,231,226,46,106,251
"2011","South Tyneside 015C","E01008645","Total",1454,229,108,121,1225,180,132,262,222,52,142,235
"2011","South Tyneside 015D","E01008646","Total",1351,183,123,60,1168,73,238,207,188,51,122,289
"2011","South Tyneside 015E","E01008656","Total",1388,177,102,75,1211,82,206,209,196,66,141,311
"2011","South Tyneside 015F","E01008658","Total",1443,142,75,67,1301,238,160,225,166,94,163,255
"2011","South Tyneside 016A","E01008593","Total",1262,195,51,144,1067,181,106,269,180,59,105,167
"2011","South Tyneside 016B","E01008605","Total",1163,142,58,84,1021,88,114,244,224,21,137,193
"2011","South Tyneside 016C","E01008606","Total",1413,243,97,146,1170,205,128,230,186,80,136,205
"2011","South Tyneside 016D","E01008607","Total",1380,175,65,110,1205,299,130,224,156,69,125,202
"2011","South Tyneside 016E","E01008609","Total",1461,214,98,116,1247,223,134,230,190,97,127,246
"2011","South Tyneside 017A","E01008631","Total",1472,172,71,101,1300,122,144,235,206,77,190,326
"2011","South Tyneside 017B","E01008632","Total",1236,209,102,107,1027,89,114,214,190,53,121,246
"2011","South Tyneside 017C","E01008659","Total",1483,189,112,77,1294,136,184,239,176,62,188,309
"2011","South Tyneside 017D","E01008662","Total",1247,144,75,69,1103,95,132,229,144,42,189,272
"2011","South Tyneside 017E","E01008663","Total",1372,220,128,92,1152,125,208,245,166,74,95,239
"2011","South Tyneside 018A","E01008624","Total",1417,175,85,90,1242,150,100,312,180,101,163,236
"2011","South Tyneside 018B","E01008684","Total",1204,229,123,106,975,86,156,178,206,27,117,205
"2011","South Tyneside 018C","E01008685","Total",1858,206,118,88,1652,130,258,319,330,90,177,348
"2011","South Tyneside 018D","E01008686","Total",1705,212,145,67,1493,88,244,308,222,68,194,369
"2011","South Tyneside 018E","E01008687","Total",1707,338,229,109,1369,63,286,299,266,61,122,272
"2011","South Tyneside 019A","E01008688","Total",1387,239,109,130,1148,142,170,267,188,54,87,240
"2011","South Tyneside 019B","E01008689","Total",1533,325,181,144,1208,123,220,210,220,55,119,261
"2011","South Tyneside 019C","E01008690","Total",1430,235,87,148,1195,125,130,278,186,60,167,249
"2011","South Tyneside 019D","E01008691","Total",1262,92,40,52,1170,38,140,203,212,48,163,366
"2011","South Tyneside 019E","E01008692","Total",1361,206,104,102,1155,75,160,239,202,52,115,312
"2011","South Tyneside 020A","E01008627","Total",1316,193,76,117,1123,41,162,263,268,10,97,282
"2011","South Tyneside 020B","E01008628","Total",1445,193,98,95,1252,210,164,198,156,57,185,282
"2011","South Tyneside 020C","E01008629","Total",1417,143,66,77,1274,65,164,347,252,31,116,299
"2011","South Tyneside 020D","E01008630","Total",1445,196,81,115,1249,186,126,300,178,83,164,212
"2011","South Tyneside 021A","E01008610","Total",1407,217,119,98,1190,239,148,256,168,77,128,174
"2011","South Tyneside 021B","E01008611","Total",1475,139,46,93,1336,33,100,382,296,32,155,338
"2011","South Tyneside 021C","E01008612","Total",1468,174,61,113,1294,42,138,301,300,57,122,334
"2011","South Tyneside 021D","E01008613","Total",1549,308,89,219,1241,157,122,272,240,97,89,264
"2011","South Tyneside 022A","E01008616","Total",1570,155,75,80,1415,64,180,369,238,60,168,336
"2011","South Tyneside 022B","E01008618","Total",1274,98,58,40,1176,15,268,269,156,54,142,272
"2011","South Tyneside 022C","E01008619","Total",1566,210,152,58,1356,27,344,258,212,46,132,337
"2011","South Tyneside 022D","E01008621","Total",1419,145,103,42,1274,28,222,325,260,41,115,283
"2011","South Tyneside 023A","E01008614","Total",1636,175,115,60,1461,94,200,294,260,104,216,293
"2011","South Tyneside 023B","E01008615","Total",1389,244,130,114,1145,111,156,228,286,52,69,243
"2011","South Tyneside 023C","E01008617","Total",1482,158,95,63,1324,44,210,371,232,53,145,269
"2011","South Tyneside 023D","E01008620","Total",1449,215,140,75,1234,42,266,305,200,55,126,240
"2011","Sunderland 001A","E01008713","Total",1604,127,73,54,1477,49,198,364,208,32,218,408
"2011","Sunderland 001B","E01008722","Total",1474,174,124,50,1300,55,256,309,214,45,110,311
"2011","Sunderland 001C","E01008724","Total",1206,93,62,31,1113,25,200,244,130,25,157,332
"2011","Sunderland 001D","E01008726","Total",1499,203,111,92,1296,44,228,330,228,60,112,294
"2011","Sunderland 002A","E01008723","Total",1381,154,107,47,1227,43,224,289,164,85,136,286
"2011","Sunderland 002B","E01008725","Total",1404,163,110,53,1241,27,278,299,218,30,131,258
"2011","Sunderland 002C","E01008727","Total",1539,295,141,154,1244,85,200,253,314,52,93,247
"2011","Sunderland 002D","E01008728","Total",1453,133,65,68,1320,35,156,321,218,35,182,373
"2011","Sunderland 002E","E01008792","Total",1174,128,81,47,1046,24,214,220,180,51,94,263
"2011","Sunderland 003A","E01008698","Total",1459,306,157,149,1153,113,164,272,228,36,125,215
"2011","Sunderland 003B","E01008837","Total",1292,260,104,156,1032,167,112,232,202,31,97,191
"2011","Sunderland 003C","E01008838","Total",1590,202,76,126,1388,156,162,357,186,42,182,303
"2011","Sunderland 003D","E01008839","Total",1359,298,112,186,1061,182,102,200,184,52,124,217
"2011","Sunderland 003E","E01008840","Total",1462,169,72,97,1293,140,122,291,168,95,235,242
"2011","Sunderland 003F","E01008841","Total",1195,183,77,106,1012,161,132,182,134,31,182,190
"2011","Sunderland 004A","E01008712","Total",1638,301,118,183,1337,128,180,256,228,62,192,291
"2011","Sunderland 004B","E01008817","Total",1118,139,45,94,979,171,80,188,142,66,135,197
"2011","Sunderland 004C","E01008819","Total",1408,188,113,75,1220,132,200,265,182,47,137,257
"2011","Sunderland 004D","E01008821","Total",1306,147,63,84,1159,195,172,197,158,55,187,195
"2011","Sunderland 004E","E01008822","Total",1621,242,86,156,1379,229,160,271,214,62,172,271
"2011","Sunderland 004F","E01008842","Total",1411,144,50,94,1267,95,116,278,272,38,163,305
"2011","Sunderland 005A","E01008708","Total",1480,251,162,89,1229,101,180,259,230,30,119,310
"2011","Sunderland 005B","E01008709","Total",1412,291,92,199,1121,167,90,204,220,75,119,246
"2011","Sunderland 005D","E01008711","Total",1439,285,117,168,1154,94,136,269,230,21,158,246
"2011","Sunderland 005F","E01008820","Total",1153,201,53,148,952,108,132,176,224,21,106,185
"2011","Sunderland 005G","E01033075","Total",2037,369,142,227,1668,218,168,334,330,132,204,282
"2011","Sunderland 006A","E01008786","Total",1431,202,103,99,1229,77,226,307,220,36,115,248
"2011","Sunderland 006B","E01008787","Total",1574,233,75,158,1341,96,138,229,290,41,135,412
"2011","Sunderland 006C","E01008788","Total",1510,290,103,187,1220,93,212,284,308,46,66,211
"2011","Sunderland 006D","E01008789","Total",1375,242,75,167,1133,60,150,273,220,27,90,313
"2011","Sunderland 006E","E01008790","Total",1514,214,81,133,1300,67,146,240,234,40,224,349
"2011","Sunderland 006F","E01008791","Total",1740,599,186,413,1141,57,176,158,266,44,100,340
"2011","Sunderland 007A","E01008855","Total",1486,208,23,185,1278,63,84,423,282,57,165,204
"2011","Sunderland 007B","E01008856","Total",1385,167,92,75,1218,39,270,210,256,40,101,302
"2011","Sunderland 007C","E01008876","Total",1468,89,46,43,1379,50,206,245,302,50,164,362
"2011","Sunderland 007D","E01008877","Total",1427,185,75,110,1242,39,198,312,268,75,137,213
"2011","Sunderland 008A","E01008693","Total",1212,205,89,116,1007,73,104,171,190,72,137,260
"2011","Sunderland 008B","E01008694","Total",1430,193,100,93,1237,131,148,294,182,88,138,256
"2011","Sunderland 008C","E01008695","Total",1527,142,68,74,1385,147,114,286,244,103,243,248
"2011","Sunderland 008D","E01008696","Total",1306,90,38,52,1216,53,100,347,196,51,170,299
"2011","Sunderland 008E","E01008697","Total",1275,182,125,57,1093,85,198,238,166,29,124,253
"2011","Sunderland 008F","E01008699","Total",1406,178,90,88,1228,154,132,236,210,50,197,249
"2011","Sunderland 009A","E01008853","Total",1371,188,63,125,1183,174,140,273,234,66,112,184
"2011","Sunderland 009B","E01008854","Total",1465,438,87,351,1027,109,82,244,264,54,98,176
"2011","Sunderland 009C","E01008857","Total",1390,208,114,94,1182,125,132,287,228,63,107,240
"2011","Sunderland 009D","E01008858","Total",1368,159,67,92,1209,240,114,294,182,79,87,213
"2011","Sunderland 009E","E01008859","Total",1382,143,35,108,1239,192,56,279,192,132,171,217
"2011","Sunderland 009F","E01008860","Total",1394,169,75,94,1225,179,126,204,200,69,146,301
"2011","Sunderland 009G","E01008878","Total",1578,167,86,81,1411,125,186,327,156,113,187,317
"2011","Sunderland 010A","E01008873","Total",1299,102,49,53,1197,48,200,254,284,42,110,259
"2011","Sunderland 010B","E01008874","Total",1803,134,63,71,1669,151,130,349,264,205,230,340
"2011","Sunderland 010C","E01008875","Total",1567,185,75,110,1382,145,86,444,320,31,132,224
"2011","Sunderland 010D","E01008879","Total",1443,185,86,99,1258,77,132,250,228,65,145,361
"2011","Sunderland 010E","E01008880","Total",1155,158,57,101,997,66,114,206,230,61,83,237
"2011","Sunderland 011A","E01008701","Total",1524,206,53,153,1318,173,94,244,230,52,190,335
"2011","Sunderland 011B","E01008704","Total",1445,252,100,152,1193,109,96,256,204,96,183,249
"2011","Sunderland 011C","E01008706","Total",1618,229,100,129,1389,128,94,270,204,134,198,361
"2011","Sunderland 011D","E01008707","Total",1303,182,50,132,1121,93,80,236,210,96,168,238
"2011","Sunderland 012A","E01008756","Total",1513,214,116,98,1299,164,150,156,186,65,206,372
"2011","Sunderland 012B","E01008762","Total",1518,185,87,98,1333,200,126,238,202,50,204,313
"2011","Sunderland 012C","E01008812","Total",1723,213,73,140,1510,245,124,396,260,55,173,257
"2011","Sunderland 012F","E01033076","Total",1548,153,66,87,1395,162,124,238,168,79,248,376
"2011","Sunderland 013A","E01008700","Total",1106,192,70,122,914,116,82,167,196,22,83,248
"2011","Sunderland 013B","E01008703","Total",1712,624,158,466,1088,60,140,88,532,17,25,226
"2011","Sunderland 013C","E01008705","Total",1109,178,54,124,931,106,64,127,166,23,108,337
"2011","Sunderland 013D","E01008831","Total",2181,601,93,508,1580,76,100,216,412,74,165,537
"2011","Sunderland 013E","E01008834","Total",1789,514,64,450,1275,72,64,181,436,45,151,326
"2011","Sunderland 014A","E01008810","Total",1635,215,76,139,1420,154,168,347,234,47,152,318
"2011","Sunderland 014B","E01008811","Total",1619,189,100,89,1430,105,196,339,236,31,182,341
"2011","Sunderland 014C","E01008813","Total",1512,195,98,97,1317,111,168,229,202,73,222,312
"2011","Sunderland 014D","E01008814","Total",1551,168,81,87,1383,126,194,271,274,83,127,308
"2011","Sunderland 015A","E01008757","Total",1442,209,83,126,1233,112,180,241,206,50,137,307
"2011","Sunderland 015B","E01008758","Total",1445,145,96,49,1300,36,214,297,210,36,168,339
"2011","Sunderland 015C","E01008759","Total",1465,210,105,105,1255,74,214,258,246,25,87,351
"2011","Sunderland 015D","E01008761","Total",1359,166,95,71,1193,40,230,231,192,28,199,273
"2011","Sunderland 016A","E01008702","Total",1107,266,100,166,841,164,96,134,164,49,94,140
"2011","Sunderland 016B","E01008735","Total",1962,547,196,351,1415,128,136,218,348,144,179,262
"2011","Sunderland 016C","E01008736","Total",1232,268,67,201,964,187,78,165,176,41,133,184
"2011","Sunderland 016D","E01008737","Total",1364,244,50,194,1120,135,72,212,228,89,111,273
"2011","Sunderland 016E","E01008738","Total",1316,233,48,185,1083,141,94,199,198,54,117,280
"2011","Sunderland 016F","E01008836","Total",1354,409,98,311,945,64,104,99,170,77,273,158
"2011","Sunderland 017A","E01008845","Total",1423,221,69,152,1202,48,232,245,290,41,115,231
"2011","Sunderland 017B","E01008846","Total",1146,129,47,82,1017,137,82,206,144,90,139,219
"2011","Sunderland 017C","E01008847","Total",1376,106,41,65,1270,176,72,237,210,168,198,209
"2011","Sunderland 017D","E01008850","Total",1723,83,38,45,1640,50,130,397,288,108,221,446
"2011","Sunderland 017E","E01008851","Total",1592,276,101,175,1316,82,152,325,314,80,85,278
"2011","Sunderland 018A","E01008760","Total",1495,175,79,96,1320,69,156,288,240,62,152,353
"2011","Sunderland 018B","E01008830","Total",1523,187,40,147,1336,57,88,232,168,122,237,432
"2011","Sunderland 018C","E01008832","Total",1570,193,68,125,1377,95,140,331,198,161,193,259
"2011","Sunderland 018D","E01008833","Total",1467,221,102,119,1246,41,198,215,188,74,220,310
"2011","Sunderland 019A","E01008843","Total",1282,141,56,85,1141,47,182,219,250,35,143,265
"2011","Sunderland 019B","E01008844","Total",1420,240,130,110,1180,52,264,239,222,36,87,280
"2011","Sunderland 019C","E01008848","Total",1343,152,92,60,1191,36,270,217,268,32,78,290
"2011","Sunderland 019D","E01008849","Total",1257,135,39,96,1122,185,64,248,158,107,159,201
"2011","Sunderland 019E","E01008852","Total",1245,135,59,76,1110,38,94,306,272,35,100,265
"2011","Sunderland 020A","E01008867","Total",1657,362,35,327,1295,159,52,268,316,187,119,194
"2011","Sunderland 020B","E01008868","Total",1219,114,39,75,1105,39,100,253,278,16,95,324
"2011","Sunderland 020C","E01008869","Total",1315,107,55,52,1208,60,130,287,242,62,149,278
"2011","Sunderland 020D","E01008870","Total",1443,130,45,85,1313,41,122,395,292,42,139,282
"2011","Sunderland 020E","E01008871","Total",1466,162,57,105,1304,112,120,276,246,53,247,250
"2011","Sunderland 020F","E01008872","Total",1477,190,73,117,1287,45,156,302,324,36,103,321
"2011","Sunderland 021A","E01008729","Total",1066,150,58,92,916,133,66,167,180,45,148,177
"2011","Sunderland 021B","E01008730","Total",1661,174,74,100,1487,171,108,259,188,108,322,331
"2011","Sunderland 021C","E01008731","Total",1273,134,80,54,1139,161,122,203,160,74,156,263
"2011","Sunderland 021D","E01008732","Total",2119,299,147,152,1820,185,174,579,332,65,196,289
"2011","Sunderland 021E","E01008733","Total",1641,453,163,290,1188,142,152,231,212,26,169,256
"2011","Sunderland 021F","E01008734","Total",1414,151,101,50,1263,33,348,178,210,26,121,347
"2011","Sunderland 022A","E01008740","Total",1381,183,120,63,1198,61,216,190,218,45,149,319
"2011","Sunderland 022B","E01008781","Total",1540,159,93,66,1381,36,210,298,238,50,170,379
"2011","Sunderland 022C","E01008782","Total",1459,139,102,37,1320,27,270,272,202,31,151,367
"2011","Sunderland 022D","E01008783","Total",1410,161,97,64,1249,16,252,247,270,58,101,305
"2011","Sunderland 022E","E01008784","Total",1584,158,103,55,1426,51,254,307,194,50,173,397
"2011","Sunderland 022F","E01008785","Total",1439,138,85,53,1301,28,316,248,244,5,161,299
"2011","Sunderland 022G","E01008835","Total",1503,192,47,145,1311,47,76,259,268,72,193,396
"2011","Sunderland 023A","E01008823","Total",1407,207,81,126,1200,106,166,203,148,79,179,319
"2011","Sunderland 023B","E01008824","Total",1507,188,51,137,1319,195,92,308,196,93,213,222
"2011","Sunderland 023C","E01008825","Total",1533,233,114,119,1300,104,222,219,166,61,185,343
"2011","Sunderland 023D","E01008826","Total",1446,162,74,88,1284,109,162,246,212,76,168,311
"2011","Sunderland 023E","E01008827","Total",1245,152,52,100,1093,161,118,185,158,95,144,232
"2011","Sunderland 023F","E01008828","Total",1585,178,77,101,1407,228,122,236,178,124,237,282
"2011","Sunderland 023G","E01008829","Total",1331,272,94,178,1059,153,80,203,184,66,174,199
"2011","Sunderland 024A","E01008739","Total",1585,129,50,79,1456,146,144,314,190,104,185,373
"2011","Sunderland 024B","E01008741","Total",1451,162,73,89,1289,89,162,309,248,51,135,295
"2011","Sunderland 024C","E01008779","Total",1446,265,148,117,1181,115,170,240,216,61,127,252
"2011","Sunderland 024D","E01008780","Total",1884,328,113,215,1556,129,144,410,236,70,198,369
"2011","Sunderland 025A","E01008799","Total",1665,122,42,80,1543,42,124,425,312,92,201,347
"2011","Sunderland 025B","E01008861","Total",1523,181,73,108,1342,101,198,226,246,62,178,331
"2011","Sunderland 025C","E01008862","Total",1441,86,39,47,1355,27,170,279,302,40,132,405
"2011","Sunderland 025D","E01008863","Total",1621,100,44,56,1521,39,212,333,298,56,199,384
"2011","Sunderland 025E","E01008864","Total",1289,108,37,71,1181,18,212,218,272,36,144,281
"2011","Sunderland 025F","E01008865","Total",1377,172,106,66,1205,82,190,256,234,68,130,245
"2011","Sunderland 025G","E01008866","Total",1410,194,70,124,1216,90,96,238,254,115,186,237
"2011","Sunderland 026A","E01008773","Total",1396,262,92,170,1134,178,110,312,208,48,84,194
"2011","Sunderland 026B","E01008776","Total",1182,133,70,63,1049,99,104,207,172,68,179,220
"2011","Sunderland 026C","E01008777","Total",1341,556,292,264,785,57,256,100,200,10,46,116
"2011","Sunderland 026D","E01008778","Total",1379,175,98,77,1204,134,166,276,204,48,145,231
"2011","Sunderland 026E","E01008809","Total",1541,197,93,104,1344,92,192,303,300,20,129,308
"2011","Sunderland 027A","E01008803","Total",1422,236,129,107,1186,112,150,240,214,93,107,270
"2011","Sunderland 027B","E01008804","Total",1589,188,105,83,1401,111,192,254,214,67,248,315
"2011","Sunderland 027C","E01008805","Total",1426,247,92,155,1179,133,112,261,206,46,129,292
"2011","Sunderland 027F","E01033077","Total",1798,206,105,101,1592,122,198,306,216,58,278,414
"2011","Sunderland 028A","E01008763","Total",1500,154,73,81,1346,153,150,258,196,70,237,282
"2011","Sunderland 028B","E01008764","Total",1496,181,86,95,1315,91,184,196,268,84,176,316
"2011","Sunderland 028C","E01008766","Total",2228,265,136,129,1963,166,162,472,306,105,362,390
"2011","Sunderland 028D","E01008768","Total",1411,137,58,79,1274,59,182,334,232,40,162,265
"2011","Sunderland 028E","E01008769","Total",1700,273,114,159,1427,145,164,364,264,59,169,262
"2011","Sunderland 029A","E01008772","Total",1366,162,102,60,1204,4,228,308,192,36,176,260
"2011","Sunderland 029B","E01008774","Total",1304,166,106,60,1138,79,268,212,188,41,108,242
"2011","Sunderland 029C","E01008775","Total",1407,135,86,49,1272,20,272,278,228,32,113,329
"2011","Sunderland 029D","E01008802","Total",1422,200,130,70,1222,32,236,224,228,52,152,298
"2011","Sunderland 029E","E01008808","Total",1442,178,34,144,1264,62,116,265,300,40,110,371
"2011","Sunderland 030A","E01008793","Total",1701,356,163,193,1345,224,146,299,212,100,112,252
"2011","Sunderland 030B","E01008795","Total",1797,153,72,81,1644,104,174,459,290,95,130,392
"2011","Sunderland 030C","E01008797","Total",1997,203,124,79,1794,80,300,524,298,78,177,337
"2011","Sunderland 030D","E01008800","Total",1436,178,62,116,1258,147,90,291,156,112,183,279
"2011","Sunderland 030E","E01008801","Total",1590,149,66,83,1441,53,182,401,288,56,182,279
"2011","Sunderland 031A","E01008765","Total",1531,125,51,74,1406,63,132,368,242,41,211,349
"2011","Sunderland 031B","E01008767","Total",1492,163,100,63,1329,82,202,272,228,47,176,322
"2011","Sunderland 031C","E01008770","Total",1404,177,66,111,1227,39,112,279,238,41,151,367
"2011","Sunderland 031D","E01008771","Total",1515,152,61,91,1363,74,158,373,216,67,151,324
"2011","Sunderland 032A","E01008720","Total",1389,186,75,111,1203,92,178,262,236,90,83,262
"2011","Sunderland 032B","E01008721","Total",1602,133,50,83,1469,52,128,481,270,105,133,300
"2011","Sunderland 032D","E01008796","Total",1523,163,62,101,1360,66,84,382,272,48,163,345
"2011","Sunderland 032F","E01032483","Total",1702,211,84,127,1491,98,144,283,308,92,195,371
"2011","Sunderland 032G","E01032484","Total",1281,170,67,103,1111,56,174,236,230,53,133,229
"2011","Sunderland 033A","E01008750","Total",1867,171,91,80,1696,102,180,476,332,47,169,390
"2011","Sunderland 033B","E01008751","Total",1038,131,61,70,907,68,134,189,186,16,105,209
"2011","Sunderland 033C","E01008752","Total",1634,224,91,133,1410,164,134,310,210,151,162,279
"2011","Sunderland 033D","E01008753","Total",1213,189,83,106,1024,90,148,274,186,35,75,216
"2011","Sunderland 033E","E01008755","Total",1338,176,72,104,1162,82,150,240,242,87,114,247
"2011","Sunderland 034A","E01008714","Total",1284,143,58,85,1141,180,126,258,150,82,144,201
"2011","Sunderland 034B","E01008715","Total",1291,192,91,101,1099,97,132,242,236,54,118,220
"2011","Sunderland 034C","E01008716","Total",1345,152,97,55,1193,31,252,225,206,42,105,332
"2011","Sunderland 034D","E01008717","Total",1635,163,86,77,1472,129,170,388,284,58,184,259
"2011","Sunderland 034E","E01008749","Total",1422,164,95,69,1258,31,318,205,230,40,139,295
"2011","Sunderland 034F","E01008754","Total",1390,296,169,127,1094,101,162,223,236,42,122,208
"2011","Sunderland 035A","E01008718","Total",1384,185,97,88,1199,49,200,226,210,49,185,280
"2011","Sunderland 035B","E01008719","Total",1175,224,111,113,951,84,116,224,174,45,90,218
"2011","Sunderland 035C","E01008742","Total",1689,254,123,131,1435,134,172,239,266,68,192,364
"2011","Sunderland 035D","E01008747","Total",1410,198,98,100,1212,52,240,255,266,35,108,256
"2011","Sunderland 035E","E01008748","Total",1345,221,139,82,1124,33,292,167,230,32,95,275
"2011","Sunderland 036A","E01008743","Total",1688,230,106,124,1458,203,164,302,214,131,168,276
"2011","Sunderland 036B","E01008744","Total",1616,288,104,184,1328,181,146,316,234,73,126,252
"2011","Sunderland 036C","E01008745","Total",1645,182,109,73,1463,61,244,322,350,57,130,299
"2011","Sunderland 036D","E01008746","Total",1643,246,101,145,1397,176,142,283,206,146,169,275
"2011","Blackburn with Darwen 001A","E01012607","Total",1504,202,86,116,1302,43,240,247,210,116,207,239
"2011","Blackburn with Darwen 001B","E01012608","Total",1640,286,85,201,1354,179,116,296,214,169,172,208
"2011","Blackburn with Darwen 001C","E01012633","Total",1592,269,124,145,1323,97,182,261,242,70,204,267
"2011","Blackburn with Darwen 001D","E01012634","Total",1386,183,57,126,1203,95,166,264,184,87,191,216
"2011","Blackburn with Darwen 001E","E01012635","Total",1641,139,74,65,1502,68,140,282,174,206,324,308
"2011","Blackburn with Darwen 001F","E01012636","Total",1503,199,134,65,1304,63,290,242,212,77,99,321
"2011","Blackburn with Darwen 002A","E01012581","Total",1243,113,53,60,1130,16,194,263,192,91,185,189
"2011","Blackburn with Darwen 002B","E01012582","Total",1618,77,36,41,1541,40,146,278,190,131,422,334
"2011","Blackburn with Darwen 002C","E01012583","Total",1642,148,87,61,1494,40,262,290,222,141,255,284
"2011","Blackburn with Darwen 002D","E01012587","Total",1938,163,60,103,1775,78,142,285,202,296,476,296
"2011","Blackburn with Darwen 002E","E01012588","Total",2086,134,41,93,1952,98,80,421,124,442,546,241
"2011","Blackburn with Darwen 003A","E01012574","Total",1439,198,96,102,1241,75,138,267,118,184,279,180
"2011","Blackburn with Darwen 003B","E01012577","Total",1914,98,33,65,1816,97,48,243,102,368,688,270
"2011","Blackburn with Darwen 003C","E01012578","Total",1976,90,30,60,1886,105,36,261,102,306,712,364
"2011","Blackburn with Darwen 003D","E01012605","Total",1883,142,66,76,1741,76,60,288,120,364,525,308
"2011","Blackburn with Darwen 003E","E01012606","Total",1681,94,33,61,1587,71,42,292,100,376,433,273
"2011","Blackburn with Darwen 004A","E01012579","Total",1650,178,67,111,1472,50,58,202,102,256,460,344
"2011","Blackburn with Darwen 004B","E01012580","Total",2159,70,15,55,2089,36,42,210,120,334,869,478
"2011","Blackburn with Darwen 004C","E01012642","Total",1643,124,30,94,1519,43,54,212,102,259,593,256
"2011","Blackburn with Darwen 004D","E01012645","Total",1948,109,50,59,1839,59,96,352,140,360,491,341
"2011","Blackburn with Darwen 005A","E01012585","Total",1512,118,64,54,1394,19,78,185,134,164,525,289
"2011","Blackburn with Darwen 005B","E01012586","Total",1594,159,41,118,1435,39,46,165,110,191,576,308
"2011","Blackburn with Darwen 005C","E01012656","Total",1648,253,58,195,1395,71,74,272,120,254,401,203
"2011","Blackburn with Darwen 005D","E01012657","Total",2029,253,57,196,1776,129,78,296,148,338,535,252
"2011","Blackburn with Darwen 005E","E01012658","Total",1799,251,101,150,1548,139,146,340,246,153,251,273
"2011","Blackburn with Darwen 006A","E01012629","Total",1109,169,24,145,940,136,48,236,166,72,140,142
"2011","Blackburn with Darwen 006B","E01012631","Total",1279,291,97,194,988,67,74,214,136,218,175,104
"2011","Blackburn with Darwen 006C","E01012643","Total",1600,288,85,203,1312,70,76,191,116,242,398,219
"2011","Blackburn with Darwen 006D","E01012644","Total",2507,104,29,75,2403,20,60,302,158,343,854,666
"2011","Blackburn with Darwen 006E","E01012655","Total",1668,494,167,327,1174,198,104,201,222,142,191,116
"2011","Blackburn with Darwen 007A","E01012571","Total",1474,113,32,81,1361,73,30,207,126,302,385,238
"2011","Blackburn with Darwen 007B","E01012572","Total",1552,175,53,122,1377,76,66,157,90,329,382,277
"2011","Blackburn with Darwen 007C","E01012573","Total",1800,85,25,60,1715,48,54,271,60,317,588,377
"2011","Blackburn with Darwen 007D","E01012575","Total",1284,259,87,172,1025,59,80,175,118,181,235,177
"2011","Blackburn with Darwen 007E","E01012630","Total",2271,100,18,82,2171,105,56,272,150,405,852,331
"2011","Blackburn with Darwen 008A","E01012576","Total",1450,228,104,124,1222,62,104,212,110,162,335,237
"2011","Blackburn with Darwen 008B","E01012637","Total",1583,191,56,135,1392,238,100,280,184,144,254,192
"2011","Blackburn with Darwen 008C","E01012638","Total",1607,276,91,185,1331,221,70,335,196,139,190,180
"2011","Blackburn with Darwen 008D","E01012639","Total",1803,213,54,159,1590,281,122,318,202,183,207,277
"2011","Blackburn with Darwen 008E","E01012640","Total",1751,220,62,158,1531,151,166,324,210,193,197,290
"2011","Blackburn with Darwen 008F","E01012641","Total",1672,122,36,86,1550,261,62,281,140,268,305,233
"2011","Blackburn with Darwen 009A","E01012595","Total",1866,336,128,208,1530,214,106,353,316,95,182,264
"2011","Blackburn with Darwen 009B","E01012596","Total",1773,283,56,227,1490,211,88,348,280,85,188,290
"2011","Blackburn with Darwen 009C","E01012622","Total",1651,367,99,268,1284,206,82,347,168,146,163,172
"2011","Blackburn with Darwen 009D","E01012623","Total",1530,204,68,136,1326,144,112,277,230,95,219,249
"2011","Blackburn with Darwen 009E","E01012624","Total",1570,277,98,179,1293,137,106,322,214,100,182,232
"2011","Blackburn with Darwen 009F","E01012625","Total",1616,301,87,214,1315,242,116,297,272,86,101,201
"2011","Blackburn with Darwen 010A","E01012584","Total",1445,105,44,61,1340,32,164,218,206,144,331,245
"2011","Blackburn with Darwen 010B","E01012609","Total",1577,136,91,45,1441,29,300,286,242,85,157,342
"2011","Blackburn with Darwen 010C","E01012610","Total",1274,107,65,42,1167,84,152,231,206,85,162,247
"2011","Blackburn with Darwen 010D","E01012611","Total",1051,140,74,66,911,43,190,173,198,30,84,193
"2011","Blackburn with Darwen 010E","E01012612","Total",1395,162,104,58,1233,56,322,257,182,41,108,267
"2011","Blackburn with Darwen 010F","E01012613","Total",1314,153,90,63,1161,39,188,287,184,26,147,290
"2011","Blackburn with Darwen 011A","E01012600","Total",1336,260,117,143,1076,132,156,185,164,104,151,184
"2011","Blackburn with Darwen 011B","E01012601","Total",1531,158,54,104,1373,225,102,237,172,186,180,271
"2011","Blackburn with Darwen 011C","E01012602","Total",1601,153,33,120,1448,81,68,507,316,79,128,269
"2011","Blackburn with Darwen 011D","E01012603","Total",1573,229,46,183,1344,251,66,252,180,154,235,206
"2011","Blackburn with Darwen 011E","E01012604","Total",1652,122,27,95,1530,144,90,387,220,213,229,247
"2011","Blackburn with Darwen 011F","E01012632","Total",2090,272,92,180,1818,84,126,370,246,195,445,352
"2011","Blackburn with Darwen 012A","E01012594","Total",1473,220,76,144,1253,193,110,262,162,163,172,191
"2011","Blackburn with Darwen 012B","E01012618","Total",1424,187,91,96,1237,75,212,239,278,40,138,255
"2011","Blackburn with Darwen 012C","E01012619","Total",1400,172,69,103,1228,197,102,195,132,141,239,222
"2011","Blackburn with Darwen 012D","E01012620","Total",1388,178,92,86,1210,65,272,191,248,37,114,283
"2011","Blackburn with Darwen 012E","E01012621","Total",1482,186,44,142,1296,152,112,291,208,121,159,253
"2011","Blackburn with Darwen 013A","E01012593","Total",1768,196,55,141,1572,106,154,459,314,103,182,254
"2011","Blackburn with Darwen 013B","E01012597","Total",1767,140,54,86,1627,69,114,460,300,107,236,341
"2011","Blackburn with Darwen 013C","E01012598","Total",2992,141,18,123,2851,144,130,1108,486,215,372,396
"2011","Blackburn with Darwen 013D","E01012599","Total",1145,142,49,93,1003,60,122,227,228,57,114,195
"2011","Blackburn with Darwen 014A","E01012589","Total",1386,239,89,150,1147,142,114,263,260,84,88,196
"2011","Blackburn with Darwen 014B","E01012590","Total",1345,237,111,126,1108,149,166,188,192,104,142,167
"2011","Blackburn with Darwen 014C","E01012591","Total",1466,255,83,172,1211,102,140,258,204,85,166,256
"2011","Blackburn with Darwen 014D","E01012648","Total",1178,189,51,138,989,128,82,254,206,70,100,149
"2011","Blackburn with Darwen 014E","E01012652","Total",1536,156,92,64,1380,33,248,234,266,63,176,360
"2011","Blackburn with Darwen 015A","E01012617","Total",1393,180,45,135,1213,164,96,250,230,74,115,284
"2011","Blackburn with Darwen 015B","E01012646","Total",1653,281,114,167,1372,231,108,291,224,121,163,234
"2011","Blackburn with Darwen 015C","E01012647","Total",1342,245,77,168,1097,143,190,196,208,57,103,200
"2011","Blackburn with Darwen 015D","E01012650","Total",1379,205,70,135,1174,178,102,197,230,116,214,137
"2011","Blackburn with Darwen 016A","E01012649","Total",1407,249,90,159,1158,154,106,234,182,104,171,207
"2011","Blackburn with Darwen 016B","E01012651","Total",1684,161,60,101,1523,167,174,360,272,108,170,272
"2011","Blackburn with Darwen 016C","E01012653","Total",1294,197,57,140,1097,136,106,255,216,46,138,200
"2011","Blackburn with Darwen 016D","E01012654","Total",1657,295,63,232,1362,144,86,289,318,153,158,214
"2011","Blackburn with Darwen 017A","E01012614","Total",1745,141,60,81,1604,72,140,424,276,88,239,365
"2011","Blackburn with Darwen 017B","E01012615","Total",1495,323,136,187,1172,101,190,252,240,63,90,236
"2011","Blackburn with Darwen 017C","E01012616","Total",1782,226,76,150,1556,104,152,438,308,76,194,284
"2011","Blackburn with Darwen 017D","E01012659","Total",1386,174,58,116,1212,55,112,342,244,77,104,278
"2011","Blackburn with Darwen 017E","E01012660","Total",1170,91,43,48,1079,41,144,233,198,61,124,278
"2011","Blackburn with Darwen 017F","E01012661","Total",1498,240,76,164,1258,102,120,335,280,61,112,248
"2011","Blackburn with Darwen 018A","E01012592","Total",1924,201,83,118,1723,56,274,315,404,82,212,380
"2011","Blackburn with Darwen 018D","E01012628","Total",1165,123,44,79,1042,18,136,244,258,30,135,221
"2011","Blackburn with Darwen 018E","E01032485","Total",1766,162,57,105,1604,50,200,428,326,101,153,346
"2011","Blackburn with Darwen 018F","E01032486","Total",1414,144,75,69,1270,47,254,309,238,41,160,221
"2011","Blackpool 001A","E01012663","Total",1602,294,150,144,1308,111,274,257,162,77,166,261
"2011","Blackpool 001B","E01012664","Total",1616,216,106,110,1400,135,206,300,262,72,138,287
"2011","Blackpool 001C","E01012665","Total",1642,346,240,106,1296,87,406,212,250,36,85,220
"2011","Blackpool 001D","E01012716","Total",1427,227,119,108,1200,77,216,278,160,53,145,271
"2011","Blackpool 001E","E01012719","Total",1396,184,115,69,1212,81,266,285,190,81,106,203
"2011","Blackpool 002A","E01012662","Total",1459,416,252,164,1043,54,308,178,224,21,64,194
"2011","Blackpool 002B","E01012703","Total",1494,235,142,93,1259,91,290,221,234,93,84,246
"2011","Blackpool 002C","E01012704","Total",1993,535,202,333,1458,187,178,370,358,79,104,182
"2011","Blackpool 002D","E01012706","Total",1645,199,91,108,1446,112,172,397,290,59,163,253
"2011","Blackpool 002E","E01012717","Total",1660,201,122,79,1459,32,318,288,220,62,223,316
"2011","Blackpool 003A","E01012666","Total",1341,280,95,185,1061,63,208,219,198,51,102,220
"2011","Blackpool 003B","E01012667","Total",1536,161,107,54,1375,78,234,311,216,57,151,328
"2011","Blackpool 003C","E01012668","Total",1535,269,143,126,1266,50,256,258,226,82,132,262
"2011","Blackpool 003D","E01012669","Total",1751,388,168,220,1363,50,256,244,264,81,185,283
"2011","Blackpool 003E","E01012718","Total",1621,246,175,71,1375,58,414,257,230,15,133,268
"2011","Blackpool 004A","E01012690","Total",1727,201,73,128,1526,134,202,372,266,79,143,330
"2011","Blackpool 004B","E01012691","Total",1863,215,107,108,1648,144,242,426,280,102,156,298
"2011","Blackpool 004C","E01012692","Total",1720,324,151,173,1396,149,210,302,268,68,169,230
"2011","Blackpool 004D","E01012705","Total",1618,248,104,144,1370,194,188,316,226,88,106,252
"2011","Blackpool 004E","E01012723","Total",1435,212,85,127,1223,107,198,259,222,36,128,273
"2011","Blackpool 005A","E01012693","Total",1550,231,117,114,1319,81,276,330,264,42,115,211
"2011","Blackpool 005B","E01012711","Total",1367,181,74,107,1186,114,148,254,228,48,149,245
"2011","Blackpool 005C","E01012747","Total",1494,130,77,53,1364,83,270,285,214,46,158,308
"2011","Blackpool 005D","E01012750","Total",1732,224,98,126,1508,129,222,265,220,106,200,366
"2011","Blackpool 006A","E01012681","Total",1203,493,78,415,710,97,62,77,224,20,88,142
"2011","Blackpool 006B","E01012683","Total",1418,392,78,314,1026,95,78,127,184,105,228,209
"2011","Blackpool 006C","E01012748","Total",1471,340,100,240,1131,105,122,158,192,96,186,272
"2011","Blackpool 006D","E01012749","Total",1578,305,83,222,1273,68,164,234,186,92,243,286
"2011","Blackpool 007A","E01012707","Total",1228,306,118,188,922,104,100,233,196,30,91,168
"2011","Blackpool 007B","E01012720","Total",1588,198,72,126,1390,243,140,295,176,183,151,202
"2011","Blackpool 007C","E01012721","Total",1679,397,111,286,1282,271,116,261,224,83,162,165
"2011","Blackpool 007D","E01012724","Total",1251,301,92,209,950,114,108,205,160,86,136,141
"2011","Blackpool 008A","E01012678","Total",1386,409,73,336,977,143,58,164,232,89,128,163
"2011","Blackpool 008B","E01012679","Total",1438,248,78,170,1190,215,80,252,176,81,218,168
"2011","Blackpool 008C","E01012680","Total",1593,235,67,168,1358,183,102,274,224,148,198,229
"2011","Blackpool 008D","E01012682","Total",1421,379,118,261,1042,138,106,200,214,98,133,153
"2011","Blackpool 008E","E01012684","Total",1421,270,91,179,1151,186,114,297,260,99,77,118
"2011","Blackpool 009A","E01012676","Total",1364,205,87,118,1159,78,148,258,218,66,161,230
"2011","Blackpool 009B","E01012677","Total",1381,215,91,124,1166,73,154,238,216,59,175,251
"2011","Blackpool 009C","E01012708","Total",1359,182,73,109,1177,119,154,317,230,51,98,208
"2011","Blackpool 009D","E01012709","Total",1612,248,84,164,1364,279,114,361,234,108,47,221
"2011","Blackpool 009E","E01012710","Total",1177,127,72,55,1050,66,152,238,162,56,141,235
"2011","Blackpool 009F","E01012722","Total",1213,155,34,121,1058,44,112,303,176,26,166,231
"2011","Blackpool 010A","E01012673","Total",1339,399,102,297,940,127,52,164,200,92,127,178
"2011","Blackpool 010B","E01012675","Total",1550,278,75,203,1272,229,78,251,210,127,160,217
"2011","Blackpool 010C","E01012735","Total",1214,404,109,295,810,59,140,99,192,33,112,175
"2011","Blackpool 010D","E01012736","Total",734,306,44,262,428,22,70,50,142,5,55,84
"2011","Blackpool 010E","E01012737","Total",1387,510,100,410,877,70,68,114,222,82,130,191
"2011","Blackpool 011A","E01012670","Total",1199,221,63,158,978,202,74,211,206,81,105,99
"2011","Blackpool 011B","E01012733","Total",1012,194,53,141,818,96,76,164,158,69,101,154
"2011","Blackpool 011C","E01012734","Total",1418,210,75,135,1208,136,130,282,210,62,148,240
"2011","Blackpool 011D","E01012738","Total",1272,216,51,165,1056,136,104,164,160,113,165,214
"2011","Blackpool 011E","E01012739","Total",1383,177,65,112,1206,153,126,229,176,98,184,240
"2011","Blackpool 011F","E01012742","Total",1138,202,77,125,936,89,126,155,204,42,99,221
"2011","Blackpool 012A","E01012712","Total",1698,163,72,91,1535,87,190,431,284,56,191,296
"2011","Blackpool 012B","E01012713","Total",1918,233,82,151,1685,166,202,444,290,102,145,336
"2011","Blackpool 012C","E01012715","Total",1555,231,96,135,1324,144,156,300,242,53,155,274
"2011","Blackpool 012D","E01012740","Total",1429,288,142,146,1141,54,156,255,200,41,131,304
"2011","Blackpool 012E","E01012741","Total",1362,202,106,96,1160,90,170,258,188,74,96,284
"2011","Blackpool 013A","E01012671","Total",1058,318,68,250,740,127,64,77,210,30,111,121
"2011","Blackpool 013B","E01012672","Total",983,319,52,267,664,54,56,69,156,43,135,151
"2011","Blackpool 013C","E01012674","Total",1592,326,64,262,1266,144,72,188,196,121,242,303
"2011","Blackpool 013D","E01012751","Total",1178,471,73,398,707,58,90,108,228,33,82,108
"2011","Blackpool 014A","E01012686","Total",1472,230,70,160,1242,204,106,238,184,118,192,200
"2011","Blackpool 014B","E01012687","Total",1425,252,74,178,1173,164,92,211,190,118,175,223
"2011","Blackpool 014C","E01012688","Total",1230,284,160,124,946,92,234,141,214,31,83,151
"2011","Blackpool 014D","E01012689","Total",1292,235,97,138,1057,105,200,194,228,65,69,196
"2011","Blackpool 014E","E01012714","Total",1650,287,137,150,1363,109,236,290,290,33,141,264
"2011","Blackpool 015A","E01012695","Total",1395,191,75,116,1204,188,126,258,216,74,157,185
"2011","Blackpool 015B","E01012743","Total",1699,279,105,174,1420,165,130,260,228,143,201,293
"2011","Blackpool 015C","E01012744","Total",1609,284,131,153,1325,184,122,246,254,114,173,232
"2011","Blackpool 015D","E01012745","Total",1674,249,100,149,1425,149,234,290,216,76,176,284
"2011","Blackpool 015E","E01012746","Total",1780,270,121,149,1510,181,190,385,244,99,188,223
"2011","Blackpool 016A","E01012685","Total",1484,174,63,111,1310,175,120,378,256,68,126,187
"2011","Blackpool 016B","E01012694","Total",1380,230,119,111,1150,184,170,252,208,56,113,167
"2011","Blackpool 016C","E01012696","Total",1563,176,70,106,1387,238,138,349,238,53,129,242
"2011","Blackpool 016D","E01012697","Total",1375,274,153,121,1101,72,232,254,194,30,131,188
"2011","Blackpool 016E","E01012698","Total",1520,172,61,111,1348,233,126,269,210,95,140,275
"2011","Blackpool 017A","E01012726","Total",1690,252,138,114,1438,110,270,286,220,87,206,259
"2011","Blackpool 017B","E01012728","Total",1509,319,121,198,1190,113,180,302,174,77,124,220
"2011","Blackpool 017C","E01012752","Total",1189,275,90,185,914,88,128,114,158,52,151,223
"2011","Blackpool 017D","E01012753","Total",1154,134,61,73,1020,61,126,194,136,64,178,261
"2011","Blackpool 017E","E01012754","Total",1151,204,66,138,947,122,76,141,172,78,132,226
"2011","Blackpool 017F","E01012755","Total",1430,173,81,92,1257,46,164,272,236,84,142,313
"2011","Blackpool 018A","E01012701","Total",1453,164,86,78,1289,109,200,301,192,72,132,283
"2011","Blackpool 018B","E01012729","Total",1600,218,135,83,1382,100,356,241,264,58,121,242
"2011","Blackpool 018C","E01012730","Total",1628,178,85,93,1450,71,194,273,288,61,196,367
"2011","Blackpool 018D","E01012731","Total",1591,233,113,120,1358,147,214,304,244,55,123,271
"2011","Blackpool 018E","E01012732","Total",1688,317,199,118,1371,139,270,236,276,67,135,248
"2011","Blackpool 019A","E01012699","Total",1722,209,117,92,1513,117,240,378,296,71,122,289
"2011","Blackpool 019B","E01012700","Total",1825,206,121,85,1619,117,238,352,248,90,228,346
"2011","Blackpool 019C","E01012702","Total",1424,386,216,170,1038,76,248,193,164,60,98,199
"2011","Blackpool 019D","E01012725","Total",1359,195,108,87,1164,62,176,218,208,49,217,234
"2011","Blackpool 019E","E01012727","Total",1575,160,95,65,1415,32,236,289,252,74,233,299
"2011","Cheshire East 022A","E01018393","Total",2045,178,78,100,1867,41,316,401,396,139,174,400
"2011","Cheshire East 022B","E01018411","Total",2319,189,118,71,2130,41,410,562,332,121,242,422
"2011","Cheshire East 022C","E01018412","Total",1516,169,104,65,1347,46,326,274,214,84,112,291
"2011","Cheshire East 023A","E01018413","Total",1277,94,56,38,1183,48,164,414,194,58,115,190
"2011","Cheshire East 023B","E01018414","Total",1372,167,86,81,1205,12,324,235,232,43,117,242
"2011","Cheshire East 023C","E01018415","Total",1613,292,203,89,1321,100,254,336,224,50,127,230
"2011","Cheshire East 023D","E01018416","Total",1314,92,39,53,1222,34,194,341,212,55,118,268
"2011","Cheshire East 024A","E01018424","Total",1695,203,69,134,1492,93,172,377,328,95,140,287
"2011","Cheshire East 024B","E01018425","Total",1564,291,116,175,1273,43,212,291,276,52,148,251
"2011","Cheshire East 024C","E01018426","Total",1602,223,123,100,1379,62,266,282,240,73,108,348
"2011","Cheshire East 024D","E01018427","Total",1283,88,42,46,1195,58,122,275,232,49,107,352
"2011","Cheshire East 025A","E01018419","Total",1361,109,31,78,1252,70,72,407,262,31,142,268
"2011","Cheshire East 025B","E01018420","Total",1902,149,40,109,1753,113,104,609,312,162,218,235
"2011","Cheshire East 025C","E01018421","Total",1342,123,38,85,1219,63,80,389,262,72,141,212
"2011","Cheshire East 025D","E01018422","Total",1285,142,69,73,1143,102,148,315,210,61,115,192
"2011","Cheshire East 025E","E01018423","Total",1456,200,86,114,1256,96,144,301,248,86,166,215
"2011","Cheshire East 026A","E01018395","Total",1603,171,74,97,1432,79,290,337,268,37,104,317
"2011","Cheshire East 026B","E01018396","Total",1479,150,91,59,1329,102,230,295,200,99,145,258
"2011","Cheshire East 026C","E01018400","Total",2090,401,103,298,1689,214,158,431,308,110,205,263
"2011","Cheshire East 026D","E01018401","Total",1575,136,47,89,1439,106,166,324,232,139,210,262
"2011","Cheshire East 027A","E01018398","Total",1451,298,144,154,1153,131,198,242,256,35,113,178
"2011","Cheshire East 027B","E01018399","Total",1471,260,107,153,1211,58,146,343,262,71,85,246
"2011","Cheshire East 027C","E01018402","Total",1828,408,97,311,1420,134,180,306,388,38,98,276
"2011","Cheshire East 027D","E01018403","Total",1953,192,96,96,1761,86,304,405,340,94,123,409
"2011","Cheshire East 028A","E01018397","Total",1788,187,72,115,1601,59,158,566,276,96,176,270
"2011","Cheshire East 028B","E01018408","Total",1782,175,96,79,1607,63,264,375,350,41,142,372
"2011","Cheshire East 028C","E01018409","Total",1838,318,201,117,1520,101,314,334,276,69,140,286
"2011","Cheshire East 028D","E01018410","Total",1543,147,89,58,1396,25,308,319,220,67,128,329
"2011","Cheshire East 029A","E01018404","Total",1458,148,92,56,1310,16,240,359,224,36,112,323
"2011","Cheshire East 029B","E01018405","Total",1362,156,46,110,1206,58,142,309,296,72,58,271
"2011","Cheshire East 029C","E01018406","Total",1444,153,77,76,1291,31,262,337,216,123,72,250
"2011","Cheshire East 029D","E01018407","Total",1481,156,89,67,1325,37,254,344,288,80,93,229
"2011","Cheshire East 030A","E01018436","Total",1392,166,93,73,1226,29,256,256,204,30,111,340
"2011","Cheshire East 030B","E01018437","Total",1567,280,113,167,1287,86,186,344,316,46,120,189
"2011","Cheshire East 030C","E01018438","Total",1414,150,104,46,1264,49,288,250,226,42,105,304
"2011","Cheshire East 030D","E01018439","Total",1308,118,88,30,1190,25,294,239,218,67,126,221
"2011","Cheshire East 031A","E01018440","Total",1733,210,58,152,1523,75,112,546,302,50,178,260
"2011","Cheshire East 031B","E01018441","Total",1690,139,33,106,1551,103,80,598,278,95,168,229
"2011","Cheshire East 031C","E01018442","Total",1829,208,89,119,1621,67,206,488,264,113,198,285
"2011","Cheshire East 031D","E01018443","Total",1493,162,71,91,1331,38,196,351,264,42,136,304
"2011","Cheshire East 032A","E01018432","Total",1492,184,103,81,1308,44,224,301,226,72,124,317
"2011","Cheshire East 032B","E01018433","Total",1228,176,107,69,1052,38,278,209,220,23,73,211
"2011","Cheshire East 032C","E01018434","Total",1335,205,92,113,1130,56,208,245,260,66,75,220
"2011","Cheshire East 032D","E01018435","Total",1353,304,160,144,1049,83,130,274,210,46,106,200
"2011","Cheshire East 033A","E01018394","Total",2047,169,72,97,1878,48,292,464,330,99,223,422
"2011","Cheshire East 033B","E01018417","Total",1577,200,116,84,1377,39,408,243,254,50,105,278
"2011","Cheshire East 033C","E01018418","Total",1485,173,83,90,1312,53,262,240,292,41,134,290
"2011","Cheshire East 033D","E01018428","Total",1399,191,102,89,1208,52,172,278,272,40,164,230
"2011","Cheshire East 033E","E01018429","Total",1492,171,95,76,1321,76,286,262,252,43,146,256
"2011","Cheshire East 033F","E01018430","Total",1388,130,48,82,1258,51,172,278,246,49,145,317
"2011","Cheshire East 033G","E01018431","Total",1163,125,51,74,1038,30,144,274,258,21,69,242
"2011","Cheshire East 040A","E01018387","Total",1684,164,113,51,1520,30,458,252,236,51,189,304
"2011","Cheshire East 040B","E01018388","Total",1568,316,107,209,1252,142,152,244,238,81,188,207
"2011","Cheshire East 040C","E01018389","Total",1586,250,155,95,1336,70,234,316,244,56,192,224
"2011","Cheshire East 040D","E01018390","Total",1666,228,153,75,1438,76,308,256,270,83,165,280
"2011","Cheshire East 042A","E01018386","Total",1333,223,135,88,1110,60,266,243,194,45,75,227
"2011","Cheshire East 042B","E01018391","Total",1931,235,128,107,1696,136,176,520,300,112,169,283
"2011","Cheshire East 042C","E01018392","Total",1899,174,77,97,1725,47,264,417,296,93,180,428
"2011","Cheshire East 034A","E01018472","Total",1386,236,65,171,1150,70,112,267,316,52,97,236
"2011","Cheshire East 034B","E01018473","Total",1671,135,18,117,1536,99,86,504,322,88,184,253
"2011","Cheshire East 034C","E01018474","Total",1838,113,21,92,1725,60,82,492,326,121,281,363
"2011","Cheshire East 034D","E01018475","Total",1873,87,13,74,1786,54,64,650,258,147,265,348
"2011","Cheshire East 035A","E01018463","Total",1482,196,65,131,1286,115,98,323,264,98,169,219
"2011","Cheshire East 035B","E01018476","Total",1358,136,56,80,1222,229,104,221,120,153,187,208
"2011","Cheshire East 035C","E01018477","Total",1492,194,113,81,1298,105,176,292,212,141,185,187
"2011","Cheshire East 035D","E01018478","Total",1467,119,59,60,1348,112,104,282,166,123,288,273
"2011","Cheshire East 035E","E01018479","Total",1603,207,105,102,1396,84,164,336,330,86,156,240
"2011","Cheshire East 036A","E01018459","Total",1410,107,46,61,1303,213,104,267,162,124,219,214
"2011","Cheshire East 036B","E01018460","Total",1400,177,107,70,1223,97,256,259,204,63,85,259
"2011","Cheshire East 036C","E01018461","Total",1401,197,100,97,1204,126,196,233,230,92,119,208
"2011","Cheshire East 036D","E01018466","Total",2304,493,152,341,1811,277,156,486,354,106,144,288
"2011","Cheshire East 036E","E01018467","Total",2192,376,84,292,1816,215,70,470,368,94,209,390
"2011","Cheshire East 037A","E01018482","Total",1401,214,93,121,1187,105,174,206,230,93,103,276
"2011","Cheshire East 037B","E01018483","Total",1370,189,78,111,1181,76,242,197,244,42,92,288
"2011","Cheshire East 037C","E01018484","Total",2353,241,107,134,2112,345,84,623,300,238,244,278
"2011","Cheshire East 037D","E01018485","Total",1540,193,49,144,1347,177,100,277,228,167,171,227
"2011","Cheshire East 038A","E01018499","Total",1544,242,96,146,1302,87,170,367,280,45,124,229
"2011","Cheshire East 038B","E01018500","Total",1254,114,60,54,1140,23,212,241,238,41,105,280
"2011","Cheshire East 038C","E01018501","Total",1572,311,180,131,1261,59,256,219,234,41,107,345
"2011","Cheshire East 038D","E01018502","Total",1176,133,79,54,1043,39,306,163,230,38,58,209
"2011","Cheshire East 039A","E01018462","Total",1417,304,78,226,1113,163,74,312,274,49,53,188
"2011","Cheshire East 039B","E01018464","Total",1375,243,81,162,1132,89,126,239,256,64,89,269
"2011","Cheshire East 039C","E01018496","Total",1680,190,82,108,1490,80,124,396,268,106,213,303
"2011","Cheshire East 039D","E01018497","Total",1174,198,53,145,976,90,60,226,182,48,130,240
"2011","Cheshire East 039E","E01018498","Total",1517,195,32,163,1322,200,64,329,254,116,122,237
"2011","Cheshire East 041A","E01018465","Total",2842,262,120,142,2580,102,386,606,542,138,330,476
"2011","Cheshire East 041B","E01018468","Total",1623,132,67,65,1491,74,182,330,252,108,191,354
"2011","Cheshire East 041C","E01018469","Total",1529,180,113,67,1349,60,196,319,236,79,147,312
"2011","Cheshire East 041D","E01018470","Total",1481,102,50,52,1379,41,172,347,248,57,189,325
"2011","Cheshire East 041E","E01018471","Total",1493,138,55,83,1355,57,206,333,284,88,89,298
"2011","Cheshire East 043A","E01018486","Total",1474,317,97,220,1157,89,92,167,230,51,157,371
"2011","Cheshire East 043B","E01018487","Total",1650,197,55,142,1453,183,72,310,198,104,176,410
"2011","Cheshire East 043C","E01018488","Total",1518,138,63,75,1380,62,164,306,222,83,222,321
"2011","Cheshire East 043D","E01018489","Total",1366,152,36,116,1214,72,76,258,194,84,204,326
"2011","Cheshire East 044A","E01018510","Total",1603,133,57,76,1470,64,118,435,262,98,147,346
"2011","Cheshire East 044B","E01018511","Total",1445,225,119,106,1220,83,170,302,202,56,139,268
"2011","Cheshire East 044C","E01018512","Total",1690,211,123,88,1479,119,230,330,212,99,201,288
"2011","Cheshire East 044D","E01018513","Total",1623,154,87,67,1469,65,216,383,236,91,180,298
"2011","Cheshire East 045A","E01018445","Total",1910,261,72,189,1649,239,114,419,312,107,189,269
"2011","Cheshire East 045B","E01018446","Total",1289,126,34,92,1163,129,66,246,164,75,148,335
"2011","Cheshire East 045C","E01018447","Total",1737,220,55,165,1517,189,90,298,262,110,217,351
"2011","Cheshire East 045D","E01018448","Total",1735,210,88,122,1525,103,176,373,274,102,153,344
"2011","Cheshire East 046A","E01018490","Total",1448,158,108,50,1290,32,348,263,216,61,95,275
"2011","Cheshire East 046B","E01018491","Total",1428,175,80,95,1253,34,218,319,248,60,119,255
"2011","Cheshire East 046C","E01018492","Total",1066,182,116,66,884,32,234,157,138,48,72,203
"2011","Cheshire East 046D","E01018505","Total",1083,81,45,36,1002,14,192,229,178,64,98,227
"2011","Cheshire East 046E","E01018506","Total",1421,69,34,35,1352,9,198,335,248,60,168,334
"2011","Cheshire East 046F","E01018507","Total",1400,81,53,28,1319,22,286,246,248,51,172,294
"2011","Cheshire East 047A","E01018451","Total",1324,420,224,196,904,67,176,143,200,47,91,180
"2011","Cheshire East 047B","E01018454","Total",1517,266,86,180,1251,97,116,213,326,101,176,222
"2011","Cheshire East 047C","E01018455","Total",1292,197,116,81,1095,50,224,264,240,26,99,192
"2011","Cheshire East 047D","E01018456","Total",1235,187,142,45,1048,23,324,167,166,25,77,266
"2011","Cheshire East 047E","E01018457","Total",1419,342,141,201,1077,76,132,247,342,36,72,172
"2011","Cheshire East 049A","E01018444","Total",2122,219,97,122,1903,71,274,406,354,110,272,416
"2011","Cheshire East 049B","E01018480","Total",1939,225,95,130,1714,61,234,345,362,133,200,379
"2011","Cheshire East 049C","E01018515","Total",2322,169,78,91,2153,59,236,590,446,169,268,385
"2011","Cheshire East 049D","E01018516","Total",1460,139,76,63,1321,55,236,346,220,60,122,282
"2011","Cheshire East 049F","E01033375","Total",1317,57,8,49,1260,75,50,571,184,83,174,123
"2011","Cheshire East 049G","E01033376","Total",1178,101,7,94,1077,78,28,461,206,108,93,103
"2011","Cheshire East 049H","E01033378","Total",1401,108,55,53,1293,35,158,375,190,76,197,262
"2011","Cheshire East 048A","E01018493","Total",1236,218,139,79,1018,60,268,194,218,10,67,201
"2011","Cheshire East 048B","E01018494","Total",1345,174,94,80,1171,31,206,253,258,67,100,256
"2011","Cheshire East 048C","E01018495","Total",1241,121,65,56,1120,61,178,220,280,27,122,232
"2011","Cheshire East 048D","E01018508","Total",1180,119,65,54,1061,32,200,244,184,59,135,207
"2011","Cheshire East 048E","E01018509","Total",1102,166,82,84,936,89,142,217,214,57,47,170
"2011","Cheshire East 050A","E01018452","Total",1139,163,87,76,976,76,190,202,148,78,108,174
"2011","Cheshire East 050C","E01018503","Total",1566,177,123,54,1389,30,352,332,238,73,125,239
"2011","Cheshire East 050D","E01018504","Total",1727,348,139,209,1379,83,266,286,290,74,156,224
"2011","Cheshire East 050E","E01033372","Total",1259,205,63,142,1054,72,96,288,338,65,67,128
"2011","Cheshire East 050F","E01033373","Total",1273,267,116,151,1006,109,122,228,224,82,84,157
"2011","Cheshire East 051A","E01018449","Total",1725,180,114,66,1545,45,370,311,268,76,133,342
"2011","Cheshire East 051B","E01018450","Total",2136,235,125,110,1901,82,344,398,370,144,181,382
"2011","Cheshire East 051C","E01018458","Total",2136,195,113,82,1941,52,304,453,384,123,248,377
"2011","Cheshire East 051D","E01018481","Total",1985,170,91,79,1815,39,352,338,306,168,222,390
"2011","Cheshire East 051E","E01018514","Total",1959,182,97,85,1777,48,292,363,374,106,213,381
"2011","Cheshire East 001A","E01018585","Total",1382,180,97,83,1202,49,224,241,236,57,124,271
"2011","Cheshire East 001B","E01018586","Total",1521,226,100,126,1295,42,168,296,284,64,128,313
"2011","Cheshire East 001C","E01018587","Total",1491,159,71,88,1332,23,284,296,296,72,104,257
"2011","Cheshire East 001D","E01018661","Total",1244,126,63,63,1118,19,216,198,186,65,156,278
"2011","Cheshire East 002A","E01018657","Total",1104,171,99,72,933,58,146,251,142,78,107,151
"2011","Cheshire East 002B","E01018662","Total",1190,95,44,51,1095,45,144,354,208,52,78,214
"2011","Cheshire East 002C","E01018663","Total",1529,182,127,55,1347,45,318,324,164,94,102,300
"2011","Cheshire East 002D","E01018664","Total",1462,110,68,42,1352,28,260,282,232,72,147,331
"2011","Cheshire East 002E","E01018665","Total",1117,126,71,55,991,40,162,266,190,55,68,210
"2011","Cheshire East 003A","E01018655","Total",1478,289,169,120,1189,53,308,265,238,35,76,214
"2011","Cheshire East 003B","E01018656","Total",1452,183,118,65,1269,44,292,306,206,41,131,249
"2011","Cheshire East 003C","E01018658","Total",1296,85,44,41,1211,33,150,342,172,88,139,287
"2011","Cheshire East 003D","E01018659","Total",1248,94,63,31,1154,12,286,182,210,82,98,284
"2011","Cheshire East 003E","E01018660","Total",1005,87,50,37,918,11,170,251,138,46,99,203
"2011","Cheshire East 004A","E01018582","Total",1694,354,61,293,1340,41,154,360,234,65,193,293
"2011","Cheshire East 004B","E01018592","Total",1710,209,108,101,1501,85,244,445,258,95,161,213
"2011","Cheshire East 004C","E01018593","Total",1674,259,130,129,1415,57,260,337,268,95,101,297
"2011","Cheshire East 004D","E01018594","Total",1649,366,156,210,1283,103,170,305,274,51,106,274
"2011","Cheshire East 004E","E01018595","Total",1520,298,154,144,1222,58,166,290,248,67,177,216
"2011","Cheshire East 004F","E01018596","Total",1918,392,90,302,1526,268,112,303,292,105,216,230
"2011","Cheshire East 005A","E01018583","Total",1822,211,66,145,1611,98,168,454,412,61,174,244
"2011","Cheshire East 005B","E01018584","Total",1885,130,41,89,1755,53,188,457,340,145,224,348
"2011","Cheshire East 005C","E01018612","Total",1206,136,52,84,1070,83,166,284,194,43,113,187
"2011","Cheshire East 005D","E01018613","Total",1483,286,124,162,1197,96,140,303,210,72,104,272
"2011","Cheshire East 006A","E01018600","Total",1609,142,82,60,1467,30,294,330,208,95,242,268
"2011","Cheshire East 006B","E01018601","Total",1686,339,166,173,1347,101,198,319,342,61,113,213
"2011","Cheshire East 006C","E01018602","Total",1710,343,171,172,1367,43,208,363,314,72,148,219
"2011","Cheshire East 006D","E01018652","Total",1563,112,48,64,1451,44,194,417,250,101,169,276
"2011","Cheshire East 007A","E01018598","Total",1578,152,70,82,1426,12,204,430,292,88,117,283
"2011","Cheshire East 007B","E01018599","Total",1145,94,43,51,1051,18,276,299,188,30,73,167
"2011","Cheshire East 007C","E01018648","Total",2072,281,128,153,1791,93,322,330,372,141,192,341
"2011","Cheshire East 007D","E01018649","Total",1283,164,99,65,1119,3,332,203,192,82,113,194
"2011","Cheshire East 007E","E01018650","Total",1642,230,88,142,1412,68,196,370,324,84,105,265
"2011","Cheshire East 007F","E01018651","Total",1170,149,74,75,1021,43,172,208,190,84,138,186
"2011","Cheshire East 007G","E01018654","Total",2088,242,139,103,1846,42,388,450,340,111,136,379
"2011","Cheshire East 008A","E01018588","Total",1543,157,67,90,1386,60,200,421,212,91,135,267
"2011","Cheshire East 008B","E01018589","Total",1608,114,73,41,1494,39,260,509,212,96,140,238
"2011","Cheshire East 008C","E01018590","Total",1840,178,97,81,1662,79,244,549,244,128,132,286
"2011","Cheshire East 008D","E01018653","Total",1997,284,165,119,1713,54,332,510,288,101,181,247
"2011","Cheshire East 009A","E01018605","Total",1136,138,91,47,998,30,234,291,150,95,71,127
"2011","Cheshire East 009B","E01018609","Total",1645,239,156,83,1406,54,342,276,206,95,114,319
"2011","Cheshire East 009C","E01018610","Total",1910,329,121,208,1581,143,190,369,370,118,150,241
"2011","Cheshire East 009D","E01018611","Total",1683,248,69,179,1435,206,136,345,284,67,151,246
"2011","Cheshire East 011A","E01018666","Total",1783,129,83,46,1654,53,372,383,272,111,182,281
"2011","Cheshire East 011B","E01018667","Total",1590,245,150,95,1345,43,322,326,206,50,173,225
"2011","Cheshire East 011C","E01018668","Total",1597,129,85,44,1468,19,316,293,272,94,171,303
"2011","Cheshire East 010A","E01018603","Total",1280,111,71,40,1169,11,208,315,192,90,124,229
"2011","Cheshire East 010B","E01018604","Total",1340,202,103,99,1138,60,178,351,242,61,75,171
"2011","Cheshire East 010C","E01018606","Total",1461,425,242,183,1036,79,156,239,270,66,56,170
"2011","Cheshire East 010D","E01018607","Total",1299,97,59,38,1202,19,260,298,182,116,95,232
"2011","Cheshire East 010E","E01018608","Total",1382,105,54,51,1277,44,250,360,190,76,142,215
"2011","Cheshire East 012A","E01018572","Total",1661,253,135,118,1408,44,258,383,248,105,146,224
"2011","Cheshire East 012B","E01018573","Total",1544,198,91,107,1346,55,268,275,234,125,147,242
"2011","Cheshire East 012C","E01018574","Total",1929,454,196,258,1475,115,194,370,318,56,135,287
"2011","Cheshire East 012D","E01018580","Total",1459,205,97,108,1254,31,264,261,238,100,104,256
"2011","Cheshire East 012E","E01018581","Total",1219,192,103,89,1027,32,230,262,160,64,104,175
"2011","Cheshire East 013A","E01018575","Total",1101,140,62,78,961,63,116,292,182,56,84,168
"2011","Cheshire East 013B","E01018576","Total",1748,347,103,244,1401,80,180,420,390,40,93,198
"2011","Cheshire East 013C","E01018577","Total",2399,366,161,205,2033,94,340,602,448,76,97,376
"2011","Cheshire East 013D","E01018578","Total",1191,110,46,64,1081,32,148,283,226,45,147,200
"2011","Cheshire East 013E","E01018579","Total",1083,161,93,68,922,63,148,209,182,62,76,182
"2011","Cheshire East 014A","E01018641","Total",1280,93,55,38,1187,26,190,299,188,33,146,305
"2011","Cheshire East 014B","E01018642","Total",1382,106,57,49,1276,36,156,422,192,70,185,215
"2011","Cheshire East 014C","E01018643","Total",1925,126,59,67,1799,61,220,557,280,134,207,340
"2011","Cheshire East 014D","E01018644","Total",1372,242,124,118,1130,24,200,315,222,54,110,205
"2011","Cheshire East 015A","E01018614","Total",1882,263,76,187,1619,91,184,531,322,111,143,237
"2011","Cheshire East 015B","E01018618","Total",1467,177,62,115,1290,147,126,299,188,125,201,204
"2011","Cheshire East 015C","E01018619","Total",1426,122,48,74,1304,54,138,429,250,98,111,224
"2011","Cheshire East 015D","E01018620","Total",1355,166,59,107,1189,107,142,252,206,85,125,272
"2011","Cheshire East 015E","E01018621","Total",1320,157,81,76,1163,37,142,281,230,75,127,271
"2011","Cheshire East 016A","E01018626","Total",2136,436,144,292,1700,102,202,407,450,109,136,294
"2011","Cheshire East 016B","E01018628","Total",1590,154,82,72,1436,33,222,352,284,68,161,316
"2011","Cheshire East 016C","E01018629","Total",1858,306,141,165,1552,197,134,415,304,95,146,261
"2011","Cheshire East 016D","E01018630","Total",1280,230,100,130,1050,74,192,273,242,26,84,159
"2011","Cheshire East 016E","E01018631","Total",1380,344,118,226,1036,93,124,225,222,64,116,192
"2011","Cheshire East 017A","E01018615","Total",1161,159,41,118,1002,45,92,267,260,47,86,205
"2011","Cheshire East 017B","E01018616","Total",1207,132,75,57,1075,25,152,298,222,57,96,225
"2011","Cheshire East 017C","E01018617","Total",1413,274,116,158,1139,41,220,233,244,56,105,240
"2011","Cheshire East 017D","E01018632","Total",1573,168,70,98,1405,45,206,432,256,68,108,290
"2011","Cheshire East 017E","E01018633","Total",1465,133,78,55,1332,13,298,272,224,46,166,313
"2011","Cheshire East 018A","E01018622","Total",1325,351,139,212,974,86,104,271,324,5,83,101
"2011","Cheshire East 018B","E01018623","Total",1489,240,83,157,1249,85,130,379,308,51,65,231
"2011","Cheshire East 018C","E01018624","Total",1824,474,73,401,1350,106,78,349,500,55,74,188
"2011","Cheshire East 018D","E01018625","Total",1384,236,56,180,1148,112,84,340,310,31,71,200
"2011","Cheshire East 018E","E01018627","Total",1571,359,81,278,1212,80,118,304,374,59,52,225
"2011","Cheshire East 018F","E01018635","Total",1187,230,71,159,957,57,114,257,254,26,43,206
"2011","Cheshire East 018G","E01018636","Total",1421,160,82,78,1261,74,126,342,244,93,112,270
"2011","Cheshire East 019A","E01018634","Total",1874,159,82,77,1715,60,284,440,308,83,178,362
"2011","Cheshire East 019B","E01018645","Total",1797,398,234,164,1399,134,200,271,244,94,201,255
"2011","Cheshire East 019C","E01018646","Total",1781,191,94,97,1590,138,182,366,268,120,211,305
"2011","Cheshire East 019D","E01018647","Total",1544,210,102,108,1334,76,182,313,216,59,160,328
"2011","Cheshire East 020A","E01018591","Total",2339,256,145,111,2083,59,506,384,392,98,155,489
"2011","Cheshire East 020B","E01018597","Total",2370,257,131,126,2113,61,488,403,366,113,219,463
"2011","Cheshire East 020C","E01018669","Total",2571,282,150,132,2289,51,396,535,472,147,245,443
"2011","Cheshire East 020D","E01018670","Total",2308,288,160,128,2020,62,436,458,400,125,180,359
"2011","Cheshire East 021A","E01018637","Total",1737,171,53,118,1566,231,126,388,230,103,201,287
"2011","Cheshire East 021B","E01018638","Total",1539,201,98,103,1338,135,192,288,246,87,144,246
"2011","Cheshire East 021C","E01018639","Total",1384,236,42,194,1148,152,80,283,332,16,89,196
"2011","Cheshire East 021D","E01018640","Total",1311,273,98,175,1038,117,110,270,174,50,156,161
"2011","Cheshire West and Chester 022A","E01018308","Total",1867,216,107,109,1651,85,286,351,264,175,183,307
"2011","Cheshire West and Chester 022B","E01018336","Total",1233,124,46,78,1109,47,160,246,240,66,98,252
"2011","Cheshire West and Chester 022C","E01018337","Total",1284,144,64,80,1140,47,154,219,292,49,128,251
"2011","Cheshire West and Chester 022D","E01018338","Total",1790,248,85,163,1542,95,170,455,288,94,161,279
"2011","Cheshire West and Chester 022E","E01018358","Total",1176,109,42,67,1067,35,154,283,190,51,121,233
"2011","Cheshire West and Chester 022F","E01018359","Total",1076,77,39,38,999,16,158,219,162,78,131,235
"2011","Cheshire West and Chester 025A","E01018360","Total",2006,137,80,57,1869,53,262,574,320,172,200,288
"2011","Cheshire West and Chester 025B","E01018366","Total",1515,154,97,57,1361,40,242,297,274,72,81,355
"2011","Cheshire West and Chester 025C","E01018367","Total",1933,213,126,87,1720,93,236,296,296,140,255,404
"2011","Cheshire West and Chester 027A","E01018364","Total",1565,304,130,174,1261,186,140,318,206,81,140,190
"2011","Cheshire West and Chester 027B","E01018365","Total",1860,276,188,88,1584,59,348,347,274,61,113,382
"2011","Cheshire West and Chester 027C","E01018378","Total",1230,151,87,64,1079,94,144,255,170,61,172,183
"2011","Cheshire West and Chester 027D","E01018379","Total",1347,181,113,68,1166,44,270,249,182,82,134,205
"2011","Cheshire West and Chester 027E","E01018380","Total",1167,154,96,58,1013,53,228,237,124,29,122,220
"2011","Cheshire West and Chester 028A","E01018362","Total",1516,170,88,82,1346,52,164,375,256,71,114,314
"2011","Cheshire West and Chester 028B","E01018363","Total",1044,153,88,65,891,28,226,206,128,15,111,177
"2011","Cheshire West and Chester 028C","E01018374","Total",1767,258,67,191,1509,43,194,411,330,120,142,269
"2011","Cheshire West and Chester 028D","E01018375","Total",1734,286,56,230,1448,44,144,309,450,43,82,376
"2011","Cheshire West and Chester 028E","E01018376","Total",1565,166,111,55,1399,58,192,411,200,124,160,254
"2011","Cheshire West and Chester 028F","E01018377","Total",1626,147,85,62,1479,79,192,525,246,77,94,266
"2011","Cheshire West and Chester 029A","E01018309","Total",1648,150,61,89,1498,130,180,331,244,69,188,356
"2011","Cheshire West and Chester 029B","E01018310","Total",1520,159,70,89,1361,172,90,237,206,130,236,290
"2011","Cheshire West and Chester 029C","E01018311","Total",1348,280,91,189,1068,200,62,298,192,53,95,168
"2011","Cheshire West and Chester 029D","E01018312","Total",1493,150,55,95,1343,153,110,268,178,108,212,314
"2011","Cheshire West and Chester 031A","E01018313","Total",1357,141,91,50,1216,63,236,238,194,58,96,331
"2011","Cheshire West and Chester 031B","E01018314","Total",1644,240,104,136,1404,153,146,272,212,145,190,286
"2011","Cheshire West and Chester 031C","E01018315","Total",1125,150,77,73,975,43,144,192,172,42,125,257
"2011","Cheshire West and Chester 031D","E01018316","Total",1430,167,71,96,1263,190,124,319,162,82,143,243
"2011","Cheshire West and Chester 031E","E01018317","Total",1438,366,70,296,1072,226,94,226,198,61,93,174
"2011","Cheshire West and Chester 030A","E01018349","Total",1618,164,93,71,1454,48,302,283,236,104,177,304
"2011","Cheshire West and Chester 030B","E01018350","Total",1897,171,106,65,1726,30,364,460,306,86,159,321
"2011","Cheshire West and Chester 030C","E01018368","Total",1377,184,102,82,1193,65,180,320,220,46,138,224
"2011","Cheshire West and Chester 030D","E01018370","Total",1351,102,66,36,1249,42,242,326,178,97,140,224
"2011","Cheshire West and Chester 032A","E01018345","Total",1317,113,49,64,1204,77,136,314,172,90,152,263
"2011","Cheshire West and Chester 032B","E01018346","Total",1328,134,63,71,1194,37,182,375,182,61,113,244
"2011","Cheshire West and Chester 032C","E01018347","Total",1355,206,100,106,1149,98,166,228,206,30,123,298
"2011","Cheshire West and Chester 032D","E01018383","Total",1531,145,92,53,1386,38,164,405,192,93,185,309
"2011","Cheshire West and Chester 032E","E01018384","Total",1446,152,101,51,1294,49,250,341,242,36,111,265
"2011","Cheshire West and Chester 033B","E01018327","Total",1989,603,168,435,1386,95,178,232,560,11,50,260
"2011","Cheshire West and Chester 033C","E01018343","Total",1497,347,110,237,1150,82,68,148,418,42,44,348
"2011","Cheshire West and Chester 033D","E01018361","Total",1453,189,59,130,1264,42,94,317,280,66,120,345
"2011","Cheshire West and Chester 033E","E01032930","Total",1809,621,186,435,1188,57,178,122,548,10,55,218
"2011","Cheshire West and Chester 033F","E01032931","Total",1083,256,39,217,827,28,70,114,330,10,16,259
"2011","Cheshire West and Chester 034A","E01018326","Total",1955,657,222,435,1298,57,218,104,488,26,58,347
"2011","Cheshire West and Chester 034B","E01018328","Total",1500,119,16,103,1381,34,72,98,136,27,87,927
"2011","Cheshire West and Chester 034C","E01018329","Total",2065,591,120,471,1474,58,70,96,404,17,26,803
"2011","Cheshire West and Chester 034D","E01018330","Total",1243,109,35,74,1134,33,96,162,192,16,47,588
"2011","Cheshire West and Chester 034E","E01018331","Total",1642,279,38,241,1363,36,72,124,348,26,55,702
"2011","Cheshire West and Chester 036A","E01018319","Total",2105,367,124,243,1738,147,162,448,434,74,143,330
"2011","Cheshire West and Chester 036B","E01018344","Total",1931,305,62,243,1626,123,72,453,556,61,89,272
"2011","Cheshire West and Chester 036C","E01018381","Total",1196,163,77,86,1033,30,128,285,196,56,79,259
"2011","Cheshire West and Chester 036D","E01018382","Total",1532,359,208,151,1173,74,194,231,260,50,122,242
"2011","Cheshire West and Chester 039A","E01018323","Total",1301,175,99,76,1126,58,160,226,222,68,156,236
"2011","Cheshire West and Chester 039B","E01018324","Total",1317,136,82,54,1181,43,184,267,182,93,146,266
"2011","Cheshire West and Chester 039C","E01018325","Total",1467,123,67,56,1344,30,230,298,240,86,211,249
"2011","Cheshire West and Chester 039D","E01018385","Total",2028,222,144,78,1806,38,406,362,280,106,243,371
"2011","Cheshire West and Chester 041A","E01018320","Total",1455,173,124,49,1282,52,238,323,174,66,130,299
"2011","Cheshire West and Chester 041B","E01018321","Total",1200,155,70,85,1045,32,168,254,222,66,132,171
"2011","Cheshire West and Chester 041C","E01018322","Total",1172,156,112,44,1016,9,164,271,172,82,93,225
"2011","Cheshire West and Chester 041D","E01018348","Total",2115,236,93,143,1879,102,214,524,384,120,163,372
"2011","Cheshire West and Chester 043A","E01018332","Total",1062,174,77,97,888,21,110,296,174,75,93,119
"2011","Cheshire West and Chester 043B","E01018333","Total",1455,181,111,70,1274,32,330,275,250,52,100,235
"2011","Cheshire West and Chester 043C","E01018334","Total",1511,164,113,51,1347,28,318,258,224,82,151,286
"2011","Cheshire West and Chester 043D","E01018340","Total",1427,217,113,104,1210,68,236,309,216,43,97,241
"2011","Cheshire West and Chester 043E","E01018341","Total",1108,149,91,58,959,20,238,240,214,35,61,151
"2011","Cheshire West and Chester 043F","E01018342","Total",1566,397,152,245,1169,76,174,252,418,45,61,143
"2011","Cheshire West and Chester 044A","E01018351","Total",1448,252,74,178,1196,144,100,274,218,84,189,187
"2011","Cheshire West and Chester 044B","E01018352","Total",1790,299,61,238,1491,89,106,488,450,77,121,160
"2011","Cheshire West and Chester 044C","E01018353","Total",1575,160,76,84,1415,50,172,333,234,110,217,299
"2011","Cheshire West and Chester 044D","E01018354","Total",1606,150,50,100,1456,204,140,285,270,119,185,253
"2011","Cheshire West and Chester 046A","E01018335","Total",2115,216,112,104,1899,63,326,420,336,156,236,362
"2011","Cheshire West and Chester 046B","E01018369","Total",1590,106,57,49,1484,52,248,307,222,131,206,318
"2011","Cheshire West and Chester 046C","E01018371","Total",1807,203,109,94,1604,97,282,361,250,96,157,361
"2011","Cheshire West and Chester 046D","E01018372","Total",1894,209,105,104,1685,46,306,405,376,88,137,327
"2011","Cheshire West and Chester 047A","E01018339","Total",2018,258,147,111,1760,82,334,423,346,107,169,299
"2011","Cheshire West and Chester 047B","E01018355","Total",1152,235,134,101,917,50,212,158,168,90,54,185
"2011","Cheshire West and Chester 047C","E01018356","Total",1474,145,65,80,1329,45,168,335,250,56,183,292
"2011","Cheshire West and Chester 047D","E01018357","Total",1291,122,67,55,1169,39,224,271,200,20,131,284
"2011","Cheshire West and Chester 047E","E01018373","Total",1980,218,99,119,1762,59,328,366,330,123,187,369
"2011","Cheshire West and Chester 001A","E01018534","Total",2521,496,206,290,2025,176,206,489,368,216,205,365
"2011","Cheshire West and Chester 001B","E01018535","Total",1499,162,97,65,1337,67,242,226,236,96,172,298
"2011","Cheshire West and Chester 001C","E01018536","Total",1647,206,116,90,1441,62,280,346,310,50,101,292
"2011","Cheshire West and Chester 001D","E01018537","Total",1906,272,178,94,1634,32,460,306,304,84,88,360
"2011","Cheshire West and Chester 004A","E01018518","Total",1507,164,91,73,1343,19,316,261,296,51,121,279
"2011","Cheshire West and Chester 004B","E01018569","Total",1283,122,80,42,1161,25,274,237,216,78,111,220
"2011","Cheshire West and Chester 004C","E01018570","Total",1166,153,75,78,1013,18,200,213,200,42,111,229
"2011","Cheshire West and Chester 004D","E01018571","Total",1324,222,145,77,1102,39,238,257,216,41,80,231
"2011","Cheshire West and Chester 005A","E01018546","Total",1467,217,102,115,1250,143,134,247,210,53,168,295
"2011","Cheshire West and Chester 005B","E01018547","Total",1384,170,79,91,1214,61,226,219,246,68,144,250
"2011","Cheshire West and Chester 005C","E01018548","Total",1561,221,112,109,1340,82,236,270,250,85,141,276
"2011","Cheshire West and Chester 005D","E01018549","Total",1412,221,99,122,1191,55,256,195,216,54,117,298
"2011","Cheshire West and Chester 006A","E01018532","Total",1855,300,189,111,1555,103,252,343,282,62,182,331
"2011","Cheshire West and Chester 006B","E01018533","Total",1506,126,73,53,1380,45,320,237,210,71,145,352
"2011","Cheshire West and Chester 006C","E01018544","Total",1487,159,76,83,1328,63,230,277,272,35,126,325
"2011","Cheshire West and Chester 006D","E01018545","Total",1913,234,128,106,1679,53,278,350,282,59,161,496
"2011","Cheshire West and Chester 007A","E01018519","Total",1416,252,57,195,1164,137,96,328,254,44,103,202
"2011","Cheshire West and Chester 007B","E01018520","Total",1035,188,49,139,847,129,66,240,176,43,35,158
"2011","Cheshire West and Chester 007C","E01018525","Total",1261,149,63,86,1112,196,64,274,180,48,167,183
"2011","Cheshire West and Chester 007D","E01018563","Total",2041,493,175,318,1548,203,112,355,380,120,159,219
"2011","Cheshire West and Chester 007E","E01018564","Total",2247,494,141,353,1753,186,160,440,386,111,197,273
"2011","Cheshire West and Chester 008A","E01018523","Total",1347,212,91,121,1135,169,138,269,128,72,116,243
"2011","Cheshire West and Chester 008B","E01018524","Total",1413,199,95,104,1214,230,86,309,140,71,173,205
"2011","Cheshire West and Chester 008C","E01018541","Total",1340,222,104,118,1118,84,164,271,236,44,95,224
"2011","Cheshire West and Chester 008D","E01018542","Total",1317,113,47,66,1204,214,82,257,140,111,221,179
"2011","Cheshire West and Chester 008E","E01018543","Total",1319,212,104,108,1107,148,146,242,202,68,103,198
"2011","Cheshire West and Chester 009A","E01018528","Total",1176,135,74,61,1041,27,130,277,198,31,93,285
"2011","Cheshire West and Chester 009B","E01018529","Total",1507,148,91,57,1359,40,284,250,262,47,145,331
"2011","Cheshire West and Chester 009C","E01018530","Total",1517,93,25,68,1424,44,112,475,250,103,172,268
"2011","Cheshire West and Chester 009D","E01018531","Total",1566,181,88,93,1385,53,218,322,254,88,113,337
"2011","Cheshire West and Chester 009E","E01018560","Total",1169,97,45,52,1072,20,142,262,214,52,118,264
"2011","Cheshire West and Chester 009F","E01018561","Total",1236,86,32,54,1150,29,120,312,216,66,137,270
"2011","Cheshire West and Chester 009G","E01018562","Total",1454,81,16,65,1373,54,62,526,240,76,158,257
"2011","Cheshire West and Chester 010A","E01018522","Total",1353,187,81,106,1166,138,146,234,194,67,132,255
"2011","Cheshire West and Chester 010B","E01018538","Total",1165,100,57,43,1065,124,122,161,148,79,184,247
"2011","Cheshire West and Chester 010C","E01018539","Total",1088,165,44,121,923,140,124,187,130,48,84,210
"2011","Cheshire West and Chester 010D","E01018540","Total",1442,163,82,81,1279,71,212,307,206,80,125,278
"2011","Cheshire West and Chester 011A","E01018521","Total",1197,156,96,60,1041,116,100,229,136,52,139,269
"2011","Cheshire West and Chester 011B","E01018550","Total",1074,190,37,153,884,134,52,212,114,73,114,185
"2011","Cheshire West and Chester 011C","E01018551","Total",1485,279,69,210,1206,135,118,273,208,85,159,228
"2011","Cheshire West and Chester 011D","E01018552","Total",1554,182,79,103,1372,125,142,315,228,103,170,289
"2011","Cheshire West and Chester 011E","E01018553","Total",1510,236,128,108,1274,155,230,214,196,79,161,239
"2011","Cheshire West and Chester 013A","E01018556","Total",1435,165,105,60,1270,73,302,254,232,52,130,227
"2011","Cheshire West and Chester 013B","E01018557","Total",1455,248,154,94,1207,82,174,266,180,65,176,264
"2011","Cheshire West and Chester 013C","E01018558","Total",1293,84,20,64,1209,61,64,365,280,41,135,263
"2011","Cheshire West and Chester 013D","E01018559","Total",1168,89,43,46,1079,44,166,246,190,36,127,270
"2011","Cheshire West and Chester 014A","E01018565","Total",1513,142,99,43,1371,46,222,338,228,79,140,318
"2011","Cheshire West and Chester 014B","E01018566","Total",1332,160,108,52,1172,37,276,196,202,36,126,299
"2011","Cheshire West and Chester 014C","E01018567","Total",1414,138,90,48,1276,49,208,241,244,36,133,365
"2011","Cheshire West and Chester 014D","E01018568","Total",1567,105,15,90,1462,68,56,559,256,95,193,235
"2011","Cheshire West and Chester 016A","E01018526","Total",1624,150,92,58,1474,63,244,288,252,63,212,352
"2011","Cheshire West and Chester 016B","E01018527","Total",1686,137,61,76,1549,51,190,371,248,90,193,406
"2011","Cheshire West and Chester 016C","E01018554","Total",2347,247,115,132,2100,70,328,498,406,73,208,517
"2011","Cheshire West and Chester 016D","E01018555","Total",1172,118,39,79,1054,31,132,262,192,58,123,256
"2011","Cheshire West and Chester 002A","E01018685","Total",1216,262,141,121,954,82,140,217,176,61,102,176
"2011","Cheshire West and Chester 002B","E01018686","Total",1414,164,51,113,1250,115,112,366,290,87,101,179
"2011","Cheshire West and Chester 002C","E01018687","Total",1365,139,89,50,1226,36,284,246,214,61,131,254
"2011","Cheshire West and Chester 002D","E01018688","Total",1560,196,86,110,1364,54,278,313,256,97,121,245
"2011","Cheshire West and Chester 002E","E01018689","Total",1389,276,166,110,1113,74,196,229,202,68,114,230
"2011","Cheshire West and Chester 002F","E01018690","Total",2041,201,114,87,1840,50,388,430,336,96,140,400
"2011","Cheshire West and Chester 003A","E01018675","Total",2092,183,97,86,1909,32,372,442,368,99,189,407
"2011","Cheshire West and Chester 003B","E01018708","Total",2117,210,111,99,1907,34,374,363,382,135,216,403
"2011","Cheshire West and Chester 003C","E01018721","Total",2201,208,104,104,1993,57,346,371,394,96,241,488
"2011","Cheshire West and Chester 012A","E01018671","Total",1258,105,57,48,1153,36,192,246,226,71,124,258
"2011","Cheshire West and Chester 012B","E01018672","Total",1606,197,96,101,1409,115,162,273,240,123,196,300
"2011","Cheshire West and Chester 012C","E01018673","Total",1192,146,61,85,1046,70,162,220,220,72,91,211
"2011","Cheshire West and Chester 012D","E01018674","Total",1545,240,104,136,1305,83,100,346,284,67,146,279
"2011","Cheshire West and Chester 015A","E01018684","Total",2230,199,104,95,2031,34,352,473,448,119,220,385
"2011","Cheshire West and Chester 015B","E01018695","Total",1684,203,78,125,1481,85,196,432,320,41,139,268
"2011","Cheshire West and Chester 015C","E01018696","Total",1473,165,101,64,1308,18,290,306,188,42,179,285
"2011","Cheshire West and Chester 015D","E01018697","Total",1753,255,155,100,1498,78,214,383,288,91,184,260
"2011","Cheshire West and Chester 015E","E01018698","Total",1958,168,114,54,1790,36,372,367,330,104,182,399
"2011","Cheshire West and Chester 017A","E01018704","Total",1184,184,93,91,1000,69,184,199,156,40,97,255
"2011","Cheshire West and Chester 017B","E01018705","Total",1530,138,62,76,1392,59,162,355,256,87,133,340
"2011","Cheshire West and Chester 017C","E01018706","Total",1268,133,48,85,1135,70,120,249,234,99,120,243
"2011","Cheshire West and Chester 017D","E01018718","Total",1631,150,47,103,1481,57,166,334,344,79,167,334
"2011","Cheshire West and Chester 017E","E01018722","Total",2229,214,120,94,2015,46,424,416,404,124,220,381
"2011","Cheshire West and Chester 018A","E01018713","Total",2713,305,124,181,2408,150,236,685,482,112,287,456
"2011","Cheshire West and Chester 018B","E01018714","Total",1703,406,127,279,1297,144,128,369,330,57,112,157
"2011","Cheshire West and Chester 018C","E01018715","Total",1729,224,47,177,1505,149,128,446,328,63,96,295
"2011","Cheshire West and Chester 019A","E01018726","Total",1473,166,89,77,1307,85,156,245,260,158,139,264
"2011","Cheshire West and Chester 019B","E01018727","Total",1652,201,118,83,1451,54,334,256,324,53,114,316
"2011","Cheshire West and Chester 019C","E01018728","Total",1563,175,93,82,1388,72,168,352,210,118,168,300
"2011","Cheshire West and Chester 019D","E01018729","Total",1673,278,151,127,1395,70,196,317,244,136,165,267
"2011","Cheshire West and Chester 020A","E01018709","Total",1492,217,41,176,1275,128,80,346,308,47,113,253
"2011","Cheshire West and Chester 020B","E01018710","Total",1470,162,58,104,1308,125,98,228,222,109,236,290
"2011","Cheshire West and Chester 020C","E01018711","Total",1513,290,65,225,1223,84,146,288,280,61,110,254
"2011","Cheshire West and Chester 020D","E01018712","Total",1561,275,86,189,1286,75,158,318,346,57,91,241
"2011","Cheshire West and Chester 021A","E01018699","Total",1628,162,73,89,1466,105,142,421,254,119,141,284
"2011","Cheshire West and Chester 021B","E01018701","Total",1462,199,117,82,1263,130,148,253,176,55,231,270
"2011","Cheshire West and Chester 021C","E01018716","Total",1544,200,89,111,1344,80,160,230,222,146,219,287
"2011","Cheshire West and Chester 021D","E01018717","Total",1763,234,65,169,1529,152,134,412,310,76,157,288
"2011","Cheshire West and Chester 021E","E01018719","Total",1550,176,78,98,1374,70,156,397,228,53,184,286
"2011","Cheshire West and Chester 021F","E01018720","Total",1565,194,116,78,1371,133,174,301,214,72,165,312
"2011","Cheshire West and Chester 023A","E01018691","Total",1582,214,122,92,1368,88,260,330,206,90,132,262
"2011","Cheshire West and Chester 023B","E01018693","Total",1589,120,68,52,1469,46,218,392,254,79,129,351
"2011","Cheshire West and Chester 023C","E01018694","Total",1582,121,61,60,1461,33,300,351,230,107,186,254
"2011","Cheshire West and Chester 023D","E01018700","Total",2041,169,25,144,1872,86,102,708,296,193,234,253
"2011","Cheshire West and Chester 023E","E01018702","Total",1286,85,23,62,1201,74,82,419,226,106,141,153
"2011","Cheshire West and Chester 023F","E01018703","Total",1811,267,51,216,1544,83,196,407,384,96,133,245
"2011","Cheshire West and Chester 024A","E01018676","Total",1443,161,101,60,1282,24,342,254,234,75,94,259
"2011","Cheshire West and Chester 024B","E01018677","Total",1430,153,77,76,1277,18,328,227,332,60,106,206
"2011","Cheshire West and Chester 024C","E01018678","Total",1209,115,75,40,1094,14,254,244,188,31,153,210
"2011","Cheshire West and Chester 024D","E01018679","Total",1727,203,91,112,1524,118,210,386,252,125,111,322
"2011","Cheshire West and Chester 024E","E01018692","Total",1975,172,80,92,1803,30,320,437,304,134,211,367
"2011","Cheshire West and Chester 026A","E01018680","Total",1622,125,56,69,1497,36,218,381,304,94,153,311
"2011","Cheshire West and Chester 026B","E01018681","Total",1451,154,77,77,1297,71,218,360,276,77,75,220
"2011","Cheshire West and Chester 026C","E01018682","Total",1075,162,87,75,913,63,168,227,146,37,93,179
"2011","Cheshire West and Chester 026D","E01018683","Total",1434,182,100,82,1252,53,202,332,286,41,101,237
"2011","Cheshire West and Chester 035A","E01018733","Total",1401,152,90,62,1249,58,260,240,236,43,122,290
"2011","Cheshire West and Chester 035B","E01018734","Total",1232,154,82,72,1078,80,154,207,194,39,133,271
"2011","Cheshire West and Chester 035C","E01018748","Total",1390,117,42,75,1273,232,86,281,104,171,187,212
"2011","Cheshire West and Chester 035D","E01018749","Total",2509,198,31,167,2311,145,90,808,462,235,283,288
"2011","Cheshire West and Chester 037A","E01018736","Total",1629,149,57,92,1480,79,150,418,294,63,206,270
"2011","Cheshire West and Chester 037B","E01018737","Total",1338,95,35,60,1243,46,136,358,244,51,120,288
"2011","Cheshire West and Chester 037C","E01018743","Total",1463,164,65,99,1299,72,176,306,252,66,87,340
"2011","Cheshire West and Chester 037D","E01018744","Total",1707,162,63,99,1545,155,140,369,256,119,218,288
"2011","Cheshire West and Chester 038A","E01018732","Total",1290,149,65,84,1141,91,110,255,250,42,148,245
"2011","Cheshire West and Chester 038B","E01018745","Total",1556,271,110,161,1285,150,122,295,206,97,157,258
"2011","Cheshire West and Chester 038C","E01018746","Total",1632,211,96,115,1421,91,168,267,286,68,188,353
"2011","Cheshire West and Chester 038D","E01018747","Total",1511,191,79,112,1320,105,142,281,264,61,159,308
"2011","Cheshire West and Chester 040A","E01018730","Total",1463,201,109,92,1262,76,218,230,194,65,222,257
"2011","Cheshire West and Chester 040B","E01018738","Total",1474,166,90,76,1308,256,88,322,112,174,183,173
"2011","Cheshire West and Chester 040C","E01018739","Total",1443,145,46,99,1298,238,94,273,222,94,192,185
"2011","Cheshire West and Chester 040D","E01018741","Total",1263,150,65,85,1113,19,214,203,154,73,156,294
"2011","Cheshire West and Chester 042A","E01018731","Total",1600,186,69,117,1414,149,138,335,258,130,139,265
"2011","Cheshire West and Chester 042B","E01018735","Total",1301,117,39,78,1184,61,140,314,270,49,109,241
"2011","Cheshire West and Chester 042C","E01018740","Total",1537,165,73,92,1372,158,108,293,212,150,223,228
"2011","Cheshire West and Chester 042D","E01018742","Total",1485,150,66,84,1335,41,186,243,300,40,182,343
"2011","Cheshire West and Chester 045A","E01018707","Total",1729,176,97,79,1553,44,336,322,258,77,151,365
"2011","Cheshire West and Chester 045B","E01018723","Total",1124,171,98,73,953,52,172,208,172,66,120,163
"2011","Cheshire West and Chester 045C","E01018724","Total",1481,196,113,83,1285,42,262,235,272,96,131,247
"2011","Cheshire West and Chester 045D","E01018725","Total",1310,123,60,63,1187,51,244,218,206,107,113,248
"2011","Halton 001A","E01012392","Total",2350,192,52,140,2158,118,142,596,410,163,275,454
"2011","Halton 001B","E01012393","Total",1989,227,108,119,1762,69,320,429,330,62,164,388
"2011","Halton 001C","E01012395","Total",1445,157,92,65,1288,45,286,221,214,68,129,325
"2011","Halton 001D","E01012411","Total",1310,178,94,84,1132,58,216,228,208,26,106,290
"2011","Halton 002A","E01012374","Total",2733,244,83,161,2489,122,200,726,488,157,358,438
"2011","Halton 002B","E01012375","Total",1583,69,41,28,1514,29,190,326,194,95,224,456
"2011","Halton 002C","E01012376","Total",2593,142,20,122,2451,120,64,881,424,143,369,450
"2011","Halton 002D","E01012421","Total",1339,98,39,59,1241,37,156,280,236,20,135,377
"2011","Halton 002E","E01012423","Total",1394,222,74,148,1172,60,142,254,260,59,95,302
"2011","Halton 003A","E01012368","Total",1892,298,160,138,1594,165,192,332,264,151,144,346
"2011","Halton 003B","E01012410","Total",1265,135,52,83,1130,40,120,258,236,31,119,326
"2011","Halton 003C","E01012412","Total",1411,295,101,194,1116,141,92,286,202,57,128,210
"2011","Halton 003D","E01012413","Total",1456,253,123,130,1203,145,132,256,196,74,177,223
"2011","Halton 003E","E01012414","Total",1232,96,49,47,1136,67,172,239,228,20,122,288
"2011","Halton 004A","E01012377","Total",1788,216,90,126,1572,141,162,277,264,88,195,445
"2011","Halton 004B","E01012390","Total",1529,220,129,91,1309,111,168,314,236,59,122,299
"2011","Halton 004C","E01012419","Total",1143,154,43,111,989,154,82,204,128,56,164,201
"2011","Halton 004D","E01012420","Total",1481,328,144,184,1153,176,156,234,202,64,117,204
"2011","Halton 004E","E01012422","Total",1474,213,73,140,1261,227,106,276,156,122,159,215
"2011","Halton 005A","E01012369","Total",1517,188,93,95,1329,68,118,284,208,74,225,352
"2011","Halton 005B","E01012394","Total",1467,261,144,117,1206,93,174,259,188,74,131,287
"2011","Halton 005C","E01012425","Total",1613,205,104,101,1408,147,166,288,240,73,141,353
"2011","Halton 005D","E01012426","Total",1341,155,89,66,1186,48,182,245,200,25,185,301
"2011","Halton 005E","E01012427","Total",1764,141,59,82,1623,106,94,423,244,100,295,361
"2011","Halton 006A","E01012378","Total",1498,169,107,62,1329,60,220,265,226,30,149,379
"2011","Halton 006B","E01012379","Total",1452,196,77,119,1256,98,124,252,232,73,138,339
"2011","Halton 006C","E01012380","Total",1331,197,78,119,1134,158,94,242,162,82,124,272
"2011","Halton 006D","E01012388","Total",1809,190,81,109,1619,263,146,318,220,118,165,389
"2011","Halton 006E","E01012442","Total",1621,164,69,95,1457,216,92,323,190,162,213,261
"2011","Halton 007A","E01012367","Total",1591,322,131,191,1269,198,142,199,258,97,126,249
"2011","Halton 007B","E01012370","Total",1699,293,73,220,1406,192,114,323,320,50,100,307
"2011","Halton 007C","E01012424","Total",1877,252,83,169,1625,202,110,262,214,171,295,371
"2011","Halton 007D","E01012441","Total",2285,420,108,312,1865,333,176,404,328,122,180,322
"2011","Halton 008A","E01012389","Total",1785,173,107,66,1612,45,346,277,258,89,177,420
"2011","Halton 008B","E01012391","Total",2130,327,106,221,1803,167,210,407,368,100,158,393
"2011","Halton 008C","E01012401","Total",1841,188,113,75,1653,51,334,280,310,66,191,421
"2011","Halton 008D","E01012443","Total",1531,137,31,106,1394,92,86,330,244,95,160,387
"2011","Halton 009A","E01012385","Total",1441,108,37,71,1333,49,118,386,334,86,114,246
"2011","Halton 009B","E01012386","Total",1945,71,15,56,1874,50,46,693,334,117,285,349
"2011","Halton 009C","E01012387","Total",1115,145,90,55,970,39,184,235,226,36,108,142
"2011","Halton 009D","E01012434","Total",1539,99,30,69,1440,66,116,412,332,71,137,306
"2011","Halton 009E","E01012435","Total",2108,98,28,70,2010,81,116,532,412,144,303,422
"2011","Halton 010A","E01012381","Total",1351,305,69,236,1046,150,76,209,214,111,117,169
"2011","Halton 010B","E01012382","Total",1497,272,67,205,1225,231,144,214,220,88,141,187
"2011","Halton 010C","E01012384","Total",1588,298,118,180,1290,60,214,203,242,54,217,300
"2011","Halton 010D","E01012444","Total",1139,97,39,58,1042,181,64,205,138,77,163,214
"2011","Halton 010E","E01012445","Total",1276,194,61,133,1082,187,82,187,166,38,136,286
"2011","Halton 011A","E01012398","Total",1239,158,89,69,1081,72,132,245,160,93,144,235
"2011","Halton 011B","E01012400","Total",1240,127,61,66,1113,93,118,242,202,89,138,231
"2011","Halton 011C","E01012402","Total",1518,218,76,142,1300,177,124,238,172,69,209,311
"2011","Halton 011D","E01012404","Total",1403,145,65,80,1258,102,144,326,234,96,124,232
"2011","Halton 011E","E01012405","Total",1992,243,121,122,1749,150,178,340,296,94,232,459
"2011","Halton 012A","E01012416","Total",1786,234,138,96,1552,90,236,370,280,81,222,273
"2011","Halton 012B","E01012417","Total",1294,166,64,102,1128,144,100,267,282,37,109,189
"2011","Halton 012C","E01012428","Total",2185,375,110,265,1810,178,120,441,462,75,182,352
"2011","Halton 012D","E01012429","Total",1387,201,103,98,1186,142,174,275,214,67,109,205
"2011","Halton 012E","E01012430","Total",1744,382,105,277,1362,250,108,268,338,64,101,233
"2011","Halton 012F","E01012431","Total",2032,400,77,323,1632,202,122,433,440,53,94,288
"2011","Halton 013A","E01012383","Total",1702,270,104,166,1432,119,152,271,258,96,190,346
"2011","Halton 013B","E01012396","Total",1474,176,82,94,1298,212,154,259,136,108,154,275
"2011","Halton 013C","E01012397","Total",1483,269,98,171,1214,205,96,298,168,84,174,189
"2011","Halton 013D","E01012399","Total",1408,244,106,138,1164,152,124,250,166,77,180,215
"2011","Halton 013E","E01012403","Total",1624,177,64,113,1447,250,120,308,176,126,212,255
"2011","Halton 013F","E01012408","Total",2008,169,45,124,1839,298,132,355,216,209,326,303
"2011","Halton 014A","E01012432","Total",1409,214,55,159,1195,164,110,239,338,49,115,180
"2011","Halton 014B","E01012433","Total",1620,199,62,137,1421,266,120,269,260,138,143,225
"2011","Halton 014C","E01012436","Total",1334,105,21,84,1229,324,52,239,158,128,134,194
"2011","Halton 014D","E01012438","Total",1178,207,95,112,971,202,88,143,148,88,123,179
"2011","Halton 014E","E01012440","Total",1373,79,24,55,1294,86,98,318,288,61,130,313
"2011","Halton 015A","E01012406","Total",1596,188,73,115,1408,147,150,259,268,119,196,269
"2011","Halton 015B","E01012407","Total",1594,323,97,226,1271,185,102,234,230,82,146,292
"2011","Halton 015C","E01012409","Total",1375,222,77,145,1153,148,150,173,200,70,172,240
"2011","Halton 015D","E01012437","Total",1354,137,39,98,1217,204,80,230,216,105,161,221
"2011","Halton 015E","E01012439","Total",1520,194,81,113,1326,199,96,249,232,113,112,325
"2011","Halton 016A","E01012371","Total",1244,130,34,96,1114,47,106,284,256,25,96,300
"2011","Halton 016B","E01012372","Total",1135,125,48,77,1010,27,178,203,250,17,68,267
"2011","Halton 016C","E01012373","Total",1290,101,52,49,1189,29,202,252,284,45,69,308
"2011","Halton 016D","E01012415","Total",1399,89,37,52,1310,40,188,244,266,129,129,314
"2011","Halton 016E","E01012418","Total",1376,164,115,49,1212,33,298,206,232,42,107,294
"2011","Warrington 001A","E01012471","Total",1225,120,73,47,1105,47,226,272,154,62,137,207
"2011","Warrington 001B","E01012472","Total",1787,159,91,68,1628,67,308,389,296,112,165,291
"2011","Warrington 001C","E01012476","Total",1544,187,84,103,1357,62,224,259,250,55,146,361
"2011","Warrington 001D","E01012477","Total",1544,137,78,59,1407,42,224,415,192,85,164,285
"2011","Warrington 002A","E01012473","Total",1558,178,139,39,1380,47,336,375,210,104,81,227
"2011","Warrington 002B","E01012474","Total",1387,205,115,90,1182,82,180,259,200,74,158,229
"2011","Warrington 002C","E01012475","Total",1490,191,88,103,1299,86,186,348,220,66,156,237
"2011","Warrington 002D","E01012554","Total",1960,211,90,121,1749,58,290,431,376,65,223,306
"2011","Warrington 003A","E01012467","Total",1196,120,82,38,1076,18,282,151,186,38,144,257
"2011","Warrington 003B","E01012468","Total",2306,207,104,103,2099,66,250,736,358,121,262,306
"2011","Warrington 003C","E01012469","Total",1455,157,62,95,1298,65,182,337,280,57,136,241
"2011","Warrington 003D","E01012470","Total",1143,146,82,64,997,94,168,191,150,52,109,233
"2011","Warrington 004A","E01012460","Total",1418,199,57,142,1219,144,108,278,268,72,119,230
"2011","Warrington 004B","E01012462","Total",1289,258,94,164,1031,68,106,270,254,52,95,186
"2011","Warrington 004C","E01012463","Total",1128,109,55,54,1019,21,256,163,238,27,70,244
"2011","Warrington 004D","E01012464","Total",1391,168,63,105,1223,81,136,271,258,69,129,279
"2011","Warrington 005A","E01012459","Total",1348,235,60,175,1113,118,90,260,238,53,119,235
"2011","Warrington 005B","E01012461","Total",1308,127,43,84,1181,31,124,310,250,63,156,247
"2011","Warrington 005C","E01012465","Total",1289,233,55,178,1056,47,98,318,248,47,106,192
"2011","Warrington 005D","E01012466","Total",1507,301,67,234,1206,185,46,272,240,122,141,200
"2011","Warrington 006A","E01012526","Total",1700,177,41,136,1523,257,76,349,188,170,247,236
"2011","Warrington 006B","E01012534","Total",1520,224,73,151,1296,176,94,283,204,104,177,258
"2011","Warrington 006C","E01012535","Total",1655,216,87,129,1439,218,90,370,252,104,171,234
"2011","Warrington 006D","E01012537","Total",1496,272,121,151,1224,200,142,264,188,91,122,217
"2011","Warrington 006E","E01012539","Total",1547,243,99,144,1304,141,150,312,222,99,148,232
"2011","Warrington 007A","E01012538","Total",1427,155,43,112,1272,43,144,312,322,27,126,298
"2011","Warrington 007B","E01012540","Total",1366,158,73,85,1208,34,164,355,248,61,105,241
"2011","Warrington 007C","E01012541","Total",1303,126,42,84,1177,69,80,303,202,75,92,356
"2011","Warrington 007D","E01012542","Total",1356,210,101,109,1146,69,198,179,260,57,121,262
"2011","Warrington 007E","E01012543","Total",1336,149,77,72,1187,56,232,245,252,35,59,308
"2011","Warrington 007F","E01012544","Total",1401,125,63,62,1276,105,186,209,272,30,178,296
"2011","Warrington 008A","E01012521","Total",1564,166,70,96,1398,131,220,242,242,94,167,302
"2011","Warrington 008B","E01012522","Total",1359,216,110,106,1143,105,120,254,208,65,129,262
"2011","Warrington 008C","E01012533","Total",1445,120,39,81,1325,293,132,261,172,140,137,190
"2011","Warrington 008D","E01012536","Total",1436,224,81,143,1212,168,106,238,208,128,128,236
"2011","Warrington 008E","E01012545","Total",1592,230,81,149,1362,262,108,276,232,123,116,245
"2011","Warrington 008F","E01012546","Total",1598,257,68,189,1341,253,46,339,202,180,152,169
"2011","Warrington 009A","E01012561","Total",1559,219,81,138,1340,58,82,449,298,77,130,246
"2011","Warrington 009B","E01012562","Total",1726,79,18,61,1647,60,86,480,296,107,270,348
"2011","Warrington 009C","E01012567","Total",1875,75,10,65,1800,66,44,577,324,106,314,369
"2011","Warrington 009D","E01012568","Total",2500,205,29,176,2295,118,70,931,480,117,260,319
"2011","Warrington 010A","E01012563","Total",1729,79,28,51,1650,48,196,449,276,47,234,400
"2011","Warrington 010B","E01012564","Total",1307,123,25,98,1184,42,90,282,250,69,133,318
"2011","Warrington 010C","E01012565","Total",2458,194,48,146,2264,112,120,767,432,211,295,327
"2011","Warrington 010D","E01012566","Total",2151,117,28,89,2034,83,72,686,300,207,381,305
"2011","Warrington 010E","E01012569","Total",1925,116,23,93,1809,53,132,584,312,120,245,363
"2011","Warrington 010F","E01012570","Total",1204,258,96,162,946,67,138,199,192,52,97,201
"2011","Warrington 011A","E01012481","Total",1594,220,70,150,1374,158,106,408,324,84,69,225
"2011","Warrington 011B","E01012482","Total",1601,434,230,204,1167,162,178,292,212,39,76,208
"2011","Warrington 011C","E01012520","Total",1465,225,85,140,1240,151,126,209,188,170,154,242
"2011","Warrington 011D","E01012523","Total",1442,184,56,128,1258,89,144,291,252,102,146,234
"2011","Warrington 011E","E01012524","Total",1523,144,84,60,1379,44,196,340,246,25,184,344
"2011","Warrington 011F","E01012525","Total",1517,183,71,112,1334,141,128,347,216,75,175,252
"2011","Warrington 012A","E01012478","Total",1446,191,99,92,1255,100,134,279,228,87,151,276
"2011","Warrington 012B","E01012547","Total",1713,156,80,76,1557,77,220,334,230,139,170,387
"2011","Warrington 012C","E01012548","Total",1793,136,61,75,1657,55,192,451,300,62,208,389
"2011","Warrington 012D","E01012549","Total",1393,189,137,52,1204,49,312,268,196,25,88,266
"2011","Warrington 012E","E01012550","Total",1583,189,111,78,1394,51,286,337,242,42,118,318
"2011","Warrington 013A","E01012453","Total",1692,181,67,114,1511,206,80,299,204,210,228,284
"2011","Warrington 013B","E01012454","Total",2014,263,57,206,1751,156,124,498,378,130,226,239
"2011","Warrington 013C","E01012455","Total",1934,344,100,244,1590,273,92,435,216,169,155,250
"2011","Warrington 013D","E01012457","Total",1628,307,75,232,1321,146,98,327,312,68,172,198
"2011","Warrington 014A","E01012551","Total",1560,103,42,61,1457,47,162,363,278,93,177,337
"2011","Warrington 014B","E01012552","Total",1357,205,130,75,1152,70,172,255,244,34,128,249
"2011","Warrington 014C","E01012553","Total",1354,65,25,40,1289,28,108,343,240,56,163,351
"2011","Warrington 014D","E01012555","Total",1311,98,47,51,1213,45,160,284,234,77,129,284
"2011","Warrington 014E","E01012556","Total",1483,145,90,55,1338,29,228,274,246,40,165,356
"2011","Warrington 015A","E01012491","Total",1422,189,108,81,1233,71,236,299,164,56,155,252
"2011","Warrington 015B","E01012492","Total",1444,131,85,46,1313,44,256,319,260,51,151,232
"2011","Warrington 015C","E01012493","Total",1716,134,52,82,1582,57,208,469,256,107,198,287
"2011","Warrington 015D","E01012494","Total",1654,131,26,105,1523,74,116,469,290,76,201,297
"2011","Warrington 015E","E01012500","Total",1354,149,77,72,1205,44,252,214,250,67,107,271
"2011","Warrington 016A","E01012495","Total",1713,132,32,100,1581,69,80,478,294,114,214,332
"2011","Warrington 016B","E01012496","Total",1400,135,69,66,1265,67,200,289,258,47,126,278
"2011","Warrington 016C","E01012497","Total",1271,129,44,85,1142,105,142,225,198,55,167,250
"2011","Warrington 016D","E01012498","Total",1523,225,100,125,1298,93,124,232,240,175,170,264
"2011","Warrington 016E","E01012499","Total",1908,132,35,97,1776,130,128,581,350,111,188,288
"2011","Warrington 016F","E01012501","Total",1419,151,61,90,1268,79,164,320,274,55,110,266
"2011","Warrington 017A","E01012479","Total",1606,340,101,239,1266,170,110,304,272,70,110,230
"2011","Warrington 017B","E01012480","Total",1752,413,71,342,1339,117,78,329,474,52,82,207
"2011","Warrington 017D","E01012510","Total",1751,386,100,286,1365,102,124,300,324,54,165,296
"2011","Warrington 017E","E01012511","Total",1670,257,67,190,1413,158,124,289,388,60,142,252
"2011","Warrington 017F","E01033299","Total",2010,368,29,339,1642,220,44,507,472,63,112,224
"2011","Warrington 017G","E01033303","Total",1165,238,61,177,927,125,70,255,230,25,48,174
"2011","Warrington 018B","E01012458","Total",2356,293,90,203,2063,211,124,646,482,131,175,294
"2011","Warrington 018C","E01012483","Total",1621,458,176,282,1163,173,114,245,272,65,104,190
"2011","Warrington 018D","E01012509","Total",1791,298,134,164,1493,102,356,261,338,51,78,307
"2011","Warrington 018E","E01012512","Total",1558,233,128,105,1325,31,358,231,230,42,106,327
"2011","Warrington 018F","E01033300","Total",1047,339,62,277,708,21,36,96,328,35,70,122
"2011","Warrington 018G","E01033302","Total",1541,291,53,238,1250,101,70,338,342,90,79,230
"2011","Warrington 019A","E01012527","Total",1491,150,73,77,1341,50,208,298,254,78,173,280
"2011","Warrington 019B","E01012528","Total",1202,107,72,35,1095,29,248,204,164,41,136,273
"2011","Warrington 019C","E01012529","Total",1426,143,65,78,1283,57,256,276,228,58,161,247
"2011","Warrington 019D","E01012530","Total",1383,101,55,46,1282,29,168,370,198,47,183,287
"2011","Warrington 019E","E01012531","Total",1513,185,105,80,1328,71,338,332,206,88,82,211
"2011","Warrington 019F","E01012532","Total",1367,157,106,51,1210,43,320,206,192,77,109,263
"2011","Warrington 020A","E01012504","Total",1751,217,64,153,1534,183,116,370,332,97,200,236
"2011","Warrington 020B","E01012505","Total",1400,261,91,170,1139,132,92,245,218,61,148,243
"2011","Warrington 020C","E01012506","Total",1544,233,72,161,1311,134,110,303,224,124,175,241
"2011","Warrington 020D","E01012507","Total",1838,420,127,293,1418,152,120,351,384,86,99,226
"2011","Warrington 020E","E01012508","Total",1505,291,93,198,1214,152,144,242,196,85,149,246
"2011","Warrington 021A","E01012513","Total",1962,211,94,117,1751,72,236,534,326,158,204,221
"2011","Warrington 021B","E01012514","Total",1837,195,81,114,1642,51,198,583,248,124,188,250
"2011","Warrington 021C","E01012515","Total",1471,205,86,119,1266,60,212,348,238,84,117,207
"2011","Warrington 021D","E01012516","Total",1301,188,87,101,1113,26,216,296,226,66,120,163
"2011","Warrington 021E","E01012517","Total",2216,217,76,141,1999,105,232,652,372,162,213,263
"2011","Warrington 021F","E01012518","Total",2003,228,96,132,1775,138,210,496,346,118,202,265
"2011","Warrington 021G","E01012519","Total",1471,167,96,71,1304,37,248,380,224,62,100,253
"2011","Warrington 022A","E01012485","Total",1568,163,58,105,1405,113,210,431,232,45,168,206
"2011","Warrington 022B","E01012486","Total",1483,170,103,67,1313,71,190,368,240,89,82,273
"2011","Warrington 022C","E01012487","Total",1537,178,97,81,1359,55,182,384,262,76,178,222
"2011","Warrington 022D","E01012489","Total",1808,129,76,53,1679,42,242,523,222,153,224,273
"2011","Warrington 022E","E01012490","Total",1466,160,109,51,1306,48,266,347,208,72,77,288
"2011","Warrington 023A","E01012450","Total",1403,224,159,65,1179,18,216,268,188,104,112,273
"2011","Warrington 023B","E01012451","Total",1504,209,134,75,1295,100,156,335,196,87,149,272
"2011","Warrington 023C","E01012557","Total",1574,283,93,190,1291,78,142,362,340,85,72,212
"2011","Warrington 023D","E01012558","Total",1787,206,94,112,1581,76,174,525,296,100,160,250
"2011","Warrington 023E","E01012559","Total",1488,123,68,55,1365,17,194,470,244,66,135,239
"2011","Warrington 023F","E01012560","Total",1476,198,117,81,1278,36,182,384,206,76,146,248
"2011","Warrington 024A","E01012448","Total",1278,95,34,61,1183,26,130,339,222,57,121,288
"2011","Warrington 024B","E01012488","Total",1711,156,93,63,1555,24,320,420,282,99,109,301
"2011","Warrington 024C","E01012502","Total",1614,134,66,68,1480,42,190,420,232,114,210,272
"2011","Warrington 024D","E01012503","Total",1451,109,37,72,1342,39,130,418,248,98,169,240
"2011","Warrington 025A","E01012446","Total",1429,67,39,28,1362,21,166,334,236,62,163,380
"2011","Warrington 025B","E01012447","Total",1494,34,10,24,1460,17,130,482,208,136,230,257
"2011","Warrington 025C","E01012449","Total",1403,162,121,41,1241,24,334,249,264,35,79,256
"2011","Warrington 025D","E01012452","Total",1770,163,100,63,1607,47,336,339,280,151,187,267
"2011","Allerdale 001A","E01019126","Total",1630,286,153,133,1344,83,222,272,256,91,180,240
"2011","Allerdale 001B","E01019127","Total",1527,209,125,84,1318,12,386,235,234,51,134,266
"2011","Allerdale 001C","E01019132","Total",1790,169,88,81,1621,23,240,284,322,131,189,432
"2011","Allerdale 001D","E01019134","Total",1523,190,109,81,1333,47,296,274,218,70,146,282
"2011","Allerdale 001E","E01019135","Total",1588,216,107,109,1372,106,150,297,218,118,164,319
"2011","Allerdale 001F","E01019136","Total",1594,167,79,88,1427,44,180,463,234,74,177,255
"2011","Allerdale 001G","E01019137","Total",1038,233,104,129,805,54,136,148,170,49,125,123
"2011","Allerdale 002A","E01019083","Total",1746,215,106,109,1531,28,336,323,336,85,118,305
"2011","Allerdale 002B","E01019107","Total",1607,180,90,90,1427,28,258,279,290,98,181,293
"2011","Allerdale 002C","E01019130","Total",1683,170,89,81,1513,32,268,325,274,103,179,332
"2011","Allerdale 002D","E01019131","Total",1892,180,93,87,1712,34,304,323,330,114,203,404
"2011","Allerdale 003A","E01019081","Total",1884,246,125,121,1638,136,240,388,328,99,169,278
"2011","Allerdale 003B","E01019082","Total",1481,207,115,92,1274,55,192,269,326,43,139,250
"2011","Allerdale 003C","E01019102","Total",1725,210,103,107,1515,82,240,255,288,122,197,331
"2011","Allerdale 003D","E01019128","Total",1624,167,84,83,1457,38,252,264,310,118,199,276
"2011","Allerdale 003E","E01019133","Total",1546,179,75,104,1367,37,212,303,298,78,171,268
"2011","Allerdale 004A","E01019093","Total",1561,148,63,85,1413,68,226,356,260,86,137,280
"2011","Allerdale 004B","E01019094","Total",1702,197,102,95,1505,74,266,381,234,60,182,308
"2011","Allerdale 004C","E01019096","Total",2274,245,143,102,2029,71,376,430,400,98,222,432
"2011","Allerdale 004D","E01019114","Total",1435,178,78,100,1257,55,184,293,256,53,133,283
"2011","Allerdale 004E","E01019115","Total",1548,352,130,222,1196,62,184,238,284,50,185,193
"2011","Allerdale 005A","E01019095","Total",1492,259,93,166,1233,132,118,281,212,62,201,227
"2011","Allerdale 005B","E01019097","Total",1797,243,116,127,1554,176,188,289,206,212,189,294
"2011","Allerdale 005C","E01019098","Total",1644,210,101,109,1434,110,194,303,274,79,227,247
"2011","Allerdale 005D","E01019099","Total",1704,232,109,123,1472,89,190,334,288,74,171,326
"2011","Allerdale 006A","E01019084","Total",1508,180,79,101,1328,106,168,396,270,92,105,191
"2011","Allerdale 006B","E01019085","Total",1547,118,57,61,1429,26,192,428,288,55,181,259
"2011","Allerdale 006C","E01019086","Total",1105,101,60,41,1004,13,226,225,166,57,114,203
"2011","Allerdale 006D","E01019088","Total",1655,515,232,283,1140,63,178,271,332,58,79,159
"2011","Allerdale 006E","E01019091","Total",1854,183,85,98,1671,47,266,433,350,103,136,336
"2011","Allerdale 007A","E01019078","Total",1546,178,99,79,1368,29,282,346,208,114,122,267
"2011","Allerdale 007B","E01019079","Total",1469,173,109,64,1296,56,230,302,284,56,134,234
"2011","Allerdale 007C","E01019080","Total",1807,291,136,155,1516,166,194,340,298,47,187,284
"2011","Allerdale 007D","E01019087","Total",1579,202,103,99,1377,43,228,308,318,69,143,268
"2011","Allerdale 007E","E01019090","Total",1544,161,83,78,1383,19,314,235,318,92,128,277
"2011","Allerdale 008A","E01019116","Total",1225,278,96,182,947,77,108,168,196,43,127,228
"2011","Allerdale 008B","E01019118","Total",1369,256,83,173,1113,114,104,261,264,35,137,198
"2011","Allerdale 008C","E01019122","Total",1414,277,115,162,1137,135,134,274,154,72,142,226
"2011","Allerdale 008D","E01019123","Total",1577,172,94,78,1405,104,234,354,222,73,147,271
"2011","Allerdale 008E","E01019124","Total",2083,182,105,77,1901,42,244,521,364,88,242,400
"2011","Allerdale 008F","E01019125","Total",1532,219,120,99,1313,57,222,319,258,62,139,256
"2011","Allerdale 009A","E01019111","Total",1537,211,82,129,1326,190,162,304,226,50,136,258
"2011","Allerdale 009B","E01019112","Total",1693,267,114,153,1426,184,144,270,232,119,148,329
"2011","Allerdale 009C","E01019113","Total",1715,356,138,218,1359,250,124,330,258,114,92,191
"2011","Allerdale 009D","E01019120","Total",1783,269,96,173,1514,92,160,379,360,46,181,296
"2011","Allerdale 009E","E01019121","Total",1989,492,172,320,1497,142,178,306,362,63,209,237
"2011","Allerdale 010A","E01019108","Total",1483,164,78,86,1319,185,162,262,212,68,141,289
"2011","Allerdale 010B","E01019109","Total",1818,203,93,110,1615,174,196,363,276,111,178,317
"2011","Allerdale 010C","E01019110","Total",1673,381,170,211,1292,202,196,271,240,50,96,237
"2011","Allerdale 010D","E01019117","Total",1309,168,59,109,1141,36,170,276,264,32,108,255
"2011","Allerdale 010E","E01019119","Total",1427,166,105,61,1261,11,300,262,220,23,153,292
"2011","Allerdale 011A","E01019089","Total",1572,211,91,120,1361,57,222,297,332,81,153,219
"2011","Allerdale 011B","E01019100","Total",1613,218,87,131,1395,44,240,329,272,55,187,268
"2011","Allerdale 011C","E01019101","Total",1437,134,65,69,1303,19,278,348,284,50,74,250
"2011","Allerdale 011D","E01019129","Total",1636,163,78,85,1473,31,232,381,348,66,111,304
"2011","Allerdale 012A","E01019092","Total",1467,163,94,69,1304,7,318,293,240,51,152,243
"2011","Allerdale 012B","E01019103","Total",1226,137,72,65,1089,70,154,231,194,86,123,231
"2011","Allerdale 012C","E01019104","Total",1271,313,171,142,958,63,270,151,240,40,66,128
"2011","Allerdale 012D","E01019105","Total",1030,227,97,130,803,32,110,137,220,25,83,196
"2011","Allerdale 012E","E01019106","Total",1442,152,88,64,1290,40,352,205,218,68,155,252
"2011","Barrow-in-Furness 001A","E01019144","Total",1426,140,81,59,1286,70,224,238,218,72,193,271
"2011","Barrow-in-Furness 001B","E01019145","Total",2004,240,112,128,1764,91,216,469,288,120,198,382
"2011","Barrow-in-Furness 001C","E01019146","Total",1370,160,81,79,1210,29,188,346,238,78,93,238
"2011","Barrow-in-Furness 001D","E01019147","Total",1575,184,87,97,1391,106,120,376,288,66,165,270
"2011","Barrow-in-Furness 002A","E01019148","Total",1404,151,63,88,1253,50,234,270,258,47,130,264
"2011","Barrow-in-Furness 002B","E01019149","Total",1505,192,72,120,1313,79,156,302,258,85,148,285
"2011","Barrow-in-Furness 002C","E01019150","Total",1539,294,120,174,1245,103,170,333,238,62,113,226
"2011","Barrow-in-Furness 002D","E01019151","Total",1442,173,102,71,1269,78,250,270,216,116,140,199
"2011","Barrow-in-Furness 003A","E01019152","Total",1101,121,77,44,980,12,162,241,164,37,136,228
"2011","Barrow-in-Furness 003B","E01019153","Total",1070,109,79,30,961,30,190,261,178,10,93,199
"2011","Barrow-in-Furness 003C","E01019154","Total",1247,200,154,46,1047,2,332,175,230,15,87,206
"2011","Barrow-in-Furness 003D","E01019155","Total",1313,225,172,53,1088,14,440,169,212,10,41,202
"2011","Barrow-in-Furness 003E","E01019162","Total",1472,157,98,59,1315,44,232,372,248,50,105,264
"2011","Barrow-in-Furness 003F","E01019163","Total",1284,96,54,42,1188,5,214,297,192,64,159,257
"2011","Barrow-in-Furness 004A","E01019156","Total",1423,415,168,247,1008,133,112,187,198,48,164,166
"2011","Barrow-in-Furness 004B","E01019159","Total",1052,187,62,125,865,90,90,218,208,47,64,148
"2011","Barrow-in-Furness 004C","E01019164","Total",1451,210,44,166,1241,193,82,310,154,145,169,188
"2011","Barrow-in-Furness 004D","E01019165","Total",1408,223,81,142,1185,76,152,282,276,47,119,233
"2011","Barrow-in-Furness 004E","E01019166","Total",1371,239,88,151,1132,90,172,264,222,47,117,220
"2011","Barrow-in-Furness 005A","E01019167","Total",1483,276,84,192,1207,125,144,297,278,55,100,208
"2011","Barrow-in-Furness 005B","E01019168","Total",1391,208,115,93,1183,39,156,265,210,64,169,280
"2011","Barrow-in-Furness 005C","E01019169","Total",1267,138,75,63,1129,35,130,265,184,112,159,244
"2011","Barrow-in-Furness 005D","E01019170","Total",1282,121,48,73,1161,94,106,294,162,35,218,252
"2011","Barrow-in-Furness 005E","E01019171","Total",1320,241,70,171,1079,109,80,283,286,61,94,166
"2011","Barrow-in-Furness 006A","E01019161","Total",1712,190,101,89,1522,125,160,393,250,94,216,284
"2011","Barrow-in-Furness 006B","E01019176","Total",1704,157,106,51,1547,15,292,356,282,100,153,349
"2011","Barrow-in-Furness 006C","E01019177","Total",1400,192,68,124,1208,165,124,268,176,68,172,235
"2011","Barrow-in-Furness 006D","E01019178","Total",1507,204,92,112,1303,55,244,343,324,20,83,234
"2011","Barrow-in-Furness 006E","E01019179","Total",1229,115,50,65,1114,29,202,251,230,36,143,223
"2011","Barrow-in-Furness 007A","E01019140","Total",1042,189,63,126,853,177,66,184,144,46,94,142
"2011","Barrow-in-Furness 007B","E01019160","Total",1380,238,88,150,1142,107,110,218,178,115,199,215
"2011","Barrow-in-Furness 007C","E01019172","Total",1383,226,67,159,1157,103,108,269,274,84,56,263
"2011","Barrow-in-Furness 007D","E01019173","Total",1286,255,90,165,1031,124,126,257,186,74,109,155
"2011","Barrow-in-Furness 007E","E01019174","Total",1163,148,63,85,1015,112,64,153,164,80,195,247
"2011","Barrow-in-Furness 007F","E01019175","Total",1436,168,76,92,1268,105,138,246,210,99,176,294
"2011","Barrow-in-Furness 008A","E01019141","Total",1216,393,123,270,823,146,86,166,164,43,100,118
"2011","Barrow-in-Furness 008B","E01019142","Total",1431,306,73,233,1125,223,112,227,208,81,121,153
"2011","Barrow-in-Furness 008C","E01019143","Total",1479,335,88,247,1144,166,90,180,208,88,181,231
"2011","Barrow-in-Furness 008D","E01019157","Total",1433,356,105,251,1077,172,98,207,236,58,139,167
"2011","Barrow-in-Furness 008E","E01019158","Total",1183,232,63,169,951,150,76,221,170,92,78,164
"2011","Barrow-in-Furness 009A","E01019180","Total",1845,347,219,128,1498,52,462,299,318,20,128,219
"2011","Barrow-in-Furness 009C","E01019182","Total",1355,197,95,102,1158,64,180,301,266,45,85,217
"2011","Barrow-in-Furness 009E","E01019184","Total",1335,231,97,134,1104,78,144,285,234,57,101,205
"2011","Barrow-in-Furness 009F","E01033160","Total",2091,303,146,157,1788,127,200,384,272,186,294,325
"2011","Barrow-in-Furness 010A","E01019138","Total",1262,223,101,122,1039,80,172,223,232,56,87,189
"2011","Barrow-in-Furness 010B","E01019139","Total",1354,564,101,463,790,140,68,174,196,15,66,131
"2011","Barrow-in-Furness 010C","E01019185","Total",1410,161,92,69,1249,45,226,313,244,50,132,239
"2011","Barrow-in-Furness 010D","E01019186","Total",1274,200,91,109,1074,95,146,270,258,62,66,177
"2011","Barrow-in-Furness 010E","E01019187","Total",1282,161,86,75,1121,57,170,240,228,50,136,240
"2011","Carlisle 001A","E01019226","Total",1153,106,50,56,1047,45,186,170,214,47,124,261
"2011","Carlisle 001B","E01019227","Total",1389,281,107,174,1108,63,184,206,228,79,127,221
"2011","Carlisle 001C","E01019228","Total",1512,201,94,107,1311,65,190,241,234,64,121,396
"2011","Carlisle 001D","E01019229","Total",1929,201,105,96,1728,41,338,330,334,111,136,438
"2011","Carlisle 002A","E01019200","Total",1545,246,123,123,1299,47,302,293,246,79,113,219
"2011","Carlisle 002B","E01019201","Total",1368,273,132,141,1095,102,198,201,202,66,149,177
"2011","Carlisle 002C","E01019202","Total",1646,224,94,130,1422,108,186,359,252,124,144,249
"2011","Carlisle 002D","E01019225","Total",1978,220,84,136,1758,37,294,416,374,109,203,325
"2011","Carlisle 003A","E01019188","Total",1488,216,99,117,1272,87,164,310,210,83,152,266
"2011","Carlisle 003B","E01019189","Total",1545,220,71,149,1325,114,86,351,228,113,141,292
"2011","Carlisle 003C","E01019190","Total",1565,191,125,66,1374,28,316,267,232,56,147,328
"2011","Carlisle 003D","E01019191","Total",1551,193,114,79,1358,60,250,265,300,90,134,259
"2011","Carlisle 003E","E01019244","Total",1460,184,121,63,1276,54,240,351,206,50,93,282
"2011","Carlisle 004A","E01019196","Total",1785,280,88,192,1505,97,212,427,370,69,122,208
"2011","Carlisle 004B","E01019238","Total",1311,172,94,78,1139,37,240,313,244,44,100,161
"2011","Carlisle 004C","E01019240","Total",1727,176,71,105,1551,59,240,404,272,105,173,298
"2011","Carlisle 004D","E01019241","Total",1612,161,91,70,1451,45,274,386,288,89,128,241
"2011","Carlisle 004E","E01019243","Total",1418,190,110,80,1228,47,200,360,272,40,124,185
"2011","Carlisle 004F","E01019251","Total",1697,216,114,102,1481,32,254,390,330,99,87,289
"2011","Carlisle 005A","E01019192","Total",1456,160,89,71,1296,48,246,326,222,58,153,243
"2011","Carlisle 005B","E01019195","Total",1339,117,49,68,1222,55,166,336,256,48,106,255
"2011","Carlisle 005C","E01019203","Total",2111,184,98,86,1927,49,318,382,404,125,198,451
"2011","Carlisle 005D","E01019254","Total",1356,165,88,77,1191,29,184,278,304,42,118,236
"2011","Carlisle 005E","E01019255","Total",1366,107,51,56,1259,35,178,259,274,78,151,284
"2011","Carlisle 006A","E01019204","Total",1215,314,58,256,901,44,46,147,270,27,45,322
"2011","Carlisle 006B","E01019206","Total",1403,453,69,384,950,45,80,125,274,42,116,268
"2011","Carlisle 006C","E01019234","Total",1540,508,181,327,1032,71,94,161,308,11,70,317
"2011","Carlisle 006D","E01019235","Total",1477,223,97,126,1254,62,152,282,288,46,141,283
"2011","Carlisle 006E","E01019237","Total",1380,210,60,150,1170,54,128,235,244,47,174,288
"2011","Carlisle 006F","E01019242","Total",1314,262,144,118,1052,38,140,227,182,62,114,289
"2011","Carlisle 007A","E01019219","Total",2157,253,120,133,1904,53,372,455,368,96,158,402
"2011","Carlisle 007B","E01019224","Total",2059,252,141,111,1807,59,306,406,350,108,175,403
"2011","Carlisle 007C","E01019239","Total",1558,140,59,81,1418,51,198,334,238,112,150,335
"2011","Carlisle 007D","E01019249","Total",1433,203,128,75,1230,34,282,209,300,46,114,245
"2011","Carlisle 007E","E01019250","Total",1343,149,76,73,1194,41,178,253,304,54,89,275
"2011","Carlisle 008A","E01019205","Total",1625,369,100,269,1256,147,120,347,330,57,123,132
"2011","Carlisle 008B","E01019207","Total",1394,283,82,201,1111,166,90,262,258,59,97,179
"2011","Carlisle 008C","E01019215","Total",1498,310,105,205,1188,99,122,237,314,89,113,214
"2011","Carlisle 008D","E01019218","Total",1492,169,58,111,1323,136,114,262,248,81,207,275
"2011","Carlisle 008E","E01019233","Total",1299,243,156,87,1056,47,252,223,188,20,89,237
"2011","Carlisle 009A","E01019193","Total",1516,229,65,164,1287,226,110,248,224,144,152,183
"2011","Carlisle 009B","E01019194","Total",2044,245,74,171,1799,200,118,525,386,138,179,253
"2011","Carlisle 009C","E01019230","Total",1542,350,160,190,1192,130,232,242,218,63,65,242
"2011","Carlisle 009D","E01019231","Total",1472,453,197,256,1019,73,220,213,184,67,122,140
"2011","Carlisle 009E","E01019232","Total",1479,207,107,100,1272,45,192,248,238,46,210,293
"2011","Carlisle 009F","E01019252","Total",1392,247,138,109,1145,62,212,235,248,45,100,243
"2011","Carlisle 010A","E01019209","Total",1441,298,107,191,1143,57,84,344,230,80,124,224
"2011","Carlisle 010B","E01019211","Total",1779,326,58,268,1453,100,96,398,412,58,123,266
"2011","Carlisle 010C","E01019216","Total",1581,414,124,290,1167,83,112,261,334,44,97,236
"2011","Carlisle 010D","E01019217","Total",1725,407,81,326,1318,156,86,272,414,47,128,215
"2011","Carlisle 010E","E01019220","Total",1502,265,74,191,1237,59,132,355,306,37,130,218
"2011","Carlisle 010F","E01019236","Total",1586,286,69,217,1300,99,66,278,370,67,132,288
"2011","Carlisle 011A","E01019197","Total",1989,350,124,226,1639,241,134,419,244,170,202,229
"2011","Carlisle 011B","E01019198","Total",1319,250,86,164,1069,150,118,301,212,56,96,136
"2011","Carlisle 011C","E01019199","Total",1062,173,62,111,889,128,96,225,178,78,64,120
"2011","Carlisle 011D","E01019221","Total",1964,280,95,185,1684,167,154,457,346,131,191,238
"2011","Carlisle 011E","E01019222","Total",1655,258,125,133,1397,152,148,324,256,140,185,192
"2011","Carlisle 011F","E01019245","Total",1556,237,84,153,1319,181,120,243,194,143,229,209
"2011","Carlisle 012A","E01019208","Total",1519,157,70,87,1362,174,132,370,216,78,137,255
"2011","Carlisle 012B","E01019210","Total",1444,150,52,98,1294,199,146,300,174,92,157,226
"2011","Carlisle 012C","E01019246","Total",1267,272,150,122,995,96,178,237,160,51,116,157
"2011","Carlisle 012D","E01019247","Total",1471,210,87,123,1261,83,206,279,228,89,120,256
"2011","Carlisle 012E","E01019248","Total",1140,195,71,124,945,166,76,248,138,90,97,130
"2011","Carlisle 013A","E01019212","Total",1438,193,108,85,1245,32,264,263,224,99,110,253
"2011","Carlisle 013B","E01019213","Total",2689,308,121,187,2381,74,340,668,526,108,274,391
"2011","Carlisle 013C","E01019214","Total",1776,265,159,106,1511,78,320,283,320,71,139,300
"2011","Carlisle 013D","E01019223","Total",1536,170,93,77,1366,43,280,249,282,62,160,290
"2011","Carlisle 013E","E01019253","Total",1760,203,99,104,1557,63,254,439,330,31,164,276
"2011","Copeland 001A","E01019268","Total",1103,132,58,74,971,40,208,178,202,36,99,208
"2011","Copeland 001B","E01019269","Total",1557,214,85,129,1343,143,160,266,228,95,151,300
"2011","Copeland 001C","E01019270","Total",1362,168,65,103,1194,111,128,273,254,69,98,261
"2011","Copeland 001D","E01019297","Total",1394,97,45,52,1297,36,160,318,266,66,198,253
"2011","Copeland 002A","E01019260","Total",1504,172,67,105,1332,77,122,302,296,83,164,288
"2011","Copeland 002B","E01019280","Total",1510,697,250,447,813,52,184,101,276,21,58,121
"2011","Copeland 002C","E01019281","Total",1219,192,110,82,1027,43,224,186,198,56,95,225
"2011","Copeland 002D","E01019282","Total",1287,120,46,74,1167,27,128,261,188,74,178,311
"2011","Copeland 003A","E01019261","Total",1756,143,62,81,1613,15,214,461,280,96,167,380
"2011","Copeland 003B","E01019262","Total",1700,172,48,124,1528,49,176,447,390,78,137,251
"2011","Copeland 003C","E01019284","Total",1255,218,109,109,1037,85,168,263,166,84,111,160
"2011","Copeland 003D","E01019285","Total",1541,184,56,128,1357,157,108,331,246,127,137,251
"2011","Copeland 003E","E01019286","Total",1319,230,111,119,1089,36,212,263,244,25,139,170
"2011","Copeland 003F","E01019287","Total",1208,116,53,63,1092,27,202,302,214,46,128,173
"2011","Copeland 003G","E01019288","Total",1468,90,45,45,1378,24,160,424,206,76,187,301
"2011","Copeland 004A","E01019256","Total",1500,185,66,119,1315,36,192,298,302,58,128,301
"2011","Copeland 004B","E01019263","Total",1138,149,55,94,989,69,132,192,184,66,121,225
"2011","Copeland 004C","E01019264","Total",1701,193,80,113,1508,53,174,437,276,79,225,264
"2011","Copeland 004D","E01019265","Total",1255,238,75,163,1017,69,154,204,230,25,107,228
"2011","Copeland 004E","E01019266","Total",1465,193,65,128,1272,69,156,272,262,62,146,305
"2011","Copeland 004F","E01019267","Total",1310,225,119,106,1085,138,142,231,158,40,162,214
"2011","Copeland 004G","E01019276","Total",1024,98,37,61,926,26,166,185,266,36,96,151
"2011","Copeland 004H","E01019277","Total",1212,204,87,117,1008,96,156,193,148,97,125,193
"2011","Copeland 004I","E01019278","Total",1345,147,50,97,1198,26,158,277,256,47,172,262
"2011","Copeland 005A","E01019291","Total",1317,210,110,100,1107,78,122,270,224,72,103,238
"2011","Copeland 005B","E01019292","Total",1120,143,64,79,977,42,186,174,210,27,143,195
"2011","Copeland 005C","E01019294","Total",1446,152,84,68,1294,107,198,262,274,35,139,279
"2011","Copeland 005D","E01019295","Total",1567,156,60,96,1411,221,94,325,194,168,173,236
"2011","Copeland 005E","E01019296","Total",1379,185,106,79,1194,91,138,247,214,51,178,275
"2011","Copeland 005F","E01019301","Total",1438,213,55,158,1225,235,100,262,166,101,108,253
"2011","Copeland 005G","E01019302","Total",1025,106,41,65,919,58,102,163,166,35,124,271
"2011","Copeland 006A","E01019271","Total",1353,179,75,104,1174,130,126,273,208,106,105,226
"2011","Copeland 006B","E01019272","Total",1485,144,64,80,1341,143,180,298,214,107,158,241
"2011","Copeland 006C","E01019273","Total",1608,185,62,123,1423,40,216,283,312,81,247,244
"2011","Copeland 006D","E01019274","Total",1542,331,135,196,1211,104,218,277,270,42,82,218
"2011","Copeland 006E","E01019275","Total",2168,289,123,166,1879,70,278,396,316,118,268,433
"2011","Copeland 007A","E01019257","Total",1498,164,82,82,1334,62,254,276,260,92,135,255
"2011","Copeland 007B","E01019258","Total",1525,165,70,95,1360,35,248,247,332,68,140,290
"2011","Copeland 007C","E01019279","Total",1360,199,95,104,1161,12,320,252,240,36,94,207
"2011","Copeland 007D","E01019300","Total",1718,200,76,124,1518,35,234,441,306,96,132,274
"2011","Copeland 007E","E01019303","Total",1503,187,95,92,1316,37,260,283,234,97,161,244
"2011","Copeland 007F","E01019304","Total",1278,175,104,71,1103,4,230,188,246,88,104,243
"2011","Copeland 008A","E01019259","Total",1276,181,80,101,1095,13,242,176,244,66,145,209
"2011","Copeland 008B","E01019283","Total",1312,158,100,58,1154,21,224,219,222,49,163,256
"2011","Copeland 008C","E01019289","Total",1386,167,90,77,1219,75,220,291,204,67,132,230
"2011","Copeland 008D","E01019290","Total",1091,139,51,88,952,57,124,176,172,75,151,197
"2011","Copeland 008E","E01019293","Total",1336,141,84,57,1195,10,244,193,256,70,140,282
"2011","Copeland 008F","E01019298","Total",1514,204,110,94,1310,70,280,283,232,61,156,228
"2011","Copeland 008G","E01019299","Total",1934,358,163,195,1576,126,204,340,254,133,168,351
"2011","Eden 001A","E01019305","Total",2060,380,165,215,1680,89,284,364,370,64,161,348
"2011","Eden 001B","E01019314","Total",1265,126,58,68,1139,36,206,214,228,83,131,241
"2011","Eden 001C","E01019320","Total",1460,140,52,88,1320,31,212,291,264,116,167,239
"2011","Eden 001D","E01019321","Total",1559,155,86,69,1404,20,224,297,288,108,185,282
"2011","Eden 002A","E01019315","Total",1677,186,89,97,1491,50,280,326,328,111,144,252
"2011","Eden 002B","E01019316","Total",1296,125,53,72,1171,33,168,315,214,86,105,250
"2011","Eden 002C","E01019322","Total",1384,186,109,77,1198,35,212,287,282,40,146,196
"2011","Eden 002D","E01019338","Total",1497,129,72,57,1368,29,226,314,268,60,167,304
"2011","Eden 003A","E01019327","Total",1336,267,131,136,1069,125,168,270,226,15,95,170
"2011","Eden 003B","E01019332","Total",1319,274,143,131,1045,60,198,286,220,56,52,173
"2011","Eden 003C","E01019333","Total",1078,227,93,134,851,92,106,207,186,18,71,171
"2011","Eden 003D","E01019335","Total",1515,217,65,152,1298,62,110,369,262,83,164,248
"2011","Eden 003E","E01019336","Total",1723,340,82,258,1383,104,114,336,352,83,85,309
"2011","Eden 004A","E01019312","Total",1396,171,89,82,1225,15,312,267,256,56,120,199
"2011","Eden 004B","E01019326","Total",1540,184,104,80,1356,71,282,323,300,33,133,214
"2011","Eden 004C","E01019328","Total",1276,147,76,71,1129,33,176,289,178,72,107,274
"2011","Eden 004D","E01019329","Total",1114,155,86,69,959,19,194,169,196,95,104,182
"2011","Eden 004E","E01019330","Total",1413,234,97,137,1179,54,150,299,286,61,98,231
"2011","Eden 004F","E01019331","Total",1526,178,88,90,1348,75,264,267,238,109,106,289
"2011","Eden 004G","E01019334","Total",1362,206,131,75,1156,40,266,279,190,74,126,181
"2011","Eden 005A","E01019308","Total",1403,166,77,89,1237,51,234,230,280,101,134,207
"2011","Eden 005B","E01019311","Total",1436,171,104,67,1265,19,278,307,262,52,123,224
"2011","Eden 005C","E01019313","Total",1370,200,114,86,1170,44,280,227,260,67,80,212
"2011","Eden 005D","E01019339","Total",1331,168,88,80,1163,42,280,242,228,47,89,235
"2011","Eden 006A","E01019306","Total",1264,267,143,124,997,34,270,230,212,52,86,113
"2011","Eden 006B","E01019307","Total",1716,230,95,135,1486,72,284,385,284,68,182,211
"2011","Eden 006C","E01019310","Total",1338,151,73,78,1187,37,206,241,260,94,115,234
"2011","Eden 006D","E01019319","Total",1549,162,72,90,1387,76,192,304,282,107,177,249
"2011","Eden 006E","E01019323","Total",1200,149,78,71,1051,38,214,217,228,95,65,194
"2011","Eden 006F","E01019324","Total",1300,123,55,68,1177,52,208,269,196,92,84,276
"2011","Eden 006G","E01019337","Total",1387,209,102,107,1178,43,194,286,212,68,116,259
"2011","Eden 007A","E01019309","Total",2291,256,114,142,2035,49,378,471,410,134,195,398
"2011","Eden 007B","E01019317","Total",1273,147,73,74,1126,13,254,239,200,96,84,240
"2011","Eden 007C","E01019318","Total",1255,233,125,108,1022,104,188,227,248,61,52,142
"2011","Eden 007D","E01019325","Total",1360,161,66,95,1199,48,180,298,252,68,97,256
"2011","Eden 007E","E01019340","Total",1344,138,74,64,1206,27,238,241,226,93,129,252
"2011","South Lakeland 001A","E01019374","Total",1488,278,127,151,1210,76,180,265,250,67,115,257
"2011","South Lakeland 001B","E01019375","Total",1286,290,186,104,996,20,320,128,246,31,85,166
"2011","South Lakeland 001C","E01019376","Total",1231,179,92,87,1052,23,254,184,250,44,90,207
"2011","South Lakeland 001D","E01019395","Total",1797,406,261,145,1391,53,378,256,322,36,107,239
"2011","South Lakeland 002A","E01019387","Total",2066,314,176,138,1752,55,368,422,372,59,209,267
"2011","South Lakeland 002B","E01019396","Total",2002,323,189,134,1679,74,366,356,308,85,155,335
"2011","South Lakeland 002C","E01019397","Total",1807,322,127,195,1485,92,326,322,378,76,109,182
"2011","South Lakeland 002D","E01019398","Total",1167,126,56,70,1041,89,112,266,204,75,118,177
"2011","South Lakeland 002E","E01019399","Total",1050,149,82,67,901,40,136,230,146,45,109,195
"2011","South Lakeland 003A","E01019346","Total",1907,232,116,116,1675,75,344,305,364,103,165,319
"2011","South Lakeland 003B","E01019359","Total",2056,341,151,190,1715,144,236,413,370,94,165,293
"2011","South Lakeland 003C","E01019365","Total",2198,346,126,220,1852,70,242,369,416,77,253,425
"2011","South Lakeland 003D","E01019370","Total",2212,402,154,248,1810,84,240,557,458,108,127,236
"2011","South Lakeland 004A","E01019360","Total",2003,470,154,316,1533,65,206,321,520,54,131,236
"2011","South Lakeland 004B","E01019363","Total",1859,445,154,291,1414,91,170,345,322,82,149,255
"2011","South Lakeland 004C","E01019364","Total",1906,312,123,189,1594,136,130,432,280,146,191,279
"2011","South Lakeland 004D","E01019371","Total",2188,281,101,180,1907,174,208,497,362,134,190,342
"2011","South Lakeland 005A","E01019358","Total",1803,196,118,78,1607,73,302,397,354,68,140,273
"2011","South Lakeland 005B","E01019362","Total",1966,281,164,117,1685,41,344,466,328,76,143,287
"2011","South Lakeland 005C","E01019366","Total",1783,225,145,80,1558,51,268,391,306,98,123,321
"2011","South Lakeland 005D","E01019394","Total",2313,188,76,112,2125,33,336,395,470,198,278,415
"2011","South Lakeland 006A","E01019361","Total",1805,222,112,110,1583,47,290,399,324,77,178,268
"2011","South Lakeland 006B","E01019367","Total",2444,362,141,221,2082,94,268,629,422,143,169,357
"2011","South Lakeland 006C","E01019368","Total",2110,190,92,98,1920,61,234,560,332,107,252,374
"2011","South Lakeland 006D","E01019369","Total",1829,292,176,116,1537,37,356,339,304,56,122,323
"2011","South Lakeland 007A","E01019356","Total",1381,241,123,118,1140,24,280,194,294,52,106,190
"2011","South Lakeland 007B","E01019381","Total",2066,239,101,138,1827,51,394,371,420,118,147,326
"2011","South Lakeland 007C","E01019386","Total",1673,248,128,120,1425,50,340,235,342,70,110,278
"2011","South Lakeland 008A","E01019344","Total",1031,129,69,60,902,32,166,203,214,25,57,205
"2011","South Lakeland 008B","E01019345","Total",1174,154,87,67,1020,9,214,196,226,76,94,205
"2011","South Lakeland 008C","E01019350","Total",1577,218,118,100,1359,48,324,220,312,30,114,311
"2011","South Lakeland 008D","E01019351","Total",1753,184,89,95,1569,46,296,252,378,62,222,313
"2011","South Lakeland 009A","E01019372","Total",1004,275,141,134,729,30,182,168,168,25,63,93
"2011","South Lakeland 009B","E01019373","Total",1200,145,68,77,1055,36,240,241,236,40,79,183
"2011","South Lakeland 009C","E01019384","Total",2151,266,148,118,1885,36,452,358,442,93,207,297
"2011","South Lakeland 009D","E01019385","Total",1138,261,124,137,877,39,168,227,204,50,48,141
"2011","South Lakeland 010A","E01019348","Total",1225,114,74,40,1111,19,244,295,208,61,132,152
"2011","South Lakeland 010B","E01019352","Total",2208,178,81,97,2030,50,352,405,424,120,232,447
"2011","South Lakeland 010C","E01019377","Total",1728,234,122,112,1494,39,436,284,296,96,102,241
"2011","South Lakeland 010D","E01019383","Total",1964,237,144,93,1727,17,472,325,338,95,178,302
"2011","South Lakeland 011A","E01019341","Total",1523,201,131,70,1322,9,518,204,316,20,77,178
"2011","South Lakeland 011B","E01019342","Total",1020,205,147,58,815,26,248,131,126,59,85,140
"2011","South Lakeland 011C","E01019343","Total",1433,191,116,75,1242,22,360,201,268,57,107,227
"2011","South Lakeland 011D","E01019347","Total",1755,229,101,128,1526,79,236,389,346,87,148,241
"2011","South Lakeland 011E","E01019382","Total",2085,319,149,170,1766,128,308,436,316,109,186,283
"2011","South Lakeland 012A","E01019388","Total",1749,237,120,117,1512,95,266,319,252,68,172,340
"2011","South Lakeland 012B","E01019389","Total",2268,294,81,213,1974,187,234,530,434,95,176,318
"2011","South Lakeland 012C","E01019390","Total",1995,367,161,206,1628,71,286,438,356,85,131,261
"2011","South Lakeland 012D","E01019392","Total",1832,527,230,297,1305,96,164,291,330,75,88,261
"2011","South Lakeland 013A","E01019349","Total",1769,242,141,101,1527,41,388,317,312,46,109,314
"2011","South Lakeland 013B","E01019353","Total",1494,222,142,80,1272,54,322,234,214,80,120,248
"2011","South Lakeland 013C","E01019354","Total",1277,377,246,131,900,5,322,119,200,43,72,139
"2011","South Lakeland 013D","E01019355","Total",1230,220,162,58,1010,10,516,94,204,15,71,100
"2011","South Lakeland 013E","E01019357","Total",1843,246,139,107,1597,61,322,340,330,53,171,320
"2011","South Lakeland 014A","E01019378","Total",1601,182,96,86,1419,46,226,372,296,30,177,272
"2011","South Lakeland 014B","E01019379","Total",1369,186,106,80,1183,26,304,224,230,53,114,232
"2011","South Lakeland 014C","E01019380","Total",1074,110,51,59,964,30,206,215,230,41,73,169
"2011","South Lakeland 014D","E01019391","Total",1717,190,105,85,1527,56,296,377,288,97,108,305
"2011","South Lakeland 014E","E01019393","Total",1931,251,160,91,1680,17,478,315,374,67,113,316
"2011","Bolton 001A","E01004768","Total",1601,100,48,52,1501,41,204,465,244,51,170,326
"2011","Bolton 001B","E01004803","Total",1635,180,68,112,1455,55,256,384,318,61,173,208
"2011","Bolton 001C","E01004804","Total",1452,119,59,60,1333,26,238,374,246,25,124,300
"2011","Bolton 001D","E01004807","Total",1446,93,17,76,1353,69,110,381,246,77,188,282
"2011","Bolton 001E","E01004808","Total",1643,174,73,101,1469,60,208,378,280,67,137,339
"2011","Bolton 002A","E01004788","Total",1392,155,104,51,1237,28,276,306,228,61,95,243
"2011","Bolton 002B","E01004790","Total",1432,189,105,84,1243,87,224,249,242,68,112,261
"2011","Bolton 002C","E01004805","Total",1633,151,90,61,1482,52,266,351,258,69,169,317
"2011","Bolton 002D","E01004806","Total",1515,181,122,59,1334,43,308,309,172,59,191,252
"2011","Bolton 002E","E01004810","Total",1594,117,50,67,1477,52,178,433,264,76,186,288
"2011","Bolton 003A","E01004769","Total",1534,223,92,131,1311,49,180,328,270,63,165,256
"2011","Bolton 003B","E01004770","Total",1465,147,103,44,1318,34,286,327,208,81,144,238
"2011","Bolton 003C","E01004771","Total",1641,113,67,46,1528,47,266,392,256,126,175,266
"2011","Bolton 003D","E01004773","Total",1942,312,94,218,1630,113,126,371,330,133,209,348
"2011","Bolton 003E","E01004809","Total",1763,375,146,229,1388,147,206,315,340,47,115,218
"2011","Bolton 004A","E01004777","Total",1533,241,87,154,1292,138,154,335,290,68,146,161
"2011","Bolton 004B","E01004881","Total",1362,367,197,170,995,104,174,257,228,36,63,133
"2011","Bolton 004C","E01004888","Total",1322,152,47,105,1170,51,114,344,212,62,119,268
"2011","Bolton 004D","E01004889","Total",1433,183,88,95,1250,109,160,304,192,94,160,231
"2011","Bolton 004E","E01004890","Total",1402,244,82,162,1158,79,178,249,282,41,127,202
"2011","Bolton 005A","E01004766","Total",1592,350,160,190,1242,108,180,258,244,49,181,222
"2011","Bolton 005B","E01004767","Total",1675,286,111,175,1389,73,194,282,286,74,217,263
"2011","Bolton 005C","E01004772","Total",1731,263,87,176,1468,185,88,356,208,141,236,254
"2011","Bolton 005D","E01004774","Total",1667,232,79,153,1435,132,110,301,252,93,242,305
"2011","Bolton 005E","E01004824","Total",1706,107,29,78,1599,51,42,227,104,281,579,315
"2011","Bolton 006A","E01004784","Total",1261,98,63,35,1163,26,216,290,194,56,107,274
"2011","Bolton 006B","E01004785","Total",1423,190,97,93,1233,101,226,257,244,75,91,239
"2011","Bolton 006C","E01004786","Total",1453,193,119,74,1260,74,234,337,224,26,92,273
"2011","Bolton 006D","E01004789","Total",1406,135,88,47,1271,22,258,298,216,61,134,282
"2011","Bolton 006E","E01004791","Total",1234,247,150,97,987,34,202,255,164,44,86,202
"2011","Bolton 006F","E01004792","Total",1465,146,92,54,1319,24,346,287,244,69,89,260
"2011","Bolton 007A","E01004779","Total",1557,119,39,80,1438,92,86,376,272,140,209,263
"2011","Bolton 007B","E01004781","Total",1816,211,62,149,1605,85,138,534,394,45,136,273
"2011","Bolton 007C","E01004882","Total",1362,180,102,78,1182,60,118,308,244,62,143,247
"2011","Bolton 007D","E01004883","Total",1431,176,70,106,1255,63,120,306,322,72,145,227
"2011","Bolton 007E","E01004884","Total",1470,188,96,92,1282,14,326,271,312,54,87,218
"2011","Bolton 008A","E01004864","Total",1550,235,96,139,1315,86,144,291,274,74,169,277
"2011","Bolton 008B","E01004867","Total",1517,204,56,148,1313,126,104,336,196,142,177,232
"2011","Bolton 008C","E01004921","Total",1561,260,119,141,1301,78,212,328,280,56,83,264
"2011","Bolton 008D","E01004924","Total",1538,122,67,55,1416,39,198,331,260,79,214,295
"2011","Bolton 008E","E01004925","Total",1496,193,104,89,1303,45,182,285,242,75,183,291
"2011","Bolton 009A","E01004778","Total",1159,146,75,71,1013,51,226,178,176,26,128,228
"2011","Bolton 009B","E01004780","Total",1970,245,90,155,1725,100,208,487,416,64,152,298
"2011","Bolton 009C","E01004782","Total",1118,150,86,64,968,46,146,226,212,64,101,173
"2011","Bolton 009D","E01004783","Total",1490,165,84,81,1325,54,214,285,268,35,179,290
"2011","Bolton 010A","E01004802","Total",1809,262,98,164,1547,229,108,390,182,140,231,267
"2011","Bolton 010B","E01004926","Total",1302,157,63,94,1145,158,66,224,132,95,254,216
"2011","Bolton 010C","E01004927","Total",2056,438,128,310,1618,227,116,375,358,96,205,241
"2011","Bolton 010D","E01004929","Total",1975,307,118,189,1668,137,136,370,316,181,200,328
"2011","Bolton 011A","E01004820","Total",1601,266,81,185,1335,144,76,252,144,148,385,186
"2011","Bolton 011B","E01004825","Total",1641,262,61,201,1379,94,52,247,132,278,332,244
"2011","Bolton 011C","E01004826","Total",1586,213,52,161,1373,181,84,288,174,180,263,203
"2011","Bolton 011D","E01004865","Total",1345,298,126,172,1047,85,106,250,208,82,155,161
"2011","Bolton 011E","E01004866","Total",1741,353,140,213,1388,184,98,270,196,172,277,191
"2011","Bolton 012A","E01004840","Total",1624,199,95,104,1425,106,216,284,294,96,153,276
"2011","Bolton 012B","E01004841","Total",1720,222,76,146,1498,183,84,361,156,240,253,221
"2011","Bolton 012C","E01004842","Total",1702,224,153,71,1478,42,246,348,240,139,168,295
"2011","Bolton 012D","E01004919","Total",1505,188,95,93,1317,80,232,306,214,73,128,284
"2011","Bolton 012E","E01004920","Total",1557,189,102,87,1368,105,208,246,242,151,169,247
"2011","Bolton 013A","E01004787","Total",1608,346,92,254,1262,244,92,280,212,130,136,168
"2011","Bolton 013B","E01004793","Total",1542,224,86,138,1318,148,148,253,210,144,195,220
"2011","Bolton 013C","E01004794","Total",1775,164,61,103,1611,250,126,361,220,210,231,213
"2011","Bolton 013D","E01004795","Total",1387,304,91,213,1083,95,170,248,210,75,83,202
"2011","Bolton 013E","E01004797","Total",1371,126,61,65,1245,181,72,249,162,154,186,241
"2011","Bolton 014A","E01004775","Total",1424,152,71,81,1272,45,226,270,280,62,161,228
"2011","Bolton 014B","E01004885","Total",1366,97,59,38,1269,33,188,344,206,62,163,273
"2011","Bolton 014C","E01004886","Total",1381,219,101,118,1162,114,112,278,188,62,204,204
"2011","Bolton 014D","E01004887","Total",1415,198,78,120,1217,75,162,237,218,94,177,254
"2011","Bolton 015A","E01004868","Total",1679,241,60,181,1438,113,76,300,272,126,301,250
"2011","Bolton 015B","E01004869","Total",1674,401,135,266,1273,173,102,342,246,83,148,179
"2011","Bolton 015C","E01004870","Total",1834,391,102,289,1443,74,114,163,188,149,439,316
"2011","Bolton 015D","E01004871","Total",1629,162,40,122,1467,120,72,220,152,208,447,248
"2011","Bolton 015E","E01004922","Total",1742,280,98,182,1462,202,114,329,266,87,204,260
"2011","Bolton 016B","E01004822","Total",1679,252,86,166,1427,111,90,206,92,229,416,283
"2011","Bolton 016C","E01004823","Total",1718,409,136,273,1309,166,134,209,198,131,215,256
"2011","Bolton 016D","E01004848","Total",1366,381,148,233,985,113,116,198,178,114,106,160
"2011","Bolton 016E","E01033217","Total",1034,400,114,286,634,65,74,108,248,27,31,81
"2011","Bolton 016F","E01033220","Total",1294,467,82,385,827,99,44,156,196,96,96,140
"2011","Bolton 017A","E01004818","Total",1536,345,76,269,1191,81,92,215,204,104,215,280
"2011","Bolton 017B","E01004819","Total",1298,220,76,144,1078,79,170,179,198,62,137,253
"2011","Bolton 017C","E01004928","Total",1404,274,98,176,1130,173,112,261,246,43,103,192
"2011","Bolton 017D","E01004930","Total",1517,168,89,79,1349,63,246,294,204,36,179,327
"2011","Bolton 017E","E01004931","Total",1584,314,160,154,1270,116,198,334,224,63,131,204
"2011","Bolton 017F","E01004932","Total",1534,243,64,179,1291,116,106,332,330,50,128,229
"2011","Bolton 018A","E01004834","Total",1476,190,62,128,1286,93,74,244,204,146,317,208
"2011","Bolton 018B","E01004838","Total",1640,206,66,140,1434,193,90,292,186,166,246,261
"2011","Bolton 018C","E01004843","Total",1495,173,91,82,1322,44,190,381,210,62,152,283
"2011","Bolton 018D","E01004845","Total",1714,175,68,107,1539,82,186,328,298,86,258,301
"2011","Bolton 018E","E01004923","Total",1578,207,44,163,1371,104,100,262,276,103,245,281
"2011","Bolton 019A","E01004796","Total",1494,183,61,122,1311,61,170,311,250,94,147,278
"2011","Bolton 019B","E01004798","Total",1652,202,87,115,1450,182,142,332,224,82,199,289
"2011","Bolton 019C","E01004799","Total",1317,160,93,67,1157,40,242,226,262,38,108,241
"2011","Bolton 019D","E01004800","Total",1303,101,40,61,1202,50,112,252,286,63,140,299
"2011","Bolton 019E","E01004801","Total",1635,208,53,155,1427,304,94,281,218,120,167,243
"2011","Bolton 019F","E01004917","Total",2044,236,68,168,1808,177,160,520,364,106,150,331
"2011","Bolton 020A","E01004835","Total",1488,135,61,74,1353,34,244,219,164,95,253,344
"2011","Bolton 020B","E01004836","Total",1463,155,92,63,1308,27,276,261,162,66,229,287
"2011","Bolton 020C","E01004837","Total",1632,103,63,40,1529,21,236,289,202,128,279,374
"2011","Bolton 020D","E01004844","Total",1581,100,58,42,1481,16,274,309,246,78,216,342
"2011","Bolton 020E","E01004897","Total",1085,124,48,76,961,40,166,267,194,32,75,187
"2011","Bolton 021A","E01004827","Total",1615,281,95,186,1334,154,100,296,146,192,235,211
"2011","Bolton 021B","E01004849","Total",1731,155,39,116,1576,64,74,209,124,246,537,322
"2011","Bolton 021C","E01004850","Total",1743,345,59,286,1398,145,80,258,200,182,284,249
"2011","Bolton 021D","E01004851","Total",1552,316,137,179,1236,73,120,134,142,190,313,264
"2011","Bolton 021E","E01004853","Total",1599,145,49,96,1454,129,48,276,98,285,357,261
"2011","Bolton 022A","E01004811","Total",1557,251,72,179,1306,133,60,241,200,199,322,151
"2011","Bolton 022B","E01004812","Total",1848,177,31,146,1671,103,60,260,202,253,487,306
"2011","Bolton 022C","E01004813","Total",1357,171,46,125,1186,110,108,204,138,98,232,296
"2011","Bolton 022D","E01004815","Total",1578,181,77,104,1397,118,122,262,160,193,279,263
"2011","Bolton 022E","E01004817","Total",1520,345,101,244,1175,75,132,240,270,87,151,220
"2011","Bolton 023A","E01004828","Total",1800,202,65,137,1598,161,96,312,176,265,359,229
"2011","Bolton 023B","E01004829","Total",1371,167,51,116,1204,98,44,192,158,157,309,246
"2011","Bolton 023C","E01004832","Total",1532,187,64,123,1345,141,118,428,222,65,126,245
"2011","Bolton 023D","E01004854","Total",1507,101,30,71,1406,62,54,277,100,200,395,318
"2011","Bolton 023E","E01004878","Total",1475,140,52,88,1335,64,144,211,150,192,277,297
"2011","Bolton 024A","E01004911","Total",1566,307,104,203,1259,102,156,299,216,79,160,247
"2011","Bolton 024B","E01004912","Total",1448,138,76,62,1310,75,270,226,316,30,112,281
"2011","Bolton 024C","E01004913","Total",1960,206,66,140,1754,155,120,510,268,158,246,297
"2011","Bolton 024D","E01004914","Total",1194,112,79,33,1082,51,274,192,186,62,96,221
"2011","Bolton 024E","E01004915","Total",1330,103,56,47,1227,56,180,235,238,31,150,337
"2011","Bolton 024F","E01004916","Total",1460,237,122,115,1223,145,146,248,226,95,125,238
"2011","Bolton 024G","E01004918","Total",1303,117,61,56,1186,55,160,225,204,61,184,297
"2011","Bolton 025A","E01004846","Total",1272,176,72,104,1096,95,76,249,158,163,179,176
"2011","Bolton 025B","E01004847","Total",1931,142,30,112,1789,177,72,424,174,284,435,223
"2011","Bolton 025C","E01004852","Total",1612,95,37,58,1517,60,76,195,126,293,457,310
"2011","Bolton 025D","E01004877","Total",1792,259,118,141,1533,154,112,290,104,253,385,235
"2011","Bolton 025E","E01004879","Total",1460,148,49,99,1312,117,90,315,132,204,281,173
"2011","Bolton 026A","E01004830","Total",1551,320,133,187,1231,129,134,302,190,100,116,260
"2011","Bolton 026B","E01004831","Total",1630,175,86,89,1455,72,156,372,230,102,218,305
"2011","Bolton 026C","E01004833","Total",1530,158,89,69,1372,71,214,327,242,52,200,266
"2011","Bolton 026D","E01004839","Total",1973,441,185,256,1532,186,174,327,226,154,241,224
"2011","Bolton 027A","E01004814","Total",1456,202,45,157,1254,114,84,261,178,124,287,206
"2011","Bolton 027B","E01004855","Total",1483,174,55,119,1309,147,112,247,228,97,218,260
"2011","Bolton 027C","E01004856","Total",1422,246,89,157,1176,131,88,293,214,94,179,177
"2011","Bolton 027D","E01004857","Total",1506,236,54,182,1270,133,90,232,214,143,234,224
"2011","Bolton 028A","E01004891","Total",1592,289,162,127,1303,42,228,262,258,63,162,288
"2011","Bolton 028B","E01004893","Total",1532,99,49,50,1433,34,188,338,260,84,154,375
"2011","Bolton 028C","E01004894","Total",1840,244,111,133,1596,113,158,354,338,128,157,348
"2011","Bolton 028E","E01004901","Total",1812,153,53,100,1659,45,180,401,362,66,203,402
"2011","Bolton 028F","E01033218","Total",1581,151,16,135,1430,83,80,579,340,88,105,155
"2011","Bolton 028G","E01033219","Total",1496,108,55,53,1388,81,196,330,254,76,178,273
"2011","Bolton 029A","E01004816","Total",1588,112,67,45,1476,68,136,137,114,262,429,330
"2011","Bolton 029B","E01004872","Total",1560,174,61,113,1386,127,116,267,208,123,263,282
"2011","Bolton 029C","E01004873","Total",1762,154,69,85,1608,181,82,266,204,231,334,310
"2011","Bolton 029D","E01004875","Total",1590,165,94,71,1425,91,218,330,214,97,159,316
"2011","Bolton 029E","E01004880","Total",1324,106,62,44,1218,52,150,253,222,60,250,231
"2011","Bolton 030A","E01004892","Total",1531,201,141,60,1330,45,336,268,208,71,130,272
"2011","Bolton 030B","E01004896","Total",1321,107,72,35,1214,19,342,203,194,63,160,233
"2011","Bolton 030C","E01004899","Total",1539,162,58,104,1377,55,172,398,218,90,168,276
"2011","Bolton 030D","E01004900","Total",1599,152,30,122,1447,90,78,480,286,83,227,203
"2011","Bolton 031A","E01004776","Total",1802,244,89,155,1558,125,146,425,346,75,139,302
"2011","Bolton 031B","E01004895","Total",1325,194,92,102,1131,65,116,272,226,82,134,236
"2011","Bolton 031C","E01004936","Total",2029,310,88,222,1719,101,178,470,490,71,133,276
"2011","Bolton 031D","E01004938","Total",1493,221,116,105,1272,169,108,266,172,101,198,258
"2011","Bolton 031E","E01004939","Total",1519,227,59,168,1292,114,162,303,264,52,156,241
"2011","Bolton 032A","E01004858","Total",1580,319,123,196,1261,98,122,304,252,91,168,226
"2011","Bolton 032B","E01004859","Total",1345,365,152,213,980,113,118,212,180,80,118,159
"2011","Bolton 032C","E01004860","Total",1487,233,97,136,1254,150,170,244,252,42,125,271
"2011","Bolton 032D","E01004902","Total",1679,308,100,208,1371,102,202,303,308,114,135,207
"2011","Bolton 032E","E01004906","Total",1652,357,147,210,1295,128,142,279,232,119,133,262
"2011","Bolton 033A","E01004861","Total",1663,157,42,115,1506,219,80,359,176,151,245,276
"2011","Bolton 033B","E01004862","Total",1374,250,100,150,1124,188,70,260,170,111,165,160
"2011","Bolton 033C","E01004863","Total",1536,223,69,154,1313,143,88,283,204,72,279,244
"2011","Bolton 033D","E01004874","Total",1782,158,71,87,1624,198,162,342,206,146,265,305
"2011","Bolton 033E","E01004876","Total",1866,252,79,173,1614,180,186,382,258,100,254,254
"2011","Bolton 034A","E01004903","Total",1470,120,44,76,1350,86,110,430,236,83,153,252
"2011","Bolton 034B","E01004904","Total",1623,200,63,137,1423,131,126,489,270,47,153,207
"2011","Bolton 034C","E01004905","Total",1601,207,75,132,1394,127,118,280,266,128,154,321
"2011","Bolton 034D","E01004907","Total",1301,158,57,101,1143,134,86,275,186,62,209,191
"2011","Bolton 034E","E01004908","Total",1347,151,93,58,1196,71,246,290,164,52,164,209
"2011","Bolton 034F","E01004909","Total",1411,226,112,114,1185,125,168,285,170,73,162,202
"2011","Bolton 034G","E01004910","Total",2096,341,63,278,1755,145,140,425,436,88,179,342
"2011","Bolton 035A","E01004933","Total",1329,170,31,139,1159,76,80,318,244,77,82,282
"2011","Bolton 035B","E01004934","Total",1517,105,18,87,1412,134,76,384,230,120,180,288
"2011","Bolton 035C","E01004935","Total",1770,157,55,102,1613,94,138,507,310,88,222,254
"2011","Bolton 035D","E01004937","Total",1524,87,21,66,1437,47,126,395,214,41,282,332
"2011","Bolton 035E","E01004940","Total",1463,147,76,71,1316,71,164,294,304,101,120,262
"2011","Bury 001A","E01005014","Total",1462,290,100,190,1172,106,194,210,330,37,94,201
"2011","Bury 001B","E01005015","Total",1520,229,103,126,1291,119,130,279,312,103,123,225
"2011","Bury 001C","E01005016","Total",1517,253,81,172,1264,67,134,326,344,78,88,227
"2011","Bury 001D","E01005017","Total",1733,190,71,119,1543,82,152,507,258,112,198,234
"2011","Bury 001E","E01005018","Total",1503,261,81,180,1242,100,138,382,288,50,127,157
"2011","Bury 001F","E01005021","Total",997,90,48,42,907,15,158,226,168,57,86,197
"2011","Bury 002A","E01005019","Total",1502,148,86,62,1354,88,214,323,234,88,141,266
"2011","Bury 002B","E01005023","Total",1277,170,108,62,1107,48,184,211,184,89,149,242
"2011","Bury 002C","E01005046","Total",1435,175,118,57,1260,29,346,277,196,68,132,212
"2011","Bury 002D","E01005048","Total",1687,115,62,53,1572,24,310,333,266,98,139,402
"2011","Bury 003A","E01005020","Total",1465,56,16,40,1409,51,76,445,222,87,174,354
"2011","Bury 003B","E01005022","Total",1594,141,43,98,1453,87,148,382,292,67,195,282
"2011","Bury 003C","E01005047","Total",1387,114,69,45,1273,42,220,273,258,76,142,262
"2011","Bury 003D","E01005049","Total",1690,197,85,112,1493,87,216,381,320,83,128,278
"2011","Bury 003E","E01005051","Total",1502,199,93,106,1303,87,134,390,270,72,129,221
"2011","Bury 004A","E01004976","Total",1547,197,83,114,1350,127,180,200,182,124,202,335
"2011","Bury 004B","E01004977","Total",1619,290,149,141,1329,84,198,286,280,80,121,280
"2011","Bury 004C","E01004978","Total",1661,183,71,112,1478,91,128,295,256,160,273,275
"2011","Bury 004D","E01004981","Total",1417,197,104,93,1220,50,230,281,232,89,133,205
"2011","Bury 004E","E01004982","Total",1449,166,76,90,1283,36,276,291,250,74,119,237
"2011","Bury 005A","E01004961","Total",1545,174,74,100,1371,160,140,289,240,103,156,283
"2011","Bury 005B","E01004965","Total",1225,94,47,47,1131,21,196,237,192,72,163,250
"2011","Bury 005C","E01004966","Total",1771,185,61,124,1586,210,170,380,220,116,211,279
"2011","Bury 005D","E01004967","Total",1284,72,37,35,1212,23,170,256,192,72,212,287
"2011","Bury 006A","E01004963","Total",1472,206,98,108,1266,69,232,294,244,41,101,285
"2011","Bury 006B","E01004968","Total",1553,122,63,59,1431,50,224,389,272,81,178,237
"2011","Bury 006C","E01005050","Total",2041,200,85,115,1841,143,138,603,308,151,183,315
"2011","Bury 006D","E01005052","Total",1464,113,51,62,1351,62,196,336,226,36,179,316
"2011","Bury 006E","E01005053","Total",1502,172,63,109,1330,113,148,360,272,63,123,251
"2011","Bury 007A","E01004954","Total",1417,224,112,112,1193,56,224,236,240,105,69,263
"2011","Bury 007B","E01004955","Total",1333,164,51,113,1169,133,98,254,204,95,169,216
"2011","Bury 007C","E01004956","Total",1498,270,105,165,1228,115,142,317,224,81,151,198
"2011","Bury 007D","E01004957","Total",1748,317,98,219,1431,259,104,302,264,78,155,269
"2011","Bury 007E","E01004960","Total",1499,226,53,173,1273,286,44,312,172,146,159,154
"2011","Bury 008A","E01004958","Total",1375,276,81,195,1099,122,88,215,248,87,120,219
"2011","Bury 008B","E01004959","Total",1658,255,65,190,1403,164,118,307,250,124,186,254
"2011","Bury 008C","E01004979","Total",1505,241,60,181,1264,113,62,260,204,185,219,221
"2011","Bury 008D","E01004980","Total",1286,249,65,184,1037,108,38,239,244,73,105,230
"2011","Bury 008E","E01005024","Total",1403,170,61,109,1233,127,54,235,136,181,330,170
"2011","Bury 008F","E01005026","Total",1612,134,42,92,1478,89,70,282,188,233,343,273
"2011","Bury 009A","E01004947","Total",1396,255,59,196,1141,126,90,299,224,35,147,220
"2011","Bury 009B","E01004948","Total",1723,377,125,252,1346,148,148,349,224,92,137,248
"2011","Bury 009C","E01004962","Total",1651,203,61,142,1448,127,116,434,336,73,119,243
"2011","Bury 009D","E01004964","Total",1782,298,75,223,1484,151,116,376,374,86,147,234
"2011","Bury 010A","E01004949","Total",1470,117,70,47,1353,42,284,391,202,61,135,238
"2011","Bury 010B","E01004950","Total",1510,122,77,45,1388,39,284,335,218,75,151,286
"2011","Bury 010C","E01004951","Total",1537,152,100,52,1385,39,294,295,252,56,164,285
"2011","Bury 010D","E01004952","Total",1379,143,98,45,1236,17,396,174,210,36,104,299
"2011","Bury 010E","E01004953","Total",1492,175,114,61,1317,53,166,319,242,75,180,282
"2011","Bury 011A","E01005025","Total",1479,248,98,150,1231,56,130,261,278,79,102,325
"2011","Bury 011B","E01005027","Total",1734,285,82,203,1449,81,80,240,278,121,383,266
"2011","Bury 011C","E01005028","Total",1863,310,107,203,1553,164,110,376,270,170,261,202
"2011","Bury 011D","E01005029","Total",1822,176,74,102,1646,106,132,291,230,203,412,272
"2011","Bury 012A","E01005000","Total",1527,108,42,66,1419,93,118,403,220,66,184,335
"2011","Bury 012B","E01005001","Total",1339,60,11,49,1279,64,72,365,266,56,168,288
"2011","Bury 012C","E01005005","Total",1373,203,105,98,1170,61,214,304,232,59,78,222
"2011","Bury 012D","E01005006","Total",1519,174,96,78,1345,89,202,256,254,78,128,338
"2011","Bury 013A","E01005030","Total",1590,307,94,213,1283,129,148,248,234,105,212,207
"2011","Bury 013B","E01005054","Total",1498,176,63,113,1322,56,182,328,232,60,123,341
"2011","Bury 013C","E01005059","Total",1707,256,90,166,1451,91,140,326,294,115,219,266
"2011","Bury 013D","E01005060","Total",1668,225,92,133,1443,100,230,341,266,85,187,234
"2011","Bury 014A","E01004997","Total",1482,148,58,90,1334,111,136,326,222,71,204,264
"2011","Bury 014B","E01004998","Total",1431,180,108,72,1251,76,250,232,258,83,115,237
"2011","Bury 014C","E01004999","Total",1480,142,54,88,1338,90,122,363,274,70,213,206
"2011","Bury 014D","E01005002","Total",1590,142,73,69,1448,87,174,318,270,77,203,319
"2011","Bury 014E","E01005003","Total",1462,232,86,146,1230,106,124,338,232,103,127,200
"2011","Bury 015A","E01004991","Total",1414,149,45,104,1265,131,162,312,208,46,224,182
"2011","Bury 015B","E01004992","Total",1476,207,58,149,1269,111,104,320,256,120,133,225
"2011","Bury 015C","E01004993","Total",1411,154,66,88,1257,99,104,322,174,110,207,241
"2011","Bury 015D","E01004994","Total",1302,249,63,186,1053,143,54,289,238,84,90,155
"2011","Bury 016A","E01004990","Total",1515,204,92,112,1311,100,110,266,224,140,198,273
"2011","Bury 016B","E01004996","Total",1427,324,75,249,1103,150,136,285,234,56,81,161
"2011","Bury 016C","E01005004","Total",1458,502,194,308,956,97,150,227,180,66,78,158
"2011","Bury 016D","E01005008","Total",1855,343,86,257,1512,232,92,391,342,95,160,200
"2011","Bury 016E","E01005009","Total",1481,335,62,273,1146,147,84,238,290,87,159,141
"2011","Bury 017A","E01004945","Total",1548,164,110,54,1384,42,308,307,194,89,148,296
"2011","Bury 017B","E01005055","Total",1493,122,82,40,1371,30,218,293,208,141,133,348
"2011","Bury 017C","E01005056","Total",1256,221,111,110,1035,36,244,171,190,59,80,255
"2011","Bury 017D","E01005057","Total",1560,168,68,100,1392,127,126,465,198,66,148,262
"2011","Bury 017E","E01005058","Total",1333,104,73,31,1229,16,218,292,120,80,171,332
"2011","Bury 018A","E01004995","Total",1543,134,75,59,1409,53,254,268,300,67,187,280
"2011","Bury 018B","E01005010","Total",1621,153,48,105,1468,107,116,447,310,82,138,268
"2011","Bury 018C","E01005012","Total",1711,267,71,196,1444,177,116,324,264,91,253,219
"2011","Bury 018D","E01005013","Total",2377,283,73,210,2094,270,98,589,320,214,269,334
"2011","Bury 019A","E01004984","Total",1367,177,108,69,1190,18,222,300,144,117,165,224
"2011","Bury 019B","E01004985","Total",1439,114,70,44,1325,27,254,301,208,63,162,310
"2011","Bury 019C","E01004989","Total",1427,140,62,78,1287,46,166,284,212,93,211,275
"2011","Bury 019D","E01005007","Total",1414,274,139,135,1140,60,232,250,248,21,109,220
"2011","Bury 019E","E01005011","Total",1385,172,80,92,1213,93,148,319,208,70,102,273
"2011","Bury 020A","E01004983","Total",1291,149,40,109,1142,55,90,274,250,53,159,261
"2011","Bury 020B","E01004986","Total",1638,318,138,180,1320,148,168,290,318,67,117,212
"2011","Bury 020C","E01004987","Total",1200,346,172,174,854,77,148,206,138,47,80,158
"2011","Bury 020D","E01004988","Total",1438,187,77,110,1251,98,168,254,284,91,143,213
"2011","Bury 021A","E01004941","Total",1783,222,95,127,1561,144,138,382,196,103,280,318
"2011","Bury 021B","E01004942","Total",1521,232,73,159,1289,221,102,301,158,152,196,159
"2011","Bury 021C","E01004943","Total",1631,169,53,116,1462,153,114,337,248,161,193,256
"2011","Bury 021D","E01004944","Total",1615,130,54,76,1485,75,172,450,244,63,159,322
"2011","Bury 021E","E01004946","Total",1624,365,163,202,1259,198,164,292,162,76,127,240
"2011","Bury 022A","E01004969","Total",1399,327,108,219,1072,52,148,218,218,66,144,226
"2011","Bury 022B","E01004970","Total",1572,130,76,54,1442,48,204,289,200,98,250,353
"2011","Bury 022C","E01004971","Total",1519,125,63,62,1394,45,224,280,208,109,187,341
"2011","Bury 022D","E01005034","Total",1397,226,97,129,1171,58,152,326,230,50,94,261
"2011","Bury 023A","E01004972","Total",1485,159,58,101,1326,142,92,289,174,135,208,286
"2011","Bury 023B","E01004973","Total",1524,198,77,121,1326,73,142,269,268,81,151,342
"2011","Bury 023C","E01004975","Total",1519,318,124,194,1201,108,94,323,328,44,86,218
"2011","Bury 023D","E01005039","Total",1486,274,124,150,1212,151,130,204,284,102,154,187
"2011","Bury 023E","E01005045","Total",1599,210,87,123,1389,112,124,336,276,90,187,264
"2011","Bury 024A","E01004974","Total",1422,183,83,100,1239,61,130,244,248,84,154,318
"2011","Bury 024B","E01005033","Total",1522,182,57,125,1340,56,174,263,200,194,197,256
"2011","Bury 024C","E01005036","Total",1816,565,193,372,1251,83,176,267,348,45,123,209
"2011","Bury 024D","E01005037","Total",1407,205,82,123,1202,66,160,267,228,63,140,278
"2011","Bury 025A","E01005031","Total",1463,198,71,127,1265,130,120,304,238,87,141,245
"2011","Bury 025B","E01005032","Total",1037,222,67,155,815,112,112,162,158,55,68,148
"2011","Bury 025C","E01005035","Total",1402,203,72,131,1199,75,128,354,270,52,114,206
"2011","Bury 025D","E01005038","Total",1347,113,47,66,1234,41,128,341,226,101,143,254
"2011","Bury 026A","E01005040","Total",1806,195,67,128,1611,56,132,402,246,161,274,340
"2011","Bury 026B","E01005041","Total",1609,99,56,43,1510,39,132,266,134,252,360,327
"2011","Bury 026C","E01005042","Total",1834,138,65,73,1696,54,160,325,148,416,295,298
"2011","Bury 026D","E01005043","Total",1872,70,43,27,1802,10,126,207,120,689,411,239
"2011","Bury 026E","E01005044","Total",1775,106,34,72,1669,32,56,179,86,823,290,203
"2011","Manchester 001A","E01005098","Total",1522,372,128,244,1150,185,138,179,208,86,166,188
"2011","Manchester 001B","E01005099","Total",1789,194,67,127,1595,381,118,337,170,104,213,272
"2011","Manchester 001C","E01005100","Total",1588,198,84,114,1390,176,146,223,220,150,163,312
"2011","Manchester 001D","E01005102","Total",1358,210,72,138,1148,117,140,262,226,48,86,269
"2011","Manchester 001E","E01005103","Total",1640,380,197,183,1260,197,156,253,220,58,137,239
"2011","Manchester 002A","E01005101","Total",1704,235,94,141,1469,195,116,327,220,94,217,300
"2011","Manchester 002B","E01005135","Total",1621,158,51,107,1463,229,114,257,166,118,257,322
"2011","Manchester 002C","E01005136","Total",1470,222,84,138,1248,92,130,190,200,88,165,383
"2011","Manchester 002D","E01005138","Total",1755,314,101,213,1441,328,100,268,148,176,148,273
"2011","Manchester 002E","E01005140","Total",2759,409,99,310,2350,296,156,496,378,224,295,505
"2011","Manchester 003B","E01005139","Total",1726,209,83,126,1517,175,130,351,244,110,201,306
"2011","Manchester 003C","E01005141","Total",1738,358,111,247,1380,196,114,274,170,116,198,312
"2011","Manchester 003D","E01005251","Total",1589,172,63,109,1417,211,98,317,182,92,242,275
"2011","Manchester 003E","E01005252","Total",1825,233,122,111,1592,161,178,303,238,135,233,344
"2011","Manchester 003F","E01033685","Total",1561,224,61,163,1337,169,66,390,200,89,200,223
"2011","Manchester 003G","E01033687","Total",1417,443,132,311,974,119,90,219,232,35,130,149
"2011","Manchester 004A","E01005104","Total",1789,356,75,281,1433,285,78,308,286,144,153,179
"2011","Manchester 004B","E01005160","Total",1769,256,103,153,1513,76,148,326,218,171,276,298
"2011","Manchester 004C","E01005161","Total",1554,196,53,143,1358,139,146,356,244,115,185,173
"2011","Manchester 004D","E01005162","Total",1694,274,127,147,1420,74,140,225,154,162,333,332
"2011","Manchester 004E","E01005163","Total",1649,221,90,131,1428,76,150,274,182,193,256,297
"2011","Manchester 005A","E01005247","Total",1438,211,91,120,1227,75,142,254,202,50,155,349
"2011","Manchester 005B","E01005248","Total",1369,144,59,85,1225,42,202,194,214,48,134,391
"2011","Manchester 005C","E01005249","Total",1759,280,74,206,1479,125,106,335,308,72,221,312
"2011","Manchester 005D","E01005250","Total",1771,215,90,125,1556,259,162,301,234,108,172,320
"2011","Manchester 005E","E01005253","Total",1585,165,87,78,1420,217,138,284,210,105,185,281
"2011","Manchester 005F","E01005254","Total",1598,195,71,124,1403,82,138,334,288,35,215,311
"2011","Manchester 006A","E01005164","Total",1565,313,58,255,1252,130,60,284,186,120,234,238
"2011","Manchester 006B","E01005205","Total",1978,396,158,238,1582,253,108,361,286,107,196,271
"2011","Manchester 006C","E01005206","Total",1614,279,68,211,1335,176,106,301,268,73,165,246
"2011","Manchester 006D","E01005207","Total",1915,255,70,185,1660,199,98,309,298,135,171,450
"2011","Manchester 007A","E01005223","Total",1234,198,48,150,1036,120,116,185,172,57,172,214
"2011","Manchester 007B","E01005224","Total",1819,204,50,154,1615,246,60,369,234,157,293,256
"2011","Manchester 007C","E01005225","Total",1842,304,123,181,1538,192,192,305,226,117,176,330
"2011","Manchester 007D","E01005226","Total",1568,218,63,155,1350,194,102,339,244,68,153,250
"2011","Manchester 007E","E01005229","Total",1512,136,80,56,1376,94,172,287,208,40,146,429
"2011","Manchester 008A","E01005145","Total",2660,166,31,135,2494,110,88,441,188,488,683,496
"2011","Manchester 008B","E01005146","Total",2335,254,74,180,2081,124,126,448,280,312,453,338
"2011","Manchester 008C","E01005149","Total",1739,72,22,50,1667,81,82,209,88,230,615,362
"2011","Manchester 008D","E01005165","Total",2055,511,149,362,1544,154,62,349,264,150,333,232
"2011","Manchester 008E","E01005166","Total",1842,292,97,195,1550,96,80,226,174,257,427,290
"2011","Manchester 008F","E01005167","Total",1957,119,26,93,1838,117,46,267,146,302,661,299
"2011","Manchester 009A","E01005202","Total",1758,292,60,232,1466,347,98,298,190,101,179,253
"2011","Manchester 009B","E01005203","Total",1896,454,109,345,1442,294,78,284,212,101,238,235
"2011","Manchester 009D","E01005227","Total",1665,235,80,155,1430,222,74,313,200,113,216,292
"2011","Manchester 009E","E01005228","Total",1691,313,97,216,1378,255,90,339,168,122,222,182
"2011","Manchester 009F","E01033678","Total",1574,291,52,239,1283,228,76,245,166,140,240,188
"2011","Manchester 009G","E01033679","Total",1366,319,87,232,1047,194,44,159,126,124,187,213
"2011","Manchester 011A","E01005256","Total",1947,279,80,199,1668,286,126,349,302,112,208,285
"2011","Manchester 011B","E01005257","Total",1798,324,86,238,1474,345,96,244,230,134,153,272
"2011","Manchester 011C","E01005258","Total",1636,323,113,210,1313,173,126,244,232,112,114,312
"2011","Manchester 011D","E01005259","Total",1602,327,85,242,1275,262,112,232,240,111,95,223
"2011","Manchester 011E","E01005260","Total",1451,175,61,114,1276,59,128,260,206,80,233,310
"2011","Manchester 012A","E01005093","Total",1685,199,79,120,1486,267,132,286,170,183,177,271
"2011","Manchester 012B","E01005094","Total",1463,253,101,152,1210,196,96,265,212,94,198,149
"2011","Manchester 012C","E01005097","Total",1731,180,59,121,1551,316,112,209,178,200,263,273
"2011","Manchester 012D","E01005255","Total",1609,419,116,303,1190,219,124,262,146,79,177,183
"2011","Manchester 012E","E01005261","Total",1631,200,75,125,1431,301,82,247,150,144,242,265
"2011","Manchester 013B","E01005129","Total",1461,340,71,269,1121,219,60,173,208,117,179,165
"2011","Manchester 013C","E01005132","Total",1480,244,69,175,1236,221,78,283,196,126,165,167
"2011","Manchester 013D","E01005133","Total",1207,248,91,157,959,112,80,102,250,32,110,273
"2011","Manchester 013E","E01033663","Total",1183,349,22,327,834,33,20,79,530,0,34,138
"2011","Manchester 013F","E01033684","Total",1203,166,0,166,1037,8,2,51,826,0,5,145
"2011","Manchester 013G","E01033688","Total",1494,302,89,213,1192,187,92,219,194,79,197,224
"2011","Manchester 015A","E01005092","Total",1612,280,108,172,1332,234,78,319,178,127,155,241
"2011","Manchester 015C","E01005105","Total",1947,246,42,204,1701,240,64,323,324,151,248,351
"2011","Manchester 015D","E01005106","Total",1877,331,92,239,1546,266,110,316,208,125,244,277
"2011","Manchester 015E","E01005107","Total",1803,264,68,196,1539,316,74,309,194,173,260,213
"2011","Manchester 015F","E01033668","Total",1136,245,21,224,891,103,22,201,398,15,59,93
"2011","Manchester 015G","E01033669","Total",1397,301,72,229,1096,159,76,218,212,79,154,198
"2011","Manchester 017A","E01005108","Total",2630,331,104,227,2299,517,138,337,274,279,360,394
"2011","Manchester 017D","E01005189","Total",1654,390,147,243,1264,233,130,246,188,89,134,244
"2011","Manchester 017E","E01005190","Total",2017,314,103,211,1703,290,126,379,248,144,222,294
"2011","Manchester 017F","E01033666","Total",2606,413,151,262,2193,222,188,388,288,228,359,520
"2011","Manchester 018A","E01005061","Total",1648,352,77,275,1296,214,60,274,150,160,251,187
"2011","Manchester 018B","E01005062","Total",1924,268,66,202,1656,123,66,325,262,189,203,488
"2011","Manchester 018C","E01005063","Total",1466,224,49,175,1242,199,84,255,166,94,248,196
"2011","Manchester 018D","E01005065","Total",2159,349,81,268,1810,240,74,478,252,214,209,343
"2011","Manchester 018E","E01005066","Total",981,280,26,254,701,70,14,98,146,67,154,152
"2011","Manchester 019A","E01005208","Total",2336,371,40,331,1965,194,40,381,744,114,131,361
"2011","Manchester 019B","E01005209","Total",1794,382,55,327,1412,132,56,239,408,78,187,312
"2011","Manchester 019C","E01005210","Total",1273,322,48,274,951,67,40,128,266,80,105,265
"2011","Manchester 019D","E01005214","Total",2279,315,14,301,1964,147,24,344,650,124,97,578
"2011","Manchester 020A","E01005067","Total",1362,240,77,163,1122,206,82,192,134,105,239,164
"2011","Manchester 020B","E01005186","Total",2265,316,75,241,1949,220,92,430,338,257,265,347
"2011","Manchester 020C","E01005232","Total",1851,248,83,165,1603,94,72,371,206,244,296,320
"2011","Manchester 020D","E01005235","Total",1760,268,68,200,1492,153,110,336,158,191,290,254
"2011","Manchester 020E","E01005239","Total",1756,247,61,186,1509,268,48,301,118,268,296,210
"2011","Manchester 021A","E01005187","Total",1926,261,58,203,1665,292,72,343,244,201,215,298
"2011","Manchester 021B","E01005188","Total",1693,210,82,128,1483,167,138,305,226,101,229,317
"2011","Manchester 021C","E01005191","Total",1657,334,97,237,1323,255,108,329,198,85,115,233
"2011","Manchester 021D","E01005192","Total",1584,237,71,166,1347,122,104,271,216,91,248,295
"2011","Manchester 021E","E01005193","Total",1798,301,90,211,1497,211,94,342,310,100,179,261
"2011","Manchester 022B","E01005230","Total",2006,363,49,314,1643,61,38,173,308,110,317,636
"2011","Manchester 022C","E01005231","Total",1749,175,27,148,1574,13,20,112,256,50,134,989
"2011","Manchester 022D","E01005236","Total",2054,205,43,162,1849,115,44,274,186,177,255,798
"2011","Manchester 022E","E01005237","Total",1956,116,30,86,1840,43,34,187,132,223,813,408
"2011","Manchester 022F","E01033652","Total",992,143,26,117,849,45,20,118,202,56,155,253
"2011","Manchester 022G","E01033657","Total",1018,193,39,154,825,77,34,102,132,50,113,317
"2011","Manchester 023A","E01005195","Total",1981,193,76,117,1788,275,104,349,194,179,391,296
"2011","Manchester 023B","E01005196","Total",2376,271,72,199,2105,389,102,534,176,244,420,240
"2011","Manchester 023C","E01005197","Total",1552,294,107,187,1258,179,96,236,180,128,177,262
"2011","Manchester 023D","E01005198","Total",1570,266,91,175,1304,218,58,230,148,175,228,247
"2011","Manchester 023E","E01005201","Total",2016,252,51,201,1764,350,66,434,274,200,239,201
"2011","Manchester 024A","E01005240","Total",2655,308,59,249,2347,425,90,428,296,346,420,342
"2011","Manchester 024B","E01005243","Total",2463,459,125,334,2004,351,102,345,322,316,321,247
"2011","Manchester 024C","E01005245","Total",2410,302,131,171,2108,389,104,309,138,331,500,337
"2011","Manchester 024D","E01005246","Total",2139,223,61,162,1916,390,70,301,136,380,394,245
"2011","Manchester 025A","E01005241","Total",2428,299,64,235,2129,253,92,497,414,182,131,560
"2011","Manchester 025B","E01005242","Total",2603,292,69,223,2311,434,58,497,298,252,195,577
"2011","Manchester 025C","E01005244","Total",2621,303,67,236,2318,159,80,247,270,152,270,1140
"2011","Manchester 025D","E01005285","Total",1279,167,39,128,1112,50,52,156,138,149,220,347
"2011","Manchester 025E","E01005288","Total",1723,184,39,145,1539,96,42,151,204,141,146,759
"2011","Manchester 026A","E01005280","Total",1919,100,41,59,1819,102,72,124,102,275,720,424
"2011","Manchester 026B","E01005281","Total",1015,291,81,210,724,6,46,49,268,10,33,312
"2011","Manchester 026C","E01005284","Total",1807,384,32,352,1423,14,20,179,324,47,88,751
"2011","Manchester 026D","E01005286","Total",1985,207,37,170,1778,20,42,198,368,57,196,897
"2011","Manchester 026E","E01005287","Total",2076,187,50,137,1889,91,90,184,132,327,552,513
"2011","Manchester 027A","E01005194","Total",2585,293,61,232,2292,194,92,461,256,347,499,443
"2011","Manchester 027B","E01005199","Total",2273,269,59,210,2004,213,68,461,332,312,255,363
"2011","Manchester 027C","E01005200","Total",1815,271,77,194,1544,168,68,347,272,166,240,283
"2011","Manchester 027D","E01005233","Total",2371,186,32,154,2185,218,66,429,196,357,558,361
"2011","Manchester 027E","E01005234","Total",2046,176,51,125,1870,132,40,250,120,301,568,459
"2011","Manchester 027F","E01005238","Total",2109,96,23,73,2013,89,40,270,132,349,691,442
"2011","Manchester 028A","E01005297","Total",2400,337,47,290,2063,182,66,391,290,186,511,437
"2011","Manchester 028B","E01005298","Total",1835,158,33,125,1677,99,64,279,264,240,378,353
"2011","Manchester 028C","E01005302","Total",1771,444,60,384,1327,92,50,266,444,82,122,271
"2011","Manchester 028E","E01033680","Total",1196,312,31,281,884,58,14,140,380,36,47,209
"2011","Manchester 028F","E01033686","Total",1224,295,50,245,929,62,56,248,224,61,79,199
"2011","Manchester 029A","E01005150","Total",1812,443,57,386,1369,37,42,151,506,65,90,478
"2011","Manchester 029B","E01005151","Total",1426,335,100,235,1091,25,80,253,332,81,112,208
"2011","Manchester 029C","E01005152","Total",1453,157,51,106,1296,41,64,398,330,68,116,279
"2011","Manchester 029D","E01005159","Total",1585,135,22,113,1450,26,98,338,328,83,163,414
"2011","Manchester 029E","E01005296","Total",1688,156,62,94,1532,29,94,223,262,219,270,435
"2011","Manchester 029F","E01005299","Total",1591,110,44,66,1481,37,92,230,194,123,407,398
"2011","Manchester 030A","E01005178","Total",1968,195,58,137,1773,122,110,257,300,167,325,492
"2011","Manchester 030B","E01005179","Total",2168,416,52,364,1752,93,56,281,398,139,384,401
"2011","Manchester 030C","E01005180","Total",1847,272,95,177,1575,250,132,296,216,69,258,354
"2011","Manchester 030D","E01005181","Total",2040,182,37,145,1858,77,92,333,214,197,529,416
"2011","Manchester 030E","E01005182","Total",1494,95,38,57,1399,128,78,212,104,191,427,259
"2011","Manchester 030F","E01005183","Total",1779,205,80,125,1574,132,132,240,198,159,362,351
"2011","Manchester 031A","E01005219","Total",2043,431,45,386,1612,119,42,281,312,110,376,372
"2011","Manchester 031B","E01005220","Total",1836,226,44,182,1610,126,78,364,276,205,261,300
"2011","Manchester 031C","E01005221","Total",2243,203,37,166,2040,125,66,348,268,338,402,493
"2011","Manchester 031D","E01005222","Total",2077,330,80,250,1747,211,78,420,296,196,222,324
"2011","Manchester 032A","E01005184","Total",2102,237,63,174,1865,46,66,234,296,71,131,1021
"2011","Manchester 032B","E01005185","Total",1692,106,22,84,1586,10,18,57,206,10,34,1251
"2011","Manchester 032C","E01005271","Total",2091,231,44,187,1860,40,34,132,282,5,51,1316
"2011","Manchester 032D","E01005282","Total",1852,86,29,57,1766,102,84,190,172,195,438,585
"2011","Manchester 032E","E01005283","Total",1449,44,14,30,1405,27,16,34,126,10,40,1152
"2011","Manchester 033A","E01005154","Total",1581,204,34,170,1377,28,36,299,380,79,147,408
"2011","Manchester 033B","E01005156","Total",1496,164,35,129,1332,47,90,333,388,93,79,302
"2011","Manchester 033C","E01005158","Total",1511,264,94,170,1247,95,82,309,340,46,95,280
"2011","Manchester 033D","E01005300","Total",1561,110,60,50,1451,30,102,178,114,142,464,421
"2011","Manchester 033E","E01005301","Total",1596,197,41,156,1399,24,84,272,230,135,335,319
"2011","Manchester 034A","E01005118","Total",1507,95,59,36,1412,36,130,262,140,146,334,364
"2011","Manchester 034B","E01005120","Total",1849,170,81,89,1679,138,144,271,194,258,370,304
"2011","Manchester 034C","E01005215","Total",2004,225,61,164,1779,141,122,374,216,238,330,358
"2011","Manchester 034D","E01005216","Total",1526,185,50,135,1341,72,92,291,252,136,237,261
"2011","Manchester 034E","E01005217","Total",1895,161,81,80,1734,79,144,306,246,168,371,420
"2011","Manchester 034F","E01005218","Total",1681,219,104,115,1462,23,124,149,172,111,295,588
"2011","Manchester 035A","E01005270","Total",1747,171,53,118,1576,172,110,294,216,104,252,428
"2011","Manchester 035B","E01005272","Total",1781,263,132,131,1518,301,90,274,196,137,204,316
"2011","Manchester 035C","E01005273","Total",1558,167,43,124,1391,79,36,94,234,11,58,879
"2011","Manchester 035D","E01005278","Total",1839,95,42,53,1744,46,100,144,70,139,248,997
"2011","Manchester 035E","E01005279","Total",2036,220,69,151,1816,173,124,428,336,153,242,360
"2011","Manchester 036A","E01005305","Total",1795,125,50,75,1670,51,86,195,182,121,252,783
"2011","Manchester 036B","E01005309","Total",2274,388,82,306,1886,14,34,52,570,10,54,1152
"2011","Manchester 036C","E01005310","Total",1860,125,45,80,1735,120,42,115,114,41,106,1197
"2011","Manchester 036D","E01005311","Total",1769,133,40,93,1636,51,74,145,280,93,128,865
"2011","Manchester 036E","E01005312","Total",1811,218,69,149,1593,34,70,47,222,0,56,1164
"2011","Manchester 037A","E01005082","Total",1548,212,80,132,1336,141,100,293,268,72,212,250
"2011","Manchester 037B","E01005153","Total",1663,307,90,217,1356,111,80,318,492,56,71,228
"2011","Manchester 037C","E01005155","Total",1411,234,70,164,1177,43,70,334,442,47,64,177
"2011","Manchester 037D","E01005157","Total",1591,140,64,76,1451,54,102,452,282,119,163,279
"2011","Manchester 038A","E01005274","Total",1766,175,61,114,1591,122,86,179,288,84,154,678
"2011","Manchester 038B","E01005275","Total",1695,364,41,323,1331,33,28,163,500,27,61,519
"2011","Manchester 038C","E01005276","Total",1529,199,32,167,1330,71,30,181,422,32,56,538
"2011","Manchester 038D","E01005277","Total",1716,242,34,208,1474,31,96,314,492,70,119,352
"2011","Manchester 039A","E01005076","Total",1434,360,39,321,1074,40,20,173,544,20,32,245
"2011","Manchester 039C","E01005081","Total",1770,320,76,244,1450,245,74,317,206,90,266,252
"2011","Manchester 039D","E01005083","Total",1710,440,21,419,1270,22,28,235,476,52,82,375
"2011","Manchester 039E","E01033670","Total",1252,249,7,242,1003,26,8,172,544,45,30,178
"2011","Manchester 039F","E01033671","Total",1647,284,29,255,1363,33,48,196,540,32,56,458
"2011","Manchester 040A","E01005125","Total",1596,187,59,128,1409,134,100,246,222,120,296,291
"2011","Manchester 040B","E01005304","Total",1797,198,57,141,1599,29,50,159,326,70,79,886
"2011","Manchester 040C","E01005306","Total",1546,236,92,144,1310,29,138,309,308,79,148,299
"2011","Manchester 040D","E01005307","Total",1971,170,76,94,1801,18,110,219,328,82,147,897
"2011","Manchester 040E","E01005308","Total",1690,131,53,78,1559,135,112,250,228,115,234,485
"2011","Manchester 041A","E01005119","Total",1531,202,81,121,1329,185,114,272,170,99,232,257
"2011","Manchester 041B","E01005121","Total",1594,169,57,112,1425,219,76,221,158,174,261,316
"2011","Manchester 041C","E01005122","Total",1681,168,59,109,1513,195,138,281,196,125,279,299
"2011","Manchester 041D","E01005123","Total",1701,147,57,90,1554,230,82,251,202,164,279,346
"2011","Manchester 041E","E01005124","Total",1734,167,52,115,1567,231,100,321,256,50,298,311
"2011","Manchester 042A","E01005077","Total",1558,187,49,138,1371,276,78,273,186,123,216,219
"2011","Manchester 042B","E01005078","Total",1401,432,97,335,969,19,44,184,504,15,44,159
"2011","Manchester 042C","E01005079","Total",1513,187,80,107,1326,90,104,293,258,106,200,275
"2011","Manchester 042D","E01005084","Total",2018,270,91,179,1748,162,126,354,388,124,187,407
"2011","Manchester 043A","E01005172","Total",1589,352,115,237,1237,23,114,231,434,104,121,210
"2011","Manchester 043B","E01005173","Total",1508,247,92,155,1261,21,126,291,380,95,89,259
"2011","Manchester 043C","E01005174","Total",1570,183,60,123,1387,30,124,362,224,118,180,349
"2011","Manchester 043D","E01005175","Total",1605,206,77,129,1399,42,130,411,314,84,122,296
"2011","Manchester 043E","E01005176","Total",1799,332,66,266,1467,43,60,275,748,48,29,264
"2011","Manchester 043F","E01005177","Total",1339,230,103,127,1109,42,130,314,318,30,55,220
"2011","Manchester 044A","E01005115","Total",1874,196,62,134,1678,197,198,461,302,68,168,284
"2011","Manchester 044B","E01005262","Total",1841,332,68,264,1509,184,88,455,330,88,124,240
"2011","Manchester 044C","E01005264","Total",1480,196,79,117,1284,154,98,257,208,117,190,260
"2011","Manchester 044D","E01005265","Total",1684,190,65,125,1494,212,106,319,260,108,217,272
"2011","Manchester 044E","E01005266","Total",1943,264,117,147,1679,232,142,394,298,135,184,294
"2011","Manchester 045A","E01005126","Total",2034,236,96,140,1798,92,164,335,350,132,269,456
"2011","Manchester 045B","E01005168","Total",1382,129,60,69,1253,51,100,337,180,105,215,265
"2011","Manchester 045C","E01005169","Total",1208,135,55,80,1073,12,122,235,186,67,164,287
"2011","Manchester 045D","E01005170","Total",1531,138,69,69,1393,69,150,311,222,165,190,286
"2011","Manchester 045E","E01005171","Total",1697,217,77,140,1480,56,128,244,338,71,246,397
"2011","Manchester 046A","E01005263","Total",1604,402,128,274,1202,91,100,273,288,59,119,272
"2011","Manchester 046B","E01005267","Total",1546,193,95,98,1353,77,164,295,260,65,137,355
"2011","Manchester 046C","E01005268","Total",2018,362,148,214,1656,53,170,393,534,31,82,393
"2011","Manchester 046D","E01005269","Total",1482,188,93,95,1294,34,164,272,202,97,179,346
"2011","Manchester 047A","E01005069","Total",1447,190,51,139,1257,49,136,326,318,46,149,233
"2011","Manchester 047B","E01005111","Total",1405,205,90,115,1200,144,164,293,172,53,129,245
"2011","Manchester 047C","E01005113","Total",1573,437,114,323,1136,153,90,281,214,77,139,182
"2011","Manchester 047D","E01005114","Total",1748,279,143,136,1469,39,308,298,262,75,177,310
"2011","Manchester 047E","E01005116","Total",1964,386,118,268,1578,132,132,411,442,40,165,256
"2011","Manchester 048A","E01005071","Total",1592,247,104,143,1345,162,84,357,210,102,151,279
"2011","Manchester 048B","E01005072","Total",1682,356,99,257,1326,174,84,376,252,91,141,208
"2011","Manchester 048C","E01005073","Total",1492,178,68,110,1314,55,168,312,206,75,192,306
"2011","Manchester 048D","E01005112","Total",1660,187,69,118,1473,189,154,321,216,127,204,262
"2011","Manchester 048E","E01005117","Total",2059,389,82,307,1670,278,108,440,240,166,197,241
"2011","Manchester 049A","E01005085","Total",1565,155,39,116,1410,214,68,296,210,173,209,240
"2011","Manchester 049B","E01005086","Total",1805,197,59,138,1608,239,104,364,216,168,243,274
"2011","Manchester 049C","E01005089","Total",1839,200,75,125,1639,244,86,377,176,207,232,317
"2011","Manchester 049D","E01005289","Total",1442,240,80,160,1202,199,84,252,176,104,126,261
"2011","Manchester 049E","E01005295","Total",2357,424,46,378,1933,166,80,544,554,91,188,310
"2011","Manchester 050A","E01005087","Total",2083,171,38,133,1912,368,100,462,250,149,242,341
"2011","Manchester 050B","E01005088","Total",1708,198,63,135,1510,289,94,324,184,199,156,264
"2011","Manchester 050C","E01005090","Total",1597,322,124,198,1275,232,106,230,168,125,135,279
"2011","Manchester 050D","E01005091","Total",2159,255,65,190,1904,336,98,450,252,149,268,351
"2011","Manchester 050E","E01005291","Total",1454,341,151,190,1113,148,74,241,164,98,123,265
"2011","Manchester 051A","E01005068","Total",1566,273,112,161,1293,218,82,297,186,60,173,277
"2011","Manchester 051B","E01005070","Total",1628,276,76,200,1352,196,118,361,220,77,167,213
"2011","Manchester 051C","E01005074","Total",1522,227,70,157,1295,106,92,329,176,146,176,270
"2011","Manchester 051D","E01005075","Total",1378,229,90,139,1149,117,94,323,166,87,139,223
"2011","Manchester 051E","E01005319","Total",2131,260,75,185,1871,268,170,411,272,121,220,409
"2011","Manchester 052A","E01005290","Total",1544,225,72,153,1319,211,106,251,244,85,184,238
"2011","Manchester 052B","E01005292","Total",1479,267,92,175,1212,212,96,238,248,53,156,209
"2011","Manchester 052C","E01005293","Total",1229,128,35,93,1101,110,102,262,248,72,94,213
"2011","Manchester 052D","E01005294","Total",1496,204,87,117,1292,63,184,219,222,80,160,364
"2011","Manchester 052E","E01005317","Total",1646,316,92,224,1330,153,138,253,258,78,192,258
"2011","Manchester 053A","E01005313","Total",1496,195,72,123,1301,177,106,205,190,106,186,331
"2011","Manchester 053B","E01005314","Total",1575,194,76,118,1381,162,118,243,186,107,216,349
"2011","Manchester 053C","E01005315","Total",1503,304,99,205,1199,151,108,297,212,63,161,207
"2011","Manchester 053D","E01005316","Total",1606,236,44,192,1370,118,102,321,252,79,130,368
"2011","Manchester 053E","E01005318","Total",1808,249,86,163,1559,236,106,398,282,68,171,298
"2011","Manchester 054A","E01005130","Total",1444,396,54,342,1048,196,74,210,216,46,116,190
"2011","Manchester 054B","E01033651","Total",1152,211,6,205,941,16,12,84,658,5,20,146
"2011","Manchester 054C","E01033658","Total",1093,392,7,385,701,15,22,68,506,0,10,80
"2011","Manchester 054D","E01033664","Total",1042,228,1,227,814,11,6,50,650,0,4,93
"2011","Manchester 054E","E01033667","Total",994,364,25,339,630,8,10,44,480,0,4,84
"2011","Manchester 055A","E01005128","Total",1300,302,5,297,998,14,2,56,792,0,0,134
"2011","Manchester 055B","E01033653","Total",1664,506,115,391,1158,4,76,70,818,0,5,185
"2011","Manchester 055C","E01033654","Total",1126,241,8,233,885,2,6,26,628,5,0,218
"2011","Manchester 055D","E01033659","Total",1336,263,3,260,1073,13,4,67,844,0,8,137
"2011","Manchester 055E","E01033661","Total",1155,340,87,253,815,4,26,31,556,0,8,190
"2011","Manchester 056A","E01005143","Total",2592,201,50,151,2391,142,72,392,162,484,609,530
"2011","Manchester 056B","E01033655","Total",1197,255,1,254,942,5,0,75,776,0,18,68
"2011","Manchester 056C","E01033665","Total",1212,337,34,303,875,16,38,67,596,30,30,98
"2011","Manchester 056D","E01033676","Total",1668,332,92,240,1336,194,76,209,160,186,280,231
"2011","Manchester 057A","E01005212","Total",1256,344,52,292,912,112,12,176,344,36,46,186
"2011","Manchester 057B","E01033656","Total",1390,328,1,327,1062,12,0,20,626,0,17,387
"2011","Manchester 057C","E01033662","Total",1332,415,8,407,917,7,2,37,736,0,0,135
"2011","Manchester 058A","E01005142","Total",1912,292,48,244,1620,156,68,342,114,314,357,269
"2011","Manchester 058B","E01005147","Total",2538,278,56,222,2260,266,80,504,224,409,468,309
"2011","Manchester 058C","E01033674","Total",1398,214,11,203,1184,98,24,161,474,77,168,182
"2011","Manchester 058D","E01033675","Total",2058,159,34,125,1899,303,70,458,266,191,316,295
"2011","Manchester 059A","E01005213","Total",2189,597,89,508,1592,202,46,265,544,102,154,279
"2011","Manchester 059B","E01033660","Total",1168,258,0,258,910,2,0,42,820,0,0,46
"2011","Manchester 059C","E01033672","Total",1291,377,53,324,914,165,38,157,348,68,51,87
"2011","Manchester 059D","E01033673","Total",1101,278,2,276,823,2,2,31,726,0,0,62
"2011","Manchester 060A","E01033677","Total",1170,301,10,291,869,6,6,65,656,0,0,136
"2011","Manchester 060B","E01033681","Total",1372,363,7,356,1009,13,14,66,862,0,8,46
"2011","Manchester 060C","E01033682","Total",1261,378,22,356,883,2,16,51,742,0,0,72
"2011","Manchester 060D","E01033683","Total",1259,319,2,317,940,6,4,87,724,0,10,109
"2011","Oldham 001A","E01005357","Total",1424,160,92,68,1264,43,240,249,218,45,132,337
"2011","Oldham 001B","E01005358","Total",1643,254,118,136,1389,138,142,356,242,81,136,294
"2011","Oldham 001C","E01005359","Total",1594,232,122,110,1362,48,366,251,280,51,129,237
"2011","Oldham 001D","E01005360","Total",1402,223,138,85,1179,86,264,167,196,87,142,237
"2011","Oldham 002A","E01005441","Total",1592,327,127,200,1265,135,190,285,244,46,121,244
"2011","Oldham 002B","E01005442","Total",1408,118,62,56,1290,63,152,307,312,37,119,300
"2011","Oldham 002C","E01005444","Total",1504,202,80,122,1302,110,126,397,274,62,103,230
"2011","Oldham 002D","E01005445","Total",1537,238,98,140,1299,133,88,341,226,103,152,256
"2011","Oldham 003A","E01005361","Total",1696,175,104,71,1521,34,338,332,272,63,188,294
"2011","Oldham 003B","E01005443","Total",1396,98,33,65,1298,39,198,334,256,62,117,292
"2011","Oldham 003C","E01005446","Total",1393,159,63,96,1234,113,144,301,280,62,114,220
"2011","Oldham 003D","E01005447","Total",1507,289,124,165,1218,151,126,298,206,102,162,173
"2011","Oldham 004A","E01005390","Total",1515,125,53,72,1390,88,188,333,254,118,133,276
"2011","Oldham 004B","E01005394","Total",1540,162,99,63,1378,64,224,310,246,58,139,337
"2011","Oldham 004C","E01005395","Total",1439,165,77,88,1274,92,178,279,212,60,143,310
"2011","Oldham 004D","E01005396","Total",1474,131,61,70,1343,66,222,216,224,89,220,306
"2011","Oldham 005A","E01005355","Total",1511,167,68,99,1344,105,128,343,246,80,166,276
"2011","Oldham 005B","E01005356","Total",1335,81,28,53,1254,56,100,343,222,66,157,310
"2011","Oldham 005C","E01005399","Total",1589,196,86,110,1393,47,224,296,280,46,145,355
"2011","Oldham 005D","E01005403","Total",1660,130,50,80,1530,110,114,459,264,91,195,297
"2011","Oldham 006A","E01005410","Total",1550,108,41,67,1442,37,200,386,248,73,181,317
"2011","Oldham 006B","E01005411","Total",1548,265,165,100,1283,40,210,312,266,41,163,251
"2011","Oldham 006C","E01005414","Total",1295,104,46,58,1191,30,166,309,244,70,129,243
"2011","Oldham 006D","E01005415","Total",1148,159,98,61,989,37,190,261,152,52,114,183
"2011","Oldham 007C","E01005452","Total",1372,115,40,75,1257,40,130,309,232,65,177,304
"2011","Oldham 007D","E01005453","Total",1320,124,54,70,1196,51,174,282,198,100,160,231
"2011","Oldham 007E","E01032558","Total",1447,231,63,168,1216,273,90,269,166,110,115,193
"2011","Oldham 007F","E01032559","Total",2725,222,60,162,2503,198,100,940,330,192,349,394
"2011","Oldham 008A","E01005391","Total",1593,176,83,93,1417,60,164,332,234,109,160,358
"2011","Oldham 008B","E01005392","Total",1481,369,188,181,1112,113,150,207,210,47,141,244
"2011","Oldham 008C","E01005393","Total",1231,132,74,58,1099,51,214,185,192,57,123,277
"2011","Oldham 008D","E01005401","Total",1652,181,100,81,1471,72,244,370,222,72,221,270
"2011","Oldham 009A","E01005397","Total",1443,197,95,102,1246,78,176,277,222,78,128,287
"2011","Oldham 009B","E01005398","Total",1482,204,98,106,1278,74,176,312,234,72,143,267
"2011","Oldham 009C","E01005400","Total",1503,317,157,160,1186,129,190,182,250,82,117,236
"2011","Oldham 009D","E01005402","Total",1506,187,85,102,1319,81,124,370,216,90,181,257
"2011","Oldham 010A","E01005335","Total",1289,124,64,60,1165,40,198,231,220,41,124,311
"2011","Oldham 010B","E01005337","Total",1963,157,54,103,1806,89,112,309,220,436,442,198
"2011","Oldham 010C","E01005339","Total",1463,129,97,32,1334,29,256,313,198,61,181,296
"2011","Oldham 010D","E01005340","Total",1435,227,101,126,1208,150,118,237,148,109,211,235
"2011","Oldham 011A","E01005421","Total",1621,247,67,180,1374,234,94,357,246,117,96,230
"2011","Oldham 011B","E01005422","Total",1503,105,32,73,1398,325,60,289,124,155,243,202
"2011","Oldham 011E","E01032920","Total",1870,340,121,219,1530,207,168,309,310,107,193,236
"2011","Oldham 012A","E01005448","Total",1458,407,148,259,1051,228,78,223,194,93,103,132
"2011","Oldham 012B","E01005449","Total",1218,242,125,117,976,123,110,178,162,60,130,213
"2011","Oldham 012C","E01005454","Total",1423,130,52,78,1293,93,112,297,230,67,177,317
"2011","Oldham 012D","E01005455","Total",1564,144,40,104,1420,87,100,428,234,68,219,284
"2011","Oldham 012E","E01005456","Total",1589,345,94,251,1244,200,112,282,256,87,137,170
"2011","Oldham 013A","E01005407","Total",1706,160,67,93,1546,41,248,433,356,45,136,287
"2011","Oldham 013B","E01005412","Total",1690,234,110,124,1456,61,222,362,388,60,131,232
"2011","Oldham 013C","E01005416","Total",1357,165,61,104,1192,52,140,352,312,45,90,201
"2011","Oldham 013D","E01005417","Total",1424,152,73,79,1272,66,230,262,296,5,95,318
"2011","Oldham 014A","E01005348","Total",1654,225,96,129,1429,124,92,277,152,265,312,207
"2011","Oldham 014B","E01005350","Total",1972,591,208,383,1381,112,116,140,196,243,351,223
"2011","Oldham 014C","E01005432","Total",1497,252,99,153,1245,234,106,214,184,127,197,183
"2011","Oldham 014D","E01005433","Total",1515,271,63,208,1244,262,70,197,198,137,224,156
"2011","Oldham 015A","E01005329","Total",1526,142,42,100,1384,62,124,350,280,43,180,345
"2011","Oldham 015B","E01005330","Total",1562,135,71,64,1427,44,152,349,282,57,152,391
"2011","Oldham 015C","E01005333","Total",1274,111,52,59,1163,22,138,213,200,50,140,400
"2011","Oldham 015D","E01005336","Total",1576,147,103,44,1429,35,232,326,188,77,223,348
"2011","Oldham 016A","E01005349","Total",2424,66,21,45,2358,100,22,210,66,644,1040,276
"2011","Oldham 016B","E01005351","Total",1986,78,35,43,1908,55,28,194,92,521,813,205
"2011","Oldham 016C","E01005352","Total",1433,144,29,115,1289,59,72,138,122,290,432,176
"2011","Oldham 016D","E01005353","Total",1913,281,52,229,1632,68,68,182,126,210,774,204
"2011","Oldham 016E","E01005354","Total",1743,113,36,77,1630,111,58,281,192,205,561,222
"2011","Oldham 017A","E01005327","Total",1798,226,100,126,1572,116,200,404,240,136,186,290
"2011","Oldham 017B","E01005328","Total",1369,364,170,194,1005,76,118,189,160,101,151,210
"2011","Oldham 017C","E01005331","Total",1544,178,84,94,1366,110,158,280,228,118,221,251
"2011","Oldham 017D","E01005334","Total",1514,82,28,54,1432,39,104,513,210,82,205,279
"2011","Oldham 017E","E01005338","Total",1791,282,166,116,1509,136,184,233,224,319,246,167
"2011","Oldham 018A","E01005387","Total",1431,188,70,118,1243,70,136,351,260,36,127,263
"2011","Oldham 018B","E01005388","Total",1321,193,99,94,1128,101,160,239,212,42,127,247
"2011","Oldham 018C","E01005389","Total",1619,268,93,175,1351,230,106,276,234,85,202,218
"2011","Oldham 018D","E01005418","Total",1510,124,72,52,1386,58,160,297,230,84,234,323
"2011","Oldham 019A","E01005428","Total",1736,130,33,97,1606,105,46,328,106,274,520,227
"2011","Oldham 019B","E01005431","Total",1663,244,95,149,1419,143,108,401,244,138,139,246
"2011","Oldham 019C","E01005450","Total",1670,185,74,111,1485,144,80,303,194,269,306,189
"2011","Oldham 019D","E01005451","Total",1336,109,40,69,1227,54,86,240,216,151,292,188
"2011","Oldham 020C","E01005408","Total",1771,233,116,117,1538,69,232,385,358,117,122,255
"2011","Oldham 020D","E01005409","Total",1658,136,71,65,1522,50,204,433,290,93,167,285
"2011","Oldham 020E","E01032922","Total",2477,323,211,112,2154,73,364,487,364,131,226,509
"2011","Oldham 021A","E01005406","Total",1414,145,79,66,1269,24,222,339,244,31,158,251
"2011","Oldham 021B","E01005413","Total",1665,131,69,62,1534,48,216,455,236,131,110,338
"2011","Oldham 021C","E01005419","Total",1502,181,73,108,1321,66,134,340,280,60,165,276
"2011","Oldham 021D","E01005420","Total",1653,232,130,102,1421,72,204,364,224,86,188,283
"2011","Oldham 022A","E01005321","Total",1576,219,54,165,1357,105,74,208,148,267,324,231
"2011","Oldham 022B","E01005326","Total",2788,58,27,31,2730,56,46,168,52,393,1584,431
"2011","Oldham 022C","E01005427","Total",2021,91,30,61,1930,105,20,266,68,375,768,328
"2011","Oldham 022D","E01005429","Total",1818,84,29,55,1734,92,22,261,92,385,611,271
"2011","Oldham 022E","E01005430","Total",2394,177,65,112,2217,151,72,331,154,453,758,298
"2011","Oldham 024A","E01005320","Total",1884,164,61,103,1720,163,64,325,140,290,403,335
"2011","Oldham 024B","E01005434","Total",1340,340,96,244,1000,89,62,207,160,138,184,160
"2011","Oldham 024C","E01005437","Total",1908,72,33,39,1836,104,64,237,158,372,580,321
"2011","Oldham 024D","E01005459","Total",1358,129,83,46,1229,63,52,179,42,166,554,173
"2011","Oldham 026A","E01005383","Total",1968,192,71,121,1776,199,126,390,208,224,368,261
"2011","Oldham 026D","E01005386","Total",1388,222,73,149,1166,218,126,229,214,81,137,161
"2011","Oldham 026E","E01032556","Total",1439,220,84,136,1219,85,158,321,264,62,97,232
"2011","Oldham 026F","E01032557","Total",1628,283,107,176,1345,328,104,282,198,118,141,174
"2011","Oldham 027A","E01005342","Total",1336,298,156,142,1038,132,128,205,198,70,139,166
"2011","Oldham 027B","E01005343","Total",1393,128,65,63,1265,154,136,321,192,93,134,235
"2011","Oldham 027C","E01005344","Total",1499,229,81,148,1270,189,72,295,208,146,111,249
"2011","Oldham 027D","E01005381","Total",1497,259,137,122,1238,146,104,207,162,163,267,189
"2011","Oldham 028A","E01005332","Total",2295,311,126,185,1984,214,220,375,354,182,292,347
"2011","Oldham 028B","E01005341","Total",1443,162,59,103,1281,106,110,313,254,74,176,248
"2011","Oldham 028C","E01005345","Total",1506,167,84,83,1339,50,180,278,222,54,223,332
"2011","Oldham 028D","E01005346","Total",1401,178,100,78,1223,30,196,276,200,36,122,363
"2011","Oldham 028E","E01005347","Total",1345,128,47,81,1217,95,118,309,214,86,160,235
"2011","Oldham 029A","E01005322","Total",1267,155,45,110,1112,207,70,197,154,123,147,214
"2011","Oldham 029B","E01005323","Total",1397,215,81,134,1182,171,110,262,198,98,124,219
"2011","Oldham 029C","E01005324","Total",1423,177,67,110,1246,274,104,207,188,84,142,247
"2011","Oldham 029D","E01005325","Total",1001,144,56,88,857,177,64,141,104,125,122,124
"2011","Oldham 029E","E01005438","Total",2331,310,94,216,2021,204,172,471,332,243,287,312
"2011","Oldham 030A","E01005377","Total",1327,115,26,89,1212,167,88,195,142,148,253,219
"2011","Oldham 030B","E01005379","Total",1272,138,52,86,1134,329,58,225,118,121,111,172
"2011","Oldham 030C","E01005380","Total",1509,101,46,55,1408,275,44,278,132,167,208,304
"2011","Oldham 030D","E01005382","Total",1453,192,85,107,1261,142,102,219,218,112,203,265
"2011","Oldham 030E","E01005439","Total",1519,191,119,72,1328,90,198,233,238,90,188,291
"2011","Oldham 031A","E01005362","Total",1460,156,80,76,1304,107,172,268,228,27,183,319
"2011","Oldham 031B","E01005364","Total",1674,190,111,79,1484,52,218,408,244,45,172,345
"2011","Oldham 031C","E01005368","Total",1542,268,99,169,1274,227,78,298,264,88,82,237
"2011","Oldham 031D","E01005376","Total",1288,190,78,112,1098,180,78,226,180,116,131,187
"2011","Oldham 031E","E01005378","Total",1494,213,83,130,1281,135,134,301,244,56,137,274
"2011","Oldham 032A","E01005363","Total",1539,233,96,137,1306,158,120,275,288,79,122,264
"2011","Oldham 032B","E01005369","Total",1419,223,59,164,1196,191,102,286,256,51,123,187
"2011","Oldham 032C","E01005370","Total",1437,316,179,137,1121,117,166,250,220,68,102,198
"2011","Oldham 032D","E01005371","Total",1309,149,36,113,1160,145,78,314,248,51,137,187
"2011","Oldham 033A","E01005365","Total",1456,168,79,89,1288,64,180,294,250,57,158,285
"2011","Oldham 033B","E01005366","Total",1475,290,140,150,1185,123,174,217,172,76,139,284
"2011","Oldham 033C","E01005367","Total",1474,116,70,46,1358,60,206,354,176,60,206,296
"2011","Oldham 033D","E01005440","Total",1334,231,109,122,1103,61,136,243,264,15,117,267
"2011","Oldham 034A","E01005372","Total",1191,162,70,92,1029,124,124,232,152,77,91,229
"2011","Oldham 034B","E01005373","Total",1201,142,91,51,1059,36,196,227,146,58,142,254
"2011","Oldham 034C","E01005374","Total",1443,181,99,82,1262,140,176,295,186,68,121,276
"2011","Oldham 034D","E01005375","Total",1469,183,125,58,1286,85,290,234,198,31,154,294
"2011","Oldham 035A","E01005435","Total",1913,69,21,48,1844,91,36,242,76,370,677,352
"2011","Oldham 035B","E01005436","Total",1657,117,54,63,1540,85,96,238,142,200,471,308
"2011","Oldham 035C","E01005460","Total",2356,174,58,116,2182,169,98,392,222,364,643,294
"2011","Oldham 035D","E01005461","Total",2334,91,36,55,2243,64,54,187,60,367,1139,372
"2011","Oldham 035E","E01005462","Total",1845,132,52,80,1713,64,94,232,130,264,619,310
"2011","Oldham 035F","E01005463","Total",1122,152,34,118,970,90,42,149,88,185,273,143
"2011","Oldham 035G","E01032921","Total",2469,254,52,202,2215,112,56,340,114,397,794,402
"2011","Rochdale 001A","E01005518","Total",1408,157,60,97,1251,83,184,248,218,100,137,281
"2011","Rochdale 001B","E01005520","Total",1758,279,116,163,1479,137,192,387,316,73,158,216
"2011","Rochdale 001C","E01005522","Total",1324,261,107,154,1063,124,108,261,262,53,94,161
"2011","Rochdale 001D","E01005523","Total",1916,212,74,138,1704,92,206,465,334,104,217,286
"2011","Rochdale 002A","E01005519","Total",1558,140,60,80,1418,103,112,401,252,124,150,276
"2011","Rochdale 002B","E01005594","Total",1455,129,53,76,1326,61,168,305,238,82,178,294
"2011","Rochdale 002C","E01005597","Total",1600,166,68,98,1434,119,172,385,286,99,126,247
"2011","Rochdale 002D","E01005598","Total",1562,174,75,99,1388,54,224,278,306,73,177,276
"2011","Rochdale 003A","E01005516","Total",1378,117,45,72,1261,64,138,327,256,72,174,230
"2011","Rochdale 003B","E01005517","Total",1465,172,90,82,1293,48,254,264,278,50,116,283
"2011","Rochdale 003C","E01005521","Total",1363,200,93,107,1163,35,150,331,300,40,111,196
"2011","Rochdale 003D","E01005596","Total",1907,176,59,117,1731,107,152,442,332,128,251,319
"2011","Rochdale 004A","E01005578","Total",1420,147,71,76,1273,97,66,195,142,190,399,184
"2011","Rochdale 004B","E01005579","Total",1674,124,36,88,1550,117,64,290,140,399,371,169
"2011","Rochdale 004C","E01005586","Total",1521,273,120,153,1248,211,126,161,148,182,222,198
"2011","Rochdale 004D","E01005593","Total",1546,129,37,92,1417,184,92,283,190,152,282,234
"2011","Rochdale 004E","E01005595","Total",1378,463,177,286,915,115,144,178,166,43,151,118
"2011","Rochdale 005A","E01005489","Total",1189,113,58,55,1076,85,180,235,220,77,81,198
"2011","Rochdale 005B","E01005490","Total",1113,100,43,57,1013,110,86,197,96,110,195,219
"2011","Rochdale 005C","E01005491","Total",1469,272,117,155,1197,80,162,284,238,84,139,210
"2011","Rochdale 005D","E01005493","Total",1608,154,71,83,1454,62,190,313,332,43,223,291
"2011","Rochdale 005E","E01005494","Total",1750,200,77,123,1550,110,156,360,226,133,254,311
"2011","Rochdale 005F","E01005495","Total",1624,225,104,121,1399,91,184,211,252,127,283,251
"2011","Rochdale 006A","E01005488","Total",1593,98,22,76,1495,107,128,486,216,147,176,235
"2011","Rochdale 006B","E01005492","Total",1557,104,52,52,1453,42,230,315,286,113,194,273
"2011","Rochdale 006C","E01005499","Total",1483,190,71,119,1293,72,158,313,272,51,124,303
"2011","Rochdale 006D","E01005571","Total",1565,172,58,114,1393,49,160,357,290,82,150,305
"2011","Rochdale 007A","E01005570","Total",1237,171,75,96,1066,40,220,209,248,56,108,185
"2011","Rochdale 007B","E01005572","Total",1645,133,60,73,1512,50,184,421,236,96,176,349
"2011","Rochdale 007C","E01005573","Total",1484,113,69,44,1371,27,182,340,206,85,244,287
"2011","Rochdale 007D","E01005574","Total",1676,167,67,100,1509,60,240,290,260,85,244,330
"2011","Rochdale 007E","E01005587","Total",1467,75,30,45,1392,55,94,354,198,107,264,320
"2011","Rochdale 007F","E01005588","Total",1374,297,177,120,1077,80,216,240,166,41,111,223
"2011","Rochdale 008A","E01005580","Total",1575,158,56,102,1417,142,96,296,176,166,235,306
"2011","Rochdale 008B","E01005581","Total",1580,214,89,125,1366,112,112,238,138,317,246,203
"2011","Rochdale 008D","E01005583","Total",1689,138,59,79,1551,46,56,142,64,136,804,303
"2011","Rochdale 008F","E01005585","Total",1419,104,20,84,1315,68,68,264,144,183,394,194
"2011","Rochdale 008G","E01033258","Total",2981,156,36,120,2825,159,68,301,168,487,1137,505
"2011","Rochdale 009A","E01005496","Total",1351,144,50,94,1207,182,76,277,124,72,182,294
"2011","Rochdale 009B","E01005589","Total",1522,219,68,151,1303,103,108,277,232,71,247,265
"2011","Rochdale 009C","E01005590","Total",1636,135,51,84,1501,88,76,245,136,226,459,271
"2011","Rochdale 009D","E01005591","Total",1391,216,109,107,1175,76,172,272,216,57,144,238
"2011","Rochdale 009E","E01005592","Total",1551,200,93,107,1351,142,112,270,174,141,268,244
"2011","Rochdale 010A","E01005472","Total",1547,240,109,131,1307,194,96,269,218,127,241,162
"2011","Rochdale 010B","E01005473","Total",1510,117,52,65,1393,81,86,232,130,196,357,311
"2011","Rochdale 010C","E01005482","Total",1955,801,130,671,1154,128,72,180,240,156,225,153
"2011","Rochdale 010D","E01005483","Total",1818,395,109,286,1423,68,74,230,260,200,427,164
"2011","Rochdale 010E","E01005484","Total",2106,444,110,334,1662,173,88,271,172,237,424,297
"2011","Rochdale 010F","E01005486","Total",1605,146,38,108,1459,194,62,316,176,251,291,169
"2011","Rochdale 010G","E01005487","Total",1705,156,67,89,1549,124,104,212,128,215,515,251
"2011","Rochdale 011A","E01005474","Total",1209,112,57,55,1097,63,184,198,154,118,117,263
"2011","Rochdale 011B","E01005575","Total",1636,216,109,107,1420,51,282,313,256,91,190,237
"2011","Rochdale 011C","E01005576","Total",1517,102,54,48,1415,18,272,238,174,110,295,308
"2011","Rochdale 011D","E01005577","Total",1482,194,107,87,1288,41,222,257,214,62,210,282
"2011","Rochdale 012A","E01005469","Total",1804,192,69,123,1612,110,170,336,236,149,266,345
"2011","Rochdale 012B","E01005563","Total",1809,164,46,118,1645,171,110,242,184,204,479,255
"2011","Rochdale 012C","E01005565","Total",1563,126,36,90,1437,113,90,312,188,183,295,256
"2011","Rochdale 012D","E01005566","Total",2134,216,79,137,1918,195,84,459,328,281,366,205
"2011","Rochdale 012E","E01005568","Total",1635,247,62,185,1388,175,48,237,144,257,322,205
"2011","Rochdale 012F","E01005569","Total",1635,204,52,152,1431,116,156,256,180,216,282,225
"2011","Rochdale 013A","E01005556","Total",1539,194,58,136,1345,98,142,387,278,40,127,273
"2011","Rochdale 013B","E01005559","Total",1566,266,115,151,1300,165,126,277,208,146,171,207
"2011","Rochdale 013C","E01005560","Total",1539,207,105,102,1332,121,238,250,260,41,121,301
"2011","Rochdale 013D","E01005567","Total",1459,214,59,155,1245,125,102,342,246,56,160,214
"2011","Rochdale 014A","E01005555","Total",1366,107,35,72,1259,77,148,248,178,103,208,297
"2011","Rochdale 014B","E01005557","Total",1209,105,58,47,1104,46,198,232,206,58,124,240
"2011","Rochdale 014C","E01005558","Total",1643,202,87,115,1441,80,160,395,334,77,149,246
"2011","Rochdale 014D","E01005561","Total",1334,179,62,117,1155,81,150,279,288,52,103,202
"2011","Rochdale 014E","E01005562","Total",1525,239,98,141,1286,93,134,301,266,112,145,235
"2011","Rochdale 015A","E01005470","Total",1721,94,32,62,1627,100,38,264,76,269,525,355
"2011","Rochdale 015B","E01005471","Total",1606,146,58,88,1460,96,88,337,156,199,335,249
"2011","Rochdale 015C","E01005475","Total",1665,198,66,132,1467,134,88,222,136,162,423,302
"2011","Rochdale 015D","E01005485","Total",2111,194,50,144,1917,68,90,174,88,217,854,426
"2011","Rochdale 015E","E01005564","Total",1938,180,67,113,1758,178,68,272,136,258,530,316
"2011","Rochdale 016A","E01005464","Total",1752,170,61,109,1582,233,74,296,166,220,320,273
"2011","Rochdale 016B","E01005465","Total",1716,277,131,146,1439,115,130,358,252,83,203,298
"2011","Rochdale 016C","E01005466","Total",2304,456,129,327,1848,306,134,400,296,189,291,232
"2011","Rochdale 016D","E01005467","Total",1722,335,119,216,1387,188,138,375,184,141,163,198
"2011","Rochdale 016E","E01005468","Total",1535,121,48,73,1414,64,198,299,258,97,164,334
"2011","Rochdale 017A","E01005476","Total",1630,232,84,148,1398,110,126,384,266,108,142,262
"2011","Rochdale 017B","E01005477","Total",1669,358,131,227,1311,161,124,249,262,129,148,238
"2011","Rochdale 017C","E01005478","Total",1591,186,77,109,1405,134,212,247,252,93,186,281
"2011","Rochdale 017D","E01005479","Total",1733,193,90,103,1540,96,184,326,266,109,230,329
"2011","Rochdale 017E","E01005480","Total",1593,264,150,114,1329,107,238,210,258,87,156,273
"2011","Rochdale 017F","E01005481","Total",1590,150,62,88,1440,101,132,277,230,139,288,273
"2011","Rochdale 018A","E01005497","Total",1577,232,92,140,1345,195,98,338,202,96,202,214
"2011","Rochdale 018B","E01005501","Total",1560,508,226,282,1052,110,178,258,218,69,91,128
"2011","Rochdale 018C","E01005502","Total",1534,294,113,181,1240,107,124,281,216,90,160,262
"2011","Rochdale 018D","E01005504","Total",1508,199,83,116,1309,145,124,272,208,121,125,314
"2011","Rochdale 018E","E01005505","Total",1707,261,97,164,1446,204,146,322,298,40,171,265
"2011","Rochdale 018F","E01005509","Total",1788,494,138,356,1294,201,118,216,308,82,117,252
"2011","Rochdale 019A","E01005510","Total",1148,67,17,50,1081,45,124,257,234,84,125,212
"2011","Rochdale 019B","E01005511","Total",1232,122,37,85,1110,52,114,246,242,58,155,243
"2011","Rochdale 019C","E01005512","Total",1491,240,89,151,1251,86,158,263,258,68,143,275
"2011","Rochdale 019D","E01005513","Total",1332,222,80,142,1110,163,90,267,174,66,156,194
"2011","Rochdale 019E","E01005514","Total",1510,209,77,132,1301,141,138,235,240,115,179,253
"2011","Rochdale 019F","E01005515","Total",1705,218,99,119,1487,258,120,313,182,145,186,283
"2011","Rochdale 020A","E01005498","Total",1461,155,58,97,1306,142,110,307,188,117,135,307
"2011","Rochdale 020B","E01005500","Total",1544,177,88,89,1367,93,122,317,292,61,198,284
"2011","Rochdale 020C","E01005503","Total",1310,109,58,51,1201,53,152,244,220,37,188,307
"2011","Rochdale 020D","E01005506","Total",1508,235,96,139,1273,108,160,260,220,88,212,225
"2011","Rochdale 020E","E01005507","Total",1574,233,67,166,1341,167,110,280,276,84,160,264
"2011","Rochdale 020F","E01005508","Total",1861,167,77,90,1694,69,188,358,306,106,265,402
"2011","Rochdale 021A","E01005524","Total",1489,190,60,130,1299,95,136,285,254,69,151,309
"2011","Rochdale 021B","E01005525","Total",1602,426,149,277,1176,107,112,258,206,130,143,220
"2011","Rochdale 021C","E01005526","Total",1584,225,60,165,1359,143,102,295,236,93,215,275
"2011","Rochdale 021D","E01005528","Total",1495,237,99,138,1258,131,150,262,224,104,143,244
"2011","Rochdale 021E","E01005536","Total",1599,175,54,121,1424,157,98,330,270,107,180,282
"2011","Rochdale 021F","E01005543","Total",1260,144,77,67,1116,56,112,222,236,42,192,256
"2011","Rochdale 022A","E01005527","Total",1447,235,77,158,1212,159,110,208,190,106,198,241
"2011","Rochdale 022B","E01005529","Total",1610,355,147,208,1255,180,120,198,258,93,200,206
"2011","Rochdale 022C","E01005551","Total",1726,315,120,195,1411,268,110,245,262,153,174,199
"2011","Rochdale 022D","E01005552","Total",1990,352,112,240,1638,288,108,337,234,164,244,263
"2011","Rochdale 022E","E01005553","Total",1831,213,95,118,1618,180,188,285,236,79,253,397
"2011","Rochdale 022F","E01005554","Total",1343,177,57,120,1166,73,116,227,278,119,138,215
"2011","Rochdale 023A","E01005534","Total",1488,229,102,127,1259,99,82,262,218,82,224,292
"2011","Rochdale 023B","E01005535","Total",1556,226,45,181,1330,102,136,264,268,63,198,299
"2011","Rochdale 023C","E01005537","Total",1363,125,41,84,1238,82,116,250,292,38,164,296
"2011","Rochdale 023D","E01005538","Total",1504,150,52,98,1354,170,96,405,162,70,225,226
"2011","Rochdale 023E","E01005540","Total",1328,163,50,113,1165,85,114,284,258,45,109,270
"2011","Rochdale 023F","E01005541","Total",1621,213,49,164,1408,150,98,405,286,61,158,250
"2011","Rochdale 023G","E01005542","Total",1303,253,110,143,1050,108,126,273,196,60,127,160
"2011","Rochdale 024A","E01005533","Total",1636,367,132,235,1269,86,142,358,336,17,115,215
"2011","Rochdale 024B","E01005539","Total",1301,339,96,243,962,121,100,210,236,65,40,190
"2011","Rochdale 024C","E01005546","Total",1237,265,114,151,972,53,140,232,208,41,99,199
"2011","Rochdale 024D","E01005547","Total",1434,195,69,126,1239,111,102,361,252,56,118,239
"2011","Rochdale 024E","E01005548","Total",1251,324,91,233,927,98,94,179,212,43,120,181
"2011","Rochdale 025A","E01005530","Total",1437,200,133,67,1237,51,284,246,194,57,126,279
"2011","Rochdale 025B","E01005531","Total",1165,169,68,101,996,108,80,211,184,39,147,227
"2011","Rochdale 025C","E01005532","Total",1435,283,94,189,1152,175,96,260,178,90,159,194
"2011","Rochdale 025D","E01005544","Total",1470,167,115,52,1303,30,206,285,168,72,158,384
"2011","Rochdale 025E","E01005545","Total",1227,101,69,32,1126,30,186,258,170,57,168,257
"2011","Rochdale 025F","E01005549","Total",1562,118,78,40,1444,28,212,319,196,115,244,330
"2011","Rochdale 025G","E01005550","Total",1420,184,125,59,1236,52,288,265,176,62,121,272
"2011","Salford 001A","E01005659","Total",1422,211,85,126,1211,170,134,251,204,73,124,255
"2011","Salford 001B","E01005660","Total",1470,278,120,158,1192,212,124,234,174,125,179,144
"2011","Salford 001C","E01005663","Total",1376,197,67,130,1179,183,138,258,220,64,127,189
"2011","Salford 001D","E01005664","Total",1487,193,76,117,1294,256,108,278,194,134,130,194
"2011","Salford 001E","E01005665","Total",1470,230,98,132,1240,240,104,207,122,146,214,207
"2011","Salford 002A","E01005703","Total",1544,278,84,194,1266,202,98,263,206,107,187,203
"2011","Salford 002B","E01005704","Total",1404,151,48,103,1253,165,150,239,230,56,189,224
"2011","Salford 002C","E01005706","Total",1456,224,98,126,1232,230,128,267,190,71,138,208
"2011","Salford 002D","E01005708","Total",1491,341,154,187,1150,140,142,256,216,58,130,208
"2011","Salford 003A","E01005702","Total",2127,288,110,178,1839,165,196,382,368,116,253,359
"2011","Salford 003B","E01005705","Total",1861,321,120,201,1540,161,150,417,336,96,148,232
"2011","Salford 003C","E01005707","Total",1718,291,78,213,1427,243,134,344,260,91,174,181
"2011","Salford 004A","E01005661","Total",1781,198,64,134,1583,265,110,396,254,110,226,222
"2011","Salford 004B","E01005662","Total",1519,189,71,118,1330,220,108,305,176,176,197,148
"2011","Salford 004C","E01005709","Total",1391,190,75,115,1201,221,126,241,186,71,157,199
"2011","Salford 004D","E01005710","Total",1508,137,70,67,1371,82,208,262,218,91,189,321
"2011","Salford 005A","E01005670","Total",1663,349,173,176,1314,193,112,262,270,69,121,287
"2011","Salford 005B","E01005672","Total",1369,177,52,125,1192,125,88,281,290,53,104,251
"2011","Salford 005C","E01005676","Total",1276,138,69,69,1138,39,246,176,202,32,143,300
"2011","Salford 005D","E01005677","Total",1540,224,106,118,1316,111,178,296,258,70,149,254
"2011","Salford 006A","E01005686","Total",1439,186,57,129,1253,156,144,228,232,63,166,264
"2011","Salford 006B","E01005688","Total",1591,158,72,86,1433,184,208,320,220,55,224,222
"2011","Salford 006C","E01005691","Total",1472,226,116,110,1246,88,300,183,238,36,138,263
"2011","Salford 006D","E01005692","Total",1280,400,125,275,880,110,108,217,226,32,64,123
"2011","Salford 007A","E01005711","Total",1505,181,64,117,1324,73,200,310,272,46,172,251
"2011","Salford 007B","E01005712","Total",1593,267,81,186,1326,130,124,279,270,49,164,310
"2011","Salford 007C","E01005713","Total",1415,169,97,72,1246,42,264,284,234,40,102,280
"2011","Salford 007D","E01005714","Total",1438,185,84,101,1253,137,164,251,200,82,155,264
"2011","Salford 007E","E01005715","Total",1649,216,102,114,1433,45,234,384,268,61,161,280
"2011","Salford 007F","E01005718","Total",1673,321,160,161,1352,77,192,248,320,65,155,295
"2011","Salford 008A","E01005673","Total",1436,217,59,158,1219,120,100,295,260,76,129,239
"2011","Salford 008B","E01005675","Total",1708,196,42,154,1512,159,78,449,280,87,188,271
"2011","Salford 008C","E01005678","Total",1519,205,75,130,1314,195,88,273,212,82,168,296
"2011","Salford 008D","E01005679","Total",1594,200,63,137,1394,293,136,316,180,128,140,201
"2011","Salford 009A","E01005687","Total",1752,275,102,173,1477,184,140,399,294,55,134,271
"2011","Salford 009B","E01005689","Total",1438,178,65,113,1260,217,88,272,142,180,167,194
"2011","Salford 009C","E01005690","Total",1555,208,87,121,1347,90,192,301,244,82,134,304
"2011","Salford 009D","E01005693","Total",1402,165,78,87,1237,104,192,267,216,50,135,273
"2011","Salford 010A","E01005646","Total",1577,181,106,75,1396,25,106,171,158,360,462,114
"2011","Salford 010B","E01005649","Total",1676,268,130,138,1408,40,170,224,202,358,281,133
"2011","Salford 010C","E01005650","Total",1518,312,132,180,1206,56,52,139,120,268,422,149
"2011","Salford 010D","E01005651","Total",2028,102,35,67,1926,157,84,218,108,612,562,185
"2011","Salford 011A","E01005647","Total",1459,329,129,200,1130,46,136,153,182,248,198,167
"2011","Salford 011B","E01005648","Total",1783,350,88,262,1433,83,150,365,350,78,134,273
"2011","Salford 011C","E01005652","Total",1398,132,47,85,1266,156,106,231,194,133,187,259
"2011","Salford 011D","E01005653","Total",1518,173,67,106,1345,267,96,267,196,47,175,297
"2011","Salford 012A","E01005671","Total",1501,332,161,171,1169,131,116,299,216,82,117,208
"2011","Salford 012B","E01005674","Total",1374,164,71,93,1210,106,124,223,218,29,206,304
"2011","Salford 012C","E01005694","Total",1741,157,70,87,1584,135,150,494,246,63,189,307
"2011","Salford 012D","E01005696","Total",1521,154,69,85,1367,90,152,328,262,70,176,289
"2011","Salford 012E","E01005698","Total",1657,346,148,198,1311,217,158,252,206,86,196,196
"2011","Salford 012F","E01005700","Total",1497,205,71,134,1292,123,136,316,244,69,128,276
"2011","Salford 013A","E01005716","Total",1770,115,43,72,1655,50,178,490,260,66,225,386
"2011","Salford 013B","E01005717","Total",1568,80,16,64,1488,32,80,622,206,75,222,251
"2011","Salford 013C","E01005734","Total",1324,213,85,128,1111,84,154,271,246,31,111,214
"2011","Salford 013D","E01005735","Total",1393,140,71,69,1253,56,172,342,224,64,103,292
"2011","Salford 013E","E01005736","Total",1420,168,65,103,1252,68,188,302,272,40,117,265
"2011","Salford 013F","E01005737","Total",1507,127,75,52,1380,47,218,387,236,70,140,282
"2011","Salford 013G","E01005739","Total",1531,125,45,80,1406,78,150,467,266,78,130,237
"2011","Salford 014A","E01005695","Total",1578,130,72,58,1448,34,232,439,228,81,194,240
"2011","Salford 014B","E01005697","Total",1563,197,108,89,1366,61,200,409,236,83,95,282
"2011","Salford 014C","E01005738","Total",1725,213,105,108,1512,68,282,366,324,88,112,272
"2011","Salford 014D","E01005740","Total",1556,230,118,112,1326,27,240,383,264,60,124,228
"2011","Salford 014E","E01005741","Total",1635,172,103,69,1463,24,248,421,230,72,107,361
"2011","Salford 014F","E01005742","Total",1587,199,93,106,1388,95,202,321,210,96,174,290
"2011","Salford 015A","E01005625","Total",1329,204,104,100,1125,79,156,267,212,31,143,237
"2011","Salford 015B","E01005627","Total",1178,126,77,49,1052,42,128,212,162,84,156,268
"2011","Salford 015C","E01005699","Total",1494,184,90,94,1310,92,182,275,226,66,159,310
"2011","Salford 015D","E01005701","Total",1566,124,67,57,1442,107,222,299,234,53,188,339
"2011","Salford 016A","E01005609","Total",1750,360,66,294,1390,206,64,252,390,81,142,255
"2011","Salford 016B","E01005611","Total",1930,400,108,292,1530,222,90,255,266,59,171,467
"2011","Salford 016C","E01005612","Total",2038,608,216,392,1430,172,120,202,222,368,199,147
"2011","Salford 016D","E01005613","Total",2254,465,59,406,1789,247,96,342,210,278,336,280
"2011","Salford 016E","E01005614","Total",1940,144,46,98,1796,100,74,180,98,760,426,158
"2011","Salford 016F","E01005615","Total",1746,253,72,181,1493,163,76,216,200,198,179,461
"2011","Salford 017A","E01005624","Total",1669,208,75,133,1461,211,136,262,178,183,199,292
"2011","Salford 017B","E01005680","Total",1356,379,82,297,977,161,90,212,174,62,91,187
"2011","Salford 017C","E01005683","Total",1590,327,104,223,1263,243,124,286,220,83,130,177
"2011","Salford 017F","E01032919","Total",2178,317,111,206,1861,323,116,334,378,77,176,457
"2011","Salford 018A","E01005622","Total",1428,248,100,148,1180,121,94,316,258,60,97,234
"2011","Salford 018B","E01005623","Total",1255,115,48,67,1140,43,138,219,182,37,176,345
"2011","Salford 018C","E01005626","Total",1245,117,58,59,1128,39,144,276,208,45,115,301
"2011","Salford 018D","E01005628","Total",1544,258,71,187,1286,62,126,226,278,58,109,427
"2011","Salford 019A","E01005725","Total",1378,179,66,113,1199,175,96,234,156,141,197,200
"2011","Salford 019B","E01005726","Total",1500,190,67,123,1310,141,106,259,210,99,214,281
"2011","Salford 019C","E01005727","Total",1337,259,41,218,1078,110,94,246,280,43,104,201
"2011","Salford 019D","E01005728","Total",1351,165,99,66,1186,69,186,276,220,72,116,247
"2011","Salford 019E","E01005733","Total",1370,124,55,69,1246,166,120,160,120,164,167,349
"2011","Salford 020A","E01005631","Total",1479,736,298,438,743,28,106,157,246,26,62,118
"2011","Salford 020B","E01005632","Total",2092,369,92,277,1723,133,76,366,388,166,330,264
"2011","Salford 020C","E01005633","Total",1393,207,115,92,1186,88,130,183,172,87,240,286
"2011","Salford 020D","E01005634","Total",1472,133,50,83,1339,51,150,363,278,53,165,279
"2011","Salford 020E","E01005635","Total",1476,303,79,224,1173,21,138,268,240,36,150,320
"2011","Salford 020F","E01005636","Total",1533,237,101,136,1296,51,160,287,246,48,160,344
"2011","Salford 020G","E01005637","Total",1314,249,80,169,1065,90,114,266,210,30,106,249
"2011","Salford 021A","E01005629","Total",1306,256,125,131,1050,38,158,203,194,62,161,234
"2011","Salford 021B","E01005630","Total",1469,209,90,119,1260,152,122,292,240,70,124,260
"2011","Salford 021C","E01005719","Total",1725,454,181,273,1271,77,126,208,338,73,84,365
"2011","Salford 021D","E01005720","Total",2372,416,94,322,1956,341,130,312,536,98,198,341
"2011","Salford 021E","E01005722","Total",1762,221,84,137,1541,213,104,265,236,135,273,315
"2011","Salford 021F","E01005723","Total",1469,225,86,139,1244,209,90,224,178,83,168,292
"2011","Salford 021G","E01005724","Total",1418,227,126,101,1191,24,184,209,206,73,131,364
"2011","Salford 022D","E01005610","Total",1056,183,75,108,873,179,90,128,128,73,146,129
"2011","Salford 022E","E01032684","Total",1302,207,23,184,1095,70,30,122,444,35,44,350
"2011","Salford 022F","E01032687","Total",1284,265,13,252,1019,15,12,56,692,0,18,226
"2011","Salford 022G","E01032906","Total",1207,366,28,338,841,62,28,60,424,11,36,220
"2011","Salford 022H","E01032907","Total",1185,300,29,271,885,84,34,86,436,15,65,165
"2011","Salford 022I","E01032909","Total",1325,404,3,401,921,7,0,67,776,0,4,67
"2011","Salford 022J","E01032911","Total",1154,388,9,379,766,37,0,62,566,31,13,57
"2011","Salford 022K","E01033330","Total",1379,566,118,448,813,112,56,132,282,27,82,122
"2011","Salford 023A","E01005654","Total",1420,283,62,221,1137,178,60,150,508,40,40,161
"2011","Salford 023B","E01005656","Total",1497,192,61,131,1305,240,116,236,224,60,148,281
"2011","Salford 023C","E01005657","Total",1442,321,124,197,1121,125,134,209,200,66,105,282
"2011","Salford 023D","E01005721","Total",1436,376,155,221,1060,91,170,156,242,22,78,301
"2011","Salford 024A","E01005655","Total",1341,374,43,331,967,134,30,189,312,85,96,121
"2011","Salford 024B","E01005658","Total",1415,276,92,184,1139,256,98,220,168,42,169,186
"2011","Salford 024C","E01005681","Total",947,336,122,214,611,49,92,63,168,16,29,194
"2011","Salford 024D","E01005682","Total",1515,723,145,578,792,159,108,81,260,20,77,87
"2011","Salford 025A","E01005729","Total",1288,427,122,305,861,174,56,199,202,47,88,95
"2011","Salford 025B","E01005730","Total",1623,232,62,170,1391,146,118,274,288,115,171,279
"2011","Salford 025C","E01005731","Total",1594,150,61,89,1444,232,98,278,188,147,244,257
"2011","Salford 025D","E01005732","Total",1142,222,84,138,920,108,124,150,190,46,92,210
"2011","Salford 026A","E01005599","Total",1610,391,95,296,1219,98,114,255,278,138,113,223
"2011","Salford 026B","E01005600","Total",1467,181,46,135,1286,195,104,241,222,102,186,236
"2011","Salford 026C","E01005601","Total",1480,228,69,159,1252,203,104,271,244,77,163,190
"2011","Salford 026D","E01005602","Total",1352,416,101,315,936,156,78,236,254,25,93,94
"2011","Salford 027A","E01005603","Total",1580,176,50,126,1404,217,72,354,266,53,221,221
"2011","Salford 027B","E01005604","Total",1523,226,85,141,1297,193,152,282,260,42,102,266
"2011","Salford 027C","E01005605","Total",1368,253,76,177,1115,127,130,239,276,72,86,185
"2011","Salford 027D","E01005638","Total",1530,299,64,235,1231,209,102,308,302,55,101,154
"2011","Salford 028B","E01005667","Total",1828,372,103,269,1456,232,104,313,316,73,171,247
"2011","Salford 028E","E01032685","Total",1494,493,16,477,1001,24,22,114,718,5,5,113
"2011","Salford 028F","E01032686","Total",1396,439,9,430,957,6,16,72,726,0,8,129
"2011","Salford 028G","E01032912","Total",1481,372,98,274,1109,167,94,203,270,75,112,188
"2011","Salford 028H","E01032914","Total",1602,453,10,443,1149,70,14,169,674,0,48,174
"2011","Salford 028I","E01032915","Total",1547,256,83,173,1291,273,54,188,282,56,156,282
"2011","Salford 028J","E01032917","Total",1056,258,26,232,798,57,36,80,430,22,26,147
"2011","Salford 029A","E01005639","Total",1566,173,58,115,1393,322,96,309,142,191,166,167
"2011","Salford 029B","E01005640","Total",1456,125,53,72,1331,247,108,261,152,130,179,254
"2011","Salford 029C","E01005641","Total",1410,225,135,90,1185,121,154,256,212,74,116,252
"2011","Salford 029D","E01005642","Total",1227,137,48,89,1090,100,124,280,178,62,112,234
"2011","Salford 029E","E01005643","Total",1387,227,150,77,1160,83,304,202,228,37,112,194
"2011","Salford 029F","E01005644","Total",1583,144,30,114,1439,102,124,390,284,125,176,238
"2011","Salford 029G","E01005645","Total",1445,154,96,58,1291,42,246,254,186,73,146,344
"2011","Salford 030A","E01005616","Total",1461,202,86,116,1259,107,180,228,166,98,183,297
"2011","Salford 030B","E01005617","Total",1536,126,60,66,1410,112,170,316,256,88,189,279
"2011","Salford 030C","E01005618","Total",1485,227,99,128,1258,192,148,320,184,111,124,179
"2011","Salford 030D","E01005619","Total",1298,127,51,76,1171,136,130,166,206,81,174,278
"2011","Salford 030E","E01005620","Total",2531,318,86,232,2213,196,160,670,396,148,295,348
"2011","Salford 030F","E01005621","Total",1652,294,102,192,1358,150,130,312,286,82,178,220
"2011","Stockport 001A","E01005886","Total",1496,213,46,167,1283,194,72,315,218,73,150,261
"2011","Stockport 001B","E01005888","Total",1522,164,63,101,1358,121,118,311,154,112,242,300
"2011","Stockport 001C","E01005889","Total",1472,245,133,112,1227,126,182,244,232,69,147,227
"2011","Stockport 001D","E01005891","Total",1293,156,59,97,1137,54,182,177,236,49,130,309
"2011","Stockport 001E","E01005894","Total",1405,143,56,87,1262,111,154,313,182,79,159,264
"2011","Stockport 002A","E01005887","Total",1498,157,48,109,1341,227,80,332,192,123,152,235
"2011","Stockport 002B","E01005890","Total",1478,159,47,112,1319,125,124,326,164,159,199,222
"2011","Stockport 002C","E01005893","Total",1697,336,96,240,1361,186,124,262,350,73,118,248
"2011","Stockport 002D","E01005896","Total",1666,268,69,199,1398,189,100,381,324,50,108,246
"2011","Stockport 002E","E01005919","Total",1576,272,81,191,1304,289,112,252,208,82,178,183
"2011","Stockport 003A","E01005862","Total",1561,144,65,79,1417,52,134,381,214,84,226,326
"2011","Stockport 003B","E01005892","Total",1311,156,68,88,1155,105,150,268,218,64,131,219
"2011","Stockport 003C","E01005895","Total",1150,157,83,74,993,80,110,259,142,70,106,226
"2011","Stockport 003D","E01005920","Total",1562,159,82,77,1403,42,168,331,256,84,173,349
"2011","Stockport 003E","E01005921","Total",1392,269,105,164,1123,149,100,227,302,53,101,191
"2011","Stockport 003F","E01005922","Total",1406,195,84,111,1211,77,170,333,250,31,91,259
"2011","Stockport 004A","E01005753","Total",1633,197,86,111,1436,298,112,277,208,100,231,210
"2011","Stockport 004B","E01005754","Total",1791,513,100,413,1278,227,90,256,230,124,148,203
"2011","Stockport 004C","E01005755","Total",1635,227,72,155,1408,247,68,317,164,155,222,235
"2011","Stockport 004D","E01005756","Total",1548,369,44,325,1179,304,82,247,138,107,154,147
"2011","Stockport 005A","E01005745","Total",1433,166,55,111,1267,99,116,293,232,45,187,295
"2011","Stockport 005B","E01005746","Total",1394,423,215,208,971,48,180,187,210,34,142,170
"2011","Stockport 005C","E01005747","Total",1454,131,55,76,1323,68,166,331,236,41,181,300
"2011","Stockport 005D","E01005748","Total",1531,167,106,61,1364,37,320,279,218,31,172,307
"2011","Stockport 006A","E01005863","Total",1714,305,128,177,1409,53,142,300,280,101,200,333
"2011","Stockport 006B","E01005864","Total",1388,219,57,162,1169,32,110,349,282,89,111,196
"2011","Stockport 006C","E01005866","Total",1694,366,94,272,1328,72,102,318,338,63,178,257
"2011","Stockport 006D","E01005869","Total",1508,169,85,84,1339,47,176,328,200,86,158,344
"2011","Stockport 007A","E01005914","Total",1426,254,100,154,1172,80,154,319,242,53,109,215
"2011","Stockport 007B","E01005915","Total",1488,280,98,182,1208,157,114,307,280,25,115,210
"2011","Stockport 007C","E01005916","Total",1537,247,79,168,1290,151,132,273,296,45,144,249
"2011","Stockport 007D","E01005917","Total",1616,388,94,294,1228,209,82,219,312,86,93,227
"2011","Stockport 008A","E01005859","Total",1376,260,77,183,1116,35,96,266,220,112,171,216
"2011","Stockport 008B","E01005865","Total",1471,197,84,113,1274,38,244,254,188,72,214,264
"2011","Stockport 008C","E01005867","Total",1409,264,122,142,1145,37,174,274,222,71,165,202
"2011","Stockport 008D","E01005868","Total",1498,151,75,76,1347,57,162,341,170,128,221,268
"2011","Stockport 009A","E01005743","Total",1353,142,62,80,1211,67,258,265,194,35,161,231
"2011","Stockport 009B","E01005744","Total",1351,218,96,122,1133,86,146,211,204,55,192,239
"2011","Stockport 009C","E01005749","Total",1647,223,99,124,1424,84,146,380,318,56,164,276
"2011","Stockport 009D","E01005750","Total",1696,187,70,117,1509,126,128,427,306,83,168,271
"2011","Stockport 009E","E01005751","Total",1314,160,54,106,1154,137,110,305,284,50,82,186
"2011","Stockport 010A","E01005897","Total",1495,168,89,79,1327,140,116,339,180,78,212,262
"2011","Stockport 010B","E01005898","Total",1599,240,126,114,1359,72,248,293,244,86,168,248
"2011","Stockport 010C","E01005900","Total",1549,315,142,173,1234,80,224,301,244,56,103,226
"2011","Stockport 010D","E01005903","Total",1430,159,105,54,1271,18,312,264,222,64,133,258
"2011","Stockport 010E","E01005904","Total",1462,181,109,72,1281,50,200,347,204,92,136,252
"2011","Stockport 011A","E01005853","Total",1570,196,78,118,1374,149,108,332,238,115,169,263
"2011","Stockport 011B","E01005856","Total",1613,188,76,112,1425,80,150,309,264,106,218,298
"2011","Stockport 011C","E01005860","Total",1488,130,74,56,1358,65,158,432,202,86,126,289
"2011","Stockport 011D","E01005861","Total",1548,263,120,143,1285,54,182,348,248,58,137,258
"2011","Stockport 012A","E01005752","Total",1477,184,92,92,1293,179,138,346,174,78,131,247
"2011","Stockport 012B","E01005899","Total",1576,267,169,98,1309,97,276,271,224,88,111,242
"2011","Stockport 012C","E01005901","Total",1394,167,93,74,1227,34,294,212,206,76,113,292
"2011","Stockport 012D","E01005902","Total",1618,269,135,134,1349,193,154,292,202,99,176,233
"2011","Stockport 012E","E01005905","Total",1393,217,67,150,1176,195,106,259,194,118,137,167
"2011","Stockport 013A","E01005852","Total",1552,256,90,166,1296,55,146,254,290,95,174,282
"2011","Stockport 013B","E01005854","Total",1623,256,91,165,1367,69,174,367,288,70,112,287
"2011","Stockport 013C","E01005855","Total",1504,178,80,98,1326,34,126,319,204,104,232,307
"2011","Stockport 013D","E01005857","Total",1549,175,60,115,1374,54,110,300,212,150,246,302
"2011","Stockport 013E","E01005858","Total",1549,321,105,216,1228,68,152,319,374,31,96,188
"2011","Stockport 014A","E01005757","Total",1607,245,51,194,1362,155,114,354,260,128,160,191
"2011","Stockport 014B","E01005758","Total",1775,735,195,540,1040,151,126,180,342,24,81,136
"2011","Stockport 014C","E01005766","Total",1450,308,99,209,1142,124,76,183,262,36,187,274
"2011","Stockport 014D","E01005918","Total",1431,558,112,446,873,192,80,158,222,46,72,103
"2011","Stockport 015A","E01005870","Total",1364,162,58,104,1202,139,100,397,288,47,63,168
"2011","Stockport 015B","E01005871","Total",1337,192,51,141,1145,152,104,281,226,45,97,240
"2011","Stockport 015C","E01005873","Total",1489,135,70,65,1354,73,164,376,166,66,200,309
"2011","Stockport 015D","E01005875","Total",1559,163,62,101,1396,105,154,348,284,68,116,321
"2011","Stockport 016A","E01005764","Total",1616,259,90,169,1357,228,106,362,380,42,87,152
"2011","Stockport 016B","E01005816","Total",1600,200,60,140,1400,218,66,368,340,54,156,198
"2011","Stockport 016C","E01005817","Total",1343,235,64,171,1108,101,74,266,304,63,129,171
"2011","Stockport 016D","E01005822","Total",1505,500,109,391,1005,169,76,213,288,42,42,175
"2011","Stockport 017A","E01005880","Total",1488,184,100,84,1304,69,216,319,218,74,103,305
"2011","Stockport 017B","E01005881","Total",1278,88,54,34,1190,30,228,270,200,68,130,264
"2011","Stockport 017C","E01005883","Total",1536,164,87,77,1372,19,328,346,242,81,129,227
"2011","Stockport 017D","E01005908","Total",1475,102,60,42,1373,16,242,324,246,118,140,287
"2011","Stockport 018A","E01005765","Total",1383,152,65,87,1231,77,94,367,268,30,162,233
"2011","Stockport 018B","E01005818","Total",1422,158,38,120,1264,161,64,339,212,129,163,196
"2011","Stockport 018C","E01005819","Total",1547,170,69,101,1377,58,162,331,292,59,150,325
"2011","Stockport 018D","E01005820","Total",1402,226,84,142,1176,106,94,262,298,102,79,235
"2011","Stockport 018E","E01005821","Total",1489,229,84,145,1260,102,118,341,288,59,139,213
"2011","Stockport 018F","E01005823","Total",1632,214,60,154,1418,119,96,410,298,77,189,229
"2011","Stockport 019A","E01005825","Total",1502,256,85,171,1246,47,108,344,276,52,120,299
"2011","Stockport 019B","E01005872","Total",1699,296,82,214,1403,204,118,394,282,84,126,195
"2011","Stockport 019C","E01005874","Total",1672,493,134,359,1179,160,118,255,264,57,103,222
"2011","Stockport 019D","E01005876","Total",1479,149,64,85,1330,116,140,305,222,45,149,353
"2011","Stockport 019E","E01005877","Total",1401,196,93,103,1205,112,122,365,224,60,143,179
"2011","Stockport 020A","E01005878","Total",1435,234,157,77,1201,134,152,288,172,76,136,243
"2011","Stockport 020B","E01005879","Total",1302,203,110,93,1099,70,172,252,200,77,118,210
"2011","Stockport 020C","E01005882","Total",1258,80,53,27,1178,33,214,284,168,41,141,297
"2011","Stockport 020D","E01005884","Total",1494,105,74,31,1389,43,272,342,192,37,182,321
"2011","Stockport 020E","E01005885","Total",1303,277,151,126,1026,71,166,208,192,70,141,178
"2011","Stockport 021A","E01005832","Total",1472,194,97,97,1278,54,160,295,192,60,187,330
"2011","Stockport 021B","E01005833","Total",1026,171,111,60,855,37,118,204,142,46,128,180
"2011","Stockport 021C","E01005835","Total",1393,132,61,71,1261,52,188,269,216,64,146,326
"2011","Stockport 021D","E01005837","Total",1588,183,65,118,1405,88,144,364,292,69,172,276
"2011","Stockport 021E","E01005843","Total",1510,131,62,69,1379,40,190,323,290,56,139,341
"2011","Stockport 022A","E01005769","Total",1335,255,84,171,1080,62,68,261,370,36,98,185
"2011","Stockport 022B","E01005778","Total",1469,196,96,100,1273,71,136,335,248,36,129,318
"2011","Stockport 022C","E01005779","Total",1419,163,80,83,1256,67,124,321,212,92,151,289
"2011","Stockport 022D","E01005780","Total",1466,125,45,80,1341,77,84,424,222,81,182,271
"2011","Stockport 022E","E01005781","Total",1533,402,157,245,1131,205,160,236,210,46,101,173
"2011","Stockport 023A","E01005759","Total",1670,181,54,127,1489,110,128,380,296,119,154,302
"2011","Stockport 023B","E01005760","Total",1857,314,80,234,1543,232,76,406,310,118,183,218
"2011","Stockport 023C","E01005797","Total",1350,265,72,193,1085,123,68,295,312,27,78,182
"2011","Stockport 023D","E01005800","Total",1627,202,94,108,1425,84,182,352,280,106,109,312
"2011","Stockport 023E","E01005804","Total",1089,171,61,110,918,86,78,253,182,49,133,137
"2011","Stockport 024A","E01005824","Total",1474,175,95,80,1299,50,152,334,208,89,138,328
"2011","Stockport 024B","E01005826","Total",1411,195,92,103,1216,170,184,195,144,143,214,166
"2011","Stockport 024C","E01005827","Total",1390,168,98,70,1222,17,246,241,184,67,130,337
"2011","Stockport 024D","E01005828","Total",1285,219,72,147,1066,240,96,217,150,77,135,151
"2011","Stockport 024E","E01005829","Total",1272,128,55,73,1144,157,104,269,138,82,151,243
"2011","Stockport 025A","E01005768","Total",1609,146,86,60,1463,36,238,295,182,122,240,350
"2011","Stockport 025B","E01005770","Total",1429,229,134,95,1200,20,192,320,166,96,191,215
"2011","Stockport 025C","E01005771","Total",1376,137,66,71,1239,46,112,378,230,111,148,214
"2011","Stockport 025D","E01005775","Total",1527,179,103,76,1348,27,190,447,206,69,216,193
"2011","Stockport 026A","E01005761","Total",1402,152,64,88,1250,104,88,320,190,127,193,228
"2011","Stockport 026B","E01005762","Total",1588,229,116,113,1359,290,112,189,168,131,225,244
"2011","Stockport 026C","E01005763","Total",1646,170,55,115,1476,184,92,312,244,183,222,239
"2011","Stockport 026D","E01005799","Total",1804,191,33,158,1613,340,62,425,230,139,215,202
"2011","Stockport 027A","E01005798","Total",1494,401,182,219,1093,55,182,213,206,92,153,192
"2011","Stockport 027B","E01005801","Total",1446,195,82,113,1251,116,116,384,256,40,119,220
"2011","Stockport 027C","E01005802","Total",1529,135,60,75,1394,54,134,411,228,82,173,312
"2011","Stockport 027D","E01005803","Total",1488,158,101,57,1330,33,176,371,194,76,156,324
"2011","Stockport 027E","E01005830","Total",1473,270,124,146,1203,93,180,305,228,31,111,255
"2011","Stockport 027F","E01005831","Total",1539,194,72,122,1345,86,120,365,302,94,135,243
"2011","Stockport 028A","E01005767","Total",1476,151,103,48,1325,17,316,180,140,84,241,347
"2011","Stockport 028B","E01005772","Total",1466,170,103,67,1296,24,216,245,134,131,283,263
"2011","Stockport 028C","E01005773","Total",1523,197,107,90,1326,46,190,396,186,82,188,238
"2011","Stockport 028D","E01005774","Total",1387,322,168,154,1065,78,160,281,172,47,141,186
"2011","Stockport 028E","E01005776","Total",1571,165,106,59,1406,26,174,309,164,118,238,377
"2011","Stockport 029A","E01005909","Total",1552,153,94,59,1399,41,274,335,206,73,134,336
"2011","Stockport 029B","E01005910","Total",1533,268,134,134,1265,104,162,286,250,76,154,233
"2011","Stockport 029C","E01005911","Total",1280,135,86,49,1145,38,232,255,178,66,106,270
"2011","Stockport 029D","E01005912","Total",1366,163,80,83,1203,55,238,257,252,63,101,237
"2011","Stockport 030A","E01005782","Total",1218,173,85,88,1045,23,182,247,208,47,68,270
"2011","Stockport 030B","E01005783","Total",1541,168,90,78,1373,57,248,332,228,93,113,302
"2011","Stockport 030C","E01005784","Total",1393,110,67,43,1283,25,232,314,148,74,225,265
"2011","Stockport 030D","E01005785","Total",1535,191,94,97,1344,37,186,364,196,97,159,305
"2011","Stockport 030E","E01005786","Total",1589,142,85,57,1447,39,200,358,170,109,223,348
"2011","Stockport 031A","E01005834","Total",1505,207,90,117,1298,103,104,349,206,59,183,294
"2011","Stockport 031B","E01005836","Total",1830,297,138,159,1533,85,310,323,298,108,172,237
"2011","Stockport 031C","E01005838","Total",1707,352,118,234,1355,158,140,373,312,93,45,234
"2011","Stockport 031D","E01005840","Total",1525,298,128,170,1227,99,150,281,252,75,130,240
"2011","Stockport 032A","E01005927","Total",1352,70,42,28,1282,43,150,364,188,85,162,290
"2011","Stockport 032B","E01005928","Total",1572,190,94,96,1382,176,196,282,228,105,145,250
"2011","Stockport 032C","E01005929","Total",1349,202,107,95,1147,18,254,286,174,73,115,227
"2011","Stockport 032D","E01005930","Total",1560,105,67,38,1455,15,292,311,222,115,242,258
"2011","Stockport 033A","E01005806","Total",1215,107,71,36,1108,30,200,321,164,52,107,234
"2011","Stockport 033B","E01005813","Total",1441,173,80,93,1268,45,188,271,224,86,139,315
"2011","Stockport 033C","E01005814","Total",1326,131,93,38,1195,31,266,231,138,56,176,297
"2011","Stockport 033D","E01005815","Total",1470,120,82,38,1350,73,228,390,210,78,146,225
"2011","Stockport 034A","E01005777","Total",1486,235,111,124,1251,81,236,309,210,49,127,239
"2011","Stockport 034B","E01005787","Total",1299,76,52,24,1223,12,188,234,146,96,209,338
"2011","Stockport 034C","E01005788","Total",1521,147,68,79,1374,64,190,405,180,94,139,302
"2011","Stockport 034D","E01005790","Total",1219,174,83,91,1045,78,60,261,174,61,164,247
"2011","Stockport 035A","E01005805","Total",1538,134,97,37,1404,37,170,447,190,76,138,346
"2011","Stockport 035B","E01005807","Total",1562,132,100,32,1430,30,278,324,192,75,179,352
"2011","Stockport 035C","E01005839","Total",1316,92,54,38,1224,25,256,249,190,72,164,268
"2011","Stockport 035D","E01005841","Total",1520,153,83,70,1367,81,256,328,192,78,195,237
"2011","Stockport 036A","E01005844","Total",1430,149,97,52,1281,48,240,171,138,77,298,309
"2011","Stockport 036B","E01005845","Total",1621,141,97,44,1480,40,204,240,184,101,299,412
"2011","Stockport 036C","E01005849","Total",1571,133,87,46,1438,35,238,248,186,130,196,405
"2011","Stockport 036D","E01005851","Total",1524,161,96,65,1363,29,264,243,162,82,259,324
"2011","Stockport 037A","E01005808","Total",1366,98,70,28,1268,61,200,333,166,82,147,279
"2011","Stockport 037B","E01005809","Total",1263,109,53,56,1154,66,184,298,132,81,110,283
"2011","Stockport 037C","E01005810","Total",1475,201,115,86,1274,59,254,313,216,58,133,241
"2011","Stockport 037D","E01005811","Total",1402,221,84,137,1181,32,152,293,236,74,103,291
"2011","Stockport 037E","E01005812","Total",1289,75,52,23,1214,17,196,287,176,124,154,260
"2011","Stockport 038A","E01005842","Total",1620,163,100,63,1457,50,280,364,230,99,126,308
"2011","Stockport 038B","E01005906","Total",1438,173,131,42,1265,7,364,229,232,68,136,229
"2011","Stockport 038C","E01005907","Total",1276,188,121,67,1088,43,352,220,174,49,56,194
"2011","Stockport 038D","E01005913","Total",1441,198,124,74,1243,37,268,293,224,72,115,234
"2011","Stockport 039A","E01005789","Total",1559,205,89,116,1354,24,182,426,204,93,171,254
"2011","Stockport 039B","E01005791","Total",1543,183,102,81,1360,59,198,367,208,82,143,303
"2011","Stockport 039C","E01005793","Total",1423,182,89,93,1241,64,200,292,240,40,137,268
"2011","Stockport 039D","E01005795","Total",1290,129,71,58,1161,50,200,265,170,81,124,271
"2011","Stockport 039E","E01005796","Total",1260,109,64,45,1151,40,148,379,164,46,96,278
"2011","Stockport 040A","E01005846","Total",1659,143,75,68,1516,33,202,324,200,139,317,301
"2011","Stockport 040B","E01005847","Total",1553,163,72,91,1390,52,180,311,198,80,204,365
"2011","Stockport 040C","E01005848","Total",1773,185,114,71,1588,79,244,340,256,88,173,408
"2011","Stockport 040D","E01005850","Total",1759,244,120,124,1515,103,182,316,264,75,263,312
"2011","Stockport 041A","E01005792","Total",1462,143,96,47,1319,34,266,295,200,96,135,293
"2011","Stockport 041B","E01005794","Total",1241,130,84,46,1111,32,166,264,168,26,167,288
"2011","Stockport 041C","E01005923","Total",1532,128,90,38,1404,24,348,363,182,80,176,231
"2011","Stockport 041D","E01005931","Total",1445,199,140,59,1246,52,280,283,204,71,152,204
"2011","Stockport 042A","E01005924","Total",1308,134,86,48,1174,32,208,324,144,86,152,228
"2011","Stockport 042B","E01005925","Total",1377,203,158,45,1174,32,232,323,176,55,146,210
"2011","Stockport 042C","E01005926","Total",1249,94,58,36,1155,44,192,242,192,93,155,237
"2011","Stockport 042D","E01005932","Total",1385,78,56,22,1307,25,246,312,212,76,159,277
"2011","Tameside 001A","E01006053","Total",1864,236,59,177,1628,75,156,479,408,84,121,305
"2011","Tameside 001B","E01006054","Total",1582,316,141,175,1266,111,180,239,240,129,148,219
"2011","Tameside 001C","E01006055","Total",1387,203,43,160,1184,63,110,339,332,58,71,211
"2011","Tameside 001D","E01006057","Total",1514,172,58,114,1342,140,112,343,326,57,108,256
"2011","Tameside 001E","E01006058","Total",1887,397,110,287,1490,121,126,377,428,57,165,216
"2011","Tameside 001F","E01006059","Total",1413,171,49,122,1242,69,160,356,264,63,125,205
"2011","Tameside 002A","E01005938","Total",1638,191,81,110,1447,89,180,304,218,136,207,313
"2011","Tameside 002B","E01005939","Total",1305,95,56,39,1210,40,220,173,148,30,257,342
"2011","Tameside 002C","E01005940","Total",1494,155,92,63,1339,51,210,256,170,90,178,384
"2011","Tameside 002D","E01005955","Total",1710,111,56,55,1599,61,160,361,264,121,254,378
"2011","Tameside 003A","E01006056","Total",1190,165,56,109,1025,156,82,244,156,92,157,138
"2011","Tameside 003B","E01006061","Total",2383,261,85,176,2122,226,150,553,336,171,315,371
"2011","Tameside 003C","E01006062","Total",2114,145,60,85,1969,67,198,582,368,148,189,417
"2011","Tameside 003D","E01006063","Total",1463,111,41,70,1352,54,120,327,246,45,219,341
"2011","Tameside 004A","E01005936","Total",1487,159,65,94,1328,66,210,278,272,47,159,296
"2011","Tameside 004B","E01005937","Total",1516,214,96,118,1302,207,194,312,206,56,108,219
"2011","Tameside 004C","E01005945","Total",1931,226,66,160,1705,253,112,342,202,224,304,268
"2011","Tameside 004D","E01005946","Total",1605,204,64,140,1401,109,90,396,252,73,166,315
"2011","Tameside 004E","E01005947","Total",1581,311,105,206,1270,157,84,360,254,72,157,186
"2011","Tameside 005A","E01005954","Total",1458,387,201,186,1071,60,188,185,222,42,143,231
"2011","Tameside 005B","E01005956","Total",1387,146,83,63,1241,47,148,233,250,33,204,326
"2011","Tameside 005C","E01005957","Total",1449,164,72,92,1285,72,136,327,214,100,169,267
"2011","Tameside 005D","E01005958","Total",1456,230,88,142,1226,152,130,296,202,91,119,236
"2011","Tameside 005E","E01005959","Total",1705,166,71,95,1539,185,128,334,176,110,247,359
"2011","Tameside 006A","E01005933","Total",1467,136,43,93,1331,174,78,273,156,140,244,266
"2011","Tameside 006B","E01005934","Total",1479,144,64,80,1335,130,162,283,266,64,178,252
"2011","Tameside 006C","E01005935","Total",1433,251,124,127,1182,165,100,230,218,110,156,203
"2011","Tameside 006D","E01005949","Total",1530,271,121,150,1259,82,116,255,314,70,177,245
"2011","Tameside 006E","E01005960","Total",1602,282,93,189,1320,180,86,315,230,85,165,259
"2011","Tameside 007A","E01005941","Total",1612,288,71,217,1324,128,122,311,234,108,224,197
"2011","Tameside 007B","E01005942","Total",1649,184,81,103,1465,95,180,370,310,52,204,254
"2011","Tameside 007C","E01005943","Total",1777,287,83,204,1490,112,158,341,380,72,194,233
"2011","Tameside 007D","E01005944","Total",1402,125,50,75,1277,41,138,302,234,100,162,300
"2011","Tameside 008A","E01006060","Total",1396,299,73,226,1097,154,84,252,230,60,130,187
"2011","Tameside 008B","E01006064","Total",1551,287,151,136,1264,180,182,214,204,82,174,228
"2011","Tameside 008C","E01006065","Total",1357,105,40,65,1252,211,62,277,160,124,200,218
"2011","Tameside 008D","E01006066","Total",1331,200,67,133,1131,109,94,323,236,35,122,212
"2011","Tameside 009A","E01006067","Total",1839,169,57,112,1670,67,118,455,334,111,223,362
"2011","Tameside 009B","E01006068","Total",1549,403,148,255,1146,85,112,335,340,51,65,158
"2011","Tameside 009C","E01006069","Total",1667,175,62,113,1492,228,104,294,204,111,245,306
"2011","Tameside 009D","E01006073","Total",1685,236,58,178,1449,208,80,364,256,151,158,232
"2011","Tameside 010A","E01005993","Total",1411,195,94,101,1216,75,174,252,210,52,162,291
"2011","Tameside 010B","E01005995","Total",1421,77,32,45,1344,40,100,310,202,40,250,402
"2011","Tameside 010C","E01005996","Total",1939,218,72,146,1721,206,144,439,322,91,201,318
"2011","Tameside 010D","E01005997","Total",1459,257,115,142,1202,106,140,220,192,68,173,303
"2011","Tameside 010E","E01006000","Total",1510,425,230,195,1085,91,186,168,194,34,124,288
"2011","Tameside 011A","E01005994","Total",1449,158,66,92,1291,146,108,343,232,46,138,278
"2011","Tameside 011B","E01005999","Total",1857,304,119,185,1553,186,140,373,270,95,207,282
"2011","Tameside 011C","E01006002","Total",1368,164,98,66,1204,81,150,214,138,110,194,317
"2011","Tameside 011D","E01006004","Total",1544,129,72,57,1415,57,196,287,190,77,238,370
"2011","Tameside 011E","E01006005","Total",1307,251,92,159,1056,171,122,240,202,46,117,158
"2011","Tameside 011F","E01006007","Total",1508,194,71,123,1314,142,128,314,246,41,196,247
"2011","Tameside 012A","E01005998","Total",1703,209,61,148,1494,138,152,354,304,87,168,291
"2011","Tameside 012B","E01006001","Total",1559,175,88,87,1384,136,152,265,246,58,250,277
"2011","Tameside 012C","E01006003","Total",1450,181,78,103,1269,99,152,257,226,81,159,295
"2011","Tameside 012D","E01006006","Total",1472,142,77,65,1330,76,160,288,248,50,168,340
"2011","Tameside 013A","E01005948","Total",1769,557,65,492,1212,117,80,242,282,127,184,180
"2011","Tameside 013B","E01005950","Total",1923,109,26,83,1814,128,80,328,158,281,570,269
"2011","Tameside 013C","E01005951","Total",1579,280,86,194,1299,172,104,343,246,101,104,229
"2011","Tameside 013D","E01005952","Total",2150,713,101,612,1437,157,96,243,278,186,224,253
"2011","Tameside 013E","E01005953","Total",2020,273,120,153,1747,155,122,368,176,260,337,329
"2011","Tameside 014A","E01005961","Total",1373,127,61,66,1246,75,150,266,260,46,160,289
"2011","Tameside 014B","E01005962","Total",1457,169,108,61,1288,52,156,301,190,84,188,317
"2011","Tameside 014C","E01005968","Total",1446,179,74,105,1267,55,182,281,234,56,142,317
"2011","Tameside 014D","E01005969","Total",1381,149,93,56,1232,62,160,235,218,52,184,321
"2011","Tameside 015A","E01006022","Total",1616,318,118,200,1298,48,168,283,336,67,121,275
"2011","Tameside 015B","E01006023","Total",1545,355,100,255,1190,121,134,294,272,49,93,227
"2011","Tameside 015C","E01006070","Total",1422,178,55,123,1244,85,156,298,272,74,103,256
"2011","Tameside 015D","E01006071","Total",1586,118,75,43,1468,22,322,240,280,92,120,392
"2011","Tameside 015E","E01006072","Total",1685,121,56,65,1564,58,204,351,310,56,175,410
"2011","Tameside 016A","E01006009","Total",1348,156,61,95,1192,78,142,279,212,32,151,298
"2011","Tameside 016B","E01006017","Total",1416,80,33,47,1336,41,184,406,206,49,170,280
"2011","Tameside 016C","E01006018","Total",1366,117,74,43,1249,25,224,225,222,94,135,324
"2011","Tameside 016D","E01006021","Total",1365,187,92,95,1178,81,174,287,222,77,88,249
"2011","Tameside 017A","E01006008","Total",1455,158,32,126,1297,135,82,417,288,51,128,196
"2011","Tameside 017B","E01006010","Total",1381,277,137,140,1104,170,106,237,234,61,145,151
"2011","Tameside 017C","E01006012","Total",1791,224,75,149,1567,140,174,383,342,72,179,277
"2011","Tameside 017D","E01006015","Total",1415,97,31,66,1318,48,110,361,218,74,221,286
"2011","Tameside 017E","E01006016","Total",1737,542,137,405,1195,157,94,269,320,70,126,159
"2011","Tameside 018A","E01006011","Total",1634,224,94,130,1410,160,148,236,214,108,290,254
"2011","Tameside 018B","E01006013","Total",1281,153,79,74,1128,68,182,238,204,47,146,243
"2011","Tameside 018C","E01006014","Total",1302,91,28,63,1211,159,80,227,204,99,218,224
"2011","Tameside 018D","E01006019","Total",1476,415,143,272,1061,94,158,263,206,58,76,206
"2011","Tameside 018E","E01006020","Total",1496,166,98,68,1330,127,154,316,160,97,179,297
"2011","Tameside 019A","E01005963","Total",1222,137,56,81,1085,71,114,252,202,58,160,228
"2011","Tameside 019B","E01005964","Total",1516,190,67,123,1326,93,150,333,254,68,105,323
"2011","Tameside 019C","E01005965","Total",1394,258,86,172,1136,139,140,235,222,52,160,188
"2011","Tameside 019D","E01005966","Total",1355,140,40,100,1215,107,74,273,200,81,248,232
"2011","Tameside 019E","E01005967","Total",1381,329,129,200,1052,127,94,208,196,63,151,213
"2011","Tameside 020A","E01006031","Total",1496,261,99,162,1235,150,100,241,202,131,192,219
"2011","Tameside 020B","E01006032","Total",1330,179,54,125,1151,101,96,242,180,140,186,206
"2011","Tameside 020C","E01006033","Total",1360,246,57,189,1114,119,98,250,226,77,123,221
"2011","Tameside 020D","E01006034","Total",2143,303,104,199,1840,217,130,522,366,162,177,266
"2011","Tameside 020E","E01006035","Total",1970,404,138,266,1566,135,142,372,368,91,172,286
"2011","Tameside 020F","E01006036","Total",1953,271,75,196,1682,188,110,390,326,197,231,240
"2011","Tameside 021A","E01005970","Total",1464,205,97,108,1259,23,220,224,236,68,132,356
"2011","Tameside 021B","E01005972","Total",1680,214,54,160,1466,205,130,377,294,50,165,245
"2011","Tameside 021C","E01005974","Total",1563,292,107,185,1271,139,132,314,250,41,194,201
"2011","Tameside 021D","E01005975","Total",1562,219,75,144,1343,129,134,298,244,72,178,288
"2011","Tameside 022A","E01006024","Total",1809,115,52,63,1694,72,172,425,272,84,243,426
"2011","Tameside 022B","E01006026","Total",1569,272,104,168,1297,101,152,349,292,74,113,216
"2011","Tameside 022C","E01006037","Total",1498,117,52,65,1381,51,186,384,266,58,105,331
"2011","Tameside 022D","E01006038","Total",1594,155,65,90,1439,96,206,343,240,78,160,316
"2011","Tameside 023A","E01006047","Total",1341,166,57,109,1175,99,158,215,214,92,181,216
"2011","Tameside 023B","E01006048","Total",1484,295,154,141,1189,48,210,265,254,58,88,266
"2011","Tameside 023C","E01006049","Total",1525,246,100,146,1279,77,214,279,276,54,133,246
"2011","Tameside 023D","E01006051","Total",1645,240,88,152,1405,90,174,320,330,95,136,260
"2011","Tameside 024A","E01005985","Total",1530,248,164,84,1282,68,298,288,170,59,114,285
"2011","Tameside 024B","E01005987","Total",1547,243,158,85,1304,68,234,246,248,52,136,320
"2011","Tameside 024C","E01005988","Total",1601,150,81,69,1451,61,200,331,214,105,215,325
"2011","Tameside 024D","E01005990","Total",1344,226,130,96,1118,69,192,211,174,50,146,276
"2011","Tameside 024E","E01005991","Total",1466,191,98,93,1275,86,146,326,190,64,140,323
"2011","Tameside 025A","E01005971","Total",1406,205,74,131,1201,135,158,231,214,76,125,262
"2011","Tameside 025B","E01005986","Total",1246,176,64,112,1070,99,98,239,148,94,138,254
"2011","Tameside 025C","E01005989","Total",1220,124,66,58,1096,22,194,216,196,36,172,260
"2011","Tameside 025D","E01005992","Total",1289,220,86,134,1069,119,104,274,200,74,91,207
"2011","Tameside 026A","E01005973","Total",1426,142,63,79,1284,66,200,259,236,61,157,305
"2011","Tameside 026B","E01005976","Total",1512,224,98,126,1288,91,118,273,146,102,282,276
"2011","Tameside 026C","E01005977","Total",1481,191,85,106,1290,74,190,291,274,42,159,260
"2011","Tameside 026D","E01005978","Total",1377,175,79,96,1202,146,130,244,256,59,157,210
"2011","Tameside 027A","E01006025","Total",1418,187,81,106,1231,167,126,252,188,129,186,183
"2011","Tameside 027B","E01006027","Total",1409,231,85,146,1178,205,128,191,180,107,197,170
"2011","Tameside 027C","E01006050","Total",1707,306,127,179,1401,296,152,275,208,89,117,264
"2011","Tameside 027D","E01006052","Total",1537,238,103,135,1299,121,144,285,180,115,194,260
"2011","Tameside 028A","E01006028","Total",1762,420,221,199,1342,200,158,275,244,69,173,223
"2011","Tameside 028B","E01006029","Total",1836,224,56,168,1612,136,80,420,250,190,311,225
"2011","Tameside 028C","E01006030","Total",1756,236,68,168,1520,158,106,344,290,109,199,314
"2011","Tameside 028D","E01006039","Total",1370,100,27,73,1270,76,112,163,120,167,424,208
"2011","Tameside 028E","E01006040","Total",1618,168,33,135,1450,93,68,238,202,194,452,203
"2011","Tameside 028F","E01006041","Total",1597,217,68,149,1380,130,96,368,242,141,202,201
"2011","Tameside 029A","E01005979","Total",1612,296,150,146,1316,61,296,205,240,111,135,268
"2011","Tameside 029B","E01005980","Total",1432,213,79,134,1219,188,152,275,208,70,150,176
"2011","Tameside 029C","E01005981","Total",1529,378,238,140,1151,144,206,181,200,61,171,188
"2011","Tameside 029D","E01005982","Total",1347,173,71,102,1174,105,208,241,178,76,136,230
"2011","Tameside 029E","E01005983","Total",1616,199,101,98,1417,70,250,345,254,46,163,289
"2011","Tameside 029F","E01005984","Total",1517,359,112,247,1158,174,140,248,212,93,97,194
"2011","Tameside 030A","E01006042","Total",1638,262,103,159,1376,109,178,353,332,46,134,224
"2011","Tameside 030B","E01006043","Total",1466,182,101,81,1284,125,148,311,172,63,167,298
"2011","Tameside 030C","E01006044","Total",1350,209,104,105,1141,56,214,245,192,51,151,232
"2011","Tameside 030D","E01006045","Total",1264,127,77,50,1137,35,216,270,208,25,97,286
"2011","Tameside 030E","E01006046","Total",1439,153,76,77,1286,44,232,382,234,53,103,238
"2011","Trafford 001A","E01006109","Total",1427,470,60,410,957,160,46,247,184,99,110,111
"2011","Trafford 001B","E01006110","Total",1775,171,61,110,1604,185,106,289,256,161,329,278
"2011","Trafford 001C","E01006111","Total",1720,149,38,111,1571,210,38,260,130,215,447,271
"2011","Trafford 001D","E01006112","Total",1704,148,69,79,1556,104,62,212,166,154,523,335
"2011","Trafford 001E","E01006185","Total",1966,513,81,432,1453,177,70,216,420,83,262,225
"2011","Trafford 001F","E01006188","Total",1553,163,32,131,1390,96,60,291,178,164,325,276
"2011","Trafford 002A","E01006116","Total",1350,111,53,58,1239,92,148,353,198,72,145,231
"2011","Trafford 002B","E01006117","Total",1672,117,68,49,1555,40,226,413,200,92,209,375
"2011","Trafford 002C","E01006118","Total",1428,199,111,88,1229,73,152,334,152,51,193,274
"2011","Trafford 002D","E01006119","Total",1608,134,76,58,1474,42,198,379,250,60,169,376
"2011","Trafford 002E","E01006121","Total",1540,123,52,71,1417,141,154,313,252,62,188,307
"2011","Trafford 003A","E01006141","Total",1604,133,56,77,1471,94,112,313,206,172,291,283
"2011","Trafford 003B","E01006186","Total",1900,238,84,154,1662,185,88,359,378,142,226,284
"2011","Trafford 003C","E01006187","Total",2528,406,87,319,2122,278,108,545,496,83,208,404
"2011","Trafford 003D","E01006189","Total",2235,259,72,187,1976,227,170,448,350,154,277,350
"2011","Trafford 004A","E01006113","Total",1524,89,46,43,1435,47,100,222,96,128,443,399
"2011","Trafford 004B","E01006114","Total",1651,158,69,89,1493,99,126,154,144,169,427,374
"2011","Trafford 004C","E01006115","Total",1583,226,81,145,1357,76,94,197,204,93,375,318
"2011","Trafford 004D","E01006145","Total",1781,221,109,112,1560,155,120,244,174,178,397,292
"2011","Trafford 004E","E01006146","Total",1894,139,78,61,1755,113,140,311,216,158,437,380
"2011","Trafford 005A","E01006122","Total",1553,187,125,62,1366,33,312,262,196,81,190,292
"2011","Trafford 005B","E01006123","Total",1669,142,85,57,1527,91,242,333,216,119,213,313
"2011","Trafford 005C","E01006124","Total",1473,141,96,45,1332,38,196,316,220,66,149,347
"2011","Trafford 005D","E01006128","Total",1739,199,105,94,1540,66,152,510,274,67,178,293
"2011","Trafford 005E","E01006131","Total",1566,187,84,103,1379,57,190,356,200,107,187,282
"2011","Trafford 006A","E01006155","Total",1606,169,69,100,1437,80,148,417,300,83,141,268
"2011","Trafford 006B","E01006157","Total",1557,151,52,99,1406,84,106,364,210,88,187,367
"2011","Trafford 006C","E01006159","Total",1804,206,87,119,1598,265,98,366,220,154,222,273
"2011","Trafford 006D","E01006182","Total",1532,124,74,50,1408,93,164,277,222,103,144,405
"2011","Trafford 006E","E01006183","Total",1650,145,69,76,1505,51,188,356,198,88,250,374
"2011","Trafford 007A","E01006125","Total",1484,148,71,77,1336,63,228,309,176,43,167,350
"2011","Trafford 007B","E01006126","Total",1665,231,109,122,1434,119,166,319,230,110,207,283
"2011","Trafford 007C","E01006127","Total",1616,128,53,75,1488,105,154,339,274,88,212,316
"2011","Trafford 007D","E01006130","Total",1777,211,105,106,1566,59,206,420,302,52,254,273
"2011","Trafford 007E","E01006132","Total",1566,217,111,106,1349,65,152,384,214,94,128,312
"2011","Trafford 008A","E01006156","Total",1593,208,73,135,1385,131,160,300,228,109,202,255
"2011","Trafford 008B","E01006158","Total",1645,301,91,210,1344,173,144,292,258,95,157,225
"2011","Trafford 008C","E01006179","Total",1717,404,132,272,1313,121,138,200,272,105,160,317
"2011","Trafford 008D","E01006184","Total",1674,256,115,141,1418,125,168,305,224,106,203,287
"2011","Trafford 009A","E01006198","Total",1476,261,93,168,1215,73,94,324,228,56,162,278
"2011","Trafford 009B","E01006199","Total",1570,262,93,169,1308,152,124,292,330,57,133,220
"2011","Trafford 009C","E01006200","Total",1364,295,172,123,1069,58,192,210,188,82,114,225
"2011","Trafford 009D","E01006201","Total",1486,241,91,150,1245,77,96,394,236,60,141,241
"2011","Trafford 009E","E01006202","Total",1356,245,63,182,1111,40,126,313,220,43,145,224
"2011","Trafford 010A","E01006120","Total",1409,118,74,44,1291,34,210,309,196,74,177,291
"2011","Trafford 010B","E01006129","Total",1329,226,123,103,1103,100,212,272,200,35,97,187
"2011","Trafford 010C","E01006133","Total",1434,203,108,95,1231,29,266,251,250,37,107,291
"2011","Trafford 010D","E01006197","Total",1526,154,94,60,1372,76,142,406,200,86,204,258
"2011","Trafford 010E","E01006203","Total",1362,97,57,40,1265,26,122,337,210,81,164,325
"2011","Trafford 011A","E01006142","Total",1659,311,151,160,1348,118,136,288,194,99,214,299
"2011","Trafford 011B","E01006143","Total",1659,243,112,131,1416,70,148,281,264,112,202,339
"2011","Trafford 011C","E01006144","Total",1444,318,136,182,1126,176,96,253,232,76,79,214
"2011","Trafford 011D","E01006180","Total",1827,248,46,202,1579,174,94,354,382,66,194,315
"2011","Trafford 011E","E01006181","Total",1651,194,100,94,1457,97,136,315,226,109,241,333
"2011","Trafford 012A","E01006147","Total",1415,114,71,43,1301,43,170,368,182,114,157,267
"2011","Trafford 012B","E01006149","Total",1485,221,126,95,1264,47,168,455,234,67,128,165
"2011","Trafford 012C","E01006150","Total",1534,271,112,159,1263,45,158,310,270,140,112,228
"2011","Trafford 012D","E01006154","Total",1501,182,55,127,1319,45,70,455,322,97,119,211
"2011","Trafford 012E","E01006165","Total",1914,272,73,199,1642,121,106,455,500,47,172,241
"2011","Trafford 013A","E01006166","Total",1567,227,81,146,1340,144,138,304,256,52,132,314
"2011","Trafford 013B","E01006169","Total",1634,176,87,89,1458,60,220,378,242,77,191,290
"2011","Trafford 013C","E01006170","Total",1550,224,135,89,1326,58,158,408,262,68,132,240
"2011","Trafford 013D","E01006171","Total",1796,299,106,193,1497,218,128,336,230,92,217,276
"2011","Trafford 014A","E01006098","Total",1260,112,60,52,1148,24,208,326,206,79,125,180
"2011","Trafford 014B","E01006099","Total",1352,149,63,86,1203,60,130,346,212,70,142,243
"2011","Trafford 014C","E01006164","Total",1650,215,130,85,1435,40,244,371,268,78,130,304
"2011","Trafford 014D","E01006174","Total",1738,297,101,196,1441,47,224,389,326,100,133,222
"2011","Trafford 014E","E01006178","Total",1821,224,103,121,1597,56,204,428,340,83,165,321
"2011","Trafford 015A","E01006097","Total",1733,340,151,189,1393,63,260,324,326,106,111,203
"2011","Trafford 015B","E01006160","Total",1753,485,214,271,1268,58,142,316,408,52,98,194
"2011","Trafford 015C","E01006161","Total",1909,347,101,246,1562,50,170,500,382,92,134,234
"2011","Trafford 015D","E01006162","Total",1615,246,85,161,1369,22,104,440,292,60,167,284
"2011","Trafford 015E","E01006163","Total",1788,266,50,216,1522,96,100,450,464,87,121,204
"2011","Trafford 016A","E01006148","Total",1575,211,94,117,1364,56,224,291,252,92,150,299
"2011","Trafford 016B","E01006151","Total",1479,117,68,49,1362,17,204,332,172,103,185,349
"2011","Trafford 016C","E01006152","Total",1636,113,74,39,1523,19,288,292,208,142,246,328
"2011","Trafford 016D","E01006153","Total",1568,161,110,51,1407,28,264,335,184,75,167,354
"2011","Trafford 016E","E01006172","Total",1524,214,131,83,1310,22,294,270,188,76,146,314
"2011","Trafford 017A","E01006104","Total",1654,237,98,139,1417,122,226,248,282,96,170,273
"2011","Trafford 017B","E01006105","Total",1933,219,60,159,1714,478,122,331,198,209,121,255
"2011","Trafford 017C","E01006106","Total",1485,170,75,95,1315,187,132,223,218,92,176,287
"2011","Trafford 017D","E01006107","Total",1618,250,130,120,1368,150,176,249,264,118,173,238
"2011","Trafford 017E","E01006108","Total",1670,216,46,170,1454,401,62,301,178,134,165,213
"2011","Trafford 018A","E01006102","Total",1368,167,111,56,1201,67,156,371,180,78,140,209
"2011","Trafford 018B","E01006173","Total",1516,143,77,66,1373,21,198,374,214,91,158,317
"2011","Trafford 018C","E01006175","Total",1613,277,170,107,1336,217,154,245,246,79,168,227
"2011","Trafford 018D","E01006176","Total",1789,215,104,111,1574,117,210,352,276,87,180,352
"2011","Trafford 018E","E01006177","Total",1645,139,55,84,1506,175,94,375,198,133,291,240
"2011","Trafford 019A","E01006091","Total",2287,257,43,214,2030,122,72,759,554,83,178,262
"2011","Trafford 019B","E01006092","Total",1355,129,41,88,1226,183,60,300,162,121,137,263
"2011","Trafford 019C","E01006095","Total",1629,182,61,121,1447,65,156,403,286,62,174,301
"2011","Trafford 019D","E01006167","Total",1632,321,93,228,1311,221,152,271,182,65,174,246
"2011","Trafford 019E","E01006168","Total",1919,302,73,229,1617,371,78,412,232,120,189,215
"2011","Trafford 020A","E01006090","Total",1964,296,62,234,1668,84,188,483,432,62,106,313
"2011","Trafford 020B","E01006094","Total",1486,147,109,38,1339,14,160,413,198,97,126,331
"2011","Trafford 020C","E01006096","Total",1532,101,48,53,1431,38,142,467,196,128,170,290
"2011","Trafford 020D","E01006100","Total",1501,168,90,78,1333,34,134,355,242,108,174,286
"2011","Trafford 020E","E01006103","Total",1618,103,61,42,1515,50,148,508,244,71,174,320
"2011","Trafford 021A","E01006101","Total",1522,81,47,34,1441,24,194,484,212,88,146,293
"2011","Trafford 021B","E01006190","Total",1664,129,70,59,1535,16,202,449,254,103,164,347
"2011","Trafford 021C","E01006195","Total",1771,107,64,43,1664,41,212,460,230,109,231,381
"2011","Trafford 021D","E01006196","Total",1784,145,68,77,1639,48,164,533,266,73,181,374
"2011","Trafford 021E","E01006210","Total",1656,183,82,101,1473,53,186,445,222,134,133,300
"2011","Trafford 022A","E01006204","Total",1610,224,141,83,1386,48,202,333,222,79,193,309
"2011","Trafford 022B","E01006206","Total",1859,233,105,128,1626,187,172,367,272,145,202,281
"2011","Trafford 022C","E01006207","Total",1611,367,109,258,1244,126,116,354,210,52,155,231
"2011","Trafford 022D","E01006208","Total",1627,165,74,91,1462,160,186,263,244,176,162,271
"2011","Trafford 022E","E01006211","Total",1530,191,107,84,1339,84,176,304,210,136,194,235
"2011","Trafford 023A","E01006093","Total",1580,130,56,74,1450,60,148,449,234,73,208,278
"2011","Trafford 023B","E01006191","Total",1658,134,78,56,1524,46,222,420,194,97,168,377
"2011","Trafford 023C","E01006192","Total",1534,173,113,60,1361,50,212,343,202,101,191,262
"2011","Trafford 023D","E01006205","Total",1388,137,84,53,1251,27,236,336,176,126,136,214
"2011","Trafford 023E","E01006209","Total",1577,143,101,42,1434,45,264,355,204,123,163,280
"2011","Trafford 024A","E01006078","Total",1843,268,95,173,1575,80,114,481,486,40,50,324
"2011","Trafford 024B","E01006080","Total",1782,251,93,158,1531,55,148,484,330,70,147,297
"2011","Trafford 024C","E01006089","Total",1497,160,63,97,1337,51,122,392,334,55,173,210
"2011","Trafford 024D","E01006193","Total",1513,152,73,79,1361,57,186,414,256,86,132,230
"2011","Trafford 024E","E01006194","Total",2333,284,76,208,2049,132,92,806,458,121,148,292
"2011","Trafford 025A","E01006074","Total",1496,190,112,78,1306,64,148,329,204,98,228,235
"2011","Trafford 025B","E01006075","Total",1908,340,151,189,1568,37,222,428,348,155,165,213
"2011","Trafford 025C","E01006076","Total",1548,318,155,163,1230,62,320,227,222,94,114,191
"2011","Trafford 025D","E01006079","Total",1991,273,65,208,1718,75,200,490,400,91,192,270
"2011","Trafford 025E","E01006087","Total",1513,120,54,66,1393,30,250,258,192,112,248,303
"2011","Trafford 026A","E01006083","Total",1397,77,51,26,1320,16,148,366,144,187,195,264
"2011","Trafford 026B","E01006084","Total",1708,148,66,82,1560,6,184,483,198,166,249,274
"2011","Trafford 026C","E01006088","Total",1575,186,63,123,1389,51,108,549,262,122,70,227
"2011","Trafford 026D","E01006139","Total",1717,193,94,99,1524,70,148,482,314,174,147,189
"2011","Trafford 026E","E01006140","Total",1685,137,63,74,1548,74,164,521,212,168,164,245
"2011","Trafford 027A","E01006077","Total",1591,314,129,185,1277,55,130,321,350,87,113,221
"2011","Trafford 027B","E01006081","Total",1369,76,41,35,1293,10,228,321,154,100,206,274
"2011","Trafford 027C","E01006082","Total",1602,187,71,116,1415,35,264,317,254,131,170,244
"2011","Trafford 027D","E01006085","Total",1495,175,88,87,1320,54,174,373,236,148,132,203
"2011","Trafford 027E","E01006086","Total",1622,190,92,98,1432,78,232,354,210,104,192,262
"2011","Trafford 028A","E01006134","Total",1527,79,51,28,1448,38,162,325,174,104,278,367
"2011","Trafford 028B","E01006135","Total",1571,136,86,50,1435,44,298,331,178,131,196,257
"2011","Trafford 028C","E01006136","Total",1551,153,105,48,1398,30,256,309,174,145,217,267
"2011","Trafford 028D","E01006137","Total",1433,85,65,20,1348,23,206,255,102,97,348,317
"2011","Trafford 028E","E01006138","Total",1747,285,190,95,1462,64,298,321,224,92,202,261
"2011","Wigan 001A","E01006315","Total",1223,128,71,57,1095,24,180,302,202,36,126,225
"2011","Wigan 001B","E01006316","Total",1486,127,57,70,1359,22,200,330,316,53,120,318
"2011","Wigan 001C","E01006317","Total",1523,185,102,83,1338,105,224,292,230,43,135,309
"2011","Wigan 001D","E01006319","Total",1439,95,46,49,1344,99,66,467,192,128,194,198
"2011","Wigan 002A","E01006229","Total",1498,181,86,95,1317,58,286,256,256,49,128,284
"2011","Wigan 002B","E01006230","Total",1417,137,75,62,1280,36,170,307,234,31,187,315
"2011","Wigan 002C","E01006233","Total",1456,84,51,33,1372,31,206,366,216,66,165,322
"2011","Wigan 002D","E01006237","Total",1576,117,53,64,1459,75,160,467,228,92,200,237
"2011","Wigan 002E","E01006238","Total",1530,325,164,161,1205,159,138,284,236,77,82,229
"2011","Wigan 003A","E01006259","Total",1321,120,51,69,1201,48,156,293,234,77,112,281
"2011","Wigan 003B","E01006312","Total",1481,145,73,72,1336,55,258,256,212,68,136,351
"2011","Wigan 003C","E01006313","Total",1067,142,65,77,925,79,126,184,148,47,135,206
"2011","Wigan 003D","E01006314","Total",1679,207,116,91,1472,43,290,362,268,35,137,337
"2011","Wigan 003E","E01006318","Total",1446,149,87,62,1297,53,278,258,234,46,132,296
"2011","Wigan 003F","E01006320","Total",1378,122,52,70,1256,44,200,278,232,42,143,317
"2011","Wigan 003G","E01006321","Total",1710,166,62,104,1544,74,160,404,346,82,163,315
"2011","Wigan 004A","E01006231","Total",1477,142,67,75,1335,57,208,307,258,62,130,313
"2011","Wigan 004B","E01006232","Total",1809,194,57,137,1615,34,210,435,332,71,207,326
"2011","Wigan 004C","E01006234","Total",1230,138,68,70,1092,48,228,216,188,56,94,262
"2011","Wigan 004D","E01006235","Total",1524,241,128,113,1283,162,186,328,220,80,119,188
"2011","Wigan 005A","E01006253","Total",1544,176,95,81,1368,105,252,282,212,86,160,271
"2011","Wigan 005B","E01006254","Total",1657,155,61,94,1502,248,128,367,166,142,214,237
"2011","Wigan 005C","E01006255","Total",1498,170,75,95,1328,48,236,299,256,57,112,320
"2011","Wigan 005D","E01006256","Total",1437,160,62,98,1277,80,140,383,232,55,114,273
"2011","Wigan 005E","E01006260","Total",1530,176,97,79,1354,129,160,332,210,103,139,281
"2011","Wigan 006A","E01006370","Total",1591,413,92,321,1178,70,110,259,280,64,104,291
"2011","Wigan 006B","E01006372","Total",1613,142,67,75,1471,27,266,331,238,61,164,384
"2011","Wigan 006C","E01006373","Total",1503,172,84,88,1331,50,174,283,278,74,137,335
"2011","Wigan 006D","E01006374","Total",1549,219,120,99,1330,35,214,405,234,66,112,264
"2011","Wigan 006E","E01006390","Total",1539,220,120,100,1319,95,256,247,210,52,128,331
"2011","Wigan 007A","E01006236","Total",1480,164,73,91,1316,42,262,283,306,46,90,287
"2011","Wigan 007B","E01006388","Total",1670,244,99,145,1426,99,192,355,254,84,125,317
"2011","Wigan 007C","E01006389","Total",1400,77,17,60,1323,109,66,343,242,72,177,314
"2011","Wigan 007D","E01006391","Total",1587,158,90,68,1429,45,266,278,266,77,158,339
"2011","Wigan 008A","E01006257","Total",1292,141,62,79,1151,65,122,288,190,57,168,261
"2011","Wigan 008B","E01006258","Total",1636,215,101,114,1421,116,188,352,242,67,162,294
"2011","Wigan 008C","E01006369","Total",1694,444,113,331,1250,145,118,258,340,49,102,238
"2011","Wigan 008D","E01006371","Total",1543,194,65,129,1349,68,150,286,278,90,164,313
"2011","Wigan 008E","E01006375","Total",1602,203,78,125,1399,53,150,358,258,113,168,299
"2011","Wigan 009A","E01006306","Total",1546,460,148,312,1086,91,144,226,262,49,104,210
"2011","Wigan 009B","E01006307","Total",1432,227,90,137,1205,114,112,277,194,73,153,282
"2011","Wigan 009C","E01006386","Total",1534,621,211,410,913,75,192,170,252,21,62,141
"2011","Wigan 009D","E01006387","Total",1268,161,77,84,1107,100,124,245,172,77,134,255
"2011","Wigan 009E","E01006392","Total",1499,217,63,154,1282,148,88,318,172,155,190,211
"2011","Wigan 010A","E01006350","Total",1823,214,89,125,1609,234,122,318,248,152,258,277
"2011","Wigan 010B","E01006351","Total",2092,319,110,209,1773,352,90,471,290,132,174,264
"2011","Wigan 010C","E01006357","Total",1672,194,87,107,1478,192,96,303,174,171,247,295
"2011","Wigan 010D","E01006360","Total",1675,254,74,180,1421,247,102,321,178,120,159,294
"2011","Wigan 010E","E01006361","Total",1616,252,53,199,1364,216,96,341,198,113,187,213
"2011","Wigan 011A","E01006356","Total",1472,191,66,125,1281,126,112,265,170,106,218,284
"2011","Wigan 011B","E01006396","Total",1429,117,39,78,1312,70,126,301,242,59,165,349
"2011","Wigan 011C","E01006397","Total",1112,258,138,120,854,63,134,216,184,51,32,174
"2011","Wigan 011D","E01006398","Total",1086,179,57,122,907,74,100,247,198,21,87,180
"2011","Wigan 011E","E01006399","Total",1538,228,106,122,1310,95,180,283,272,69,162,249
"2011","Wigan 012A","E01006305","Total",1783,213,78,135,1570,181,112,324,210,158,250,335
"2011","Wigan 012B","E01006308","Total",1600,217,77,140,1383,149,118,329,240,105,173,269
"2011","Wigan 012C","E01006309","Total",1565,169,40,129,1396,156,82,340,220,123,148,327
"2011","Wigan 012D","E01006310","Total",1513,277,126,151,1236,155,104,315,216,83,197,166
"2011","Wigan 012E","E01006311","Total",1593,168,55,113,1425,181,120,312,254,116,196,246
"2011","Wigan 013A","E01006269","Total",1603,264,112,152,1339,88,200,321,210,71,177,272
"2011","Wigan 013B","E01006271","Total",1754,205,68,137,1549,100,210,310,268,56,235,370
"2011","Wigan 013C","E01006272","Total",1558,228,86,142,1330,90,110,403,302,51,182,192
"2011","Wigan 013D","E01006273","Total",1533,174,69,105,1359,150,178,286,292,74,111,268
"2011","Wigan 013E","E01006276","Total",2274,167,59,108,2107,137,158,681,372,130,275,354
"2011","Wigan 014A","E01006353","Total",1543,157,82,75,1386,89,204,261,274,34,196,328
"2011","Wigan 014B","E01006354","Total",1502,205,103,102,1297,108,136,343,212,50,159,289
"2011","Wigan 014C","E01006355","Total",1531,194,72,122,1337,88,208,349,308,30,108,246
"2011","Wigan 014D","E01006358","Total",1704,288,122,166,1416,147,172,270,314,74,132,307
"2011","Wigan 014E","E01006359","Total",1514,164,76,88,1350,129,114,304,210,98,200,295
"2011","Wigan 015A","E01006349","Total",1762,356,111,245,1406,116,118,304,428,56,109,275
"2011","Wigan 015B","E01006352","Total",1619,265,79,186,1354,107,134,306,332,82,127,266
"2011","Wigan 015C","E01006404","Total",1617,240,99,141,1377,110,114,352,270,112,220,199
"2011","Wigan 015D","E01006405","Total",1344,237,89,148,1107,106,150,215,228,63,99,246
"2011","Wigan 015E","E01006411","Total",1630,427,108,319,1203,211,114,284,188,111,128,167
"2011","Wigan 016A","E01006270","Total",1495,240,110,130,1255,72,208,228,180,91,190,286
"2011","Wigan 016B","E01006274","Total",1511,240,114,126,1271,151,146,280,180,112,155,247
"2011","Wigan 016C","E01006275","Total",1529,217,114,103,1312,188,132,286,152,103,149,302
"2011","Wigan 016D","E01006277","Total",1802,84,15,69,1718,80,66,639,260,73,241,359
"2011","Wigan 016E","E01006286","Total",1467,163,73,90,1304,45,288,209,246,35,149,332
"2011","Wigan 017A","E01006239","Total",1965,482,162,320,1483,153,150,342,324,88,174,252
"2011","Wigan 017B","E01006240","Total",1601,161,38,123,1440,225,98,312,214,170,168,253
"2011","Wigan 017C","E01006241","Total",1946,172,53,119,1774,226,142,405,292,177,224,308
"2011","Wigan 017D","E01006287","Total",1217,77,40,37,1140,34,126,257,240,59,98,326
"2011","Wigan 017E","E01006289","Total",1746,383,112,271,1363,219,138,274,252,76,169,235
"2011","Wigan 018A","E01006362","Total",1782,180,92,88,1602,52,288,402,270,93,149,348
"2011","Wigan 018B","E01006363","Total",1542,241,178,63,1301,50,334,224,204,57,133,299
"2011","Wigan 018C","E01006364","Total",1811,277,137,140,1534,138,186,367,272,87,188,296
"2011","Wigan 018D","E01006365","Total",2206,139,56,83,2067,103,162,750,324,94,249,385
"2011","Wigan 018E","E01006366","Total",1681,281,121,160,1400,69,284,295,248,61,114,329
"2011","Wigan 018F","E01006367","Total",1577,178,98,80,1399,54,272,347,296,35,122,273
"2011","Wigan 018G","E01006368","Total",1641,188,95,93,1453,114,272,362,240,56,128,281
"2011","Wigan 019A","E01006278","Total",1574,185,89,96,1389,102,270,270,266,51,143,287
"2011","Wigan 019B","E01006279","Total",1579,108,44,64,1471,66,152,395,280,68,193,317
"2011","Wigan 019C","E01006280","Total",1405,198,119,79,1207,111,170,271,202,51,109,293
"2011","Wigan 019D","E01006281","Total",1764,149,62,87,1615,95,196,440,340,50,165,329
"2011","Wigan 019E","E01006285","Total",1838,125,61,64,1713,50,232,401,318,67,211,434
"2011","Wigan 020A","E01006406","Total",1460,158,77,81,1302,47,240,219,246,74,161,315
"2011","Wigan 020B","E01006407","Total",1507,119,33,86,1388,40,110,364,270,55,179,370
"2011","Wigan 020C","E01006408","Total",1544,163,75,88,1381,108,160,304,258,110,172,269
"2011","Wigan 020D","E01006409","Total",1388,141,81,60,1247,37,240,262,216,25,150,317
"2011","Wigan 020E","E01006410","Total",1403,88,39,49,1315,40,168,271,242,46,224,324
"2011","Wigan 021A","E01006393","Total",1490,135,46,89,1355,63,150,260,298,101,168,315
"2011","Wigan 021B","E01006394","Total",1561,140,69,71,1421,39,266,292,256,37,162,369
"2011","Wigan 021C","E01006395","Total",2502,94,20,74,2408,76,112,926,366,169,286,473
"2011","Wigan 021D","E01006400","Total",1345,81,21,60,1264,67,78,381,258,55,170,255
"2011","Wigan 021E","E01006401","Total",1463,95,45,50,1368,43,186,345,262,61,177,294
"2011","Wigan 021F","E01006402","Total",1198,89,43,46,1109,37,142,274,198,31,104,323
"2011","Wigan 021G","E01006403","Total",1705,123,56,67,1582,65,286,332,272,103,165,359
"2011","Wigan 022A","E01006290","Total",1375,174,79,95,1201,50,234,230,248,43,114,282
"2011","Wigan 022B","E01006291","Total",1470,241,94,147,1229,105,152,299,258,79,125,211
"2011","Wigan 022C","E01006292","Total",1530,153,65,88,1377,81,220,282,242,72,129,351
"2011","Wigan 022D","E01006293","Total",1538,272,89,183,1266,111,162,323,272,86,92,220
"2011","Wigan 023A","E01006242","Total",1625,249,106,143,1376,60,212,370,324,47,104,259
"2011","Wigan 023B","E01006243","Total",2045,224,79,145,1821,88,218,517,420,85,188,305
"2011","Wigan 023C","E01006244","Total",1560,412,178,234,1148,138,186,263,246,40,57,218
"2011","Wigan 023D","E01006245","Total",2417,319,96,223,2098,208,182,639,464,62,159,384
"2011","Wigan 024A","E01006213","Total",1627,243,81,162,1384,217,114,335,226,65,207,220
"2011","Wigan 024B","E01006215","Total",1602,261,86,175,1341,173,158,251,240,103,149,267
"2011","Wigan 024C","E01006217","Total",2334,229,103,126,2105,178,162,635,370,138,257,365
"2011","Wigan 024D","E01006218","Total",2055,240,53,187,1815,201,140,525,376,110,195,268
"2011","Wigan 024E","E01006219","Total",1297,107,39,68,1190,120,100,187,266,78,107,332
"2011","Wigan 025A","E01006288","Total",1803,199,76,123,1604,232,152,364,254,119,183,300
"2011","Wigan 025B","E01006294","Total",1963,315,75,240,1648,220,82,519,376,45,148,258
"2011","Wigan 025C","E01006295","Total",1593,351,109,242,1242,118,104,356,282,61,105,216
"2011","Wigan 025D","E01006377","Total",1614,173,69,104,1441,81,172,340,266,46,165,371
"2011","Wigan 025E","E01006378","Total",1334,138,75,63,1196,39,270,247,248,25,92,275
"2011","Wigan 026A","E01006212","Total",1388,124,63,61,1264,53,194,316,240,56,130,275
"2011","Wigan 026B","E01006214","Total",1375,176,60,116,1199,166,90,300,244,93,90,216
"2011","Wigan 026C","E01006216","Total",2191,187,53,134,2004,173,136,622,442,114,187,330
"2011","Wigan 026D","E01006322","Total",1539,225,74,151,1314,125,124,321,252,92,150,250
"2011","Wigan 026E","E01006329","Total",1078,141,45,96,937,56,106,204,202,63,96,210
"2011","Wigan 027A","E01006282","Total",1661,183,73,110,1478,95,170,398,250,102,130,333
"2011","Wigan 027B","E01006283","Total",1535,221,67,154,1314,202,118,325,234,101,121,213
"2011","Wigan 027C","E01006284","Total",1520,208,70,138,1312,106,112,272,260,125,154,283
"2011","Wigan 027D","E01006336","Total",1593,284,81,203,1309,246,118,288,190,129,101,237
"2011","Wigan 027E","E01006337","Total",1507,195,77,118,1312,104,180,326,236,50,121,295
"2011","Wigan 028A","E01006376","Total",1642,196,74,122,1446,199,152,330,230,105,157,273
"2011","Wigan 028B","E01006381","Total",1920,130,27,103,1790,102,94,509,324,143,249,369
"2011","Wigan 028C","E01006382","Total",1410,60,27,33,1350,48,166,347,200,41,181,367
"2011","Wigan 028D","E01006383","Total",1660,120,38,82,1540,47,114,419,322,103,205,330
"2011","Wigan 028E","E01006384","Total",1394,173,44,129,1221,54,122,316,242,25,164,298
"2011","Wigan 029A","E01006250","Total",1532,182,65,117,1350,53,232,349,284,58,86,288
"2011","Wigan 029B","E01006251","Total",1462,137,61,76,1325,57,158,359,262,41,97,351
"2011","Wigan 029C","E01006379","Total",1551,181,79,102,1370,100,248,341,300,52,101,228
"2011","Wigan 029D","E01006380","Total",1655,269,132,137,1386,160,166,304,220,98,140,298
"2011","Wigan 029E","E01006385","Total",1489,125,58,67,1364,46,212,325,250,50,110,371
"2011","Wigan 030A","E01006328","Total",1432,285,79,206,1147,101,98,231,240,100,154,223
"2011","Wigan 030B","E01006333","Total",1789,329,72,257,1460,134,114,385,328,131,119,249
"2011","Wigan 030C","E01006334","Total",1716,334,75,259,1382,167,114,410,322,73,105,191
"2011","Wigan 030D","E01006338","Total",1588,249,85,164,1339,134,150,364,280,69,115,227
"2011","Wigan 031A","E01006248","Total",1564,395,101,294,1169,128,128,268,174,110,134,227
"2011","Wigan 031B","E01006249","Total",1578,167,59,108,1411,144,148,297,218,110,197,297
"2011","Wigan 031C","E01006330","Total",1629,149,74,75,1480,37,236,357,268,58,145,379
"2011","Wigan 031D","E01006331","Total",1596,132,50,82,1464,52,184,423,262,76,128,339
"2011","Wigan 031E","E01006332","Total",1862,317,70,247,1545,100,142,525,322,51,194,211
"2011","Wigan 032A","E01006262","Total",1531,159,68,91,1372,111,128,362,218,101,146,306
"2011","Wigan 032B","E01006263","Total",1547,117,67,50,1430,25,330,244,254,85,171,321
"2011","Wigan 032C","E01006266","Total",1392,165,105,60,1227,43,274,201,256,45,136,272
"2011","Wigan 032D","E01006267","Total",1637,335,172,163,1302,177,170,234,202,79,145,295
"2011","Wigan 032E","E01006268","Total",1762,184,82,102,1578,115,150,382,274,102,191,364
"2011","Wigan 033A","E01006323","Total",1502,188,61,127,1314,157,148,334,192,99,130,254
"2011","Wigan 033B","E01006324","Total",1325,234,100,134,1091,131,124,163,196,90,138,249
"2011","Wigan 033C","E01006325","Total",1608,132,52,80,1476,110,132,322,270,95,221,326
"2011","Wigan 033D","E01006326","Total",1430,240,76,164,1190,116,106,296,232,76,129,235
"2011","Wigan 033E","E01006327","Total",1458,221,115,106,1237,131,130,259,160,144,189,224
"2011","Wigan 034A","E01006246","Total",1566,238,71,167,1328,106,248,297,250,62,114,251
"2011","Wigan 034B","E01006247","Total",1330,146,79,67,1184,36,200,257,176,57,184,274
"2011","Wigan 034C","E01006252","Total",1464,173,86,87,1291,53,228,355,244,30,130,251
"2011","Wigan 034D","E01006297","Total",1631,292,100,192,1339,205,128,333,266,81,142,184
"2011","Wigan 034E","E01006335","Total",1672,277,66,211,1395,179,106,360,286,60,121,283
"2011","Wigan 035A","E01006220","Total",1797,238,118,120,1559,141,206,375,218,109,184,326
"2011","Wigan 035B","E01006221","Total",1645,179,79,100,1466,108,206,365,250,78,151,308
"2011","Wigan 035C","E01006222","Total",1577,153,80,73,1424,45,194,419,246,102,160,258
"2011","Wigan 035D","E01006224","Total",1577,60,10,50,1517,93,46,500,196,164,248,270
"2011","Wigan 035E","E01006226","Total",1754,186,82,104,1568,90,214,392,332,120,97,323
"2011","Wigan 036A","E01006223","Total",1568,235,71,164,1333,125,144,362,278,70,102,252
"2011","Wigan 036B","E01006225","Total",1486,169,103,66,1317,70,222,248,260,82,109,326
"2011","Wigan 036C","E01006261","Total",1502,191,111,80,1311,85,214,336,190,25,181,280
"2011","Wigan 036D","E01006264","Total",1356,68,30,38,1288,30,186,286,254,40,130,362
"2011","Wigan 036E","E01006265","Total",1432,161,77,84,1271,103,174,258,244,56,122,314
"2011","Wigan 037A","E01006296","Total",1533,252,79,173,1281,225,94,325,248,79,111,199
"2011","Wigan 037B","E01006298","Total",1405,286,107,179,1119,155,112,245,196,63,156,192
"2011","Wigan 037C","E01006299","Total",1888,232,73,159,1656,97,226,503,326,66,158,280
"2011","Wigan 037D","E01006300","Total",1347,158,115,43,1189,23,318,228,232,55,113,220
"2011","Wigan 037E","E01006301","Total",1362,88,50,38,1274,48,206,285,228,63,143,301
"2011","Wigan 038A","E01006227","Total",1554,140,51,89,1414,52,172,350,268,126,162,284
"2011","Wigan 038B","E01006228","Total",1731,207,48,159,1524,179,130,360,288,131,171,265
"2011","Wigan 038C","E01006342","Total",1567,220,99,121,1347,104,186,259,256,127,144,271
"2011","Wigan 038D","E01006344","Total",1450,172,102,70,1278,180,138,212,176,108,192,272
"2011","Wigan 038E","E01006346","Total",2134,320,116,204,1814,152,212,428,430,129,185,278
"2011","Wigan 039A","E01006339","Total",1370,143,64,79,1227,33,218,199,308,52,128,289
"2011","Wigan 039B","E01006340","Total",1457,222,92,130,1235,127,110,307,230,78,182,201
"2011","Wigan 039C","E01006343","Total",1758,112,25,87,1646,72,110,583,288,128,213,252
"2011","Wigan 039D","E01006345","Total",1559,152,82,70,1407,77,260,394,284,62,87,243
"2011","Wigan 039E","E01006348","Total",1574,167,82,85,1407,35,288,338,268,65,141,272
"2011","Wigan 040A","E01006302","Total",1603,162,42,120,1441,98,138,386,276,56,163,324
"2011","Wigan 040B","E01006303","Total",1394,142,66,76,1252,70,210,264,242,81,95,290
"2011","Wigan 040C","E01006304","Total",1481,161,68,93,1320,106,226,263,232,85,159,249
"2011","Wigan 040D","E01006341","Total",1644,267,112,155,1377,131,174,391,260,41,156,224
"2011","Wigan 040E","E01006347","Total",1580,146,99,47,1434,39,252,342,222,88,163,328
"2011","Burnley 001A","E01024859","Total",1489,212,46,166,1277,142,100,313,364,45,91,222
"2011","Burnley 001B","E01024861","Total",1309,105,47,58,1204,49,184,280,216,50,125,300
"2011","Burnley 001C","E01024862","Total",1573,160,74,86,1413,70,172,438,268,41,114,310
"2011","Burnley 001D","E01024891","Total",1601,170,90,80,1431,140,256,217,172,122,199,325
"2011","Burnley 001E","E01024892","Total",1428,211,126,85,1217,70,214,149,188,104,226,266
"2011","Burnley 001F","E01024894","Total",1376,122,53,69,1254,73,126,284,188,82,197,304
"2011","Burnley 002A","E01024893","Total",1483,255,113,142,1228,96,138,260,212,167,195,160
"2011","Burnley 002B","E01024896","Total",1326,173,89,84,1153,52,144,207,252,86,124,288
"2011","Burnley 002C","E01024897","Total",1303,168,96,72,1135,57,202,194,144,87,221,230
"2011","Burnley 002D","E01024898","Total",1562,257,63,194,1305,183,88,304,268,89,145,228
"2011","Burnley 003A","E01024856","Total",1587,199,53,146,1388,145,92,258,174,241,331,147
"2011","Burnley 003B","E01024875","Total",1405,108,11,97,1297,53,48,185,82,337,401,191
"2011","Burnley 003C","E01024876","Total",1361,159,36,123,1202,51,54,160,86,223,366,262
"2011","Burnley 003D","E01024877","Total",1555,192,49,143,1363,83,58,176,112,277,490,167
"2011","Burnley 003E","E01024878","Total",1609,74,16,58,1535,58,62,181,68,407,585,174
"2011","Burnley 003F","E01024895","Total",1377,237,46,191,1140,134,68,213,154,197,186,188
"2011","Burnley 004A","E01024883","Total",1490,215,109,106,1275,121,154,298,212,69,162,259
"2011","Burnley 004B","E01024884","Total",1544,204,110,94,1340,125,234,294,262,31,138,256
"2011","Burnley 004C","E01024885","Total",1665,414,88,326,1251,180,88,279,310,114,106,174
"2011","Burnley 004D","E01024886","Total",1392,218,65,153,1174,161,108,265,256,77,126,181
"2011","Burnley 004E","E01024889","Total",1241,259,116,143,982,70,146,203,252,48,80,183
"2011","Burnley 004F","E01024890","Total",1470,220,92,128,1250,173,112,366,192,76,133,198
"2011","Burnley 005A","E01024879","Total",1302,181,80,101,1121,121,94,267,212,61,115,251
"2011","Burnley 005B","E01024880","Total",1383,204,115,89,1179,97,202,205,206,57,134,278
"2011","Burnley 005C","E01024912","Total",1368,137,76,61,1231,38,206,273,268,46,120,280
"2011","Burnley 005D","E01024913","Total",1372,84,31,53,1288,67,72,413,218,56,199,263
"2011","Burnley 005E","E01024914","Total",1484,133,52,81,1351,53,214,289,242,48,121,384
"2011","Burnley 006A","E01024881","Total",1422,205,78,127,1217,117,112,225,230,102,187,244
"2011","Burnley 006B","E01024882","Total",1473,301,79,222,1172,175,110,239,250,81,116,201
"2011","Burnley 006C","E01024902","Total",1491,255,79,176,1236,150,116,347,282,66,118,157
"2011","Burnley 006D","E01024911","Total",1760,277,126,151,1483,123,170,328,292,128,121,321
"2011","Burnley 007A","E01024855","Total",1404,400,171,229,1004,118,180,183,194,55,57,217
"2011","Burnley 007B","E01024857","Total",1456,255,133,122,1201,95,108,215,198,142,229,214
"2011","Burnley 007C","E01024858","Total",1320,326,76,250,994,128,54,163,184,134,219,112
"2011","Burnley 007D","E01024864","Total",1587,267,103,164,1320,111,144,296,266,69,123,311
"2011","Burnley 008A","E01024863","Total",1471,177,71,106,1294,154,146,294,218,116,165,201
"2011","Burnley 008B","E01024865","Total",1427,382,159,223,1045,97,182,215,204,46,108,193
"2011","Burnley 008C","E01024866","Total",1761,345,169,176,1416,109,218,288,278,52,158,313
"2011","Burnley 008D","E01024867","Total",1420,112,70,42,1308,39,302,240,246,72,109,300
"2011","Burnley 009A","E01024860","Total",1243,136,68,68,1107,46,144,218,234,38,157,270
"2011","Burnley 009B","E01024868","Total",1206,137,67,70,1069,54,156,260,232,64,95,208
"2011","Burnley 009C","E01024869","Total",1414,175,109,66,1239,20,314,212,256,50,84,303
"2011","Burnley 009D","E01024870","Total",1146,147,63,84,999,35,180,216,250,30,82,206
"2011","Burnley 010A","E01024872","Total",1357,272,80,192,1085,193,132,214,190,93,75,188
"2011","Burnley 010B","E01024899","Total",1644,195,72,123,1449,184,172,279,210,150,200,254
"2011","Burnley 010C","E01024900","Total",1589,244,87,157,1345,210,100,276,192,161,175,231
"2011","Burnley 010D","E01024907","Total",1221,236,69,167,985,98,114,208,178,68,121,198
"2011","Burnley 010E","E01024908","Total",1034,286,77,209,748,124,60,142,194,29,65,134
"2011","Burnley 010F","E01024909","Total",1474,312,67,245,1162,140,100,249,258,58,158,199
"2011","Burnley 011A","E01024874","Total",1041,103,38,65,938,18,126,185,212,42,137,218
"2011","Burnley 011B","E01024887","Total",1500,134,42,92,1366,115,122,321,260,113,147,288
"2011","Burnley 011C","E01024888","Total",1630,195,63,132,1435,83,266,318,304,35,169,260
"2011","Burnley 011D","E01024901","Total",1815,190,52,138,1625,86,140,477,366,41,161,354
"2011","Burnley 014D","E01024871","Total",1260,130,64,66,1130,54,192,206,180,37,141,320
"2011","Burnley 014E","E01024873","Total",1380,181,100,81,1199,59,198,284,224,71,121,242
"2011","Burnley 014F","E01024903","Total",1260,116,49,67,1144,126,88,250,150,100,162,268
"2011","Burnley 014A","E01024904","Total",1660,218,76,142,1442,100,192,308,242,82,210,308
"2011","Burnley 014G","E01024905","Total",1220,119,60,59,1101,18,158,322,176,33,123,271
"2011","Burnley 014B","E01024906","Total",1530,393,114,279,1137,163,110,199,248,70,158,189
"2011","Burnley 014C","E01024910","Total",1446,214,76,138,1232,122,118,323,208,46,156,259
"2011","Chorley 001A","E01024951","Total",1205,124,29,95,1081,152,64,190,182,90,199,204
"2011","Chorley 001B","E01024952","Total",1166,292,66,226,874,83,80,202,224,47,63,175
"2011","Chorley 001C","E01024953","Total",1368,258,87,171,1110,167,96,215,232,77,119,204
"2011","Chorley 001D","E01024954","Total",1399,204,71,133,1195,64,182,222,280,70,130,247
"2011","Chorley 002A","E01024921","Total",2062,179,83,96,1883,60,316,401,386,50,203,467
"2011","Chorley 002B","E01024978","Total",1341,144,58,86,1197,94,120,326,292,121,82,162
"2011","Chorley 002C","E01024979","Total",1382,140,55,85,1242,59,178,307,296,35,185,182
"2011","Chorley 002D","E01024980","Total",1388,138,72,66,1250,66,210,264,240,104,135,231
"2011","Chorley 003A","E01024946","Total",1241,132,68,64,1109,56,178,310,214,53,105,193
"2011","Chorley 003B","E01024947","Total",1348,89,23,66,1259,36,84,374,232,149,152,232
"2011","Chorley 003C","E01024955","Total",1437,208,66,142,1229,53,152,293,284,37,96,314
"2011","Chorley 003D","E01024956","Total",1433,137,53,84,1296,64,206,291,308,37,86,304
"2011","Chorley 003E","E01024957","Total",1407,144,90,54,1263,8,252,304,230,74,181,214
"2011","Chorley 003F","E01024958","Total",1371,162,49,113,1209,102,104,318,224,102,145,214
"2011","Chorley 004A","E01024948","Total",1456,184,78,106,1272,60,206,313,258,83,120,232
"2011","Chorley 004B","E01024949","Total",2261,308,65,243,1953,118,102,636,530,149,143,275
"2011","Chorley 004C","E01024950","Total",1356,103,40,63,1253,30,144,409,272,88,101,209
"2011","Chorley 004D","E01024977","Total",2239,186,80,106,2053,59,240,672,418,88,185,391
"2011","Chorley 005A","E01024967","Total",1302,102,53,49,1200,27,222,276,228,46,133,268
"2011","Chorley 005B","E01024968","Total",1887,158,65,93,1729,86,172,674,302,148,159,188
"2011","Chorley 005C","E01024969","Total",1360,190,114,76,1170,62,186,289,192,30,141,270
"2011","Chorley 005D","E01024970","Total",1370,131,64,67,1239,64,172,335,254,52,110,252
"2011","Chorley 005E","E01024971","Total",1239,116,63,53,1123,56,202,263,228,41,100,233
"2011","Chorley 005F","E01024972","Total",1264,122,66,56,1142,20,170,259,250,46,106,291
"2011","Chorley 006A","E01024929","Total",1285,180,55,125,1105,160,78,265,158,101,134,209
"2011","Chorley 006B","E01024930","Total",1438,182,62,120,1256,133,140,324,282,65,100,212
"2011","Chorley 006C","E01024931","Total",1465,220,62,158,1245,142,134,319,264,72,123,191
"2011","Chorley 006D","E01024932","Total",1025,81,43,38,944,27,156,177,204,55,102,223
"2011","Chorley 006E","E01024933","Total",1356,213,98,115,1143,90,206,168,238,67,138,236
"2011","Chorley 006F","E01024937","Total",1465,177,98,79,1288,33,240,327,204,42,117,325
"2011","Chorley 007A","E01024964","Total",1462,155,86,69,1307,36,228,302,252,64,171,254
"2011","Chorley 007B","E01024974","Total",1547,148,76,72,1399,80,216,370,252,66,127,288
"2011","Chorley 007C","E01024975","Total",1274,138,58,80,1136,42,130,332,258,61,127,186
"2011","Chorley 007D","E01024976","Total",1510,205,97,108,1305,86,142,308,254,96,146,273
"2011","Chorley 008A","E01024919","Total",2513,360,82,278,2153,203,124,635,528,140,203,320
"2011","Chorley 008B","E01024920","Total",1934,281,153,128,1653,53,370,316,400,70,78,366
"2011","Chorley 008C","E01024934","Total",1438,169,105,64,1269,42,256,288,204,59,127,293
"2011","Chorley 008D","E01024935","Total",1418,164,119,45,1254,28,310,233,238,79,132,234
"2011","Chorley 009A","E01024925","Total",1708,309,150,159,1399,154,92,350,216,174,212,201
"2011","Chorley 009B","E01024926","Total",1916,311,106,205,1605,185,124,351,300,128,234,283
"2011","Chorley 009C","E01024927","Total",1667,217,88,129,1450,104,194,415,296,79,122,240
"2011","Chorley 009D","E01024928","Total",1501,200,69,131,1301,70,160,311,252,109,101,298
"2011","Chorley 010A","E01024936","Total",1540,311,129,182,1229,80,126,275,322,63,110,253
"2011","Chorley 010B","E01024938","Total",1624,182,91,91,1442,56,240,339,290,87,174,256
"2011","Chorley 010C","E01024939","Total",1744,137,80,57,1607,51,298,354,272,108,198,326
"2011","Chorley 010D","E01024940","Total",1694,392,98,294,1302,108,124,369,282,41,132,246
"2011","Chorley 010E","E01024941","Total",1568,300,135,165,1268,101,124,286,272,126,121,238
"2011","Chorley 011A","E01024923","Total",1229,126,68,58,1103,26,212,191,210,60,151,253
"2011","Chorley 011B","E01024924","Total",1407,135,71,64,1272,29,246,242,272,58,138,287
"2011","Chorley 011C","E01024963","Total",1515,193,112,81,1322,83,232,298,246,61,96,306
"2011","Chorley 011D","E01024965","Total",1398,122,68,54,1276,32,230,251,226,56,183,298
"2011","Chorley 011E","E01024966","Total",1588,164,77,87,1424,56,220,404,246,83,165,250
"2011","Chorley 012A","E01024942","Total",1625,320,131,189,1305,161,146,349,238,76,115,220
"2011","Chorley 012B","E01024943","Total",2289,245,55,190,2044,315,96,628,394,145,157,309
"2011","Chorley 012C","E01024944","Total",1786,104,26,78,1682,73,80,585,286,128,244,286
"2011","Chorley 012D","E01024945","Total",2842,326,89,237,2516,216,168,812,484,227,278,331
"2011","Chorley 013A","E01024922","Total",1450,127,65,62,1323,86,182,370,240,74,144,227
"2011","Chorley 013B","E01024959","Total",1700,278,100,178,1422,133,108,352,244,114,185,286
"2011","Chorley 013C","E01024960","Total",1623,158,83,75,1465,115,136,361,238,113,198,304
"2011","Chorley 013D","E01024961","Total",1573,162,72,90,1411,67,186,318,300,66,143,331
"2011","Chorley 013E","E01024962","Total",1500,125,67,58,1375,32,274,229,266,90,124,360
"2011","Chorley 014A","E01024915","Total",2181,317,158,159,1864,145,246,566,324,80,210,293
"2011","Chorley 014B","E01024916","Total",1643,179,99,80,1464,59,284,369,308,32,129,283
"2011","Chorley 014C","E01024917","Total",1723,260,78,182,1463,99,150,443,322,52,175,222
"2011","Chorley 014D","E01024918","Total",1746,197,100,97,1549,46,276,398,308,73,122,326
"2011","Chorley 014E","E01024973","Total",2085,203,103,100,1882,65,354,451,356,75,232,349
"2011","Fylde 001A","E01024993","Total",1478,150,71,79,1328,65,218,309,256,83,103,294
"2011","Fylde 001B","E01025026","Total",1277,147,76,71,1130,28,246,166,214,89,139,248
"2011","Fylde 001C","E01025027","Total",1749,180,68,112,1569,108,138,447,292,162,174,248
"2011","Fylde 001D","E01025028","Total",1368,112,44,68,1256,83,202,244,200,54,170,303
"2011","Fylde 001E","E01025031","Total",1205,130,77,53,1075,17,336,193,188,46,120,175
"2011","Fylde 002A","E01025007","Total",1247,104,35,69,1143,71,136,254,244,65,138,235
"2011","Fylde 002B","E01025008","Total",1151,118,72,46,1033,54,192,225,194,55,54,259
"2011","Fylde 002C","E01025009","Total",1450,289,127,162,1161,79,236,227,270,41,100,208
"2011","Fylde 002D","E01025011","Total",1412,269,117,152,1143,119,118,238,258,76,144,190
"2011","Fylde 002E","E01025012","Total",1975,180,77,103,1795,84,226,473,336,71,257,348
"2011","Fylde 002F","E01025013","Total",1609,225,61,164,1384,168,130,357,266,75,158,230
"2011","Fylde 002G","E01025019","Total",1373,159,90,69,1214,33,312,241,234,43,131,220
"2011","Fylde 003A","E01024998","Total",1784,183,93,90,1601,212,214,359,232,108,154,322
"2011","Fylde 003B","E01025010","Total",1271,116,63,53,1155,32,214,296,210,56,164,183
"2011","Fylde 003C","E01025014","Total",1680,153,62,91,1527,95,200,305,288,103,178,358
"2011","Fylde 003D","E01025015","Total",1544,136,71,65,1408,66,216,330,280,66,170,280
"2011","Fylde 004A","E01025004","Total",1322,200,101,99,1122,90,198,259,180,63,117,215
"2011","Fylde 004B","E01025006","Total",1313,316,111,205,997,143,104,145,228,125,85,167
"2011","Fylde 004C","E01025023","Total",1332,156,82,74,1176,79,254,278,262,35,77,191
"2011","Fylde 004D","E01025024","Total",1256,308,165,143,948,78,290,122,240,11,54,153
"2011","Fylde 004E","E01025025","Total",1533,245,79,166,1288,160,118,316,262,72,99,261
"2011","Fylde 005A","E01025001","Total",1560,332,213,119,1228,92,348,202,216,56,123,191
"2011","Fylde 005B","E01025002","Total",1463,221,83,138,1242,137,144,363,234,57,118,189
"2011","Fylde 005C","E01025005","Total",1429,262,163,99,1167,74,390,176,246,20,60,201
"2011","Fylde 005D","E01025016","Total",2360,257,138,119,2103,53,472,561,398,96,200,323
"2011","Fylde 005E","E01025018","Total",1232,168,111,57,1064,56,300,222,158,20,94,214
"2011","Fylde 006A","E01024984","Total",1420,222,124,98,1198,49,312,211,224,46,124,232
"2011","Fylde 006B","E01024985","Total",1373,207,124,83,1166,55,214,244,226,78,110,239
"2011","Fylde 006C","E01024986","Total",1456,581,241,340,875,50,218,127,220,65,68,127
"2011","Fylde 006D","E01024987","Total",1267,444,74,370,823,144,64,139,214,22,81,159
"2011","Fylde 006E","E01024988","Total",1453,475,201,274,978,101,240,160,192,32,101,152
"2011","Fylde 006F","E01024989","Total",1463,231,92,139,1232,101,176,271,222,61,174,227
"2011","Fylde 006G","E01024996","Total",1149,358,122,236,791,34,140,148,152,60,113,144
"2011","Fylde 007A","E01024997","Total",1375,240,121,119,1135,42,232,198,272,57,123,211
"2011","Fylde 007B","E01024999","Total",1514,222,135,87,1292,78,226,246,268,68,121,285
"2011","Fylde 007C","E01025000","Total",1282,185,95,90,1097,50,232,154,256,65,96,244
"2011","Fylde 007D","E01025029","Total",1949,297,164,133,1652,71,428,336,300,47,133,337
"2011","Fylde 007E","E01025030","Total",1643,176,54,122,1467,237,118,356,264,75,147,270
"2011","Fylde 008A","E01024981","Total",1318,260,154,106,1058,28,336,164,234,31,47,218
"2011","Fylde 008B","E01024982","Total",1173,298,165,133,875,33,218,188,156,46,105,129
"2011","Fylde 008C","E01024983","Total",1459,200,89,111,1259,82,132,348,230,77,187,203
"2011","Fylde 008D","E01024994","Total",1554,217,120,97,1337,38,332,305,272,67,90,233
"2011","Fylde 008E","E01024995","Total",1372,260,132,128,1112,31,264,243,180,36,123,235
"2011","Fylde 008F","E01025003","Total",1631,286,180,106,1345,64,352,314,218,56,91,250
"2011","Fylde 008G","E01025017","Total",1418,423,303,120,995,77,278,156,192,31,91,170
"2011","Fylde 009A","E01024990","Total",1542,364,152,212,1178,53,262,289,288,74,86,126
"2011","Fylde 009B","E01024991","Total",908,251,129,122,657,31,200,95,162,36,58,75
"2011","Fylde 009C","E01024992","Total",1346,294,197,97,1052,71,432,144,188,21,27,169
"2011","Fylde 009D","E01025020","Total",1290,164,61,103,1126,140,132,259,210,80,101,204
"2011","Fylde 009E","E01025021","Total",1436,251,116,135,1185,40,236,284,220,68,127,210
"2011","Fylde 009F","E01025022","Total",1871,306,98,208,1565,182,178,440,360,75,141,189
"2011","Hyndburn 001A","E01025060","Total",1462,185,53,132,1277,153,84,284,230,146,157,223
"2011","Hyndburn 001B","E01025061","Total",1448,244,160,84,1204,30,318,173,204,59,196,224
"2011","Hyndburn 001C","E01025062","Total",1562,312,94,218,1250,160,98,293,192,121,226,160
"2011","Hyndburn 001D","E01025063","Total",1506,271,109,162,1235,64,200,195,190,119,179,288
"2011","Hyndburn 001E","E01025064","Total",1565,178,98,80,1387,40,308,297,240,47,108,347
"2011","Hyndburn 001F","E01025065","Total",1617,280,88,192,1337,158,148,292,294,74,137,234
"2011","Hyndburn 001G","E01025066","Total",1592,153,47,106,1439,97,140,405,276,117,139,265
"2011","Hyndburn 002A","E01025032","Total",1408,203,71,132,1205,124,150,244,224,109,159,195
"2011","Hyndburn 002B","E01025033","Total",2282,123,21,102,2159,126,86,740,358,177,317,355
"2011","Hyndburn 002C","E01025034","Total",1682,197,53,144,1485,113,208,309,304,139,100,312
"2011","Hyndburn 002D","E01025048","Total",1583,202,113,89,1381,62,200,256,282,121,149,311
"2011","Hyndburn 002E","E01025049","Total",1598,306,99,207,1292,187,160,289,294,73,99,190
"2011","Hyndburn 002F","E01025050","Total",1459,179,49,130,1280,85,146,328,282,61,143,235
"2011","Hyndburn 002G","E01025053","Total",1547,165,56,109,1382,113,160,389,252,72,145,251
"2011","Hyndburn 003A","E01025070","Total",1162,142,55,87,1020,142,92,214,194,81,144,153
"2011","Hyndburn 003B","E01025071","Total",1381,223,86,137,1158,83,116,230,204,59,170,296
"2011","Hyndburn 003C","E01025072","Total",1381,244,84,160,1137,139,130,262,198,111,128,169
"2011","Hyndburn 003D","E01025073","Total",1287,190,64,126,1097,77,176,217,246,74,106,201
"2011","Hyndburn 003E","E01025074","Total",1412,120,70,50,1292,18,284,292,176,48,195,279
"2011","Hyndburn 004A","E01025051","Total",1336,232,59,173,1104,97,112,230,196,108,130,231
"2011","Hyndburn 004B","E01025052","Total",1482,152,70,82,1330,55,192,329,316,48,134,256
"2011","Hyndburn 004C","E01025057","Total",1571,223,118,105,1348,70,198,293,232,83,192,280
"2011","Hyndburn 004D","E01025058","Total",1351,252,131,121,1099,113,228,230,196,50,106,176
"2011","Hyndburn 004E","E01025059","Total",1435,249,111,138,1186,137,200,262,194,88,80,225
"2011","Hyndburn 004F","E01025067","Total",1491,291,79,212,1200,176,94,238,234,139,125,194
"2011","Hyndburn 004G","E01025068","Total",1512,325,112,213,1187,169,92,257,262,120,153,134
"2011","Hyndburn 004H","E01025069","Total",1481,198,62,136,1283,168,84,350,228,106,139,208
"2011","Hyndburn 005A","E01025044","Total",1236,144,57,87,1092,121,112,237,162,106,153,201
"2011","Hyndburn 005B","E01025045","Total",1281,173,77,96,1108,169,100,220,116,162,149,192
"2011","Hyndburn 005C","E01025046","Total",1218,293,126,167,925,126,92,195,232,70,83,127
"2011","Hyndburn 005D","E01025081","Total",1651,142,56,86,1509,69,170,349,288,79,235,319
"2011","Hyndburn 006A","E01025041","Total",1708,275,124,151,1433,156,102,185,118,236,395,241
"2011","Hyndburn 006B","E01025042","Total",2197,153,42,111,2044,129,82,236,126,418,763,290
"2011","Hyndburn 006E","E01025082","Total",1715,194,79,115,1521,270,104,238,172,173,270,294
"2011","Hyndburn 006F","E01025083","Total",1945,268,87,181,1677,267,134,383,266,137,281,209
"2011","Hyndburn 006G","E01025084","Total",1611,150,43,107,1461,157,76,190,156,296,343,243
"2011","Hyndburn 006H","E01033231","Total",2858,233,70,163,2625,182,122,396,176,482,887,380
"2011","Hyndburn 007A","E01025055","Total",1485,275,108,167,1210,166,136,320,232,69,122,165
"2011","Hyndburn 007B","E01025075","Total",1677,281,69,212,1396,122,116,403,320,62,172,201
"2011","Hyndburn 007C","E01025076","Total",1367,266,139,127,1101,119,128,293,160,72,143,186
"2011","Hyndburn 007D","E01025077","Total",1334,221,111,110,1113,114,204,180,244,32,140,199
"2011","Hyndburn 007E","E01025078","Total",1516,141,50,91,1375,59,202,357,264,80,132,281
"2011","Hyndburn 008A","E01025035","Total",1483,212,95,117,1271,51,176,242,220,75,198,309
"2011","Hyndburn 008B","E01025036","Total",1488,389,77,312,1099,123,86,223,286,111,114,156
"2011","Hyndburn 008C","E01025037","Total",1405,190,63,127,1215,140,170,334,200,31,110,230
"2011","Hyndburn 008D","E01025038","Total",1358,159,93,66,1199,67,252,262,226,40,137,215
"2011","Hyndburn 008E","E01025039","Total",1212,112,56,56,1100,31,132,285,208,37,128,279
"2011","Hyndburn 008F","E01025040","Total",1467,161,47,114,1306,53,178,326,264,63,153,269
"2011","Hyndburn 009A","E01025054","Total",1714,267,102,165,1447,68,194,273,294,81,238,299
"2011","Hyndburn 009B","E01025056","Total",1341,156,90,66,1185,35,268,245,262,45,113,217
"2011","Hyndburn 009C","E01025079","Total",1666,184,100,84,1482,84,282,268,276,52,160,360
"2011","Hyndburn 009D","E01025080","Total",1562,183,70,113,1379,72,156,278,288,56,185,344
"2011","Lancaster 001A","E01025088","Total",1121,118,52,66,1003,31,130,276,164,63,124,215
"2011","Lancaster 001B","E01025096","Total",1598,180,60,120,1418,69,160,427,292,109,99,262
"2011","Lancaster 001C","E01025097","Total",1488,208,119,89,1280,133,180,269,206,84,183,225
"2011","Lancaster 001D","E01025098","Total",1266,174,82,92,1092,52,204,251,288,36,72,189
"2011","Lancaster 001E","E01025148","Total",1991,265,162,103,1726,36,502,351,396,62,126,253
"2011","Lancaster 001F","E01025168","Total",1094,175,78,97,919,76,160,217,220,41,53,152
"2011","Lancaster 001G","E01025169","Total",1248,132,84,48,1116,43,256,280,210,62,62,203
"2011","Lancaster 002A","E01025130","Total",2118,269,144,125,1849,55,418,411,378,98,142,347
"2011","Lancaster 002B","E01025132","Total",1423,139,60,79,1284,31,218,219,268,105,136,307
"2011","Lancaster 002C","E01025166","Total",1167,161,90,71,1006,52,280,191,188,39,78,178
"2011","Lancaster 002D","E01025167","Total",1172,109,53,56,1063,18,192,210,208,107,136,192
"2011","Lancaster 003A","E01025089","Total",1383,199,111,88,1184,51,224,233,232,75,123,246
"2011","Lancaster 003B","E01025090","Total",1731,184,102,82,1547,57,352,360,292,69,167,250
"2011","Lancaster 003C","E01025158","Total",1359,178,125,53,1181,36,340,251,190,62,101,201
"2011","Lancaster 003D","E01025159","Total",1363,163,93,70,1200,39,278,223,238,46,125,251
"2011","Lancaster 003E","E01025160","Total",1255,129,92,37,1126,27,304,232,206,45,111,201
"2011","Lancaster 004A","E01025085","Total",1327,203,100,103,1124,72,242,231,178,65,146,190
"2011","Lancaster 004B","E01025086","Total",1324,223,152,71,1101,30,362,177,208,58,96,170
"2011","Lancaster 004C","E01025087","Total",1187,381,219,162,806,32,228,144,130,53,96,123
"2011","Lancaster 004D","E01025161","Total",1123,269,193,76,854,36,376,102,150,11,45,134
"2011","Lancaster 005A","E01025108","Total",1199,158,76,82,1041,46,190,259,198,89,61,198
"2011","Lancaster 005B","E01025109","Total",1045,122,76,46,923,38,164,228,170,64,127,132
"2011","Lancaster 005C","E01025131","Total",1533,185,97,88,1348,55,204,277,260,91,151,310
"2011","Lancaster 005D","E01025133","Total",1421,225,141,84,1196,56,294,292,236,43,95,180
"2011","Lancaster 006A","E01025112","Total",1629,338,119,219,1291,174,184,193,218,69,189,264
"2011","Lancaster 006B","E01025136","Total",1565,286,126,160,1279,250,106,294,182,95,189,163
"2011","Lancaster 006C","E01025138","Total",1460,162,71,91,1298,132,94,369,188,88,174,253
"2011","Lancaster 006D","E01025139","Total",1633,434,112,322,1199,153,120,180,250,100,175,221
"2011","Lancaster 006E","E01025140","Total",1294,294,113,181,1000,47,148,181,194,46,153,231
"2011","Lancaster 008A","E01025111","Total",1760,199,83,116,1561,172,158,396,254,88,175,318
"2011","Lancaster 008B","E01025113","Total",1519,177,78,99,1342,59,166,302,240,72,166,337
"2011","Lancaster 008C","E01025118","Total",1110,172,58,114,938,118,112,185,124,75,137,187
"2011","Lancaster 008D","E01025119","Total",1292,174,86,88,1118,99,156,268,208,37,110,240
"2011","Lancaster 009A","E01025110","Total",1371,358,61,297,1013,140,50,238,202,58,133,192
"2011","Lancaster 009B","E01025116","Total",1319,284,118,166,1035,96,164,154,218,50,141,212
"2011","Lancaster 009C","E01025117","Total",1406,290,43,247,1116,160,40,199,204,101,206,206
"2011","Lancaster 009D","E01025120","Total",1389,260,72,188,1129,137,98,267,178,137,112,200
"2011","Lancaster 010A","E01025170","Total",1679,297,163,134,1382,107,362,301,256,88,71,197
"2011","Lancaster 010B","E01025171","Total",1710,292,142,150,1418,265,258,241,222,106,105,221
"2011","Lancaster 010C","E01025172","Total",1509,166,62,104,1343,131,190,326,284,71,116,225
"2011","Lancaster 010D","E01025173","Total",1640,275,137,138,1365,153,276,246,218,98,136,238
"2011","Lancaster 011A","E01025149","Total",2127,329,95,234,1798,171,126,516,440,107,138,300
"2011","Lancaster 011B","E01025150","Total",1485,150,72,78,1335,115,136,298,252,89,132,313
"2011","Lancaster 011C","E01025151","Total",1538,331,94,237,1207,160,96,252,322,26,100,251
"2011","Lancaster 011D","E01025152","Total",1511,167,58,109,1344,177,110,307,228,85,175,262
"2011","Lancaster 011E","E01025154","Total",1339,267,147,120,1072,197,140,148,152,108,145,182
"2011","Lancaster 013A","E01025091","Total",1473,231,110,121,1242,86,170,258,196,133,172,227
"2011","Lancaster 013B","E01025092","Total",1177,170,79,91,1007,118,104,259,148,86,103,189
"2011","Lancaster 013C","E01025095","Total",1137,140,33,107,997,76,66,279,278,37,66,195
"2011","Lancaster 013D","E01025126","Total",1905,177,52,125,1728,52,150,489,364,92,133,448
"2011","Lancaster 014A","E01025093","Total",1623,259,51,208,1364,86,72,152,348,17,101,588
"2011","Lancaster 014B","E01025094","Total",1197,284,100,184,913,89,54,202,252,35,43,238
"2011","Lancaster 014C","E01025099","Total",1476,370,66,304,1106,84,84,193,366,21,69,289
"2011","Lancaster 014E","E01033071","Total",1113,294,38,256,819,27,32,87,292,38,48,295
"2011","Lancaster 014F","E01033073","Total",1462,319,121,198,1143,24,72,208,306,83,82,368
"2011","Lancaster 015A","E01025125","Total",995,86,27,59,909,55,44,80,184,11,52,483
"2011","Lancaster 015B","E01025128","Total",1313,268,64,204,1045,86,42,139,346,27,31,374
"2011","Lancaster 015C","E01025129","Total",1244,135,30,105,1109,35,28,157,218,61,85,525
"2011","Lancaster 015D","E01025147","Total",1432,188,68,120,1244,62,122,328,226,80,66,360
"2011","Lancaster 016A","E01025114","Total",1492,216,128,88,1276,46,288,274,212,73,132,251
"2011","Lancaster 016B","E01025115","Total",1570,192,98,94,1378,162,206,319,186,101,183,221
"2011","Lancaster 016C","E01025121","Total",1725,177,64,113,1548,131,234,375,330,57,187,234
"2011","Lancaster 016D","E01025122","Total",1711,244,137,107,1467,60,322,361,272,103,116,233
"2011","Lancaster 016E","E01025123","Total",2306,183,67,116,2123,146,220,646,392,135,242,342
"2011","Lancaster 016F","E01025124","Total",1510,227,93,134,1283,213,148,254,242,85,170,171
"2011","Lancaster 016I","E01033072","Total",2377,335,177,158,2042,100,428,388,380,152,243,351
"2011","Lancaster 017A","E01025100","Total",1450,222,75,147,1228,105,100,324,318,88,69,224
"2011","Lancaster 017B","E01025101","Total",1413,230,80,150,1183,139,102,260,250,113,140,179
"2011","Lancaster 017C","E01025102","Total",1435,166,69,97,1269,37,90,221,174,81,200,466
"2011","Lancaster 017D","E01025103","Total",1337,106,51,55,1231,35,142,315,236,85,141,277
"2011","Lancaster 017E","E01025144","Total",1665,300,100,200,1365,74,132,313,366,62,86,332
"2011","Lancaster 017F","E01025146","Total",1988,164,89,75,1824,47,270,459,322,128,239,359
"2011","Lancaster 018A","E01025127","Total",1376,154,91,63,1222,22,246,311,236,28,133,246
"2011","Lancaster 018B","E01025141","Total",1443,193,99,94,1250,27,160,322,188,100,113,340
"2011","Lancaster 018C","E01025143","Total",1423,225,125,100,1198,109,162,260,196,48,128,295
"2011","Lancaster 018D","E01025145","Total",1472,171,62,109,1301,141,82,317,288,91,101,281
"2011","Lancaster 019A","E01025105","Total",1332,98,43,55,1234,23,184,264,218,110,149,286
"2011","Lancaster 019B","E01025106","Total",1704,225,96,129,1479,103,178,406,352,89,150,201
"2011","Lancaster 019C","E01025107","Total",1637,163,64,99,1474,28,240,281,312,130,150,333
"2011","Lancaster 019D","E01025142","Total",1435,154,89,65,1281,40,262,162,264,55,179,319
"2011","Lancaster 020A","E01025137","Total",1446,161,90,71,1285,81,172,343,208,75,154,252
"2011","Lancaster 020F","E01025153","Total",1245,103,46,57,1142,69,142,253,236,73,145,224
"2011","Lancaster 020G","E01025155","Total",1258,118,62,56,1140,49,152,242,220,88,125,264
"2011","Lancaster 020H","E01025156","Total",1175,112,26,86,1063,288,58,172,112,94,187,152
"2011","Lancaster 020I","E01025157","Total",1153,245,134,111,908,78,136,214,168,46,100,166
"2011","Lancaster 020B","E01025162","Total",1348,260,191,69,1088,29,316,219,220,36,89,179
"2011","Lancaster 020C","E01025163","Total",1384,180,115,65,1204,30,304,261,194,36,98,281
"2011","Lancaster 020D","E01025164","Total",1355,218,122,96,1137,76,202,264,218,32,104,241
"2011","Lancaster 020E","E01025165","Total",1500,124,32,92,1376,78,122,444,244,93,173,222
"2011","Pendle 001A","E01025191","Total",1254,139,70,69,1115,43,158,291,206,57,127,233
"2011","Pendle 001B","E01025192","Total",1394,197,63,134,1197,109,114,328,212,107,114,213
"2011","Pendle 001C","E01025193","Total",1358,172,110,62,1186,75,224,300,232,35,98,222
"2011","Pendle 001D","E01025194","Total",1395,217,101,116,1178,106,98,284,252,75,138,225
"2011","Pendle 002A","E01025195","Total",1210,133,50,83,1077,44,142,273,248,51,99,220
"2011","Pendle 002B","E01025196","Total",1577,370,84,286,1207,83,146,255,330,79,148,166
"2011","Pendle 002C","E01025197","Total",1341,150,78,72,1191,13,226,238,202,77,150,285
"2011","Pendle 002D","E01025198","Total",1386,216,108,108,1170,63,152,237,192,118,183,225
"2011","Pendle 003A","E01025199","Total",1678,195,75,120,1483,72,246,319,336,84,164,262
"2011","Pendle 003B","E01025200","Total",1522,206,88,118,1316,73,164,301,288,108,149,233
"2011","Pendle 003C","E01025201","Total",1599,203,101,102,1396,92,182,282,290,118,173,259
"2011","Pendle 003D","E01025202","Total",1381,138,59,79,1243,74,208,255,292,66,142,206
"2011","Pendle 004A","E01025205","Total",1381,198,58,140,1183,141,72,318,230,68,154,200
"2011","Pendle 004B","E01025206","Total",1173,125,79,46,1048,56,220,180,210,41,119,222
"2011","Pendle 004C","E01025207","Total",1265,318,104,214,947,88,102,198,286,29,76,168
"2011","Pendle 004D","E01025208","Total",1203,366,175,191,837,77,126,153,148,39,98,196
"2011","Pendle 005A","E01025220","Total",1594,189,69,120,1405,269,114,332,200,139,163,188
"2011","Pendle 005B","E01025221","Total",1351,120,46,74,1231,141,106,314,190,107,175,198
"2011","Pendle 005C","E01025222","Total",1454,158,66,92,1296,61,188,280,268,86,160,253
"2011","Pendle 005D","E01025223","Total",1351,245,92,153,1106,103,116,222,204,104,129,228
"2011","Pendle 006A","E01025178","Total",1795,229,113,116,1566,71,228,394,338,51,150,334
"2011","Pendle 006B","E01025179","Total",1570,196,78,118,1374,89,182,361,320,36,105,281
"2011","Pendle 006C","E01025180","Total",1876,171,72,99,1705,70,220,457,350,83,173,352
"2011","Pendle 006D","E01025203","Total",1683,194,89,105,1489,24,266,313,384,79,144,279
"2011","Pendle 007A","E01025226","Total",1574,364,98,266,1210,159,112,232,268,104,135,200
"2011","Pendle 007B","E01025227","Total",2002,442,104,338,1560,192,164,293,290,167,151,303
"2011","Pendle 007C","E01025228","Total",1577,162,64,98,1415,92,142,359,298,84,192,248
"2011","Pendle 008A","E01025174","Total",1439,156,77,79,1283,39,240,243,260,87,148,266
"2011","Pendle 008B","E01025175","Total",1539,175,80,95,1364,55,222,334,262,71,140,280
"2011","Pendle 008C","E01025176","Total",2002,434,178,256,1568,135,146,412,450,75,134,216
"2011","Pendle 008D","E01025177","Total",1782,192,92,100,1590,51,324,346,368,52,152,297
"2011","Pendle 008E","E01025204","Total",1640,178,74,104,1462,41,270,309,354,82,103,303
"2011","Pendle 008F","E01025211","Total",1459,191,113,78,1268,41,284,312,248,65,80,238
"2011","Pendle 009A","E01025181","Total",1565,205,100,105,1360,149,162,277,132,231,243,166
"2011","Pendle 009B","E01025182","Total",1627,248,79,169,1379,59,88,201,140,235,412,244
"2011","Pendle 009C","E01025183","Total",1626,292,93,199,1334,95,102,252,190,172,277,246
"2011","Pendle 009D","E01025184","Total",1648,149,44,105,1499,105,48,259,110,254,485,238
"2011","Pendle 010A","E01025188","Total",2013,395,170,225,1618,164,168,264,190,240,324,268
"2011","Pendle 010B","E01025189","Total",1679,236,52,184,1443,158,94,268,232,195,265,231
"2011","Pendle 010C","E01025210","Total",1796,272,97,175,1524,201,150,348,272,86,171,296
"2011","Pendle 010D","E01025217","Total",1508,240,76,164,1268,109,98,254,206,195,196,210
"2011","Pendle 010E","E01025218","Total",1249,245,71,174,1004,67,58,167,98,182,317,115
"2011","Pendle 010F","E01025219","Total",1160,243,43,200,917,109,74,195,144,148,123,124
"2011","Pendle 011A","E01025224","Total",2165,244,95,149,1921,135,146,320,168,358,481,313
"2011","Pendle 011B","E01025225","Total",1683,204,89,115,1479,82,188,296,144,183,288,298
"2011","Pendle 011C","E01025229","Total",2222,165,58,107,2057,87,76,244,170,364,711,405
"2011","Pendle 011D","E01025230","Total",1632,197,72,125,1435,38,46,187,146,261,529,228
"2011","Pendle 012A","E01025187","Total",1424,165,79,86,1259,49,228,186,194,118,242,242
"2011","Pendle 012B","E01025190","Total",1661,155,65,90,1506,84,198,245,250,142,261,326
"2011","Pendle 012C","E01025209","Total",1686,181,96,85,1505,142,236,260,202,132,216,317
"2011","Pendle 012D","E01025216","Total",2036,158,78,80,1878,122,140,341,236,249,412,378
"2011","Pendle 013A","E01025185","Total",1886,248,105,143,1638,85,172,261,186,167,461,306
"2011","Pendle 013B","E01025186","Total",1509,223,55,168,1286,83,100,211,152,223,294,223
"2011","Pendle 013C","E01025212","Total",1402,109,70,39,1293,34,246,146,182,124,245,316
"2011","Pendle 013D","E01025213","Total",1122,102,66,36,1020,47,100,183,144,138,202,206
"2011","Pendle 013E","E01025214","Total",1361,97,38,59,1264,35,194,237,236,64,196,302
"2011","Pendle 013F","E01025215","Total",1381,176,63,113,1205,79,82,141,118,162,417,206
"2011","Preston 001A","E01025278","Total",2517,230,106,124,2287,68,342,664,372,162,256,423
"2011","Preston 001B","E01025279","Total",1914,140,58,82,1774,21,262,342,270,119,327,433
"2011","Preston 001C","E01025282","Total",1367,150,93,57,1217,33,182,280,228,105,109,280
"2011","Preston 002A","E01025257","Total",1346,69,40,29,1277,23,194,270,194,60,159,377
"2011","Preston 002B","E01025277","Total",1722,199,149,50,1523,21,330,339,230,89,150,364
"2011","Preston 002C","E01025280","Total",1785,148,55,93,1637,63,210,330,296,94,239,405
"2011","Preston 002D","E01025281","Total",1500,109,57,52,1391,35,256,342,184,59,216,299
"2011","Preston 003A","E01025256","Total",1503,207,144,63,1296,31,238,279,168,101,194,285
"2011","Preston 003B","E01025258","Total",1490,170,119,51,1320,39,306,270,190,52,182,281
"2011","Preston 003C","E01025259","Total",2065,237,134,103,1828,60,312,466,290,81,232,387
"2011","Preston 003D","E01025299","Total",1441,180,99,81,1261,28,230,314,236,76,156,221
"2011","Preston 003E","E01025301","Total",1128,146,26,120,982,64,64,255,170,97,110,222
"2011","Preston 003F","E01025302","Total",1213,120,52,68,1093,30,170,280,208,57,77,271
"2011","Preston 004A","E01025253","Total",1773,157,20,137,1616,61,34,587,384,98,204,248
"2011","Preston 004B","E01025254","Total",1154,129,60,69,1025,28,118,318,172,52,112,225
"2011","Preston 004C","E01025255","Total",1595,107,12,95,1488,88,100,465,264,100,267,204
"2011","Preston 004D","E01025300","Total",1027,287,124,163,740,9,174,126,126,26,58,221
"2011","Preston 004E","E01025303","Total",1339,215,68,147,1124,53,118,254,246,45,148,260
"2011","Preston 005A","E01025260","Total",1449,377,117,260,1072,190,118,229,236,97,106,96
"2011","Preston 005B","E01025262","Total",1510,287,127,160,1223,111,178,228,214,82,123,287
"2011","Preston 005C","E01025263","Total",1417,217,63,154,1200,193,130,243,200,118,125,191
"2011","Preston 005D","E01025264","Total",1451,223,51,172,1228,177,114,213,230,83,143,268
"2011","Preston 006A","E01025239","Total",1393,251,153,98,1142,35,232,227,210,92,107,239
"2011","Preston 006B","E01025241","Total",1585,214,113,101,1371,40,206,294,214,72,239,306
"2011","Preston 006C","E01025242","Total",1565,142,97,45,1423,23,288,302,216,107,241,246
"2011","Preston 006D","E01025243","Total",1924,281,100,181,1643,52,146,346,284,162,305,348
"2011","Preston 006E","E01025251","Total",1494,155,94,61,1339,61,154,235,146,123,355,265
"2011","Preston 007A","E01025234","Total",1416,156,50,106,1260,106,110,319,198,79,191,257
"2011","Preston 007B","E01025235","Total",1647,174,85,89,1473,63,258,285,210,114,198,345
"2011","Preston 007C","E01025237","Total",1488,213,105,108,1275,154,138,240,218,68,184,273
"2011","Preston 007D","E01025238","Total",1556,216,83,133,1340,231,96,316,150,121,175,251
"2011","Preston 007E","E01025245","Total",2663,243,92,151,2420,288,130,414,236,333,627,392
"2011","Preston 007F","E01025252","Total",1339,253,135,118,1086,74,166,240,198,49,148,211
"2011","Preston 008A","E01025233","Total",1363,120,58,62,1243,46,142,314,160,91,206,284
"2011","Preston 008B","E01025240","Total",1545,174,110,64,1371,62,220,261,246,52,197,333
"2011","Preston 008C","E01025261","Total",1378,224,111,113,1154,32,232,219,246,70,122,233
"2011","Preston 008D","E01025266","Total",1262,127,82,45,1135,61,196,205,178,55,186,254
"2011","Preston 008E","E01025309","Total",1160,164,84,80,996,87,144,193,188,66,120,198
"2011","Preston 009A","E01025236","Total",1450,177,63,114,1273,215,74,278,138,155,197,216
"2011","Preston 009B","E01025283","Total",1685,166,59,107,1519,382,80,269,144,185,251,208
"2011","Preston 009C","E01025284","Total",1709,176,76,100,1533,126,124,297,242,153,246,345
"2011","Preston 009D","E01025285","Total",1428,131,52,79,1297,116,134,174,136,145,301,291
"2011","Preston 009E","E01025286","Total",1706,212,57,155,1494,221,76,315,216,165,272,229
"2011","Preston 009F","E01025287","Total",1961,482,130,352,1479,200,122,286,292,173,189,217
"2011","Preston 010A","E01025270","Total",1592,178,62,116,1414,71,174,341,274,46,186,322
"2011","Preston 010B","E01025272","Total",1584,145,46,99,1439,51,100,389,284,109,219,287
"2011","Preston 010C","E01025273","Total",1420,82,19,63,1338,41,70,483,202,67,195,280
"2011","Preston 010D","E01025288","Total",1567,462,65,397,1105,125,80,248,434,42,30,146
"2011","Preston 011A","E01025246","Total",1750,111,33,78,1639,52,84,318,104,281,465,335
"2011","Preston 011B","E01025274","Total",1857,306,50,256,1551,118,54,268,328,67,91,625
"2011","Preston 011C","E01025275","Total",1546,358,97,261,1188,138,98,246,240,47,114,305
"2011","Preston 011D","E01025294","Total",1809,203,42,161,1606,88,52,371,212,185,272,426
"2011","Preston 012A","E01025276","Total",1695,182,55,127,1513,101,132,269,200,127,237,447
"2011","Preston 012B","E01025308","Total",1717,237,42,195,1480,169,54,307,318,110,102,420
"2011","Preston 012C","E01025310","Total",1497,263,73,190,1234,108,84,271,314,58,98,301
"2011","Preston 012D","E01025311","Total",1346,269,88,181,1077,126,80,286,292,65,56,172
"2011","Preston 012E","E01025312","Total",1640,263,50,213,1377,149,74,314,356,60,121,303
"2011","Preston 012F","E01025313","Total",1242,337,82,255,905,90,66,140,226,36,59,288
"2011","Preston 012G","E01025314","Total",1631,360,59,301,1271,98,80,235,378,19,66,395
"2011","Preston 013A","E01025231","Total",1373,197,90,107,1176,28,174,272,190,76,210,226
"2011","Preston 013B","E01025232","Total",1602,311,53,258,1291,122,56,311,316,55,97,334
"2011","Preston 013C","E01025265","Total",1490,193,57,136,1297,96,118,302,292,96,128,265
"2011","Preston 013D","E01025267","Total",1446,214,100,114,1232,94,164,288,178,83,175,250
"2011","Preston 013E","E01025268","Total",1664,364,137,227,1300,174,126,334,228,47,143,248
"2011","Preston 013F","E01025269","Total",1638,182,75,107,1456,177,126,358,214,120,222,239
"2011","Preston 013G","E01025271","Total",1557,162,94,68,1395,114,186,231,184,97,243,340
"2011","Preston 014A","E01025295","Total",1986,613,181,432,1373,156,112,258,342,148,176,181
"2011","Preston 014B","E01025296","Total",1950,250,59,191,1700,268,66,349,180,208,293,336
"2011","Preston 014C","E01025297","Total",2057,283,67,216,1774,268,80,388,242,224,266,306
"2011","Preston 014D","E01025298","Total",1621,173,46,127,1448,157,74,336,188,166,303,224
"2011","Preston 015A","E01025244","Total",1690,96,24,72,1594,90,60,284,138,212,504,306
"2011","Preston 015B","E01025292","Total",1371,398,52,346,973,97,50,117,340,71,57,241
"2011","Preston 015C","E01025293","Total",2030,438,128,310,1592,128,126,213,228,142,384,371
"2011","Preston 016A","E01025247","Total",1728,225,55,170,1503,138,70,317,216,198,360,204
"2011","Preston 016B","E01025248","Total",1328,134,48,86,1194,243,74,268,144,137,159,169
"2011","Preston 016C","E01025249","Total",976,155,88,67,821,34,126,190,112,61,97,201
"2011","Preston 016D","E01025250","Total",1712,205,38,167,1507,218,76,247,150,214,313,289
"2011","Preston 016E","E01025304","Total",1845,139,67,72,1706,58,148,285,166,277,437,335
"2011","Preston 016F","E01025305","Total",1641,247,73,174,1394,135,98,183,186,134,337,321
"2011","Preston 017A","E01025289","Total",1665,262,40,222,1403,115,60,207,340,57,111,513
"2011","Preston 017B","E01025290","Total",1675,391,43,348,1284,90,40,163,244,74,155,518
"2011","Preston 017C","E01025291","Total",1365,295,88,207,1070,104,86,227,210,62,95,286
"2011","Preston 017D","E01025306","Total",1762,448,52,396,1314,41,48,141,338,101,269,376
"2011","Preston 017F","E01033223","Total",833,452,65,387,381,2,22,49,190,5,11,102
"2011","Preston 017G","E01033224","Total",995,370,85,285,625,75,30,113,208,64,35,100
"2011","Preston 017H","E01033226","Total",1076,327,59,268,749,35,50,133,174,65,169,123
"2011","Ribble Valley 001A","E01025315","Total",1400,134,60,74,1266,38,196,247,176,125,188,296
"2011","Ribble Valley 001B","E01025320","Total",1320,128,64,64,1192,26,170,226,232,111,166,261
"2011","Ribble Valley 001C","E01025331","Total",1380,137,68,69,1243,36,184,286,232,96,174,235
"2011","Ribble Valley 001D","E01025348","Total",1517,235,143,92,1282,36,342,190,300,64,90,260
"2011","Ribble Valley 001E","E01025349","Total",1389,133,64,69,1256,19,210,350,234,92,100,251
"2011","Ribble Valley 002A","E01025334","Total",1528,203,97,106,1325,77,250,309,252,69,150,218
"2011","Ribble Valley 002B","E01025344","Total",1367,230,123,107,1137,91,178,315,182,62,147,162
"2011","Ribble Valley 002C","E01025345","Total",1432,176,109,67,1256,45,242,332,228,84,121,204
"2011","Ribble Valley 002D","E01025346","Total",1502,191,62,129,1311,82,124,400,268,93,104,240
"2011","Ribble Valley 002E","E01025347","Total",1617,196,72,124,1421,82,176,402,250,120,149,242
"2011","Ribble Valley 003A","E01025329","Total",1426,191,118,73,1235,57,218,282,186,77,151,264
"2011","Ribble Valley 003B","E01025330","Total",1286,224,90,134,1062,65,176,282,198,64,89,188
"2011","Ribble Valley 003C","E01025335","Total",1373,339,173,166,1034,109,186,215,174,95,89,166
"2011","Ribble Valley 003D","E01025338","Total",1562,275,74,201,1287,102,114,342,284,78,120,247
"2011","Ribble Valley 003E","E01025339","Total",1483,209,96,113,1274,84,184,304,208,64,122,308
"2011","Ribble Valley 004A","E01025322","Total",1345,115,58,57,1230,57,200,240,234,68,146,285
"2011","Ribble Valley 004B","E01025326","Total",1423,187,101,86,1236,67,188,231,254,73,129,294
"2011","Ribble Valley 004C","E01025327","Total",1316,141,71,70,1175,54,160,306,208,82,131,234
"2011","Ribble Valley 004D","E01025342","Total",1590,183,81,102,1407,89,226,300,240,102,144,306
"2011","Ribble Valley 005A","E01025321","Total",1262,175,79,96,1087,38,178,281,204,40,129,217
"2011","Ribble Valley 005B","E01025340","Total",1402,177,74,103,1225,103,184,278,224,61,137,238
"2011","Ribble Valley 005C","E01025341","Total",1171,107,66,41,1064,37,202,232,168,77,115,233
"2011","Ribble Valley 005D","E01025343","Total",1422,179,86,93,1243,66,178,326,240,98,112,223
"2011","Ribble Valley 005E","E01025354","Total",1316,153,73,80,1163,57,218,299,206,70,92,221
"2011","Ribble Valley 006A","E01025316","Total",1480,110,48,62,1370,56,180,297,230,74,204,329
"2011","Ribble Valley 006B","E01025317","Total",1150,140,56,84,1010,150,122,257,178,50,118,135
"2011","Ribble Valley 006C","E01025325","Total",1518,313,156,157,1205,96,134,267,262,71,157,218
"2011","Ribble Valley 006D","E01025328","Total",1188,129,62,67,1059,87,218,228,180,85,104,157
"2011","Ribble Valley 007A","E01025318","Total",1060,136,77,59,924,62,122,217,172,104,77,170
"2011","Ribble Valley 007B","E01025319","Total",2082,179,61,118,1903,48,218,644,290,130,301,272
"2011","Ribble Valley 007C","E01025333","Total",1212,161,73,88,1051,22,188,264,210,36,135,196
"2011","Ribble Valley 007D","E01025350","Total",1263,195,117,78,1068,33,190,232,168,71,175,199
"2011","Ribble Valley 007E","E01025351","Total",2424,246,124,122,2178,107,310,659,316,190,258,338
"2011","Ribble Valley 008A","E01025323","Total",1132,120,74,46,1012,49,222,190,162,49,152,188
"2011","Ribble Valley 008B","E01025324","Total",1383,150,71,79,1233,76,226,340,218,67,111,195
"2011","Ribble Valley 008C","E01025332","Total",1049,83,56,27,966,31,236,191,152,50,133,173
"2011","Ribble Valley 008D","E01025336","Total",1121,124,66,58,997,44,196,219,204,56,84,194
"2011","Ribble Valley 008E","E01025337","Total",1551,211,125,86,1340,31,278,323,252,96,100,260
"2011","Ribble Valley 008F","E01025352","Total",1432,112,77,35,1320,33,220,337,166,83,171,310
"2011","Ribble Valley 008G","E01025353","Total",1077,121,51,70,956,66,174,238,158,61,84,175
"2011","Rossendale 001A","E01025355","Total",2209,146,54,92,2063,92,180,553,390,145,234,469
"2011","Rossendale 001B","E01025361","Total",2035,261,92,169,1774,110,136,484,454,103,157,330
"2011","Rossendale 001C","E01025362","Total",1971,206,86,120,1765,47,218,547,374,115,177,287
"2011","Rossendale 001D","E01025393","Total",1417,181,64,117,1236,58,128,207,312,69,190,272
"2011","Rossendale 002A","E01025363","Total",1265,186,105,81,1079,66,150,261,164,57,165,216
"2011","Rossendale 002B","E01025364","Total",1310,126,56,70,1184,17,190,256,228,36,181,276
"2011","Rossendale 002C","E01025366","Total",1557,188,42,146,1369,134,94,250,178,178,340,195
"2011","Rossendale 002D","E01025395","Total",1565,231,85,146,1334,64,204,306,298,89,140,233
"2011","Rossendale 002E","E01025396","Total",1375,321,102,219,1054,99,116,170,168,104,252,145
"2011","Rossendale 002F","E01025397","Total",1662,204,44,160,1458,131,92,317,222,177,293,226
"2011","Rossendale 002G","E01025398","Total",1406,165,50,115,1241,142,84,310,186,156,200,163
"2011","Rossendale 003A","E01025367","Total",1752,144,42,102,1608,66,136,435,306,121,198,346
"2011","Rossendale 003B","E01025368","Total",1562,223,76,147,1339,97,168,343,264,100,121,246
"2011","Rossendale 003C","E01025369","Total",1208,216,80,136,992,126,82,202,200,65,135,182
"2011","Rossendale 003D","E01025381","Total",1473,187,59,128,1286,161,132,338,208,121,88,238
"2011","Rossendale 003E","E01025382","Total",1722,303,96,207,1419,178,164,308,266,119,153,231
"2011","Rossendale 003F","E01025383","Total",2309,211,70,141,2098,100,198,569,414,180,237,400
"2011","Rossendale 004A","E01025356","Total",1449,198,76,122,1251,127,150,264,234,80,220,176
"2011","Rossendale 004C","E01025373","Total",1561,214,101,113,1347,53,190,300,260,75,209,260
"2011","Rossendale 004D","E01025385","Total",1250,228,81,147,1022,160,122,209,190,57,119,165
"2011","Rossendale 004F","E01025387","Total",1320,112,45,67,1208,54,148,222,182,115,234,253
"2011","Rossendale 004G","E01033281","Total",2598,376,136,240,2222,144,238,444,436,141,404,415
"2011","Rossendale 007A","E01025377","Total",1413,109,41,68,1304,40,124,366,270,73,135,296
"2011","Rossendale 007B","E01025378","Total",1500,180,49,131,1320,42,146,388,306,73,125,240
"2011","Rossendale 007C","E01025379","Total",1280,248,125,123,1032,117,180,197,182,67,108,181
"2011","Rossendale 007D","E01025380","Total",1486,109,64,45,1377,42,240,311,212,93,162,317
"2011","Rossendale 008A","E01025357","Total",1302,214,75,139,1088,110,112,262,242,59,100,203
"2011","Rossendale 008B","E01025358","Total",2181,254,98,156,1927,58,240,487,464,111,183,384
"2011","Rossendale 008C","E01025365","Total",1488,186,90,96,1302,43,184,309,296,57,151,262
"2011","Rossendale 008D","E01025384","Total",1193,157,76,81,1036,39,172,237,242,56,124,166
"2011","Rossendale 009A","E01025359","Total",1627,187,78,109,1440,62,232,295,312,65,174,300
"2011","Rossendale 009B","E01025360","Total",1952,337,141,196,1615,85,248,339,350,118,176,299
"2011","Rossendale 009C","E01025375","Total",1660,139,40,99,1521,86,186,324,354,62,176,333
"2011","Rossendale 009D","E01025376","Total",2227,358,147,211,1869,241,168,511,254,143,233,319
"2011","Rossendale 010F","E01025370","Total",1173,151,52,99,1022,54,136,176,218,41,151,246
"2011","Rossendale 010A","E01025371","Total",1400,237,96,141,1163,88,158,284,232,98,136,167
"2011","Rossendale 010B","E01025374","Total",1418,211,97,114,1207,52,180,277,222,101,139,236
"2011","Rossendale 010G","E01025388","Total",1462,238,75,163,1224,103,158,249,218,132,134,230
"2011","Rossendale 010H","E01025389","Total",1232,193,69,124,1039,119,98,265,156,115,67,219
"2011","Rossendale 010I","E01025390","Total",1092,204,93,111,888,90,134,154,164,80,106,160
"2011","Rossendale 010C","E01025391","Total",1491,220,69,151,1271,172,140,284,202,86,151,236
"2011","Rossendale 010D","E01025392","Total",1191,206,79,127,985,71,146,218,238,47,47,218
"2011","Rossendale 010E","E01025394","Total",1518,223,79,144,1295,104,126,277,262,133,151,242
"2011","South Ribble 001A","E01025424","Total",1261,100,49,51,1161,34,178,308,214,67,131,229
"2011","South Ribble 001B","E01025425","Total",1312,125,67,58,1187,53,142,334,194,57,130,277
"2011","South Ribble 001C","E01025426","Total",1234,118,77,41,1116,31,174,254,188,53,146,270
"2011","South Ribble 001D","E01025466","Total",1491,155,101,54,1336,67,198,330,238,101,139,263
"2011","South Ribble 002A","E01025413","Total",1774,206,130,76,1568,88,276,325,296,104,142,337
"2011","South Ribble 002B","E01025414","Total",1571,164,96,68,1407,24,310,261,266,56,116,374
"2011","South Ribble 002C","E01025456","Total",1158,101,50,51,1057,31,174,186,218,73,167,208
"2011","South Ribble 002D","E01025458","Total",1476,221,88,133,1255,95,138,322,268,53,128,251
"2011","South Ribble 003A","E01025408","Total",1447,190,109,81,1257,43,226,223,276,35,141,313
"2011","South Ribble 003B","E01025409","Total",1322,166,60,106,1156,48,146,244,250,72,130,266
"2011","South Ribble 003C","E01025410","Total",1394,96,51,45,1298,24,116,374,194,84,174,332
"2011","South Ribble 003D","E01025467","Total",2009,237,160,77,1772,54,384,338,296,65,203,432
"2011","South Ribble 004A","E01025403","Total",2021,158,39,119,1863,85,126,663,384,142,179,284
"2011","South Ribble 004B","E01025457","Total",1393,199,78,121,1194,59,154,256,280,70,141,234
"2011","South Ribble 004C","E01025463","Total",1339,156,58,98,1183,55,130,329,252,56,123,238
"2011","South Ribble 004D","E01025464","Total",1297,87,49,38,1210,10,180,306,212,58,177,267
"2011","South Ribble 004E","E01025465","Total",1118,156,73,83,962,54,136,245,226,26,95,180
"2011","South Ribble 005A","E01025411","Total",2054,214,84,130,1840,117,250,492,404,93,166,318
"2011","South Ribble 005B","E01025448","Total",1608,200,75,125,1408,66,198,318,318,56,188,264
"2011","South Ribble 005C","E01025449","Total",1002,136,98,38,866,21,114,179,140,36,155,221
"2011","South Ribble 005D","E01025450","Total",1030,112,41,71,918,93,100,262,126,31,153,153
"2011","South Ribble 006A","E01025412","Total",1478,226,110,116,1252,74,214,295,252,88,117,212
"2011","South Ribble 006B","E01025427","Total",1438,349,102,247,1089,87,168,238,214,58,127,197
"2011","South Ribble 006C","E01025428","Total",1479,187,71,116,1292,87,146,332,218,66,190,253
"2011","South Ribble 006D","E01025429","Total",1347,214,62,152,1133,202,70,259,246,97,97,162
"2011","South Ribble 007A","E01025404","Total",1209,165,124,41,1044,23,270,155,152,56,84,304
"2011","South Ribble 007B","E01025405","Total",1142,221,116,105,921,79,144,163,214,46,98,177
"2011","South Ribble 007C","E01025406","Total",1223,163,104,59,1060,50,218,211,190,15,144,232
"2011","South Ribble 007D","E01025407","Total",1950,281,96,185,1669,218,134,368,344,85,210,310
"2011","South Ribble 008A","E01025399","Total",1579,143,57,86,1436,188,110,350,212,129,192,255
"2011","South Ribble 008B","E01025400","Total",1804,140,63,77,1664,124,238,435,276,79,203,309
"2011","South Ribble 008C","E01025401","Total",1472,182,72,110,1290,47,224,270,262,77,103,307
"2011","South Ribble 008D","E01025402","Total",1435,154,45,109,1281,93,130,431,248,76,115,188
"2011","South Ribble 009A","E01025442","Total",1075,195,61,134,880,103,72,246,238,41,54,126
"2011","South Ribble 009B","E01025443","Total",1337,166,74,92,1171,56,206,236,282,54,99,238
"2011","South Ribble 009C","E01025444","Total",1316,143,49,94,1173,64,132,312,256,71,94,244
"2011","South Ribble 009D","E01025461","Total",1941,144,68,76,1797,48,184,531,284,117,242,391
"2011","South Ribble 009E","E01025462","Total",1702,175,73,102,1527,69,218,399,282,89,188,282
"2011","South Ribble 010A","E01025439","Total",1358,144,94,50,1214,44,268,285,200,84,76,257
"2011","South Ribble 010B","E01025453","Total",1630,150,81,69,1480,65,284,305,218,81,166,361
"2011","South Ribble 010C","E01025454","Total",1279,99,66,33,1180,34,228,253,168,76,173,248
"2011","South Ribble 010D","E01025455","Total",1458,168,105,63,1290,31,310,265,222,70,124,268
"2011","South Ribble 011A","E01025436","Total",2277,200,101,99,2077,63,312,502,366,93,258,483
"2011","South Ribble 011B","E01025437","Total",1790,227,107,120,1563,85,236,410,284,78,127,343
"2011","South Ribble 011C","E01025438","Total",1267,101,54,47,1166,32,196,269,252,61,114,242
"2011","South Ribble 011D","E01025440","Total",1412,153,107,46,1259,26,278,257,206,88,130,274
"2011","South Ribble 011E","E01025441","Total",1408,221,154,67,1187,43,266,270,216,45,97,250
"2011","South Ribble 012A","E01025417","Total",1413,157,83,74,1256,45,226,263,272,44,113,293
"2011","South Ribble 012B","E01025418","Total",1399,163,77,86,1236,88,164,296,242,71,113,262
"2011","South Ribble 012C","E01025419","Total",1576,202,96,106,1374,94,128,344,222,95,193,298
"2011","South Ribble 012D","E01025420","Total",2748,195,88,107,2553,76,316,659,432,151,338,581
"2011","South Ribble 013A","E01025421","Total",2304,199,35,164,2105,165,130,605,434,250,196,325
"2011","South Ribble 013B","E01025422","Total",1340,233,140,93,1107,100,140,223,260,35,117,232
"2011","South Ribble 013C","E01025431","Total",1738,249,55,194,1489,160,76,423,356,91,138,245
"2011","South Ribble 013D","E01025433","Total",1803,184,80,104,1619,119,194,381,322,64,156,383
"2011","South Ribble 014A","E01025416","Total",1511,129,55,74,1382,45,196,308,286,91,158,298
"2011","South Ribble 014B","E01025451","Total",1970,121,38,83,1849,67,150,585,332,104,234,377
"2011","South Ribble 014C","E01025452","Total",1703,226,68,158,1477,221,120,306,310,84,164,272
"2011","South Ribble 015A","E01025415","Total",2051,223,94,129,1828,114,216,405,344,93,257,399
"2011","South Ribble 015B","E01025423","Total",1353,209,84,125,1144,188,128,278,182,77,134,157
"2011","South Ribble 015C","E01025435","Total",1469,222,111,111,1247,64,204,315,242,68,100,254
"2011","South Ribble 015D","E01025446","Total",1481,193,108,85,1288,71,232,292,240,36,135,282
"2011","South Ribble 016A","E01025430","Total",1993,173,100,73,1820,149,220,407,306,106,203,429
"2011","South Ribble 016C","E01025434","Total",1962,161,118,43,1801,22,466,316,304,75,209,409
"2011","South Ribble 016D","E01032928","Total",1929,215,27,188,1714,170,54,621,514,104,90,161
"2011","South Ribble 016E","E01032929","Total",1084,148,88,60,936,66,176,158,216,48,88,184
"2011","South Ribble 017A","E01025445","Total",1443,118,37,81,1325,235,102,322,158,119,202,187
"2011","South Ribble 017B","E01025447","Total",1186,218,121,97,968,155,82,201,130,103,151,146
"2011","South Ribble 017C","E01025459","Total",1646,179,76,103,1467,87,238,304,318,74,156,290
"2011","South Ribble 017D","E01025460","Total",2006,328,94,234,1678,129,192,394,338,134,174,317
"2011","West Lancashire 001A","E01025496","Total",1204,112,60,52,1092,63,142,236,180,71,142,258
"2011","West Lancashire 001B","E01025497","Total",1548,85,33,52,1463,48,162,411,222,94,216,310
"2011","West Lancashire 001C","E01025498","Total",1265,117,57,60,1148,39,194,231,210,75,135,264
"2011","West Lancashire 001D","E01025530","Total",1437,140,65,75,1297,38,274,285,238,48,111,303
"2011","West Lancashire 001E","E01025532","Total",1534,110,62,48,1424,46,272,351,226,63,222,244
"2011","West Lancashire 001F","E01025533","Total",1571,222,132,90,1349,57,240,355,264,41,125,267
"2011","West Lancashire 002A","E01025507","Total",1525,179,66,113,1346,74,256,285,300,51,144,236
"2011","West Lancashire 002B","E01025508","Total",1394,194,97,97,1200,70,196,204,226,90,126,288
"2011","West Lancashire 002C","E01025509","Total",1198,186,101,85,1012,71,166,190,188,61,76,260
"2011","West Lancashire 002D","E01025513","Total",2018,207,115,92,1811,54,286,398,302,130,236,405
"2011","West Lancashire 002E","E01025531","Total",1110,121,66,55,989,20,224,168,212,31,90,244
"2011","West Lancashire 003A","E01025474","Total",1126,93,47,46,1033,40,182,199,176,47,125,264
"2011","West Lancashire 003B","E01025495","Total",2024,231,118,113,1793,38,350,373,322,122,165,423
"2011","West Lancashire 003C","E01025514","Total",2263,242,136,106,2021,52,318,450,440,108,210,443
"2011","West Lancashire 003D","E01025515","Total",1547,193,111,82,1354,19,286,215,260,56,181,337
"2011","West Lancashire 004A","E01025483","Total",2180,300,131,169,1880,142,286,432,336,153,198,333
"2011","West Lancashire 004B","E01025484","Total",1936,180,91,89,1756,83,280,434,296,115,165,383
"2011","West Lancashire 004C","E01025485","Total",1700,187,74,113,1513,76,196,390,250,80,211,310
"2011","West Lancashire 004D","E01025486","Total",1664,136,52,84,1528,73,200,429,240,98,159,329
"2011","West Lancashire 004E","E01025487","Total",1593,131,74,57,1462,88,194,398,226,68,152,336
"2011","West Lancashire 005A","E01025510","Total",1292,93,60,33,1199,27,276,254,150,30,147,315
"2011","West Lancashire 005B","E01025511","Total",1147,96,53,43,1051,27,228,267,180,57,100,192
"2011","West Lancashire 005C","E01025512","Total",1270,180,92,88,1090,57,154,304,184,48,105,238
"2011","West Lancashire 005D","E01025538","Total",1529,179,99,80,1350,25,258,318,254,51,166,278
"2011","West Lancashire 005E","E01025539","Total",1323,136,67,69,1187,51,182,318,244,61,124,207
"2011","West Lancashire 006A","E01025499","Total",1359,192,86,106,1167,48,166,240,220,42,134,317
"2011","West Lancashire 006B","E01025501","Total",1113,138,103,35,975,29,256,184,150,26,90,240
"2011","West Lancashire 006C","E01025502","Total",1611,144,104,40,1467,48,268,355,184,106,159,347
"2011","West Lancashire 006D","E01025516","Total",1502,157,82,75,1345,70,222,316,242,41,148,306
"2011","West Lancashire 006E","E01025517","Total",1511,137,54,83,1374,90,154,297,236,98,179,320
"2011","West Lancashire 006F","E01025519","Total",1187,130,79,51,1057,35,220,176,158,50,95,323
"2011","West Lancashire 007A","E01025488","Total",1822,248,131,117,1574,55,146,219,234,31,94,795
"2011","West Lancashire 007B","E01025489","Total",1304,120,70,50,1184,41,156,246,172,73,129,367
"2011","West Lancashire 007C","E01025490","Total",1276,140,78,62,1136,50,138,172,158,107,92,419
"2011","West Lancashire 007D","E01025500","Total",1425,253,139,114,1172,59,186,205,226,35,93,368
"2011","West Lancashire 007E","E01025518","Total",1434,248,130,118,1186,59,120,170,176,57,51,553
"2011","West Lancashire 008A","E01025479","Total",1988,204,104,100,1784,64,346,280,328,92,230,444
"2011","West Lancashire 008B","E01025491","Total",1341,145,90,55,1196,28,288,225,184,65,119,287
"2011","West Lancashire 008C","E01025506","Total",1965,217,126,91,1748,34,344,380,314,66,184,426
"2011","West Lancashire 009A","E01025468","Total",1714,84,27,57,1630,71,78,427,260,117,291,386
"2011","West Lancashire 009B","E01025469","Total",1567,324,142,182,1243,90,148,286,228,31,166,294
"2011","West Lancashire 009C","E01025470","Total",1502,86,25,61,1416,50,100,391,228,47,236,364
"2011","West Lancashire 009D","E01025522","Total",1144,147,107,40,997,53,186,154,182,41,118,263
"2011","West Lancashire 010A","E01025471","Total",1527,123,31,92,1404,203,92,331,194,119,181,284
"2011","West Lancashire 010B","E01025480","Total",1368,108,23,85,1260,158,62,320,176,95,236,213
"2011","West Lancashire 010C","E01025481","Total",1451,214,58,156,1237,165,114,261,212,69,147,269
"2011","West Lancashire 010D","E01025482","Total",1452,176,46,130,1276,192,70,267,166,181,180,220
"2011","West Lancashire 010E","E01025520","Total",1194,184,80,104,1010,121,134,218,116,81,100,240
"2011","West Lancashire 010F","E01025521","Total",1687,162,54,108,1525,216,130,318,208,160,184,309
"2011","West Lancashire 011A","E01025523","Total",1594,213,75,138,1381,142,130,348,234,78,180,269
"2011","West Lancashire 011B","E01025524","Total",1478,340,109,231,1138,107,120,246,244,70,129,222
"2011","West Lancashire 011C","E01025525","Total",1625,140,68,72,1485,100,180,298,198,164,186,359
"2011","West Lancashire 011D","E01025526","Total",1696,254,117,137,1442,102,212,307,284,82,146,309
"2011","West Lancashire 012A","E01025472","Total",1402,92,69,23,1310,24,258,312,204,97,161,254
"2011","West Lancashire 012B","E01025473","Total",1366,198,101,97,1168,62,222,224,184,89,69,318
"2011","West Lancashire 012C","E01025475","Total",1467,127,100,27,1340,30,282,260,216,60,163,329
"2011","West Lancashire 012D","E01025476","Total",1244,154,100,54,1090,32,216,239,190,41,123,249
"2011","West Lancashire 012E","E01025477","Total",1198,116,69,47,1082,22,162,219,154,62,164,299
"2011","West Lancashire 012F","E01025478","Total",1191,95,64,31,1096,17,262,224,140,51,159,243
"2011","West Lancashire 013A","E01025492","Total",1283,98,38,60,1185,97,138,275,210,42,192,231
"2011","West Lancashire 013B","E01025527","Total",1390,246,114,132,1144,185,108,167,142,89,201,252
"2011","West Lancashire 013C","E01025528","Total",1767,162,39,123,1605,346,102,405,200,111,201,240
"2011","West Lancashire 013D","E01025529","Total",1770,169,55,114,1601,250,120,427,224,96,190,294
"2011","West Lancashire 014A","E01025493","Total",1635,181,38,143,1454,371,62,277,180,136,165,263
"2011","West Lancashire 014B","E01025494","Total",1542,259,100,159,1283,221,88,179,192,115,228,260
"2011","West Lancashire 014C","E01025503","Total",1369,98,28,70,1271,201,70,327,150,96,184,243
"2011","West Lancashire 014D","E01025504","Total",1107,157,51,106,950,222,74,151,134,58,134,177
"2011","West Lancashire 014E","E01025505","Total",1425,188,73,115,1237,158,162,210,252,51,176,228
"2011","West Lancashire 015A","E01025534","Total",1726,144,84,60,1582,48,256,457,244,119,157,301
"2011","West Lancashire 015B","E01025535","Total",1415,145,59,86,1270,45,176,249,230,30,209,331
"2011","West Lancashire 015C","E01025536","Total",1524,202,105,97,1322,116,138,347,194,70,190,267
"2011","West Lancashire 015D","E01025537","Total",1484,201,98,103,1283,64,268,280,282,41,129,219
"2011","West Lancashire 015E","E01025540","Total",1149,116,61,55,1033,25,172,165,220,81,106,264
"2011","Wyre 001A","E01025573","Total",1389,155,90,65,1234,63,196,244,200,72,168,291
"2011","Wyre 001B","E01025574","Total",1533,294,160,134,1239,163,172,319,234,63,110,178
"2011","Wyre 001C","E01025581","Total",1370,179,86,93,1191,93,146,231,188,40,168,325
"2011","Wyre 001D","E01025582","Total",1250,203,65,138,1047,144,88,227,250,82,63,193
"2011","Wyre 001E","E01025583","Total",1289,224,87,137,1065,109,118,270,202,87,103,176
"2011","Wyre 001F","E01025584","Total",1453,474,145,329,979,72,186,167,266,17,110,161
"2011","Wyre 002A","E01025605","Total",1359,142,88,54,1217,43,214,271,208,72,166,243
"2011","Wyre 002B","E01025606","Total",1258,147,60,87,1111,180,118,211,174,100,125,203
"2011","Wyre 002C","E01025607","Total",1564,160,94,66,1404,10,242,284,206,114,207,341
"2011","Wyre 002D","E01025608","Total",1606,162,88,74,1444,75,240,283,206,104,193,343
"2011","Wyre 003A","E01025590","Total",1506,193,96,97,1313,234,136,203,140,120,199,281
"2011","Wyre 003B","E01025591","Total",1552,217,153,64,1335,27,426,231,274,10,102,265
"2011","Wyre 003C","E01025592","Total",1494,196,88,108,1298,269,138,211,188,127,148,217
"2011","Wyre 003D","E01025593","Total",1446,155,106,49,1291,25,434,145,212,41,145,289
"2011","Wyre 004A","E01025563","Total",1009,121,63,58,888,25,234,126,172,46,91,194
"2011","Wyre 004B","E01025564","Total",1610,208,127,81,1402,69,286,249,268,92,140,298
"2011","Wyre 004C","E01025565","Total",1484,164,102,62,1320,22,318,217,234,70,178,281
"2011","Wyre 004D","E01025586","Total",1568,190,131,59,1378,40,406,258,242,63,140,229
"2011","Wyre 004E","E01025587","Total",1497,206,117,89,1291,42,386,205,206,92,111,249
"2011","Wyre 004F","E01025588","Total",1314,279,187,92,1035,23,406,126,208,10,93,169
"2011","Wyre 004G","E01025589","Total",1241,121,48,73,1120,39,134,245,192,58,177,275
"2011","Wyre 005A","E01025557","Total",1551,178,90,88,1373,83,244,353,284,46,146,217
"2011","Wyre 005B","E01025575","Total",1089,269,119,150,820,126,106,145,132,85,64,162
"2011","Wyre 005C","E01025578","Total",1533,162,88,74,1371,165,188,239,190,86,167,336
"2011","Wyre 005D","E01025579","Total",1394,101,52,49,1293,182,108,266,182,167,120,268
"2011","Wyre 005E","E01025580","Total",1246,103,60,43,1143,38,230,132,170,112,147,314
"2011","Wyre 006A","E01025547","Total",1613,174,89,85,1439,34,236,278,260,93,217,321
"2011","Wyre 006B","E01025549","Total",2078,193,88,105,1885,68,260,476,390,158,196,337
"2011","Wyre 006C","E01025609","Total",1979,212,108,104,1767,69,284,299,338,152,245,380
"2011","Wyre 007A","E01025548","Total",1522,244,170,74,1278,26,462,187,226,63,83,231
"2011","Wyre 007B","E01025553","Total",2581,215,98,117,2366,59,316,628,440,169,274,480
"2011","Wyre 007C","E01025558","Total",1691,278,194,84,1413,24,458,251,238,65,129,248
"2011","Wyre 007D","E01025559","Total",1811,218,113,105,1593,62,252,346,302,86,221,324
"2011","Wyre 007E","E01025560","Total",1311,204,152,52,1107,13,356,151,268,69,66,184
"2011","Wyre 008A","E01025554","Total",1514,272,172,100,1242,34,426,226,214,44,83,215
"2011","Wyre 008B","E01025556","Total",1501,185,107,78,1316,74,242,282,180,87,178,273
"2011","Wyre 008C","E01025570","Total",1148,362,179,183,786,61,242,119,152,21,52,139
"2011","Wyre 008D","E01025571","Total",1390,158,64,94,1232,140,224,203,180,83,179,223
"2011","Wyre 008E","E01025572","Total",1332,203,135,68,1129,26,396,168,184,15,127,213
"2011","Wyre 008F","E01025604","Total",1504,195,115,80,1309,75,224,293,200,26,189,302
"2011","Wyre 009A","E01025561","Total",1471,125,62,63,1346,25,236,335,204,92,162,292
"2011","Wyre 009B","E01025562","Total",2098,227,139,88,1871,55,324,345,322,116,287,422
"2011","Wyre 009C","E01025585","Total",2253,166,90,76,2087,50,388,388,354,157,284,466
"2011","Wyre 010A","E01025542","Total",1648,148,84,64,1500,57,244,338,296,60,180,325
"2011","Wyre 010B","E01025555","Total",1359,246,181,65,1113,38,344,217,210,32,65,207
"2011","Wyre 010C","E01025601","Total",1395,151,102,49,1244,13,364,229,202,43,111,282
"2011","Wyre 010D","E01025602","Total",1550,233,76,157,1317,90,152,360,238,55,135,287
"2011","Wyre 010E","E01025603","Total",1502,206,141,65,1296,64,380,213,254,32,109,244
"2011","Wyre 011A","E01025541","Total",1684,175,73,102,1509,113,186,385,262,99,179,285
"2011","Wyre 011B","E01025543","Total",1751,200,86,114,1551,134,164,467,312,72,179,223
"2011","Wyre 011C","E01025544","Total",1540,280,163,117,1260,126,282,208,248,54,143,199
"2011","Wyre 011D","E01025576","Total",2306,359,207,152,1947,115,388,480,358,51,202,353
"2011","Wyre 011E","E01025577","Total",1432,224,119,105,1208,66,184,349,198,70,134,207
"2011","Wyre 012A","E01025550","Total",1486,191,114,77,1295,16,324,301,230,73,120,231
"2011","Wyre 012B","E01025552","Total",1283,91,44,47,1192,26,158,290,194,83,112,329
"2011","Wyre 012C","E01025594","Total",1496,257,176,81,1239,55,354,205,242,21,74,288
"2011","Wyre 012D","E01025595","Total",1442,135,90,45,1307,32,352,293,228,26,113,263
"2011","Wyre 012E","E01025596","Total",2057,189,82,107,1868,87,238,567,284,146,223,323
"2011","Wyre 012F","E01025597","Total",1096,125,76,49,971,67,218,207,170,79,106,124
"2011","Wyre 013A","E01025545","Total",1749,253,141,112,1496,45,300,267,276,89,146,373
"2011","Wyre 013B","E01025546","Total",1456,289,131,158,1167,106,130,237,286,101,98,209
"2011","Wyre 013C","E01025551","Total",1292,151,63,88,1141,36,166,261,218,40,97,323
"2011","Wyre 013D","E01025567","Total",1520,282,139,143,1238,98,276,190,262,53,104,255
"2011","Wyre 013E","E01025598","Total",1448,328,181,147,1120,64,266,238,264,27,79,182
"2011","Wyre 014A","E01025566","Total",1986,200,139,61,1786,32,450,380,282,92,223,327
"2011","Wyre 014B","E01025568","Total",1717,244,139,105,1473,84,340,262,274,90,145,278
"2011","Wyre 014C","E01025569","Total",1846,290,192,98,1556,54,404,305,296,55,136,306
"2011","Wyre 014D","E01025599","Total",988,112,64,48,876,25,176,190,174,21,103,187
"2011","Wyre 014E","E01025600","Total",1531,179,94,85,1352,51,242,344,246,76,88,305
"2011","Knowsley 001A","E01006448","Total",1677,243,106,137,1434,292,124,247,190,84,197,300
"2011","Knowsley 001B","E01006492","Total",1358,93,26,67,1265,128,80,185,218,58,205,391
"2011","Knowsley 001C","E01006493","Total",1115,115,50,65,1000,189,58,132,122,94,177,228
"2011","Knowsley 001D","E01006494","Total",1423,121,42,79,1302,254,52,209,142,122,205,318
"2011","Knowsley 001E","E01006495","Total",1872,136,25,111,1736,301,84,430,242,147,241,291
"2011","Knowsley 002A","E01006454","Total",1222,144,84,60,1078,40,152,177,156,30,163,360
"2011","Knowsley 002B","E01006456","Total",1595,226,108,118,1369,72,146,239,178,56,288,390
"2011","Knowsley 002C","E01006457","Total",1188,142,98,44,1046,24,266,102,140,36,131,347
"2011","Knowsley 002D","E01006458","Total",1413,175,72,103,1238,159,156,190,172,39,181,341
"2011","Knowsley 002E","E01006490","Total",2757,200,26,174,2557,303,62,781,494,201,330,386
"2011","Knowsley 002F","E01006491","Total",1970,174,22,152,1796,152,82,558,324,115,243,322
"2011","Knowsley 003A","E01006415","Total",2101,226,85,141,1875,230,126,407,250,129,313,420
"2011","Knowsley 003B","E01006417","Total",1310,385,95,290,925,188,84,114,180,41,116,202
"2011","Knowsley 003C","E01006436","Total",1466,243,63,180,1223,148,106,184,170,78,198,339
"2011","Knowsley 003D","E01006437","Total",1369,228,78,150,1141,145,98,210,192,36,155,305
"2011","Knowsley 003E","E01006447","Total",1307,288,68,220,1019,159,76,117,178,73,138,278
"2011","Knowsley 004A","E01006455","Total",1655,197,67,130,1458,286,138,231,206,94,179,324
"2011","Knowsley 004B","E01006506","Total",1317,150,32,118,1167,145,58,211,234,87,151,281
"2011","Knowsley 004C","E01006507","Total",1428,232,86,146,1196,232,98,212,148,40,162,304
"2011","Knowsley 004D","E01006508","Total",1394,180,47,133,1214,121,86,301,190,88,160,268
"2011","Knowsley 004E","E01006509","Total",1640,215,102,113,1425,264,110,255,186,43,243,324
"2011","Knowsley 004F","E01006510","Total",1199,119,50,69,1080,78,140,195,186,36,137,308
"2011","Knowsley 005A","E01006416","Total",1451,242,83,159,1209,229,108,194,216,41,124,297
"2011","Knowsley 005B","E01006418","Total",1357,177,77,100,1180,144,100,219,148,81,163,325
"2011","Knowsley 005C","E01006434","Total",1521,193,63,130,1328,268,76,237,192,44,182,329
"2011","Knowsley 005D","E01006435","Total",1556,199,87,112,1357,201,118,154,210,59,259,356
"2011","Knowsley 005E","E01006438","Total",1200,149,81,68,1051,46,222,126,122,73,173,289
"2011","Knowsley 005F","E01006439","Total",1613,221,108,113,1392,130,186,212,192,88,228,356
"2011","Knowsley 005G","E01006446","Total",1362,160,66,94,1202,161,126,234,174,43,193,271
"2011","Knowsley 006A","E01006412","Total",1457,145,64,81,1312,194,172,145,164,59,244,334
"2011","Knowsley 006B","E01006413","Total",1419,537,151,386,882,196,108,134,188,23,107,126
"2011","Knowsley 006C","E01006414","Total",1366,213,100,113,1153,188,178,127,136,41,193,290
"2011","Knowsley 006D","E01006441","Total",2358,321,130,191,2037,190,180,471,330,167,320,379
"2011","Knowsley 007A","E01006460","Total",1576,206,77,129,1370,259,114,197,194,114,178,314
"2011","Knowsley 007B","E01006461","Total",1590,157,67,90,1433,199,150,265,162,119,203,335
"2011","Knowsley 007C","E01006463","Total",1824,469,125,344,1355,186,126,341,328,63,98,213
"2011","Knowsley 007D","E01006464","Total",1574,272,167,105,1302,82,254,205,176,66,143,376
"2011","Knowsley 007E","E01006466","Total",1549,335,174,161,1214,107,134,283,272,40,133,245
"2011","Knowsley 008A","E01006453","Total",1223,136,51,85,1087,245,112,184,146,74,108,218
"2011","Knowsley 008B","E01006467","Total",1275,184,69,115,1091,265,88,138,146,46,140,268
"2011","Knowsley 008E","E01006470","Total",1375,200,82,118,1175,123,126,149,166,96,216,299
"2011","Knowsley 008F","E01033228","Total",1907,270,106,164,1637,320,136,258,182,132,231,378
"2011","Knowsley 009A","E01006459","Total",1592,144,48,96,1448,104,136,275,216,81,230,406
"2011","Knowsley 009B","E01006462","Total",1514,192,109,83,1322,82,202,322,178,103,176,259
"2011","Knowsley 009C","E01006496","Total",1375,224,110,114,1151,77,148,221,148,87,145,325
"2011","Knowsley 009D","E01006498","Total",1527,101,45,56,1426,50,100,452,176,97,206,345
"2011","Knowsley 009E","E01006499","Total",1591,203,79,124,1388,93,178,351,218,68,164,316
"2011","Knowsley 010A","E01006440","Total",1454,196,78,118,1258,216,106,230,168,75,182,281
"2011","Knowsley 010B","E01006442","Total",1272,273,71,202,999,194,80,147,146,71,158,203
"2011","Knowsley 010C","E01006443","Total",1371,290,121,169,1081,203,154,172,162,41,129,220
"2011","Knowsley 010D","E01006444","Total",1318,140,50,90,1178,199,104,196,122,91,202,264
"2011","Knowsley 010E","E01006445","Total",1329,159,58,101,1170,209,90,204,116,76,168,307
"2011","Knowsley 011A","E01006465","Total",1686,143,69,74,1543,34,134,390,222,113,220,430
"2011","Knowsley 011B","E01006482","Total",1530,144,66,78,1386,184,124,201,168,89,276,344
"2011","Knowsley 011C","E01006483","Total",1341,226,98,128,1115,163,154,196,158,51,158,235
"2011","Knowsley 011D","E01006484","Total",1376,175,73,102,1201,122,112,249,154,70,174,320
"2011","Knowsley 012A","E01006449","Total",1464,188,106,82,1276,100,198,232,166,71,194,315
"2011","Knowsley 012B","E01006450","Total",1422,203,91,112,1219,219,126,213,160,88,166,247
"2011","Knowsley 012C","E01006451","Total",1476,156,81,75,1320,162,168,218,192,77,181,322
"2011","Knowsley 012D","E01006452","Total",1528,166,70,96,1362,149,128,285,200,79,214,307
"2011","Knowsley 013A","E01006497","Total",1073,141,63,78,932,41,136,187,166,32,98,272
"2011","Knowsley 013B","E01006500","Total",1109,135,86,49,974,73,126,140,136,72,165,262
"2011","Knowsley 013C","E01006501","Total",1431,123,38,85,1308,174,130,382,210,106,149,157
"2011","Knowsley 013D","E01006504","Total",1376,202,46,156,1174,129,92,260,160,134,154,245
"2011","Knowsley 013E","E01006505","Total",1750,212,109,103,1538,196,118,304,190,125,278,327
"2011","Knowsley 014A","E01006472","Total",1565,158,95,63,1407,36,228,240,222,74,231,376
"2011","Knowsley 014B","E01006485","Total",1544,159,85,74,1385,98,180,292,182,121,201,311
"2011","Knowsley 014C","E01006486","Total",1172,128,69,59,1044,35,160,216,178,44,122,289
"2011","Knowsley 014D","E01006487","Total",1529,159,84,75,1370,76,220,263,182,56,182,391
"2011","Knowsley 014E","E01006488","Total",1715,165,96,69,1550,55,196,335,244,63,240,417
"2011","Knowsley 014F","E01006489","Total",1434,159,95,64,1275,80,162,226,174,73,176,384
"2011","Knowsley 015A","E01006477","Total",1372,166,62,104,1206,159,130,223,164,51,146,333
"2011","Knowsley 015B","E01006478","Total",1345,242,92,150,1103,135,108,226,150,46,150,288
"2011","Knowsley 015C","E01006479","Total",1395,181,85,96,1214,158,134,181,170,67,192,312
"2011","Knowsley 015D","E01006480","Total",1369,237,118,119,1132,149,130,155,152,54,220,272
"2011","Knowsley 015E","E01006481","Total",1329,299,143,156,1030,126,134,175,130,45,157,263
"2011","Knowsley 016A","E01006471","Total",1487,174,105,69,1313,62,208,256,178,46,202,361
"2011","Knowsley 016B","E01006473","Total",1248,115,69,46,1133,43,162,200,146,66,155,361
"2011","Knowsley 016C","E01006474","Total",1446,202,127,75,1244,24,242,228,176,86,162,326
"2011","Knowsley 016D","E01006475","Total",1380,134,65,69,1246,42,200,229,150,47,180,398
"2011","Knowsley 016E","E01006476","Total",1428,139,94,45,1289,14,166,267,208,50,203,381
"2011","Knowsley 017A","E01006420","Total",2066,155,61,94,1911,118,122,545,292,142,257,435
"2011","Knowsley 017B","E01006424","Total",2066,189,72,117,1877,67,128,460,344,91,279,508
"2011","Knowsley 017C","E01006502","Total",1739,214,114,100,1525,93,278,274,278,57,111,434
"2011","Knowsley 017D","E01006503","Total",1243,158,116,42,1085,33,222,150,174,69,113,324
"2011","Knowsley 018A","E01006421","Total",1210,62,9,53,1148,60,70,348,182,58,147,283
"2011","Knowsley 018B","E01006425","Total",1362,173,69,104,1189,71,102,239,186,78,184,329
"2011","Knowsley 018C","E01006430","Total",1213,293,141,152,920,144,124,142,136,42,127,205
"2011","Knowsley 018D","E01006433","Total",1398,231,93,138,1167,103,128,291,180,40,116,309
"2011","Knowsley 019A","E01006419","Total",1492,172,48,124,1320,103,94,414,260,46,129,274
"2011","Knowsley 019B","E01006422","Total",1269,135,84,51,1134,52,212,205,150,35,149,331
"2011","Knowsley 019C","E01006423","Total",1426,88,21,67,1338,59,100,367,238,59,144,371
"2011","Knowsley 019D","E01006427","Total",1450,172,105,67,1278,56,240,212,196,63,197,314
"2011","Knowsley 020A","E01006426","Total",1230,198,71,127,1032,164,104,169,180,22,154,239
"2011","Knowsley 020B","E01006428","Total",1511,192,66,126,1319,154,96,344,204,77,176,268
"2011","Knowsley 020C","E01006429","Total",1127,133,60,73,994,163,78,168,132,66,127,260
"2011","Knowsley 020D","E01006431","Total",1670,270,92,178,1400,172,182,260,250,77,121,338
"2011","Knowsley 020E","E01006432","Total",1526,235,101,134,1291,178,140,249,200,72,154,298
"2011","Liverpool 001A","E01006651","Total",1642,103,27,76,1539,97,66,496,236,66,283,295
"2011","Liverpool 001B","E01006653","Total",1520,203,74,129,1317,147,164,292,214,72,179,249
"2011","Liverpool 001C","E01006655","Total",1733,194,88,106,1539,114,164,357,232,96,211,365
"2011","Liverpool 001D","E01006658","Total",1300,254,84,170,1046,182,146,173,174,42,100,229
"2011","Liverpool 001E","E01006660","Total",1433,226,97,129,1207,122,118,288,136,66,192,285
"2011","Liverpool 002A","E01006652","Total",1505,193,67,126,1312,124,128,297,194,68,171,330
"2011","Liverpool 002B","E01006656","Total",1493,222,69,153,1271,158,136,229,224,68,125,331
"2011","Liverpool 002C","E01006657","Total",1211,236,71,165,975,136,110,223,176,66,66,198
"2011","Liverpool 002D","E01006780","Total",1465,191,80,111,1274,125,138,268,200,41,186,316
"2011","Liverpool 002E","E01006783","Total",1548,199,73,126,1349,152,108,309,196,104,153,327
"2011","Liverpool 003A","E01006781","Total",1469,163,60,103,1306,74,116,324,204,41,166,381
"2011","Liverpool 003B","E01006782","Total",1541,271,79,192,1270,130,88,298,206,46,146,356
"2011","Liverpool 003C","E01006784","Total",1344,209,57,152,1135,94,80,293,192,57,143,276
"2011","Liverpool 003D","E01006785","Total",1769,275,87,188,1494,169,150,294,222,77,202,380
"2011","Liverpool 003E","E01006786","Total",1820,237,67,170,1583,91,160,399,270,110,205,348
"2011","Liverpool 004A","E01006661","Total",1663,269,123,146,1394,193,194,216,194,86,157,354
"2011","Liverpool 004B","E01006662","Total",1633,333,162,171,1300,174,154,341,192,72,158,209
"2011","Liverpool 004C","E01006663","Total",1153,175,64,111,978,135,70,251,174,59,102,187
"2011","Liverpool 004D","E01006664","Total",1795,327,128,199,1468,231,124,258,244,104,223,284
"2011","Liverpool 004E","E01006669","Total",1470,123,28,95,1347,84,64,352,216,94,247,290
"2011","Liverpool 005A","E01006654","Total",1455,217,98,119,1238,100,84,273,202,72,181,326
"2011","Liverpool 005B","E01006659","Total",1070,264,77,187,806,130,88,140,128,58,80,182
"2011","Liverpool 005C","E01006734","Total",1412,187,79,108,1225,349,114,166,170,67,97,262
"2011","Liverpool 005D","E01006735","Total",1309,207,71,136,1102,188,96,192,134,60,164,268
"2011","Liverpool 005E","E01006736","Total",1460,158,57,101,1302,167,110,243,160,39,205,378
"2011","Liverpool 005F","E01006737","Total",1435,142,62,80,1293,142,128,244,142,42,245,350
"2011","Liverpool 006A","E01006787","Total",1534,312,43,269,1222,155,78,212,174,64,223,316
"2011","Liverpool 006B","E01006788","Total",1825,137,62,75,1688,190,148,387,204,115,209,435
"2011","Liverpool 006C","E01006790","Total",1587,350,108,242,1237,283,94,234,220,40,109,257
"2011","Liverpool 006D","E01006791","Total",1674,418,127,291,1256,160,158,231,248,51,126,282
"2011","Liverpool 007A","E01006665","Total",1555,180,49,131,1375,119,74,363,242,79,191,307
"2011","Liverpool 007B","E01006666","Total",1504,84,30,54,1420,73,58,347,172,96,325,349
"2011","Liverpool 007C","E01006667","Total",1413,188,78,110,1225,125,136,236,240,42,145,301
"2011","Liverpool 007D","E01006668","Total",1534,119,32,87,1415,127,86,434,254,79,201,234
"2011","Liverpool 007E","E01006670","Total",1520,133,38,95,1387,131,140,351,220,70,159,316
"2011","Liverpool 008A","E01006607","Total",1529,196,80,116,1333,214,162,204,146,57,156,394
"2011","Liverpool 008B","E01006612","Total",1495,346,124,222,1149,192,158,183,144,60,152,260
"2011","Liverpool 008C","E01006729","Total",1400,121,74,47,1279,264,98,194,158,130,180,255
"2011","Liverpool 008F","E01032510","Total",1809,262,69,193,1547,137,146,318,218,120,226,382
"2011","Liverpool 008G","E01032511","Total",1378,199,61,138,1179,151,124,195,234,46,107,322
"2011","Liverpool 009A","E01006608","Total",1213,221,74,147,992,117,98,188,174,27,164,224
"2011","Liverpool 009B","E01006609","Total",1283,209,62,147,1074,119,112,216,164,45,134,284
"2011","Liverpool 009C","E01006610","Total",1395,283,134,149,1112,197,96,179,180,38,143,279
"2011","Liverpool 009D","E01006613","Total",1360,240,114,126,1120,93,148,160,134,48,199,338
"2011","Liverpool 009E","E01006705","Total",1409,299,57,242,1110,184,90,179,206,58,120,273
"2011","Liverpool 010A","E01006598","Total",1361,223,106,117,1138,204,120,185,146,126,133,224
"2011","Liverpool 010B","E01006599","Total",1121,158,45,113,963,251,58,207,114,42,114,177
"2011","Liverpool 010E","E01006672","Total",1955,238,80,158,1717,286,128,384,208,133,269,309
"2011","Liverpool 010F","E01033759","Total",1147,142,65,77,1005,148,82,230,158,49,126,212
"2011","Liverpool 011A","E01006600","Total",1407,180,92,88,1227,122,160,165,152,52,200,376
"2011","Liverpool 011B","E01006603","Total",1386,182,78,104,1204,127,182,163,162,56,186,328
"2011","Liverpool 011C","E01006730","Total",1323,165,90,75,1158,147,108,178,140,87,190,308
"2011","Liverpool 011D","E01006731","Total",1196,142,61,81,1054,135,106,183,128,76,163,263
"2011","Liverpool 011E","E01006732","Total",1643,170,69,101,1473,330,144,218,140,142,217,282
"2011","Liverpool 012A","E01006611","Total",1291,411,82,329,880,209,82,196,160,53,22,158
"2011","Liverpool 012B","E01006614","Total",1322,292,67,225,1030,172,136,210,188,34,90,200
"2011","Liverpool 012C","E01006615","Total",1302,279,72,207,1023,227,88,176,196,5,96,235
"2011","Liverpool 012D","E01006698","Total",1716,244,70,174,1472,234,114,272,194,126,153,379
"2011","Liverpool 012E","E01006700","Total",1410,265,61,204,1145,142,116,208,168,62,174,275
"2011","Liverpool 013A","E01006623","Total",1462,69,32,37,1393,37,190,276,190,75,181,444
"2011","Liverpool 013B","E01006624","Total",1551,268,90,178,1283,120,138,239,214,61,169,342
"2011","Liverpool 013C","E01006627","Total",1378,195,88,107,1183,61,138,304,190,21,170,299
"2011","Liverpool 013D","E01006671","Total",1349,115,52,63,1234,85,114,177,156,59,290,353
"2011","Liverpool 014A","E01006699","Total",1581,322,78,244,1259,231,132,251,230,69,100,246
"2011","Liverpool 014B","E01006701","Total",1380,290,80,210,1090,133,110,175,200,27,127,318
"2011","Liverpool 014C","E01006702","Total",1596,263,84,179,1333,242,138,245,240,77,116,275
"2011","Liverpool 014D","E01006703","Total",1527,447,114,333,1080,142,112,164,202,67,127,266
"2011","Liverpool 014E","E01006778","Total",2205,496,132,364,1709,263,140,258,422,44,189,393
"2011","Liverpool 015A","E01006541","Total",1593,362,139,223,1231,151,178,217,202,21,146,316
"2011","Liverpool 015B","E01006543","Total",1247,148,73,75,1099,72,128,191,132,43,137,396
"2011","Liverpool 015C","E01006544","Total",1658,264,85,179,1394,235,150,233,206,79,209,282
"2011","Liverpool 015D","E01006616","Total",1428,207,88,119,1221,109,142,159,186,70,213,342
"2011","Liverpool 015E","E01006762","Total",1692,226,80,146,1466,206,160,223,226,90,213,348
"2011","Liverpool 016A","E01006604","Total",1367,175,78,97,1192,114,138,171,166,53,203,347
"2011","Liverpool 016B","E01006605","Total",1531,289,123,166,1242,116,148,201,158,63,242,314
"2011","Liverpool 016C","E01006618","Total",1639,212,132,80,1427,99,216,220,188,32,236,436
"2011","Liverpool 016D","E01006625","Total",1416,185,114,71,1231,86,188,267,180,45,167,298
"2011","Liverpool 016E","E01006626","Total",1448,173,101,72,1275,41,158,234,170,31,191,450
"2011","Liverpool 017A","E01006637","Total",1596,208,66,142,1388,299,76,315,208,102,167,221
"2011","Liverpool 017B","E01006638","Total",1219,161,60,101,1058,206,98,177,126,77,125,249
"2011","Liverpool 017C","E01006639","Total",1509,199,71,128,1310,164,112,310,192,90,170,272
"2011","Liverpool 017D","E01006644","Total",2040,404,114,290,1636,205,138,348,274,94,237,340
"2011","Liverpool 017E","E01006645","Total",1424,299,138,161,1125,219,154,164,136,42,127,283
"2011","Liverpool 018A","E01006542","Total",1297,241,50,191,1056,117,86,188,142,64,193,266
"2011","Liverpool 018B","E01006558","Total",1357,380,93,287,977,177,78,152,212,49,108,201
"2011","Liverpool 018E","E01006562","Total",1514,294,77,217,1220,248,78,216,180,72,150,276
"2011","Liverpool 018F","E01033747","Total",1035,233,78,155,802,135,72,113,102,77,142,161
"2011","Liverpool 019A","E01006545","Total",1512,201,72,129,1311,240,124,219,176,69,195,288
"2011","Liverpool 019B","E01006546","Total",1319,227,57,170,1092,212,68,179,156,62,173,242
"2011","Liverpool 019C","E01006547","Total",1490,334,69,265,1156,175,104,187,158,73,170,289
"2011","Liverpool 019D","E01006548","Total",1580,334,86,248,1246,272,106,250,154,61,141,262
"2011","Liverpool 019E","E01006766","Total",1265,232,49,183,1033,203,66,204,126,82,114,238
"2011","Liverpool 019F","E01006767","Total",1784,294,64,230,1490,218,92,365,214,109,117,375
"2011","Liverpool 020A","E01006606","Total",1521,272,82,190,1249,160,164,211,232,60,116,306
"2011","Liverpool 020B","E01006761","Total",1583,383,98,285,1200,171,128,208,178,53,158,304
"2011","Liverpool 020C","E01006763","Total",1471,217,72,145,1254,207,130,220,232,58,178,229
"2011","Liverpool 020D","E01006764","Total",1522,259,47,212,1263,163,108,167,190,89,251,295
"2011","Liverpool 020E","E01006765","Total",1468,243,85,158,1225,144,120,239,208,51,179,284
"2011","Liverpool 020F","E01006768","Total",1347,234,37,197,1113,57,102,151,158,62,188,395
"2011","Liverpool 021A","E01006617","Total",1421,211,69,142,1210,78,164,261,268,50,76,313
"2011","Liverpool 021B","E01006619","Total",1599,256,89,167,1343,83,216,333,240,64,111,296
"2011","Liverpool 021C","E01006620","Total",1409,229,145,84,1180,70,188,190,162,58,187,325
"2011","Liverpool 021D","E01006621","Total",1468,163,88,75,1305,34,186,253,154,51,192,435
"2011","Liverpool 021E","E01006622","Total",1519,129,76,53,1390,50,206,325,166,90,156,397
"2011","Liverpool 021F","E01006640","Total",1880,217,91,126,1663,98,184,421,240,107,223,390
"2011","Liverpool 022B","E01006776","Total",1646,386,154,232,1260,161,146,208,302,11,181,251
"2011","Liverpool 022D","E01006779","Total",1934,334,160,174,1600,307,172,221,270,62,203,365
"2011","Liverpool 022E","E01033764","Total",2191,607,197,410,1584,293,190,215,284,52,138,412
"2011","Liverpool 023A","E01006560","Total",1860,536,177,359,1324,209,174,177,192,48,178,346
"2011","Liverpool 023B","E01006564","Total",1721,300,121,179,1421,125,230,167,242,52,217,388
"2011","Liverpool 023C","E01006646","Total",1881,503,94,409,1378,165,114,212,366,36,199,286
"2011","Liverpool 023D","E01006648","Total",2175,428,125,303,1747,171,116,226,540,45,162,487
"2011","Liverpool 024A","E01006540","Total",1485,415,100,315,1070,252,58,182,134,16,170,258
"2011","Liverpool 024B","E01006563","Total",1740,477,208,269,1263,244,176,189,112,78,166,298
"2011","Liverpool 024C","E01006647","Total",1422,242,92,150,1180,248,120,177,130,122,166,217
"2011","Liverpool 024D","E01006693","Total",1508,463,182,281,1045,85,204,169,146,17,133,291
"2011","Liverpool 025A","E01006572","Total",1207,133,67,66,1074,222,108,180,168,73,109,214
"2011","Liverpool 025B","E01006574","Total",1388,231,118,113,1157,133,130,266,118,92,129,289
"2011","Liverpool 025C","E01006641","Total",1640,154,17,137,1486,157,34,566,264,125,187,153
"2011","Liverpool 025D","E01006642","Total",1290,219,81,138,1071,193,92,176,170,88,121,231
"2011","Liverpool 025E","E01006643","Total",1822,198,57,141,1624,259,126,372,234,129,243,261
"2011","Liverpool 026A","E01006567","Total",1622,500,185,315,1122,111,166,177,156,69,124,319
"2011","Liverpool 026B","E01006568","Total",1491,191,70,121,1300,152,100,295,228,58,166,301
"2011","Liverpool 026C","E01006570","Total",1463,165,78,87,1298,95,144,256,180,70,165,388
"2011","Liverpool 026D","E01006571","Total",1438,204,84,120,1234,108,144,211,170,68,199,334
"2011","Liverpool 027A","E01006711","Total",1500,277,83,194,1223,153,110,265,178,64,223,230
"2011","Liverpool 027D","E01006717","Total",1436,168,67,101,1268,91,112,204,166,58,257,380
"2011","Liverpool 027E","E01006718","Total",1584,245,86,159,1339,95,126,268,196,89,190,375
"2011","Liverpool 027F","E01006719","Total",1535,193,69,124,1342,178,122,269,194,77,198,304
"2011","Liverpool 027G","E01032508","Total",1723,399,102,297,1324,188,102,212,234,68,233,287
"2011","Liverpool 027H","E01032509","Total",1432,247,67,180,1185,204,112,293,190,30,128,228
"2011","Liverpool 028A","E01006690","Total",1457,436,57,379,1021,150,72,159,232,11,105,292
"2011","Liverpool 028B","E01006692","Total",2180,400,94,306,1780,202,156,358,316,105,283,360
"2011","Liverpool 028C","E01006695","Total",1814,637,58,579,1177,197,60,162,226,42,205,285
"2011","Liverpool 028D","E01006759","Total",1052,180,41,139,872,104,62,156,118,45,127,260
"2011","Liverpool 028E","E01006760","Total",1548,498,70,428,1050,103,40,154,192,46,114,401
"2011","Liverpool 029A","E01006565","Total",1549,197,105,92,1352,95,176,246,168,64,228,375
"2011","Liverpool 029B","E01006569","Total",1372,236,106,130,1136,63,172,154,152,71,216,308
"2011","Liverpool 029C","E01006573","Total",1501,368,149,219,1133,204,138,213,192,64,106,216
"2011","Liverpool 029D","E01006712","Total",1303,194,68,126,1109,132,94,284,202,113,89,195
"2011","Liverpool 029E","E01006713","Total",1375,196,95,101,1179,110,108,287,216,65,118,275
"2011","Liverpool 030A","E01006691","Total",1488,247,59,188,1241,211,84,231,152,105,113,345
"2011","Liverpool 030B","E01006694","Total",1864,375,65,310,1489,275,118,264,238,99,170,325
"2011","Liverpool 030C","E01006696","Total",1744,290,78,212,1454,192,100,270,236,119,179,358
"2011","Liverpool 030D","E01006697","Total",1843,319,68,251,1524,221,114,278,248,116,174,373
"2011","Liverpool 030E","E01006746","Total",1506,216,88,128,1290,116,178,127,164,59,128,518
"2011","Liverpool 031A","E01006512","Total",1420,431,28,403,989,81,4,194,412,63,67,168
"2011","Liverpool 031B","E01006747","Total",1655,460,69,391,1195,49,56,191,294,5,68,532
"2011","Liverpool 031C","E01006748","Total",1936,239,75,164,1697,97,78,130,198,38,98,1058
"2011","Liverpool 031F","E01006751","Total",2043,301,118,183,1742,191,124,270,230,60,274,593
"2011","Liverpool 031G","E01033763","Total",1471,507,140,367,964,70,68,107,160,33,70,456
"2011","Liverpool 032A","E01006566","Total",1431,184,92,92,1247,72,98,285,172,56,228,336
"2011","Liverpool 032B","E01006585","Total",1354,268,102,166,1086,108,144,161,170,63,147,293
"2011","Liverpool 032C","E01006586","Total",1875,414,126,288,1461,149,152,301,288,20,203,348
"2011","Liverpool 032D","E01006587","Total",1619,259,57,202,1360,78,120,246,258,114,192,352
"2011","Liverpool 032E","E01006716","Total",1454,285,71,214,1169,226,84,240,232,74,135,178
"2011","Liverpool 034A","E01006575","Total",1289,205,97,108,1084,81,164,203,156,40,154,286
"2011","Liverpool 034B","E01006576","Total",1691,191,98,93,1500,68,166,416,302,31,184,333
"2011","Liverpool 034C","E01006577","Total",1503,145,76,69,1358,39,156,335,202,70,179,377
"2011","Liverpool 034D","E01006579","Total",1643,131,94,37,1512,42,190,396,178,100,211,395
"2011","Liverpool 034E","E01006584","Total",1393,205,77,128,1188,70,156,249,200,68,174,271
"2011","Liverpool 035A","E01006720","Total",2108,361,73,288,1747,221,44,276,282,208,184,532
"2011","Liverpool 035B","E01006725","Total",1537,308,84,224,1229,151,108,247,242,47,115,319
"2011","Liverpool 035C","E01006726","Total",1565,226,50,176,1339,158,76,149,232,75,88,561
"2011","Liverpool 035D","E01006727","Total",1438,238,63,175,1200,132,96,191,272,62,126,321
"2011","Liverpool 035E","E01006728","Total",1620,399,103,296,1221,247,80,216,322,72,75,209
"2011","Liverpool 035F","E01006752","Total",1012,232,54,178,780,98,60,126,142,30,123,201
"2011","Liverpool 036A","E01006578","Total",1380,139,65,74,1241,62,130,300,210,93,170,276
"2011","Liverpool 036B","E01006580","Total",1331,113,56,57,1218,30,160,266,170,65,173,354
"2011","Liverpool 036C","E01006581","Total",1559,138,72,66,1421,33,184,398,190,84,168,364
"2011","Liverpool 036D","E01006773","Total",1378,114,48,66,1264,60,162,343,218,36,124,321
"2011","Liverpool 036E","E01006774","Total",1445,124,62,62,1321,53,118,334,194,52,222,348
"2011","Liverpool 037A","E01006514","Total",1758,747,72,675,1011,57,20,126,412,15,42,339
"2011","Liverpool 037B","E01006515","Total",1208,313,91,222,895,118,90,127,246,45,83,186
"2011","Liverpool 037D","E01006673","Total",1925,482,125,357,1443,244,58,242,296,128,258,217
"2011","Liverpool 037E","E01033757","Total",1015,548,15,533,467,43,10,27,182,10,37,158
"2011","Liverpool 037F","E01033768","Total",1219,599,50,549,620,68,16,98,234,10,42,152
"2011","Liverpool 038A","E01006550","Total",1595,118,27,91,1477,24,46,110,162,18,61,1056
"2011","Liverpool 038B","E01006557","Total",2051,138,41,97,1913,50,38,81,202,70,103,1369
"2011","Liverpool 038C","E01006721","Total",1655,453,136,317,1202,266,66,181,346,37,83,223
"2011","Liverpool 038D","E01006722","Total",1793,155,56,99,1638,94,36,111,162,77,131,1027
"2011","Liverpool 038E","E01006723","Total",1862,264,63,201,1598,82,82,136,224,48,128,898
"2011","Liverpool 038F","E01006724","Total",1783,113,36,77,1670,31,74,87,156,41,122,1159
"2011","Liverpool 039A","E01006552","Total",2027,346,48,298,1681,360,60,296,274,200,258,233
"2011","Liverpool 039B","E01006556","Total",2010,538,92,446,1472,291,74,225,228,119,212,323
"2011","Liverpool 039C","E01006674","Total",1885,400,113,287,1485,217,100,295,158,204,327,184
"2011","Liverpool 039D","E01006679","Total",2184,392,91,301,1792,288,110,301,204,339,347,203
"2011","Liverpool 040A","E01006709","Total",1438,293,118,175,1145,114,134,200,186,39,161,311
"2011","Liverpool 040B","E01006769","Total",1270,401,199,202,869,138,146,139,138,60,99,149
"2011","Liverpool 040C","E01006770","Total",1002,160,77,83,842,107,118,155,112,38,144,168
"2011","Liverpool 040D","E01006771","Total",1425,296,141,155,1129,168,142,190,180,56,119,274
"2011","Liverpool 040E","E01006772","Total",1081,168,81,87,913,79,116,144,148,30,146,250
"2011","Liverpool 040F","E01006775","Total",1302,165,82,83,1137,115,172,139,162,72,174,303
"2011","Liverpool 041A","E01006582","Total",1630,110,53,57,1520,42,166,356,182,73,334,367
"2011","Liverpool 041B","E01006589","Total",1512,152,78,74,1360,55,146,366,192,72,164,365
"2011","Liverpool 041C","E01006591","Total",1633,192,65,127,1441,58,120,303,274,77,165,444
"2011","Liverpool 041D","E01006592","Total",1541,189,123,66,1352,26,186,239,184,93,184,440
"2011","Liverpool 041E","E01006597","Total",1639,193,92,101,1446,49,178,303,260,88,172,396
"2011","Liverpool 042A","E01006553","Total",1880,167,29,138,1713,52,52,164,250,68,94,1033
"2011","Liverpool 042C","E01006588","Total",1521,272,72,200,1249,28,120,209,304,45,113,430
"2011","Liverpool 042D","E01006590","Total",1637,231,65,166,1406,59,98,233,294,37,87,598
"2011","Liverpool 042E","E01006593","Total",1541,232,52,180,1309,85,82,242,266,56,93,485
"2011","Liverpool 042F","E01033749","Total",1151,973,5,968,178,10,8,39,60,20,4,37
"2011","Liverpool 042G","E01033766","Total",1072,104,28,76,968,58,56,102,194,10,95,453
"2011","Liverpool 043A","E01006520","Total",1685,805,140,665,880,38,40,127,540,10,39,86
"2011","Liverpool 043B","E01006549","Total",1559,636,48,588,923,60,24,108,314,22,85,310
"2011","Liverpool 043C","E01006675","Total",1682,766,71,695,916,71,22,122,444,27,69,161
"2011","Liverpool 043D","E01006677","Total",993,210,58,152,783,214,42,170,98,59,83,117
"2011","Liverpool 044A","E01006518","Total",1630,389,139,250,1241,157,140,183,274,89,128,270
"2011","Liverpool 044B","E01006630","Total",1338,166,45,121,1172,185,96,231,178,56,213,213
"2011","Liverpool 044C","E01006632","Total",1842,344,83,261,1498,280,182,282,292,83,130,249
"2011","Liverpool 044D","E01006676","Total",1753,290,83,207,1463,271,92,311,194,146,228,221
"2011","Liverpool 044E","E01006678","Total",2126,513,115,398,1613,206,166,232,246,110,226,427
"2011","Liverpool 045A","E01006706","Total",1346,186,77,109,1160,171,158,175,138,46,180,292
"2011","Liverpool 045B","E01006707","Total",1294,163,89,74,1131,138,168,163,168,85,151,258
"2011","Liverpool 045C","E01006708","Total",1757,249,96,153,1508,145,152,350,252,92,229,288
"2011","Liverpool 045D","E01006710","Total",1490,136,67,69,1354,191,136,209,190,64,194,370
"2011","Liverpool 046A","E01006792","Total",1364,138,100,38,1226,32,242,268,140,31,182,331
"2011","Liverpool 046B","E01006794","Total",1590,224,85,139,1366,76,240,303,224,58,137,328
"2011","Liverpool 046C","E01006800","Total",1401,257,137,120,1144,29,334,172,156,63,99,291
"2011","Liverpool 046D","E01006801","Total",1344,171,106,65,1173,29,266,196,228,42,89,323
"2011","Liverpool 047A","E01006532","Total",1554,149,97,52,1405,26,240,294,192,114,202,337
"2011","Liverpool 047B","E01006539","Total",1403,176,79,97,1227,23,200,233,218,60,160,333
"2011","Liverpool 047C","E01006583","Total",1255,85,61,24,1170,9,174,291,134,69,165,328
"2011","Liverpool 047D","E01006594","Total",1405,172,96,76,1233,8,178,249,196,78,184,340
"2011","Liverpool 047E","E01006796","Total",1586,105,71,34,1481,14,220,281,168,154,183,461
"2011","Liverpool 048A","E01006522","Total",1670,675,58,617,995,118,18,138,542,0,22,157
"2011","Liverpool 048B","E01006524","Total",1079,273,72,201,806,39,122,167,250,21,77,130
"2011","Liverpool 048C","E01006526","Total",1301,287,81,206,1014,51,128,247,236,36,114,202
"2011","Liverpool 048D","E01006529","Total",1304,180,58,122,1124,35,102,325,212,68,87,295
"2011","Liverpool 048E","E01006551","Total",1134,511,209,302,623,55,144,73,166,5,22,158
"2011","Liverpool 048F","E01006554","Total",1670,280,34,246,1390,29,48,136,214,58,157,748
"2011","Liverpool 049A","E01006525","Total",1209,109,61,48,1100,18,164,220,164,25,155,354
"2011","Liverpool 049B","E01006595","Total",1745,280,128,152,1465,107,164,340,348,56,75,375
"2011","Liverpool 049C","E01006596","Total",1451,162,78,84,1289,35,152,240,248,77,172,365
"2011","Liverpool 049D","E01006689","Total",1651,228,98,130,1423,49,182,362,266,83,165,316
"2011","Liverpool 050B","E01006633","Total",1432,317,145,172,1115,183,118,194,182,58,175,205
"2011","Liverpool 050F","E01032505","Total",1315,182,68,114,1133,79,122,215,174,70,163,310
"2011","Liverpool 050G","E01032506","Total",1344,260,72,188,1084,106,108,223,244,21,81,301
"2011","Liverpool 050H","E01032507","Total",1539,195,43,152,1344,73,94,208,344,48,140,437
"2011","Liverpool 050I","E01033748","Total",1276,369,15,354,907,68,26,99,604,10,19,81
"2011","Liverpool 050J","E01033767","Total",1067,261,65,196,806,208,64,125,154,10,33,212
"2011","Liverpool 051A","E01006793","Total",1494,337,134,203,1157,121,202,198,238,84,107,207
"2011","Liverpool 051B","E01006795","Total",1407,215,89,126,1192,36,158,265,228,87,120,298
"2011","Liverpool 051C","E01006797","Total",1499,297,101,196,1202,112,150,248,190,53,149,300
"2011","Liverpool 051D","E01006798","Total",1410,183,74,109,1227,47,192,237,222,25,148,356
"2011","Liverpool 051E","E01006799","Total",1796,719,351,368,1077,90,248,182,258,26,57,216
"2011","Liverpool 052A","E01006521","Total",1619,485,173,312,1134,84,180,171,366,48,41,244
"2011","Liverpool 052B","E01006523","Total",1473,448,78,370,1025,67,62,184,358,35,52,267
"2011","Liverpool 052C","E01006528","Total",1434,214,45,169,1220,67,84,249,234,44,151,391
"2011","Liverpool 052D","E01006628","Total",1518,200,77,123,1318,74,108,255,296,63,163,359
"2011","Liverpool 052E","E01006629","Total",1242,203,79,124,1039,49,124,167,220,42,88,349
"2011","Liverpool 053A","E01006527","Total",1373,245,112,133,1128,75,162,258,184,40,100,309
"2011","Liverpool 053B","E01006680","Total",1569,140,89,51,1429,44,184,314,172,56,203,456
"2011","Liverpool 053C","E01006682","Total",1310,96,58,38,1214,43,174,274,154,78,153,338
"2011","Liverpool 053D","E01006683","Total",1507,136,80,56,1371,30,194,320,192,68,200,367
"2011","Liverpool 053E","E01006686","Total",1429,122,77,45,1307,39,168,193,156,95,215,441
"2011","Liverpool 054A","E01006534","Total",1542,224,89,135,1318,84,122,240,182,71,259,360
"2011","Liverpool 054B","E01006535","Total",1550,205,105,100,1345,85,142,238,226,52,189,413
"2011","Liverpool 054C","E01006536","Total",1848,272,103,169,1576,122,212,258,276,64,268,376
"2011","Liverpool 054D","E01006681","Total",1585,276,107,169,1309,82,174,256,202,52,169,374
"2011","Liverpool 055A","E01006530","Total",1428,172,109,63,1256,46,258,285,172,21,141,333
"2011","Liverpool 055B","E01006531","Total",1455,227,171,56,1228,29,328,197,168,52,111,343
"2011","Liverpool 055C","E01006533","Total",1355,240,116,124,1115,55,170,205,162,63,135,325
"2011","Liverpool 055D","E01006537","Total",2257,278,58,220,1979,220,194,376,390,81,232,486
"2011","Liverpool 055E","E01006538","Total",1318,130,71,59,1188,62,152,234,162,50,176,352
"2011","Liverpool 056A","E01006519","Total",1286,128,66,62,1158,29,148,278,172,78,149,304
"2011","Liverpool 056B","E01006684","Total",2113,361,106,255,1752,92,208,433,444,106,154,315
"2011","Liverpool 056C","E01006685","Total",1426,181,88,93,1245,42,170,244,192,97,93,407
"2011","Liverpool 056D","E01006687","Total",1896,391,149,242,1505,77,184,401,332,73,94,344
"2011","Liverpool 056E","E01006688","Total",1520,282,84,198,1238,76,166,284,226,62,96,328
"2011","Liverpool 057A","E01006740","Total",1280,273,83,190,1007,147,82,153,156,139,100,230
"2011","Liverpool 057B","E01006742","Total",1394,195,75,120,1199,76,136,256,176,75,145,335
"2011","Liverpool 057C","E01006744","Total",1482,321,81,240,1161,177,116,223,234,72,111,228
"2011","Liverpool 057D","E01006745","Total",1854,407,65,342,1447,270,108,278,252,48,164,327
"2011","Liverpool 058A","E01006738","Total",1501,220,97,123,1281,199,130,229,202,77,164,280
"2011","Liverpool 058B","E01006739","Total",1738,225,91,134,1513,230,112,300,184,125,279,283
"2011","Liverpool 058C","E01006741","Total",1815,251,105,146,1564,195,176,311,230,38,214,400
"2011","Liverpool 058D","E01006743","Total",2175,385,99,286,1790,250,116,437,362,91,203,331
"2011","Liverpool 059A","E01006753","Total",1557,211,75,136,1346,265,130,216,194,98,185,258
"2011","Liverpool 059B","E01006754","Total",1627,322,110,212,1305,218,130,223,224,42,204,264
"2011","Liverpool 059C","E01006755","Total",1552,257,76,181,1295,310,86,224,186,70,178,241
"2011","Liverpool 059D","E01006756","Total",1820,220,66,154,1600,362,126,331,194,75,201,311
"2011","Liverpool 059E","E01006757","Total",1491,203,73,130,1288,237,84,269,166,127,157,248
"2011","Liverpool 059F","E01006758","Total",1527,199,71,128,1328,261,100,228,176,80,180,303
"2011","Liverpool 060A","E01006513","Total",1691,467,30,437,1224,38,26,57,534,0,31,538
"2011","Liverpool 060B","E01033758","Total",703,312,15,297,391,30,14,43,220,8,21,55
"2011","Liverpool 060C","E01033760","Total",856,330,5,325,526,10,4,14,272,0,5,221
"2011","Liverpool 060D","E01033761","Total",1340,415,3,412,925,16,2,26,694,0,4,183
"2011","Liverpool 060E","E01033762","Total",722,282,38,244,440,8,12,27,242,0,13,138
"2011","Liverpool 061A","E01033750","Total",1448,504,17,487,944,26,30,126,538,5,21,198
"2011","Liverpool 061B","E01033754","Total",1448,396,50,346,1052,51,76,81,568,20,46,210
"2011","Liverpool 061C","E01033756","Total",1136,414,10,404,722,9,20,71,500,0,8,114
"2011","Liverpool 061D","E01033765","Total",1351,282,68,214,1069,202,88,165,226,66,106,216
"2011","Liverpool 062A","E01033751","Total",1039,313,47,266,726,67,20,76,358,11,55,139
"2011","Liverpool 062B","E01033752","Total",1195,448,4,444,747,8,2,78,566,0,5,88
"2011","Liverpool 062C","E01033753","Total",1051,423,6,417,628,7,6,61,496,0,5,53
"2011","Liverpool 062D","E01033755","Total",1082,341,6,335,741,4,6,77,532,5,0,117
"2011","Sefton 001A","E01006946","Total",1397,228,145,83,1169,56,350,218,192,45,86,222
"2011","Sefton 001B","E01007028","Total",1355,167,90,77,1188,100,186,258,224,59,97,264
"2011","Sefton 001C","E01007029","Total",1248,195,148,47,1053,26,400,161,166,31,77,192
"2011","Sefton 001D","E01007030","Total",1539,183,90,93,1356,110,164,363,200,119,185,215
"2011","Sefton 001E","E01007036","Total",1212,133,85,48,1079,58,214,205,236,25,87,254
"2011","Sefton 002A","E01006947","Total",1427,160,107,53,1267,54,266,245,196,51,155,300
"2011","Sefton 002B","E01007031","Total",1446,129,83,46,1317,61,210,271,228,123,131,293
"2011","Sefton 002C","E01007032","Total",1324,131,83,48,1193,47,208,286,200,59,136,257
"2011","Sefton 002D","E01007033","Total",1491,177,122,55,1314,87,260,294,202,78,112,281
"2011","Sefton 002E","E01007035","Total",1383,194,108,86,1189,52,248,259,198,106,101,225
"2011","Sefton 003A","E01006944","Total",1456,477,301,176,979,62,388,114,258,28,33,96
"2011","Sefton 003B","E01006948","Total",1277,301,189,112,976,90,170,154,174,55,77,256
"2011","Sefton 003C","E01006949","Total",1427,318,215,103,1109,27,328,192,162,56,106,238
"2011","Sefton 003D","E01006951","Total",1404,367,194,173,1037,63,310,171,192,28,86,187
"2011","Sefton 003E","E01007034","Total",1315,175,121,54,1140,36,230,230,188,50,153,253
"2011","Sefton 004A","E01006945","Total",1456,404,173,231,1052,43,212,203,270,26,90,208
"2011","Sefton 004B","E01006950","Total",1340,444,144,300,896,50,132,164,318,15,53,164
"2011","Sefton 004C","E01006968","Total",1668,654,214,440,1014,99,152,251,286,6,78,142
"2011","Sefton 004D","E01006969","Total",1409,266,81,185,1143,112,110,246,214,112,102,247
"2011","Sefton 004F","E01033094","Total",927,316,73,243,611,55,106,135,200,0,32,83
"2011","Sefton 004G","E01033097","Total",1038,326,110,216,712,65,122,157,178,27,51,112
"2011","Sefton 005A","E01007055","Total",1484,138,53,85,1346,160,140,296,200,135,177,238
"2011","Sefton 005B","E01007056","Total",1616,166,68,98,1450,131,144,436,272,68,152,247
"2011","Sefton 005C","E01007057","Total",1528,159,76,83,1369,179,184,271,264,58,99,314
"2011","Sefton 005D","E01007062","Total",1434,170,72,98,1264,66,156,327,210,81,151,273
"2011","Sefton 005E","E01007063","Total",1580,178,100,78,1402,130,124,341,212,104,197,294
"2011","Sefton 006A","E01007058","Total",1425,218,70,148,1207,105,106,262,238,71,153,272
"2011","Sefton 006B","E01007059","Total",1516,149,75,74,1367,112,140,344,224,98,175,274
"2011","Sefton 006C","E01007060","Total",1389,179,75,104,1210,99,110,298,216,144,69,274
"2011","Sefton 006D","E01007061","Total",1494,114,40,74,1380,132,96,329,230,124,187,282
"2011","Sefton 006E","E01007064","Total",1227,108,46,62,1119,52,98,250,206,75,198,240
"2011","Sefton 007A","E01006934","Total",1529,202,95,107,1327,109,134,302,230,78,171,303
"2011","Sefton 007B","E01006970","Total",1589,327,100,227,1262,111,152,236,272,109,139,243
"2011","Sefton 007C","E01006994","Total",1593,191,56,135,1402,166,86,325,246,161,153,265
"2011","Sefton 007D","E01006996","Total",1514,214,75,139,1300,74,124,286,222,123,208,263
"2011","Sefton 007E","E01006998","Total",1659,199,76,123,1460,180,126,350,256,72,217,259
"2011","Sefton 008A","E01006995","Total",1297,121,53,68,1176,44,110,216,158,113,223,312
"2011","Sefton 008B","E01006997","Total",1511,175,51,124,1336,93,116,300,218,115,202,292
"2011","Sefton 008C","E01006999","Total",1602,182,112,70,1420,112,248,296,222,61,182,299
"2011","Sefton 008D","E01007000","Total",1286,141,54,87,1145,81,112,269,188,84,194,217
"2011","Sefton 008E","E01007001","Total",1588,206,83,123,1382,164,110,329,232,127,174,246
"2011","Sefton 008F","E01007002","Total",1330,154,90,64,1176,56,236,212,238,63,123,248
"2011","Sefton 009A","E01006928","Total",1466,143,85,58,1323,49,186,281,168,117,179,343
"2011","Sefton 009B","E01006935","Total",1679,211,96,115,1468,49,182,316,232,151,249,289
"2011","Sefton 009C","E01006971","Total",1488,354,193,161,1134,30,396,125,238,43,97,205
"2011","Sefton 009D","E01006972","Total",1542,478,341,137,1064,32,412,146,180,37,83,174
"2011","Sefton 009E","E01006973","Total",1388,217,140,77,1171,54,320,148,180,59,160,250
"2011","Sefton 009F","E01006974","Total",1542,198,116,82,1344,40,276,209,266,80,184,289
"2011","Sefton 010A","E01006929","Total",1550,159,58,101,1391,82,166,311,192,100,194,346
"2011","Sefton 010B","E01006930","Total",1460,163,89,74,1297,112,166,350,246,72,103,248
"2011","Sefton 010C","E01006931","Total",1530,170,96,74,1360,65,242,365,170,62,134,322
"2011","Sefton 010D","E01006932","Total",1502,115,61,54,1387,38,222,324,228,69,162,344
"2011","Sefton 010E","E01006933","Total",1445,151,75,76,1294,104,164,330,208,136,115,237
"2011","Sefton 011A","E01006920","Total",1620,215,136,79,1405,112,252,318,178,81,179,285
"2011","Sefton 011B","E01006924","Total",1453,259,155,104,1194,133,204,272,186,106,112,181
"2011","Sefton 011C","E01006925","Total",1508,153,86,67,1355,116,150,229,204,132,184,340
"2011","Sefton 011D","E01006927","Total",1677,252,170,82,1425,119,270,299,242,66,153,276
"2011","Sefton 012A","E01006921","Total",1305,159,121,38,1146,16,378,188,172,44,102,246
"2011","Sefton 012B","E01006922","Total",1417,125,77,48,1292,23,366,192,210,33,144,324
"2011","Sefton 012C","E01006923","Total",1472,182,147,35,1290,28,400,213,258,41,108,242
"2011","Sefton 012D","E01006926","Total",1615,178,131,47,1437,21,410,225,250,68,128,335
"2011","Sefton 013A","E01006985","Total",1455,141,86,55,1314,42,286,271,172,100,160,283
"2011","Sefton 013B","E01006986","Total",1202,113,82,31,1089,22,308,150,176,45,119,269
"2011","Sefton 013C","E01006987","Total",1251,143,99,44,1108,38,288,177,158,62,142,243
"2011","Sefton 013D","E01006989","Total",1294,125,91,34,1169,13,346,183,182,78,126,241
"2011","Sefton 013E","E01006990","Total",1236,77,51,26,1159,34,232,232,152,79,111,319
"2011","Sefton 014A","E01006988","Total",1341,226,152,74,1115,58,252,206,176,58,120,245
"2011","Sefton 014B","E01007079","Total",1573,167,119,48,1406,52,288,287,162,139,161,317
"2011","Sefton 014C","E01007080","Total",1414,179,89,90,1235,64,228,295,198,64,137,249
"2011","Sefton 014D","E01007081","Total",1491,293,207,86,1198,31,278,258,166,51,110,304
"2011","Sefton 015A","E01006991","Total",1496,107,77,30,1389,27,362,263,180,92,158,307
"2011","Sefton 015B","E01006992","Total",1063,129,92,37,934,13,152,247,130,32,120,240
"2011","Sefton 015C","E01006993","Total",1498,117,84,33,1381,44,280,218,160,127,174,378
"2011","Sefton 015D","E01007078","Total",1537,162,103,59,1375,15,316,318,196,73,154,303
"2011","Sefton 016A","E01007075","Total",1370,190,116,74,1180,84,276,213,178,58,132,239
"2011","Sefton 016B","E01007076","Total",1381,148,96,52,1233,51,224,246,184,51,196,281
"2011","Sefton 016C","E01007077","Total",1512,143,84,59,1369,56,200,331,172,119,196,295
"2011","Sefton 016D","E01007082","Total",1434,166,103,63,1268,64,248,328,188,60,103,277
"2011","Sefton 017A","E01007067","Total",1367,170,76,94,1197,31,214,214,206,80,144,308
"2011","Sefton 017B","E01007068","Total",1272,85,42,43,1187,37,160,242,172,52,165,359
"2011","Sefton 017C","E01007069","Total",1442,239,128,111,1203,101,226,196,182,48,168,282
"2011","Sefton 017D","E01007070","Total",1471,128,91,37,1343,40,284,208,200,50,180,381
"2011","Sefton 017E","E01007101","Total",1440,152,109,43,1288,24,288,224,170,30,159,393
"2011","Sefton 018C","E01007095","Total",1583,232,163,69,1351,36,298,285,168,48,194,322
"2011","Sefton 018D","E01007096","Total",1332,154,102,52,1178,38,258,163,150,51,146,372
"2011","Sefton 018E","E01007100","Total",1391,179,112,67,1212,47,188,306,166,52,107,346
"2011","Sefton 018F","E01033096","Total",2405,240,148,92,2165,93,352,461,338,90,229,602
"2011","Sefton 019A","E01007074","Total",1500,168,110,58,1332,87,174,313,188,76,172,322
"2011","Sefton 019B","E01007097","Total",1529,175,107,68,1354,60,288,296,184,37,128,361
"2011","Sefton 019C","E01007098","Total",1418,174,97,77,1244,34,290,191,204,76,133,316
"2011","Sefton 019D","E01007099","Total",1415,241,182,59,1174,21,274,187,160,46,149,337
"2011","Sefton 020A","E01007065","Total",1338,84,53,31,1254,70,128,258,198,73,181,346
"2011","Sefton 020B","E01007066","Total",1560,122,70,52,1438,67,158,371,222,46,192,382
"2011","Sefton 020C","E01007071","Total",1254,121,78,43,1133,13,188,249,146,57,146,334
"2011","Sefton 020D","E01007072","Total",1417,261,199,62,1156,18,320,169,156,25,141,327
"2011","Sefton 020E","E01007073","Total",1333,87,48,39,1246,17,202,264,148,70,187,358
"2011","Sefton 021A","E01007020","Total",1419,178,94,84,1241,112,130,211,160,78,200,350
"2011","Sefton 021B","E01007022","Total",1420,191,98,93,1229,43,170,213,190,122,147,344
"2011","Sefton 021C","E01007023","Total",1311,123,70,53,1188,24,190,199,176,69,139,391
"2011","Sefton 021D","E01007027","Total",2063,216,129,87,1847,49,312,300,428,62,189,507
"2011","Sefton 021E","E01007037","Total",1506,198,123,75,1308,40,246,228,192,66,142,394
"2011","Sefton 021F","E01007038","Total",1488,175,92,83,1313,62,190,202,172,73,217,397
"2011","Sefton 022A","E01006936","Total",1479,341,197,144,1138,25,266,152,260,53,128,254
"2011","Sefton 022B","E01006937","Total",1306,96,56,40,1210,36,138,283,166,116,161,310
"2011","Sefton 022C","E01006938","Total",1199,152,93,59,1047,19,274,142,182,46,136,248
"2011","Sefton 022D","E01006939","Total",1479,225,100,125,1254,90,130,276,266,88,144,260
"2011","Sefton 022E","E01006940","Total",1372,207,97,110,1165,35,184,191,168,98,157,332
"2011","Sefton 022F","E01006943","Total",1229,103,72,31,1126,18,174,235,160,42,158,339
"2011","Sefton 023A","E01007083","Total",1187,123,67,56,1064,90,136,170,134,51,120,363
"2011","Sefton 023B","E01007085","Total",1353,186,78,108,1167,178,142,194,160,70,176,247
"2011","Sefton 023C","E01007086","Total",1121,164,82,82,957,118,110,177,160,55,91,246
"2011","Sefton 023D","E01007091","Total",1285,235,116,119,1050,63,200,173,174,55,169,216
"2011","Sefton 023E","E01007092","Total",1079,149,78,71,930,74,138,122,118,53,194,231
"2011","Sefton 024A","E01006979","Total",1453,213,87,126,1240,177,102,274,172,116,163,236
"2011","Sefton 024B","E01006980","Total",1473,224,85,139,1249,247,96,225,166,83,186,246
"2011","Sefton 024C","E01007024","Total",1076,151,60,91,925,135,106,138,178,40,110,218
"2011","Sefton 024D","E01007026","Total",1145,188,105,83,957,97,132,158,148,32,147,243
"2011","Sefton 024E","E01007089","Total",1329,220,85,135,1109,165,126,173,158,63,165,259
"2011","Sefton 025A","E01007021","Total",1304,145,103,42,1159,20,202,167,152,45,127,446
"2011","Sefton 025B","E01007025","Total",1339,126,85,41,1213,28,202,206,166,66,205,340
"2011","Sefton 025C","E01007105","Total",1628,240,134,106,1388,120,160,355,202,77,154,320
"2011","Sefton 025D","E01007106","Total",1477,190,105,85,1287,89,168,342,196,46,125,321
"2011","Sefton 025E","E01007107","Total",1302,102,63,39,1200,26,118,316,136,75,178,351
"2011","Sefton 025F","E01007108","Total",1571,116,55,61,1455,57,162,369,220,85,189,373
"2011","Sefton 026A","E01007039","Total",1268,122,56,66,1146,95,126,312,184,30,134,265
"2011","Sefton 026B","E01007040","Total",1882,166,65,101,1716,102,168,425,316,101,217,387
"2011","Sefton 026C","E01007042","Total",1275,171,108,63,1104,59,174,218,140,52,122,339
"2011","Sefton 026D","E01007044","Total",1367,200,152,48,1167,34,316,151,148,46,147,325
"2011","Sefton 026E","E01007045","Total",1236,100,57,43,1136,45,198,204,140,50,146,353
"2011","Sefton 027A","E01007041","Total",1403,155,83,72,1248,57,166,268,166,46,187,358
"2011","Sefton 027B","E01007043","Total",1408,180,114,66,1228,22,282,176,162,48,158,380
"2011","Sefton 027C","E01007046","Total",1593,151,72,79,1442,88,154,321,242,41,234,362
"2011","Sefton 027D","E01007053","Total",1408,141,74,67,1267,76,144,294,160,54,200,339
"2011","Sefton 027E","E01007084","Total",1385,116,35,81,1269,43,108,268,238,92,174,346
"2011","Sefton 028A","E01006941","Total",1607,236,124,112,1371,80,164,238,234,88,220,347
"2011","Sefton 028B","E01006942","Total",1461,194,79,115,1267,102,114,315,266,61,106,303
"2011","Sefton 028C","E01006954","Total",1473,278,112,166,1195,71,108,221,224,37,183,351
"2011","Sefton 028D","E01007104","Total",1377,162,72,90,1215,36,132,335,194,74,149,295
"2011","Sefton 028E","E01007109","Total",1531,214,92,122,1317,136,160,256,238,126,143,258
"2011","Sefton 029A","E01007048","Total",1620,174,47,127,1446,212,70,348,182,103,274,257
"2011","Sefton 029B","E01007054","Total",1396,198,85,113,1198,105,190,169,184,63,168,319
"2011","Sefton 029C","E01007087","Total",1316,242,85,157,1074,118,126,132,176,71,160,291
"2011","Sefton 029D","E01007088","Total",1293,198,102,96,1095,123,114,218,174,36,131,299
"2011","Sefton 029E","E01007090","Total",1143,226,82,144,917,132,112,153,114,56,129,221
"2011","Sefton 030A","E01006955","Total",1650,117,44,73,1533,122,114,321,246,105,205,420
"2011","Sefton 030B","E01006956","Total",1552,234,54,180,1318,105,90,272,292,91,196,272
"2011","Sefton 030C","E01006958","Total",1460,310,96,214,1150,110,118,258,258,47,93,266
"2011","Sefton 030D","E01007102","Total",1513,146,55,91,1367,74,92,337,228,99,226,311
"2011","Sefton 030E","E01007103","Total",1477,166,86,80,1311,35,204,313,226,65,148,320
"2011","Sefton 031A","E01006978","Total",1397,135,64,71,1262,59,166,221,230,61,229,296
"2011","Sefton 031B","E01006981","Total",1486,203,70,133,1283,173,124,198,170,103,195,320
"2011","Sefton 031C","E01006982","Total",1382,140,78,62,1242,99,166,223,196,90,170,298
"2011","Sefton 031D","E01006983","Total",1651,186,70,116,1465,148,148,364,264,63,164,314
"2011","Sefton 031E","E01006984","Total",1351,103,46,57,1248,298,76,208,144,138,166,218
"2011","Sefton 032A","E01006952","Total",1339,276,55,221,1063,108,92,205,176,81,144,257
"2011","Sefton 032B","E01006953","Total",1414,265,65,200,1149,150,126,229,198,57,149,240
"2011","Sefton 032C","E01006957","Total",1454,505,117,388,949,95,118,138,248,21,106,223
"2011","Sefton 032D","E01006959","Total",1483,243,91,152,1240,90,136,222,230,58,184,320
"2011","Sefton 032E","E01006977","Total",1637,456,279,177,1181,123,196,218,218,52,165,209
"2011","Sefton 033A","E01006976","Total",1454,156,70,86,1298,123,110,308,228,50,153,326
"2011","Sefton 033B","E01007014","Total",1588,169,115,54,1419,76,192,301,218,72,192,368
"2011","Sefton 033E","E01007047","Total",1439,253,112,141,1186,89,158,249,190,78,190,232
"2011","Sefton 033F","E01033095","Total",1845,191,111,80,1654,100,268,315,182,95,207,487
"2011","Sefton 034A","E01007004","Total",1415,265,75,190,1150,188,86,250,172,67,121,266
"2011","Sefton 034B","E01007005","Total",1316,228,36,192,1088,240,78,120,162,128,167,193
"2011","Sefton 034C","E01007011","Total",1440,288,104,184,1152,198,88,146,162,47,181,330
"2011","Sefton 034D","E01007016","Total",1802,205,56,149,1597,223,126,317,250,110,191,380
"2011","Sefton 034E","E01007017","Total",1541,324,73,251,1217,209,84,261,200,72,125,266
"2011","Sefton 035A","E01007019","Total",1376,130,54,76,1246,229,72,216,164,86,231,248
"2011","Sefton 035B","E01007049","Total",1518,218,132,86,1300,104,132,282,202,47,182,351
"2011","Sefton 035C","E01007050","Total",1314,103,60,43,1211,64,142,237,138,82,216,332
"2011","Sefton 035D","E01007051","Total",1213,158,75,83,1055,143,104,174,172,70,160,232
"2011","Sefton 035E","E01007052","Total",1386,148,53,95,1238,170,104,253,144,116,167,284
"2011","Sefton 036A","E01006964","Total",1469,218,64,154,1251,152,102,250,226,95,154,272
"2011","Sefton 036B","E01007003","Total",1179,225,42,183,954,211,78,182,168,40,125,150
"2011","Sefton 036C","E01007006","Total",1423,213,89,124,1210,193,104,226,146,94,194,253
"2011","Sefton 036D","E01007012","Total",1318,211,51,160,1107,145,88,248,222,53,132,219
"2011","Sefton 036E","E01007013","Total",1423,301,83,218,1122,193,68,240,190,113,68,250
"2011","Sefton 037A","E01006967","Total",1458,389,158,231,1069,139,126,188,176,31,134,275
"2011","Sefton 037B","E01007007","Total",1232,327,95,232,905,139,70,130,192,72,117,185
"2011","Sefton 037C","E01007008","Total",1261,289,74,215,972,207,80,186,186,15,75,223
"2011","Sefton 037D","E01007009","Total",1184,391,93,298,793,95,66,93,176,60,104,199
"2011","Sefton 037E","E01007010","Total",1090,220,66,154,870,190,70,117,136,53,146,158
"2011","Sefton 038A","E01006960","Total",1161,91,48,43,1070,53,166,142,134,60,187,328
"2011","Sefton 038B","E01006961","Total",1509,213,76,137,1296,193,90,217,216,84,204,292
"2011","Sefton 038C","E01006962","Total",1402,261,138,123,1141,104,148,191,170,56,161,311
"2011","Sefton 038D","E01006963","Total",1491,218,46,172,1273,259,96,236,174,82,179,247
"2011","Sefton 038E","E01006965","Total",1478,162,87,75,1316,179,124,257,138,72,217,329
"2011","Sefton 038F","E01006966","Total",1487,213,88,125,1274,127,78,304,210,41,162,352
"2011","St. Helens 001A","E01006882","Total",1188,110,73,37,1078,13,266,253,146,36,117,247
"2011","St. Helens 001B","E01006883","Total",1305,190,121,69,1115,43,262,232,202,35,98,243
"2011","St. Helens 001C","E01006884","Total",1353,195,122,73,1158,31,236,236,222,70,89,274
"2011","St. Helens 001D","E01006885","Total",1276,119,84,35,1157,32,266,206,236,35,148,234
"2011","St. Helens 001E","E01006886","Total",1311,146,93,53,1165,27,270,259,208,40,92,269
"2011","St. Helens 001F","E01006887","Total",1299,181,78,103,1118,107,194,202,204,51,128,232
"2011","St. Helens 002A","E01006802","Total",1653,234,118,116,1419,68,216,278,280,82,119,376
"2011","St. Helens 002B","E01006804","Total",1599,157,92,65,1442,69,246,293,236,116,121,361
"2011","St. Helens 002C","E01006806","Total",1519,123,73,50,1396,24,316,279,220,98,151,308
"2011","St. Helens 002D","E01006807","Total",1335,140,85,55,1195,19,288,257,218,65,90,258
"2011","St. Helens 003A","E01006803","Total",1434,134,69,65,1300,54,230,257,242,44,144,329
"2011","St. Helens 003B","E01006805","Total",1539,153,64,89,1386,89,164,345,226,97,189,276
"2011","St. Helens 003C","E01006808","Total",1300,122,42,80,1178,28,112,251,270,41,131,345
"2011","St. Helens 003D","E01006809","Total",1468,125,77,48,1343,37,264,254,238,50,166,334
"2011","St. Helens 004A","E01006849","Total",1444,243,116,127,1201,170,120,253,176,74,187,221
"2011","St. Helens 004B","E01006850","Total",1519,333,146,187,1186,138,140,237,188,90,117,276
"2011","St. Helens 004C","E01006851","Total",1264,155,78,77,1109,69,196,210,204,26,97,307
"2011","St. Helens 004D","E01006852","Total",1319,93,46,47,1226,38,170,306,236,16,140,320
"2011","St. Helens 004E","E01006853","Total",1342,155,57,98,1187,46,158,288,218,21,122,334
"2011","St. Helens 004F","E01006854","Total",1458,199,77,122,1259,95,128,319,234,62,123,298
"2011","St. Helens 004G","E01006855","Total",1453,174,84,90,1279,125,188,237,250,79,132,268
"2011","St. Helens 005A","E01006836","Total",1415,158,78,80,1257,83,206,225,204,88,156,295
"2011","St. Helens 005B","E01006839","Total",1341,155,76,79,1186,48,170,209,230,47,141,341
"2011","St. Helens 005C","E01006840","Total",1502,190,84,106,1312,78,200,221,294,80,117,322
"2011","St. Helens 005D","E01006842","Total",1538,199,85,114,1339,187,112,289,222,133,148,248
"2011","St. Helens 006A","E01006837","Total",1531,132,62,70,1399,108,170,380,232,82,128,299
"2011","St. Helens 006B","E01006838","Total",1444,303,161,142,1141,79,180,255,250,75,102,200
"2011","St. Helens 006C","E01006841","Total",1681,122,71,51,1559,47,170,477,258,92,184,331
"2011","St. Helens 006D","E01006843","Total",1195,151,80,71,1044,96,232,197,166,41,104,208
"2011","St. Helens 007A","E01006914","Total",1224,124,78,46,1100,26,268,239,186,45,148,188
"2011","St. Helens 007B","E01006915","Total",1573,208,115,93,1365,85,152,292,234,64,163,375
"2011","St. Helens 007C","E01006916","Total",1503,210,94,116,1293,91,128,299,244,51,151,329
"2011","St. Helens 007D","E01006917","Total",1662,164,108,56,1498,61,238,402,210,74,178,335
"2011","St. Helens 007E","E01006918","Total",1250,134,50,84,1116,64,112,276,202,36,192,234
"2011","St. Helens 007F","E01006919","Total",1545,174,69,105,1371,212,114,312,204,120,172,237
"2011","St. Helens 008A","E01006810","Total",1279,71,28,43,1208,31,182,228,212,56,176,323
"2011","St. Helens 008B","E01006811","Total",1361,189,90,99,1172,87,224,173,218,67,122,281
"2011","St. Helens 008C","E01006812","Total",1416,155,69,86,1261,216,112,301,196,78,127,231
"2011","St. Helens 008D","E01006813","Total",1487,262,112,150,1225,105,170,254,214,57,145,280
"2011","St. Helens 008E","E01006814","Total",1554,93,43,50,1461,50,176,374,280,33,174,374
"2011","St. Helens 008F","E01006815","Total",1279,160,87,73,1119,105,174,208,202,58,120,252
"2011","St. Helens 008G","E01006818","Total",1283,101,43,58,1182,53,144,253,278,33,93,328
"2011","St. Helens 009A","E01006822","Total",1382,117,71,46,1265,60,210,321,208,87,102,277
"2011","St. Helens 009B","E01006823","Total",1264,165,129,36,1099,16,346,231,118,5,142,241
"2011","St. Helens 009C","E01006824","Total",1224,144,99,45,1080,39,174,293,176,82,85,231
"2011","St. Helens 009D","E01006825","Total",1450,131,76,55,1319,32,280,261,224,61,131,330
"2011","St. Helens 010A","E01006866","Total",1546,177,87,90,1369,172,136,265,246,147,185,218
"2011","St. Helens 010B","E01006867","Total",2054,160,48,112,1894,87,130,641,356,118,237,325
"2011","St. Helens 010C","E01006868","Total",1497,233,97,136,1264,127,130,317,230,91,175,194
"2011","St. Helens 010D","E01006869","Total",1474,224,72,152,1250,115,144,278,228,77,140,268
"2011","St. Helens 011A","E01006819","Total",1507,145,55,90,1362,110,106,286,258,89,193,320
"2011","St. Helens 011B","E01006820","Total",1455,182,69,113,1273,192,82,255,226,102,173,243
"2011","St. Helens 011C","E01006821","Total",1417,241,109,132,1176,211,128,207,180,87,140,223
"2011","St. Helens 011D","E01006871","Total",1485,243,71,172,1242,171,110,229,216,128,160,228
"2011","St. Helens 012A","E01006832","Total",1646,314,39,275,1332,112,56,462,340,96,114,152
"2011","St. Helens 012B","E01006834","Total",1178,260,72,188,918,157,92,178,258,28,49,156
"2011","St. Helens 012C","E01006877","Total",1321,376,158,218,945,110,156,131,226,17,94,211
"2011","St. Helens 012D","E01006880","Total",1440,355,112,243,1085,190,120,229,250,25,87,184
"2011","St. Helens 012E","E01006881","Total",1441,342,103,239,1099,127,118,231,224,50,107,242
"2011","St. Helens 013A","E01006863","Total",1631,377,126,251,1254,171,130,300,258,51,117,227
"2011","St. Helens 013B","E01006864","Total",1866,233,63,170,1633,98,132,448,420,61,137,337
"2011","St. Helens 013C","E01006865","Total",1738,320,181,139,1418,213,202,303,254,80,109,257
"2011","St. Helens 014A","E01006845","Total",1508,236,83,153,1272,122,142,300,250,81,113,264
"2011","St. Helens 014B","E01006870","Total",1370,252,85,167,1118,114,128,266,220,50,109,231
"2011","St. Helens 014C","E01006872","Total",1381,405,129,276,976,132,124,174,272,33,102,139
"2011","St. Helens 014D","E01006873","Total",1179,166,76,90,1013,211,98,175,114,94,148,173
"2011","St. Helens 014E","E01006874","Total",1204,237,73,164,967,193,80,189,192,74,92,147
"2011","St. Helens 015A","E01006856","Total",1346,199,60,139,1147,60,108,337,286,46,119,191
"2011","St. Helens 015B","E01006857","Total",1402,166,83,83,1236,45,216,315,218,40,81,321
"2011","St. Helens 015C","E01006858","Total",1486,155,57,98,1331,184,104,292,226,104,184,237
"2011","St. Helens 015D","E01006859","Total",1641,178,84,94,1463,26,224,404,290,50,209,260
"2011","St. Helens 015E","E01006860","Total",1391,179,59,120,1212,95,156,263,300,71,110,217
"2011","St. Helens 015F","E01006861","Total",1547,176,71,105,1371,253,98,339,206,76,174,225
"2011","St. Helens 015G","E01006862","Total",1292,196,91,105,1096,76,120,269,202,71,107,251
"2011","St. Helens 016A","E01006831","Total",1464,220,75,145,1244,116,128,338,246,51,106,259
"2011","St. Helens 016B","E01006833","Total",1615,264,103,161,1351,126,144,309,306,36,141,289
"2011","St. Helens 016C","E01006835","Total",1389,238,93,145,1151,70,164,232,242,72,122,249
"2011","St. Helens 016D","E01006876","Total",1477,225,77,148,1252,124,168,252,248,42,121,297
"2011","St. Helens 016E","E01006878","Total",1346,225,95,130,1121,99,144,235,294,26,108,215
"2011","St. Helens 016F","E01006879","Total",1512,149,75,74,1363,132,122,296,210,108,215,280
"2011","St. Helens 016G","E01006904","Total",1686,153,76,77,1533,163,170,300,240,71,204,385
"2011","St. Helens 017A","E01006816","Total",1694,233,76,157,1461,209,76,303,246,146,201,280
"2011","St. Helens 017B","E01006817","Total",1330,260,91,169,1070,161,98,178,174,81,157,221
"2011","St. Helens 017C","E01006875","Total",1292,117,61,56,1175,178,104,203,162,69,152,307
"2011","St. Helens 017D","E01006899","Total",2042,210,76,134,1832,197,158,471,296,177,217,316
"2011","St. Helens 018A","E01006826","Total",1338,249,101,148,1089,62,224,180,214,59,126,224
"2011","St. Helens 018B","E01006827","Total",1591,132,52,80,1459,65,146,459,216,85,217,271
"2011","St. Helens 018C","E01006828","Total",2118,227,143,84,1891,57,300,384,310,92,231,517
"2011","St. Helens 018D","E01006829","Total",1202,137,70,67,1065,32,194,225,208,51,108,247
"2011","St. Helens 019A","E01006830","Total",1344,160,85,75,1184,193,86,181,164,124,188,248
"2011","St. Helens 019C","E01006903","Total",1521,331,151,180,1190,123,162,243,238,93,130,201
"2011","St. Helens 019D","E01006905","Total",1338,178,55,123,1160,166,126,174,206,67,113,308
"2011","St. Helens 019E","E01006906","Total",1455,214,78,136,1241,133,128,313,254,30,112,271
"2011","St. Helens 019F","E01006907","Total",1527,197,70,127,1330,126,176,330,236,43,142,277
"2011","St. Helens 019G","E01006912","Total",1466,179,46,133,1287,221,88,304,212,111,132,219
"2011","St. Helens 019H","E01006913","Total",1317,122,63,59,1195,140,144,206,192,103,159,251
"2011","St. Helens 019I","E01032904","Total",1880,122,60,62,1758,62,208,575,220,124,270,299
"2011","St. Helens 019J","E01032905","Total",1564,231,149,82,1333,47,140,373,232,127,186,228
"2011","St. Helens 020A","E01006844","Total",1603,309,104,205,1294,200,144,279,248,61,160,202
"2011","St. Helens 020B","E01006846","Total",1390,163,100,63,1227,54,248,277,236,44,103,265
"2011","St. Helens 020C","E01006847","Total",1725,183,58,125,1542,213,98,417,208,96,215,295
"2011","St. Helens 020D","E01006848","Total",1403,205,80,125,1198,46,148,285,248,35,107,329
"2011","St. Helens 020E","E01006896","Total",1523,155,79,76,1368,36,250,273,276,35,110,388
"2011","St. Helens 020F","E01006897","Total",1435,174,79,95,1261,56,176,232,250,32,114,401
"2011","St. Helens 020G","E01006901","Total",1309,116,47,69,1193,101,124,245,232,41,139,311
"2011","St. Helens 021A","E01006890","Total",1418,168,79,89,1250,98,200,240,212,55,151,294
"2011","St. Helens 021B","E01006892","Total",1164,121,73,48,1043,25,166,230,160,36,133,293
"2011","St. Helens 021C","E01006893","Total",1382,206,92,114,1176,105,176,246,164,41,129,315
"2011","St. Helens 021D","E01006894","Total",1351,146,101,45,1205,37,314,252,146,37,131,288
"2011","St. Helens 022A","E01006898","Total",1618,249,129,120,1369,132,264,249,224,56,150,294
"2011","St. Helens 022B","E01006900","Total",2712,236,41,195,2476,164,134,826,484,160,295,413
"2011","St. Helens 022C","E01006908","Total",1339,215,56,159,1124,172,84,259,202,75,104,228
"2011","St. Helens 022D","E01006909","Total",1325,121,40,81,1204,270,92,205,144,153,172,168
"2011","St. Helens 022E","E01006910","Total",1711,232,77,155,1479,190,142,326,266,61,161,333
"2011","St. Helens 022F","E01006911","Total",1508,118,64,54,1390,31,274,232,230,64,163,396
"2011","St. Helens 023A","E01006888","Total",1182,120,80,40,1062,17,268,241,132,41,88,275
"2011","St. Helens 023B","E01006889","Total",1444,125,64,61,1319,46,206,290,160,80,154,383
"2011","St. Helens 023C","E01006891","Total",1343,131,84,47,1212,51,214,269,138,50,168,322
"2011","St. Helens 023D","E01006895","Total",1361,208,133,75,1153,25,376,164,166,25,109,288
"2011","Wirral 001A","E01007229","Total",1660,210,63,147,1450,189,122,285,258,86,223,287
"2011","Wirral 001B","E01007230","Total",1239,188,78,110,1051,97,156,161,236,60,142,199
"2011","Wirral 001C","E01007231","Total",1545,287,86,201,1258,75,164,282,248,41,175,273
"2011","Wirral 001D","E01007237","Total",1483,485,243,242,998,101,224,184,204,41,82,162
"2011","Wirral 001E","E01007238","Total",1546,473,160,313,1073,162,128,151,282,58,102,190
"2011","Wirral 002A","E01007218","Total",1476,235,65,170,1241,170,70,281,236,88,151,245
"2011","Wirral 002B","E01007232","Total",1375,226,74,152,1149,100,120,241,224,54,162,248
"2011","Wirral 002C","E01007233","Total",1822,269,121,148,1553,150,124,295,254,200,222,308
"2011","Wirral 002D","E01007234","Total",1577,255,64,191,1322,139,162,245,260,35,246,235
"2011","Wirral 002E","E01007236","Total",1360,198,99,99,1162,124,110,280,208,45,143,252
"2011","Wirral 003A","E01007307","Total",1737,185,66,119,1552,75,196,245,246,65,291,434
"2011","Wirral 003B","E01007308","Total",1486,312,151,161,1174,52,230,186,216,52,164,274
"2011","Wirral 003C","E01007312","Total",1491,221,141,80,1270,72,206,257,196,69,145,325
"2011","Wirral 003D","E01007313","Total",1553,318,165,153,1235,114,188,189,218,42,157,327
"2011","Wirral 003E","E01007315","Total",1543,148,90,58,1395,102,156,353,204,41,187,352
"2011","Wirral 004A","E01007211","Total",1183,139,74,65,1044,43,162,223,166,43,138,269
"2011","Wirral 004B","E01007235","Total",1525,155,78,77,1370,115,174,296,194,75,201,315
"2011","Wirral 004C","E01007310","Total",1371,122,69,53,1249,48,144,257,154,73,164,409
"2011","Wirral 004D","E01007311","Total",1473,163,107,56,1310,25,196,249,236,42,166,396
"2011","Wirral 004E","E01007314","Total",1489,158,60,98,1331,116,132,271,214,66,175,357
"2011","Wirral 004F","E01007316","Total",1523,133,75,58,1390,77,192,266,182,59,178,436
"2011","Wirral 005A","E01007215","Total",1562,395,160,235,1167,195,134,226,182,86,167,177
"2011","Wirral 005B","E01007216","Total",1548,207,67,140,1341,207,132,267,194,111,145,285
"2011","Wirral 005C","E01007219","Total",1526,215,61,154,1311,107,120,220,162,136,236,330
"2011","Wirral 005D","E01007220","Total",1220,215,40,175,1005,209,68,178,140,82,146,182
"2011","Wirral 005E","E01007275","Total",1541,244,64,180,1297,209,80,276,228,67,164,273
"2011","Wirral 006A","E01007203","Total",2022,240,71,169,1782,98,166,392,402,98,242,384
"2011","Wirral 006B","E01007205","Total",1541,188,86,102,1353,93,154,272,170,134,242,288
"2011","Wirral 006C","E01007210","Total",1955,286,97,189,1669,253,198,281,306,130,167,334
"2011","Wirral 006D","E01007309","Total",1546,148,90,58,1398,41,256,330,170,73,165,363
"2011","Wirral 007A","E01007212","Total",1468,168,89,79,1300,51,210,252,232,93,178,284
"2011","Wirral 007B","E01007213","Total",1529,177,94,83,1352,92,202,233,230,63,162,370
"2011","Wirral 007C","E01007214","Total",1442,291,121,170,1151,141,168,214,174,46,169,239
"2011","Wirral 007D","E01007217","Total",1582,333,116,217,1249,188,128,239,246,56,140,252
"2011","Wirral 007E","E01007276","Total",1550,147,59,88,1403,159,148,310,182,90,223,291
"2011","Wirral 008A","E01007272","Total",1446,194,56,138,1252,206,128,227,154,117,157,263
"2011","Wirral 008B","E01007273","Total",1310,296,93,203,1014,253,66,222,190,48,86,149
"2011","Wirral 008C","E01007274","Total",1368,315,116,199,1053,312,62,197,142,77,102,161
"2011","Wirral 008D","E01007277","Total",1449,243,70,173,1206,221,120,198,160,70,170,267
"2011","Wirral 008E","E01007278","Total",1476,253,87,166,1223,239,92,242,190,117,118,225
"2011","Wirral 009A","E01007204","Total",1656,217,76,141,1439,366,74,230,168,181,214,206
"2011","Wirral 009B","E01007206","Total",1868,158,57,101,1710,153,150,461,294,79,232,341
"2011","Wirral 009C","E01007207","Total",1351,314,135,179,1037,173,156,133,182,85,109,199
"2011","Wirral 009D","E01007209","Total",1290,360,199,161,930,93,182,152,114,68,100,221
"2011","Wirral 010C","E01007269","Total",1816,281,75,206,1535,316,110,256,296,99,204,254
"2011","Wirral 010D","E01007270","Total",1689,290,80,210,1399,227,92,306,232,82,131,329
"2011","Wirral 010E","E01007271","Total",1668,261,83,178,1407,244,126,311,224,98,130,274
"2011","Wirral 010F","E01032903","Total",2451,364,110,254,2087,395,206,433,298,128,187,440
"2011","Wirral 011A","E01007120","Total",1376,144,57,87,1232,228,88,250,182,113,184,187
"2011","Wirral 011B","E01007121","Total",1475,275,78,197,1200,241,82,238,222,111,104,202
"2011","Wirral 011C","E01007122","Total",1381,349,96,253,1032,308,90,125,178,98,69,164
"2011","Wirral 011D","E01007123","Total",1724,207,46,161,1517,433,64,373,240,99,116,192
"2011","Wirral 011E","E01007124","Total",1512,200,73,127,1312,309,74,195,150,125,179,280
"2011","Wirral 012A","E01007208","Total",1727,214,97,117,1513,130,196,273,254,125,177,358
"2011","Wirral 012B","E01007221","Total",1467,188,86,102,1279,109,204,232,244,37,161,292
"2011","Wirral 012C","E01007225","Total",1799,194,123,71,1605,48,338,282,272,116,186,363
"2011","Wirral 012D","E01007227","Total",1475,243,130,113,1232,135,130,214,194,102,181,276
"2011","Wirral 012E","E01007228","Total",1392,318,163,155,1074,100,172,241,194,51,88,228
"2011","Wirral 013A","E01007195","Total",1624,135,85,50,1489,72,248,314,206,80,188,381
"2011","Wirral 013B","E01007199","Total",1547,122,78,44,1425,19,262,323,174,104,188,355
"2011","Wirral 013C","E01007222","Total",1608,199,83,116,1409,125,164,341,286,62,118,313
"2011","Wirral 013D","E01007223","Total",1353,146,15,131,1207,71,76,407,274,52,174,153
"2011","Wirral 014A","E01007193","Total",1610,257,146,111,1353,57,270,227,262,90,170,277
"2011","Wirral 014B","E01007194","Total",1418,269,115,154,1149,69,134,287,230,66,110,253
"2011","Wirral 014C","E01007200","Total",1653,158,97,61,1495,19,186,424,218,93,181,374
"2011","Wirral 014D","E01007201","Total",1460,208,107,101,1252,67,154,281,238,119,127,266
"2011","Wirral 014E","E01007202","Total",1330,216,96,120,1114,93,158,242,220,61,87,253
"2011","Wirral 015A","E01007125","Total",1683,280,90,190,1403,227,122,329,270,68,142,245
"2011","Wirral 015B","E01007156","Total",1454,240,70,170,1214,72,170,196,222,76,117,361
"2011","Wirral 015C","E01007157","Total",1526,149,69,80,1377,110,134,380,174,50,189,340
"2011","Wirral 015D","E01007158","Total",1509,235,110,125,1274,67,198,215,238,59,194,303
"2011","Wirral 015E","E01007159","Total",1737,182,82,100,1555,79,268,378,252,87,238,253
"2011","Wirral 016A","E01007126","Total",1824,744,117,627,1080,244,102,192,334,43,60,105
"2011","Wirral 016B","E01007127","Total",1565,240,53,187,1325,306,68,239,172,126,153,261
"2011","Wirral 016C","E01007128","Total",1651,562,204,358,1089,157,94,197,188,134,128,191
"2011","Wirral 016D","E01007129","Total",1506,378,80,298,1128,239,98,200,210,60,148,173
"2011","Wirral 016E","E01007133","Total",1086,443,138,305,643,120,66,97,138,33,72,117
"2011","Wirral 017A","E01007224","Total",1475,152,79,73,1323,53,186,306,240,52,159,327
"2011","Wirral 017B","E01007226","Total",1599,236,146,90,1363,74,258,273,298,37,96,327
"2011","Wirral 017C","E01007265","Total",1365,124,55,69,1241,53,140,369,174,79,149,277
"2011","Wirral 017D","E01007299","Total",1331,181,91,90,1150,81,136,254,216,70,95,298
"2011","Wirral 017E","E01007306","Total",1612,232,88,144,1380,98,172,328,304,53,128,297
"2011","Wirral 018A","E01007297","Total",1390,214,147,67,1176,118,180,248,164,75,164,227
"2011","Wirral 018B","E01007298","Total",1472,143,103,40,1329,36,248,188,188,99,196,374
"2011","Wirral 018C","E01007301","Total",1632,203,108,95,1429,95,218,320,224,60,161,351
"2011","Wirral 018D","E01007302","Total",1435,298,112,186,1137,89,180,276,210,52,98,232
"2011","Wirral 018E","E01007305","Total",1631,223,103,120,1408,75,232,296,286,47,160,312
"2011","Wirral 019A","E01007119","Total",1427,176,83,93,1251,204,158,144,228,69,186,262
"2011","Wirral 019B","E01007161","Total",1538,183,92,91,1355,66,246,257,210,106,162,308
"2011","Wirral 019C","E01007162","Total",1500,131,63,68,1369,219,112,181,154,122,304,277
"2011","Wirral 019D","E01007300","Total",1868,260,96,164,1608,251,152,332,240,116,232,285
"2011","Wirral 020A","E01007155","Total",1653,520,147,373,1133,103,128,190,250,42,127,293
"2011","Wirral 020B","E01007160","Total",1662,352,87,265,1310,95,162,313,274,80,133,253
"2011","Wirral 020C","E01007240","Total",1464,498,110,388,966,83,108,179,294,31,106,165
"2011","Wirral 020D","E01007241","Total",1377,304,170,134,1073,26,240,215,214,46,82,250
"2011","Wirral 020E","E01007242","Total",1644,388,196,192,1256,56,240,261,312,34,122,231
"2011","Wirral 021A","E01007130","Total",1774,235,63,172,1539,229,82,293,216,159,291,269
"2011","Wirral 021B","E01007131","Total",1595,278,84,194,1317,294,66,296,218,83,139,221
"2011","Wirral 021C","E01007179","Total",1272,257,64,193,1015,184,72,193,192,42,149,183
"2011","Wirral 021D","E01007291","Total",1670,456,94,362,1214,279,88,257,288,15,89,198
"2011","Wirral 021E","E01007292","Total",1472,275,76,199,1197,291,90,213,186,89,165,163
"2011","Wirral 021F","E01007294","Total",1481,223,64,159,1258,295,86,319,224,98,95,141
"2011","Wirral 022A","E01007180","Total",1528,278,106,172,1250,96,132,182,208,67,201,364
"2011","Wirral 022B","E01007181","Total",1465,218,67,151,1247,159,98,268,232,78,147,265
"2011","Wirral 022C","E01007239","Total",1724,294,76,218,1430,233,94,306,300,119,128,250
"2011","Wirral 022D","E01007243","Total",1604,368,158,210,1236,64,236,271,246,52,103,264
"2011","Wirral 022E","E01007244","Total",2077,318,63,255,1759,278,90,449,294,145,172,331
"2011","Wirral 023A","E01007259","Total",1208,117,79,38,1091,27,172,225,170,61,133,303
"2011","Wirral 023B","E01007261","Total",1364,171,117,54,1193,33,336,191,186,65,109,273
"2011","Wirral 023C","E01007264","Total",1412,207,110,97,1205,49,276,260,214,45,73,288
"2011","Wirral 023D","E01007266","Total",1538,140,103,37,1398,35,244,311,200,116,154,338
"2011","Wirral 023E","E01007267","Total",1454,168,92,76,1286,68,192,264,238,69,113,342
"2011","Wirral 023F","E01007268","Total",1262,194,105,89,1068,54,216,203,206,42,108,239
"2011","Wirral 024A","E01007163","Total",2347,199,83,116,2148,138,228,515,322,181,285,479
"2011","Wirral 024B","E01007245","Total",1539,164,101,63,1375,55,210,278,216,80,134,402
"2011","Wirral 024C","E01007246","Total",1553,97,47,50,1456,56,200,322,210,73,179,416
"2011","Wirral 024D","E01007247","Total",1756,116,45,71,1640,58,186,460,238,104,204,390
"2011","Wirral 024E","E01007252","Total",1548,181,85,96,1367,55,186,317,256,91,152,310
"2011","Wirral 025A","E01007249","Total",1358,217,92,125,1141,165,100,261,166,97,117,235
"2011","Wirral 025B","E01007251","Total",1166,193,83,110,973,37,164,225,174,26,67,280
"2011","Wirral 025C","E01007257","Total",1299,275,100,175,1024,134,102,233,164,82,145,164
"2011","Wirral 025D","E01007303","Total",1438,317,158,159,1121,159,116,189,174,75,150,258
"2011","Wirral 025E","E01007304","Total",1486,198,81,117,1288,244,116,254,192,64,178,240
"2011","Wirral 026A","E01007196","Total",1529,325,211,114,1204,62,226,273,184,98,127,234
"2011","Wirral 026B","E01007197","Total",1671,161,85,76,1510,56,232,358,224,177,189,274
"2011","Wirral 026C","E01007198","Total",1680,365,202,163,1315,78,196,316,288,111,137,189
"2011","Wirral 026D","E01007263","Total",1412,206,119,87,1206,80,200,242,196,57,166,265
"2011","Wirral 026E","E01007282","Total",1418,266,145,121,1152,77,138,322,216,96,76,227
"2011","Wirral 027A","E01007175","Total",1788,365,102,263,1423,197,110,248,242,123,200,303
"2011","Wirral 027B","E01007290","Total",1691,411,124,287,1280,263,86,202,208,114,180,227
"2011","Wirral 027C","E01007293","Total",1483,326,129,197,1157,347,82,156,158,85,167,162
"2011","Wirral 027D","E01007295","Total",1180,183,31,152,997,208,42,161,192,78,115,201
"2011","Wirral 027E","E01007296","Total",1713,323,91,232,1390,302,110,289,224,107,140,218
"2011","Wirral 028A","E01007258","Total",1454,165,89,76,1289,57,228,303,234,71,93,303
"2011","Wirral 028B","E01007260","Total",1561,154,104,50,1407,50,234,335,230,102,147,309
"2011","Wirral 028C","E01007262","Total",1499,152,103,49,1347,35,300,296,236,71,157,252
"2011","Wirral 028D","E01007281","Total",1333,192,124,68,1141,11,264,281,180,83,125,197
"2011","Wirral 028E","E01007283","Total",1229,92,66,26,1137,39,268,164,168,84,155,259
"2011","Wirral 029A","E01007173","Total",1521,145,77,68,1376,81,156,229,182,98,193,437
"2011","Wirral 029B","E01007174","Total",1562,179,84,95,1383,131,140,319,204,73,179,337
"2011","Wirral 029C","E01007176","Total",1560,309,78,231,1251,146,102,316,226,71,114,276
"2011","Wirral 029D","E01007177","Total",1502,235,127,108,1267,133,216,224,208,57,157,272
"2011","Wirral 029E","E01007178","Total",1535,278,95,183,1257,99,170,239,212,58,184,295
"2011","Wirral 030A","E01007248","Total",1505,156,60,96,1349,33,190,239,146,120,236,385
"2011","Wirral 030B","E01007250","Total",1415,131,81,50,1284,33,188,278,170,76,178,361
"2011","Wirral 030C","E01007253","Total",1552,293,143,150,1259,115,186,266,184,77,118,313
"2011","Wirral 030D","E01007254","Total",1499,125,72,53,1374,29,268,269,222,57,192,337
"2011","Wirral 031A","E01007115","Total",1594,207,97,110,1387,74,168,313,236,143,170,283
"2011","Wirral 031B","E01007138","Total",1633,331,102,229,1302,212,118,236,258,119,128,231
"2011","Wirral 031C","E01007139","Total",1552,250,65,185,1302,141,86,317,236,88,162,272
"2011","Wirral 031D","E01007141","Total",1590,396,170,226,1194,124,228,251,282,36,46,227
"2011","Wirral 031E","E01007289","Total",1578,218,42,176,1360,342,64,280,192,119,155,208
"2011","Wirral 032A","E01007111","Total",1575,103,61,42,1472,42,186,395,196,68,179,406
"2011","Wirral 032B","E01007112","Total",1534,208,88,120,1326,109,186,313,190,93,126,309
"2011","Wirral 032C","E01007113","Total",1364,180,101,79,1184,31,160,321,194,62,130,286
"2011","Wirral 032D","E01007114","Total",1530,125,46,79,1405,175,116,385,182,151,114,282
"2011","Wirral 032E","E01007116","Total",1552,219,118,101,1333,71,236,296,198,92,127,313
"2011","Wirral 033A","E01007280","Total",1742,231,137,94,1511,67,210,344,218,98,195,379
"2011","Wirral 033B","E01007284","Total",1623,166,97,69,1457,14,288,296,284,65,158,352
"2011","Wirral 033C","E01007285","Total",1489,161,99,62,1328,73,302,232,184,67,180,290
"2011","Wirral 033D","E01007287","Total",1837,290,207,83,1547,41,368,267,288,53,145,385
"2011","Wirral 034A","E01007183","Total",1285,118,59,59,1167,21,206,305,202,93,86,254
"2011","Wirral 034B","E01007255","Total",1486,210,109,101,1276,51,216,289,212,66,155,287
"2011","Wirral 034C","E01007256","Total",1581,248,178,70,1333,53,364,229,226,41,147,273
"2011","Wirral 034D","E01007279","Total",1647,149,83,66,1498,95,226,327,242,91,186,331
"2011","Wirral 034E","E01007286","Total",1437,198,95,103,1239,91,180,254,260,66,136,252
"2011","Wirral 035A","E01007110","Total",1601,209,115,94,1392,64,248,313,256,65,143,303
"2011","Wirral 035B","E01007117","Total",1697,127,71,56,1570,104,176,460,196,107,162,365
"2011","Wirral 035C","E01007118","Total",1503,238,107,131,1265,117,152,273,174,109,162,278
"2011","Wirral 035D","E01007151","Total",1570,162,114,48,1408,77,208,367,190,77,176,313
"2011","Wirral 035E","E01007154","Total",1540,130,78,52,1410,38,246,383,208,76,122,337
"2011","Wirral 036A","E01007140","Total",1692,285,91,194,1407,135,124,435,310,85,103,215
"2011","Wirral 036B","E01007142","Total",1697,188,74,114,1509,50,290,321,374,31,133,310
"2011","Wirral 036C","E01007143","Total",1648,200,59,141,1448,172,132,393,256,102,80,313
"2011","Wirral 036D","E01007152","Total",1650,292,192,100,1358,93,218,313,250,97,136,251
"2011","Wirral 036E","E01007153","Total",1411,243,159,84,1168,64,188,275,168,72,127,274
"2011","Wirral 037A","E01007182","Total",1508,283,187,96,1225,28,294,235,238,90,96,244
"2011","Wirral 037B","E01007184","Total",1462,199,130,69,1263,48,216,376,196,70,99,258
"2011","Wirral 037C","E01007185","Total",1594,226,105,121,1368,112,166,381,268,107,132,202
"2011","Wirral 037D","E01007192","Total",1298,233,164,69,1065,25,264,212,154,72,125,213
"2011","Wirral 037E","E01007288","Total",1587,264,171,93,1323,113,302,217,200,64,157,270
"2011","Wirral 038A","E01007144","Total",1240,156,82,74,1084,25,232,239,190,35,131,232
"2011","Wirral 038B","E01007145","Total",1299,99,56,43,1200,19,298,237,176,30,90,350
"2011","Wirral 038C","E01007146","Total",1566,226,120,106,1340,54,248,257,264,57,143,317
"2011","Wirral 038D","E01007147","Total",1402,154,81,73,1248,51,274,260,214,78,106,265
"2011","Wirral 038E","E01007148","Total",1615,132,88,44,1483,8,360,295,228,77,164,351
"2011","Wirral 039A","E01007135","Total",1511,163,94,69,1348,63,262,270,222,103,145,283
"2011","Wirral 039B","E01007136","Total",1681,193,89,104,1488,183,134,320,246,152,157,296
"2011","Wirral 039C","E01007137","Total",1643,325,137,188,1318,121,154,288,250,94,143,268
"2011","Wirral 039D","E01007170","Total",1530,160,100,60,1370,29,270,324,190,86,179,292
"2011","Wirral 040A","E01007186","Total",1590,161,101,60,1429,53,286,371,182,102,131,304
"2011","Wirral 040B","E01007187","Total",1445,162,95,67,1283,14,380,211,248,69,88,273
"2011","Wirral 040C","E01007188","Total",1491,142,105,37,1349,33,270,345,216,77,144,264
"2011","Wirral 040D","E01007189","Total",1596,199,139,60,1397,12,402,273,218,102,127,263
"2011","Wirral 040E","E01007190","Total",1485,159,109,50,1326,28,358,242,204,132,153,209
"2011","Wirral 040F","E01007191","Total",1336,97,77,20,1239,8,316,238,150,98,180,249
"2011","Wirral 041A","E01007149","Total",1489,146,86,60,1343,34,306,287,192,47,120,357
"2011","Wirral 041B","E01007150","Total",1480,129,62,67,1351,42,240,297,200,98,163,311
"2011","Wirral 041C","E01007165","Total",1338,142,94,48,1196,32,268,233,188,61,132,282
"2011","Wirral 041D","E01007171","Total",1545,150,91,59,1395,30,202,344,202,129,137,351
"2011","Wirral 041E","E01007172","Total",1436,159,96,63,1277,27,244,259,226,94,151,276
"2011","Wirral 042A","E01007164","Total",1730,234,103,131,1496,86,156,411,256,109,170,308
"2011","Wirral 042B","E01007166","Total",1446,167,109,58,1279,44,274,254,220,52,97,338
"2011","Wirral 042C","E01007167","Total",1492,179,87,92,1313,115,158,236,216,133,179,276
"2011","Wirral 042D","E01007168","Total",1640,293,149,144,1347,118,218,282,260,95,116,258
"2011","Wirral 042E","E01007169","Total",1715,231,121,110,1484,102,224,310,276,80,168,324
"2011","East Riding of Yorkshire 001A","E01012933","Total",1027,125,76,49,902,22,268,140,190,22,90,170
"2011","East Riding of Yorkshire 001B","E01012934","Total",1511,215,124,91,1296,69,332,224,270,63,104,234
"2011","East Riding of Yorkshire 001C","E01012938","Total",2256,328,174,154,1928,100,562,381,438,107,147,193
"2011","East Riding of Yorkshire 001D","E01012939","Total",1820,173,108,65,1647,70,488,316,302,115,89,267
"2011","East Riding of Yorkshire 001E","E01012940","Total",1655,270,169,101,1385,52,488,229,298,22,86,210
"2011","East Riding of Yorkshire 001F","E01012941","Total",1361,217,163,54,1144,27,474,151,276,20,55,141
"2011","East Riding of Yorkshire 002A","E01012929","Total",1952,180,77,103,1772,191,168,432,344,116,228,293
"2011","East Riding of Yorkshire 002B","E01012930","Total",1424,166,93,73,1258,77,322,211,230,61,144,213
"2011","East Riding of Yorkshire 002C","E01012935","Total",1270,168,133,35,1102,14,416,172,192,20,85,203
"2011","East Riding of Yorkshire 002D","E01012937","Total",2158,326,189,137,1832,59,580,216,400,67,179,331
"2011","East Riding of Yorkshire 002E","E01012942","Total",1226,222,166,56,1004,23,474,95,212,20,71,109
"2011","East Riding of Yorkshire 003A","E01012928","Total",1680,234,125,109,1446,186,184,331,184,163,163,235
"2011","East Riding of Yorkshire 003B","E01012931","Total",1550,355,230,125,1195,127,246,219,254,66,84,199
"2011","East Riding of Yorkshire 003C","E01012932","Total",1629,225,102,123,1404,188,216,289,226,136,134,215
"2011","East Riding of Yorkshire 003D","E01012946","Total",1562,231,126,105,1331,201,188,284,182,112,146,218
"2011","East Riding of Yorkshire 003E","E01012949","Total",1337,225,127,98,1112,78,208,212,234,76,113,191
"2011","East Riding of Yorkshire 004A","E01012936","Total",1240,309,166,143,931,24,326,111,214,11,70,175
"2011","East Riding of Yorkshire 004B","E01012943","Total",1577,245,105,140,1332,111,170,297,240,95,148,271
"2011","East Riding of Yorkshire 004C","E01012945","Total",1570,276,85,191,1294,134,176,249,222,97,209,207
"2011","East Riding of Yorkshire 004D","E01012952","Total",1337,265,85,180,1072,90,200,192,196,54,137,203
"2011","East Riding of Yorkshire 005A","E01012944","Total",1419,368,67,301,1051,94,102,168,190,99,185,213
"2011","East Riding of Yorkshire 005B","E01012947","Total",1416,116,62,54,1300,88,242,214,226,80,155,295
"2011","East Riding of Yorkshire 005C","E01012948","Total",1296,305,88,217,991,72,116,196,232,59,136,180
"2011","East Riding of Yorkshire 005D","E01012951","Total",1212,239,102,137,973,51,200,133,176,69,170,174
"2011","East Riding of Yorkshire 006A","E01012950","Total",1360,138,89,49,1222,45,338,239,188,69,105,238
"2011","East Riding of Yorkshire 006B","E01012990","Total",1364,164,85,79,1200,43,230,272,248,46,134,227
"2011","East Riding of Yorkshire 006C","E01012991","Total",1579,148,69,79,1431,54,280,275,284,89,148,301
"2011","East Riding of Yorkshire 006D","E01012992","Total",1486,184,83,101,1302,70,242,196,276,68,159,291
"2011","East Riding of Yorkshire 008A","E01012978","Total",1418,179,133,46,1239,24,342,277,230,35,111,220
"2011","East Riding of Yorkshire 008B","E01012981","Total",1403,149,68,81,1254,25,232,250,296,58,125,268
"2011","East Riding of Yorkshire 008C","E01012983","Total",1775,166,85,81,1609,42,256,430,340,78,195,268
"2011","East Riding of Yorkshire 008D","E01012989","Total",1704,177,92,85,1527,47,396,301,268,73,158,284
"2011","East Riding of Yorkshire 008E","E01013125","Total",1724,184,84,100,1540,38,246,339,358,120,169,270
"2011","East Riding of Yorkshire 009A","E01013057","Total",1503,106,44,62,1397,40,242,389,290,55,136,245
"2011","East Riding of Yorkshire 009B","E01013059","Total",1620,148,80,68,1472,40,268,389,282,103,87,303
"2011","East Riding of Yorkshire 009C","E01013060","Total",1846,180,105,75,1666,61,346,419,324,91,143,282
"2011","East Riding of Yorkshire 009D","E01013061","Total",1614,184,106,78,1430,72,246,375,278,47,120,292
"2011","East Riding of Yorkshire 009E","E01013126","Total",1550,114,44,70,1436,38,176,397,278,97,187,263
"2011","East Riding of Yorkshire 010A","E01012986","Total",1563,212,115,97,1351,28,406,208,298,67,141,203
"2011","East Riding of Yorkshire 010B","E01012987","Total",1698,160,84,76,1538,34,266,377,294,82,179,306
"2011","East Riding of Yorkshire 010C","E01012988","Total",1498,174,85,89,1324,66,208,323,262,93,166,206
"2011","East Riding of Yorkshire 010D","E01013048","Total",2059,182,91,91,1877,55,334,433,424,101,200,330
"2011","East Riding of Yorkshire 011A","E01013052","Total",1539,146,83,63,1393,42,190,327,308,50,207,269
"2011","East Riding of Yorkshire 011B","E01013053","Total",1364,191,130,61,1173,13,370,193,250,51,82,214
"2011","East Riding of Yorkshire 011C","E01013054","Total",1939,217,85,132,1722,81,190,620,312,133,174,212
"2011","East Riding of Yorkshire 011D","E01013055","Total",1523,180,97,83,1343,77,246,284,274,68,132,262
"2011","East Riding of Yorkshire 011E","E01013056","Total",1582,281,112,169,1301,99,184,312,262,105,87,252
"2011","East Riding of Yorkshire 011F","E01013058","Total",1328,167,92,75,1161,44,192,261,296,62,111,195
"2011","East Riding of Yorkshire 011G","E01013119","Total",1476,169,68,101,1307,28,210,284,268,112,155,250
"2011","East Riding of Yorkshire 012A","E01013046","Total",1621,224,143,81,1397,48,392,166,292,66,115,318
"2011","East Riding of Yorkshire 012B","E01013047","Total",1529,223,121,102,1306,51,302,201,230,86,147,289
"2011","East Riding of Yorkshire 012C","E01013049","Total",1536,294,172,122,1242,82,258,197,268,52,152,233
"2011","East Riding of Yorkshire 012D","E01013050","Total",1624,197,100,97,1427,64,356,286,278,68,115,260
"2011","East Riding of Yorkshire 012E","E01013051","Total",1579,173,88,85,1406,139,274,298,208,106,148,233
"2011","East Riding of Yorkshire 013A","E01012922","Total",1490,142,65,77,1348,45,244,271,328,86,108,266
"2011","East Riding of Yorkshire 013B","E01012923","Total",1520,131,60,71,1389,68,170,381,260,111,180,219
"2011","East Riding of Yorkshire 013C","E01012925","Total",1301,114,57,57,1187,25,186,360,226,44,132,214
"2011","East Riding of Yorkshire 013D","E01012927","Total",1571,114,73,41,1457,32,328,273,254,96,115,359
"2011","East Riding of Yorkshire 014A","E01012924","Total",1731,141,71,70,1590,41,244,415,318,68,152,352
"2011","East Riding of Yorkshire 014B","E01012926","Total",2425,240,138,102,2185,78,502,511,452,72,202,368
"2011","East Riding of Yorkshire 014C","E01013027","Total",1622,197,118,79,1425,55,332,257,304,20,134,323
"2011","East Riding of Yorkshire 014D","E01013034","Total",1797,149,67,82,1648,45,258,443,388,101,187,226
"2011","East Riding of Yorkshire 015A","E01013120","Total",1931,196,92,104,1735,51,328,369,402,113,149,323
"2011","East Riding of Yorkshire 015B","E01013121","Total",2026,132,52,80,1894,89,180,503,384,168,217,353
"2011","East Riding of Yorkshire 015C","E01013123","Total",1528,167,68,99,1361,82,220,332,300,53,147,227
"2011","East Riding of Yorkshire 015D","E01013124","Total",2043,341,201,140,1702,162,346,388,376,70,135,225
"2011","East Riding of Yorkshire 016A","E01013064","Total",1429,84,13,71,1345,55,120,447,214,87,185,237
"2011","East Riding of Yorkshire 016B","E01013065","Total",1644,203,121,82,1441,37,324,326,282,31,136,305
"2011","East Riding of Yorkshire 016C","E01013066","Total",1621,164,94,70,1457,59,266,377,256,60,124,315
"2011","East Riding of Yorkshire 016D","E01013067","Total",1732,153,50,103,1579,45,192,437,330,113,158,304
"2011","East Riding of Yorkshire 016E","E01013068","Total",1396,157,100,57,1239,21,360,245,214,31,101,267
"2011","East Riding of Yorkshire 016F","E01013070","Total",1501,224,127,97,1277,36,258,299,266,75,112,231
"2011","East Riding of Yorkshire 017A","E01013038","Total",1554,166,65,101,1388,185,138,302,158,171,170,264
"2011","East Riding of Yorkshire 017B","E01013045","Total",1571,172,92,80,1399,189,138,335,192,155,161,229
"2011","East Riding of Yorkshire 017C","E01013069","Total",1563,189,78,111,1374,87,226,313,296,57,76,319
"2011","East Riding of Yorkshire 017D","E01013071","Total",1551,373,180,193,1178,148,176,188,252,88,111,215
"2011","East Riding of Yorkshire 018A","E01013022","Total",1884,142,53,89,1742,24,222,401,420,108,204,363
"2011","East Riding of Yorkshire 018B","E01013023","Total",1801,149,70,79,1652,27,300,342,388,80,203,312
"2011","East Riding of Yorkshire 018C","E01013024","Total",1832,168,94,74,1664,85,236,366,342,113,217,305
"2011","East Riding of Yorkshire 018D","E01013122","Total",1474,114,47,67,1360,35,208,294,278,87,192,266
"2011","East Riding of Yorkshire 018E","E01013127","Total",1500,115,52,63,1385,39,220,367,294,79,159,227
"2011","East Riding of Yorkshire 019A","E01013036","Total",1527,326,124,202,1201,131,152,291,310,26,59,232
"2011","East Riding of Yorkshire 019B","E01013037","Total",1481,185,41,144,1296,61,130,383,328,67,89,238
"2011","East Riding of Yorkshire 019C","E01013040","Total",1972,260,52,208,1712,129,140,481,474,115,109,264
"2011","East Riding of Yorkshire 019D","E01013041","Total",1523,439,239,200,1084,73,318,191,266,33,47,156
"2011","East Riding of Yorkshire 019E","E01013062","Total",1679,414,178,236,1265,80,220,249,360,72,84,200
"2011","East Riding of Yorkshire 019F","E01013063","Total",1514,206,106,100,1308,47,242,297,282,102,96,242
"2011","East Riding of Yorkshire 020A","E01012919","Total",1226,155,73,82,1071,48,150,340,206,66,93,168
"2011","East Riding of Yorkshire 020B","E01012921","Total",1149,135,77,58,1014,30,134,288,208,80,108,166
"2011","East Riding of Yorkshire 020C","E01013039","Total",1735,217,98,119,1518,52,286,252,376,58,172,322
"2011","East Riding of Yorkshire 020D","E01013042","Total",1696,117,52,65,1579,63,220,533,248,87,153,275
"2011","East Riding of Yorkshire 020E","E01013043","Total",1414,114,40,74,1300,79,140,368,206,78,188,241
"2011","East Riding of Yorkshire 020F","E01013044","Total",1621,139,50,89,1482,39,204,445,312,81,152,249
"2011","East Riding of Yorkshire 021A","E01013029","Total",1462,156,88,68,1306,61,236,219,290,90,144,266
"2011","East Riding of Yorkshire 021B","E01013030","Total",1493,169,85,84,1324,25,256,275,298,59,134,277
"2011","East Riding of Yorkshire 021C","E01013031","Total",1489,136,83,53,1353,26,276,210,300,28,215,298
"2011","East Riding of Yorkshire 021D","E01013032","Total",1444,157,90,67,1287,37,234,251,258,66,103,338
"2011","East Riding of Yorkshire 021E","E01013035","Total",1324,97,43,54,1227,23,208,257,294,52,102,291
"2011","East Riding of Yorkshire 022A","E01012954","Total",1241,135,74,61,1106,37,256,189,222,53,123,226
"2011","East Riding of Yorkshire 022B","E01012956","Total",1242,82,59,23,1160,29,198,241,182,87,184,239
"2011","East Riding of Yorkshire 022C","E01012958","Total",1047,122,82,40,925,23,254,155,214,15,76,188
"2011","East Riding of Yorkshire 022D","E01012961","Total",1466,203,141,62,1263,55,374,291,204,26,116,197
"2011","East Riding of Yorkshire 022E","E01012966","Total",1257,150,94,56,1107,17,246,182,286,26,109,241
"2011","East Riding of Yorkshire 023A","E01012953","Total",1076,140,58,82,936,15,178,202,206,36,103,196
"2011","East Riding of Yorkshire 023B","E01012955","Total",1503,194,94,100,1309,50,264,310,224,51,119,291
"2011","East Riding of Yorkshire 023C","E01012959","Total",1459,178,86,92,1281,45,190,340,276,68,105,257
"2011","East Riding of Yorkshire 023D","E01012962","Total",1067,129,72,57,938,14,164,242,206,30,85,197
"2011","East Riding of Yorkshire 023E","E01012964","Total",1680,222,137,85,1458,134,240,327,250,67,134,306
"2011","East Riding of Yorkshire 024A","E01012920","Total",1470,154,51,103,1316,35,216,354,274,101,105,231
"2011","East Riding of Yorkshire 024B","E01012965","Total",986,97,51,46,889,19,162,173,194,35,104,202
"2011","East Riding of Yorkshire 024C","E01012967","Total",1536,157,101,56,1379,44,278,333,270,66,128,260
"2011","East Riding of Yorkshire 024D","E01012968","Total",1716,137,59,78,1579,34,286,432,320,86,165,256
"2011","East Riding of Yorkshire 024E","E01012969","Total",1131,116,64,52,1015,40,166,261,180,63,86,219
"2011","East Riding of Yorkshire 025A","E01012957","Total",1428,380,201,179,1048,67,194,220,266,45,93,163
"2011","East Riding of Yorkshire 025B","E01012960","Total",1567,199,127,72,1368,52,270,253,296,77,166,254
"2011","East Riding of Yorkshire 025C","E01012963","Total",1426,343,180,163,1083,130,246,160,198,98,64,187
"2011","East Riding of Yorkshire 025D","E01013112","Total",1424,166,128,38,1258,26,390,216,224,54,126,222
"2011","East Riding of Yorkshire 026A","E01013018","Total",1819,186,102,84,1633,82,236,451,328,107,184,245
"2011","East Riding of Yorkshire 026B","E01013019","Total",1174,116,52,64,1058,46,152,220,242,21,118,259
"2011","East Riding of Yorkshire 026C","E01013021","Total",1496,163,91,72,1333,27,262,260,316,67,126,275
"2011","East Riding of Yorkshire 026D","E01013025","Total",1348,176,98,78,1172,39,224,295,206,58,111,239
"2011","East Riding of Yorkshire 026E","E01013026","Total",1661,170,78,92,1491,44,232,336,288,102,155,334
"2011","East Riding of Yorkshire 027A","E01013105","Total",1439,150,94,56,1289,122,218,266,198,66,143,276
"2011","East Riding of Yorkshire 027B","E01013110","Total",1551,214,136,78,1337,56,168,417,202,93,145,256
"2011","East Riding of Yorkshire 027C","E01013111","Total",1464,148,84,64,1316,55,218,343,226,57,147,270
"2011","East Riding of Yorkshire 027D","E01013115","Total",1533,152,81,71,1381,83,196,370,238,55,121,318
"2011","East Riding of Yorkshire 027E","E01013117","Total",1502,108,68,40,1394,31,270,328,188,51,185,341
"2011","East Riding of Yorkshire 028A","E01013108","Total",1486,149,74,75,1337,18,276,280,234,61,130,338
"2011","East Riding of Yorkshire 028B","E01013113","Total",1460,204,123,81,1256,49,256,278,234,62,100,277
"2011","East Riding of Yorkshire 028C","E01013114","Total",1502,129,85,44,1373,26,322,270,264,64,122,305
"2011","East Riding of Yorkshire 028D","E01013116","Total",1519,125,71,54,1394,17,288,375,208,59,139,308
"2011","East Riding of Yorkshire 028E","E01013118","Total",1476,150,111,39,1326,31,324,264,236,87,107,277
"2011","East Riding of Yorkshire 029A","E01013094","Total",1395,112,66,46,1283,23,238,286,232,73,140,291
"2011","East Riding of Yorkshire 029B","E01013095","Total",1449,209,94,115,1240,72,214,219,288,56,130,261
"2011","East Riding of Yorkshire 029C","E01013096","Total",1650,183,82,101,1467,87,204,400,290,46,165,275
"2011","East Riding of Yorkshire 029D","E01013097","Total",1437,197,83,114,1240,106,206,255,268,25,94,286
"2011","East Riding of Yorkshire 029E","E01013102","Total",1417,183,88,95,1234,36,252,295,312,25,66,248
"2011","East Riding of Yorkshire 031A","E01013028","Total",1558,142,62,80,1416,38,236,290,314,94,162,282
"2011","East Riding of Yorkshire 031B","E01013078","Total",1399,135,64,71,1264,36,254,231,268,46,202,227
"2011","East Riding of Yorkshire 031C","E01013081","Total",1485,159,70,89,1326,34,240,264,334,32,151,271
"2011","East Riding of Yorkshire 031D","E01013082","Total",1521,167,91,76,1354,70,306,268,232,65,125,288
"2011","East Riding of Yorkshire 031E","E01013085","Total",1654,170,89,81,1484,81,276,303,272,80,155,317
"2011","East Riding of Yorkshire 032A","E01012970","Total",1460,160,61,99,1300,18,248,344,260,35,108,287
"2011","East Riding of Yorkshire 032C","E01012972","Total",1524,93,64,29,1431,46,268,403,252,94,156,212
"2011","East Riding of Yorkshire 032D","E01012973","Total",2772,263,52,211,2509,115,190,938,588,118,216,344
"2011","East Riding of Yorkshire 032E","E01012974","Total",1508,194,101,93,1314,62,208,379,220,51,123,271
"2011","East Riding of Yorkshire 032F","E01013092","Total",2025,217,119,98,1808,55,268,579,348,139,158,261
"2011","East Riding of Yorkshire 032G","E01033495","Total",1392,147,2,145,1245,84,48,544,310,47,100,112
"2011","East Riding of Yorkshire 032H","E01033496","Total",1722,117,49,68,1605,51,176,598,270,104,162,244
"2011","East Riding of Yorkshire 033A","E01013033","Total",1608,124,59,65,1484,52,152,369,352,106,177,276
"2011","East Riding of Yorkshire 033B","E01013098","Total",2229,221,82,139,2008,112,260,588,410,94,236,308
"2011","East Riding of Yorkshire 033C","E01013099","Total",1341,222,122,100,1119,103,230,210,220,32,139,185
"2011","East Riding of Yorkshire 033D","E01013100","Total",1661,147,72,75,1514,43,304,315,258,79,202,313
"2011","East Riding of Yorkshire 033E","E01013101","Total",1695,179,80,99,1516,53,250,365,334,102,182,230
"2011","East Riding of Yorkshire 034A","E01013008","Total",1474,189,55,134,1285,110,114,359,312,40,125,225
"2011","East Riding of Yorkshire 034B","E01013009","Total",1517,312,154,158,1205,89,198,291,236,69,96,226
"2011","East Riding of Yorkshire 034C","E01013013","Total",1528,183,61,122,1345,103,196,357,274,49,127,239
"2011","East Riding of Yorkshire 034D","E01013014","Total",1521,154,85,69,1367,90,192,316,182,101,218,268
"2011","East Riding of Yorkshire 034E","E01013107","Total",1534,342,225,117,1192,109,190,311,228,54,104,196
"2011","East Riding of Yorkshire 035A","E01013088","Total",1657,138,91,47,1519,29,384,377,246,110,157,216
"2011","East Riding of Yorkshire 035B","E01013089","Total",1621,182,74,108,1439,57,274,404,290,48,140,226
"2011","East Riding of Yorkshire 035C","E01013090","Total",1414,127,86,41,1287,28,236,326,246,36,181,234
"2011","East Riding of Yorkshire 035D","E01013091","Total",1593,170,93,77,1423,52,252,408,218,96,127,270
"2011","East Riding of Yorkshire 035E","E01013093","Total",1487,135,68,67,1352,44,324,279,242,103,128,232
"2011","East Riding of Yorkshire 036A","E01013005","Total",1232,148,69,79,1084,22,218,206,180,77,123,258
"2011","East Riding of Yorkshire 036B","E01013007","Total",1539,192,98,94,1347,65,190,388,260,49,152,243
"2011","East Riding of Yorkshire 036C","E01013011","Total",1512,207,108,99,1305,53,158,393,228,55,146,272
"2011","East Riding of Yorkshire 036D","E01013012","Total",1339,74,29,45,1265,13,176,367,246,40,129,294
"2011","East Riding of Yorkshire 037A","E01012996","Total",1518,143,72,71,1375,44,252,302,278,98,118,283
"2011","East Riding of Yorkshire 037B","E01012998","Total",2155,186,96,90,1969,90,270,540,386,87,187,409
"2011","East Riding of Yorkshire 037C","E01013015","Total",1547,199,62,137,1348,54,142,309,332,98,140,273
"2011","East Riding of Yorkshire 037D","E01013016","Total",1656,137,71,66,1519,22,278,366,372,48,113,320
"2011","East Riding of Yorkshire 038A","E01013003","Total",1402,221,144,77,1181,47,234,267,250,80,79,224
"2011","East Riding of Yorkshire 038B","E01013017","Total",1632,239,125,114,1393,85,222,336,282,68,161,239
"2011","East Riding of Yorkshire 038C","E01013020","Total",1800,142,63,79,1658,58,176,434,370,95,151,374
"2011","East Riding of Yorkshire 038D","E01013076","Total",1476,165,70,95,1311,52,224,328,270,83,157,197
"2011","East Riding of Yorkshire 039A","E01013079","Total",1516,182,94,88,1334,22,316,213,322,57,164,240
"2011","East Riding of Yorkshire 039B","E01013080","Total",1365,162,81,81,1203,182,178,238,190,99,145,171
"2011","East Riding of Yorkshire 039C","E01013083","Total",1409,211,90,121,1198,119,162,144,224,112,228,209
"2011","East Riding of Yorkshire 039D","E01013084","Total",1397,259,159,100,1138,154,230,180,192,78,123,181
"2011","East Riding of Yorkshire 039E","E01013086","Total",1464,198,127,71,1266,74,210,252,228,103,160,239
"2011","East Riding of Yorkshire 039F","E01013087","Total",1362,141,70,71,1221,58,196,239,264,72,158,234
"2011","East Riding of Yorkshire 040A","E01012993","Total",1322,165,102,63,1157,21,252,211,242,66,121,244
"2011","East Riding of Yorkshire 040B","E01012997","Total",1855,313,105,208,1542,129,166,380,282,79,181,325
"2011","East Riding of Yorkshire 040C","E01012999","Total",1740,175,53,122,1565,155,66,374,268,105,241,356
"2011","East Riding of Yorkshire 040D","E01013001","Total",1750,194,97,97,1556,83,270,395,308,113,144,243
"2011","East Riding of Yorkshire 040E","E01013074","Total",1593,146,55,91,1447,50,274,300,310,68,130,315
"2011","East Riding of Yorkshire 041A","E01012994","Total",1755,239,139,100,1516,73,236,385,288,121,120,293
"2011","East Riding of Yorkshire 041B","E01012995","Total",1923,200,85,115,1723,196,160,398,220,128,284,337
"2011","East Riding of Yorkshire 041C","E01013000","Total",1801,425,94,331,1376,171,100,280,332,67,176,250
"2011","East Riding of Yorkshire 041D","E01013002","Total",1619,176,73,103,1443,176,126,332,294,106,154,255
"2011","East Riding of Yorkshire 041E","E01013004","Total",1672,156,73,83,1516,181,130,335,264,106,206,294
"2011","East Riding of Yorkshire 042A","E01013072","Total",1664,175,87,88,1489,51,222,446,302,116,129,223
"2011","East Riding of Yorkshire 042B","E01013073","Total",1581,167,59,108,1414,55,230,337,280,56,160,296
"2011","East Riding of Yorkshire 042C","E01013075","Total",1321,107,43,64,1214,38,190,267,276,68,112,263
"2011","East Riding of Yorkshire 042D","E01013077","Total",1947,199,103,96,1748,62,240,491,354,77,181,343
"2011","East Riding of Yorkshire 043A","E01013006","Total",1530,165,52,113,1365,119,114,338,256,74,183,281
"2011","East Riding of Yorkshire 043B","E01013010","Total",1471,160,78,82,1311,58,214,317,240,56,139,287
"2011","East Riding of Yorkshire 043C","E01013103","Total",1419,140,76,64,1279,35,268,269,270,65,120,252
"2011","East Riding of Yorkshire 043D","E01013104","Total",1243,151,78,73,1092,55,246,246,246,20,84,195
"2011","East Riding of Yorkshire 043E","E01013106","Total",1198,122,70,52,1076,87,126,232,158,104,142,227
"2011","East Riding of Yorkshire 043F","E01032596","Total",1420,164,84,80,1256,63,164,303,224,55,161,286
"2011","East Riding of Yorkshire 044A","E01012975","Total",1480,161,84,77,1319,44,272,273,254,32,110,334
"2011","East Riding of Yorkshire 044B","E01012977","Total",2551,237,90,147,2314,98,260,709,384,149,266,448
"2011","East Riding of Yorkshire 044C","E01012984","Total",1679,161,78,83,1518,30,272,408,290,77,120,321
"2011","East Riding of Yorkshire 044D","E01012985","Total",1678,209,121,88,1469,65,298,373,268,89,152,224
"2011","East Riding of Yorkshire 045A","E01012976","Total",1457,157,83,74,1300,89,182,234,250,108,155,282
"2011","East Riding of Yorkshire 045B","E01012979","Total",1508,261,120,141,1247,58,268,272,266,59,97,227
"2011","East Riding of Yorkshire 045C","E01012980","Total",1725,326,156,170,1399,117,184,338,316,93,94,257
"2011","East Riding of Yorkshire 045D","E01012982","Total",1652,249,131,118,1403,78,260,296,324,87,121,237
"2011","Kingston upon Hull 001A","E01012779","Total",1283,123,18,105,1160,181,44,257,154,169,169,186
"2011","Kingston upon Hull 001B","E01012780","Total",1560,149,28,121,1411,249,70,312,166,162,184,268
"2011","Kingston upon Hull 001C","E01012781","Total",1218,142,53,89,1076,173,66,225,132,156,138,186
"2011","Kingston upon Hull 001E","E01012832","Total",1350,143,19,124,1207,94,52,411,254,59,135,202
"2011","Kingston upon Hull 001F","E01033105","Total",1448,97,3,94,1351,55,42,411,360,99,133,251
"2011","Kingston upon Hull 001G","E01033106","Total",1150,150,5,145,1000,40,4,340,288,58,88,182
"2011","Kingston upon Hull 001H","E01033107","Total",1314,73,6,67,1241,53,22,398,328,73,135,232
"2011","Kingston upon Hull 001I","E01033108","Total",1451,111,8,103,1340,89,34,441,310,91,180,195
"2011","Kingston upon Hull 002A","E01012782","Total",1411,206,95,111,1205,172,84,236,136,133,270,174
"2011","Kingston upon Hull 002B","E01012785","Total",1328,175,60,115,1153,252,94,190,158,128,160,171
"2011","Kingston upon Hull 002C","E01012786","Total",1222,138,72,66,1084,78,148,204,166,59,154,275
"2011","Kingston upon Hull 002D","E01012787","Total",1517,245,75,170,1272,228,110,223,204,95,176,236
"2011","Kingston upon Hull 002E","E01012788","Total",1472,146,53,93,1326,187,136,234,150,121,205,293
"2011","Kingston upon Hull 002F","E01012789","Total",1343,125,40,85,1218,173,138,231,182,100,158,236
"2011","Kingston upon Hull 003A","E01012875","Total",1495,256,81,175,1239,237,72,233,164,169,197,167
"2011","Kingston upon Hull 003B","E01012876","Total",1706,201,80,121,1505,300,166,226,172,191,198,252
"2011","Kingston upon Hull 003C","E01012877","Total",1434,91,39,52,1343,215,80,235,158,214,213,228
"2011","Kingston upon Hull 003D","E01012878","Total",1574,179,62,117,1395,202,150,286,216,97,186,258
"2011","Kingston upon Hull 003E","E01012879","Total",1431,265,70,195,1166,254,72,232,154,129,124,201
"2011","Kingston upon Hull 004A","E01012778","Total",1480,108,33,75,1372,183,74,260,164,172,234,285
"2011","Kingston upon Hull 004B","E01012783","Total",1214,195,49,146,1019,186,86,184,152,116,178,117
"2011","Kingston upon Hull 004C","E01012784","Total",2108,161,37,124,1947,228,90,547,340,171,300,271
"2011","Kingston upon Hull 004D","E01012790","Total",1256,195,100,95,1061,103,166,161,180,57,163,231
"2011","Kingston upon Hull 004E","E01012906","Total",1611,217,74,143,1394,276,112,248,200,99,178,281
"2011","Kingston upon Hull 004F","E01012908","Total",1087,158,59,99,929,134,106,235,172,32,91,159
"2011","Kingston upon Hull 005A","E01012764","Total",1133,177,74,103,956,33,230,207,242,32,49,163
"2011","Kingston upon Hull 005B","E01012765","Total",1503,169,57,112,1334,70,170,321,248,96,163,266
"2011","Kingston upon Hull 005C","E01012768","Total",1359,258,93,165,1101,63,218,214,332,10,56,208
"2011","Kingston upon Hull 005D","E01012769","Total",1334,239,125,114,1095,43,404,199,196,26,52,175
"2011","Kingston upon Hull 006A","E01012829","Total",1593,190,81,109,1403,48,186,325,322,67,144,311
"2011","Kingston upon Hull 006B","E01012830","Total",1468,126,56,70,1342,61,178,297,308,45,155,298
"2011","Kingston upon Hull 006C","E01012905","Total",1339,175,68,107,1164,174,148,183,182,69,163,245
"2011","Kingston upon Hull 006D","E01012910","Total",1298,69,19,50,1229,82,76,308,208,72,166,317
"2011","Kingston upon Hull 006E","E01012912","Total",1837,165,87,78,1672,90,276,393,294,63,204,352
"2011","Kingston upon Hull 007A","E01012822","Total",1475,211,122,89,1264,62,212,360,184,52,109,285
"2011","Kingston upon Hull 007B","E01012904","Total",1377,240,101,139,1137,68,152,178,286,36,177,240
"2011","Kingston upon Hull 007C","E01012907","Total",1397,168,56,112,1229,126,132,286,228,42,123,292
"2011","Kingston upon Hull 007D","E01012909","Total",1303,170,37,133,1133,50,106,319,340,31,92,195
"2011","Kingston upon Hull 007E","E01012911","Total",1214,113,27,86,1101,62,106,260,244,20,123,286
"2011","Kingston upon Hull 008A","E01012873","Total",1542,187,66,121,1355,290,114,276,146,111,158,260
"2011","Kingston upon Hull 008B","E01012874","Total",1580,210,86,124,1370,213,122,254,178,180,222,201
"2011","Kingston upon Hull 008C","E01012880","Total",1720,199,78,121,1521,287,104,317,208,144,196,265
"2011","Kingston upon Hull 008D","E01012881","Total",1520,217,78,139,1303,208,112,275,152,76,229,251
"2011","Kingston upon Hull 008E","E01012915","Total",1483,200,106,94,1283,161,142,271,204,90,170,245
"2011","Kingston upon Hull 008F","E01012917","Total",1621,339,170,169,1282,122,188,275,212,127,147,211
"2011","Kingston upon Hull 008G","E01012918","Total",1552,142,43,99,1410,180,110,291,234,108,238,249
"2011","Kingston upon Hull 009A","E01012833","Total",1494,197,105,92,1297,166,132,308,208,85,155,243
"2011","Kingston upon Hull 009B","E01012835","Total",1154,142,89,53,1012,34,232,130,234,45,109,228
"2011","Kingston upon Hull 009C","E01012836","Total",1487,389,143,246,1098,100,160,236,222,65,127,188
"2011","Kingston upon Hull 009D","E01012839","Total",1297,163,96,67,1134,101,160,250,176,67,126,254
"2011","Kingston upon Hull 009E","E01012840","Total",1490,212,80,132,1278,181,138,284,194,84,149,248
"2011","Kingston upon Hull 010A","E01012824","Total",1590,185,78,107,1405,76,154,365,294,56,157,303
"2011","Kingston upon Hull 010B","E01012825","Total",1499,232,121,111,1267,52,212,229,222,76,155,321
"2011","Kingston upon Hull 010C","E01012834","Total",1578,187,81,106,1391,248,144,317,212,126,163,181
"2011","Kingston upon Hull 010D","E01012837","Total",1571,290,149,141,1281,147,182,266,218,45,181,242
"2011","Kingston upon Hull 010E","E01012838","Total",1510,162,71,91,1348,242,106,318,204,110,196,172
"2011","Kingston upon Hull 011A","E01012821","Total",1213,280,189,91,933,55,136,180,200,55,119,188
"2011","Kingston upon Hull 011B","E01012823","Total",1433,193,102,91,1240,206,162,197,170,123,189,193
"2011","Kingston upon Hull 011C","E01012826","Total",1510,270,164,106,1240,106,202,308,224,79,130,191
"2011","Kingston upon Hull 011D","E01012827","Total",1436,355,195,160,1081,44,202,199,246,5,115,270
"2011","Kingston upon Hull 011E","E01012828","Total",1539,211,107,104,1328,93,218,313,220,56,147,281
"2011","Kingston upon Hull 012A","E01012766","Total",1433,110,31,79,1323,45,104,296,294,57,180,347
"2011","Kingston upon Hull 012B","E01012767","Total",1689,155,31,124,1534,25,92,189,230,72,141,785
"2011","Kingston upon Hull 012C","E01012914","Total",1734,231,26,205,1503,31,36,70,142,5,139,1080
"2011","Kingston upon Hull 012D","E01012916","Total",1531,244,91,153,1287,67,168,310,232,69,79,362
"2011","Kingston upon Hull 013A","E01012812","Total",1449,86,48,38,1363,31,150,380,156,63,216,367
"2011","Kingston upon Hull 013B","E01012813","Total",1777,127,58,69,1650,64,140,419,304,76,218,429
"2011","Kingston upon Hull 013C","E01012814","Total",1540,135,82,53,1405,49,210,391,228,50,137,340
"2011","Kingston upon Hull 013D","E01012815","Total",1598,172,46,126,1426,85,128,443,332,56,133,249
"2011","Kingston upon Hull 013E","E01012818","Total",1250,123,58,65,1127,49,156,256,168,40,152,306
"2011","Kingston upon Hull 014A","E01012791","Total",1672,137,63,74,1535,46,210,333,284,98,164,400
"2011","Kingston upon Hull 014B","E01012792","Total",1590,150,78,72,1440,67,186,396,272,97,131,291
"2011","Kingston upon Hull 014C","E01012793","Total",1412,196,128,68,1216,32,198,170,252,92,147,325
"2011","Kingston upon Hull 014D","E01012794","Total",1588,149,51,98,1439,55,120,426,278,42,163,355
"2011","Kingston upon Hull 014E","E01012913","Total",1979,220,62,158,1759,208,140,426,352,124,199,310
"2011","Kingston upon Hull 015A","E01012761","Total",1683,469,124,345,1214,69,100,143,286,64,164,388
"2011","Kingston upon Hull 015B","E01012868","Total",1718,273,89,184,1445,36,50,135,214,30,111,869
"2011","Kingston upon Hull 015C","E01012869","Total",1765,231,68,163,1534,67,50,119,244,44,146,864
"2011","Kingston upon Hull 015D","E01012871","Total",1829,228,26,202,1601,118,62,252,314,77,206,572
"2011","Kingston upon Hull 015E","E01012872","Total",1851,265,53,212,1586,47,28,137,174,54,93,1053
"2011","Kingston upon Hull 016A","E01012804","Total",1467,221,54,167,1246,56,146,315,336,57,79,257
"2011","Kingston upon Hull 016B","E01012806","Total",1461,334,73,261,1127,146,72,326,278,42,97,166
"2011","Kingston upon Hull 016C","E01012807","Total",1346,189,80,109,1157,47,178,300,224,48,111,249
"2011","Kingston upon Hull 016D","E01012817","Total",1370,219,40,179,1151,99,102,330,296,25,72,227
"2011","Kingston upon Hull 016E","E01012819","Total",1435,161,57,104,1274,92,130,279,324,78,109,262
"2011","Kingston upon Hull 017A","E01012841","Total",1603,197,78,119,1406,279,96,336,188,135,205,167
"2011","Kingston upon Hull 017B","E01012844","Total",1333,228,84,144,1105,188,100,225,178,98,126,190
"2011","Kingston upon Hull 017C","E01012849","Total",1496,270,125,145,1226,152,168,231,234,70,150,221
"2011","Kingston upon Hull 017D","E01012895","Total",1501,175,68,107,1326,225,108,227,132,193,199,242
"2011","Kingston upon Hull 017E","E01012897","Total",1551,262,104,158,1289,273,114,269,166,145,161,161
"2011","Kingston upon Hull 017F","E01012898","Total",1380,292,206,86,1088,88,212,184,142,96,130,236
"2011","Kingston upon Hull 018A","E01012758","Total",1555,243,49,194,1312,41,108,362,332,73,111,285
"2011","Kingston upon Hull 018B","E01012762","Total",1570,181,33,148,1389,73,82,283,298,32,191,430
"2011","Kingston upon Hull 018C","E01012763","Total",2032,546,41,505,1486,78,64,217,320,123,230,454
"2011","Kingston upon Hull 018D","E01012866","Total",1576,231,52,179,1345,118,56,217,324,52,94,484
"2011","Kingston upon Hull 018E","E01012870","Total",1683,200,31,169,1483,68,34,193,282,40,88,778
"2011","Kingston upon Hull 019A","E01012774","Total",1549,215,80,135,1334,103,134,329,240,83,170,275
"2011","Kingston upon Hull 019B","E01012795","Total",1937,315,165,150,1622,139,238,335,258,110,235,307
"2011","Kingston upon Hull 019C","E01012797","Total",1386,231,127,104,1155,74,170,355,216,60,105,175
"2011","Kingston upon Hull 019D","E01012798","Total",1543,399,246,153,1144,108,242,217,236,68,101,172
"2011","Kingston upon Hull 019E","E01012801","Total",1456,202,85,117,1254,98,170,283,300,79,113,211
"2011","Kingston upon Hull 020A","E01012816","Total",1372,166,82,84,1206,59,128,268,242,61,151,297
"2011","Kingston upon Hull 020B","E01012848","Total",1180,302,40,262,878,46,74,233,266,16,75,168
"2011","Kingston upon Hull 020C","E01012894","Total",1562,160,60,100,1402,120,150,251,208,96,213,364
"2011","Kingston upon Hull 020D","E01012896","Total",2102,177,45,132,1925,117,120,547,330,99,333,379
"2011","Kingston upon Hull 020E","E01012901","Total",1427,192,82,110,1235,57,130,340,234,78,125,271
"2011","Kingston upon Hull 021A","E01012842","Total",1523,160,60,100,1363,178,118,292,168,174,168,265
"2011","Kingston upon Hull 021B","E01012843","Total",1449,240,75,165,1209,193,108,288,168,151,160,141
"2011","Kingston upon Hull 021C","E01012845","Total",1572,183,86,97,1389,235,108,254,166,128,270,228
"2011","Kingston upon Hull 021D","E01012846","Total",1437,212,96,116,1225,167,142,260,186,74,159,237
"2011","Kingston upon Hull 021E","E01012847","Total",1298,146,60,86,1152,199,100,208,140,132,170,203
"2011","Kingston upon Hull 022A","E01012820","Total",1414,166,36,130,1248,77,96,297,182,131,180,285
"2011","Kingston upon Hull 022B","E01012899","Total",1483,203,52,151,1280,97,120,335,320,57,155,196
"2011","Kingston upon Hull 022C","E01012900","Total",1571,293,49,244,1278,177,98,319,328,69,136,151
"2011","Kingston upon Hull 022D","E01012902","Total",1586,137,68,69,1449,67,138,306,256,103,191,388
"2011","Kingston upon Hull 022E","E01012903","Total",1676,323,68,255,1353,134,122,340,364,76,88,229
"2011","Kingston upon Hull 023A","E01012796","Total",1310,163,81,82,1147,48,192,314,208,50,91,244
"2011","Kingston upon Hull 023B","E01012799","Total",1253,204,50,154,1049,97,96,372,304,27,39,114
"2011","Kingston upon Hull 023C","E01012800","Total",1499,309,110,199,1190,97,120,297,326,40,108,202
"2011","Kingston upon Hull 023D","E01012802","Total",1403,204,71,133,1199,83,140,339,320,33,89,195
"2011","Kingston upon Hull 023E","E01012803","Total",1440,216,57,159,1224,131,170,329,260,46,93,195
"2011","Kingston upon Hull 024A","E01012850","Total",1917,546,63,483,1371,126,62,282,286,155,185,275
"2011","Kingston upon Hull 024B","E01012852","Total",1684,359,75,284,1325,135,124,200,254,50,276,286
"2011","Kingston upon Hull 024C","E01012856","Total",1599,412,122,290,1187,142,158,243,194,105,156,189
"2011","Kingston upon Hull 024D","E01012857","Total",1580,362,105,257,1218,133,98,223,230,109,188,237
"2011","Kingston upon Hull 024E","E01012867","Total",1577,331,77,254,1246,140,60,296,234,143,144,229
"2011","Kingston upon Hull 025A","E01012756","Total",1532,266,62,204,1266,83,106,284,334,61,126,272
"2011","Kingston upon Hull 025B","E01012757","Total",1505,264,38,226,1241,95,68,265,298,76,112,327
"2011","Kingston upon Hull 025C","E01012759","Total",1649,312,79,233,1337,121,114,293,360,70,131,248
"2011","Kingston upon Hull 025D","E01012760","Total",1510,272,57,215,1238,132,76,294,362,68,112,194
"2011","Kingston upon Hull 025E","E01012862","Total",1307,245,90,155,1062,88,124,181,176,92,174,227
"2011","Kingston upon Hull 026A","E01012805","Total",1369,299,64,235,1070,114,84,262,226,58,104,222
"2011","Kingston upon Hull 026B","E01012808","Total",1660,440,148,292,1220,143,128,216,264,56,146,267
"2011","Kingston upon Hull 026C","E01012809","Total",1794,429,74,355,1365,172,76,320,364,55,155,223
"2011","Kingston upon Hull 026D","E01012810","Total",1880,409,128,281,1471,83,172,542,372,65,82,155
"2011","Kingston upon Hull 026E","E01012811","Total",1633,392,52,340,1241,99,96,393,374,71,76,132
"2011","Kingston upon Hull 027A","E01012773","Total",1703,223,78,145,1480,106,142,459,328,85,106,254
"2011","Kingston upon Hull 027B","E01012776","Total",1453,194,67,127,1259,100,128,356,290,31,97,257
"2011","Kingston upon Hull 027C","E01012863","Total",1418,171,53,118,1247,139,104,314,250,46,134,260
"2011","Kingston upon Hull 027D","E01012864","Total",1679,297,40,257,1382,124,54,311,246,135,209,303
"2011","Kingston upon Hull 027E","E01012865","Total",1351,222,51,171,1129,95,106,283,224,121,97,203
"2011","Kingston upon Hull 028A","E01012770","Total",1499,103,52,51,1396,65,190,384,256,62,118,321
"2011","Kingston upon Hull 028B","E01012771","Total",1536,160,89,71,1376,64,198,328,240,73,151,322
"2011","Kingston upon Hull 028C","E01012772","Total",1466,170,53,117,1296,36,156,362,244,68,176,254
"2011","Kingston upon Hull 028D","E01012775","Total",1452,225,99,126,1227,105,172,292,220,61,155,222
"2011","Kingston upon Hull 028E","E01012777","Total",1393,360,256,104,1033,74,194,218,176,39,83,249
"2011","Kingston upon Hull 029A","E01012851","Total",2218,832,151,681,1386,119,118,251,546,53,80,219
"2011","Kingston upon Hull 029C","E01012854","Total",2026,786,111,675,1240,142,116,331,348,66,123,114
"2011","Kingston upon Hull 029D","E01012855","Total",1739,527,128,399,1212,114,118,283,254,92,190,161
"2011","Kingston upon Hull 029E","E01033104","Total",1220,669,106,563,551,8,36,72,344,15,10,66
"2011","Kingston upon Hull 029F","E01033109","Total",1258,547,73,474,711,78,32,106,340,25,34,96
"2011","Kingston upon Hull 030A","E01012859","Total",1498,261,47,214,1237,172,40,256,208,116,206,239
"2011","Kingston upon Hull 030B","E01012889","Total",1358,282,101,181,1076,131,130,224,188,117,110,176
"2011","Kingston upon Hull 030C","E01012891","Total",2111,563,49,514,1548,142,48,357,362,113,217,309
"2011","Kingston upon Hull 030D","E01012892","Total",1894,320,46,274,1574,171,76,370,282,157,235,283
"2011","Kingston upon Hull 030E","E01012893","Total",1457,303,74,229,1154,161,108,215,192,99,140,239
"2011","Kingston upon Hull 031A","E01012858","Total",1752,203,85,118,1549,175,158,362,250,68,212,324
"2011","Kingston upon Hull 031B","E01012860","Total",1622,151,52,99,1471,116,112,329,238,125,149,402
"2011","Kingston upon Hull 031D","E01012886","Total",1584,219,86,133,1365,153,156,283,254,61,170,288
"2011","Kingston upon Hull 031E","E01012888","Total",1488,288,56,232,1200,163,58,312,300,33,61,273
"2011","Kingston upon Hull 031G","E01033110","Total",1502,308,120,188,1194,130,148,194,234,118,143,227
"2011","Kingston upon Hull 033A","E01012882","Total",1577,195,70,125,1382,76,152,349,312,67,122,304
"2011","Kingston upon Hull 033B","E01012883","Total",1462,365,245,120,1097,37,300,186,314,38,69,153
"2011","Kingston upon Hull 033C","E01012884","Total",1787,305,165,140,1482,176,214,302,228,90,190,282
"2011","Kingston upon Hull 033D","E01012887","Total",1460,307,86,221,1153,189,156,173,164,93,140,238
"2011","Kingston upon Hull 033E","E01032595","Total",1802,245,114,131,1557,155,228,282,212,120,212,348
"2011","North East Lincolnshire 001A","E01013174","Total",1462,102,13,89,1360,271,44,347,180,198,137,183
"2011","North East Lincolnshire 001B","E01013175","Total",1380,162,83,79,1218,38,182,237,294,50,172,245
"2011","North East Lincolnshire 001C","E01013176","Total",1403,160,65,95,1243,88,178,264,270,91,141,211
"2011","North East Lincolnshire 001D","E01013177","Total",1572,381,135,246,1191,162,152,269,206,91,120,191
"2011","North East Lincolnshire 001E","E01013178","Total",1472,156,93,63,1316,70,274,277,254,61,136,244
"2011","North East Lincolnshire 001F","E01013179","Total",1469,181,89,92,1288,94,210,234,224,102,166,258
"2011","North East Lincolnshire 001G","E01013180","Total",1427,168,96,72,1259,56,180,217,290,52,198,266
"2011","North East Lincolnshire 002A","E01013136","Total",1462,521,151,370,941,153,102,142,282,46,75,141
"2011","North East Lincolnshire 002B","E01013137","Total",1476,665,212,453,811,125,120,118,266,39,36,107
"2011","North East Lincolnshire 002C","E01013139","Total",1217,358,123,235,859,161,80,150,148,100,102,118
"2011","North East Lincolnshire 002D","E01013142","Total",1702,290,69,221,1412,244,82,324,248,138,180,196
"2011","North East Lincolnshire 003A","E01013218","Total",1407,206,49,157,1201,189,78,300,236,85,99,214
"2011","North East Lincolnshire 003B","E01013219","Total",1407,211,79,132,1196,191,116,236,228,74,134,217
"2011","North East Lincolnshire 003C","E01013220","Total",1636,280,78,202,1356,224,98,330,266,125,78,235
"2011","North East Lincolnshire 003D","E01013221","Total",1744,488,132,356,1256,180,118,250,318,89,115,186
"2011","North East Lincolnshire 003E","E01013222","Total",1560,239,63,176,1321,180,96,264,282,106,155,238
"2011","North East Lincolnshire 004A","E01013144","Total",1455,417,150,267,1038,186,136,206,204,90,66,150
"2011","North East Lincolnshire 004B","E01013145","Total",1275,82,37,45,1193,37,172,227,258,64,140,295
"2011","North East Lincolnshire 004C","E01013146","Total",1742,163,53,110,1579,142,172,397,308,138,155,267
"2011","North East Lincolnshire 004D","E01013148","Total",1439,112,37,75,1327,48,156,224,298,49,217,335
"2011","North East Lincolnshire 005A","E01013195","Total",1447,202,79,123,1245,176,98,298,182,131,140,220
"2011","North East Lincolnshire 005B","E01013196","Total",1415,145,47,98,1270,202,78,269,202,104,171,244
"2011","North East Lincolnshire 005C","E01013201","Total",1540,225,42,183,1315,239,82,255,252,109,146,232
"2011","North East Lincolnshire 005D","E01013202","Total",1543,171,43,128,1372,190,112,327,202,156,150,235
"2011","North East Lincolnshire 005E","E01013203","Total",1653,274,53,221,1379,215,72,293,256,118,177,248
"2011","North East Lincolnshire 006A","E01013138","Total",1382,221,42,179,1161,238,64,240,232,100,119,168
"2011","North East Lincolnshire 006B","E01013140","Total",1555,192,44,148,1363,188,76,281,270,132,169,247
"2011","North East Lincolnshire 006C","E01013141","Total",1628,166,51,115,1462,181,112,336,224,121,221,267
"2011","North East Lincolnshire 006D","E01013143","Total",1376,164,55,109,1212,176,84,277,216,129,106,224
"2011","North East Lincolnshire 007A","E01013173","Total",1194,128,72,56,1066,46,182,234,288,38,100,178
"2011","North East Lincolnshire 007B","E01013223","Total",2936,222,116,106,2714,81,372,746,490,209,341,475
"2011","North East Lincolnshire 007C","E01013224","Total",1857,195,97,98,1662,90,252,419,314,93,214,280
"2011","North East Lincolnshire 007D","E01013226","Total",1531,129,79,50,1402,61,234,327,286,76,151,267
"2011","North East Lincolnshire 008A","E01013187","Total",1307,474,224,250,833,56,158,120,228,46,85,140
"2011","North East Lincolnshire 008B","E01013188","Total",1568,181,77,104,1387,40,196,312,324,20,133,362
"2011","North East Lincolnshire 008C","E01013231","Total",1615,198,81,117,1417,172,144,334,300,92,123,252
"2011","North East Lincolnshire 008D","E01013233","Total",1444,168,42,126,1276,98,120,291,276,93,126,272
"2011","North East Lincolnshire 009A","E01013147","Total",1406,182,88,94,1224,147,166,229,208,91,155,228
"2011","North East Lincolnshire 009D","E01013234","Total",1379,243,126,117,1136,94,142,303,268,55,120,154
"2011","North East Lincolnshire 009E","E01033414","Total",2253,230,86,144,2023,130,310,406,460,119,171,427
"2011","North East Lincolnshire 010A","E01013128","Total",1406,194,62,132,1212,126,98,271,264,63,162,228
"2011","North East Lincolnshire 010B","E01013198","Total",1419,166,64,102,1253,111,128,224,300,98,135,257
"2011","North East Lincolnshire 010C","E01013199","Total",1081,214,30,184,867,171,60,158,240,27,86,125
"2011","North East Lincolnshire 010D","E01013200","Total",1279,111,52,59,1168,74,138,269,214,53,151,269
"2011","North East Lincolnshire 011A","E01013159","Total",1489,165,39,126,1324,197,82,284,242,150,105,264
"2011","North East Lincolnshire 011B","E01013161","Total",1429,160,33,127,1269,192,60,273,214,153,186,191
"2011","North East Lincolnshire 011C","E01013162","Total",1602,245,36,209,1357,121,94,277,188,170,222,285
"2011","North East Lincolnshire 011D","E01013165","Total",1346,220,47,173,1126,143,60,221,232,125,125,220
"2011","North East Lincolnshire 012A","E01013158","Total",1465,170,76,94,1295,116,130,258,198,93,188,312
"2011","North East Lincolnshire 012B","E01013160","Total",1483,180,76,104,1303,77,182,280,316,57,122,269
"2011","North East Lincolnshire 012C","E01013163","Total",1316,172,93,79,1144,34,274,191,242,45,97,261
"2011","North East Lincolnshire 012D","E01013164","Total",1745,200,70,130,1545,179,136,380,254,124,171,301
"2011","North East Lincolnshire 012E","E01013197","Total",1285,127,61,66,1158,88,136,267,198,70,119,280
"2011","North East Lincolnshire 013A","E01013149","Total",1152,96,41,55,1056,35,194,224,236,32,133,202
"2011","North East Lincolnshire 013B","E01013150","Total",1324,95,35,60,1229,41,156,230,268,60,193,281
"2011","North East Lincolnshire 013C","E01013227","Total",1618,240,125,115,1378,83,268,295,260,57,122,293
"2011","North East Lincolnshire 013D","E01013228","Total",1573,198,31,167,1375,74,126,393,334,68,96,284
"2011","North East Lincolnshire 013E","E01013229","Total",1494,136,52,84,1358,195,92,288,196,110,192,285
"2011","North East Lincolnshire 014A","E01013131","Total",1510,345,149,196,1165,170,126,192,300,105,87,185
"2011","North East Lincolnshire 014B","E01013132","Total",1465,191,108,83,1274,64,178,303,232,78,128,291
"2011","North East Lincolnshire 014C","E01013133","Total",1528,322,108,214,1206,133,138,201,322,62,140,210
"2011","North East Lincolnshire 014D","E01013134","Total",1449,238,163,75,1211,90,264,207,244,56,144,206
"2011","North East Lincolnshire 015A","E01013206","Total",1351,195,72,123,1156,135,134,224,184,79,142,258
"2011","North East Lincolnshire 015B","E01013207","Total",1345,174,85,89,1171,69,228,202,248,43,122,259
"2011","North East Lincolnshire 015C","E01013211","Total",1512,164,84,80,1348,93,188,276,284,117,140,250
"2011","North East Lincolnshire 015D","E01013212","Total",1351,240,78,162,1111,258,66,227,144,106,152,158
"2011","North East Lincolnshire 016A","E01013181","Total",1541,166,34,132,1375,208,68,299,242,160,150,248
"2011","North East Lincolnshire 016B","E01013182","Total",1383,174,104,70,1209,24,288,246,280,42,81,248
"2011","North East Lincolnshire 016C","E01013183","Total",1548,150,69,81,1398,89,188,324,260,97,134,306
"2011","North East Lincolnshire 016D","E01013184","Total",1449,223,66,157,1226,92,132,226,284,104,137,251
"2011","North East Lincolnshire 016E","E01013185","Total",1592,170,78,92,1422,77,150,348,278,119,123,327
"2011","North East Lincolnshire 016F","E01013186","Total",1297,99,53,46,1198,45,128,308,230,72,156,259
"2011","North East Lincolnshire 017A","E01013129","Total",1490,326,68,258,1164,116,94,243,272,87,182,170
"2011","North East Lincolnshire 017B","E01013151","Total",1260,107,78,29,1153,21,226,275,210,25,141,255
"2011","North East Lincolnshire 017C","E01013152","Total",1454,169,115,54,1285,28,244,351,220,58,125,259
"2011","North East Lincolnshire 017D","E01013155","Total",1393,181,96,85,1212,42,256,276,248,76,101,213
"2011","North East Lincolnshire 018A","E01013130","Total",1375,237,134,103,1138,68,162,176,198,87,171,276
"2011","North East Lincolnshire 018B","E01013135","Total",1439,319,201,118,1120,44,326,166,230,70,89,195
"2011","North East Lincolnshire 018C","E01013154","Total",1396,134,78,56,1262,35,342,254,256,30,102,243
"2011","North East Lincolnshire 018D","E01013156","Total",1250,266,207,59,984,35,330,155,212,32,67,153
"2011","North East Lincolnshire 019A","E01013204","Total",1398,171,104,67,1227,138,138,205,218,103,163,262
"2011","North East Lincolnshire 019B","E01013205","Total",1337,133,44,89,1204,276,62,185,170,158,139,214
"2011","North East Lincolnshire 019C","E01013208","Total",1418,113,41,72,1305,304,70,225,162,171,199,174
"2011","North East Lincolnshire 019D","E01013209","Total",1483,262,92,170,1221,217,120,242,204,139,97,202
"2011","North East Lincolnshire 019E","E01013210","Total",1446,118,44,74,1328,291,80,254,152,186,162,203
"2011","North East Lincolnshire 020A","E01013153","Total",1332,184,120,64,1148,40,360,181,248,33,65,221
"2011","North East Lincolnshire 020B","E01013157","Total",1847,151,69,82,1696,88,214,527,314,78,185,290
"2011","North East Lincolnshire 020C","E01013166","Total",1552,197,129,68,1355,37,318,251,230,63,179,277
"2011","North East Lincolnshire 020D","E01013167","Total",1748,247,128,119,1501,15,372,355,306,37,188,228
"2011","North East Lincolnshire 020E","E01013169","Total",1049,192,140,52,857,25,264,139,170,41,69,149
"2011","North East Lincolnshire 021A","E01013189","Total",1434,191,127,64,1243,46,244,289,238,54,152,220
"2011","North East Lincolnshire 021B","E01013190","Total",2822,214,85,129,2608,160,244,706,454,216,346,482
"2011","North East Lincolnshire 021C","E01013191","Total",1540,144,93,51,1396,44,284,309,228,86,137,308
"2011","North East Lincolnshire 021D","E01013192","Total",1485,358,175,183,1127,95,174,255,166,91,155,191
"2011","North East Lincolnshire 021E","E01013194","Total",1461,205,138,67,1256,56,324,260,236,75,83,222
"2011","North East Lincolnshire 022A","E01013168","Total",1618,170,105,65,1448,12,348,329,268,61,117,313
"2011","North East Lincolnshire 022B","E01013170","Total",1508,178,118,60,1330,75,266,308,248,39,142,252
"2011","North East Lincolnshire 022C","E01013171","Total",1776,89,37,52,1687,33,166,523,230,149,246,340
"2011","North East Lincolnshire 022D","E01013172","Total",1467,219,131,88,1248,51,308,226,214,54,102,293
"2011","North East Lincolnshire 022E","E01013193","Total",1576,216,147,69,1360,21,320,262,296,74,105,282
"2011","North East Lincolnshire 023A","E01013213","Total",1163,280,193,87,883,82,214,161,194,42,57,133
"2011","North East Lincolnshire 023B","E01013214","Total",1441,151,92,59,1290,29,324,183,270,79,146,259
"2011","North East Lincolnshire 023C","E01013215","Total",1518,134,71,63,1384,25,296,283,218,124,144,294
"2011","North East Lincolnshire 023D","E01013216","Total",1301,82,36,46,1219,63,154,339,250,50,139,224
"2011","North East Lincolnshire 023E","E01013217","Total",1438,170,88,82,1268,30,224,264,248,74,128,300
"2011","North East Lincolnshire 023F","E01013225","Total",1008,93,41,52,915,27,182,137,206,70,59,234
"2011","North Lincolnshire 001A","E01013254","Total",1679,305,134,171,1374,150,218,306,274,73,94,259
"2011","North Lincolnshire 001B","E01013255","Total",1634,333,132,201,1301,100,240,248,314,38,107,254
"2011","North Lincolnshire 001C","E01013256","Total",2460,260,96,164,2200,151,240,652,408,126,210,413
"2011","North Lincolnshire 001D","E01013257","Total",1788,138,67,71,1650,64,304,309,382,112,151,328
"2011","North Lincolnshire 001E","E01013258","Total",1699,209,107,102,1490,144,166,340,260,137,190,253
"2011","North Lincolnshire 001F","E01013259","Total",1703,159,60,99,1544,137,214,375,258,179,156,225
"2011","North Lincolnshire 002A","E01013303","Total",1292,175,77,98,1117,51,172,224,254,62,131,223
"2011","North Lincolnshire 002B","E01013304","Total",1614,134,62,72,1480,51,220,354,306,111,125,313
"2011","North Lincolnshire 002C","E01013305","Total",1596,132,51,81,1464,44,184,368,350,92,140,286
"2011","North Lincolnshire 002D","E01013307","Total",1704,200,96,104,1504,71,238,329,360,101,160,245
"2011","North Lincolnshire 003A","E01013288","Total",1579,136,77,59,1443,57,214,358,282,101,137,294
"2011","North Lincolnshire 003B","E01013291","Total",1591,147,84,63,1444,162,122,325,194,203,196,242
"2011","North Lincolnshire 003C","E01013292","Total",1708,193,96,97,1515,92,258,275,352,60,211,267
"2011","North Lincolnshire 003D","E01013294","Total",1552,155,78,77,1397,80,238,267,326,41,178,267
"2011","North Lincolnshire 004A","E01013270","Total",1914,229,98,131,1685,93,230,440,338,91,191,302
"2011","North Lincolnshire 004B","E01013306","Total",1544,167,86,81,1377,51,200,339,308,102,162,215
"2011","North Lincolnshire 004C","E01013308","Total",1742,187,79,108,1555,82,234,316,356,92,201,274
"2011","North Lincolnshire 004D","E01013309","Total",1586,185,79,106,1401,33,252,347,308,51,142,268
"2011","North Lincolnshire 005A","E01013286","Total",2309,437,193,244,1872,120,472,369,420,89,170,232
"2011","North Lincolnshire 005B","E01013287","Total",1461,217,84,133,1244,38,260,288,332,53,44,229
"2011","North Lincolnshire 005C","E01013289","Total",1639,206,77,129,1433,44,166,371,312,79,230,231
"2011","North Lincolnshire 005D","E01013290","Total",1644,183,99,84,1461,54,322,285,318,42,140,300
"2011","North Lincolnshire 005E","E01013293","Total",1549,165,101,64,1384,38,294,325,258,81,134,254
"2011","North Lincolnshire 006A","E01013245","Total",1488,161,75,86,1327,118,134,298,246,157,156,218
"2011","North Lincolnshire 006B","E01013246","Total",1530,142,66,76,1388,50,192,296,358,70,165,257
"2011","North Lincolnshire 006C","E01013247","Total",1740,164,82,82,1576,62,190,388,316,89,173,358
"2011","North Lincolnshire 006D","E01013248","Total",1747,195,86,109,1552,72,264,324,340,52,180,320
"2011","North Lincolnshire 006E","E01013249","Total",1735,219,97,122,1516,99,188,385,274,106,212,252
"2011","North Lincolnshire 007A","E01013297","Total",2138,239,106,133,1899,69,142,511,408,81,283,405
"2011","North Lincolnshire 007B","E01013300","Total",1671,183,70,113,1488,116,66,212,238,140,339,377
"2011","North Lincolnshire 007C","E01013302","Total",1419,112,43,69,1307,61,172,270,238,63,166,337
"2011","North Lincolnshire 007D","E01013331","Total",1673,374,141,233,1299,94,160,291,318,69,130,237
"2011","North Lincolnshire 008A","E01013296","Total",1633,196,36,160,1437,159,62,324,254,161,220,257
"2011","North Lincolnshire 008B","E01013298","Total",1605,102,39,63,1503,163,46,319,164,285,236,290
"2011","North Lincolnshire 008C","E01013299","Total",1640,213,84,129,1427,175,124,256,182,261,219,210
"2011","North Lincolnshire 008D","E01013330","Total",1695,327,84,243,1368,135,86,252,320,124,212,239
"2011","North Lincolnshire 008E","E01013332","Total",1863,151,58,93,1712,81,90,267,290,215,443,326
"2011","North Lincolnshire 009A","E01013295","Total",1385,140,72,68,1245,64,286,264,210,37,120,264
"2011","North Lincolnshire 009B","E01013301","Total",1616,160,69,91,1456,91,182,372,254,73,205,279
"2011","North Lincolnshire 009C","E01013333","Total",1631,170,74,96,1461,51,120,316,212,195,258,309
"2011","North Lincolnshire 009D","E01013334","Total",1556,177,83,94,1379,69,156,329,260,84,187,294
"2011","North Lincolnshire 010A","E01013310","Total",1481,168,66,102,1313,126,138,280,238,102,172,257
"2011","North Lincolnshire 010B","E01013312","Total",1798,271,63,208,1527,227,76,388,304,74,141,317
"2011","North Lincolnshire 010C","E01013313","Total",1552,194,102,92,1358,97,128,355,300,58,136,284
"2011","North Lincolnshire 010D","E01013314","Total",1516,193,71,122,1323,84,120,289,224,109,179,318
"2011","North Lincolnshire 011A","E01013267","Total",1226,106,57,49,1120,36,198,274,226,73,106,207
"2011","North Lincolnshire 011B","E01013268","Total",1259,162,87,75,1097,102,192,200,264,77,80,182
"2011","North Lincolnshire 011C","E01013269","Total",1738,154,86,68,1584,32,252,361,346,95,144,354
"2011","North Lincolnshire 011D","E01013271","Total",1891,203,83,120,1688,135,172,376,274,192,199,340
"2011","North Lincolnshire 011E","E01013272","Total",1621,376,186,190,1245,76,178,254,312,68,131,226
"2011","North Lincolnshire 011F","E01013273","Total",1702,201,118,83,1501,54,330,288,326,70,133,300
"2011","North Lincolnshire 012A","E01013279","Total",1427,306,108,198,1121,183,110,202,254,93,67,212
"2011","North Lincolnshire 012B","E01013285","Total",1262,118,50,68,1144,40,182,207,232,76,124,283
"2011","North Lincolnshire 012C","E01013316","Total",1437,121,68,53,1316,44,220,268,240,84,160,300
"2011","North Lincolnshire 012D","E01013321","Total",1647,144,67,77,1503,53,200,351,290,107,171,331
"2011","North Lincolnshire 013A","E01013274","Total",1939,193,70,123,1746,79,210,458,420,78,174,327
"2011","North Lincolnshire 013B","E01013275","Total",1563,144,93,51,1419,67,220,324,282,91,184,251
"2011","North Lincolnshire 013C","E01013276","Total",1622,235,140,95,1387,96,234,339,238,76,134,270
"2011","North Lincolnshire 013D","E01013277","Total",1486,150,77,73,1336,50,194,325,302,62,112,291
"2011","North Lincolnshire 014A","E01013315","Total",1494,360,246,114,1134,73,224,187,242,107,94,207
"2011","North Lincolnshire 014B","E01013317","Total",1352,157,91,66,1195,63,152,213,212,104,147,304
"2011","North Lincolnshire 014C","E01013318","Total",1537,189,97,92,1348,57,136,286,196,140,211,322
"2011","North Lincolnshire 014D","E01013319","Total",2243,276,70,206,1967,239,132,498,314,211,273,300
"2011","North Lincolnshire 015A","E01013238","Total",1677,287,124,163,1390,82,138,370,298,95,151,256
"2011","North Lincolnshire 015B","E01013240","Total",2301,294,106,188,2007,189,164,540,412,84,289,329
"2011","North Lincolnshire 015C","E01013311","Total",1809,265,110,155,1544,222,130,327,256,166,247,196
"2011","North Lincolnshire 015D","E01013320","Total",1494,184,77,107,1310,66,172,339,238,107,150,238
"2011","North Lincolnshire 016A","E01013278","Total",1500,223,69,154,1277,210,108,252,204,131,181,191
"2011","North Lincolnshire 016B","E01013280","Total",1462,130,54,76,1332,58,228,292,236,92,143,283
"2011","North Lincolnshire 016C","E01013281","Total",1375,110,45,65,1265,147,122,257,170,151,193,225
"2011","North Lincolnshire 016D","E01013283","Total",1483,97,49,48,1386,180,130,277,172,139,214,274
"2011","North Lincolnshire 017A","E01013236","Total",1557,263,152,111,1294,61,242,322,222,60,118,269
"2011","North Lincolnshire 017B","E01013239","Total",1557,234,96,138,1323,72,198,253,304,53,177,266
"2011","North Lincolnshire 017C","E01013282","Total",1587,137,75,62,1450,137,172,281,244,139,201,276
"2011","North Lincolnshire 017D","E01013284","Total",1606,182,82,100,1424,131,150,260,204,144,223,312
"2011","North Lincolnshire 018B","E01013237","Total",1747,151,94,57,1596,199,126,301,192,206,287,285
"2011","North Lincolnshire 018C","E01013261","Total",1458,156,104,52,1302,35,324,302,238,73,90,240
"2011","North Lincolnshire 018D","E01013262","Total",1358,138,85,53,1220,29,276,248,258,83,84,242
"2011","North Lincolnshire 018E","E01013263","Total",1434,212,127,85,1222,32,234,238,274,43,116,285
"2011","North Lincolnshire 018F","E01033296","Total",1439,138,70,68,1301,67,208,323,238,78,123,264
"2011","North Lincolnshire 018G","E01033297","Total",1669,147,4,143,1522,140,28,660,284,84,136,190
"2011","North Lincolnshire 019A","E01013260","Total",1477,166,107,59,1311,32,302,259,266,40,132,280
"2011","North Lincolnshire 019B","E01013264","Total",1729,185,94,91,1544,102,196,382,376,73,129,286
"2011","North Lincolnshire 019C","E01013265","Total",1648,181,118,63,1467,40,312,296,306,66,136,311
"2011","North Lincolnshire 019D","E01013266","Total",1934,220,87,133,1714,82,226,438,386,120,130,332
"2011","North Lincolnshire 020A","E01013241","Total",1520,239,133,106,1281,45,304,272,280,54,95,231
"2011","North Lincolnshire 020B","E01013242","Total",1770,138,58,80,1632,41,230,351,318,112,193,387
"2011","North Lincolnshire 020C","E01013243","Total",2147,190,84,106,1957,117,224,471,418,112,242,373
"2011","North Lincolnshire 020D","E01013244","Total",1806,246,116,130,1560,111,208,456,296,91,160,238
"2011","North Lincolnshire 021A","E01013324","Total",1553,137,67,70,1416,9,230,341,246,56,190,344
"2011","North Lincolnshire 021B","E01013326","Total",1580,170,105,65,1410,49,326,299,282,48,126,280
"2011","North Lincolnshire 021C","E01013327","Total",1409,225,141,84,1184,37,358,246,272,52,51,168
"2011","North Lincolnshire 021D","E01013328","Total",1293,90,48,42,1203,63,198,330,212,55,119,226
"2011","North Lincolnshire 022A","E01013322","Total",1919,201,83,118,1718,108,248,400,338,125,234,265
"2011","North Lincolnshire 022B","E01013323","Total",1580,140,73,67,1440,80,230,333,324,81,138,254
"2011","North Lincolnshire 022C","E01013325","Total",1536,148,80,68,1388,27,282,252,272,73,173,309
"2011","North Lincolnshire 022D","E01013329","Total",1818,208,93,115,1610,67,264,368,332,129,226,224
"2011","North Lincolnshire 023A","E01013250","Total",1597,189,109,80,1408,45,248,287,332,87,164,245
"2011","North Lincolnshire 023B","E01013251","Total",1816,170,82,88,1646,19,328,325,344,76,187,367
"2011","North Lincolnshire 023C","E01013252","Total",1735,137,78,59,1598,58,262,433,300,108,175,262
"2011","North Lincolnshire 023D","E01013253","Total",1946,194,93,101,1752,74,246,456,332,124,211,309
"2011","York 001A","E01013436","Total",1687,100,44,56,1587,42,176,538,276,164,175,216
"2011","York 001B","E01013438","Total",1779,186,108,78,1593,100,202,437,284,112,156,302
"2011","York 001C","E01013439","Total",1450,80,35,45,1370,17,130,520,238,98,192,175
"2011","York 001D","E01013440","Total",1856,195,98,97,1661,64,234,377,354,118,163,351
"2011","York 002A","E01013370","Total",1495,301,195,106,1194,63,260,219,280,70,114,188
"2011","York 002B","E01013373","Total",1429,199,127,72,1230,53,212,328,232,73,126,206
"2011","York 002C","E01013375","Total",1308,156,98,58,1152,28,268,254,260,36,72,234
"2011","York 002D","E01013376","Total",1467,131,82,49,1336,37,272,283,312,67,107,258
"2011","York 003A","E01013371","Total",1465,112,71,41,1353,40,200,344,270,72,111,316
"2011","York 003B","E01013372","Total",1573,319,220,99,1254,43,328,231,282,73,89,208
"2011","York 003C","E01013374","Total",1526,88,54,34,1438,44,218,397,272,72,143,292
"2011","York 003D","E01013377","Total",1620,129,67,62,1491,38,226,387,300,86,113,341
"2011","York 004A","E01013404","Total",1433,205,85,120,1228,72,178,250,286,67,138,237
"2011","York 004B","E01013407","Total",1389,234,170,64,1155,43,282,203,248,89,75,215
"2011","York 004C","E01013408","Total",1324,174,129,45,1150,31,370,153,228,40,97,231
"2011","York 004D","E01013410","Total",1397,230,126,104,1167,132,126,200,178,67,213,251
"2011","York 005A","E01013405","Total",1404,157,89,68,1247,43,242,244,240,72,108,298
"2011","York 005B","E01013406","Total",1959,207,51,156,1752,115,180,447,450,70,211,279
"2011","York 005C","E01013409","Total",1566,211,141,70,1355,52,286,293,258,60,138,268
"2011","York 005D","E01013411","Total",1526,221,159,62,1305,34,370,279,200,41,133,248
"2011","York 006A","E01013428","Total",1636,189,69,120,1447,100,112,416,360,61,142,256
"2011","York 006B","E01013429","Total",2065,174,29,145,1891,134,92,626,414,165,190,270
"2011","York 006C","E01013430","Total",1549,140,67,73,1409,51,244,324,308,56,182,244
"2011","York 006D","E01013431","Total",1556,173,34,139,1383,119,86,500,322,72,117,167
"2011","York 006E","E01013435","Total",1466,167,84,83,1299,57,178,354,290,51,149,220
"2011","York 007A","E01013344","Total",1432,258,75,183,1174,28,120,240,346,78,81,281
"2011","York 007B","E01013346","Total",1623,311,161,150,1312,52,236,276,370,62,90,226
"2011","York 007C","E01013432","Total",2038,233,101,132,1805,105,212,575,374,118,161,260
"2011","York 007D","E01013433","Total",1461,177,113,64,1284,30,264,317,242,46,122,263
"2011","York 007E","E01013434","Total",1398,157,78,79,1241,38,240,335,272,37,107,212
"2011","York 008A","E01013379","Total",1467,166,97,69,1301,39,180,359,232,84,115,292
"2011","York 008B","E01013380","Total",1672,232,88,144,1440,45,152,257,316,69,148,453
"2011","York 008C","E01013385","Total",1455,205,83,122,1250,130,132,258,238,76,135,281
"2011","York 008D","E01013387","Total",1475,198,141,57,1277,24,314,319,264,67,91,198
"2011","York 008E","E01013388","Total",1033,164,105,59,869,19,246,133,186,25,69,191
"2011","York 008F","E01013389","Total",1158,131,85,46,1027,30,212,219,190,40,110,226
"2011","York 008G","E01013437","Total",1180,138,65,73,1042,38,206,217,222,26,97,236
"2011","York 009A","E01013343","Total",1883,275,98,177,1608,66,100,274,472,85,74,537
"2011","York 009B","E01013345","Total",1720,245,117,128,1475,65,118,271,440,50,88,443
"2011","York 009C","E01013347","Total",1637,212,72,140,1425,139,104,308,230,124,193,327
"2011","York 009D","E01013349","Total",1387,143,35,108,1244,152,74,256,148,152,235,227
"2011","York 009E","E01013350","Total",1609,233,69,164,1376,112,128,239,246,97,229,325
"2011","York 010A","E01013348","Total",1545,201,43,158,1344,98,70,266,346,25,52,487
"2011","York 010B","E01013368","Total",2234,277,65,212,1957,91,90,332,448,41,87,868
"2011","York 010C","E01013382","Total",1656,278,105,173,1378,137,126,303,312,44,185,271
"2011","York 010D","E01013383","Total",2281,356,88,268,1925,167,120,292,490,101,112,643
"2011","York 010E","E01013386","Total",1769,257,99,158,1512,158,86,311,336,146,183,292
"2011","York 011A","E01013421","Total",1237,122,62,60,1115,41,210,258,232,66,111,197
"2011","York 011B","E01013422","Total",1686,114,57,57,1572,59,190,479,298,111,207,228
"2011","York 011C","E01013426","Total",1648,178,131,47,1470,33,364,331,272,93,127,250
"2011","York 011D","E01013427","Total",1442,142,111,31,1300,30,342,297,168,102,126,235
"2011","York 012A","E01013335","Total",1577,172,80,92,1405,150,160,290,208,95,220,282
"2011","York 012B","E01013336","Total",1470,194,90,104,1276,63,222,244,212,101,117,317
"2011","York 012C","E01013337","Total",1650,203,93,110,1447,39,170,343,282,128,155,330
"2011","York 012D","E01013338","Total",2229,197,83,114,2032,146,262,534,350,115,212,413
"2011","York 012E","E01013339","Total",1595,156,104,52,1439,21,204,380,246,130,174,284
"2011","York 012F","E01013392","Total",1542,169,74,95,1373,51,120,356,284,130,142,290
"2011","York 013A","E01013366","Total",1732,517,130,387,1215,69,118,183,432,31,38,344
"2011","York 013C","E01013369","Total",1819,500,164,336,1319,68,156,194,436,19,67,379
"2011","York 013E","E01013416","Total",1550,359,123,236,1191,164,66,199,348,52,86,276
"2011","York 013F","E01033067","Total",1327,355,78,277,972,95,72,172,360,20,29,224
"2011","York 013G","E01033068","Total",1144,321,53,268,823,51,76,89,460,5,9,133
"2011","York 013H","E01033069","Total",1143,323,74,249,820,46,80,140,338,22,52,142
"2011","York 013I","E01033070","Total",1119,396,71,325,723,21,58,86,382,5,22,149
"2011","York 014A","E01013381","Total",1544,157,82,75,1387,65,148,366,228,30,143,407
"2011","York 014B","E01013402","Total",1717,144,99,45,1573,18,276,223,198,41,163,654
"2011","York 014C","E01013419","Total",1484,186,126,60,1298,44,298,253,218,63,132,290
"2011","York 014D","E01013420","Total",2038,243,136,107,1795,63,294,460,274,78,143,483
"2011","York 015A","E01013384","Total",1749,192,87,105,1557,91,78,268,178,99,151,692
"2011","York 015B","E01013398","Total",1608,132,50,82,1476,80,100,236,150,96,151,663
"2011","York 015C","E01013399","Total",1774,189,81,108,1585,232,86,357,180,187,167,376
"2011","York 015D","E01013400","Total",1936,283,34,249,1653,91,52,171,570,16,63,690
"2011","York 015E","E01013401","Total",1696,113,51,62,1583,87,76,190,268,77,153,732
"2011","York 015F","E01013403","Total",1887,146,68,78,1741,37,154,155,212,20,177,986
"2011","York 016A","E01013393","Total",1599,227,54,173,1372,133,124,333,380,83,93,226
"2011","York 016B","E01013394","Total",1312,267,87,180,1045,127,160,264,230,46,85,133
"2011","York 016C","E01013395","Total",1450,197,63,134,1253,48,124,361,320,66,116,218
"2011","York 016D","E01013396","Total",1571,289,155,134,1282,67,254,333,242,91,81,214
"2011","York 016E","E01013441","Total",1528,212,78,134,1316,89,162,317,326,52,84,286
"2011","York 016F","E01013445","Total",1538,328,160,168,1210,132,128,294,298,55,136,167
"2011","York 017A","E01013390","Total",1573,269,47,222,1304,118,54,295,578,36,59,164
"2011","York 017B","E01013391","Total",2167,341,70,271,1826,128,96,384,734,118,56,310
"2011","York 017C","E01013397","Total",1494,175,80,95,1319,74,170,308,282,100,105,280
"2011","York 017D","E01013413","Total",1665,232,82,150,1433,56,102,399,358,111,80,327
"2011","York 017E","E01013417","Total",1855,304,75,229,1551,51,164,389,382,163,137,265
"2011","York 018A","E01013442","Total",1379,165,94,71,1214,100,192,267,286,41,106,222
"2011","York 018B","E01013443","Total",1440,297,116,181,1143,166,108,238,242,106,88,195
"2011","York 018C","E01013444","Total",1413,158,62,96,1255,200,108,310,196,96,104,241
"2011","York 018D","E01013446","Total",1660,203,87,116,1457,127,138,360,266,94,174,298
"2011","York 018E","E01013447","Total",1499,180,76,104,1319,164,110,281,226,80,173,285
"2011","York 018F","E01013448","Total",1375,210,59,151,1165,154,74,287,234,116,116,184
"2011","York 019A","E01013360","Total",1820,106,55,51,1714,63,130,554,246,146,179,396
"2011","York 019B","E01013361","Total",1879,210,55,155,1669,123,106,319,420,40,80,581
"2011","York 019C","E01013362","Total",1678,278,144,134,1400,64,220,281,284,72,127,352
"2011","York 019D","E01013363","Total",1865,321,101,220,1544,73,72,234,450,17,60,638
"2011","York 019E","E01013364","Total",2007,317,71,246,1690,84,74,180,396,40,128,788
"2011","York 019F","E01013418","Total",1549,333,96,237,1216,97,124,280,376,25,66,248
"2011","York 020A","E01013351","Total",1855,167,101,66,1688,54,376,420,258,82,220,278
"2011","York 020B","E01013352","Total",1700,220,154,66,1480,44,374,370,226,121,96,249
"2011","York 020C","E01013451","Total",1239,78,33,45,1161,52,126,320,242,137,125,159
"2011","York 020D","E01013452","Total",1634,123,80,43,1511,46,244,429,264,151,179,198
"2011","York 021A","E01013357","Total",1990,162,88,74,1828,64,392,517,294,151,183,227
"2011","York 021B","E01013358","Total",1559,176,58,118,1383,51,200,397,300,82,94,259
"2011","York 021C","E01013412","Total",1780,309,81,228,1471,128,70,325,556,58,52,282
"2011","York 021D","E01013414","Total",1661,231,78,153,1430,107,152,317,424,64,70,296
"2011","York 022A","E01013353","Total",1596,264,132,132,1332,77,166,314,284,68,171,252
"2011","York 022B","E01013354","Total",1414,136,53,83,1278,37,168,308,356,15,133,261
"2011","York 022C","E01013355","Total",1476,209,115,94,1267,32,340,224,326,21,89,235
"2011","York 022D","E01013356","Total",1452,178,95,83,1274,72,232,276,296,20,131,247
"2011","York 022E","E01013359","Total",1547,198,93,105,1349,93,154,338,238,104,157,265
"2011","York 022F","E01013449","Total",1679,179,81,98,1500,122,184,311,306,128,141,308
"2011","York 023A","E01013365","Total",2683,375,214,161,2308,106,412,478,414,148,240,510
"2011","York 023B","E01013378","Total",1125,150,65,85,975,38,118,179,186,50,118,286
"2011","York 023C","E01013450","Total",1237,107,49,58,1130,41,210,262,220,96,97,204
"2011","York 024A","E01013340","Total",1274,113,62,51,1161,36,210,361,192,66,88,208
"2011","York 024B","E01013341","Total",1266,229,157,72,1037,49,266,260,184,71,46,161
"2011","York 024C","E01013342","Total",1355,128,56,72,1227,34,320,281,248,30,91,223
"2011","York 024D","E01013423","Total",1285,100,66,34,1185,26,218,312,258,81,68,222
"2011","York 024E","E01013424","Total",1335,69,23,46,1266,47,172,294,234,86,141,292
"2011","York 024F","E01013425","Total",1553,176,95,81,1377,89,238,364,310,61,138,177
"2011","Craven 001A","E01027558","Total",1870,247,129,118,1623,42,326,350,356,82,119,348
"2011","Craven 001B","E01027559","Total",1713,243,112,131,1470,112,248,314,294,80,101,321
"2011","Craven 001C","E01027569","Total",1328,144,88,56,1184,30,278,238,264,52,136,186
"2011","Craven 001D","E01027570","Total",2425,326,172,154,2099,75,422,432,448,111,201,410
"2011","Craven 002A","E01027562","Total",1580,175,87,88,1405,26,264,219,294,98,216,288
"2011","Craven 002B","E01027567","Total",1585,309,193,116,1276,45,330,254,254,83,120,190
"2011","Craven 002C","E01027585","Total",1791,238,161,77,1553,39,492,270,286,99,112,255
"2011","Craven 003A","E01027568","Total",2164,234,117,117,1930,64,376,420,440,150,162,318
"2011","Craven 003B","E01027571","Total",1730,218,124,94,1512,59,342,323,320,90,125,253
"2011","Craven 003C","E01027572","Total",2008,405,183,222,1603,75,290,338,374,77,171,278
"2011","Craven 003D","E01027573","Total",1516,226,145,81,1290,41,330,240,220,80,134,245
"2011","Craven 004A","E01027557","Total",1592,156,68,88,1436,34,270,324,274,101,198,235
"2011","Craven 004B","E01027561","Total",1879,228,126,102,1651,63,320,359,350,129,175,255
"2011","Craven 004C","E01027576","Total",1561,164,111,53,1397,22,310,268,268,88,207,234
"2011","Craven 005A","E01027574","Total",1458,169,93,76,1289,27,276,281,270,72,117,246
"2011","Craven 005B","E01027575","Total",1897,278,183,95,1619,76,284,395,366,46,118,334
"2011","Craven 005C","E01027577","Total",1915,348,180,168,1567,85,238,381,396,71,149,247
"2011","Craven 005D","E01027579","Total",1132,204,98,106,928,140,100,227,180,30,105,146
"2011","Craven 006A","E01027578","Total",1515,269,105,164,1246,138,116,274,360,92,82,184
"2011","Craven 006B","E01027580","Total",1121,185,92,93,936,111,74,154,132,89,151,225
"2011","Craven 006C","E01027581","Total",2454,481,174,307,1973,149,210,382,418,168,375,271
"2011","Craven 006D","E01027582","Total",1511,224,91,133,1287,78,176,243,276,110,177,227
"2011","Craven 007A","E01027556","Total",1690,177,74,103,1513,45,226,413,298,89,166,276
"2011","Craven 007B","E01027560","Total",2345,244,80,164,2101,141,200,635,454,133,211,327
"2011","Craven 007C","E01027563","Total",1379,255,152,103,1124,48,266,217,250,47,108,188
"2011","Craven 007D","E01027586","Total",1874,261,113,148,1613,56,296,408,370,95,146,242
"2011","Craven 008A","E01027555","Total",1879,220,108,112,1659,62,332,407,340,61,190,267
"2011","Craven 008B","E01027564","Total",1111,261,146,115,850,69,126,192,180,41,83,159
"2011","Craven 008C","E01027565","Total",1530,160,90,70,1370,71,254,357,262,73,164,189
"2011","Craven 008D","E01027566","Total",1235,138,72,66,1097,54,164,256,230,60,90,243
"2011","Craven 008E","E01027583","Total",2006,227,130,97,1779,112,258,450,306,114,224,315
"2011","Craven 008F","E01027584","Total",1581,237,134,103,1344,73,212,345,300,39,92,283
"2011","Hambleton 001A","E01027591","Total",1668,188,86,102,1480,49,314,270,296,87,132,332
"2011","Hambleton 001B","E01027597","Total",1568,191,99,92,1377,42,288,334,240,80,126,267
"2011","Hambleton 001C","E01027599","Total",1653,318,151,167,1335,103,230,317,252,77,130,226
"2011","Hambleton 001D","E01027623","Total",1297,181,125,56,1116,37,238,271,186,67,96,221
"2011","Hambleton 001E","E01027625","Total",1651,297,162,135,1354,140,234,283,232,98,140,227
"2011","Hambleton 002A","E01027598","Total",1751,271,173,98,1480,35,482,281,294,45,89,254
"2011","Hambleton 002B","E01027618","Total",2421,248,144,104,2173,61,488,433,414,112,241,424
"2011","Hambleton 002C","E01027624","Total",1269,115,76,39,1154,40,220,264,194,57,134,245
"2011","Hambleton 002D","E01027626","Total",1320,145,85,60,1175,38,290,226,232,52,108,229
"2011","Hambleton 002E","E01027627","Total",1820,225,111,114,1595,20,338,346,306,62,212,311
"2011","Hambleton 003A","E01027590","Total",2055,355,132,223,1700,70,260,406,416,64,164,320
"2011","Hambleton 003B","E01027592","Total",1744,171,72,99,1573,35,334,274,350,55,171,354
"2011","Hambleton 003C","E01027613","Total",1761,217,107,110,1544,35,294,331,276,90,191,327
"2011","Hambleton 003D","E01027617","Total",1100,108,54,54,992,16,148,174,202,75,117,260
"2011","Hambleton 004A","E01027605","Total",1524,263,75,188,1261,79,114,341,362,75,88,202
"2011","Hambleton 004B","E01027606","Total",1522,216,135,81,1306,36,278,358,248,59,72,255
"2011","Hambleton 004C","E01027608","Total",1652,261,78,183,1391,126,130,266,252,140,154,323
"2011","Hambleton 004D","E01027609","Total",1342,133,34,99,1209,155,58,368,248,49,149,182
"2011","Hambleton 004E","E01027610","Total",1685,228,86,142,1457,122,166,344,300,97,150,278
"2011","Hambleton 004F","E01027611","Total",1903,317,208,109,1586,45,408,306,340,73,131,283
"2011","Hambleton 004G","E01027612","Total",1686,262,148,114,1424,162,192,318,224,111,142,275
"2011","Hambleton 004H","E01027616","Total",1430,230,123,107,1200,84,180,308,242,79,127,180
"2011","Hambleton 005A","E01027603","Total",1883,178,100,78,1705,46,310,401,322,58,197,371
"2011","Hambleton 005B","E01027604","Total",1761,183,96,87,1578,46,314,352,348,102,139,277
"2011","Hambleton 005C","E01027607","Total",1237,131,92,39,1106,25,280,183,218,22,117,261
"2011","Hambleton 005D","E01027614","Total",1236,156,103,53,1080,21,250,239,222,20,101,227
"2011","Hambleton 005E","E01027615","Total",1276,89,66,23,1187,27,188,343,212,45,103,269
"2011","Hambleton 006A","E01027587","Total",1330,218,157,61,1112,51,264,245,172,25,127,228
"2011","Hambleton 006B","E01027588","Total",1519,233,104,129,1286,75,170,316,236,71,182,236
"2011","Hambleton 006C","E01027589","Total",1673,182,98,84,1491,57,224,331,302,61,139,377
"2011","Hambleton 006D","E01027593","Total",1726,201,101,100,1525,21,292,366,314,63,187,282
"2011","Hambleton 007B","E01027628","Total",1862,167,89,78,1695,49,248,419,378,149,131,321
"2011","Hambleton 007C","E01027633","Total",1844,171,79,92,1673,36,366,369,352,141,133,276
"2011","Hambleton 007D","E01033065","Total",1197,84,46,38,1113,37,130,389,206,68,77,206
"2011","Hambleton 007E","E01033066","Total",1677,64,29,35,1613,22,78,647,204,346,159,157
"2011","Hambleton 008A","E01027620","Total",1921,222,105,117,1699,108,226,526,298,71,197,273
"2011","Hambleton 008B","E01027630","Total",1730,344,143,201,1386,88,214,301,368,72,78,265
"2011","Hambleton 008C","E01027631","Total",1386,250,142,108,1136,43,236,230,254,69,119,185
"2011","Hambleton 008D","E01027632","Total",1479,135,65,70,1344,43,192,344,228,90,186,261
"2011","Hambleton 008E","E01027637","Total",1863,204,99,105,1659,41,344,343,370,77,158,326
"2011","Hambleton 009A","E01027621","Total",2239,282,175,107,1957,86,386,379,422,97,241,346
"2011","Hambleton 009B","E01027629","Total",1378,204,110,94,1174,120,192,299,196,92,107,168
"2011","Hambleton 009C","E01027635","Total",2346,172,85,87,2174,67,270,668,460,190,172,347
"2011","Hambleton 009D","E01027636","Total",2067,202,122,80,1865,38,362,371,374,144,177,399
"2011","Hambleton 010A","E01027594","Total",1485,312,184,128,1173,83,238,286,200,58,115,193
"2011","Hambleton 010B","E01027595","Total",1620,235,124,111,1385,76,262,311,250,83,121,282
"2011","Hambleton 010C","E01027596","Total",1504,263,168,95,1241,33,330,210,242,100,105,221
"2011","Hambleton 010D","E01027601","Total",1938,190,108,82,1748,69,266,452,322,103,232,304
"2011","Hambleton 010E","E01027622","Total",1917,179,93,86,1738,43,360,376,308,124,209,318
"2011","Hambleton 011A","E01027600","Total",1914,157,76,81,1757,48,244,513,358,90,191,313
"2011","Hambleton 011B","E01027619","Total",2461,184,82,102,2277,82,258,731,422,199,241,344
"2011","Hambleton 011C","E01027634","Total",2030,147,76,71,1883,73,216,532,348,123,247,344
"2011","Harrogate 001A","E01027666","Total",1715,161,96,65,1554,63,298,342,316,129,137,269
"2011","Harrogate 001B","E01027667","Total",1364,128,54,74,1236,25,202,358,226,72,143,210
"2011","Harrogate 001C","E01027685","Total",1201,217,125,92,984,52,214,175,242,47,102,152
"2011","Harrogate 001D","E01027686","Total",1128,89,32,57,1039,46,180,241,212,63,86,211
"2011","Harrogate 002A","E01027712","Total",1318,98,51,47,1220,48,154,380,190,80,140,228
"2011","Harrogate 002B","E01027713","Total",1630,265,125,140,1365,80,212,306,284,94,136,253
"2011","Harrogate 002C","E01027714","Total",1609,255,132,123,1354,66,238,298,282,138,137,195
"2011","Harrogate 002D","E01027715","Total",1114,77,48,29,1037,21,80,452,166,105,104,109
"2011","Harrogate 003A","E01027643","Total",1447,157,78,79,1290,37,300,275,252,102,136,188
"2011","Harrogate 003B","E01027688","Total",1553,165,91,74,1388,43,316,339,290,68,93,239
"2011","Harrogate 003C","E01027736","Total",1564,142,73,69,1422,53,224,347,348,115,125,210
"2011","Harrogate 003D","E01027737","Total",1611,89,46,43,1522,47,146,618,298,118,105,190
"2011","Harrogate 004A","E01027705","Total",1659,197,61,136,1462,89,156,387,308,90,165,267
"2011","Harrogate 004B","E01027706","Total",1931,423,211,212,1508,156,220,324,306,105,158,239
"2011","Harrogate 004C","E01027707","Total",1751,232,91,141,1519,144,276,335,326,81,126,231
"2011","Harrogate 004D","E01027708","Total",1383,156,92,64,1227,46,244,344,232,64,84,213
"2011","Harrogate 004E","E01027709","Total",1203,114,73,41,1089,11,238,221,202,76,116,225
"2011","Harrogate 004F","E01027710","Total",1054,149,83,66,905,113,160,188,134,63,123,124
"2011","Harrogate 004G","E01027711","Total",1296,101,53,48,1195,87,98,304,220,88,158,240
"2011","Harrogate 005A","E01027644","Total",1488,200,113,87,1288,53,228,408,250,68,101,180
"2011","Harrogate 005B","E01027645","Total",1524,192,65,127,1332,81,234,263,280,46,143,285
"2011","Harrogate 005C","E01027647","Total",1604,153,80,73,1451,21,290,368,292,71,151,258
"2011","Harrogate 005D","E01027687","Total",1494,142,75,67,1352,27,218,320,266,76,174,271
"2011","Harrogate 006A","E01027681","Total",1605,160,62,98,1445,66,226,300,302,127,171,253
"2011","Harrogate 006B","E01027693","Total",1791,168,88,80,1623,36,284,368,316,87,180,352
"2011","Harrogate 006C","E01027701","Total",1568,183,85,98,1385,44,246,280,314,107,124,270
"2011","Harrogate 006D","E01027702","Total",1125,216,127,89,909,49,162,194,218,42,104,140
"2011","Harrogate 007A","E01027642","Total",1393,137,72,65,1256,41,312,322,218,87,121,155
"2011","Harrogate 007B","E01027646","Total",1546,169,86,83,1377,57,284,323,276,93,153,191
"2011","Harrogate 007C","E01027674","Total",1352,128,87,41,1224,35,174,350,220,82,152,211
"2011","Harrogate 007D","E01027675","Total",2384,193,113,80,2191,78,280,672,380,167,221,393
"2011","Harrogate 008A","E01027641","Total",1297,64,22,42,1233,18,110,356,216,60,173,300
"2011","Harrogate 008B","E01027664","Total",2118,242,167,75,1876,82,332,494,322,219,186,241
"2011","Harrogate 008C","E01027665","Total",1081,110,65,45,971,28,200,232,168,75,93,175
"2011","Harrogate 008D","E01027722","Total",1425,100,27,73,1325,83,56,454,262,117,156,197
"2011","Harrogate 009A","E01027668","Total",1539,187,112,75,1352,106,206,463,234,53,119,171
"2011","Harrogate 009B","E01027669","Total",1841,382,235,147,1459,84,348,288,272,68,110,289
"2011","Harrogate 009C","E01027673","Total",1750,352,143,209,1398,115,240,279,324,56,142,242
"2011","Harrogate 009D","E01027676","Total",1762,162,72,90,1600,108,134,476,244,104,221,313
"2011","Harrogate 010A","E01027638","Total",1339,141,71,70,1198,41,266,282,276,55,79,199
"2011","Harrogate 010B","E01027639","Total",1284,146,78,68,1138,54,178,291,208,80,118,209
"2011","Harrogate 010C","E01027640","Total",1489,189,103,86,1300,84,214,371,234,64,124,209
"2011","Harrogate 010D","E01027690","Total",1424,166,92,74,1258,47,222,311,276,45,88,269
"2011","Harrogate 010E","E01027738","Total",1321,147,63,84,1174,98,108,290,294,60,87,237
"2011","Harrogate 010F","E01027739","Total",1094,108,42,66,986,40,86,274,250,44,113,179
"2011","Harrogate 010G","E01027741","Total",1369,184,117,67,1185,79,200,255,242,89,65,255
"2011","Harrogate 011A","E01027689","Total",1392,194,61,133,1198,102,140,281,314,60,98,203
"2011","Harrogate 011B","E01027691","Total",1494,196,64,132,1298,99,126,375,324,55,128,191
"2011","Harrogate 011C","E01027720","Total",1480,206,64,142,1274,98,128,360,284,88,108,208
"2011","Harrogate 011D","E01027721","Total",1507,164,61,103,1343,54,148,371,314,84,153,219
"2011","Harrogate 011E","E01027723","Total",1490,312,108,204,1178,126,102,321,286,40,116,187
"2011","Harrogate 012A","E01027670","Total",1627,144,70,74,1483,104,184,403,288,79,149,276
"2011","Harrogate 012B","E01027671","Total",1567,116,79,37,1451,30,270,425,220,70,165,271
"2011","Harrogate 012C","E01027672","Total",1703,135,96,39,1568,38,350,380,258,25,157,360
"2011","Harrogate 012D","E01027704","Total",1159,127,78,49,1032,19,220,260,204,57,106,166
"2011","Harrogate 013A","E01027649","Total",1631,177,79,98,1454,123,132,361,340,71,125,302
"2011","Harrogate 013B","E01027651","Total",1519,184,87,97,1335,120,108,332,154,134,197,290
"2011","Harrogate 013C","E01027657","Total",1245,194,37,157,1051,84,40,271,326,40,78,212
"2011","Harrogate 013D","E01027658","Total",1566,238,71,167,1328,158,104,287,410,72,114,183
"2011","Harrogate 013E","E01027692","Total",1171,201,73,128,970,71,98,238,218,65,76,204
"2011","Harrogate 013F","E01027740","Total",1536,556,300,256,980,75,236,172,222,50,61,164
"2011","Harrogate 014A","E01027648","Total",1596,227,109,118,1369,120,146,381,202,110,164,246
"2011","Harrogate 014B","E01027650","Total",1538,155,85,70,1383,80,174,327,236,85,178,303
"2011","Harrogate 014C","E01027726","Total",1558,189,82,107,1369,118,120,354,296,80,110,291
"2011","Harrogate 014D","E01027727","Total",1553,190,113,77,1363,73,154,321,298,46,149,322
"2011","Harrogate 014E","E01027728","Total",1343,187,116,71,1156,62,244,288,190,37,92,243
"2011","Harrogate 014F","E01027729","Total",1576,196,63,133,1380,177,70,381,330,78,137,207
"2011","Harrogate 015A","E01027652","Total",1483,245,80,165,1238,97,162,326,276,102,121,154
"2011","Harrogate 015B","E01027655","Total",1176,191,89,102,985,20,192,198,188,81,156,150
"2011","Harrogate 015C","E01027659","Total",1775,427,82,345,1348,109,80,300,458,78,84,239
"2011","Harrogate 015D","E01027677","Total",1349,277,75,202,1072,31,138,207,350,37,80,229
"2011","Harrogate 015E","E01027678","Total",1682,459,94,365,1223,67,84,265,420,30,70,287
"2011","Harrogate 015F","E01027680","Total",1299,383,116,267,916,67,98,219,276,46,67,143
"2011","Harrogate 016A","E01027683","Total",1457,128,72,56,1329,47,162,401,262,86,113,258
"2011","Harrogate 016B","E01027684","Total",1431,126,67,59,1305,46,180,326,276,91,123,263
"2011","Harrogate 016C","E01027695","Total",1653,151,84,67,1502,69,218,400,334,105,134,242
"2011","Harrogate 016D","E01027696","Total",1403,103,51,52,1300,36,176,327,252,83,152,274
"2011","Harrogate 016E","E01027703","Total",1789,192,89,103,1597,61,256,373,394,56,140,317
"2011","Harrogate 017A","E01027660","Total",1495,178,126,52,1317,31,274,269,216,108,151,268
"2011","Harrogate 017B","E01027661","Total",1438,178,97,81,1260,82,208,321,192,32,118,307
"2011","Harrogate 017C","E01027662","Total",1202,79,53,26,1123,17,128,333,166,92,109,278
"2011","Harrogate 017D","E01027663","Total",1359,192,101,91,1167,30,198,317,242,43,106,231
"2011","Harrogate 017E","E01027697","Total",1454,149,82,67,1305,71,176,426,190,86,142,214
"2011","Harrogate 017F","E01027733","Total",1317,111,72,39,1206,37,194,380,168,94,95,238
"2011","Harrogate 018A","E01027682","Total",1639,144,79,65,1495,43,280,339,282,165,99,287
"2011","Harrogate 018B","E01027694","Total",1220,84,46,38,1136,42,214,252,208,117,115,188
"2011","Harrogate 018C","E01027734","Total",1549,147,72,75,1402,21,258,316,306,129,149,223
"2011","Harrogate 018D","E01027735","Total",1648,156,82,74,1492,44,272,360,246,119,184,267
"2011","Harrogate 019A","E01027656","Total",1631,382,177,205,1249,58,272,261,338,53,64,203
"2011","Harrogate 019B","E01027679","Total",1522,381,191,190,1141,63,226,269,290,55,81,157
"2011","Harrogate 019C","E01027730","Total",1516,229,91,138,1287,76,166,322,288,109,114,212
"2011","Harrogate 019D","E01027731","Total",1446,195,81,114,1251,97,124,306,270,157,110,187
"2011","Harrogate 019E","E01027732","Total",1260,146,71,75,1114,35,214,253,234,126,121,131
"2011","Harrogate 020A","E01027653","Total",1359,274,153,121,1085,84,200,252,178,85,125,161
"2011","Harrogate 020B","E01027654","Total",1187,116,52,64,1071,34,160,291,198,120,90,178
"2011","Harrogate 020C","E01027698","Total",1545,133,85,48,1412,58,276,343,224,82,191,238
"2011","Harrogate 020D","E01027716","Total",1437,135,98,37,1302,29,316,317,186,106,103,245
"2011","Harrogate 020E","E01027717","Total",1531,154,88,66,1377,37,180,532,214,68,149,197
"2011","Harrogate 020F","E01027718","Total",1849,161,87,74,1688,126,226,523,284,143,156,230
"2011","Harrogate 020G","E01027719","Total",1371,198,128,70,1173,74,246,262,206,67,138,180
"2011","Harrogate 021A","E01027699","Total",1301,88,63,25,1213,16,268,294,186,78,171,200
"2011","Harrogate 021B","E01027700","Total",1185,113,63,50,1072,30,212,295,168,69,81,217
"2011","Harrogate 021C","E01027724","Total",1595,144,76,68,1451,42,294,382,246,138,135,214
"2011","Harrogate 021D","E01027725","Total",1479,167,75,92,1312,34,228,362,254,72,124,238
"2011","Richmondshire 001A","E01027743","Total",1224,125,62,63,1099,27,254,229,234,66,92,197
"2011","Richmondshire 001B","E01027751","Total",1266,118,57,61,1148,45,202,274,214,56,102,255
"2011","Richmondshire 001C","E01027752","Total",1177,176,95,81,1001,16,178,217,258,61,111,160
"2011","Richmondshire 001D","E01027759","Total",1404,161,77,84,1243,47,214,307,276,51,138,210
"2011","Richmondshire 001E","E01027761","Total",1123,151,78,73,972,36,280,210,202,50,91,103
"2011","Richmondshire 001F","E01027762","Total",1298,147,61,86,1151,29,180,240,288,62,123,229
"2011","Richmondshire 002A","E01027765","Total",1576,158,85,73,1418,109,208,306,310,67,147,271
"2011","Richmondshire 002B","E01027766","Total",1174,241,121,120,933,56,154,178,196,46,123,180
"2011","Richmondshire 002C","E01027767","Total",1515,135,78,57,1380,75,262,288,250,119,127,259
"2011","Richmondshire 002D","E01027768","Total",1166,120,71,49,1046,54,204,253,168,61,108,198
"2011","Richmondshire 002E","E01027769","Total",1293,156,64,92,1137,119,188,192,222,57,140,219
"2011","Richmondshire 002F","E01027770","Total",1592,362,152,210,1230,147,216,252,310,63,76,166
"2011","Richmondshire 003A","E01027745","Total",1582,133,51,82,1449,71,178,410,256,126,195,213
"2011","Richmondshire 003B","E01027746","Total",1412,190,89,101,1222,61,190,272,304,47,96,252
"2011","Richmondshire 003C","E01027747","Total",1366,140,44,96,1226,58,122,408,290,69,107,172
"2011","Richmondshire 003D","E01027748","Total",1166,158,98,60,1008,54,232,243,186,53,84,156
"2011","Richmondshire 004A","E01027749","Total",1941,218,82,136,1723,262,126,371,248,152,210,354
"2011","Richmondshire 004B","E01027750","Total",2532,225,75,150,2307,205,126,576,474,141,349,436
"2011","Richmondshire 004C","E01027754","Total",1292,74,31,43,1218,41,80,431,190,233,134,109
"2011","Richmondshire 004E","E01027771","Total",1606,14,7,7,1592,54,22,833,206,243,172,62
"2011","Richmondshire 004F","E01027772","Total",1258,126,48,78,1132,53,130,240,308,43,145,213
"2011","Richmondshire 004G","E01033183","Total",1599,2,0,2,1597,39,0,822,108,378,186,64
"2011","Richmondshire 004H","E01033184","Total",1502,35,6,29,1467,111,10,627,262,157,153,147
"2011","Richmondshire 005A","E01027742","Total",1328,204,111,93,1124,17,268,197,272,48,116,206
"2011","Richmondshire 005B","E01027753","Total",1343,178,77,101,1165,33,202,256,294,37,138,205
"2011","Richmondshire 005C","E01027763","Total",1133,165,81,84,968,12,262,182,266,36,69,141
"2011","Richmondshire 005D","E01027764","Total",1225,144,73,71,1081,17,218,218,254,61,130,183
"2011","Richmondshire 005E","E01027773","Total",1068,134,67,67,934,12,222,156,250,48,75,171
"2011","Richmondshire 006A","E01027744","Total",1267,159,81,78,1108,33,316,227,248,58,69,157
"2011","Richmondshire 006B","E01027756","Total",1763,153,65,88,1610,105,148,483,364,98,154,258
"2011","Richmondshire 006D","E01027758","Total",1368,134,66,68,1234,28,264,259,266,76,95,246
"2011","Richmondshire 006E","E01027760","Total",1272,179,83,96,1093,33,242,161,252,91,70,244
"2011","Richmondshire 006F","E01033185","Total",1245,223,132,91,1022,56,252,198,200,48,51,217
"2011","Richmondshire 006G","E01033186","Total",1268,201,137,64,1067,32,314,169,242,47,79,184
"2011","Ryedale 001A","E01027776","Total",1531,163,97,66,1368,44,296,209,268,125,154,272
"2011","Ryedale 001B","E01027777","Total",1401,148,66,82,1253,36,274,197,256,78,143,269
"2011","Ryedale 001C","E01027783","Total",1759,244,140,104,1515,47,408,292,292,67,122,287
"2011","Ryedale 001D","E01027784","Total",1678,262,159,103,1416,85,270,308,264,123,146,220
"2011","Ryedale 002A","E01027792","Total",1750,319,190,129,1431,50,392,278,312,45,136,218
"2011","Ryedale 002B","E01027793","Total",1418,237,140,97,1181,66,212,246,216,66,139,236
"2011","Ryedale 002C","E01027794","Total",2000,207,140,67,1793,85,428,363,346,135,147,289
"2011","Ryedale 002D","E01027795","Total",1581,252,135,117,1329,86,202,276,260,125,103,277
"2011","Ryedale 002E","E01027801","Total",1598,247,169,78,1351,43,334,241,272,76,115,270
"2011","Ryedale 002F","E01027802","Total",1609,178,96,82,1431,36,284,270,354,69,186,232
"2011","Ryedale 003A","E01027775","Total",1486,175,97,78,1311,32,274,257,216,74,182,276
"2011","Ryedale 003B","E01027780","Total",1780,217,112,105,1563,48,302,313,320,92,140,348
"2011","Ryedale 003C","E01027781","Total",1249,240,155,85,1009,54,306,198,200,20,81,150
"2011","Ryedale 003D","E01027800","Total",1683,174,109,65,1509,37,312,273,332,110,153,292
"2011","Ryedale 004A","E01027779","Total",1157,108,62,46,1049,47,194,186,212,75,152,183
"2011","Ryedale 004B","E01027796","Total",1743,221,137,84,1522,39,286,369,312,103,128,285
"2011","Ryedale 004C","E01027798","Total",1977,202,109,93,1775,110,250,417,338,89,188,383
"2011","Ryedale 004D","E01027803","Total",1801,140,57,83,1661,47,226,395,366,181,176,270
"2011","Ryedale 007A","E01027774","Total",2010,198,99,99,1812,74,306,444,326,159,180,323
"2011","Ryedale 007B","E01027778","Total",2285,269,137,132,2016,74,358,449,458,98,234,345
"2011","Ryedale 007C","E01027782","Total",1645,214,129,85,1431,54,322,264,360,42,124,265
"2011","Ryedale 007D","E01027797","Total",1688,163,79,84,1525,35,274,279,364,82,213,278
"2011","Ryedale 007E","E01027799","Total",1729,195,112,83,1534,55,296,288,348,125,132,290
"2011","Ryedale 008A","E01027785","Total",1516,398,150,248,1118,91,152,290,268,71,80,166
"2011","Ryedale 008B","E01027786","Total",1534,188,107,81,1346,28,344,233,248,67,140,286
"2011","Ryedale 008C","E01027787","Total",1731,229,118,111,1502,89,258,273,234,153,163,332
"2011","Ryedale 008D","E01027788","Total",1405,216,140,76,1189,37,256,247,238,36,99,276
"2011","Ryedale 008E","E01027789","Total",2432,339,149,190,2093,167,204,587,424,167,191,353
"2011","Ryedale 008F","E01027790","Total",1896,246,77,169,1650,87,172,408,374,96,226,287
"2011","Ryedale 008G","E01027791","Total",1539,157,90,67,1382,34,198,364,298,87,131,270
"2011","Scarborough 001A","E01027837","Total",1403,261,171,90,1142,118,228,208,200,90,96,202
"2011","Scarborough 001B","E01027839","Total",1661,194,119,75,1467,74,232,381,256,134,134,256
"2011","Scarborough 001C","E01027869","Total",966,369,110,259,597,40,144,85,206,10,28,84
"2011","Scarborough 001D","E01027870","Total",1272,291,145,146,981,116,200,148,282,20,65,150
"2011","Scarborough 001E","E01027871","Total",1454,256,157,99,1198,70,248,255,224,45,109,247
"2011","Scarborough 002A","E01027813","Total",2061,214,118,96,1847,38,344,275,348,88,306,448
"2011","Scarborough 002B","E01027822","Total",1391,172,87,85,1219,26,202,221,276,83,176,235
"2011","Scarborough 002C","E01027840","Total",2091,356,182,174,1735,99,296,318,354,108,174,386
"2011","Scarborough 002D","E01027841","Total",1310,161,92,69,1149,25,224,211,266,48,122,253
"2011","Scarborough 003A","E01027838","Total",1556,178,93,85,1378,38,310,235,280,85,147,283
"2011","Scarborough 003B","E01027864","Total",1456,149,56,93,1307,103,150,309,208,106,160,271
"2011","Scarborough 003C","E01027865","Total",1612,309,97,212,1303,130,168,241,298,51,129,286
"2011","Scarborough 003D","E01027866","Total",1495,209,91,118,1286,79,192,266,246,72,139,292
"2011","Scarborough 004A","E01027821","Total",1403,184,108,76,1219,37,354,177,248,25,133,245
"2011","Scarborough 004B","E01027823","Total",1429,197,133,64,1232,47,332,249,228,74,97,205
"2011","Scarborough 004C","E01027831","Total",1045,120,64,56,925,32,214,181,180,57,71,190
"2011","Scarborough 004D","E01027832","Total",918,159,89,70,759,19,160,95,196,46,65,178
"2011","Scarborough 004E","E01027836","Total",2203,290,181,109,1913,78,458,413,418,76,113,357
"2011","Scarborough 004F","E01027857","Total",1283,144,89,55,1139,29,260,214,212,69,141,214
"2011","Scarborough 005A","E01027842","Total",1625,200,118,82,1425,93,284,281,244,71,149,303
"2011","Scarborough 005B","E01027843","Total",1401,197,118,79,1204,93,206,307,208,75,127,188
"2011","Scarborough 005C","E01027844","Total",1556,142,84,58,1414,35,264,311,300,54,155,295
"2011","Scarborough 005D","E01027845","Total",1718,185,113,72,1533,67,252,323,266,96,172,357
"2011","Scarborough 005E","E01027855","Total",1478,130,83,47,1348,16,352,227,240,57,204,252
"2011","Scarborough 005F","E01027856","Total",1153,246,197,49,907,8,372,132,140,42,66,147
"2011","Scarborough 006A","E01027805","Total",1475,358,145,213,1117,132,180,171,272,69,91,202
"2011","Scarborough 006B","E01027806","Total",1693,511,146,365,1182,119,88,240,288,57,139,251
"2011","Scarborough 006C","E01027846","Total",1764,254,64,190,1510,136,160,365,250,117,204,278
"2011","Scarborough 006D","E01027847","Total",1789,544,121,423,1245,125,114,232,342,82,135,215
"2011","Scarborough 006E","E01027848","Total",1052,129,66,63,923,31,184,235,146,61,101,165
"2011","Scarborough 007A","E01027849","Total",1100,183,105,78,917,32,234,133,152,67,107,192
"2011","Scarborough 007B","E01027850","Total",1302,273,141,132,1029,88,142,232,160,88,158,161
"2011","Scarborough 007C","E01027872","Total",1455,182,89,93,1273,119,162,228,196,107,180,281
"2011","Scarborough 007D","E01027874","Total",1658,159,68,91,1499,252,98,299,204,173,257,216
"2011","Scarborough 008A","E01027810","Total",1691,162,48,114,1529,188,80,390,242,124,208,297
"2011","Scarborough 008B","E01027811","Total",1708,177,55,122,1531,248,110,400,260,104,143,266
"2011","Scarborough 008C","E01027812","Total",1783,224,83,141,1559,230,112,422,238,102,151,304
"2011","Scarborough 008D","E01027851","Total",1537,162,54,108,1375,77,138,355,254,72,168,311
"2011","Scarborough 008E","E01027862","Total",1571,297,90,207,1274,139,140,284,286,83,115,227
"2011","Scarborough 009A","E01027824","Total",1426,310,214,96,1116,42,254,167,210,58,139,246
"2011","Scarborough 009B","E01027825","Total",1787,222,62,160,1565,156,90,456,328,146,171,218
"2011","Scarborough 009C","E01027826","Total",1489,214,83,131,1275,140,118,349,246,58,121,243
"2011","Scarborough 009D","E01027861","Total",1295,274,120,154,1021,103,140,203,216,71,97,191
"2011","Scarborough 009E","E01027863","Total",1372,216,146,70,1156,27,330,179,240,44,125,211
"2011","Scarborough 009F","E01027873","Total",1482,292,161,131,1190,50,226,262,232,60,112,248
"2011","Scarborough 010A","E01027804","Total",1453,465,87,378,988,137,96,119,324,28,50,234
"2011","Scarborough 010B","E01027852","Total",1518,493,111,382,1025,66,156,139,342,10,50,262
"2011","Scarborough 010C","E01027853","Total",1189,311,123,188,878,64,204,147,236,21,54,152
"2011","Scarborough 010D","E01027854","Total",1358,481,155,326,877,53,148,91,402,20,54,109
"2011","Scarborough 010E","E01027868","Total",1967,605,322,283,1362,38,444,208,386,44,50,192
"2011","Scarborough 011A","E01027807","Total",1464,167,102,65,1297,52,300,263,236,69,128,249
"2011","Scarborough 011B","E01027808","Total",1440,156,96,60,1284,50,380,210,244,62,90,248
"2011","Scarborough 011C","E01027809","Total",1248,223,142,81,1025,35,346,168,246,36,48,146
"2011","Scarborough 011D","E01027818","Total",1371,158,82,76,1213,103,170,342,300,44,94,160
"2011","Scarborough 011E","E01027867","Total",1350,176,121,55,1174,22,340,236,232,60,94,190
"2011","Scarborough 012A","E01027817","Total",1379,195,77,118,1184,164,112,217,178,81,210,222
"2011","Scarborough 012B","E01027819","Total",1432,189,78,111,1243,182,114,279,128,133,189,218
"2011","Scarborough 012C","E01027820","Total",1400,107,44,63,1293,167,104,326,154,173,195,174
"2011","Scarborough 012D","E01027858","Total",1377,144,87,57,1233,24,296,251,252,58,112,240
"2011","Scarborough 012E","E01027860","Total",1545,151,86,65,1394,84,232,349,232,97,138,262
"2011","Scarborough 013A","E01027814","Total",1565,176,103,73,1389,49,310,260,262,89,168,251
"2011","Scarborough 013B","E01027815","Total",1322,151,83,68,1171,40,240,220,306,63,120,182
"2011","Scarborough 013C","E01027816","Total",1571,193,124,69,1378,52,316,297,260,74,120,259
"2011","Scarborough 013D","E01027859","Total",1720,159,90,69,1561,42,262,385,336,64,199,273
"2011","Scarborough 014A","E01027827","Total",1614,442,240,202,1172,52,268,168,310,51,135,188
"2011","Scarborough 014B","E01027828","Total",1636,250,196,54,1386,47,508,200,226,45,113,247
"2011","Scarborough 014C","E01027829","Total",1471,274,175,99,1197,33,476,159,242,39,53,195
"2011","Scarborough 014D","E01027830","Total",1806,186,97,89,1620,105,242,385,246,152,196,294
"2011","Scarborough 014E","E01027833","Total",1581,232,136,96,1349,51,348,182,294,47,152,275
"2011","Scarborough 014F","E01027834","Total",1542,227,154,73,1315,76,362,211,256,61,100,249
"2011","Scarborough 014G","E01027835","Total",1739,199,96,103,1540,64,324,230,314,75,242,291
"2011","Selby 001A","E01027918","Total",1485,215,97,118,1270,37,140,331,254,144,125,239
"2011","Selby 001B","E01027919","Total",1149,176,64,112,973,32,122,236,188,53,127,215
"2011","Selby 001C","E01027920","Total",1187,116,58,58,1071,33,138,242,226,22,103,307
"2011","Selby 001D","E01027921","Total",1732,339,199,140,1393,50,310,330,278,39,80,306
"2011","Selby 001E","E01027922","Total",1699,132,81,51,1567,25,258,384,256,134,139,371
"2011","Selby 002A","E01027875","Total",1865,114,63,51,1751,25,292,403,294,195,214,328
"2011","Selby 002B","E01027886","Total",1334,137,56,81,1197,42,174,392,248,30,121,190
"2011","Selby 002C","E01027887","Total",1548,157,48,109,1391,37,184,353,364,84,126,243
"2011","Selby 002D","E01027888","Total",1754,144,41,103,1610,27,190,583,336,73,136,265
"2011","Selby 002E","E01027904","Total",2310,173,69,104,2137,60,220,603,416,213,239,386
"2011","Selby 003A","E01027876","Total",1635,125,54,71,1510,63,192,398,310,106,155,286
"2011","Selby 003B","E01027877","Total",1225,120,52,68,1105,34,150,250,248,97,71,255
"2011","Selby 003C","E01027900","Total",1902,133,69,64,1769,95,166,529,412,102,158,307
"2011","Selby 003D","E01027901","Total",1541,124,56,68,1417,33,220,363,334,104,86,277
"2011","Selby 003E","E01027902","Total",1490,122,64,58,1368,103,206,293,262,93,181,230
"2011","Selby 003F","E01027903","Total",1025,89,50,39,936,15,164,272,152,77,89,167
"2011","Selby 004A","E01027898","Total",2363,255,134,121,2108,76,232,604,492,112,183,409
"2011","Selby 004B","E01027914","Total",1680,132,63,69,1548,44,214,308,316,84,208,374
"2011","Selby 004C","E01027915","Total",1614,227,115,112,1387,56,188,301,296,122,142,282
"2011","Selby 004D","E01027916","Total",1504,198,86,112,1306,89,138,268,272,97,158,284
"2011","Selby 004E","E01027917","Total",1831,121,41,80,1710,75,128,539,320,85,159,404
"2011","Selby 005A","E01027878","Total",1272,158,56,102,1114,102,80,340,214,36,106,236
"2011","Selby 005B","E01027905","Total",1831,319,92,227,1512,101,144,343,380,80,97,367
"2011","Selby 005C","E01027907","Total",1377,168,70,98,1209,158,122,247,164,118,171,229
"2011","Selby 005D","E01027908","Total",1562,333,139,194,1229,101,118,274,302,72,128,234
"2011","Selby 005E","E01027909","Total",1996,346,116,230,1650,144,126,403,444,64,167,302
"2011","Selby 005F","E01027910","Total",2759,273,114,159,2486,254,154,662,492,208,316,400
"2011","Selby 006A","E01027881","Total",1294,188,126,62,1106,49,230,221,218,82,89,217
"2011","Selby 006B","E01027906","Total",1424,152,59,93,1272,96,112,304,242,81,183,254
"2011","Selby 006C","E01027911","Total",1352,194,112,82,1158,29,254,214,244,76,113,228
"2011","Selby 006D","E01027912","Total",1030,101,67,34,929,13,148,216,180,40,115,217
"2011","Selby 006E","E01027913","Total",1191,105,71,34,1086,31,220,256,162,55,108,254
"2011","Selby 007A","E01027879","Total",1345,137,60,77,1208,31,170,296,250,51,136,274
"2011","Selby 007B","E01027880","Total",1583,99,61,38,1484,32,296,350,256,51,166,333
"2011","Selby 007C","E01027882","Total",1827,105,48,57,1722,48,186,479,382,92,219,316
"2011","Selby 007D","E01027894","Total",1889,163,72,91,1726,63,250,399,372,118,207,317
"2011","Selby 007E","E01027895","Total",1567,148,82,66,1419,39,306,259,316,83,118,298
"2011","Selby 008A","E01027883","Total",1116,93,49,44,1023,55,142,178,202,46,148,252
"2011","Selby 008B","E01027884","Total",1565,138,58,80,1427,73,148,366,268,96,175,301
"2011","Selby 008C","E01027885","Total",1562,164,83,81,1398,53,222,369,256,80,123,295
"2011","Selby 008D","E01027896","Total",1998,178,87,91,1820,94,196,522,374,70,207,357
"2011","Selby 008E","E01027897","Total",2100,156,79,77,1944,32,278,504,424,110,212,384
"2011","Selby 009A","E01027891","Total",1672,207,89,118,1465,67,238,239,364,103,121,333
"2011","Selby 009B","E01027892","Total",1866,273,93,180,1593,114,218,365,342,90,156,308
"2011","Selby 009C","E01027893","Total",1841,155,75,80,1686,39,268,429,398,114,142,296
"2011","Selby 009D","E01027899","Total",1721,130,66,64,1591,93,218,478,286,122,128,266
"2011","Selby 010A","E01027889","Total",1768,171,78,93,1597,148,192,383,312,93,154,315
"2011","Selby 010B","E01027890","Total",1959,161,79,82,1798,41,274,425,394,98,204,362
"2011","Selby 010C","E01027923","Total",2266,226,116,110,2040,74,324,500,380,107,200,455
"2011","Selby 010D","E01027924","Total",2119,143,56,87,1976,64,208,497,482,129,239,357
"2011","Barnsley 001A","E01007434","Total",1924,270,99,171,1654,138,158,478,310,103,155,312
"2011","Barnsley 001B","E01007435","Total",1579,278,138,140,1301,78,164,244,244,170,145,256
"2011","Barnsley 001C","E01007438","Total",1497,160,94,66,1337,83,204,353,202,25,142,328
"2011","Barnsley 001D","E01007439","Total",1210,106,53,53,1104,37,168,239,218,45,102,295
"2011","Barnsley 002A","E01007433","Total",1615,176,77,99,1439,135,198,338,216,57,163,332
"2011","Barnsley 002B","E01007436","Total",1267,161,79,82,1106,68,198,197,226,108,90,219
"2011","Barnsley 002C","E01007437","Total",1476,176,59,117,1300,106,118,311,258,60,156,291
"2011","Barnsley 002D","E01007440","Total",1520,216,83,133,1304,133,122,296,264,113,130,246
"2011","Barnsley 003A","E01007329","Total",1565,161,74,87,1404,89,164,386,238,138,148,241
"2011","Barnsley 003B","E01007331","Total",1853,223,90,133,1630,110,260,366,382,78,138,296
"2011","Barnsley 003C","E01007342","Total",1398,104,44,60,1294,143,206,218,242,42,174,269
"2011","Barnsley 003D","E01007343","Total",1346,247,152,95,1099,87,172,215,226,41,129,229
"2011","Barnsley 004A","E01007356","Total",1381,146,79,67,1235,62,248,248,246,47,142,242
"2011","Barnsley 004B","E01007357","Total",1347,177,84,93,1170,95,144,285,252,51,136,207
"2011","Barnsley 004C","E01007361","Total",1585,195,57,138,1390,105,120,433,334,41,87,270
"2011","Barnsley 004D","E01007362","Total",1633,166,76,90,1467,36,220,403,312,62,148,286
"2011","Barnsley 004E","E01007363","Total",1575,288,145,143,1287,103,232,277,270,46,104,255
"2011","Barnsley 005A","E01007355","Total",1537,110,46,64,1427,66,146,452,266,92,175,230
"2011","Barnsley 005B","E01007358","Total",1497,160,64,96,1337,91,164,383,310,61,126,202
"2011","Barnsley 005C","E01007359","Total",1509,199,90,109,1310,90,188,338,240,86,157,211
"2011","Barnsley 005D","E01007360","Total",1522,169,97,72,1353,62,256,255,250,67,174,289
"2011","Barnsley 005E","E01007386","Total",1701,202,108,94,1499,49,324,375,312,40,116,283
"2011","Barnsley 006A","E01007328","Total",1899,247,103,144,1652,176,154,362,282,90,272,316
"2011","Barnsley 006B","E01007330","Total",1708,177,81,96,1531,100,216,345,328,62,178,302
"2011","Barnsley 006C","E01007332","Total",2203,288,119,169,1915,215,176,451,484,154,172,263
"2011","Barnsley 006D","E01007333","Total",1331,92,38,54,1239,166,120,228,160,118,181,266
"2011","Barnsley 007A","E01007323","Total",1483,167,48,119,1316,162,94,356,244,89,137,234
"2011","Barnsley 007B","E01007324","Total",1667,249,121,128,1418,162,156,291,266,68,169,306
"2011","Barnsley 007C","E01007325","Total",1689,113,41,72,1576,288,92,311,192,205,204,284
"2011","Barnsley 007D","E01007326","Total",1525,206,111,95,1319,102,142,259,232,82,208,294
"2011","Barnsley 007E","E01007327","Total",1676,299,169,130,1377,96,252,229,292,74,157,277
"2011","Barnsley 007F","E01007411","Total",1191,162,59,103,1029,143,74,188,150,104,174,196
"2011","Barnsley 008A","E01007341","Total",1264,149,54,95,1115,141,108,216,172,83,193,202
"2011","Barnsley 008B","E01007345","Total",1567,189,68,121,1378,155,126,352,278,76,129,262
"2011","Barnsley 008C","E01007346","Total",1620,173,71,102,1447,155,132,359,240,61,190,310
"2011","Barnsley 008D","E01007347","Total",1594,182,75,107,1412,80,162,392,254,71,178,275
"2011","Barnsley 009A","E01007334","Total",1356,101,35,66,1255,48,166,291,276,25,135,314
"2011","Barnsley 009B","E01007335","Total",1454,143,74,69,1311,56,160,317,264,80,102,332
"2011","Barnsley 009C","E01007400","Total",2017,200,106,94,1817,81,236,494,396,131,150,329
"2011","Barnsley 009D","E01007404","Total",1287,169,106,63,1118,43,240,159,302,32,96,246
"2011","Barnsley 009E","E01007406","Total",1720,345,150,195,1375,146,222,265,258,98,149,237
"2011","Barnsley 010C","E01007408","Total",1485,183,86,97,1302,73,192,331,220,78,182,226
"2011","Barnsley 010D","E01007409","Total",1428,198,87,111,1230,56,146,321,228,38,155,286
"2011","Barnsley 010E","E01007410","Total",1631,373,118,255,1258,120,202,255,310,42,105,224
"2011","Barnsley 010G","E01032550","Total",2841,334,121,213,2507,249,210,637,448,162,348,453
"2011","Barnsley 010H","E01032551","Total",2567,290,117,173,2277,115,280,601,460,187,247,387
"2011","Barnsley 011A","E01007344","Total",2128,240,81,159,1888,149,182,510,364,150,200,333
"2011","Barnsley 011B","E01007402","Total",1660,161,70,91,1499,147,136,343,242,159,244,228
"2011","Barnsley 011C","E01007403","Total",1495,160,84,76,1335,148,120,263,232,125,158,289
"2011","Barnsley 011D","E01007405","Total",1334,154,83,71,1180,76,234,157,260,74,114,265
"2011","Barnsley 012A","E01007379","Total",1591,164,86,78,1427,64,268,273,340,61,176,245
"2011","Barnsley 012B","E01007380","Total",1810,163,85,78,1647,47,218,463,338,75,170,336
"2011","Barnsley 012C","E01007381","Total",1547,187,107,80,1360,64,202,319,238,52,165,320
"2011","Barnsley 012D","E01007387","Total",1452,158,78,80,1294,55,156,331,294,104,133,221
"2011","Barnsley 012E","E01007442","Total",1377,183,126,57,1194,24,334,219,246,26,133,212
"2011","Barnsley 012F","E01007444","Total",1516,305,147,158,1211,75,250,276,280,36,73,221
"2011","Barnsley 012G","E01007446","Total",1308,221,122,99,1087,47,280,220,234,65,68,173
"2011","Barnsley 013A","E01007336","Total",1543,306,79,227,1237,133,134,277,298,27,98,270
"2011","Barnsley 013B","E01007340","Total",1636,266,61,205,1370,140,70,322,324,78,155,281
"2011","Barnsley 013C","E01007415","Total",1478,167,74,93,1311,60,172,307,292,89,159,232
"2011","Barnsley 013D","E01007417","Total",1552,255,83,172,1297,209,102,313,322,48,75,228
"2011","Barnsley 013E","E01007441","Total",1537,260,73,187,1277,153,98,348,334,20,107,217
"2011","Barnsley 013F","E01007443","Total",2000,429,79,350,1571,185,102,370,458,79,131,246
"2011","Barnsley 013G","E01007445","Total",1451,303,100,203,1148,98,138,282,310,57,83,180
"2011","Barnsley 014A","E01007372","Total",1281,178,105,73,1103,160,102,199,168,136,154,184
"2011","Barnsley 014B","E01007373","Total",1594,202,72,130,1392,179,146,271,220,119,186,271
"2011","Barnsley 014C","E01007374","Total",1470,168,89,79,1302,100,270,274,230,36,102,290
"2011","Barnsley 014D","E01007375","Total",1605,185,101,84,1420,67,202,301,280,62,169,339
"2011","Barnsley 014E","E01007377","Total",1105,122,48,74,983,115,74,222,148,71,143,210
"2011","Barnsley 014F","E01007378","Total",1556,325,152,173,1231,169,124,222,202,134,119,261
"2011","Barnsley 015A","E01007319","Total",1465,128,73,55,1337,44,260,312,240,48,156,277
"2011","Barnsley 015B","E01007321","Total",1433,182,109,73,1251,35,282,265,254,25,102,288
"2011","Barnsley 015C","E01007322","Total",2004,284,82,202,1720,165,110,441,452,97,169,286
"2011","Barnsley 015D","E01007337","Total",1775,334,60,274,1441,141,106,429,408,53,97,207
"2011","Barnsley 016A","E01007418","Total",1279,190,115,75,1089,46,264,235,218,41,92,193
"2011","Barnsley 016B","E01007419","Total",1721,155,83,72,1566,61,260,481,310,81,112,261
"2011","Barnsley 016C","E01007420","Total",1432,149,98,51,1283,53,226,358,250,27,104,265
"2011","Barnsley 016D","E01007425","Total",1470,140,78,62,1330,21,282,331,264,69,85,278
"2011","Barnsley 017A","E01007338","Total",1533,526,275,251,1007,92,232,181,222,38,72,170
"2011","Barnsley 017B","E01007339","Total",1479,298,72,226,1181,141,100,292,294,62,112,180
"2011","Barnsley 017C","E01007413","Total",1349,215,74,141,1134,198,98,268,186,111,116,157
"2011","Barnsley 017D","E01007414","Total",1572,227,83,144,1345,172,108,329,306,85,121,224
"2011","Barnsley 018A","E01007317","Total",1493,198,86,112,1295,124,170,270,246,91,168,226
"2011","Barnsley 018B","E01007318","Total",1507,177,72,105,1330,164,116,318,274,111,165,182
"2011","Barnsley 018C","E01007320","Total",1596,186,70,116,1410,195,138,299,246,108,151,273
"2011","Barnsley 018D","E01007416","Total",1194,157,68,89,1037,102,120,212,194,86,140,183
"2011","Barnsley 019A","E01007382","Total",1483,235,99,136,1248,84,220,288,226,61,141,228
"2011","Barnsley 019B","E01007383","Total",1370,84,21,63,1286,45,74,415,246,46,170,290
"2011","Barnsley 019C","E01007384","Total",1614,175,102,73,1439,66,234,345,336,44,135,279
"2011","Barnsley 019D","E01007385","Total",1369,267,134,133,1102,69,218,227,202,37,149,200
"2011","Barnsley 020A","E01007348","Total",1399,185,121,64,1214,113,206,203,200,82,146,264
"2011","Barnsley 020B","E01007349","Total",1529,208,96,112,1321,104,196,321,238,64,190,208
"2011","Barnsley 020C","E01007350","Total",1183,114,71,43,1069,36,290,134,218,54,108,229
"2011","Barnsley 020D","E01007351","Total",1426,188,77,111,1238,92,198,312,274,70,115,177
"2011","Barnsley 020E","E01007352","Total",1412,191,103,88,1221,143,136,245,240,75,121,261
"2011","Barnsley 020F","E01007353","Total",1583,153,47,106,1430,134,158,344,268,111,124,291
"2011","Barnsley 020G","E01007354","Total",1645,177,58,119,1468,99,166,371,310,67,155,300
"2011","Barnsley 021A","E01007458","Total",1432,176,51,125,1256,72,134,260,290,77,169,254
"2011","Barnsley 021B","E01007459","Total",1509,215,137,78,1294,56,364,186,302,21,85,280
"2011","Barnsley 021C","E01007460","Total",1427,160,81,79,1267,61,220,202,254,72,192,266
"2011","Barnsley 021D","E01007461","Total",1641,303,121,182,1338,157,154,286,246,76,170,249
"2011","Barnsley 021E","E01007462","Total",1602,193,84,109,1409,156,146,307,220,112,223,245
"2011","Barnsley 021F","E01007463","Total",1747,257,120,137,1490,216,210,335,230,67,199,233
"2011","Barnsley 022A","E01007369","Total",1490,229,55,174,1261,150,136,279,312,141,66,177
"2011","Barnsley 022B","E01007370","Total",1389,177,79,98,1212,138,126,256,218,64,134,276
"2011","Barnsley 022C","E01007371","Total",1954,204,65,139,1750,150,204,437,322,104,229,304
"2011","Barnsley 022D","E01007376","Total",1403,232,92,140,1171,124,92,264,274,96,117,204
"2011","Barnsley 023A","E01007447","Total",1538,197,124,73,1341,101,186,319,224,84,186,241
"2011","Barnsley 023B","E01007448","Total",1593,286,61,225,1307,161,116,314,324,76,74,242
"2011","Barnsley 023C","E01007449","Total",1770,236,75,161,1534,132,186,347,416,79,94,280
"2011","Barnsley 023D","E01007450","Total",1497,263,123,140,1234,86,202,224,240,76,129,277
"2011","Barnsley 024A","E01007427","Total",1554,172,67,105,1382,55,208,390,318,80,117,214
"2011","Barnsley 024B","E01007428","Total",1444,201,100,101,1243,63,162,318,296,60,104,240
"2011","Barnsley 024C","E01007429","Total",1422,310,211,99,1112,65,192,198,278,40,136,203
"2011","Barnsley 024D","E01007430","Total",2273,170,56,114,2103,118,124,753,504,108,207,289
"2011","Barnsley 024E","E01007431","Total",1363,100,47,53,1263,51,168,313,246,39,142,304
"2011","Barnsley 024F","E01007432","Total",1431,128,61,67,1303,53,164,361,230,77,133,285
"2011","Barnsley 025A","E01007364","Total",1390,176,93,83,1214,100,152,259,204,65,184,250
"2011","Barnsley 025B","E01007365","Total",1203,156,73,83,1047,94,110,253,180,66,154,190
"2011","Barnsley 025C","E01007366","Total",2005,193,71,122,1812,97,198,508,424,95,135,355
"2011","Barnsley 025D","E01007367","Total",1178,115,58,57,1063,118,86,200,204,73,145,237
"2011","Barnsley 025E","E01007368","Total",1626,213,80,133,1413,129,114,350,302,112,172,234
"2011","Barnsley 026A","E01007451","Total",1683,219,99,120,1464,138,146,382,288,77,166,267
"2011","Barnsley 026B","E01007452","Total",1555,132,54,78,1423,102,140,415,308,85,125,248
"2011","Barnsley 026C","E01007453","Total",1558,204,119,85,1354,176,136,231,200,128,217,266
"2011","Barnsley 026E","E01007455","Total",1358,122,58,64,1236,35,262,212,272,51,131,273
"2011","Barnsley 026F","E01032924","Total",1535,131,29,102,1404,62,54,517,344,86,186,155
"2011","Barnsley 026G","E01032925","Total",1327,197,112,85,1130,114,150,333,214,41,120,158
"2011","Barnsley 027A","E01007421","Total",1320,119,51,68,1201,9,230,256,280,31,111,284
"2011","Barnsley 027B","E01007422","Total",1571,144,69,75,1427,52,188,376,274,102,210,225
"2011","Barnsley 027C","E01007423","Total",1655,175,95,80,1480,68,260,328,288,74,199,263
"2011","Barnsley 027D","E01007426","Total",1547,200,94,106,1347,61,208,298,320,78,140,242
"2011","Barnsley 028A","E01007396","Total",1580,262,119,143,1318,113,154,323,296,73,142,217
"2011","Barnsley 028B","E01007397","Total",1422,237,142,95,1185,75,226,271,228,62,106,217
"2011","Barnsley 028C","E01007398","Total",1619,225,136,89,1394,62,400,297,268,34,80,253
"2011","Barnsley 028D","E01007399","Total",2057,260,100,160,1797,122,198,544,370,71,172,320
"2011","Barnsley 028E","E01007424","Total",1671,194,100,94,1477,69,198,467,330,41,114,258
"2011","Barnsley 029A","E01007388","Total",1615,180,49,131,1435,67,134,407,344,100,75,308
"2011","Barnsley 029B","E01007393","Total",1811,274,113,161,1537,129,154,388,310,115,159,282
"2011","Barnsley 029C","E01007394","Total",1384,151,84,67,1233,114,150,215,188,107,152,307
"2011","Barnsley 029D","E01007456","Total",1756,194,66,128,1562,103,204,471,366,63,88,267
"2011","Barnsley 029E","E01007457","Total",1648,172,67,105,1476,104,170,398,302,118,179,205
"2011","Barnsley 030A","E01007389","Total",1396,179,103,76,1217,33,340,192,286,15,80,271
"2011","Barnsley 030B","E01007390","Total",1527,147,71,76,1380,88,200,346,288,44,115,299
"2011","Barnsley 030C","E01007391","Total",1468,247,143,104,1221,119,164,252,232,67,113,274
"2011","Barnsley 030D","E01007392","Total",1498,167,83,84,1331,96,118,275,230,139,203,270
"2011","Barnsley 030E","E01007395","Total",2016,236,119,117,1780,197,192,360,264,200,233,334
"2011","Doncaster 001A","E01007632","Total",1617,131,51,80,1486,112,118,362,246,117,240,291
"2011","Doncaster 001B","E01007633","Total",1355,120,43,77,1235,103,102,293,186,171,159,221
"2011","Doncaster 001C","E01007634","Total",1636,162,76,86,1474,142,158,353,248,186,149,238
"2011","Doncaster 001D","E01007635","Total",1410,145,65,80,1265,83,260,232,288,93,113,196
"2011","Doncaster 002A","E01007487","Total",1615,189,103,86,1426,114,242,302,244,78,149,297
"2011","Doncaster 002B","E01007488","Total",1735,182,76,106,1553,75,256,280,304,105,190,343
"2011","Doncaster 002C","E01007489","Total",1673,192,73,119,1481,107,180,349,314,108,131,292
"2011","Doncaster 002D","E01007490","Total",1550,155,74,81,1395,74,208,250,250,121,170,322
"2011","Doncaster 002E","E01007491","Total",1754,158,49,109,1596,239,136,309,190,178,258,286
"2011","Doncaster 002F","E01007492","Total",1496,247,130,117,1249,112,190,175,190,103,249,230
"2011","Doncaster 002G","E01007493","Total",1736,168,71,97,1568,53,220,443,292,97,154,309
"2011","Doncaster 003A","E01007636","Total",1517,198,94,104,1319,136,184,299,198,95,147,260
"2011","Doncaster 003B","E01007637","Total",1489,172,89,83,1317,154,242,251,240,84,110,236
"2011","Doncaster 003C","E01007638","Total",1587,214,100,114,1373,141,240,237,244,82,170,259
"2011","Doncaster 003D","E01007639","Total",1832,365,119,246,1467,96,210,344,344,48,128,297
"2011","Doncaster 003E","E01007640","Total",1616,175,97,78,1441,46,296,324,362,36,95,282
"2011","Doncaster 003F","E01007641","Total",1479,130,61,69,1349,66,142,354,254,96,154,283
"2011","Doncaster 003G","E01007642","Total",1605,177,88,89,1428,114,148,286,244,188,207,241
"2011","Doncaster 004A","E01007625","Total",1537,128,69,59,1409,54,224,338,244,69,200,280
"2011","Doncaster 004B","E01007626","Total",1193,203,66,137,990,78,140,128,198,63,195,188
"2011","Doncaster 004C","E01007627","Total",1671,215,115,100,1456,156,192,354,190,89,186,289
"2011","Doncaster 004D","E01007628","Total",1404,126,46,80,1278,126,96,276,206,110,208,256
"2011","Doncaster 004E","E01007629","Total",1606,201,96,105,1405,174,144,293,216,141,182,255
"2011","Doncaster 005A","E01007468","Total",1296,149,96,53,1147,29,340,172,268,32,74,232
"2011","Doncaster 005B","E01007469","Total",1326,134,43,91,1192,74,146,329,216,85,128,214
"2011","Doncaster 005C","E01007470","Total",1428,130,48,82,1298,128,98,341,202,130,141,258
"2011","Doncaster 005D","E01007472","Total",1593,212,93,119,1381,142,130,252,198,172,205,282
"2011","Doncaster 005E","E01007473","Total",1430,171,49,122,1259,147,104,288,224,91,133,272
"2011","Doncaster 005F","E01007474","Total",1321,257,159,98,1064,147,204,167,204,97,82,163
"2011","Doncaster 006A","E01007554","Total",1594,170,57,113,1424,56,172,411,310,62,147,266
"2011","Doncaster 006B","E01007555","Total",1464,189,109,80,1275,135,218,235,194,91,181,221
"2011","Doncaster 006C","E01007556","Total",1364,123,51,72,1241,134,90,329,178,82,136,292
"2011","Doncaster 006D","E01007561","Total",1393,99,43,56,1294,42,222,346,222,69,150,243
"2011","Doncaster 006E","E01007562","Total",1362,187,68,119,1175,73,166,254,256,85,120,221
"2011","Doncaster 006F","E01007563","Total",1451,112,32,80,1339,160,98,310,174,179,189,229
"2011","Doncaster 007A","E01007621","Total",1410,116,36,80,1294,53,110,386,212,87,169,277
"2011","Doncaster 007B","E01007622","Total",1515,183,75,108,1332,50,216,292,274,86,121,293
"2011","Doncaster 007C","E01007623","Total",1224,218,90,128,1006,75,172,283,194,56,45,181
"2011","Doncaster 007D","E01007624","Total",1858,175,61,114,1683,86,168,537,326,122,189,255
"2011","Doncaster 007E","E01007630","Total",1358,211,139,72,1147,69,318,183,220,46,119,192
"2011","Doncaster 007F","E01007631","Total",1221,125,78,47,1096,24,240,290,240,42,96,164
"2011","Doncaster 008A","E01007553","Total",1648,190,88,102,1458,52,236,316,314,46,169,325
"2011","Doncaster 008B","E01007557","Total",1002,105,41,64,897,41,148,197,176,84,101,150
"2011","Doncaster 008C","E01007558","Total",1453,155,80,75,1298,64,194,320,258,56,142,264
"2011","Doncaster 008D","E01007559","Total",941,91,52,39,850,27,190,131,160,39,95,208
"2011","Doncaster 008E","E01007560","Total",1497,151,79,72,1346,70,286,254,242,40,160,294
"2011","Doncaster 009A","E01007464","Total",1497,154,59,95,1343,138,102,286,242,101,204,270
"2011","Doncaster 009B","E01007465","Total",1483,183,104,79,1300,125,160,262,218,112,141,282
"2011","Doncaster 009C","E01007466","Total",1755,121,42,79,1634,210,112,412,228,229,219,224
"2011","Doncaster 009D","E01007467","Total",1523,196,95,101,1327,113,136,263,246,142,130,297
"2011","Doncaster 009E","E01007471","Total",1507,122,41,81,1385,42,152,373,246,46,167,359
"2011","Doncaster 009F","E01007504","Total",1532,164,84,80,1368,83,134,270,250,110,198,323
"2011","Doncaster 009G","E01007507","Total",1375,116,36,80,1259,146,52,263,160,183,214,241
"2011","Doncaster 010A","E01007506","Total",1397,150,51,99,1247,112,116,238,160,109,264,248
"2011","Doncaster 010B","E01007508","Total",1664,216,70,146,1448,206,94,354,194,156,164,280
"2011","Doncaster 010C","E01007509","Total",1758,298,144,154,1460,228,166,276,302,146,102,240
"2011","Doncaster 010D","E01007510","Total",1539,281,139,142,1258,133,136,329,256,20,153,231
"2011","Doncaster 010E","E01007511","Total",1576,148,62,86,1428,129,150,300,208,143,237,261
"2011","Doncaster 011A","E01007475","Total",1549,130,50,80,1419,65,134,412,310,75,124,299
"2011","Doncaster 011B","E01007476","Total",1439,223,146,77,1216,66,194,302,182,61,132,279
"2011","Doncaster 011C","E01007477","Total",1431,151,81,70,1280,48,238,257,210,84,167,276
"2011","Doncaster 011D","E01007478","Total",1532,179,87,92,1353,74,172,284,286,90,127,320
"2011","Doncaster 012A","E01007512","Total",1668,184,101,83,1484,96,168,375,354,107,144,240
"2011","Doncaster 012B","E01007513","Total",1435,220,136,84,1215,102,190,240,206,79,175,223
"2011","Doncaster 012C","E01007515","Total",1554,197,108,89,1357,97,158,259,236,122,180,305
"2011","Doncaster 012D","E01007518","Total",1486,158,79,79,1328,52,174,274,204,88,221,315
"2011","Doncaster 012E","E01007519","Total",1298,146,57,89,1152,80,84,252,202,73,203,258
"2011","Doncaster 013A","E01007505","Total",1654,189,100,89,1465,77,212,326,332,47,138,333
"2011","Doncaster 013B","E01007514","Total",1465,230,53,177,1235,130,86,311,268,67,91,282
"2011","Doncaster 013C","E01007516","Total",1336,154,88,66,1182,71,150,223,244,60,185,249
"2011","Doncaster 013D","E01007517","Total",1551,237,66,171,1314,182,98,319,256,75,138,246
"2011","Doncaster 014A","E01007479","Total",1593,172,93,79,1421,100,238,315,242,108,165,253
"2011","Doncaster 014B","E01007480","Total",1472,112,48,64,1360,130,96,297,208,69,273,287
"2011","Doncaster 014D","E01007482","Total",1350,253,146,107,1097,71,180,235,218,81,125,187
"2011","Doncaster 014E","E01033259","Total",1567,169,30,139,1398,102,86,489,326,55,120,220
"2011","Doncaster 014F","E01033260","Total",1611,148,42,106,1463,116,56,456,282,99,204,250
"2011","Doncaster 015A","E01007570","Total",1482,186,114,72,1296,42,230,253,254,86,154,277
"2011","Doncaster 015B","E01007650","Total",1649,335,182,153,1314,38,238,293,314,46,120,265
"2011","Doncaster 015C","E01007651","Total",1830,138,48,90,1692,211,110,386,228,231,181,345
"2011","Doncaster 015D","E01007652","Total",1889,263,116,147,1626,172,142,321,220,148,293,330
"2011","Doncaster 015E","E01007653","Total",1579,158,66,92,1421,99,124,356,252,67,152,371
"2011","Doncaster 015F","E01007656","Total",1589,177,100,77,1412,126,178,258,216,157,229,248
"2011","Doncaster 016A","E01007581","Total",1559,121,53,68,1438,49,222,395,240,52,177,303
"2011","Doncaster 016B","E01007582","Total",1457,146,62,84,1311,72,168,365,272,55,103,276
"2011","Doncaster 016C","E01007588","Total",1673,137,82,55,1536,87,222,402,250,113,218,244
"2011","Doncaster 016D","E01007589","Total",1712,186,121,65,1526,35,292,345,218,98,183,355
"2011","Doncaster 017A","E01007483","Total",1381,162,63,99,1219,41,176,272,294,45,153,238
"2011","Doncaster 017B","E01007484","Total",1382,208,110,98,1174,60,190,237,230,62,140,255
"2011","Doncaster 017C","E01007485","Total",1435,137,51,86,1298,51,124,397,288,73,119,246
"2011","Doncaster 017D","E01007486","Total",1317,188,120,68,1129,35,298,169,286,26,70,245
"2011","Doncaster 018A","E01007564","Total",1536,170,84,86,1366,131,132,323,176,170,169,265
"2011","Doncaster 018B","E01007565","Total",1512,177,104,73,1335,20,186,366,268,103,179,213
"2011","Doncaster 018C","E01007566","Total",1626,316,134,182,1310,137,168,269,270,62,182,222
"2011","Doncaster 018D","E01007567","Total",1302,123,71,52,1179,85,108,252,220,82,180,252
"2011","Doncaster 018E","E01007568","Total",1662,133,47,86,1529,225,76,321,194,195,306,212
"2011","Doncaster 018F","E01007569","Total",1601,168,89,79,1433,107,128,305,214,142,217,320
"2011","Doncaster 019A","E01007644","Total",1475,145,71,74,1330,53,134,325,228,71,202,317
"2011","Doncaster 019B","E01007646","Total",1341,218,60,158,1123,56,124,191,260,42,152,298
"2011","Doncaster 019C","E01007647","Total",1472,277,117,160,1195,40,122,251,282,62,149,289
"2011","Doncaster 019D","E01007648","Total",1855,370,79,291,1485,100,76,216,360,116,220,397
"2011","Doncaster 019E","E01007649","Total",1549,152,57,95,1397,57,122,337,270,93,192,326
"2011","Doncaster 019F","E01007654","Total",1525,182,44,138,1343,94,114,259,230,96,238,312
"2011","Doncaster 020A","E01007583","Total",1452,154,74,80,1298,32,272,248,272,47,150,277
"2011","Doncaster 020B","E01007586","Total",1487,169,97,72,1318,40,220,297,288,18,149,306
"2011","Doncaster 020C","E01007587","Total",1542,226,126,100,1316,43,302,215,302,55,120,279
"2011","Doncaster 020D","E01007620","Total",1606,156,82,74,1450,44,270,321,356,15,127,317
"2011","Doncaster 021A","E01007584","Total",1548,187,83,104,1361,79,206,351,280,81,137,227
"2011","Doncaster 021B","E01007585","Total",1585,145,65,80,1440,83,192,370,210,82,216,287
"2011","Doncaster 021C","E01007617","Total",1511,138,94,44,1373,67,312,345,242,35,114,258
"2011","Doncaster 021D","E01007618","Total",1248,98,61,37,1150,63,192,214,222,47,145,267
"2011","Doncaster 021E","E01007619","Total",1810,135,72,63,1675,54,264,490,270,98,201,298
"2011","Doncaster 022A","E01007529","Total",1448,221,32,189,1227,170,62,295,292,93,114,201
"2011","Doncaster 022B","E01007530","Total",1206,183,53,130,1023,101,54,271,174,72,164,187
"2011","Doncaster 022C","E01007531","Total",1618,332,149,183,1286,122,154,307,276,68,163,196
"2011","Doncaster 022D","E01007643","Total",1665,194,86,108,1471,173,96,328,218,188,172,296
"2011","Doncaster 022E","E01007645","Total",1983,293,71,222,1690,136,68,287,338,166,286,409
"2011","Doncaster 022F","E01007655","Total",1815,331,57,274,1484,156,86,328,400,42,167,305
"2011","Doncaster 023A","E01007494","Total",1529,200,64,136,1329,112,104,334,334,57,131,257
"2011","Doncaster 023B","E01007532","Total",1771,610,177,433,1161,126,114,304,252,75,129,161
"2011","Doncaster 023C","E01007533","Total",1419,214,99,115,1205,65,146,259,228,66,190,251
"2011","Doncaster 023D","E01007535","Total",1544,176,67,109,1368,170,104,283,272,101,162,276
"2011","Doncaster 024A","E01007522","Total",1511,339,180,159,1172,102,180,228,236,98,120,208
"2011","Doncaster 024B","E01007525","Total",1532,222,147,75,1310,110,190,243,204,132,137,294
"2011","Doncaster 024C","E01007528","Total",1389,219,146,73,1170,113,210,291,186,74,139,157
"2011","Doncaster 024D","E01007604","Total",1426,117,64,53,1309,47,224,248,232,75,139,344
"2011","Doncaster 025A","E01007521","Total",1435,144,79,65,1291,47,228,266,222,92,163,273
"2011","Doncaster 025B","E01007523","Total",1486,221,118,103,1265,20,212,256,218,67,176,316
"2011","Doncaster 025C","E01007524","Total",1581,217,108,109,1364,32,310,257,280,65,142,278
"2011","Doncaster 025D","E01007526","Total",1606,161,95,66,1445,42,264,297,262,75,185,320
"2011","Doncaster 025E","E01007607","Total",1412,172,78,94,1240,133,178,243,210,73,123,280
"2011","Doncaster 026A","E01007599","Total",1763,133,69,64,1630,62,262,420,324,74,181,307
"2011","Doncaster 026B","E01007600","Total",1434,128,67,61,1306,37,238,284,278,53,106,310
"2011","Doncaster 026C","E01007601","Total",1367,164,102,62,1203,34,292,238,212,67,124,236
"2011","Doncaster 026D","E01007602","Total",1500,140,68,72,1360,61,218,264,270,94,169,284
"2011","Doncaster 026E","E01007603","Total",1467,123,64,59,1344,62,212,331,278,35,175,251
"2011","Doncaster 027A","E01007520","Total",1411,155,110,45,1256,19,284,227,220,84,167,255
"2011","Doncaster 027B","E01007527","Total",2325,290,50,240,2035,77,186,543,548,127,175,379
"2011","Doncaster 027C","E01007605","Total",1509,147,102,45,1362,38,272,240,240,95,180,297
"2011","Doncaster 027D","E01007606","Total",1524,120,73,47,1404,18,254,257,260,111,206,298
"2011","Doncaster 028A","E01007495","Total",1857,207,65,142,1650,188,112,369,318,149,182,332
"2011","Doncaster 028B","E01007500","Total",1308,192,123,69,1116,134,154,246,162,75,150,195
"2011","Doncaster 028C","E01007502","Total",2710,241,21,220,2469,97,92,853,580,160,240,447
"2011","Doncaster 028D","E01007534","Total",2018,338,45,293,1680,221,84,413,394,118,179,271
"2011","Doncaster 029A","E01007496","Total",1622,152,58,94,1470,194,62,342,200,162,274,236
"2011","Doncaster 029B","E01007497","Total",1376,102,47,55,1274,182,142,275,238,93,114,230
"2011","Doncaster 029C","E01007498","Total",1576,196,55,141,1380,118,118,336,246,102,177,283
"2011","Doncaster 029D","E01007499","Total",1452,270,144,126,1182,122,134,221,188,157,146,214
"2011","Doncaster 029E","E01007501","Total",1456,176,108,68,1280,42,308,228,206,57,154,285
"2011","Doncaster 029F","E01007503","Total",1617,154,63,91,1463,39,186,352,372,109,112,293
"2011","Doncaster 030A","E01007575","Total",1408,246,139,107,1162,160,132,173,158,153,149,237
"2011","Doncaster 030B","E01007578","Total",1616,208,91,117,1408,126,148,251,236,144,158,345
"2011","Doncaster 030C","E01007579","Total",1504,240,75,165,1264,74,126,351,276,70,95,272
"2011","Doncaster 030D","E01007580","Total",1378,157,79,78,1221,52,256,166,274,58,129,286
"2011","Doncaster 031A","E01007571","Total",1607,202,80,122,1405,99,114,359,314,42,204,273
"2011","Doncaster 031B","E01007572","Total",1416,120,72,48,1296,100,190,246,220,56,150,334
"2011","Doncaster 031C","E01007573","Total",1546,240,108,132,1306,154,126,240,212,133,238,203
"2011","Doncaster 031D","E01007574","Total",1482,209,54,155,1273,136,102,308,218,120,111,278
"2011","Doncaster 031E","E01007576","Total",1518,182,76,106,1336,70,124,259,284,74,155,370
"2011","Doncaster 031F","E01007577","Total",1486,281,74,207,1205,163,116,326,242,70,95,193
"2011","Doncaster 032A","E01007536","Total",1952,278,72,206,1674,108,182,408,428,92,134,322
"2011","Doncaster 032B","E01007542","Total",1772,287,119,168,1485,154,158,300,284,159,165,265
"2011","Doncaster 032C","E01007543","Total",1500,261,148,113,1239,95,182,185,206,58,241,272
"2011","Doncaster 032D","E01007544","Total",1674,292,153,139,1382,210,170,208,194,160,186,254
"2011","Doncaster 033A","E01007546","Total",1425,177,84,93,1248,141,154,270,228,58,154,243
"2011","Doncaster 033B","E01007551","Total",1671,192,86,106,1479,75,270,336,304,82,131,281
"2011","Doncaster 033C","E01007552","Total",1408,163,85,78,1245,50,212,291,220,79,110,283
"2011","Doncaster 033D","E01007613","Total",1548,158,85,73,1390,15,296,226,306,74,149,324
"2011","Doncaster 034A","E01007545","Total",1456,168,47,121,1288,103,94,319,308,72,158,234
"2011","Doncaster 034B","E01007547","Total",1529,154,55,99,1375,136,102,245,252,155,195,290
"2011","Doncaster 034C","E01007548","Total",1103,93,46,47,1010,134,106,191,140,149,110,180
"2011","Doncaster 034D","E01007549","Total",1439,234,129,105,1205,89,168,205,228,113,167,235
"2011","Doncaster 034E","E01007550","Total",1665,184,125,59,1481,117,210,237,224,56,284,353
"2011","Doncaster 035A","E01007537","Total",1733,180,75,105,1553,90,168,362,272,149,131,381
"2011","Doncaster 035B","E01007538","Total",1530,137,84,53,1393,91,128,312,208,108,247,299
"2011","Doncaster 035C","E01007539","Total",1398,131,53,78,1267,123,110,287,208,107,193,239
"2011","Doncaster 035D","E01007540","Total",1633,138,73,65,1495,92,148,364,230,115,187,359
"2011","Doncaster 035E","E01007541","Total",1517,186,104,82,1331,85,216,244,206,62,224,294
"2011","Doncaster 036A","E01007591","Total",1452,157,78,79,1295,80,192,264,222,68,139,330
"2011","Doncaster 036B","E01007594","Total",2019,183,48,135,1836,101,144,577,456,112,207,239
"2011","Doncaster 036C","E01007596","Total",1205,91,48,43,1114,34,182,166,284,80,119,249
"2011","Doncaster 036D","E01007598","Total",1532,147,63,84,1385,41,212,301,364,40,113,314
"2011","Doncaster 037A","E01007590","Total",1212,109,45,64,1103,96,90,218,192,67,192,248
"2011","Doncaster 037B","E01007592","Total",1589,195,97,98,1394,173,146,365,172,158,171,209
"2011","Doncaster 037C","E01007593","Total",1306,115,34,81,1191,104,108,257,206,126,151,239
"2011","Doncaster 037D","E01007595","Total",1471,198,106,92,1273,103,184,253,202,81,194,256
"2011","Doncaster 037E","E01007597","Total",1568,250,126,124,1318,194,100,276,194,167,175,212
"2011","Doncaster 038A","E01007608","Total",1701,110,17,93,1591,180,30,486,260,149,178,308
"2011","Doncaster 038B","E01007609","Total",2305,322,139,183,1983,104,292,478,418,157,234,300
"2011","Doncaster 038C","E01007610","Total",1795,243,126,117,1552,54,330,399,284,72,92,321
"2011","Doncaster 039A","E01007611","Total",1293,171,97,74,1122,64,238,171,226,66,134,223
"2011","Doncaster 039B","E01007612","Total",1378,181,101,80,1197,34,324,244,234,40,88,233
"2011","Doncaster 039C","E01007614","Total",1257,118,54,64,1139,43,172,309,246,50,79,240
"2011","Doncaster 039D","E01007615","Total",1258,252,162,90,1006,64,302,214,190,40,53,143
"2011","Doncaster 039E","E01007616","Total",1239,182,108,74,1057,44,276,247,200,20,76,194
"2011","Rotherham 001A","E01007693","Total",2148,293,85,208,1855,148,134,604,446,85,174,264
"2011","Rotherham 001B","E01007694","Total",1753,222,113,109,1531,131,112,339,308,135,208,298
"2011","Rotherham 001C","E01007695","Total",2461,215,96,119,2246,145,158,793,408,151,193,398
"2011","Rotherham 001D","E01007697","Total",1522,228,127,101,1294,109,162,277,202,93,183,268
"2011","Rotherham 001E","E01007698","Total",1482,170,57,113,1312,77,146,305,292,48,148,296
"2011","Rotherham 002A","E01007816","Total",1655,147,80,67,1508,93,172,406,240,105,210,282
"2011","Rotherham 002B","E01007817","Total",1421,211,119,92,1210,85,204,246,230,54,167,224
"2011","Rotherham 002C","E01007819","Total",1445,167,111,56,1278,42,246,289,230,63,118,290
"2011","Rotherham 002D","E01007820","Total",1483,167,43,124,1316,167,88,322,272,87,146,234
"2011","Rotherham 002E","E01007821","Total",1535,218,127,91,1317,94,180,330,220,73,149,271
"2011","Rotherham 002F","E01007822","Total",1540,243,126,117,1297,152,222,265,254,71,164,169
"2011","Rotherham 003A","E01007796","Total",1156,244,150,94,912,139,126,201,172,51,91,132
"2011","Rotherham 003B","E01007797","Total",1362,147,62,85,1215,64,232,310,168,39,141,261
"2011","Rotherham 003C","E01007798","Total",1261,121,70,51,1140,38,204,245,258,50,92,253
"2011","Rotherham 003D","E01007799","Total",1414,180,102,78,1234,64,226,259,204,78,173,230
"2011","Rotherham 003E","E01007800","Total",1428,268,90,178,1160,84,140,295,290,62,68,221
"2011","Rotherham 003F","E01007818","Total",1591,161,95,66,1430,36,264,330,282,73,160,285
"2011","Rotherham 004A","E01007777","Total",1576,163,83,80,1413,111,146,339,272,104,157,284
"2011","Rotherham 004B","E01007793","Total",1366,216,115,101,1150,63,182,241,228,27,156,253
"2011","Rotherham 004C","E01007794","Total",1433,117,58,59,1316,140,166,278,186,135,182,229
"2011","Rotherham 004D","E01007795","Total",1439,139,68,71,1300,47,176,258,384,35,89,311
"2011","Rotherham 005A","E01007778","Total",1526,105,64,41,1421,55,184,329,270,43,210,330
"2011","Rotherham 005B","E01007779","Total",1215,214,83,131,1001,83,190,210,190,77,71,180
"2011","Rotherham 005C","E01007780","Total",1414,166,94,72,1248,51,240,221,240,61,156,279
"2011","Rotherham 005D","E01007781","Total",1524,209,109,100,1315,107,172,309,204,94,170,259
"2011","Rotherham 005E","E01007782","Total",1495,155,67,88,1340,125,114,252,234,148,205,262
"2011","Rotherham 006A","E01007771","Total",1421,145,71,74,1276,70,224,290,296,69,115,212
"2011","Rotherham 006B","E01007772","Total",1325,151,68,83,1174,91,106,283,244,68,130,252
"2011","Rotherham 006C","E01007773","Total",1412,207,105,102,1205,116,144,348,252,57,87,201
"2011","Rotherham 006D","E01007774","Total",1503,136,52,84,1367,161,86,361,254,84,162,259
"2011","Rotherham 007A","E01007696","Total",1453,194,103,91,1259,38,268,326,254,52,67,254
"2011","Rotherham 007B","E01007801","Total",1491,121,52,69,1370,70,162,330,324,53,110,321
"2011","Rotherham 007C","E01007802","Total",1330,155,64,91,1175,41,194,243,260,37,102,298
"2011","Rotherham 007D","E01007803","Total",1337,132,61,71,1205,87,158,241,220,80,156,263
"2011","Rotherham 007E","E01007808","Total",1469,116,44,72,1353,28,132,286,322,62,119,404
"2011","Rotherham 008A","E01007775","Total",1341,160,74,86,1181,164,94,253,188,157,123,202
"2011","Rotherham 008B","E01007776","Total",1487,199,83,116,1288,102,158,256,282,91,174,225
"2011","Rotherham 008C","E01007783","Total",1658,340,187,153,1318,95,190,312,276,88,115,242
"2011","Rotherham 008D","E01007784","Total",1645,274,44,230,1371,164,74,392,342,69,134,196
"2011","Rotherham 009A","E01007728","Total",1104,129,69,60,975,63,190,178,166,36,89,253
"2011","Rotherham 009B","E01007729","Total",1602,412,131,281,1190,98,142,247,284,30,124,265
"2011","Rotherham 009C","E01007730","Total",1417,301,111,190,1116,94,166,198,208,67,129,254
"2011","Rotherham 009D","E01007731","Total",1187,194,95,99,993,49,142,180,262,36,93,231
"2011","Rotherham 009E","E01007732","Total",1415,385,133,252,1030,65,212,178,196,40,116,223
"2011","Rotherham 009F","E01007733","Total",1323,233,99,134,1090,77,202,236,198,52,130,195
"2011","Rotherham 010A","E01007719","Total",1247,157,79,78,1090,125,116,231,194,66,171,187
"2011","Rotherham 010B","E01007720","Total",1454,185,87,98,1269,89,218,261,232,85,146,238
"2011","Rotherham 010C","E01007721","Total",1575,235,93,142,1340,157,146,314,266,109,83,265
"2011","Rotherham 010D","E01007727","Total",1498,252,143,109,1246,99,180,201,218,56,199,293
"2011","Rotherham 011A","E01007740","Total",1471,154,80,74,1317,101,134,296,206,69,191,320
"2011","Rotherham 011B","E01007804","Total",1430,256,124,132,1174,87,174,231,196,78,176,232
"2011","Rotherham 011C","E01007805","Total",1425,249,130,119,1176,99,140,267,186,74,202,208
"2011","Rotherham 011D","E01007806","Total",1304,141,73,68,1163,145,78,280,176,106,179,199
"2011","Rotherham 011E","E01007807","Total",1448,164,93,71,1284,88,184,276,236,102,189,209
"2011","Rotherham 012A","E01007681","Total",1331,140,86,54,1191,51,236,236,256,69,82,261
"2011","Rotherham 012B","E01007691","Total",2045,189,104,85,1856,59,342,501,434,55,127,338
"2011","Rotherham 012C","E01007692","Total",1519,235,108,127,1284,56,200,388,314,68,52,206
"2011","Rotherham 012E","E01032926","Total",1762,123,11,112,1639,137,30,699,274,123,180,196
"2011","Rotherham 012F","E01032927","Total",1505,190,65,125,1315,120,108,358,248,97,168,216
"2011","Rotherham 013A","E01007723","Total",1379,190,79,111,1189,139,138,212,188,102,192,218
"2011","Rotherham 013B","E01007735","Total",1427,153,60,93,1274,228,68,258,172,142,160,246
"2011","Rotherham 013C","E01007737","Total",1583,170,24,146,1413,270,60,270,158,197,230,228
"2011","Rotherham 013D","E01007738","Total",1497,122,36,86,1375,223,110,236,188,132,231,255
"2011","Rotherham 013E","E01007739","Total",1587,200,123,77,1387,115,166,196,164,162,306,278
"2011","Rotherham 014A","E01007736","Total",1593,267,96,171,1326,198,82,256,192,152,259,187
"2011","Rotherham 014B","E01007765","Total",1513,188,62,126,1325,115,104,283,268,74,181,300
"2011","Rotherham 014C","E01007766","Total",1468,98,46,52,1370,146,90,223,172,124,275,340
"2011","Rotherham 014D","E01007768","Total",1901,396,95,301,1505,101,110,252,182,216,442,202
"2011","Rotherham 014E","E01007770","Total",1744,134,60,74,1610,143,122,220,224,164,365,372
"2011","Rotherham 015A","E01007741","Total",1527,180,110,70,1347,35,244,283,326,31,139,289
"2011","Rotherham 015B","E01007742","Total",1421,167,99,68,1254,93,204,274,190,78,134,281
"2011","Rotherham 015C","E01007743","Total",1302,79,30,49,1223,46,148,278,232,16,161,342
"2011","Rotherham 015D","E01007744","Total",1534,250,95,155,1284,113,158,272,306,53,151,231
"2011","Rotherham 015E","E01007745","Total",1537,218,118,100,1319,140,156,298,242,91,161,231
"2011","Rotherham 015F","E01007746","Total",1542,103,52,51,1439,88,168,325,260,66,191,341
"2011","Rotherham 016A","E01007715","Total",1761,184,27,157,1577,255,62,325,206,226,334,169
"2011","Rotherham 016B","E01007716","Total",1902,294,83,211,1608,93,116,203,230,188,501,277
"2011","Rotherham 016C","E01007717","Total",1882,270,82,188,1612,167,116,415,312,98,225,279
"2011","Rotherham 016D","E01007718","Total",1489,237,63,174,1252,153,72,319,256,86,166,200
"2011","Rotherham 017A","E01007677","Total",1343,223,87,136,1120,157,72,165,146,136,232,212
"2011","Rotherham 017B","E01007714","Total",1992,529,149,380,1463,105,94,194,322,189,291,268
"2011","Rotherham 017C","E01007767","Total",1501,260,93,167,1241,116,104,212,262,77,256,214
"2011","Rotherham 017D","E01007769","Total",1728,175,45,130,1553,99,46,345,214,269,375,205
"2011","Rotherham 018A","E01007685","Total",1437,121,59,62,1316,52,222,338,258,51,121,274
"2011","Rotherham 018B","E01007754","Total",1387,107,25,82,1280,61,66,371,230,44,219,289
"2011","Rotherham 018C","E01007755","Total",1386,116,34,82,1270,60,114,327,326,57,109,277
"2011","Rotherham 018D","E01007756","Total",1446,135,70,65,1311,38,170,330,264,45,130,334
"2011","Rotherham 018E","E01007761","Total",1616,210,129,81,1406,143,170,291,262,80,169,291
"2011","Rotherham 018F","E01007762","Total",1386,152,84,68,1234,64,258,264,162,62,144,280
"2011","Rotherham 019A","E01007682","Total",1440,107,52,55,1333,65,168,306,212,94,177,311
"2011","Rotherham 019B","E01007683","Total",1401,123,55,68,1278,38,152,252,320,68,125,323
"2011","Rotherham 019C","E01007686","Total",1417,243,171,72,1174,49,328,215,196,40,88,258
"2011","Rotherham 019D","E01007688","Total",1429,177,121,56,1252,76,300,261,246,46,99,224
"2011","Rotherham 019E","E01007725","Total",1270,89,45,44,1181,49,88,331,218,81,127,287
"2011","Rotherham 019F","E01007726","Total",1600,287,141,146,1313,189,114,301,232,137,134,206
"2011","Rotherham 020A","E01007757","Total",1667,133,74,59,1534,90,220,343,286,78,163,354
"2011","Rotherham 020B","E01007758","Total",1336,172,95,77,1164,108,126,277,196,59,143,255
"2011","Rotherham 020C","E01007759","Total",1473,228,112,116,1245,92,150,305,256,41,161,240
"2011","Rotherham 020D","E01007760","Total",1784,260,67,193,1524,207,116,334,306,155,204,202
"2011","Rotherham 020E","E01007763","Total",1517,234,109,125,1283,144,140,234,236,117,152,260
"2011","Rotherham 020F","E01007764","Total",1704,214,86,128,1490,240,138,268,202,169,211,262
"2011","Rotherham 021A","E01007708","Total",1672,288,152,136,1384,141,176,285,246,101,187,248
"2011","Rotherham 021B","E01007709","Total",1456,131,89,42,1325,32,258,327,264,53,151,240
"2011","Rotherham 021C","E01007710","Total",1564,139,95,44,1425,25,308,287,260,78,131,336
"2011","Rotherham 021D","E01007711","Total",1754,141,95,46,1613,58,274,376,258,86,221,340
"2011","Rotherham 021E","E01007724","Total",1372,130,72,58,1242,41,214,314,252,41,105,275
"2011","Rotherham 021F","E01007734","Total",1757,281,168,113,1476,160,136,316,214,94,238,318
"2011","Rotherham 022A","E01007684","Total",1617,152,57,95,1465,104,144,413,284,66,151,303
"2011","Rotherham 022B","E01007687","Total",1452,190,123,67,1262,56,256,296,212,51,144,247
"2011","Rotherham 022C","E01007689","Total",1537,156,102,54,1381,48,142,411,238,98,135,309
"2011","Rotherham 022D","E01007690","Total",1644,147,90,57,1497,32,362,347,256,57,164,279
"2011","Rotherham 023A","E01007675","Total",1850,168,78,90,1682,48,156,284,208,209,463,314
"2011","Rotherham 023B","E01007678","Total",1576,159,81,78,1417,36,310,197,260,78,230,306
"2011","Rotherham 023C","E01007679","Total",1854,247,117,130,1607,54,206,286,244,165,356,296
"2011","Rotherham 023D","E01007680","Total",1880,229,96,133,1651,72,138,212,218,213,520,278
"2011","Rotherham 023E","E01007712","Total",1965,163,85,78,1802,32,242,439,304,180,281,324
"2011","Rotherham 023F","E01007713","Total",1604,123,85,38,1481,27,336,322,206,62,259,269
"2011","Rotherham 024A","E01007811","Total",1358,149,95,54,1209,35,218,265,230,76,109,276
"2011","Rotherham 024B","E01007812","Total",1241,170,88,82,1071,79,154,207,206,42,158,225
"2011","Rotherham 024C","E01007813","Total",1331,171,75,96,1160,60,186,320,250,38,105,201
"2011","Rotherham 024D","E01007814","Total",1097,132,73,59,965,16,188,230,176,54,88,213
"2011","Rotherham 025A","E01007676","Total",1629,201,94,107,1428,95,214,332,314,70,151,252
"2011","Rotherham 025B","E01007702","Total",1595,125,45,80,1470,161,114,331,274,112,185,293
"2011","Rotherham 025C","E01007703","Total",1237,110,77,33,1127,43,198,260,156,50,154,266
"2011","Rotherham 025D","E01007704","Total",1450,237,120,117,1213,61,200,309,216,78,104,245
"2011","Rotherham 025E","E01007705","Total",1522,117,64,53,1405,75,222,324,206,73,190,315
"2011","Rotherham 025F","E01007707","Total",1527,157,91,66,1370,36,284,279,238,48,161,324
"2011","Rotherham 026A","E01007666","Total",1357,126,66,60,1231,41,172,197,278,20,157,366
"2011","Rotherham 026B","E01007809","Total",1550,274,112,162,1276,132,222,254,228,82,144,214
"2011","Rotherham 026C","E01007810","Total",1955,202,119,83,1753,103,240,418,276,123,218,375
"2011","Rotherham 026D","E01007815","Total",1700,187,77,110,1513,147,170,367,264,109,146,310
"2011","Rotherham 027A","E01007665","Total",1766,141,55,86,1625,52,208,483,282,70,167,363
"2011","Rotherham 027B","E01007699","Total",1826,203,76,127,1623,94,136,439,362,137,219,236
"2011","Rotherham 027C","E01007700","Total",1758,170,52,118,1588,119,128,556,346,67,145,227
"2011","Rotherham 027D","E01007701","Total",1647,245,114,131,1402,127,176,317,258,102,170,252
"2011","Rotherham 027E","E01007706","Total",1458,96,23,73,1362,79,124,308,266,47,189,349
"2011","Rotherham 028A","E01007787","Total",2751,293,98,195,2458,134,322,590,682,135,270,325
"2011","Rotherham 028B","E01007788","Total",1501,178,79,99,1323,74,218,332,290,50,123,236
"2011","Rotherham 028C","E01007789","Total",1617,266,116,150,1351,122,200,301,230,106,145,247
"2011","Rotherham 028D","E01007792","Total",1347,71,40,31,1276,26,98,302,218,45,287,300
"2011","Rotherham 029A","E01007657","Total",1447,109,55,54,1338,73,216,318,248,63,137,283
"2011","Rotherham 029B","E01007659","Total",1148,106,45,61,1042,37,152,273,194,56,119,211
"2011","Rotherham 029C","E01007785","Total",1351,105,57,48,1246,86,132,275,218,55,239,241
"2011","Rotherham 029D","E01007786","Total",1112,127,82,45,985,61,158,243,218,50,90,165
"2011","Rotherham 029E","E01007790","Total",1467,265,102,163,1202,213,158,193,234,75,125,204
"2011","Rotherham 029F","E01007791","Total",1371,164,67,97,1207,86,98,309,192,101,187,234
"2011","Rotherham 030A","E01007667","Total",1342,164,72,92,1178,72,160,320,204,49,161,212
"2011","Rotherham 030B","E01007668","Total",1571,253,136,117,1318,126,164,255,200,137,189,247
"2011","Rotherham 030C","E01007669","Total",1497,155,98,57,1342,46,296,253,224,64,126,333
"2011","Rotherham 030D","E01007670","Total",1449,131,64,67,1318,33,214,289,308,41,135,298
"2011","Rotherham 030E","E01007672","Total",1433,113,42,71,1320,74,190,355,280,46,106,269
"2011","Rotherham 030F","E01007673","Total",1496,188,106,82,1308,203,150,269,234,112,105,235
"2011","Rotherham 031A","E01007671","Total",2117,157,63,94,1960,127,186,575,332,82,256,402
"2011","Rotherham 031B","E01007674","Total",1939,197,69,128,1742,61,220,514,412,102,183,250
"2011","Rotherham 031C","E01007747","Total",1295,153,94,59,1142,68,148,257,182,56,185,246
"2011","Rotherham 031D","E01007750","Total",1521,142,89,53,1379,66,290,244,248,79,152,300
"2011","Rotherham 032A","E01007658","Total",1391,137,54,83,1254,69,148,310,268,59,129,271
"2011","Rotherham 032B","E01007660","Total",1212,88,47,41,1124,17,172,269,236,51,106,273
"2011","Rotherham 032C","E01007661","Total",1401,112,67,45,1289,53,226,307,270,56,136,241
"2011","Rotherham 032D","E01007662","Total",1035,164,99,65,871,77,156,216,118,70,91,143
"2011","Rotherham 032E","E01007663","Total",1460,145,90,55,1315,55,302,280,246,50,88,294
"2011","Rotherham 032F","E01007664","Total",1854,201,116,85,1653,49,442,312,332,51,163,304
"2011","Rotherham 033A","E01007748","Total",1443,164,110,54,1279,50,330,218,248,40,146,247
"2011","Rotherham 033B","E01007749","Total",1804,197,88,109,1607,61,256,490,282,112,164,242
"2011","Rotherham 033C","E01007751","Total",1962,247,91,156,1715,120,160,557,360,103,197,218
"2011","Rotherham 033D","E01007752","Total",1487,125,56,69,1362,24,248,399,272,71,97,251
"2011","Rotherham 033E","E01007753","Total",1527,193,134,59,1334,44,250,352,242,53,160,233
"2011","Sheffield 001A","E01008144","Total",1614,224,86,138,1390,76,188,388,306,93,162,177
"2011","Sheffield 001B","E01008145","Total",1472,292,157,135,1180,89,208,178,220,106,130,249
"2011","Sheffield 001C","E01008148","Total",1509,153,79,74,1356,87,238,277,250,79,152,273
"2011","Sheffield 001D","E01008149","Total",1496,166,67,99,1330,59,208,345,300,54,128,236
"2011","Sheffield 001E","E01008150","Total",1372,227,107,120,1145,103,156,291,246,66,103,180
"2011","Sheffield 002A","E01008142","Total",1464,189,81,108,1275,103,138,295,250,110,166,213
"2011","Sheffield 002B","E01008143","Total",1620,285,95,190,1335,97,186,376,322,63,121,170
"2011","Sheffield 002C","E01008146","Total",1334,77,38,39,1257,21,230,361,224,91,83,247
"2011","Sheffield 002D","E01008147","Total",1426,146,91,55,1280,33,256,294,258,53,84,302
"2011","Sheffield 003A","E01007888","Total",1379,86,25,61,1293,41,182,334,290,45,129,272
"2011","Sheffield 003B","E01007892","Total",1448,209,115,94,1239,130,164,232,222,87,169,235
"2011","Sheffield 003C","E01007893","Total",1491,126,76,50,1365,23,252,356,286,26,106,316
"2011","Sheffield 003D","E01007898","Total",1469,163,66,97,1306,45,98,392,318,41,146,266
"2011","Sheffield 003E","E01007899","Total",1463,122,60,62,1341,34,272,285,252,47,178,273
"2011","Sheffield 003F","E01007900","Total",1694,228,106,122,1466,142,212,366,294,53,139,260
"2011","Sheffield 003G","E01007901","Total",1481,290,170,120,1191,117,190,246,184,87,145,222
"2011","Sheffield 004A","E01007887","Total",1362,189,107,82,1173,46,138,340,252,45,129,223
"2011","Sheffield 004B","E01007889","Total",2658,233,89,144,2425,80,194,815,490,182,292,372
"2011","Sheffield 004C","E01007890","Total",1422,118,59,59,1304,25,232,384,268,57,116,222
"2011","Sheffield 004D","E01007891","Total",1551,147,107,40,1404,35,302,276,264,87,139,301
"2011","Sheffield 004E","E01007894","Total",1410,197,83,114,1213,84,150,268,298,81,122,210
"2011","Sheffield 004F","E01007895","Total",1400,214,123,91,1186,70,222,224,230,50,141,249
"2011","Sheffield 004G","E01007896","Total",1280,126,65,61,1154,39,170,274,256,42,88,285
"2011","Sheffield 005A","E01007897","Total",1386,124,76,48,1262,44,332,216,308,47,92,223
"2011","Sheffield 005B","E01008134","Total",1331,188,113,75,1143,23,248,221,262,32,140,217
"2011","Sheffield 005C","E01008135","Total",1710,220,76,144,1490,71,182,404,374,31,154,274
"2011","Sheffield 005D","E01008137","Total",1441,140,84,56,1301,9,324,316,238,15,130,269
"2011","Sheffield 005E","E01008141","Total",1589,154,80,74,1435,36,292,349,260,82,124,292
"2011","Sheffield 006A","E01008053","Total",1245,200,95,105,1045,75,164,178,178,100,100,250
"2011","Sheffield 006B","E01008056","Total",1497,148,64,84,1349,144,146,321,194,59,169,316
"2011","Sheffield 006C","E01008058","Total",1460,176,88,88,1284,47,216,294,196,37,145,349
"2011","Sheffield 006D","E01008138","Total",1302,270,178,92,1032,48,198,250,168,60,111,197
"2011","Sheffield 006E","E01008139","Total",1582,203,97,106,1379,74,272,291,272,54,165,251
"2011","Sheffield 007A","E01007856","Total",1317,156,63,93,1161,120,124,223,184,133,146,231
"2011","Sheffield 007B","E01008054","Total",1324,141,43,98,1183,209,92,256,150,110,140,226
"2011","Sheffield 007C","E01008055","Total",1485,165,65,100,1320,204,86,330,212,132,125,231
"2011","Sheffield 007D","E01008057","Total",1489,167,70,97,1322,184,102,337,184,158,155,202
"2011","Sheffield 008A","E01008126","Total",1552,136,85,51,1416,29,322,323,224,80,169,269
"2011","Sheffield 008C","E01008128","Total",1702,165,66,99,1537,28,222,383,390,101,147,266
"2011","Sheffield 008D","E01008136","Total",1355,177,77,100,1178,60,172,301,208,78,144,215
"2011","Sheffield 008E","E01008140","Total",1786,288,130,158,1498,130,200,424,352,55,101,236
"2011","Sheffield 008F","E01033275","Total",1611,170,25,145,1441,105,72,468,320,130,120,226
"2011","Sheffield 008G","E01033280","Total",1575,103,44,59,1472,66,158,417,274,86,198,273
"2011","Sheffield 009A","E01008085","Total",1368,228,103,125,1140,127,140,201,180,90,159,243
"2011","Sheffield 009B","E01008086","Total",1349,175,61,114,1174,136,132,281,196,103,161,165
"2011","Sheffield 009C","E01008116","Total",1327,156,74,82,1171,162,128,208,182,110,148,233
"2011","Sheffield 009D","E01008117","Total",1221,233,104,129,988,98,134,173,118,84,153,228
"2011","Sheffield 009E","E01008118","Total",1397,200,103,97,1197,121,158,236,226,87,148,221
"2011","Sheffield 009F","E01008119","Total",1248,111,45,66,1137,176,76,182,148,122,227,206
"2011","Sheffield 009G","E01008125","Total",1481,187,99,88,1294,77,172,224,202,136,201,282
"2011","Sheffield 010A","E01007849","Total",2113,280,105,175,1833,260,146,375,246,135,385,286
"2011","Sheffield 010B","E01007857","Total",1552,182,87,95,1370,239,142,277,196,83,199,234
"2011","Sheffield 010C","E01008059","Total",1512,202,78,124,1310,177,118,328,198,97,187,205
"2011","Sheffield 010D","E01008060","Total",1386,201,79,122,1185,194,142,292,204,92,99,162
"2011","Sheffield 011A","E01008061","Total",1596,192,101,91,1404,150,138,352,186,173,174,231
"2011","Sheffield 011B","E01008063","Total",1505,277,96,181,1228,46,220,291,188,88,127,268
"2011","Sheffield 011E","E01033277","Total",2334,278,101,177,2056,283,168,442,328,244,283,308
"2011","Sheffield 012A","E01008087","Total",1514,183,76,107,1331,68,192,334,304,34,122,277
"2011","Sheffield 012B","E01008088","Total",1429,197,85,112,1232,91,234,236,266,31,94,280
"2011","Sheffield 012C","E01008090","Total",1624,244,82,162,1380,249,150,306,270,55,143,207
"2011","Sheffield 012D","E01008092","Total",1389,358,119,239,1031,145,142,247,182,51,112,152
"2011","Sheffield 012E","E01008122","Total",1350,159,51,108,1191,182,102,306,138,130,133,200
"2011","Sheffield 012F","E01008124","Total",1499,223,53,170,1276,248,92,329,244,110,149,104
"2011","Sheffield 013A","E01007848","Total",1616,217,93,124,1399,214,104,266,246,154,192,223
"2011","Sheffield 013B","E01007851","Total",1483,131,50,81,1352,153,96,206,152,181,289,275
"2011","Sheffield 013C","E01007947","Total",1615,507,204,303,1108,121,142,136,210,181,164,154
"2011","Sheffield 013D","E01007948","Total",1756,160,84,76,1596,192,120,266,150,256,381,231
"2011","Sheffield 013E","E01008062","Total",1693,181,99,82,1512,134,128,319,144,188,376,223
"2011","Sheffield 014A","E01007847","Total",1297,273,91,182,1024,86,170,210,182,81,109,186
"2011","Sheffield 014B","E01007850","Total",1562,113,54,59,1449,110,234,225,228,48,253,351
"2011","Sheffield 014C","E01007852","Total",1482,179,42,137,1303,98,132,291,284,71,138,289
"2011","Sheffield 014D","E01007853","Total",1568,201,94,107,1367,61,218,341,272,58,135,282
"2011","Sheffield 014E","E01007854","Total",1735,162,42,120,1573,249,54,484,228,101,262,195
"2011","Sheffield 014F","E01007855","Total",1976,199,35,164,1777,265,108,373,332,128,288,283
"2011","Sheffield 015A","E01007941","Total",1534,218,129,89,1316,149,148,263,200,111,160,285
"2011","Sheffield 015B","E01007945","Total",1771,225,95,130,1546,243,152,328,212,79,204,328
"2011","Sheffield 015C","E01007946","Total",1585,164,56,108,1421,258,96,309,198,144,210,206
"2011","Sheffield 015D","E01007950","Total",1529,174,88,86,1355,268,138,329,182,124,147,167
"2011","Sheffield 015E","E01008123","Total",1293,138,52,86,1155,171,92,248,172,136,104,232
"2011","Sheffield 016A","E01007987","Total",1468,142,48,94,1326,61,124,338,268,47,178,310
"2011","Sheffield 016B","E01007988","Total",1520,180,103,77,1340,64,190,361,254,65,117,289
"2011","Sheffield 016C","E01007989","Total",1419,161,55,106,1258,43,118,374,292,36,118,277
"2011","Sheffield 016D","E01007991","Total",1503,157,95,62,1346,180,190,255,188,74,204,255
"2011","Sheffield 017A","E01007995","Total",1470,239,55,184,1231,109,66,264,390,65,90,247
"2011","Sheffield 017B","E01008089","Total",1679,199,67,132,1480,166,158,270,224,200,213,249
"2011","Sheffield 017C","E01008091","Total",1464,186,31,155,1278,81,88,297,344,38,138,292
"2011","Sheffield 017D","E01008093","Total",1455,366,115,251,1089,64,102,281,326,47,74,195
"2011","Sheffield 018A","E01007903","Total",1537,190,83,107,1347,33,142,258,164,143,370,237
"2011","Sheffield 018B","E01007904","Total",1700,231,106,125,1469,149,166,206,160,254,329,205
"2011","Sheffield 018C","E01007913","Total",1481,116,31,85,1365,111,44,235,124,279,376,196
"2011","Sheffield 018D","E01007914","Total",1559,108,41,67,1451,104,64,317,120,263,410,173
"2011","Sheffield 019A","E01007870","Total",1756,269,67,202,1487,128,144,241,244,88,349,293
"2011","Sheffield 019B","E01007871","Total",1783,379,144,235,1404,123,194,239,234,120,249,245
"2011","Sheffield 019C","E01007943","Total",1748,291,139,152,1457,273,162,331,224,124,121,222
"2011","Sheffield 019D","E01008094","Total",1115,122,52,70,993,116,140,220,172,54,82,209
"2011","Sheffield 020A","E01007869","Total",1693,111,30,81,1582,87,72,223,130,301,478,291
"2011","Sheffield 020B","E01007872","Total",1713,212,88,124,1501,84,124,199,158,263,435,238
"2011","Sheffield 020C","E01007873","Total",1752,219,71,148,1533,116,108,297,160,199,401,252
"2011","Sheffield 020D","E01007942","Total",1834,99,30,69,1735,113,56,230,114,321,556,345
"2011","Sheffield 020E","E01007949","Total",1555,103,24,79,1452,94,78,287,134,255,356,248
"2011","Sheffield 021A","E01007990","Total",1485,192,116,76,1293,73,252,265,244,91,125,243
"2011","Sheffield 021B","E01007992","Total",1612,208,87,121,1404,65,142,406,314,82,137,258
"2011","Sheffield 021C","E01007993","Total",1682,178,88,90,1504,97,224,312,240,184,127,320
"2011","Sheffield 021D","E01007994","Total",1435,151,45,106,1284,64,106,433,306,46,85,244
"2011","Sheffield 021E","E01007996","Total",1532,223,113,110,1309,82,200,318,302,85,114,208
"2011","Sheffield 022A","E01007874","Total",1848,187,56,131,1661,294,104,202,188,231,412,230
"2011","Sheffield 022B","E01007875","Total",1838,167,49,118,1671,238,80,257,120,265,460,251
"2011","Sheffield 022D","E01007877","Total",1372,91,26,65,1281,116,70,141,92,256,461,145
"2011","Sheffield 022E","E01007940","Total",1690,193,57,136,1497,203,102,281,148,232,351,180
"2011","Sheffield 022F","E01007944","Total",2058,115,20,95,1943,108,62,374,160,390,585,264
"2011","Sheffield 022G","E01033269","Total",1919,217,51,166,1702,212,40,248,148,405,373,276
"2011","Sheffield 022H","E01033270","Total",1463,372,24,348,1091,77,24,157,486,107,102,138
"2011","Sheffield 023A","E01008129","Total",1377,159,81,78,1218,60,178,241,206,89,177,267
"2011","Sheffield 023B","E01008130","Total",1494,164,96,68,1330,45,292,278,236,67,123,289
"2011","Sheffield 023C","E01008131","Total",1576,148,73,75,1428,48,232,340,254,95,149,310
"2011","Sheffield 023D","E01008132","Total",1416,108,53,55,1308,33,172,374,220,53,118,338
"2011","Sheffield 023E","E01008133","Total",1530,268,181,87,1262,41,344,250,220,73,108,226
"2011","Sheffield 024A","E01008151","Total",1539,223,52,171,1316,38,62,248,428,43,70,427
"2011","Sheffield 024B","E01008153","Total",1653,318,94,224,1335,57,136,270,490,58,60,264
"2011","Sheffield 024C","E01008154","Total",1628,293,108,185,1335,58,176,331,394,44,71,261
"2011","Sheffield 024D","E01008155","Total",1546,220,56,164,1326,86,108,222,474,52,110,274
"2011","Sheffield 024E","E01008156","Total",1449,193,69,124,1256,35,186,278,394,47,72,244
"2011","Sheffield 024F","E01008160","Total",1399,233,112,121,1166,64,138,258,298,52,102,254
"2011","Sheffield 025A","E01007997","Total",1479,166,96,70,1313,70,288,320,220,75,119,221
"2011","Sheffield 025B","E01007998","Total",1561,519,244,275,1042,77,208,243,152,63,95,204
"2011","Sheffield 025C","E01008152","Total",1426,228,101,127,1198,67,216,331,226,37,69,252
"2011","Sheffield 025D","E01008158","Total",1535,258,119,139,1277,123,212,308,252,74,80,228
"2011","Sheffield 026A","E01008065","Total",1903,552,178,374,1351,174,92,211,180,211,185,298
"2011","Sheffield 026B","E01008068","Total",2077,395,73,322,1682,125,52,309,238,194,163,601
"2011","Sheffield 026C","E01008072","Total",1552,242,83,159,1310,133,104,236,232,127,210,268
"2011","Sheffield 026D","E01008157","Total",1557,437,221,216,1120,105,174,196,266,72,79,228
"2011","Sheffield 026E","E01008161","Total",1668,275,67,208,1393,86,176,313,418,61,75,264
"2011","Sheffield 027A","E01007883","Total",1322,94,42,52,1228,109,58,156,108,206,410,181
"2011","Sheffield 027B","E01007902","Total",1752,348,164,184,1404,162,168,197,228,174,287,188
"2011","Sheffield 027C","E01007905","Total",1770,73,13,60,1697,146,36,413,124,238,515,225
"2011","Sheffield 027D","E01007906","Total",2081,140,66,74,1941,103,106,297,146,443,582,264
"2011","Sheffield 028A","E01008064","Total",1687,160,41,119,1527,39,56,203,274,42,54,859
"2011","Sheffield 028B","E01008066","Total",1554,87,19,68,1467,2,34,72,144,18,44,1153
"2011","Sheffield 028C","E01008069","Total",1617,138,56,82,1479,28,40,121,250,30,42,968
"2011","Sheffield 028D","E01008074","Total",1460,125,38,87,1335,35,64,219,304,31,47,635
"2011","Sheffield 029A","E01007951","Total",1567,215,110,105,1352,49,172,289,314,115,92,321
"2011","Sheffield 029B","E01007960","Total",1580,209,83,126,1371,56,120,266,338,67,60,464
"2011","Sheffield 029C","E01007962","Total",1426,207,85,122,1219,19,106,172,300,45,35,542
"2011","Sheffield 029D","E01008159","Total",1527,265,85,180,1262,72,144,250,476,61,54,205
"2011","Sheffield 030A","E01007866","Total",1714,180,45,135,1534,19,34,179,214,65,127,896
"2011","Sheffield 030B","E01007867","Total",2006,177,41,136,1829,16,30,86,232,46,32,1387
"2011","Sheffield 030C","E01007868","Total",1110,194,75,119,916,14,70,163,230,69,77,293
"2011","Sheffield 030D","E01008067","Total",1646,128,12,116,1518,20,16,50,148,11,34,1239
"2011","Sheffield 030E","E01008073","Total",1702,267,62,205,1435,36,76,187,280,48,77,731
"2011","Sheffield 032A","E01007907","Total",1656,141,51,90,1515,61,120,294,198,176,428,238
"2011","Sheffield 032B","E01007908","Total",1492,199,62,137,1293,54,138,377,296,50,154,224
"2011","Sheffield 032C","E01007909","Total",2047,238,88,150,1809,87,192,525,394,122,219,270
"2011","Sheffield 032D","E01007911","Total",1397,139,81,58,1258,58,222,345,222,27,114,270
"2011","Sheffield 032E","E01008014","Total",1531,264,141,123,1267,100,184,235,216,115,238,179
"2011","Sheffield 032F","E01008016","Total",1466,197,94,103,1269,128,154,250,224,95,149,269
"2011","Sheffield 033A","E01007952","Total",1569,146,89,57,1423,33,244,438,238,62,146,262
"2011","Sheffield 033B","E01007953","Total",1561,385,203,182,1176,21,382,193,248,61,117,154
"2011","Sheffield 033C","E01007954","Total",1650,142,77,65,1508,35,204,544,228,67,140,290
"2011","Sheffield 033D","E01007961","Total",1508,128,80,48,1380,40,194,401,198,97,163,287
"2011","Sheffield 036A","E01007859","Total",1420,134,27,107,1286,16,76,119,164,37,45,829
"2011","Sheffield 036B","E01007860","Total",1528,244,69,175,1284,11,44,172,244,76,81,656
"2011","Sheffield 036C","E01007863","Total",1702,240,83,157,1462,29,88,258,222,65,94,706
"2011","Sheffield 036D","E01007864","Total",1882,77,23,54,1805,10,26,56,144,0,18,1551
"2011","Sheffield 036E","E01008104","Total",1406,155,50,105,1251,71,86,184,176,83,121,530
"2011","Sheffield 037A","E01007910","Total",1579,267,119,148,1312,149,170,250,246,122,169,206
"2011","Sheffield 037B","E01007912","Total",1516,229,137,92,1287,50,232,293,254,58,120,280
"2011","Sheffield 037C","E01007971","Total",1434,203,108,95,1231,109,182,265,204,121,134,216
"2011","Sheffield 037D","E01007973","Total",1523,168,113,55,1355,48,242,348,226,93,149,249
"2011","Sheffield 038A","E01007858","Total",1358,258,62,196,1100,56,108,279,282,124,79,172
"2011","Sheffield 038B","E01007861","Total",1525,211,81,130,1314,39,232,353,248,90,107,245
"2011","Sheffield 038C","E01007862","Total",2286,227,64,163,2059,35,98,169,166,66,132,1393
"2011","Sheffield 038D","E01007865","Total",1682,261,120,141,1421,80,144,474,318,99,108,198
"2011","Sheffield 039A","E01008011","Total",1633,236,71,165,1397,275,94,278,168,168,192,222
"2011","Sheffield 039B","E01008012","Total",2144,351,79,272,1793,292,142,422,308,166,217,246
"2011","Sheffield 039C","E01008013","Total",1168,195,55,140,973,146,68,173,192,126,125,143
"2011","Sheffield 039D","E01008015","Total",1608,295,115,180,1313,133,148,289,232,105,177,229
"2011","Sheffield 039E","E01008017","Total",1588,272,127,145,1316,124,140,262,196,128,198,268
"2011","Sheffield 039F","E01008018","Total",1283,181,78,103,1102,134,112,261,170,71,145,209
"2011","Sheffield 040A","E01008105","Total",2046,224,31,193,1822,70,32,145,266,119,246,944
"2011","Sheffield 040C","E01008107","Total",1492,237,59,178,1255,107,48,187,230,64,225,394
"2011","Sheffield 040D","E01008111","Total",1592,192,33,159,1400,20,46,112,182,73,110,857
"2011","Sheffield 040E","E01033271","Total",1403,436,58,378,967,105,50,308,252,103,78,71
"2011","Sheffield 040F","E01033272","Total",1154,379,60,319,775,46,22,134,362,44,55,112
"2011","Sheffield 041A","E01007955","Total",1371,104,72,32,1267,17,250,288,188,118,151,255
"2011","Sheffield 041B","E01007956","Total",2196,233,130,103,1963,65,376,666,266,70,249,271
"2011","Sheffield 041C","E01007957","Total",1629,141,90,51,1488,25,232,469,226,129,149,258
"2011","Sheffield 041D","E01007958","Total",1458,159,85,74,1299,22,270,333,230,142,107,195
"2011","Sheffield 041E","E01007959","Total",1491,138,90,48,1353,29,208,405,218,133,147,213
"2011","Sheffield 042A","E01008108","Total",1972,193,21,172,1779,68,44,158,372,105,249,783
"2011","Sheffield 042B","E01008109","Total",1993,240,76,164,1753,70,82,155,248,144,271,783
"2011","Sheffield 042D","E01008112","Total",1750,137,28,109,1613,73,52,240,190,226,357,475
"2011","Sheffield 042E","E01008113","Total",1732,188,55,133,1544,43,66,288,294,124,338,391
"2011","Sheffield 042F","E01033273","Total",1576,154,39,115,1422,69,32,115,196,31,121,858
"2011","Sheffield 042G","E01033274","Total",1287,233,3,230,1054,29,2,76,352,5,5,585
"2011","Sheffield 043A","E01008095","Total",1245,266,81,185,979,117,74,127,336,132,63,130
"2011","Sheffield 043B","E01008096","Total",2176,323,112,211,1853,214,162,369,320,163,236,389
"2011","Sheffield 043C","E01008097","Total",1572,257,126,131,1315,207,146,229,198,156,149,230
"2011","Sheffield 043D","E01008101","Total",1763,295,90,205,1468,127,182,331,308,103,165,252
"2011","Sheffield 044A","E01007965","Total",1906,305,224,81,1601,168,256,327,172,162,180,336
"2011","Sheffield 044B","E01007969","Total",1418,188,87,101,1230,57,194,224,266,64,145,280
"2011","Sheffield 044C","E01007972","Total",1473,131,73,58,1342,50,252,340,242,54,154,250
"2011","Sheffield 044D","E01007974","Total",1468,110,39,71,1358,78,128,383,218,44,214,293
"2011","Sheffield 045A","E01007963","Total",1443,312,124,188,1131,64,174,277,244,36,111,225
"2011","Sheffield 045B","E01007967","Total",1665,294,133,161,1371,110,218,327,240,81,206,189
"2011","Sheffield 045C","E01007999","Total",1349,141,60,81,1208,43,152,221,250,47,134,361
"2011","Sheffield 045D","E01008008","Total",1617,260,112,148,1357,149,206,270,214,43,202,273
"2011","Sheffield 045E","E01008009","Total",1547,169,69,100,1378,296,94,291,136,134,228,199
"2011","Sheffield 046A","E01008043","Total",1730,179,86,93,1551,37,176,376,310,142,219,291
"2011","Sheffield 046B","E01008044","Total",1603,169,111,58,1434,53,232,338,158,153,263,237
"2011","Sheffield 046C","E01008047","Total",1509,175,35,140,1334,22,54,130,316,26,71,715
"2011","Sheffield 046D","E01008048","Total",1516,125,27,98,1391,25,86,146,202,88,74,770
"2011","Sheffield 046E","E01008050","Total",1411,148,21,127,1263,48,52,195,376,26,66,500
"2011","Sheffield 047A","E01007931","Total",1604,149,110,39,1455,35,204,386,256,140,128,306
"2011","Sheffield 047B","E01007934","Total",1468,162,69,93,1306,48,128,482,194,123,93,238
"2011","Sheffield 047C","E01007935","Total",1419,120,29,91,1299,58,60,398,258,40,60,425
"2011","Sheffield 047D","E01007936","Total",1590,158,34,124,1432,105,64,439,364,73,65,322
"2011","Sheffield 047E","E01007937","Total",1395,148,87,61,1247,35,132,423,242,66,112,237
"2011","Sheffield 047F","E01007938","Total",1509,125,67,58,1384,38,200,478,218,89,159,202
"2011","Sheffield 048A","E01008098","Total",1590,166,63,103,1424,230,122,315,172,148,169,268
"2011","Sheffield 048B","E01008100","Total",1265,164,67,97,1101,196,108,184,200,78,154,181
"2011","Sheffield 048C","E01008102","Total",1115,230,100,130,885,119,126,193,132,76,76,163
"2011","Sheffield 048D","E01008103","Total",1390,178,52,126,1212,240,124,239,182,109,117,201
"2011","Sheffield 049A","E01007964","Total",1517,253,98,155,1264,82,180,269,304,96,104,229
"2011","Sheffield 049B","E01007966","Total",1551,190,77,113,1361,66,112,288,290,40,244,321
"2011","Sheffield 049C","E01007968","Total",1467,201,120,81,1266,146,156,232,204,92,230,206
"2011","Sheffield 049D","E01007970","Total",1528,626,279,347,902,89,198,186,222,35,53,119
"2011","Sheffield 050A","E01008042","Total",1616,226,58,168,1390,68,118,233,254,171,278,268
"2011","Sheffield 050B","E01008045","Total",1377,194,59,135,1183,41,68,232,202,83,325,232
"2011","Sheffield 050C","E01008046","Total",1659,222,45,177,1437,101,84,351,360,102,203,236
"2011","Sheffield 050D","E01008049","Total",1527,341,154,187,1186,26,134,238,328,48,119,293
"2011","Sheffield 050E","E01008051","Total",1741,190,33,157,1551,37,84,263,292,160,344,371
"2011","Sheffield 050F","E01008052","Total",1782,280,55,225,1502,38,90,322,420,71,214,347
"2011","Sheffield 051A","E01007975","Total",1636,365,144,221,1271,87,138,275,308,140,126,197
"2011","Sheffield 051B","E01007976","Total",1426,256,96,160,1170,57,130,275,254,67,131,256
"2011","Sheffield 051C","E01007977","Total",1496,465,144,321,1031,107,166,188,214,69,61,226
"2011","Sheffield 051D","E01007979","Total",1614,221,89,132,1393,252,114,248,156,178,148,297
"2011","Sheffield 051E","E01008099","Total",1545,168,42,126,1377,116,84,332,346,53,93,353
"2011","Sheffield 052A","E01008000","Total",1446,248,129,119,1198,68,176,278,298,26,101,251
"2011","Sheffield 052B","E01008001","Total",1471,195,86,109,1276,113,194,325,256,57,140,191
"2011","Sheffield 052C","E01008004","Total",1606,265,162,103,1341,97,222,310,226,77,184,225
"2011","Sheffield 052D","E01008005","Total",1546,211,110,101,1335,60,272,255,288,66,121,273
"2011","Sheffield 052E","E01008010","Total",1454,148,76,72,1306,151,146,285,186,78,213,247
"2011","Sheffield 053A","E01007978","Total",1664,274,38,236,1390,125,50,305,382,58,195,275
"2011","Sheffield 053B","E01007980","Total",1527,213,35,178,1314,113,62,326,352,75,129,257
"2011","Sheffield 053C","E01007981","Total",1427,186,39,147,1241,46,70,356,284,109,132,244
"2011","Sheffield 053D","E01007983","Total",1483,194,46,148,1289,72,60,357,356,88,112,244
"2011","Sheffield 053E","E01007985","Total",1515,194,57,137,1321,82,176,310,256,74,164,259
"2011","Sheffield 054A","E01007982","Total",1821,282,78,204,1539,181,146,339,270,136,201,266
"2011","Sheffield 054B","E01008002","Total",1557,175,93,82,1382,49,282,329,310,44,114,254
"2011","Sheffield 054C","E01008003","Total",1410,200,111,89,1210,26,212,269,252,46,110,295
"2011","Sheffield 054D","E01008006","Total",1362,200,99,101,1162,65,264,199,250,46,76,262
"2011","Sheffield 055A","E01007927","Total",1608,158,98,60,1450,34,288,389,198,109,167,265
"2011","Sheffield 055B","E01007928","Total",1751,171,102,69,1580,32,276,370,226,156,185,335
"2011","Sheffield 055C","E01007929","Total",1628,142,53,89,1486,50,196,422,258,132,138,290
"2011","Sheffield 055D","E01007930","Total",1470,94,65,29,1376,22,206,372,184,138,197,257
"2011","Sheffield 055E","E01007932","Total",1415,166,110,56,1249,36,200,330,198,83,162,240
"2011","Sheffield 055F","E01007939","Total",1534,178,107,71,1356,45,238,358,236,110,118,251
"2011","Sheffield 056A","E01008028","Total",1547,196,75,121,1351,91,164,262,270,113,148,303
"2011","Sheffield 056B","E01008029","Total",1496,157,78,79,1339,132,144,300,210,125,174,254
"2011","Sheffield 056C","E01008032","Total",1407,209,105,104,1198,85,166,289,238,61,145,214
"2011","Sheffield 056D","E01008034","Total",1737,172,85,87,1565,101,134,380,234,84,223,409
"2011","Sheffield 059A","E01007828","Total",1699,253,114,139,1446,109,166,350,282,117,170,252
"2011","Sheffield 059B","E01007829","Total",1562,223,60,163,1339,90,148,387,386,51,79,198
"2011","Sheffield 059C","E01007831","Total",1469,223,66,157,1246,51,116,323,352,87,135,182
"2011","Sheffield 059D","E01007832","Total",1543,221,88,133,1322,95,142,394,254,61,121,255
"2011","Sheffield 059E","E01007986","Total",1369,226,55,171,1143,86,122,286,370,36,98,145
"2011","Sheffield 060A","E01008007","Total",1658,403,167,236,1255,103,212,196,186,117,248,193
"2011","Sheffield 060B","E01008075","Total",1441,224,61,163,1217,223,120,232,174,92,165,211
"2011","Sheffield 060C","E01008076","Total",1352,245,99,146,1107,148,128,253,190,95,87,206
"2011","Sheffield 060D","E01008077","Total",1461,283,122,161,1178,100,160,241,190,80,145,262
"2011","Sheffield 061A","E01008031","Total",1436,193,96,97,1243,44,174,309,254,56,152,254
"2011","Sheffield 061B","E01008033","Total",1290,179,62,117,1111,24,218,158,296,41,108,266
"2011","Sheffield 061C","E01008038","Total",1535,218,129,89,1317,29,386,230,310,35,91,236
"2011","Sheffield 061D","E01008040","Total",1704,159,55,104,1545,91,126,410,320,78,166,354
"2011","Sheffield 062A","E01007835","Total",1381,181,97,84,1200,39,254,295,216,53,125,218
"2011","Sheffield 062B","E01007836","Total",1605,213,141,72,1392,29,310,354,180,102,146,271
"2011","Sheffield 062C","E01007843","Total",1600,316,177,139,1284,143,170,294,254,90,110,223
"2011","Sheffield 062D","E01007846","Total",1494,181,106,75,1313,66,198,275,246,86,137,305
"2011","Sheffield 063A","E01008030","Total",1384,138,42,96,1246,42,128,383,230,96,134,233
"2011","Sheffield 063B","E01008035","Total",1195,88,45,43,1107,10,138,295,214,45,131,274
"2011","Sheffield 063C","E01008036","Total",1427,160,30,130,1267,39,80,360,302,67,130,289
"2011","Sheffield 063D","E01008041","Total",1519,84,22,62,1435,76,76,473,276,84,133,317
"2011","Sheffield 064A","E01007827","Total",1504,222,104,118,1282,51,196,305,340,37,88,265
"2011","Sheffield 064B","E01007830","Total",1455,230,142,88,1225,25,224,295,206,35,179,261
"2011","Sheffield 064C","E01007833","Total",1648,298,210,88,1350,24,314,327,244,35,128,278
"2011","Sheffield 064D","E01007984","Total",1435,135,71,64,1300,29,204,375,250,53,144,245
"2011","Sheffield 064E","E01008078","Total",1335,248,126,122,1087,36,230,197,218,60,91,255
"2011","Sheffield 064F","E01008079","Total",1235,109,64,45,1126,41,194,307,198,56,112,218
"2011","Sheffield 065A","E01008019","Total",1840,174,66,108,1666,135,150,376,316,112,232,345
"2011","Sheffield 065B","E01008020","Total",1434,162,60,102,1272,44,166,280,272,71,141,298
"2011","Sheffield 065C","E01008022","Total",1513,373,84,289,1140,166,104,237,230,87,138,178
"2011","Sheffield 065D","E01008027","Total",1501,251,101,150,1250,118,190,334,242,66,125,175
"2011","Sheffield 065E","E01008037","Total",1392,260,142,118,1132,108,308,142,268,28,53,225
"2011","Sheffield 065F","E01008039","Total",1312,175,90,85,1137,27,252,217,280,29,77,255
"2011","Sheffield 066A","E01007824","Total",1393,129,80,49,1264,25,202,347,212,88,132,258
"2011","Sheffield 066B","E01007825","Total",1404,160,113,47,1244,26,212,390,242,50,73,251
"2011","Sheffield 066C","E01007826","Total",1526,112,64,48,1414,36,202,431,208,106,149,282
"2011","Sheffield 066D","E01007834","Total",1654,287,170,117,1367,51,246,346,234,146,81,263
"2011","Sheffield 068A","E01007920","Total",1622,165,106,59,1457,18,346,361,232,82,141,277
"2011","Sheffield 068B","E01007921","Total",1562,278,185,93,1284,48,344,254,200,93,149,196
"2011","Sheffield 068C","E01007923","Total",1802,256,141,115,1546,53,308,413,286,100,140,246
"2011","Sheffield 068D","E01007925","Total",1630,266,132,134,1364,54,272,373,234,103,132,196
"2011","Sheffield 068E","E01007926","Total",1686,168,117,51,1518,28,326,356,268,131,169,240
"2011","Sheffield 068F","E01007933","Total",1658,112,70,42,1546,22,260,417,220,128,187,312
"2011","Sheffield 069A","E01007823","Total",1658,334,188,146,1324,67,272,350,248,51,114,222
"2011","Sheffield 069B","E01007916","Total",1529,330,108,222,1199,206,122,248,178,159,108,178
"2011","Sheffield 069C","E01007919","Total",1603,334,118,216,1269,224,110,362,222,78,84,189
"2011","Sheffield 069D","E01008080","Total",1483,242,105,137,1241,48,200,305,216,76,141,255
"2011","Sheffield 070A","E01008081","Total",1481,411,127,284,1070,111,162,171,202,62,147,215
"2011","Sheffield 070B","E01008082","Total",1488,406,161,245,1082,166,196,215,212,58,96,139
"2011","Sheffield 070C","E01008083","Total",1471,308,111,197,1163,148,120,255,210,120,139,171
"2011","Sheffield 070D","E01008084","Total",1644,356,81,275,1288,268,146,252,240,148,83,151
"2011","Sheffield 071A","E01007915","Total",1415,154,93,61,1261,32,282,370,208,62,105,202
"2011","Sheffield 071B","E01007917","Total",1460,234,137,97,1226,52,322,235,204,101,89,223
"2011","Sheffield 071C","E01007918","Total",1635,269,122,147,1366,57,268,364,214,101,135,227
"2011","Sheffield 071D","E01007922","Total",1406,130,69,61,1276,21,214,317,224,67,160,273
"2011","Sheffield 071E","E01007924","Total",1484,268,134,134,1216,98,190,306,234,96,97,195
"2011","Sheffield 072A","E01008021","Total",1472,96,33,63,1376,24,148,391,264,52,209,288
"2011","Sheffield 072B","E01008023","Total",2110,277,47,230,1833,88,144,645,444,78,177,257
"2011","Sheffield 072C","E01008024","Total",1786,197,95,102,1589,80,186,496,312,103,149,263
"2011","Sheffield 072D","E01008025","Total",2021,224,104,120,1797,81,238,526,386,107,181,278
"2011","Sheffield 072E","E01032585","Total",1409,196,93,103,1213,26,310,261,256,40,86,234
"2011","Sheffield 073A","E01033261","Total",1701,246,22,224,1455,2,4,62,534,17,14,822
"2011","Sheffield 073B","E01033262","Total",1139,321,7,314,818,18,2,47,334,5,5,407
"2011","Sheffield 073C","E01033263","Total",1330,225,11,214,1105,52,6,160,480,61,41,305
"2011","Sheffield 073D","E01033264","Total",1299,270,3,267,1029,16,4,64,478,0,5,462
"2011","Sheffield 073E","E01033276","Total",1641,296,1,295,1345,8,0,47,336,11,19,924
"2011","Sheffield 074A","E01008114","Total",2309,305,21,284,2004,159,36,189,238,137,274,971
"2011","Sheffield 074B","E01008115","Total",1775,125,16,109,1650,47,34,71,218,46,124,1110
"2011","Sheffield 074C","E01033265","Total",966,337,10,327,629,11,6,30,416,0,4,162
"2011","Sheffield 074D","E01033266","Total",1424,242,8,234,1182,21,2,56,340,35,56,672
"2011","Sheffield 074E","E01033267","Total",1386,191,4,187,1195,8,10,26,290,5,9,847
"2011","Sheffield 075A","E01007878","Total",1716,175,78,97,1541,167,114,203,160,149,129,619
"2011","Sheffield 075B","E01007879","Total",1637,318,138,180,1319,52,110,179,212,113,160,493
"2011","Sheffield 075C","E01007881","Total",1609,205,84,121,1404,142,158,203,270,155,184,292
"2011","Sheffield 075D","E01007882","Total",1637,155,43,112,1482,40,124,249,218,83,172,596
"2011","Sheffield 075E","E01007885","Total",1557,239,33,206,1318,156,90,279,290,147,131,225
"2011","Sheffield 075F","E01007886","Total",1623,190,76,114,1433,284,116,265,212,159,162,235
"2011","Sheffield 075G","E01033268","Total",2359,415,134,281,1944,461,150,128,320,75,53,757
"2011","Sheffield 076A","E01007838","Total",1507,176,81,95,1331,60,162,314,270,84,151,290
"2011","Sheffield 076B","E01007839","Total",1635,140,49,91,1495,84,154,508,306,66,93,284
"2011","Sheffield 076C","E01007841","Total",1604,146,66,80,1458,71,162,385,250,118,171,301
"2011","Sheffield 076D","E01007842","Total",1575,206,119,87,1369,114,186,319,234,58,172,286
"2011","Sheffield 076E","E01033278","Total",2431,473,238,235,1958,226,292,411,348,166,215,300
"2011","Sheffield 076F","E01033279","Total",2313,342,147,195,1971,155,248,478,320,153,230,387
"2011","Bradford 001A","E01010646","Total",1319,216,140,76,1103,26,254,299,224,51,86,163
"2011","Bradford 001B","E01010647","Total",1091,182,112,70,909,65,200,248,134,20,82,160
"2011","Bradford 001C","E01010648","Total",1320,176,87,89,1144,44,314,259,250,71,72,134
"2011","Bradford 001D","E01010692","Total",1800,297,149,148,1503,26,288,361,286,121,176,245
"2011","Bradford 002A","E01010691","Total",1510,169,117,52,1341,20,320,338,216,111,169,167
"2011","Bradford 002B","E01010693","Total",1448,97,59,38,1351,24,304,352,178,105,178,210
"2011","Bradford 002C","E01010694","Total",1494,141,83,58,1353,46,314,221,220,156,183,213
"2011","Bradford 002D","E01010695","Total",1639,390,243,147,1249,94,174,346,288,106,77,164
"2011","Bradford 002E","E01010696","Total",1531,131,80,51,1400,29,240,398,186,137,152,258
"2011","Bradford 002F","E01010697","Total",1468,212,125,87,1256,18,304,342,200,113,131,148
"2011","Bradford 002G","E01010698","Total",1808,325,143,182,1483,68,164,414,350,113,109,265
"2011","Bradford 002H","E01010699","Total",1757,267,145,122,1490,110,212,370,280,134,131,253
"2011","Bradford 003A","E01010767","Total",1450,213,126,87,1237,54,230,334,172,136,113,198
"2011","Bradford 003B","E01010768","Total",1659,113,45,68,1546,37,220,579,240,100,156,214
"2011","Bradford 003C","E01010769","Total",1540,269,113,156,1271,60,148,471,296,52,50,194
"2011","Bradford 003D","E01010771","Total",1260,63,38,25,1197,19,218,398,182,62,110,208
"2011","Bradford 004A","E01010638","Total",1479,175,86,89,1304,43,250,289,254,67,95,306
"2011","Bradford 004B","E01010639","Total",1762,309,128,181,1453,85,284,392,296,70,117,209
"2011","Bradford 004C","E01010640","Total",1691,280,88,192,1411,96,128,412,370,80,111,214
"2011","Bradford 004D","E01010641","Total",1457,163,93,70,1294,46,212,253,256,61,176,290
"2011","Bradford 004E","E01010642","Total",1745,136,82,54,1609,50,336,299,378,62,180,304
"2011","Bradford 004F","E01010643","Total",1364,192,74,118,1172,71,128,268,316,56,113,220
"2011","Bradford 004G","E01010644","Total",1537,159,69,90,1378,66,166,384,274,95,160,233
"2011","Bradford 004H","E01010645","Total",1301,120,80,40,1181,28,188,297,264,67,122,215
"2011","Bradford 005A","E01010770","Total",1629,95,51,44,1534,21,216,483,276,111,157,270
"2011","Bradford 005B","E01010772","Total",1270,87,71,16,1183,11,250,259,182,127,104,250
"2011","Bradford 005C","E01010773","Total",1400,207,123,84,1193,23,180,329,220,100,137,204
"2011","Bradford 005D","E01010774","Total",1570,241,119,122,1329,46,264,281,324,92,117,205
"2011","Bradford 006A","E01010706","Total",1645,197,84,113,1448,42,212,479,304,69,138,204
"2011","Bradford 006B","E01010707","Total",1727,212,90,122,1515,50,278,343,322,86,165,271
"2011","Bradford 006C","E01010708","Total",1656,160,69,91,1496,85,204,258,286,154,268,241
"2011","Bradford 006D","E01010709","Total",2652,243,131,112,2409,70,284,702,466,213,310,364
"2011","Bradford 007A","E01010719","Total",1710,100,45,55,1610,94,98,212,122,289,555,240
"2011","Bradford 007B","E01010727","Total",1690,249,121,128,1441,23,190,241,330,100,209,348
"2011","Bradford 007C","E01010728","Total",1800,120,47,73,1680,86,104,134,164,241,665,286
"2011","Bradford 007D","E01010729","Total",1446,84,44,40,1362,28,184,204,154,213,332,247
"2011","Bradford 008A","E01010700","Total",1533,97,29,68,1436,102,44,161,114,275,505,235
"2011","Bradford 008B","E01010701","Total",1474,111,43,68,1363,34,44,170,122,333,512,148
"2011","Bradford 008C","E01010702","Total",2145,123,50,73,2022,50,56,139,54,359,1069,295
"2011","Bradford 008D","E01010703","Total",1625,194,86,108,1431,95,124,373,270,144,170,255
"2011","Bradford 008E","E01010704","Total",1461,175,62,113,1286,96,134,307,236,90,148,275
"2011","Bradford 008F","E01010705","Total",1684,140,68,72,1544,72,262,292,246,136,212,324
"2011","Bradford 008G","E01010710","Total",2044,424,78,346,1620,100,66,272,250,227,450,255
"2011","Bradford 009A","E01010712","Total",1752,92,22,70,1660,119,48,284,110,425,482,192
"2011","Bradford 009B","E01010720","Total",1571,180,90,90,1391,159,114,312,172,203,177,254
"2011","Bradford 009C","E01010721","Total",1450,208,84,124,1242,136,166,241,190,128,168,213
"2011","Bradford 009D","E01010723","Total",1614,110,31,79,1504,91,34,263,156,372,446,142
"2011","Bradford 009E","E01010724","Total",1426,209,86,123,1217,165,110,287,186,86,168,215
"2011","Bradford 009F","E01010725","Total",1540,248,128,120,1292,136,164,290,242,109,137,214
"2011","Bradford 010A","E01010579","Total",1527,138,79,59,1389,25,292,395,244,36,155,242
"2011","Bradford 010B","E01010580","Total",2452,239,115,124,2213,73,240,760,438,172,186,344
"2011","Bradford 010C","E01010764","Total",1637,142,82,60,1495,24,290,347,290,76,158,310
"2011","Bradford 010D","E01010765","Total",2227,377,187,190,1850,95,296,444,434,76,129,376
"2011","Bradford 010E","E01010766","Total",1302,111,66,45,1191,37,184,339,250,61,109,211
"2011","Bradford 011A","E01010711","Total",1401,518,204,314,883,52,104,128,172,116,157,154
"2011","Bradford 011B","E01010713","Total",1350,165,73,92,1185,142,158,239,192,97,134,223
"2011","Bradford 011C","E01010714","Total",1393,208,87,121,1185,108,108,272,188,90,194,225
"2011","Bradford 011D","E01010716","Total",1865,295,105,190,1570,165,166,430,344,75,143,247
"2011","Bradford 012A","E01010715","Total",1144,141,62,79,1003,91,124,219,136,54,210,169
"2011","Bradford 012B","E01010717","Total",1606,204,91,113,1402,134,130,385,222,134,185,212
"2011","Bradford 012C","E01010718","Total",1583,231,89,142,1352,158,94,245,228,124,205,298
"2011","Bradford 012D","E01010726","Total",1517,141,87,54,1376,36,248,241,232,81,210,328
"2011","Bradford 012E","E01010859","Total",1650,140,77,63,1510,43,218,356,346,52,162,333
"2011","Bradford 013A","E01010573","Total",1782,157,83,74,1625,53,236,424,310,101,183,318
"2011","Bradford 013B","E01010574","Total",1358,200,108,92,1158,33,232,225,258,52,115,243
"2011","Bradford 013C","E01010575","Total",1619,279,154,125,1340,28,230,367,230,68,138,279
"2011","Bradford 013D","E01010577","Total",1581,162,73,89,1419,51,236,420,244,84,92,292
"2011","Bradford 014A","E01010722","Total",1584,166,44,122,1418,190,116,295,216,150,208,243
"2011","Bradford 014B","E01010860","Total",1549,169,77,92,1380,33,158,344,370,71,138,266
"2011","Bradford 014C","E01010862","Total",1706,182,75,107,1524,95,120,478,342,58,161,270
"2011","Bradford 014D","E01010863","Total",1505,133,56,77,1372,51,178,413,278,62,119,271
"2011","Bradford 015A","E01010578","Total",1488,266,73,193,1222,65,144,288,332,46,118,229
"2011","Bradford 015B","E01010581","Total",1686,184,84,100,1502,119,174,438,324,105,132,210
"2011","Bradford 015C","E01010582","Total",1629,234,64,170,1395,70,100,400,364,92,142,227
"2011","Bradford 015D","E01010584","Total",1747,386,133,253,1361,134,150,274,344,63,129,267
"2011","Bradford 015E","E01010585","Total",1924,445,243,202,1479,112,186,393,352,77,115,244
"2011","Bradford 016A","E01010568","Total",1782,288,131,157,1494,88,236,391,294,74,126,285
"2011","Bradford 016B","E01010569","Total",1712,334,149,185,1378,85,200,338,284,76,181,214
"2011","Bradford 016C","E01010571","Total",1649,351,98,253,1298,113,126,330,342,67,118,202
"2011","Bradford 016D","E01010572","Total",1450,181,108,73,1269,42,238,301,230,51,122,285
"2011","Bradford 016E","E01010576","Total",1513,170,75,95,1343,41,232,286,272,72,167,273
"2011","Bradford 017A","E01010683","Total",1613,204,45,159,1409,35,140,385,358,62,147,282
"2011","Bradford 017B","E01010684","Total",1496,191,89,102,1305,64,166,326,286,48,129,286
"2011","Bradford 017C","E01010685","Total",1654,200,73,127,1454,54,204,373,340,66,148,269
"2011","Bradford 017D","E01010686","Total",1617,183,98,85,1434,51,264,353,310,86,113,257
"2011","Bradford 018A","E01010570","Total",1412,93,58,35,1319,24,248,276,226,95,137,313
"2011","Bradford 018B","E01010583","Total",1620,305,90,215,1315,125,164,287,254,112,116,257
"2011","Bradford 018C","E01010784","Total",1592,288,71,217,1304,86,100,335,366,95,68,254
"2011","Bradford 018D","E01010785","Total",1552,376,135,241,1176,60,130,332,332,50,91,181
"2011","Bradford 018E","E01010786","Total",1442,135,84,51,1307,26,176,274,214,141,269,207
"2011","Bradford 018F","E01010790","Total",1445,132,69,63,1313,28,260,300,256,112,127,230
"2011","Bradford 019A","E01010680","Total",1778,406,132,274,1372,154,126,296,342,103,155,196
"2011","Bradford 019B","E01010681","Total",1385,74,42,32,1311,24,152,300,226,63,226,320
"2011","Bradford 019C","E01010682","Total",1487,234,123,111,1253,116,150,269,218,81,175,244
"2011","Bradford 019D","E01010687","Total",1836,164,34,130,1672,43,126,586,368,71,184,294
"2011","Bradford 019E","E01010688","Total",1819,302,69,233,1517,89,118,466,334,51,181,278
"2011","Bradford 019F","E01010689","Total",1696,241,82,159,1455,112,148,370,364,66,126,269
"2011","Bradford 019G","E01010690","Total",1907,262,144,118,1645,82,186,385,300,126,238,328
"2011","Bradford 020B","E01010782","Total",1745,406,130,276,1339,124,92,261,370,101,191,200
"2011","Bradford 020C","E01010787","Total",1591,231,134,97,1360,29,196,331,242,115,128,319
"2011","Bradford 020D","E01010788","Total",1441,199,80,119,1242,53,84,248,228,122,203,304
"2011","Bradford 020E","E01033689","Total",1196,393,68,325,803,75,34,202,384,6,26,76
"2011","Bradford 020F","E01033694","Total",1011,210,50,160,801,44,50,175,308,15,61,148
"2011","Bradford 021A","E01010776","Total",1681,187,50,137,1494,100,144,400,244,138,237,231
"2011","Bradford 021B","E01010777","Total",1482,337,92,245,1145,145,66,301,236,87,166,144
"2011","Bradford 021C","E01010779","Total",1420,207,74,133,1213,118,164,251,250,87,163,180
"2011","Bradford 021D","E01010781","Total",1501,136,40,96,1365,123,88,343,240,170,172,229
"2011","Bradford 021E","E01010783","Total",1571,189,90,99,1382,109,210,304,224,107,172,256
"2011","Bradford 022A","E01010586","Total",1600,167,87,80,1433,45,280,331,334,76,121,246
"2011","Bradford 022B","E01010587","Total",1859,245,84,161,1614,73,190,409,374,96,195,277
"2011","Bradford 022C","E01010588","Total",1665,176,83,93,1489,53,190,394,276,60,200,316
"2011","Bradford 022D","E01010589","Total",1516,152,72,80,1364,56,226,359,274,45,128,276
"2011","Bradford 022E","E01010591","Total",1524,251,122,129,1273,77,152,286,264,133,129,232
"2011","Bradford 022F","E01010593","Total",1707,218,108,110,1489,155,222,377,280,79,131,245
"2011","Bradford 022G","E01010596","Total",1440,152,79,73,1288,30,250,269,258,71,175,235
"2011","Bradford 023A","E01010854","Total",1738,304,110,194,1434,92,144,442,354,63,112,227
"2011","Bradford 023B","E01010855","Total",1747,202,105,97,1545,68,234,363,334,115,151,280
"2011","Bradford 023C","E01010856","Total",1549,308,95,213,1241,80,114,335,352,80,83,197
"2011","Bradford 023D","E01010857","Total",1580,166,76,90,1414,56,244,242,356,46,139,331
"2011","Bradford 023E","E01010858","Total",1584,204,80,124,1380,71,150,423,336,79,102,219
"2011","Bradford 023F","E01010861","Total",1837,148,55,93,1689,75,220,459,368,108,138,321
"2011","Bradford 024A","E01010603","Total",1646,151,75,76,1495,65,176,337,200,140,239,338
"2011","Bradford 024B","E01010604","Total",1808,180,133,47,1628,45,234,262,278,161,219,429
"2011","Bradford 024C","E01010605","Total",1541,197,113,84,1344,126,102,262,188,87,285,294
"2011","Bradford 024D","E01010775","Total",1849,135,63,72,1714,64,210,436,252,142,262,348
"2011","Bradford 024E","E01010778","Total",1876,220,64,156,1656,167,136,383,262,158,274,276
"2011","Bradford 025A","E01010789","Total",1799,201,62,139,1598,63,144,233,234,252,438,234
"2011","Bradford 025B","E01010791","Total",1699,122,52,70,1577,55,90,167,146,246,570,303
"2011","Bradford 025C","E01010792","Total",1876,170,40,130,1706,84,58,187,134,287,631,325
"2011","Bradford 025D","E01010793","Total",1929,141,35,106,1788,56,60,187,136,344,708,297
"2011","Bradford 026A","E01010652","Total",1554,270,140,130,1284,61,236,264,258,60,131,274
"2011","Bradford 026B","E01010653","Total",1572,232,90,142,1340,217,112,301,236,91,180,203
"2011","Bradford 026C","E01010655","Total",1446,122,34,88,1324,222,78,269,176,148,247,184
"2011","Bradford 026D","E01010656","Total",1507,180,106,74,1327,54,184,239,180,127,192,351
"2011","Bradford 026E","E01010657","Total",1542,202,69,133,1340,123,128,310,288,87,147,257
"2011","Bradford 027A","E01010649","Total",1395,181,59,122,1214,128,136,284,242,70,162,192
"2011","Bradford 027B","E01010650","Total",1647,116,38,78,1531,339,58,293,152,177,239,273
"2011","Bradford 027C","E01010654","Total",1398,191,80,111,1207,149,110,333,168,101,162,184
"2011","Bradford 027D","E01010826","Total",1468,150,50,100,1318,133,66,232,162,220,351,154
"2011","Bradford 028A","E01010597","Total",1518,166,65,101,1352,97,120,261,170,144,286,274
"2011","Bradford 028B","E01010598","Total",1751,170,86,84,1581,40,190,310,236,100,350,355
"2011","Bradford 028C","E01010599","Total",1356,98,27,71,1258,75,78,240,174,80,322,289
"2011","Bradford 028D","E01010600","Total",1433,86,35,51,1347,93,100,303,178,128,272,273
"2011","Bradford 028E","E01010602","Total",1521,175,80,95,1346,71,158,288,194,156,199,280
"2011","Bradford 029A","E01010670","Total",1563,96,30,66,1467,75,44,176,142,164,525,341
"2011","Bradford 029B","E01010671","Total",1694,108,60,48,1586,49,90,250,60,237,572,328
"2011","Bradford 029C","E01010673","Total",1809,129,29,100,1680,75,52,208,106,287,739,213
"2011","Bradford 029D","E01010675","Total",1886,183,92,91,1703,40,150,172,144,192,585,420
"2011","Bradford 030A","E01010669","Total",1934,134,78,56,1800,88,150,339,206,391,390,236
"2011","Bradford 030B","E01010674","Total",1627,110,56,54,1517,113,74,262,122,382,365,199
"2011","Bradford 030C","E01010677","Total",2129,124,60,64,2005,213,62,418,150,419,512,231
"2011","Bradford 030D","E01010805","Total",1545,100,32,68,1445,32,110,215,140,166,550,232
"2011","Bradford 031A","E01010590","Total",1796,232,77,155,1564,91,174,341,298,99,220,341
"2011","Bradford 031B","E01010592","Total",1460,210,119,91,1250,56,260,284,230,40,126,254
"2011","Bradford 031C","E01010594","Total",1690,164,77,87,1526,73,198,348,284,79,216,328
"2011","Bradford 031D","E01010595","Total",1799,261,107,154,1538,149,152,414,286,93,170,274
"2011","Bradford 032A","E01010601","Total",1722,246,95,151,1476,106,136,340,268,133,220,273
"2011","Bradford 032B","E01010651","Total",1521,165,91,74,1356,63,154,300,266,96,238,239
"2011","Bradford 032C","E01010825","Total",1346,112,41,71,1234,102,116,252,232,106,193,233
"2011","Bradford 032D","E01010827","Total",1322,161,58,103,1161,87,118,258,170,103,266,159
"2011","Bradford 033A","E01010804","Total",2314,37,16,21,2277,33,58,188,62,231,1191,514
"2011","Bradford 033B","E01010806","Total",1581,158,62,96,1423,41,72,184,84,235,541,266
"2011","Bradford 033C","E01010807","Total",2094,324,86,238,1770,72,60,236,158,204,738,302
"2011","Bradford 033D","E01010808","Total",2275,58,17,41,2217,70,40,275,88,538,861,345
"2011","Bradford 033E","E01010809","Total",2235,54,19,35,2181,36,38,138,74,357,1069,469
"2011","Bradford 034A","E01010676","Total",2420,60,15,45,2360,82,38,118,72,423,1289,338
"2011","Bradford 034B","E01010679","Total",1654,220,29,191,1434,33,22,79,56,149,818,277
"2011","Bradford 034C","E01010824","Total",1630,395,58,337,1235,40,40,253,156,115,468,163
"2011","Bradford 034D","E01010840","Total",1603,174,90,84,1429,47,76,144,52,198,643,269
"2011","Bradford 034E","E01010841","Total",1802,161,28,133,1641,29,38,87,50,305,835,297
"2011","Bradford 035A","E01010828","Total",1624,312,150,162,1312,143,128,182,222,130,283,224
"2011","Bradford 035B","E01010829","Total",1630,221,67,154,1409,69,66,200,176,283,395,220
"2011","Bradford 035C","E01010830","Total",1836,177,59,118,1659,114,78,268,188,376,357,278
"2011","Bradford 035D","E01010831","Total",1995,158,15,143,1837,102,46,155,114,449,709,262
"2011","Bradford 035E","E01010832","Total",1694,103,47,56,1591,84,52,236,84,295,623,217
"2011","Bradford 036A","E01010672","Total",1301,123,50,73,1178,37,134,318,236,95,135,223
"2011","Bradford 036B","E01010678","Total",1345,161,56,105,1184,36,148,221,218,92,241,228
"2011","Bradford 036C","E01010799","Total",1518,201,86,115,1317,107,144,261,270,140,194,201
"2011","Bradford 036D","E01010800","Total",1759,242,111,131,1517,324,76,349,136,248,175,209
"2011","Bradford 036E","E01010801","Total",1829,153,54,99,1676,85,110,310,200,272,456,243
"2011","Bradford 036F","E01010802","Total",1594,191,51,140,1403,169,90,284,196,193,200,271
"2011","Bradford 037A","E01010803","Total",1809,129,28,101,1680,52,56,286,130,329,546,281
"2011","Bradford 037B","E01010810","Total",2014,76,45,31,1938,63,100,292,78,406,718,281
"2011","Bradford 037C","E01010811","Total",2202,95,18,77,2107,77,40,276,96,508,859,251
"2011","Bradford 037D","E01010813","Total",1811,148,50,98,1663,78,48,292,96,414,567,168
"2011","Bradford 038A","E01010618","Total",1704,128,50,78,1576,53,56,182,136,313,653,183
"2011","Bradford 038B","E01010619","Total",2240,60,35,25,2180,76,56,153,78,342,1033,442
"2011","Bradford 038C","E01010625","Total",1660,103,34,69,1557,146,62,225,110,279,482,253
"2011","Bradford 038D","E01010626","Total",1991,51,20,31,1940,103,66,222,98,377,796,278
"2011","Bradford 038E","E01010627","Total",1604,143,35,108,1461,122,50,247,140,202,425,275
"2011","Bradford 039A","E01010606","Total",1961,182,57,125,1779,95,40,257,122,406,570,289
"2011","Bradford 039B","E01010607","Total",2072,152,13,139,1920,133,38,277,96,363,779,234
"2011","Bradford 039C","E01010617","Total",1369,276,96,180,1093,119,46,206,166,207,203,146
"2011","Bradford 039E","E01010842","Total",1911,221,48,173,1690,87,48,194,94,322,665,280
"2011","Bradford 039G","E01033690","Total",1134,382,5,377,752,20,0,126,438,51,16,101
"2011","Bradford 039H","E01033691","Total",1524,297,71,226,1227,41,52,137,208,142,493,154
"2011","Bradford 039I","E01033692","Total",1079,315,25,290,764,31,22,135,306,98,78,94
"2011","Bradford 039J","E01033693","Total",2380,180,11,169,2200,53,34,317,162,368,991,275
"2011","Bradford 040A","E01010628","Total",1668,210,93,117,1458,88,162,324,208,144,259,273
"2011","Bradford 040B","E01010629","Total",1904,141,57,84,1763,91,112,277,166,364,456,297
"2011","Bradford 040C","E01010630","Total",1574,188,120,68,1386,95,132,302,158,288,173,238
"2011","Bradford 040D","E01010631","Total",1495,150,38,112,1345,165,78,281,168,244,250,159
"2011","Bradford 040E","E01010632","Total",1338,122,24,98,1216,170,52,295,164,184,191,160
"2011","Bradford 041A","E01010658","Total",1985,116,41,75,1869,91,68,301,166,397,486,360
"2011","Bradford 041B","E01010812","Total",2044,183,38,145,1861,84,50,304,162,462,559,240
"2011","Bradford 041C","E01010833","Total",1663,159,57,102,1504,54,44,200,118,203,567,318
"2011","Bradford 041D","E01010843","Total",2125,61,9,52,2064,39,26,150,58,315,1129,347
"2011","Bradford 042A","E01010620","Total",1789,124,39,85,1665,96,44,183,112,341,639,250
"2011","Bradford 042B","E01010621","Total",2371,43,9,34,2328,100,28,261,86,596,903,354
"2011","Bradford 042C","E01010622","Total",2372,115,27,88,2257,178,36,268,158,532,797,288
"2011","Bradford 042D","E01010623","Total",1681,166,58,108,1515,120,36,207,106,215,546,285
"2011","Bradford 042E","E01010624","Total",2274,135,32,103,2139,99,34,252,112,418,956,268
"2011","Bradford 043A","E01010794","Total",1812,238,125,113,1574,135,250,329,262,96,235,267
"2011","Bradford 043B","E01010795","Total",1791,221,56,165,1570,82,132,448,324,72,229,283
"2011","Bradford 043C","E01010796","Total",1600,233,100,133,1367,108,148,298,242,87,226,258
"2011","Bradford 043D","E01010797","Total",1394,92,31,61,1302,34,136,393,256,42,156,285
"2011","Bradford 043E","E01010798","Total",1546,225,76,149,1321,119,138,330,288,105,121,220
"2011","Bradford 044A","E01010834","Total",1744,327,8,319,1417,8,12,93,206,53,487,558
"2011","Bradford 044B","E01010835","Total",3196,128,35,93,3068,50,86,209,164,554,1347,658
"2011","Bradford 044C","E01010836","Total",1783,150,19,131,1633,13,32,124,104,224,558,578
"2011","Bradford 044D","E01010837","Total",2188,55,19,36,2133,44,52,199,106,374,906,452
"2011","Bradford 044E","E01010838","Total",1920,98,19,79,1822,80,42,198,108,312,857,225
"2011","Bradford 044F","E01010839","Total",1663,146,37,109,1517,73,30,193,124,200,688,209
"2011","Bradford 045A","E01010608","Total",1884,84,14,70,1800,114,26,251,84,506,603,216
"2011","Bradford 045B","E01010613","Total",1477,241,87,154,1236,176,108,192,184,97,247,232
"2011","Bradford 045C","E01010730","Total",1568,406,92,314,1162,158,64,235,212,96,160,237
"2011","Bradford 045D","E01010734","Total",1574,120,26,94,1454,203,32,274,152,207,368,218
"2011","Bradford 046A","E01010609","Total",1542,252,114,138,1290,160,134,316,214,63,166,237
"2011","Bradford 046B","E01010610","Total",1573,284,94,190,1289,250,70,254,188,194,143,190
"2011","Bradford 046C","E01010611","Total",2210,287,99,188,1923,191,102,479,284,201,388,278
"2011","Bradford 046D","E01010614","Total",1345,168,50,118,1177,166,84,239,218,118,147,205
"2011","Bradford 047A","E01010633","Total",1563,163,65,98,1400,75,136,303,250,79,253,304
"2011","Bradford 047B","E01010634","Total",1445,131,73,58,1314,64,178,293,254,62,194,269
"2011","Bradford 047C","E01010635","Total",1443,290,123,167,1153,156,118,269,136,105,197,172
"2011","Bradford 047D","E01010636","Total",1736,237,117,120,1499,83,160,379,278,84,199,316
"2011","Bradford 047E","E01010637","Total",1377,129,39,90,1248,109,76,354,222,84,183,220
"2011","Bradford 048A","E01010731","Total",1680,367,59,308,1313,46,40,144,180,114,519,270
"2011","Bradford 048B","E01010732","Total",2016,211,27,184,1805,145,34,410,210,295,513,198
"2011","Bradford 048C","E01010733","Total",1885,275,67,208,1610,157,56,308,142,204,462,281
"2011","Bradford 048D","E01010736","Total",2049,209,39,170,1840,157,44,391,228,356,424,240
"2011","Bradford 048E","E01010737","Total",1734,155,30,125,1579,112,40,203,98,276,642,208
"2011","Bradford 049A","E01010659","Total",1876,153,59,94,1723,177,64,303,130,294,455,300
"2011","Bradford 049D","E01010662","Total",1376,94,33,61,1282,84,96,267,188,97,252,298
"2011","Bradford 049E","E01010664","Total",1523,130,62,68,1393,56,138,206,170,145,383,295
"2011","Bradford 049G","E01010761","Total",1616,219,102,117,1397,112,166,322,246,115,204,232
"2011","Bradford 049H","E01033695","Total",1950,145,24,121,1805,135,60,622,278,172,228,310
"2011","Bradford 049I","E01033696","Total",1530,199,55,144,1331,92,126,389,254,85,156,229
"2011","Bradford 049J","E01033697","Total",2837,154,48,106,2683,100,78,394,190,586,889,446
"2011","Bradford 050A","E01010663","Total",1641,242,76,166,1399,106,76,206,214,193,430,174
"2011","Bradford 050B","E01010665","Total",1661,159,45,114,1502,92,134,272,184,226,311,283
"2011","Bradford 050C","E01010666","Total",1475,277,119,158,1198,154,92,238,212,145,189,168
"2011","Bradford 050D","E01010667","Total",1605,175,44,131,1430,106,112,333,214,226,268,171
"2011","Bradford 051A","E01010735","Total",1776,87,28,59,1689,214,56,255,108,421,401,234
"2011","Bradford 051B","E01010738","Total",2032,96,20,76,1936,153,36,338,112,372,662,263
"2011","Bradford 051C","E01010739","Total",1789,176,75,101,1613,212,60,296,134,359,381,171
"2011","Bradford 051D","E01010740","Total",1816,148,54,94,1668,109,58,149,94,308,610,340
"2011","Bradford 051E","E01010744","Total",1825,73,25,48,1752,71,42,300,106,318,676,239
"2011","Bradford 052A","E01010612","Total",1377,213,37,176,1164,251,70,226,138,168,134,177
"2011","Bradford 052B","E01010819","Total",1540,220,100,120,1320,313,110,244,148,97,236,172
"2011","Bradford 052C","E01010820","Total",1525,191,87,104,1334,198,108,301,146,182,254,145
"2011","Bradford 052D","E01010821","Total",2046,220,58,162,1826,331,56,540,258,234,178,229
"2011","Bradford 052E","E01010822","Total",1326,179,67,112,1147,179,88,292,160,85,159,184
"2011","Bradford 053A","E01010615","Total",1417,148,50,98,1269,105,90,278,244,123,203,226
"2011","Bradford 053B","E01010616","Total",1858,125,52,73,1733,149,110,290,142,260,476,306
"2011","Bradford 053C","E01010742","Total",1988,183,64,119,1805,117,42,269,126,422,588,241
"2011","Bradford 053D","E01010743","Total",1817,255,73,182,1562,118,72,209,194,309,452,208
"2011","Bradford 054A","E01010847","Total",1570,213,82,131,1357,139,132,332,240,133,129,252
"2011","Bradford 054B","E01010848","Total",1504,214,97,117,1290,74,156,283,232,61,232,252
"2011","Bradford 054C","E01010852","Total",1594,221,128,93,1373,157,174,254,182,225,184,197
"2011","Bradford 054D","E01010853","Total",1325,113,56,57,1212,76,130,249,210,115,169,263
"2011","Bradford 055A","E01010668","Total",1356,122,64,58,1234,58,170,181,190,152,227,256
"2011","Bradford 055B","E01010755","Total",1673,187,52,135,1486,284,66,435,208,140,161,192
"2011","Bradford 055C","E01010762","Total",1594,161,66,95,1433,114,114,334,210,133,313,215
"2011","Bradford 055D","E01010763","Total",1479,174,84,90,1305,83,178,246,220,98,147,333
"2011","Bradford 055E","E01010846","Total",2150,232,75,157,1918,138,160,433,326,204,316,341
"2011","Bradford 056A","E01010745","Total",1657,173,47,126,1484,198,82,263,190,205,305,241
"2011","Bradford 056B","E01010747","Total",1614,210,106,104,1404,79,120,277,210,186,295,237
"2011","Bradford 056C","E01010748","Total",1507,229,132,97,1278,205,124,239,224,57,211,218
"2011","Bradford 056D","E01010749","Total",1344,226,103,123,1118,118,120,230,214,66,169,201
"2011","Bradford 057A","E01010814","Total",1648,327,106,221,1321,154,126,297,302,49,184,209
"2011","Bradford 057B","E01010815","Total",2345,208,58,150,2137,208,104,616,298,189,377,345
"2011","Bradford 057C","E01010816","Total",1873,166,50,116,1707,116,190,472,366,110,184,269
"2011","Bradford 057D","E01010817","Total",2149,276,91,185,1873,338,126,475,226,139,253,316
"2011","Bradford 057E","E01010818","Total",1853,142,45,97,1711,109,136,453,270,129,282,332
"2011","Bradford 058A","E01010752","Total",1733,306,82,224,1427,114,140,385,340,58,134,256
"2011","Bradford 058B","E01010753","Total",1437,113,66,47,1324,50,234,262,286,35,127,330
"2011","Bradford 058C","E01010754","Total",1607,191,80,111,1416,92,110,407,254,106,200,247
"2011","Bradford 058D","E01010756","Total",1457,166,51,115,1291,104,90,292,274,64,190,277
"2011","Bradford 058E","E01010758","Total",1290,65,21,44,1225,33,80,376,250,52,139,295
"2011","Bradford 058F","E01010759","Total",1545,202,102,100,1343,108,154,335,222,101,160,263
"2011","Bradford 058G","E01010760","Total",1552,120,51,69,1432,67,144,406,268,82,156,309
"2011","Bradford 059A","E01010741","Total",1487,216,61,155,1271,82,164,319,204,63,131,308
"2011","Bradford 059B","E01010845","Total",2013,301,140,161,1712,206,138,348,272,230,304,214
"2011","Bradford 059C","E01010849","Total",1411,172,95,77,1239,37,186,311,216,86,112,291
"2011","Bradford 059D","E01010850","Total",1381,120,36,84,1261,192,52,263,170,154,238,192
"2011","Bradford 059E","E01010851","Total",1578,183,55,128,1395,97,146,307,262,107,172,304
"2011","Bradford 059F","E01010864","Total",1320,138,40,98,1182,139,72,344,200,111,155,161
"2011","Bradford 059G","E01010867","Total",1468,140,40,100,1328,176,110,330,202,140,153,217
"2011","Bradford 059H","E01010874","Total",1157,187,85,102,970,133,70,213,168,104,116,166
"2011","Bradford 060A","E01010746","Total",1628,181,101,80,1447,72,252,207,252,74,236,354
"2011","Bradford 060B","E01010750","Total",1602,202,96,106,1400,94,196,316,246,82,135,331
"2011","Bradford 060C","E01010751","Total",1509,218,127,91,1291,81,202,237,236,87,126,322
"2011","Bradford 060D","E01010865","Total",1618,187,68,119,1431,104,168,380,336,65,123,255
"2011","Bradford 060E","E01010866","Total",1355,182,56,126,1173,101,116,294,308,60,127,167
"2011","Bradford 061A","E01010868","Total",1602,252,58,194,1350,139,116,287,268,106,210,224
"2011","Bradford 061B","E01010869","Total",1693,218,83,135,1475,157,174,322,298,61,174,289
"2011","Bradford 061C","E01010870","Total",1503,206,109,97,1297,57,190,306,328,25,131,260
"2011","Bradford 061D","E01010871","Total",1686,242,77,165,1444,165,152,312,286,70,159,300
"2011","Bradford 061E","E01010872","Total",1611,194,86,108,1417,171,148,297,202,133,200,266
"2011","Bradford 061F","E01010873","Total",1224,114,62,52,1110,41,208,227,184,41,144,265
"2011","Calderdale 001A","E01010911","Total",1706,169,68,101,1537,90,198,315,330,99,199,306
"2011","Calderdale 001B","E01010912","Total",1565,252,109,143,1313,148,182,292,174,138,179,200
"2011","Calderdale 001C","E01010913","Total",1283,134,92,42,1149,41,208,237,232,15,114,302
"2011","Calderdale 001D","E01010915","Total",1394,137,54,83,1257,72,148,325,244,41,173,254
"2011","Calderdale 002A","E01010914","Total",1841,237,71,166,1604,183,152,336,304,151,228,250
"2011","Calderdale 002B","E01010924","Total",1186,341,62,279,845,135,102,108,198,73,100,129
"2011","Calderdale 002C","E01010925","Total",1404,171,71,100,1233,143,126,181,212,116,198,257
"2011","Calderdale 002D","E01010926","Total",1196,93,30,63,1103,199,60,306,144,134,127,133
"2011","Calderdale 003A","E01010931","Total",1406,187,103,84,1219,42,194,293,204,46,189,251
"2011","Calderdale 003B","E01010932","Total",1536,175,78,97,1361,50,248,338,288,20,98,319
"2011","Calderdale 003C","E01010933","Total",1578,205,107,98,1373,85,196,291,298,62,143,298
"2011","Calderdale 003D","E01010935","Total",1560,183,88,95,1377,74,284,340,242,35,80,322
"2011","Calderdale 003E","E01010936","Total",2000,219,123,96,1781,74,224,598,256,120,219,290
"2011","Calderdale 003F","E01010937","Total",1560,199,92,107,1361,66,210,356,270,102,96,261
"2011","Calderdale 004A","E01010881","Total",1652,208,53,155,1444,119,136,431,330,80,109,239
"2011","Calderdale 004B","E01010882","Total",1441,230,120,110,1211,53,150,329,258,109,128,184
"2011","Calderdale 004C","E01010883","Total",1528,174,69,105,1354,39,172,383,306,75,169,210
"2011","Calderdale 004D","E01010887","Total",1607,196,55,141,1411,66,202,350,346,84,122,241
"2011","Calderdale 004E","E01010888","Total",1531,345,95,250,1186,127,106,313,362,30,86,162
"2011","Calderdale 004F","E01010923","Total",1601,324,84,240,1277,169,96,317,372,78,83,162
"2011","Calderdale 005A","E01010916","Total",1427,168,78,90,1259,181,116,262,160,85,213,242
"2011","Calderdale 005B","E01010939","Total",1758,167,70,97,1591,42,182,455,298,106,209,299
"2011","Calderdale 005C","E01010941","Total",1346,134,71,63,1212,163,86,236,182,100,187,258
"2011","Calderdale 005D","E01010942","Total",1600,349,99,250,1251,157,116,241,222,104,189,222
"2011","Calderdale 005E","E01010944","Total",1363,210,99,111,1153,162,104,249,186,135,119,198
"2011","Calderdale 006A","E01010938","Total",1421,208,55,153,1213,208,106,288,190,134,98,189
"2011","Calderdale 006B","E01010940","Total",1426,208,72,136,1218,111,126,260,252,80,120,269
"2011","Calderdale 006C","E01010943","Total",1495,174,45,129,1321,214,90,313,166,78,204,256
"2011","Calderdale 006D","E01010961","Total",1133,190,40,150,943,152,64,185,238,63,69,172
"2011","Calderdale 007A","E01010917","Total",1814,307,128,179,1507,63,258,413,346,77,101,249
"2011","Calderdale 007B","E01010918","Total",1695,203,104,99,1492,87,202,430,290,68,159,256
"2011","Calderdale 007C","E01010919","Total",1589,313,171,142,1276,111,226,280,240,78,140,201
"2011","Calderdale 007D","E01010920","Total",1670,207,72,135,1463,69,178,337,334,97,161,287
"2011","Calderdale 007E","E01010921","Total",1640,237,87,150,1403,109,188,367,250,128,164,197
"2011","Calderdale 008A","E01010934","Total",1945,307,105,202,1638,96,210,389,420,79,119,325
"2011","Calderdale 008D","E01010967","Total",1488,395,117,278,1093,148,106,281,232,73,70,183
"2011","Calderdale 008E","E01010994","Total",1611,717,190,527,894,50,118,152,280,28,116,150
"2011","Calderdale 008F","E01032923","Total",2313,457,128,329,1856,214,200,490,396,84,168,304
"2011","Calderdale 009A","E01010927","Total",1637,149,91,58,1488,74,256,318,340,72,196,232
"2011","Calderdale 009B","E01010928","Total",1415,194,73,121,1221,190,110,242,224,134,127,194
"2011","Calderdale 009C","E01010997","Total",1455,163,98,65,1292,41,264,238,234,26,217,272
"2011","Calderdale 009D","E01010999","Total",1486,146,75,71,1340,54,240,277,298,68,149,254
"2011","Calderdale 010A","E01010929","Total",2369,258,83,175,2111,193,114,572,298,368,306,260
"2011","Calderdale 010B","E01010930","Total",1576,279,113,166,1297,235,142,327,200,74,126,193
"2011","Calderdale 010C","E01010998","Total",1611,276,137,139,1335,128,152,297,220,85,251,202
"2011","Calderdale 010D","E01011000","Total",2051,130,55,75,1921,142,76,364,130,346,594,269
"2011","Calderdale 011A","E01010904","Total",1395,139,61,78,1256,61,170,342,274,30,94,285
"2011","Calderdale 011B","E01010906","Total",1404,125,79,46,1279,43,268,334,248,62,123,201
"2011","Calderdale 011C","E01010907","Total",1425,158,60,98,1267,57,172,356,226,55,116,285
"2011","Calderdale 011D","E01010909","Total",1485,266,111,155,1219,110,174,313,264,61,107,190
"2011","Calderdale 012A","E01010960","Total",1626,94,28,66,1532,107,44,222,136,243,559,221
"2011","Calderdale 012B","E01010964","Total",1629,238,82,156,1391,110,52,223,96,234,439,237
"2011","Calderdale 012C","E01010965","Total",1473,246,95,151,1227,43,52,96,54,173,557,252
"2011","Calderdale 012D","E01010966","Total",1691,141,37,104,1550,93,40,229,94,288,574,232
"2011","Calderdale 012E","E01010995","Total",1316,124,29,95,1192,63,24,132,80,134,545,214
"2011","Calderdale 013A","E01010982","Total",1336,187,67,120,1149,62,184,246,250,73,156,178
"2011","Calderdale 013B","E01010983","Total",1543,331,111,220,1212,91,128,250,272,67,206,198
"2011","Calderdale 013C","E01010985","Total",1416,191,58,133,1225,70,146,308,316,52,135,198
"2011","Calderdale 013D","E01010986","Total",1690,285,70,215,1405,162,106,313,324,140,135,225
"2011","Calderdale 013E","E01010987","Total",1726,245,118,127,1481,129,172,433,300,83,97,267
"2011","Calderdale 013F","E01010988","Total",1454,207,88,119,1247,108,146,242,244,85,165,257
"2011","Calderdale 014A","E01010996","Total",1603,89,34,55,1514,72,36,203,54,301,575,273
"2011","Calderdale 014B","E01011001","Total",1640,87,19,68,1553,96,44,188,122,256,579,268
"2011","Calderdale 014C","E01011002","Total",1745,181,55,126,1564,87,100,319,212,217,418,211
"2011","Calderdale 014D","E01011003","Total",1214,248,97,151,966,147,44,146,166,125,155,183
"2011","Calderdale 015A","E01010878","Total",1756,400,135,265,1356,135,144,282,354,125,64,252
"2011","Calderdale 015B","E01010879","Total",1831,239,117,122,1592,39,294,368,360,99,142,290
"2011","Calderdale 015C","E01010905","Total",1819,193,89,104,1626,74,202,522,334,97,125,272
"2011","Calderdale 015D","E01010908","Total",2086,307,119,188,1779,114,218,532,420,63,145,287
"2011","Calderdale 015E","E01010910","Total",1275,205,90,115,1070,82,162,235,172,92,119,208
"2011","Calderdale 016A","E01010969","Total",1686,234,88,146,1452,88,176,319,326,111,150,282
"2011","Calderdale 016B","E01010970","Total",1825,360,136,224,1465,67,176,306,352,131,172,261
"2011","Calderdale 016C","E01010974","Total",1524,239,110,129,1285,87,96,225,168,131,351,227
"2011","Calderdale 016D","E01010977","Total",1515,184,82,102,1331,84,230,252,292,58,130,285
"2011","Calderdale 017A","E01010975","Total",1533,280,185,95,1253,51,306,211,234,76,126,249
"2011","Calderdale 017B","E01010976","Total",1794,212,111,101,1582,40,216,369,376,99,176,306
"2011","Calderdale 017C","E01010978","Total",1303,176,51,125,1127,110,74,302,244,67,102,228
"2011","Calderdale 017D","E01010979","Total",1513,441,104,337,1072,93,106,221,326,47,106,173
"2011","Calderdale 017E","E01010980","Total",1463,229,60,169,1234,133,102,297,324,80,102,196
"2011","Calderdale 017F","E01010981","Total",1472,250,56,194,1222,130,100,263,314,66,142,207
"2011","Calderdale 018A","E01010989","Total",1501,303,96,207,1198,50,186,193,302,110,140,217
"2011","Calderdale 018B","E01010990","Total",1636,234,88,146,1402,119,182,375,262,67,152,245
"2011","Calderdale 018C","E01010991","Total",1576,172,71,101,1404,96,234,409,268,60,74,263
"2011","Calderdale 018D","E01010992","Total",1689,273,101,172,1416,148,134,415,326,53,152,188
"2011","Calderdale 018E","E01010993","Total",1686,248,92,156,1438,155,112,379,268,67,233,224
"2011","Calderdale 019A","E01010875","Total",1734,218,143,75,1516,49,336,419,294,81,113,224
"2011","Calderdale 019B","E01010876","Total",1628,166,78,88,1462,62,242,399,270,61,177,251
"2011","Calderdale 019C","E01010877","Total",1501,339,124,215,1162,88,206,254,268,20,136,190
"2011","Calderdale 019D","E01010880","Total",1482,288,87,201,1194,133,164,295,230,79,123,170
"2011","Calderdale 019E","E01010949","Total",1533,297,105,192,1236,143,130,254,282,70,128,229
"2011","Calderdale 020A","E01010922","Total",1896,221,56,165,1675,126,172,502,322,90,143,320
"2011","Calderdale 020B","E01010956","Total",1539,195,51,144,1344,54,194,279,326,67,139,285
"2011","Calderdale 020C","E01010958","Total",1471,254,153,101,1217,109,200,212,194,121,168,213
"2011","Calderdale 020D","E01010959","Total",1755,149,66,83,1606,146,226,387,292,117,120,318
"2011","Calderdale 021A","E01010968","Total",1732,269,89,180,1463,68,176,347,294,80,192,306
"2011","Calderdale 021B","E01010971","Total",1905,258,131,127,1647,83,216,475,294,153,175,251
"2011","Calderdale 021C","E01010972","Total",1593,187,107,80,1406,57,214,324,256,119,181,255
"2011","Calderdale 021D","E01010973","Total",1668,269,144,125,1399,75,252,366,268,63,109,266
"2011","Calderdale 022A","E01010884","Total",1589,295,166,129,1294,102,222,248,294,86,130,212
"2011","Calderdale 022B","E01010885","Total",1396,222,79,143,1174,63,148,325,294,53,78,213
"2011","Calderdale 022C","E01010886","Total",1113,172,62,110,941,35,138,219,218,73,95,163
"2011","Calderdale 022D","E01010984","Total",1287,191,42,149,1096,106,118,281,238,70,86,197
"2011","Calderdale 023A","E01010946","Total",1379,120,86,34,1259,33,288,241,196,81,152,268
"2011","Calderdale 023B","E01010947","Total",1490,167,85,82,1323,51,204,427,246,31,107,257
"2011","Calderdale 023C","E01010950","Total",1432,279,64,215,1153,102,134,298,220,79,85,235
"2011","Calderdale 023D","E01010951","Total",1421,226,70,156,1195,131,140,307,282,48,79,208
"2011","Calderdale 024A","E01010891","Total",1737,287,100,187,1450,159,186,364,288,98,127,228
"2011","Calderdale 024B","E01010892","Total",1901,151,57,94,1750,108,170,555,308,101,209,299
"2011","Calderdale 024C","E01010895","Total",1398,228,95,133,1170,86,170,279,228,70,93,244
"2011","Calderdale 024D","E01010945","Total",1603,159,63,96,1444,70,200,351,282,107,139,295
"2011","Calderdale 024E","E01010948","Total",1378,221,128,93,1157,48,230,249,210,78,105,237
"2011","Calderdale 025A","E01010889","Total",1728,402,158,244,1326,153,192,248,312,95,155,171
"2011","Calderdale 025B","E01010890","Total",1786,298,80,218,1488,130,154,353,420,70,172,189
"2011","Calderdale 025C","E01010893","Total",1395,211,106,105,1184,75,152,316,192,58,171,220
"2011","Calderdale 025D","E01010894","Total",1613,269,79,190,1344,168,122,347,244,97,121,245
"2011","Calderdale 025E","E01010901","Total",1651,192,88,104,1459,70,278,328,304,82,130,267
"2011","Calderdale 025F","E01010903","Total",1647,215,107,108,1432,104,236,388,236,50,183,235
"2011","Calderdale 026A","E01010896","Total",1628,145,41,104,1483,32,190,427,322,107,138,267
"2011","Calderdale 026B","E01010897","Total",1671,244,75,169,1427,56,148,364,362,86,141,270
"2011","Calderdale 026C","E01010898","Total",1648,325,114,211,1323,120,110,367,316,56,120,234
"2011","Calderdale 026D","E01010899","Total",1408,130,75,55,1278,99,162,328,238,86,128,237
"2011","Calderdale 026E","E01010900","Total",1573,150,58,92,1423,39,222,413,304,61,114,270
"2011","Calderdale 026F","E01010902","Total",1589,176,72,104,1413,170,114,367,268,134,170,190
"2011","Calderdale 027A","E01010952","Total",1546,254,138,116,1292,77,148,279,308,87,145,248
"2011","Calderdale 027B","E01010953","Total",1467,142,63,79,1325,63,152,401,258,83,131,237
"2011","Calderdale 027C","E01010954","Total",2389,223,68,155,2166,110,172,778,452,193,187,274
"2011","Calderdale 027D","E01010955","Total",1388,172,39,133,1216,54,140,343,276,42,117,244
"2011","Calderdale 027E","E01010957","Total",1485,161,58,103,1324,35,158,378,340,40,105,268
"2011","Kirklees 001A","E01011051","Total",1566,182,80,102,1384,71,198,391,276,51,133,264
"2011","Kirklees 001B","E01011055","Total",1256,153,73,80,1103,48,164,269,254,71,128,169
"2011","Kirklees 001C","E01011056","Total",1609,187,100,87,1422,78,214,395,280,61,132,262
"2011","Kirklees 001D","E01011057","Total",1365,204,92,112,1161,60,160,312,246,44,121,218
"2011","Kirklees 001E","E01011058","Total",1237,109,61,48,1128,98,178,318,174,58,95,207
"2011","Kirklees 002A","E01011048","Total",1599,412,190,222,1187,90,186,195,296,50,87,283
"2011","Kirklees 002B","E01011049","Total",1644,183,81,102,1461,132,182,298,274,99,187,289
"2011","Kirklees 002C","E01011050","Total",1520,129,58,71,1391,38,216,320,258,104,139,316
"2011","Kirklees 002D","E01011052","Total",1642,208,66,142,1434,114,134,434,276,83,139,254
"2011","Kirklees 002E","E01011053","Total",1476,139,57,82,1337,39,212,373,268,52,104,289
"2011","Kirklees 002F","E01011059","Total",1524,172,40,132,1352,239,70,362,212,168,140,161
"2011","Kirklees 003A","E01011062","Total",1694,203,62,141,1491,112,178,401,326,83,122,269
"2011","Kirklees 003B","E01011064","Total",1432,192,70,122,1240,131,180,302,264,61,132,170
"2011","Kirklees 003C","E01011068","Total",1669,191,85,106,1478,74,214,418,284,60,126,302
"2011","Kirklees 003D","E01011069","Total",1341,185,82,103,1156,38,206,271,254,62,108,217
"2011","Kirklees 004A","E01011241","Total",1648,121,59,62,1527,58,184,498,292,86,137,272
"2011","Kirklees 004B","E01011242","Total",1580,193,97,96,1387,94,216,330,218,89,169,271
"2011","Kirklees 004C","E01011243","Total",1681,187,82,105,1494,80,244,382,314,42,132,300
"2011","Kirklees 004D","E01011244","Total",2033,191,46,145,1842,136,178,543,368,114,189,314
"2011","Kirklees 005A","E01011060","Total",1621,317,112,205,1304,48,192,307,304,69,149,235
"2011","Kirklees 005B","E01011061","Total",1635,432,147,285,1203,114,122,286,274,69,150,188
"2011","Kirklees 005C","E01011063","Total",2047,360,129,231,1687,120,244,496,352,79,143,253
"2011","Kirklees 005D","E01011065","Total",1662,198,54,144,1464,118,100,396,280,99,156,315
"2011","Kirklees 005E","E01011066","Total",1514,148,83,65,1366,45,222,348,220,72,140,319
"2011","Kirklees 006A","E01011027","Total",1252,116,41,75,1136,115,124,228,220,86,147,216
"2011","Kirklees 006B","E01011028","Total",1444,258,70,188,1186,124,106,299,222,98,131,206
"2011","Kirklees 006C","E01011030","Total",1530,129,35,94,1401,207,72,379,186,160,149,248
"2011","Kirklees 006D","E01011031","Total",1627,143,87,56,1484,43,234,292,282,85,193,355
"2011","Kirklees 006E","E01011054","Total",1346,125,60,65,1221,38,276,215,256,56,98,282
"2011","Kirklees 007A","E01011013","Total",1487,148,102,46,1339,33,280,269,268,123,148,218
"2011","Kirklees 007B","E01011014","Total",1529,202,54,148,1327,80,74,274,222,170,255,252
"2011","Kirklees 007C","E01011023","Total",1670,178,58,120,1492,38,164,279,198,232,300,281
"2011","Kirklees 007D","E01011024","Total",1762,199,51,148,1563,118,110,376,174,237,246,302
"2011","Kirklees 008A","E01011067","Total",1574,180,85,95,1394,89,200,280,284,66,197,278
"2011","Kirklees 008B","E01011247","Total",1554,140,53,87,1414,75,132,398,346,62,142,259
"2011","Kirklees 008C","E01011249","Total",1585,177,93,84,1408,138,194,351,230,117,152,226
"2011","Kirklees 008D","E01011251","Total",1622,248,103,145,1374,183,124,301,206,147,184,229
"2011","Kirklees 009A","E01011245","Total",1566,164,52,112,1402,72,188,343,234,105,183,277
"2011","Kirklees 009B","E01011246","Total",1475,195,63,132,1280,116,80,333,218,150,146,237
"2011","Kirklees 009C","E01011248","Total",1483,237,141,96,1246,63,200,304,226,75,131,247
"2011","Kirklees 009D","E01011250","Total",1616,391,105,286,1225,110,112,326,342,52,100,183
"2011","Kirklees 010A","E01011015","Total",1580,203,105,98,1377,65,80,163,102,219,486,262
"2011","Kirklees 010B","E01011029","Total",1444,304,104,200,1140,107,104,249,190,190,161,139
"2011","Kirklees 010C","E01011032","Total",1566,181,81,100,1385,133,96,284,160,206,330,176
"2011","Kirklees 010D","E01011034","Total",1629,106,45,61,1523,76,64,171,108,275,570,259
"2011","Kirklees 011A","E01011157","Total",1645,141,37,104,1504,70,106,281,206,178,352,311
"2011","Kirklees 011B","E01011161","Total",1311,128,42,86,1183,63,138,331,198,88,145,220
"2011","Kirklees 011C","E01011163","Total",1370,204,96,108,1166,154,144,247,138,96,115,272
"2011","Kirklees 011D","E01011164","Total",1695,166,82,84,1529,91,240,411,258,79,194,256
"2011","Kirklees 011E","E01011165","Total",1823,88,22,66,1735,72,100,341,188,184,500,350
"2011","Kirklees 011F","E01011166","Total",1610,228,82,146,1382,70,116,317,234,136,246,263
"2011","Kirklees 011G","E01011167","Total",1864,268,94,174,1596,141,134,303,186,168,386,278
"2011","Kirklees 012A","E01011033","Total",1686,178,64,114,1508,83,144,310,266,143,219,343
"2011","Kirklees 012B","E01011035","Total",1677,106,39,67,1571,69,80,198,94,281,568,281
"2011","Kirklees 012C","E01011036","Total",1728,152,53,99,1576,139,88,345,154,290,351,209
"2011","Kirklees 012D","E01011037","Total",2104,221,52,169,1883,141,146,457,318,268,325,228
"2011","Kirklees 013A","E01011016","Total",1557,150,32,118,1407,32,54,239,202,155,409,316
"2011","Kirklees 013B","E01011017","Total",1674,92,52,40,1582,55,54,146,92,236,576,423
"2011","Kirklees 013C","E01011018","Total",1540,96,44,52,1444,44,38,172,88,327,470,305
"2011","Kirklees 013D","E01011019","Total",1714,96,40,56,1618,29,108,196,166,179,444,496
"2011","Kirklees 013E","E01011020","Total",1337,126,32,94,1211,72,50,285,118,182,345,159
"2011","Kirklees 014A","E01011021","Total",1643,196,78,118,1447,57,194,367,254,74,161,340
"2011","Kirklees 014B","E01011022","Total",1449,152,73,79,1297,57,172,296,226,55,170,321
"2011","Kirklees 014C","E01011126","Total",1547,329,133,196,1218,93,194,271,250,73,110,227
"2011","Kirklees 014D","E01011127","Total",1410,158,72,86,1252,62,174,308,212,92,145,259
"2011","Kirklees 015A","E01011156","Total",1556,231,127,104,1325,42,212,332,252,77,190,220
"2011","Kirklees 015B","E01011158","Total",1762,197,66,131,1565,101,134,371,306,109,251,293
"2011","Kirklees 015C","E01011159","Total",1696,194,89,105,1502,62,230,425,284,105,109,287
"2011","Kirklees 015D","E01011160","Total",1399,123,34,89,1276,59,122,360,244,76,212,203
"2011","Kirklees 015E","E01011162","Total",1485,192,103,89,1293,57,246,292,290,76,102,230
"2011","Kirklees 016A","E01011025","Total",1570,132,41,91,1438,188,66,267,212,193,248,264
"2011","Kirklees 016B","E01011026","Total",1510,178,94,84,1332,54,112,250,174,114,392,236
"2011","Kirklees 016C","E01011136","Total",1470,183,65,118,1287,134,118,302,188,179,174,192
"2011","Kirklees 016D","E01011137","Total",1509,203,58,145,1306,153,68,344,256,109,147,229
"2011","Kirklees 017A","E01011128","Total",1996,282,66,216,1714,103,80,296,298,316,346,275
"2011","Kirklees 017B","E01011130","Total",1927,483,119,364,1444,115,122,232,352,152,295,176
"2011","Kirklees 017E","E01033542","Total",2802,309,96,213,2493,85,164,446,302,294,749,453
"2011","Kirklees 018A","E01011121","Total",1482,190,46,144,1292,159,74,289,268,121,156,225
"2011","Kirklees 018B","E01011122","Total",1414,111,32,79,1303,214,66,256,120,197,212,238
"2011","Kirklees 018C","E01011123","Total",1551,258,89,169,1293,80,172,265,232,77,253,214
"2011","Kirklees 018D","E01011124","Total",1858,287,105,182,1571,118,144,457,386,88,101,277
"2011","Kirklees 018E","E01011125","Total",1543,195,102,93,1348,132,184,328,228,80,127,269
"2011","Kirklees 018F","E01011129","Total",1353,97,34,63,1256,76,108,281,188,105,182,316
"2011","Kirklees 019A","E01011138","Total",1684,245,57,188,1439,162,62,273,156,252,340,194
"2011","Kirklees 019B","E01011139","Total",1446,79,30,49,1367,41,96,263,152,175,356,284
"2011","Kirklees 019C","E01011140","Total",1643,77,25,52,1566,169,42,287,124,331,419,194
"2011","Kirklees 019D","E01011141","Total",1726,131,38,93,1595,63,52,335,128,325,414,278
"2011","Kirklees 020A","E01011132","Total",1434,93,63,30,1341,29,234,332,164,90,155,337
"2011","Kirklees 020B","E01011142","Total",1557,196,93,103,1361,45,208,327,292,37,179,273
"2011","Kirklees 020C","E01011217","Total",1601,187,116,71,1414,61,368,315,294,26,83,267
"2011","Kirklees 020D","E01011218","Total",1626,238,125,113,1388,83,218,316,274,100,156,241
"2011","Kirklees 021A","E01011216","Total",1374,137,74,63,1237,38,196,346,212,70,117,258
"2011","Kirklees 021B","E01011219","Total",1535,185,77,108,1350,42,230,329,292,26,100,331
"2011","Kirklees 021C","E01011220","Total",1793,222,92,130,1571,185,114,325,260,143,282,262
"2011","Kirklees 021D","E01011221","Total",1744,167,95,72,1577,89,252,378,298,71,179,310
"2011","Kirklees 022A","E01011046","Total",1316,84,56,28,1232,27,228,246,210,67,174,280
"2011","Kirklees 022B","E01011100","Total",1496,308,136,172,1188,152,126,210,226,74,166,234
"2011","Kirklees 022C","E01011102","Total",1414,96,38,58,1318,52,120,313,230,109,197,297
"2011","Kirklees 022D","E01011108","Total",1460,193,65,128,1267,90,162,236,288,54,118,319
"2011","Kirklees 023A","E01011133","Total",1468,136,36,100,1332,87,64,203,106,269,442,161
"2011","Kirklees 023B","E01011134","Total",1964,150,32,118,1814,177,40,307,130,439,513,208
"2011","Kirklees 023C","E01011143","Total",1621,170,36,134,1451,118,32,267,120,254,505,155
"2011","Kirklees 023D","E01011144","Total",1492,177,61,116,1315,112,34,224,98,233,447,167
"2011","Kirklees 023E","E01011260","Total",1354,167,55,112,1187,79,102,301,174,201,145,185
"2011","Kirklees 024A","E01011257","Total",2226,36,9,27,2190,16,60,210,68,267,1014,555
"2011","Kirklees 024B","E01011258","Total",1893,26,15,11,1867,17,66,112,50,183,931,508
"2011","Kirklees 024C","E01011259","Total",1680,172,56,116,1508,83,86,239,180,202,444,274
"2011","Kirklees 024D","E01011261","Total",1402,124,37,87,1278,89,40,250,102,350,305,142
"2011","Kirklees 024E","E01011262","Total",1655,157,63,94,1498,108,66,217,116,361,442,188
"2011","Kirklees 024F","E01011263","Total",1636,165,66,99,1471,90,136,296,234,165,284,266
"2011","Kirklees 025A","E01011101","Total",1738,225,49,176,1513,359,84,363,208,124,193,182
"2011","Kirklees 025B","E01011103","Total",1316,249,85,164,1067,175,128,231,196,65,76,196
"2011","Kirklees 025C","E01011104","Total",1577,343,113,230,1234,189,158,235,230,76,144,202
"2011","Kirklees 025D","E01011105","Total",2041,201,60,141,1840,269,90,635,264,156,237,189
"2011","Kirklees 026A","E01011212","Total",1612,319,182,137,1293,96,242,331,244,53,102,225
"2011","Kirklees 026B","E01011213","Total",1587,135,91,44,1452,57,322,330,234,66,189,254
"2011","Kirklees 026C","E01011214","Total",1545,205,67,138,1340,92,184,341,312,77,126,208
"2011","Kirklees 026D","E01011215","Total",1964,396,148,248,1568,86,248,397,390,66,139,242
"2011","Kirklees 027A","E01011039","Total",1808,174,90,84,1634,70,258,226,182,124,435,339
"2011","Kirklees 027B","E01011042","Total",1590,176,67,109,1414,55,136,314,296,122,206,285
"2011","Kirklees 027C","E01011047","Total",1549,137,83,54,1412,22,332,304,244,56,149,305
"2011","Kirklees 027D","E01011210","Total",1952,238,69,169,1714,85,150,473,354,117,250,285
"2011","Kirklees 028A","E01011252","Total",1151,81,38,43,1070,28,182,155,308,26,138,233
"2011","Kirklees 028B","E01011253","Total",1264,139,64,75,1125,102,132,215,178,89,179,230
"2011","Kirklees 028C","E01011254","Total",1472,161,90,71,1311,10,264,267,308,69,134,259
"2011","Kirklees 028D","E01011255","Total",1464,199,68,131,1265,167,122,300,194,97,164,221
"2011","Kirklees 028E","E01011256","Total",1355,218,96,122,1137,85,146,310,188,47,145,216
"2011","Kirklees 029A","E01011038","Total",1638,256,100,156,1382,249,108,386,132,150,162,195
"2011","Kirklees 029B","E01011041","Total",1487,268,65,203,1219,141,98,225,192,136,204,223
"2011","Kirklees 029C","E01011106","Total",1485,243,78,165,1242,243,64,338,222,70,152,153
"2011","Kirklees 029D","E01011107","Total",1800,381,48,333,1419,168,70,281,238,131,166,365
"2011","Kirklees 030A","E01011201","Total",1700,392,193,199,1308,113,168,365,380,48,103,131
"2011","Kirklees 030B","E01011203","Total",1805,168,96,72,1637,78,236,493,230,68,187,345
"2011","Kirklees 030C","E01011209","Total",1556,142,96,46,1414,39,266,346,226,98,162,277
"2011","Kirklees 030D","E01011211","Total",1591,188,102,86,1403,50,278,296,254,98,159,268
"2011","Kirklees 031A","E01011040","Total",1879,219,44,175,1660,100,56,288,236,224,375,381
"2011","Kirklees 031B","E01011043","Total",2335,327,68,259,2008,108,84,297,276,209,552,482
"2011","Kirklees 031C","E01011044","Total",1542,144,47,97,1398,75,102,282,158,170,358,253
"2011","Kirklees 031D","E01011045","Total",1888,300,83,217,1588,90,94,216,180,221,471,316
"2011","Kirklees 032A","E01011089","Total",1297,193,98,95,1104,115,198,259,216,30,101,185
"2011","Kirklees 032B","E01011091","Total",1456,105,49,56,1351,75,170,376,262,74,158,236
"2011","Kirklees 032C","E01011092","Total",1276,148,80,68,1128,11,222,257,272,55,84,227
"2011","Kirklees 032D","E01011200","Total",2319,176,52,124,2143,117,142,706,466,105,248,359
"2011","Kirklees 033A","E01011204","Total",1415,113,62,51,1302,22,234,277,186,76,238,269
"2011","Kirklees 033B","E01011206","Total",1679,331,114,217,1348,104,166,350,296,66,180,186
"2011","Kirklees 033C","E01011208","Total",1587,306,91,215,1281,147,148,324,298,78,102,184
"2011","Kirklees 033D","E01011240","Total",1699,274,112,162,1425,114,170,315,258,85,236,247
"2011","Kirklees 034A","E01011231","Total",1532,285,111,174,1247,90,168,251,352,76,115,195
"2011","Kirklees 034B","E01011236","Total",1684,420,52,368,1264,42,40,155,260,104,209,454
"2011","Kirklees 034C","E01011238","Total",1575,346,96,250,1229,40,148,182,272,76,232,279
"2011","Kirklees 034D","E01011239","Total",1614,255,86,169,1359,52,116,260,282,107,274,268
"2011","Kirklees 035A","E01011093","Total",1436,275,58,217,1161,238,84,190,214,101,131,203
"2011","Kirklees 035B","E01011094","Total",1542,270,120,150,1272,229,122,235,122,96,212,256
"2011","Kirklees 035C","E01011096","Total",1561,165,93,72,1396,89,146,217,236,96,293,319
"2011","Kirklees 035D","E01011098","Total",1522,240,58,182,1282,89,88,277,270,73,131,354
"2011","Kirklees 036A","E01011146","Total",1557,141,66,75,1416,57,130,358,338,55,151,327
"2011","Kirklees 036B","E01011151","Total",1631,143,53,90,1488,57,162,416,302,93,181,277
"2011","Kirklees 036C","E01011202","Total",1552,260,156,104,1292,81,210,268,240,60,182,251
"2011","Kirklees 036D","E01011205","Total",1604,196,71,125,1408,62,172,333,318,40,181,302
"2011","Kirklees 037A","E01011090","Total",1550,219,85,134,1331,106,180,314,218,76,144,293
"2011","Kirklees 037B","E01011095","Total",1383,195,107,88,1188,78,212,248,232,52,128,238
"2011","Kirklees 037C","E01011097","Total",1556,265,111,154,1291,86,142,287,226,62,190,298
"2011","Kirklees 037D","E01011099","Total",1489,158,77,81,1331,103,200,338,210,58,135,287
"2011","Kirklees 038A","E01011150","Total",1598,198,71,127,1400,84,128,363,352,69,156,248
"2011","Kirklees 038B","E01011155","Total",1861,292,75,217,1569,101,196,427,418,75,101,251
"2011","Kirklees 038C","E01011207","Total",1495,133,77,56,1362,72,230,337,230,81,175,237
"2011","Kirklees 038D","E01011234","Total",1487,278,81,197,1209,148,112,294,220,79,127,229
"2011","Kirklees 039A","E01011232","Total",1579,320,99,221,1259,81,102,130,168,70,380,328
"2011","Kirklees 039B","E01011233","Total",1624,190,64,126,1434,69,118,455,226,128,221,217
"2011","Kirklees 039C","E01011235","Total",1804,468,132,336,1336,78,102,110,250,67,293,436
"2011","Kirklees 039D","E01011237","Total",1657,208,60,148,1449,175,98,283,196,168,312,217
"2011","Kirklees 040A","E01011004","Total",1357,343,169,174,1014,150,154,220,200,32,113,145
"2011","Kirklees 040B","E01011006","Total",1516,198,113,85,1318,100,162,259,242,72,174,309
"2011","Kirklees 040C","E01011008","Total",1487,213,43,170,1274,83,70,273,296,85,120,347
"2011","Kirklees 040D","E01011012","Total",1668,202,82,120,1466,134,144,408,278,74,116,312
"2011","Kirklees 041A","E01011145","Total",1530,159,69,90,1371,68,190,392,252,46,152,271
"2011","Kirklees 041B","E01011147","Total",1483,171,56,115,1312,99,108,349,308,62,110,276
"2011","Kirklees 041C","E01011148","Total",1615,317,128,189,1298,185,138,222,220,143,133,257
"2011","Kirklees 041D","E01011152","Total",1686,238,54,184,1448,112,122,395,448,46,124,201
"2011","Kirklees 042A","E01011007","Total",1486,228,61,167,1258,75,118,267,294,67,119,318
"2011","Kirklees 042B","E01011223","Total",1773,198,62,136,1575,225,116,404,278,155,98,299
"2011","Kirklees 042C","E01011225","Total",1765,196,51,145,1569,200,108,269,332,88,121,451
"2011","Kirklees 042D","E01011229","Total",1703,540,101,439,1163,52,48,123,380,88,174,298
"2011","Kirklees 043A","E01011080","Total",1924,270,74,196,1654,172,92,365,246,186,328,265
"2011","Kirklees 043B","E01011081","Total",1773,301,65,236,1472,107,72,266,238,149,394,246
"2011","Kirklees 043C","E01011082","Total",1836,106,28,78,1730,62,24,224,96,271,761,292
"2011","Kirklees 043D","E01011230","Total",2077,103,35,68,1974,110,70,276,104,367,696,351
"2011","Kirklees 044A","E01011005","Total",1497,194,123,71,1303,47,278,270,250,53,136,269
"2011","Kirklees 044B","E01011009","Total",1322,208,90,118,1114,94,210,238,214,51,95,212
"2011","Kirklees 044C","E01011010","Total",1572,185,83,102,1387,195,140,269,234,137,186,226
"2011","Kirklees 044D","E01011011","Total",1576,188,102,86,1388,29,288,315,284,103,115,254
"2011","Kirklees 045A","E01011077","Total",1612,217,66,151,1395,90,144,333,344,76,153,255
"2011","Kirklees 045B","E01011149","Total",1856,412,70,342,1444,140,88,376,346,80,125,289
"2011","Kirklees 045C","E01011153","Total",1715,228,93,135,1487,117,194,322,310,69,198,277
"2011","Kirklees 045D","E01011154","Total",1562,176,54,122,1386,136,96,400,248,169,132,205
"2011","Kirklees 046A","E01011191","Total",1576,164,86,78,1412,53,230,358,250,101,123,297
"2011","Kirklees 046B","E01011192","Total",1577,240,118,122,1337,74,192,342,266,111,161,191
"2011","Kirklees 046C","E01011193","Total",1912,161,65,96,1751,95,218,537,386,105,128,282
"2011","Kirklees 046D","E01011194","Total",1370,142,99,43,1228,30,278,245,274,65,111,225
"2011","Kirklees 047A","E01011079","Total",1887,382,127,255,1505,135,122,304,294,140,256,254
"2011","Kirklees 047B","E01011083","Total",1782,195,101,94,1587,73,206,375,248,158,247,280
"2011","Kirklees 047C","E01011084","Total",1819,160,34,126,1659,235,56,323,184,311,288,262
"2011","Kirklees 047D","E01011085","Total",1551,234,124,110,1317,100,240,270,208,92,166,241
"2011","Kirklees 048A","E01011224","Total",1631,279,100,179,1352,158,116,315,274,63,120,306
"2011","Kirklees 048B","E01011226","Total",1560,171,93,78,1389,66,210,250,254,74,234,301
"2011","Kirklees 048C","E01011227","Total",1619,404,180,224,1215,166,174,203,258,37,160,217
"2011","Kirklees 048D","E01011228","Total",1498,186,77,109,1312,49,190,260,254,66,186,307
"2011","Kirklees 049A","E01011071","Total",1678,172,81,91,1506,104,212,349,268,61,177,335
"2011","Kirklees 049B","E01011072","Total",1613,174,69,105,1439,77,140,468,256,35,133,330
"2011","Kirklees 049C","E01011073","Total",1496,222,65,157,1274,108,172,340,272,62,126,194
"2011","Kirklees 049D","E01011078","Total",1721,323,107,216,1398,89,168,477,368,91,83,122
"2011","Kirklees 050A","E01011086","Total",1628,193,114,79,1435,32,334,324,262,85,95,303
"2011","Kirklees 050B","E01011087","Total",1575,295,138,157,1280,112,200,306,266,49,113,234
"2011","Kirklees 050C","E01011088","Total",1414,144,93,51,1270,33,260,290,246,36,91,314
"2011","Kirklees 050D","E01011222","Total",1768,514,100,414,1254,117,164,264,376,28,81,224
"2011","Kirklees 051A","E01011190","Total",1617,203,74,129,1414,40,248,334,350,66,107,269
"2011","Kirklees 051B","E01011195","Total",1069,110,57,53,959,15,190,238,164,64,90,198
"2011","Kirklees 051C","E01011196","Total",1820,154,66,88,1666,14,208,524,336,117,163,304
"2011","Kirklees 051D","E01011197","Total",1521,199,83,116,1322,91,170,314,270,66,115,296
"2011","Kirklees 052A","E01011070","Total",1572,146,65,81,1426,70,200,420,316,67,117,236
"2011","Kirklees 052B","E01011074","Total",1912,233,101,132,1679,69,186,509,386,106,127,296
"2011","Kirklees 052C","E01011075","Total",1438,229,94,135,1209,53,184,263,274,101,97,237
"2011","Kirklees 052D","E01011076","Total",1476,157,66,91,1319,83,192,318,258,90,88,290
"2011","Kirklees 053A","E01011169","Total",1431,138,69,69,1293,28,224,339,268,52,132,250
"2011","Kirklees 053B","E01011170","Total",1838,168,82,86,1670,42,212,499,310,103,172,332
"2011","Kirklees 053C","E01011171","Total",1388,210,65,145,1178,34,142,369,272,40,114,207
"2011","Kirklees 053D","E01011172","Total",1016,265,185,80,751,66,130,158,130,46,107,114
"2011","Kirklees 053E","E01011173","Total",1321,109,65,44,1212,44,204,373,202,74,119,196
"2011","Kirklees 053F","E01011176","Total",1432,131,63,68,1301,39,208,353,216,98,127,260
"2011","Kirklees 054A","E01011109","Total",1795,151,55,96,1644,99,176,399,364,148,158,300
"2011","Kirklees 054B","E01011113","Total",1691,186,86,100,1505,44,282,379,314,65,135,286
"2011","Kirklees 054C","E01011114","Total",1494,242,142,100,1252,82,202,262,234,106,110,256
"2011","Kirklees 054D","E01011119","Total",1497,179,96,83,1318,60,254,305,288,61,152,198
"2011","Kirklees 055A","E01011168","Total",1631,150,83,67,1481,42,274,339,264,92,180,290
"2011","Kirklees 055B","E01011174","Total",1772,135,60,75,1637,46,244,422,330,71,246,278
"2011","Kirklees 055C","E01011175","Total",1450,159,69,90,1291,159,138,274,224,132,152,212
"2011","Kirklees 055D","E01011177","Total",1709,163,76,87,1546,73,236,379,370,96,143,249
"2011","Kirklees 055E","E01011178","Total",1857,338,156,182,1519,87,218,303,320,130,229,232
"2011","Kirklees 056A","E01011118","Total",1578,142,58,84,1436,48,162,486,298,61,157,224
"2011","Kirklees 056B","E01011120","Total",1575,103,47,56,1472,30,156,449,264,136,168,269
"2011","Kirklees 056C","E01011198","Total",1593,164,85,79,1429,48,236,435,266,93,97,254
"2011","Kirklees 056D","E01011199","Total",1518,153,90,63,1365,83,180,422,218,80,131,251
"2011","Kirklees 057A","E01011110","Total",1358,155,53,102,1203,39,200,362,216,57,94,235
"2011","Kirklees 057B","E01011111","Total",1587,144,76,68,1443,65,194,353,274,88,186,283
"2011","Kirklees 057C","E01011112","Total",1616,155,80,75,1461,100,174,411,304,59,151,262
"2011","Kirklees 057D","E01011115","Total",1768,214,80,134,1554,50,220,472,350,106,99,257
"2011","Kirklees 057E","E01011116","Total",1661,144,67,77,1517,70,256,377,288,61,126,339
"2011","Kirklees 057F","E01011117","Total",1786,152,83,69,1634,62,248,442,338,96,206,242
"2011","Kirklees 058A","E01011180","Total",1917,188,89,99,1729,78,224,518,352,78,154,325
"2011","Kirklees 058B","E01011182","Total",1733,233,98,135,1500,65,178,440,362,108,125,222
"2011","Kirklees 058C","E01011186","Total",1534,183,97,86,1351,50,250,279,282,74,155,261
"2011","Kirklees 058D","E01011188","Total",1702,167,90,77,1535,72,234,406,282,87,208,246
"2011","Kirklees 059A","E01011179","Total",1767,186,63,123,1581,71,240,451,364,47,154,254
"2011","Kirklees 059B","E01011181","Total",1788,304,84,220,1484,78,170,419,410,79,143,185
"2011","Kirklees 059C","E01011183","Total",1995,172,46,126,1823,54,188,582,372,111,215,301
"2011","Kirklees 059D","E01011184","Total",1472,142,66,76,1330,115,156,295,204,113,201,246
"2011","Kirklees 059E","E01011185","Total",1565,216,104,112,1349,79,192,405,284,52,149,188
"2011","Kirklees 059F","E01011187","Total",1758,139,55,84,1619,78,202,388,260,178,170,343
"2011","Kirklees 059G","E01011189","Total",1601,148,78,70,1453,30,252,388,318,111,66,288
"2011","Leeds 001A","E01011698","Total",1501,158,74,84,1343,66,240,264,244,101,152,276
"2011","Leeds 001B","E01011699","Total",1341,138,71,67,1203,32,244,272,266,83,77,229
"2011","Leeds 001C","E01011701","Total",1287,125,73,52,1162,38,188,268,226,88,142,212
"2011","Leeds 001D","E01011702","Total",1184,84,58,26,1100,20,252,226,194,82,102,224
"2011","Leeds 001E","E01011703","Total",1279,123,81,42,1156,9,334,227,200,47,124,215
"2011","Leeds 002A","E01011697","Total",1278,151,78,73,1127,49,192,319,240,94,61,172
"2011","Leeds 002B","E01011700","Total",1108,154,89,65,954,27,192,245,172,20,93,205
"2011","Leeds 002C","E01011704","Total",1746,488,281,207,1258,80,276,302,336,50,47,167
"2011","Leeds 002D","E01011705","Total",1375,221,144,77,1154,111,194,273,204,99,97,176
"2011","Leeds 003A","E01011581","Total",1469,156,88,68,1313,64,264,302,226,78,132,247
"2011","Leeds 003B","E01011582","Total",1651,293,171,122,1358,101,160,356,256,138,164,183
"2011","Leeds 003C","E01011583","Total",1479,129,74,55,1350,96,206,286,242,84,154,282
"2011","Leeds 003D","E01011584","Total",1250,177,104,73,1073,85,174,217,188,83,127,199
"2011","Leeds 004A","E01011569","Total",1662,310,107,203,1352,53,186,379,330,61,100,243
"2011","Leeds 004B","E01011571","Total",1557,287,137,150,1270,66,192,252,342,83,126,209
"2011","Leeds 004C","E01011572","Total",1763,273,96,177,1490,74,142,411,410,88,111,254
"2011","Leeds 004D","E01011573","Total",1341,114,62,52,1227,43,170,263,244,79,162,266
"2011","Leeds 004E","E01011574","Total",1406,301,175,126,1105,43,184,287,272,67,61,191
"2011","Leeds 005A","E01011707","Total",1359,194,136,58,1165,24,254,287,212,90,111,187
"2011","Leeds 005B","E01011709","Total",1555,176,110,66,1379,13,314,402,214,116,132,188
"2011","Leeds 005C","E01011710","Total",1421,197,99,98,1224,54,152,345,306,91,99,177
"2011","Leeds 005D","E01011711","Total",1389,228,136,92,1161,44,256,289,232,46,122,172
"2011","Leeds 005E","E01011712","Total",1359,145,68,77,1214,52,182,264,304,41,139,232
"2011","Leeds 006A","E01011561","Total",1217,162,72,90,1055,34,150,230,232,69,107,233
"2011","Leeds 006B","E01011696","Total",1498,182,126,56,1316,27,308,310,226,112,117,216
"2011","Leeds 006C","E01011706","Total",1526,140,75,65,1386,43,274,412,198,123,118,218
"2011","Leeds 006D","E01011708","Total",1468,144,72,72,1324,41,236,298,240,78,176,255
"2011","Leeds 006E","E01011713","Total",1843,153,66,87,1690,67,290,463,274,124,187,285
"2011","Leeds 007A","E01011570","Total",2284,264,122,142,2020,67,296,706,374,178,151,248
"2011","Leeds 007C","E01011576","Total",1404,146,86,60,1258,22,266,254,224,71,191,230
"2011","Leeds 007E","E01032503","Total",1462,157,73,84,1305,36,202,354,234,90,152,237
"2011","Leeds 007F","E01032504","Total",1584,177,136,41,1407,37,308,410,210,67,158,217
"2011","Leeds 008A","E01011266","Total",2027,255,52,203,1772,63,194,494,456,98,152,315
"2011","Leeds 008B","E01011270","Total",1616,118,66,52,1498,21,328,351,256,116,190,236
"2011","Leeds 008C","E01011279","Total",1285,169,86,83,1116,59,182,352,220,40,52,211
"2011","Leeds 008D","E01011280","Total",1757,151,59,92,1606,76,212,446,328,131,125,288
"2011","Leeds 009A","E01011265","Total",1554,303,168,135,1251,69,126,337,330,51,127,211
"2011","Leeds 009B","E01011267","Total",1496,218,116,102,1278,97,196,317,234,126,78,230
"2011","Leeds 009C","E01011271","Total",2158,234,103,131,1924,86,240,639,356,108,176,319
"2011","Leeds 009D","E01011272","Total",1521,81,39,42,1440,54,178,432,260,94,147,275
"2011","Leeds 010A","E01011268","Total",1394,214,76,138,1180,123,130,272,204,114,156,181
"2011","Leeds 010B","E01011273","Total",1459,265,87,178,1194,68,154,311,304,55,94,208
"2011","Leeds 010C","E01011274","Total",1431,274,128,146,1157,95,152,315,222,97,115,161
"2011","Leeds 010D","E01011275","Total",1350,188,85,103,1162,87,172,285,246,59,89,224
"2011","Leeds 011A","E01011264","Total",1276,159,91,68,1117,45,202,228,220,57,110,255
"2011","Leeds 011B","E01011269","Total",1538,265,133,132,1273,100,228,267,276,58,130,214
"2011","Leeds 011C","E01011276","Total",1384,182,66,116,1202,85,144,322,276,68,98,209
"2011","Leeds 011D","E01011578","Total",1321,213,107,106,1108,69,178,207,282,47,110,215
"2011","Leeds 012A","E01011554","Total",1446,150,76,74,1296,47,230,315,220,116,112,256
"2011","Leeds 012B","E01011562","Total",1592,137,87,50,1455,36,272,299,198,70,217,363
"2011","Leeds 012C","E01011563","Total",1416,167,99,68,1249,9,336,293,186,63,157,205
"2011","Leeds 012D","E01011564","Total",1501,141,75,66,1360,24,210,365,232,119,134,276
"2011","Leeds 012E","E01011567","Total",1393,138,69,69,1255,45,158,335,224,100,131,262
"2011","Leeds 013A","E01011376","Total",1516,127,77,50,1389,30,248,361,250,50,125,325
"2011","Leeds 013B","E01011377","Total",1386,173,124,49,1213,21,300,262,158,36,150,286
"2011","Leeds 013C","E01011378","Total",1394,306,74,232,1088,103,124,238,228,107,102,186
"2011","Leeds 013D","E01011382","Total",1456,201,121,80,1255,50,244,347,250,72,88,204
"2011","Leeds 014A","E01011277","Total",1511,136,39,97,1375,93,96,492,296,60,123,215
"2011","Leeds 014B","E01011278","Total",1631,204,91,113,1427,69,180,454,312,67,72,273
"2011","Leeds 014C","E01011579","Total",1245,102,51,51,1143,71,118,352,216,53,122,211
"2011","Leeds 014D","E01011580","Total",1342,177,104,73,1165,26,194,322,256,51,91,225
"2011","Leeds 015A","E01011556","Total",1576,305,105,200,1271,84,146,435,272,67,104,163
"2011","Leeds 015B","E01011557","Total",1510,220,108,112,1290,34,194,270,194,75,229,294
"2011","Leeds 015C","E01011565","Total",1433,151,90,61,1282,59,212,323,214,58,148,268
"2011","Leeds 015D","E01011566","Total",1309,186,76,110,1123,55,148,286,190,93,104,247
"2011","Leeds 015E","E01011568","Total",1825,320,133,187,1505,47,246,311,346,84,188,283
"2011","Leeds 016A","E01011380","Total",1523,204,96,108,1319,41,266,328,260,67,122,235
"2011","Leeds 016B","E01011381","Total",1310,113,68,45,1197,44,184,234,180,66,216,273
"2011","Leeds 016C","E01011385","Total",1223,152,84,68,1071,34,174,237,206,67,145,208
"2011","Leeds 016D","E01011386","Total",1419,188,85,103,1231,26,200,324,236,89,117,239
"2011","Leeds 017A","E01011379","Total",1482,342,133,209,1140,103,180,298,270,76,99,114
"2011","Leeds 017B","E01011384","Total",1485,210,88,122,1275,80,184,309,244,60,144,254
"2011","Leeds 017E","E01032501","Total",1173,120,62,58,1053,58,172,231,232,90,87,183
"2011","Leeds 017F","E01032502","Total",1842,265,77,188,1577,252,126,399,266,118,113,303
"2011","Leeds 018A","E01011555","Total",1362,123,48,75,1239,32,216,253,236,62,169,271
"2011","Leeds 018B","E01011558","Total",1577,274,99,175,1303,180,124,305,220,135,164,175
"2011","Leeds 018C","E01011559","Total",1232,225,105,120,1007,136,68,255,168,68,125,187
"2011","Leeds 018D","E01011560","Total",1800,391,133,258,1409,181,136,320,276,92,181,223
"2011","Leeds 019A","E01011383","Total",1566,283,160,123,1283,47,200,256,290,103,154,233
"2011","Leeds 019B","E01011388","Total",1407,240,136,104,1167,33,180,278,212,92,167,205
"2011","Leeds 019C","E01011684","Total",1548,183,85,98,1365,83,164,266,230,85,203,334
"2011","Leeds 019D","E01011695","Total",1533,278,96,182,1255,216,112,301,188,88,137,213
"2011","Leeds 020A","E01011650","Total",1424,177,68,109,1247,30,154,300,246,89,187,241
"2011","Leeds 020B","E01011651","Total",1446,206,62,144,1240,80,110,404,270,93,76,207
"2011","Leeds 020C","E01011653","Total",1330,245,96,149,1085,41,86,243,230,61,135,289
"2011","Leeds 020D","E01011655","Total",1354,313,146,167,1041,31,178,239,304,78,107,104
"2011","Leeds 021A","E01011455","Total",1169,102,65,37,1067,27,210,337,174,52,94,173
"2011","Leeds 021B","E01011456","Total",1707,226,95,131,1481,30,284,397,214,107,169,280
"2011","Leeds 021C","E01011459","Total",1567,247,116,131,1320,49,250,293,336,62,119,211
"2011","Leeds 021D","E01011461","Total",1530,125,85,40,1405,38,282,338,194,99,186,268
"2011","Leeds 022A","E01011311","Total",1217,68,40,28,1149,35,194,300,178,70,132,240
"2011","Leeds 022B","E01011649","Total",1466,172,90,82,1294,29,262,334,278,52,113,226
"2011","Leeds 022C","E01011715","Total",1277,130,65,65,1147,41,188,260,206,71,130,251
"2011","Leeds 022D","E01011719","Total",1420,151,103,48,1269,58,304,273,250,20,129,235
"2011","Leeds 023A","E01011509","Total",1351,257,158,99,1094,20,194,264,210,62,156,188
"2011","Leeds 023B","E01011511","Total",1324,179,116,63,1145,24,120,257,156,71,253,264
"2011","Leeds 023C","E01011512","Total",1562,212,77,135,1350,62,140,258,260,91,217,322
"2011","Leeds 023D","E01011515","Total",1421,222,79,143,1199,45,150,209,324,93,139,239
"2011","Leeds 023E","E01011516","Total",1704,138,62,76,1566,34,146,446,242,103,225,370
"2011","Leeds 024A","E01011508","Total",1414,80,36,44,1334,21,46,354,182,131,304,296
"2011","Leeds 024B","E01011517","Total",1638,249,66,183,1389,106,118,337,312,89,190,237
"2011","Leeds 024C","E01011652","Total",1295,117,40,77,1178,49,94,292,228,56,199,260
"2011","Leeds 024D","E01011654","Total",1434,98,52,46,1336,35,120,468,216,104,152,241
"2011","Leeds 025A","E01011505","Total",1599,178,99,79,1421,82,198,330,230,53,238,290
"2011","Leeds 025B","E01011506","Total",1439,121,50,71,1318,25,104,364,160,113,223,329
"2011","Leeds 025C","E01011507","Total",1580,172,85,87,1408,43,166,355,320,59,177,288
"2011","Leeds 025D","E01011510","Total",1536,477,223,254,1059,129,174,227,198,71,101,159
"2011","Leeds 025E","E01011514","Total",1628,163,63,100,1465,35,144,308,296,108,242,332
"2011","Leeds 027A","E01011452","Total",1524,136,53,83,1388,18,208,427,276,118,128,213
"2011","Leeds 027B","E01011454","Total",1492,184,68,116,1308,51,138,390,382,56,75,216
"2011","Leeds 027C","E01011457","Total",1456,141,71,70,1315,24,192,379,226,113,116,265
"2011","Leeds 027D","E01011458","Total",1382,120,66,54,1262,34,216,386,208,84,109,225
"2011","Leeds 027E","E01011465","Total",1507,335,172,163,1172,63,172,252,362,56,57,210
"2011","Leeds 028A","E01011453","Total",1482,189,89,100,1293,43,214,323,306,94,91,222
"2011","Leeds 028B","E01011460","Total",1380,247,84,163,1133,63,94,266,318,80,112,200
"2011","Leeds 028C","E01011462","Total",1632,207,97,110,1425,100,150,307,298,84,172,314
"2011","Leeds 028D","E01011463","Total",1583,273,145,128,1310,97,168,284,318,78,136,229
"2011","Leeds 028E","E01011464","Total",1678,270,68,202,1408,63,142,317,538,53,69,226
"2011","Leeds 029A","E01011714","Total",1474,142,81,61,1332,86,180,266,234,83,167,316
"2011","Leeds 029B","E01011716","Total",1481,152,73,79,1329,35,258,242,206,64,205,319
"2011","Leeds 029C","E01011717","Total",1495,204,109,95,1291,156,154,241,228,85,166,261
"2011","Leeds 029D","E01011718","Total",1393,201,66,135,1192,123,98,306,214,101,118,232
"2011","Leeds 029E","E01011720","Total",1498,258,130,128,1240,126,164,207,262,110,144,227
"2011","Leeds 030A","E01011296","Total",1678,207,140,67,1471,52,374,367,308,55,75,240
"2011","Leeds 030B","E01011297","Total",1585,149,71,78,1436,56,168,414,260,109,167,262
"2011","Leeds 030C","E01011309","Total",1507,171,81,90,1336,76,230,325,284,73,99,249
"2011","Leeds 030D","E01011310","Total",1623,230,116,114,1393,42,258,356,248,97,140,252
"2011","Leeds 031A","E01011513","Total",2164,270,70,200,1894,102,140,607,458,156,146,285
"2011","Leeds 031B","E01011688","Total",1488,152,35,117,1336,64,100,407,286,64,176,239
"2011","Leeds 031C","E01011689","Total",1552,308,132,176,1244,53,196,294,290,80,94,237
"2011","Leeds 031D","E01011691","Total",1527,210,84,126,1317,183,110,252,212,90,142,328
"2011","Leeds 032A","E01011504","Total",1390,388,111,277,1002,182,112,221,190,40,102,155
"2011","Leeds 032B","E01011641","Total",1522,175,68,107,1347,33,126,426,236,137,116,273
"2011","Leeds 032C","E01011642","Total",1299,128,48,80,1171,54,108,244,186,118,226,235
"2011","Leeds 032D","E01011645","Total",1442,214,73,141,1228,54,90,375,238,57,203,211
"2011","Leeds 033A","E01011484","Total",1538,236,94,142,1302,177,102,347,202,123,155,196
"2011","Leeds 033B","E01011485","Total",1505,317,98,219,1188,124,116,283,280,39,163,183
"2011","Leeds 033E","E01011686","Total",1545,376,148,228,1169,138,158,255,260,74,125,159
"2011","Leeds 033F","E01032493","Total",1343,203,68,135,1140,54,128,280,308,51,77,242
"2011","Leeds 033G","E01032494","Total",1727,212,72,140,1515,195,96,288,282,128,213,313
"2011","Leeds 034A","E01011350","Total",1625,223,77,146,1402,40,142,369,352,63,192,244
"2011","Leeds 034B","E01011351","Total",1684,350,103,247,1334,43,120,246,558,26,53,288
"2011","Leeds 034C","E01011352","Total",1727,397,117,280,1330,51,90,221,452,36,80,400
"2011","Leeds 034D","E01011353","Total",1865,235,70,165,1630,57,106,377,518,107,167,298
"2011","Leeds 035A","E01011656","Total",1490,166,56,110,1324,254,64,281,178,143,112,292
"2011","Leeds 035B","E01011657","Total",1307,235,69,166,1072,154,82,236,190,75,95,240
"2011","Leeds 035C","E01011659","Total",1368,278,88,190,1090,111,114,224,218,56,179,188
"2011","Leeds 035D","E01011661","Total",1541,464,208,256,1077,123,166,181,206,70,121,210
"2011","Leeds 037A","E01011643","Total",1296,212,109,103,1084,53,164,230,224,57,129,227
"2011","Leeds 037B","E01011644","Total",1176,204,78,126,972,59,164,201,180,54,150,164
"2011","Leeds 037C","E01011646","Total",1645,179,75,104,1466,85,130,345,234,148,243,281
"2011","Leeds 037D","E01011647","Total",1716,103,40,63,1613,87,84,197,128,171,648,298
"2011","Leeds 037E","E01011648","Total",1744,113,58,55,1631,70,152,276,156,191,494,292
"2011","Leeds 038A","E01011354","Total",1397,228,40,188,1169,240,82,259,168,43,177,200
"2011","Leeds 038B","E01011355","Total",1378,174,77,97,1204,154,84,243,230,118,129,246
"2011","Leeds 038C","E01011357","Total",1914,397,101,296,1517,288,74,302,214,168,238,233
"2011","Leeds 038D","E01011450","Total",1226,163,49,114,1063,69,100,244,216,72,125,237
"2011","Leeds 039A","E01011588","Total",1692,164,62,102,1528,79,144,499,338,97,140,231
"2011","Leeds 039B","E01011589","Total",1521,229,89,140,1292,40,154,431,342,86,69,170
"2011","Leeds 039C","E01011590","Total",1514,142,61,81,1372,60,234,385,296,55,129,213
"2011","Leeds 039D","E01011592","Total",1402,291,111,180,1111,27,168,262,348,67,43,196
"2011","Leeds 039E","E01011593","Total",1764,218,70,148,1546,72,206,367,420,72,141,268
"2011","Leeds 040A","E01011421","Total",1486,203,103,100,1283,103,148,226,160,123,260,263
"2011","Leeds 040B","E01011425","Total",1553,157,64,93,1396,78,160,321,162,91,176,408
"2011","Leeds 040C","E01011658","Total",1344,259,135,124,1085,279,126,169,148,77,132,154
"2011","Leeds 040D","E01011660","Total",1320,221,94,127,1099,141,116,262,168,99,128,185
"2011","Leeds 040E","E01011662","Total",1189,179,33,146,1010,190,48,202,138,104,178,150
"2011","Leeds 041A","E01011721","Total",1522,178,78,100,1344,197,154,291,178,164,137,223
"2011","Leeds 041B","E01011722","Total",1860,276,108,168,1584,145,114,400,340,123,221,241
"2011","Leeds 041C","E01011723","Total",1417,212,133,79,1205,249,128,226,174,65,175,188
"2011","Leeds 041D","E01011724","Total",1821,305,110,195,1516,196,150,369,294,106,180,221
"2011","Leeds 042A","E01011356","Total",1910,385,71,314,1525,112,104,270,328,56,264,391
"2011","Leeds 042B","E01011358","Total",1453,304,126,178,1149,173,110,225,212,79,138,212
"2011","Leeds 042C","E01011359","Total",1682,311,51,260,1371,102,84,240,272,117,234,322
"2011","Leeds 042D","E01011360","Total",2071,241,71,170,1830,251,80,218,134,254,561,332
"2011","Leeds 042E","E01011361","Total",2478,510,98,412,1968,302,102,303,254,233,408,366
"2011","Leeds 044A","E01011435","Total",1783,130,23,107,1653,5,22,37,214,0,42,1333
"2011","Leeds 044D","E01011440","Total",1622,210,68,142,1412,7,36,42,286,5,18,1018
"2011","Leeds 044E","E01011441","Total",1882,191,30,161,1691,22,30,92,224,49,100,1174
"2011","Leeds 044F","E01032945","Total",3161,172,34,138,2989,0,50,88,230,17,109,2495
"2011","Leeds 045A","E01011477","Total",1842,355,81,274,1487,117,106,282,368,153,133,328
"2011","Leeds 045B","E01011480","Total",1582,149,75,74,1433,11,198,205,260,87,190,482
"2011","Leeds 045C","E01011488","Total",1431,216,68,148,1215,97,72,183,398,32,55,378
"2011","Leeds 045D","E01011489","Total",1687,339,118,221,1348,113,140,194,366,37,132,366
"2011","Leeds 046A","E01011324","Total",1307,177,38,139,1130,199,36,257,126,129,151,232
"2011","Leeds 046B","E01011325","Total",1436,210,58,152,1226,115,102,317,316,36,136,204
"2011","Leeds 046C","E01011326","Total",1354,155,69,86,1199,190,106,256,238,83,126,200
"2011","Leeds 046D","E01011332","Total",1296,195,57,138,1101,144,106,242,190,103,161,155
"2011","Leeds 047A","E01011423","Total",1622,169,70,99,1453,222,100,322,146,159,258,246
"2011","Leeds 047B","E01011424","Total",1600,99,32,67,1501,194,94,318,110,283,311,191
"2011","Leeds 047C","E01011427","Total",1769,142,47,95,1627,180,52,247,120,362,444,222
"2011","Leeds 047D","E01011431","Total",1854,280,82,198,1574,310,84,305,198,202,285,190
"2011","Leeds 048A","E01011422","Total",1463,186,21,165,1277,77,30,136,86,204,504,240
"2011","Leeds 048B","E01011426","Total",1701,140,38,102,1561,97,38,246,90,275,629,186
"2011","Leeds 048C","E01011428","Total",1870,168,39,129,1702,104,36,304,146,261,491,360
"2011","Leeds 048D","E01011429","Total",1999,277,65,212,1722,141,56,166,120,250,684,305
"2011","Leeds 050A","E01011663","Total",1256,81,26,55,1175,236,28,292,126,127,228,138
"2011","Leeds 050B","E01011664","Total",1110,148,83,65,962,125,106,219,148,56,116,192
"2011","Leeds 050C","E01011665","Total",1386,228,68,160,1158,100,146,211,240,64,196,201
"2011","Leeds 050D","E01011667","Total",1491,102,46,56,1389,389,32,276,118,165,240,169
"2011","Leeds 051A","E01011323","Total",1262,200,123,77,1062,59,188,207,188,62,121,237
"2011","Leeds 051B","E01011329","Total",1486,180,72,108,1306,65,176,261,350,45,136,273
"2011","Leeds 051C","E01011330","Total",1254,164,62,102,1090,101,156,244,218,56,145,170
"2011","Leeds 051D","E01011333","Total",1263,160,63,97,1103,107,142,281,214,40,83,236
"2011","Leeds 052A","E01011327","Total",1317,245,55,190,1072,80,86,250,262,69,121,204
"2011","Leeds 052B","E01011328","Total",1491,204,92,112,1287,136,142,336,274,91,86,222
"2011","Leeds 052C","E01011335","Total",1671,263,79,184,1408,148,130,331,410,65,125,199
"2011","Leeds 052D","E01011591","Total",1616,275,57,218,1341,56,136,345,532,42,39,191
"2011","Leeds 053A","E01011430","Total",1508,106,26,80,1402,105,46,218,84,236,435,278
"2011","Leeds 053B","E01011432","Total",1547,203,35,168,1344,160,34,278,118,232,364,158
"2011","Leeds 053C","E01011433","Total",1538,268,36,232,1270,259,30,276,190,157,182,176
"2011","Leeds 053D","E01011434","Total",1397,234,30,204,1163,189,34,347,192,167,96,138
"2011","Leeds 054A","E01011445","Total",1679,48,1,47,1631,9,4,22,122,5,55,1414
"2011","Leeds 054B","E01011446","Total",1574,117,5,112,1457,17,14,46,86,26,99,1169
"2011","Leeds 054C","E01011447","Total",1337,84,14,70,1253,22,16,29,96,26,88,976
"2011","Leeds 054D","E01011448","Total",1542,113,21,92,1429,76,16,49,114,48,103,1023
"2011","Leeds 054E","E01011449","Total",1380,140,19,121,1240,105,26,66,400,64,57,522
"2011","Leeds 055A","E01011670","Total",1917,401,100,301,1516,175,120,212,278,133,125,473
"2011","Leeds 055B","E01011671","Total",1535,214,48,166,1321,265,90,218,184,89,183,292
"2011","Leeds 055F","E01033002","Total",1310,414,102,312,896,61,42,237,364,52,25,115
"2011","Leeds 055G","E01033003","Total",1783,697,35,662,1086,89,28,378,396,57,45,93
"2011","Leeds 055H","E01033005","Total",1993,395,50,345,1598,104,34,144,322,89,154,751
"2011","Leeds 056A","E01011478","Total",1679,280,64,216,1399,66,64,126,364,54,66,659
"2011","Leeds 056B","E01011479","Total",1476,154,25,129,1322,39,8,44,238,12,23,958
"2011","Leeds 056C","E01011481","Total",1558,219,28,191,1339,72,36,128,274,107,111,611
"2011","Leeds 056D","E01011482","Total",1693,308,68,240,1385,78,62,189,488,26,99,443
"2011","Leeds 056E","E01011483","Total",1553,280,75,205,1273,101,54,133,218,75,208,484
"2011","Leeds 057A","E01011406","Total",1403,156,92,64,1247,55,208,302,214,31,150,287
"2011","Leeds 057B","E01011407","Total",1435,221,112,109,1214,132,190,251,216,61,102,262
"2011","Leeds 057C","E01011408","Total",1451,265,177,88,1186,48,352,167,258,42,92,227
"2011","Leeds 057D","E01011409","Total",1374,220,70,150,1154,72,138,210,296,46,112,280
"2011","Leeds 057E","E01011410","Total",1274,217,95,122,1057,38,206,214,266,42,74,217
"2011","Leeds 057F","E01011412","Total",1370,187,114,73,1183,20,268,272,236,37,157,193
"2011","Leeds 058A","E01011331","Total",1238,217,104,113,1021,75,106,209,272,78,85,196
"2011","Leeds 058B","E01011334","Total",1288,226,49,177,1062,81,86,237,248,60,138,212
"2011","Leeds 058C","E01011336","Total",1525,379,184,195,1146,112,128,238,234,99,140,195
"2011","Leeds 058D","E01011337","Total",1399,104,26,78,1295,229,42,266,106,200,263,189
"2011","Leeds 059A","E01011281","Total",1820,288,64,224,1532,150,106,327,390,104,148,307
"2011","Leeds 059B","E01011282","Total",1378,209,72,137,1169,131,110,303,224,70,128,203
"2011","Leeds 059C","E01011283","Total",1331,156,55,101,1175,184,110,252,152,89,201,187
"2011","Leeds 059D","E01011286","Total",1244,157,50,107,1087,53,110,274,246,38,122,244
"2011","Leeds 059E","E01011295","Total",1526,245,39,206,1281,164,88,325,268,89,118,229
"2011","Leeds 060A","E01011339","Total",1783,358,113,245,1425,154,160,289,208,164,250,200
"2011","Leeds 060B","E01011340","Total",1616,217,103,114,1399,228,128,296,234,97,161,255
"2011","Leeds 060C","E01011342","Total",1410,176,54,122,1234,266,88,213,170,152,170,175
"2011","Leeds 060D","E01011346","Total",1791,331,128,203,1460,246,190,270,210,141,202,201
"2011","Leeds 061A","E01011341","Total",1484,196,83,113,1288,110,140,344,226,98,126,244
"2011","Leeds 061B","E01011343","Total",1663,322,91,231,1341,111,134,263,356,70,145,262
"2011","Leeds 061C","E01011345","Total",1418,221,106,115,1197,174,120,222,206,98,178,199
"2011","Leeds 061D","E01011666","Total",1490,141,77,64,1349,48,146,281,236,116,167,355
"2011","Leeds 062A","E01011585","Total",1435,218,106,112,1217,115,122,326,282,44,133,195
"2011","Leeds 062B","E01011587","Total",1660,237,62,175,1423,71,156,367,386,55,114,274
"2011","Leeds 062C","E01011594","Total",1455,179,106,73,1276,129,110,325,194,77,163,278
"2011","Leeds 062D","E01011596","Total",1675,231,71,160,1444,59,150,425,408,74,103,225
"2011","Leeds 062E","E01011598","Total",1524,259,67,192,1265,65,144,336,372,60,102,186
"2011","Leeds 063B","E01011678","Total",1393,321,58,263,1072,35,44,62,290,41,48,552
"2011","Leeds 063D","E01011681","Total",1557,295,26,269,1262,143,36,93,230,60,172,528
"2011","Leeds 063E","E01033006","Total",2218,457,19,438,1761,45,28,143,440,20,117,968
"2011","Leeds 064A","E01011338","Total",1626,352,77,275,1274,203,68,274,160,198,231,140
"2011","Leeds 064B","E01011673","Total",1691,399,65,334,1292,209,20,374,188,131,186,184
"2011","Leeds 064D","E01011677","Total",1526,387,96,291,1139,168,100,248,220,116,102,185
"2011","Leeds 064E","E01033031","Total",1269,450,59,391,819,37,62,143,382,57,53,85
"2011","Leeds 064F","E01033035","Total",1407,436,29,407,971,147,18,310,162,151,76,107
"2011","Leeds 065A","E01011344","Total",1764,346,68,278,1418,297,56,309,250,138,139,229
"2011","Leeds 065B","E01011347","Total",1671,304,59,245,1367,329,62,335,226,89,120,206
"2011","Leeds 065C","E01011348","Total",1619,207,48,159,1412,253,108,263,144,209,213,222
"2011","Leeds 065D","E01011349","Total",1716,544,159,385,1172,142,126,250,256,78,110,210
"2011","Leeds 066A","E01011586","Total",1494,156,89,67,1338,65,198,261,212,93,269,240
"2011","Leeds 066B","E01011595","Total",1804,144,83,61,1660,55,192,278,192,131,407,405
"2011","Leeds 066C","E01011597","Total",1488,142,67,75,1346,83,114,309,184,112,252,292
"2011","Leeds 066D","E01011599","Total",1535,194,102,92,1341,67,150,388,242,83,146,265
"2011","Leeds 067B","E01011287","Total",1320,198,75,123,1122,72,140,290,244,49,121,206
"2011","Leeds 067G","E01032499","Total",1725,180,76,104,1545,15,196,346,304,88,249,347
"2011","Leeds 067H","E01032500","Total",1144,262,55,207,882,89,46,136,242,63,126,180
"2011","Leeds 067I","E01032606","Total",1982,326,87,239,1656,157,166,382,334,68,237,312
"2011","Leeds 067J","E01032607","Total",1057,255,84,171,802,90,66,156,216,63,62,149
"2011","Leeds 067K","E01032608","Total",1147,177,40,137,970,75,64,183,222,47,155,224
"2011","Leeds 068A","E01011608","Total",1384,173,77,96,1211,122,128,263,238,59,159,242
"2011","Leeds 068B","E01011609","Total",1453,269,77,192,1184,114,118,323,214,77,142,196
"2011","Leeds 068C","E01011610","Total",1394,203,76,127,1191,53,148,295,250,51,131,263
"2011","Leeds 068D","E01011611","Total",1359,202,83,119,1157,171,124,253,180,79,108,242
"2011","Leeds 068E","E01011614","Total",1807,245,78,167,1562,79,210,318,404,108,164,279
"2011","Leeds 069A","E01011413","Total",1557,112,68,44,1445,71,160,358,212,92,194,358
"2011","Leeds 069B","E01011415","Total",1587,228,79,149,1359,78,186,335,296,76,105,283
"2011","Leeds 069C","E01011416","Total",1498,136,65,71,1362,85,182,381,224,80,98,312
"2011","Leeds 069D","E01011417","Total",1496,278,163,115,1218,38,270,224,230,51,139,266
"2011","Leeds 069E","E01011420","Total",1293,198,143,55,1095,12,330,147,226,56,85,239
"2011","Leeds 070A","E01011615","Total",1508,181,68,113,1327,135,130,302,250,110,121,279
"2011","Leeds 070B","E01011617","Total",1608,183,71,112,1425,235,138,381,226,76,146,223
"2011","Leeds 070C","E01011618","Total",1581,261,68,193,1320,230,82,364,236,69,99,240
"2011","Leeds 070D","E01011621","Total",1486,163,61,102,1323,207,112,238,174,105,244,243
"2011","Leeds 071A","E01011284","Total",1742,376,50,326,1366,202,56,236,416,80,114,262
"2011","Leeds 071B","E01011292","Total",1619,415,148,267,1204,167,104,206,220,81,171,255
"2011","Leeds 071C","E01011293","Total",1703,270,68,202,1433,139,112,316,290,127,255,194
"2011","Leeds 071D","E01011294","Total",1013,181,55,126,832,121,78,201,136,46,124,126
"2011","Leeds 071E","E01011363","Total",1567,307,81,226,1260,252,96,315,188,37,174,198
"2011","Leeds 072A","E01011616","Total",1431,275,97,178,1156,188,144,209,182,47,161,225
"2011","Leeds 072B","E01011620","Total",1314,104,45,59,1210,241,98,183,134,97,243,214
"2011","Leeds 072C","E01011622","Total",1635,188,49,139,1447,283,48,379,168,99,200,270
"2011","Leeds 072D","E01011624","Total",1823,231,109,122,1592,301,84,306,188,202,285,226
"2011","Leeds 073A","E01011411","Total",1591,167,74,93,1424,65,178,435,286,55,127,278
"2011","Leeds 073B","E01011414","Total",1484,166,69,97,1318,26,212,328,228,66,171,287
"2011","Leeds 073C","E01011418","Total",1457,154,59,95,1303,52,122,385,294,52,140,258
"2011","Leeds 073D","E01011419","Total",1223,88,36,52,1135,14,210,213,222,72,126,278
"2011","Leeds 074A","E01011396","Total",1766,265,103,162,1501,109,158,325,334,66,133,376
"2011","Leeds 074B","E01011399","Total",1463,166,86,80,1297,107,182,315,224,51,121,297
"2011","Leeds 074C","E01011400","Total",1424,161,84,77,1263,64,184,348,196,68,90,313
"2011","Leeds 074D","E01011403","Total",1322,210,154,56,1112,26,256,288,188,41,119,194
"2011","Leeds 075B","E01011623","Total",1517,291,55,236,1226,274,66,220,202,138,130,196
"2011","Leeds 075C","E01011625","Total",1472,284,47,237,1188,192,92,287,196,93,124,204
"2011","Leeds 075D","E01011626","Total",1782,478,105,373,1304,214,76,153,402,99,165,195
"2011","Leeds 075E","E01033021","Total",1244,391,124,267,853,134,82,129,224,82,82,120
"2011","Leeds 075F","E01033033","Total",1185,381,43,338,804,38,48,56,528,0,9,125
"2011","Leeds 075G","E01033034","Total",1025,316,10,306,709,4,2,48,576,0,5,74
"2011","Leeds 076A","E01011602","Total",1483,312,168,144,1171,56,210,277,254,82,103,189
"2011","Leeds 076B","E01011603","Total",1460,205,92,113,1255,52,174,361,258,32,105,273
"2011","Leeds 076C","E01011605","Total",1458,164,97,67,1294,42,228,349,258,57,82,278
"2011","Leeds 076D","E01011606","Total",1682,142,73,69,1540,123,220,334,210,155,268,230
"2011","Leeds 076E","E01011613","Total",1303,147,57,90,1156,137,106,274,264,73,135,167
"2011","Leeds 077A","E01011397","Total",1506,136,68,68,1370,78,154,316,240,80,154,348
"2011","Leeds 077B","E01011398","Total",1257,95,33,62,1162,48,116,289,236,60,112,301
"2011","Leeds 077C","E01011401","Total",1509,115,65,50,1394,51,226,462,232,81,116,226
"2011","Leeds 077D","E01011404","Total",1321,109,54,55,1212,49,168,365,192,72,105,261
"2011","Leeds 077E","E01011405","Total",1414,155,117,38,1259,43,346,239,214,46,85,286
"2011","Leeds 078A","E01011725","Total",1557,283,79,204,1274,219,90,292,180,132,196,165
"2011","Leeds 078B","E01011729","Total",1498,331,78,253,1167,151,74,255,264,42,147,234
"2011","Leeds 078C","E01011730","Total",1559,199,51,148,1360,227,74,321,264,130,164,180
"2011","Leeds 078D","E01011735","Total",1659,278,109,169,1381,211,128,287,208,104,177,266
"2011","Leeds 079A","E01011600","Total",1484,201,88,113,1283,43,158,386,310,36,97,253
"2011","Leeds 079B","E01011601","Total",1494,184,59,125,1310,113,130,371,214,90,163,229
"2011","Leeds 079C","E01011604","Total",1318,205,77,128,1113,46,112,364,278,66,102,145
"2011","Leeds 079D","E01011607","Total",1588,186,59,127,1402,125,146,446,304,84,93,204
"2011","Leeds 079E","E01011612","Total",1228,356,199,157,872,37,186,191,220,63,66,109
"2011","Leeds 080A","E01011726","Total",1428,218,62,156,1210,159,120,269,222,67,166,207
"2011","Leeds 080B","E01011727","Total",1547,169,55,114,1378,90,180,394,324,36,140,214
"2011","Leeds 080C","E01011728","Total",1414,183,100,83,1231,58,230,267,242,70,139,225
"2011","Leeds 080D","E01011739","Total",1530,256,66,190,1274,153,156,236,224,91,138,276
"2011","Leeds 081A","E01011362","Total",1811,493,105,388,1318,148,62,328,404,107,96,173
"2011","Leeds 081B","E01011731","Total",1418,166,88,78,1252,39,162,325,280,55,116,275
"2011","Leeds 081C","E01011732","Total",1812,211,93,118,1601,82,184,411,360,108,160,296
"2011","Leeds 081D","E01011733","Total",1459,238,113,125,1221,68,174,261,294,35,133,256
"2011","Leeds 082A","E01011366","Total",1588,339,82,257,1249,179,76,301,210,121,157,205
"2011","Leeds 082C","E01011368","Total",1275,295,38,257,980,140,32,225,204,69,167,143
"2011","Leeds 082D","E01011370","Total",1646,294,43,251,1352,78,62,262,238,125,318,269
"2011","Leeds 082E","E01033013","Total",1164,298,63,235,866,66,62,146,410,32,73,77
"2011","Leeds 082F","E01033032","Total",1278,417,37,380,861,38,28,153,524,5,21,92
"2011","Leeds 083A","E01011734","Total",2315,291,81,210,2024,144,182,579,510,76,218,315
"2011","Leeds 083B","E01011736","Total",1485,173,66,107,1312,57,196,353,274,42,131,259
"2011","Leeds 083C","E01011737","Total",1563,301,95,206,1262,229,98,255,302,57,103,218
"2011","Leeds 083D","E01011738","Total",1428,191,72,119,1237,49,146,348,290,53,127,224
"2011","Leeds 085A","E01011364","Total",1631,345,69,276,1286,165,98,267,274,130,143,209
"2011","Leeds 085B","E01011371","Total",1421,384,183,201,1037,113,144,161,158,116,130,215
"2011","Leeds 085C","E01011373","Total",1438,196,52,144,1242,209,56,214,160,208,211,184
"2011","Leeds 085D","E01011374","Total",1184,256,45,211,928,139,46,209,256,35,84,159
"2011","Leeds 086A","E01011312","Total",1598,311,39,272,1287,171,34,213,148,190,356,175
"2011","Leeds 086B","E01011316","Total",1657,325,41,284,1332,192,56,219,200,184,240,241
"2011","Leeds 086C","E01011372","Total",1380,220,33,187,1160,143,26,161,118,227,355,130
"2011","Leeds 086D","E01011375","Total",1847,288,39,249,1559,115,40,252,158,360,449,185
"2011","Leeds 087A","E01011390","Total",1443,176,101,75,1267,107,168,236,226,78,206,246
"2011","Leeds 087B","E01011391","Total",1645,214,141,73,1431,74,344,207,228,102,175,301
"2011","Leeds 087C","E01011392","Total",1463,165,93,72,1298,80,246,267,272,57,133,243
"2011","Leeds 087D","E01011402","Total",1751,253,154,99,1498,61,358,327,272,30,160,290
"2011","Leeds 088A","E01011298","Total",1538,202,89,113,1336,147,152,319,282,107,108,221
"2011","Leeds 088B","E01011299","Total",2238,236,87,149,2002,137,236,586,444,122,190,287
"2011","Leeds 088C","E01011302","Total",1371,142,81,61,1229,32,278,195,292,25,56,351
"2011","Leeds 088D","E01011303","Total",1145,120,69,51,1025,81,174,261,170,66,86,187
"2011","Leeds 089A","E01011300","Total",1469,165,83,82,1304,139,158,390,202,92,125,198
"2011","Leeds 089B","E01011301","Total",1336,96,45,51,1240,63,190,333,286,35,80,253
"2011","Leeds 089C","E01011304","Total",1591,246,131,115,1345,114,124,342,258,107,158,242
"2011","Leeds 089D","E01011305","Total",1496,158,52,106,1338,70,144,341,314,67,164,238
"2011","Leeds 089E","E01011306","Total",1342,101,49,52,1241,47,184,294,258,35,186,237
"2011","Leeds 090A","E01011315","Total",1552,196,79,117,1356,89,154,271,238,95,235,274
"2011","Leeds 090B","E01011317","Total",1705,398,131,267,1307,229,104,275,262,128,155,154
"2011","Leeds 090C","E01011318","Total",1470,218,51,167,1252,228,66,321,206,99,166,166
"2011","Leeds 090D","E01011321","Total",1544,201,64,137,1343,190,86,314,182,131,178,262
"2011","Leeds 090E","E01011369","Total",1561,265,137,128,1296,143,190,220,254,113,146,230
"2011","Leeds 091A","E01011313","Total",1595,202,60,142,1393,156,90,283,248,150,213,253
"2011","Leeds 091B","E01011314","Total",1472,247,81,166,1225,112,98,290,314,101,155,155
"2011","Leeds 091C","E01011319","Total",1542,203,78,125,1339,98,136,271,194,145,217,278
"2011","Leeds 091D","E01011320","Total",1674,184,75,109,1490,118,184,329,236,85,217,321
"2011","Leeds 091E","E01011322","Total",1539,205,97,108,1334,142,182,255,248,93,142,272
"2011","Leeds 092A","E01011471","Total",1400,224,79,145,1176,225,110,176,232,67,129,237
"2011","Leeds 092B","E01011472","Total",1564,271,121,150,1293,202,156,247,172,122,144,250
"2011","Leeds 092C","E01011473","Total",1476,246,55,191,1230,275,38,283,162,135,168,169
"2011","Leeds 092D","E01011474","Total",1457,262,83,179,1195,175,74,235,184,128,208,191
"2011","Leeds 093A","E01011518","Total",2187,276,77,199,1911,161,142,505,514,124,172,293
"2011","Leeds 093B","E01011524","Total",1235,144,52,92,1091,47,162,265,244,50,118,205
"2011","Leeds 093C","E01011526","Total",1291,71,22,49,1220,44,90,390,258,57,140,241
"2011","Leeds 093D","E01011531","Total",1424,205,131,74,1219,31,316,198,260,25,124,265
"2011","Leeds 094A","E01011466","Total",1454,230,96,134,1224,141,164,216,186,54,159,304
"2011","Leeds 094B","E01011469","Total",1460,182,58,124,1278,67,150,313,316,72,105,255
"2011","Leeds 094C","E01011475","Total",1497,258,62,196,1239,229,76,285,232,72,122,223
"2011","Leeds 094D","E01011476","Total",1195,138,72,66,1057,185,98,215,156,94,99,210
"2011","Leeds 095A","E01011519","Total",1488,200,86,114,1288,126,128,349,258,80,117,230
"2011","Leeds 095B","E01011522","Total",1396,122,50,72,1274,29,218,354,274,50,104,245
"2011","Leeds 095C","E01011525","Total",1529,222,57,165,1307,85,148,371,320,60,101,222
"2011","Leeds 095D","E01011528","Total",1596,127,49,78,1469,62,92,516,296,56,167,280
"2011","Leeds 095E","E01011532","Total",1556,267,129,138,1289,130,132,258,260,118,209,182
"2011","Leeds 096A","E01011520","Total",1491,171,81,90,1320,60,246,315,288,58,149,204
"2011","Leeds 096B","E01011521","Total",1968,283,107,176,1685,110,230,453,436,60,112,284
"2011","Leeds 096C","E01011523","Total",1704,260,137,123,1444,75,156,454,314,71,143,231
"2011","Leeds 096D","E01011527","Total",1773,191,74,117,1582,77,296,397,328,44,116,324
"2011","Leeds 096E","E01011529","Total",1431,146,65,81,1285,135,128,319,234,127,141,201
"2011","Leeds 097B","E01011635","Total",1547,219,97,122,1328,81,224,314,298,57,140,214
"2011","Leeds 097C","E01011637","Total",1768,174,50,124,1594,96,172,492,346,92,143,253
"2011","Leeds 097D","E01011638","Total",1487,164,82,82,1323,58,230,360,198,100,150,227
"2011","Leeds 097F","E01032487","Total",1013,145,97,48,868,106,124,159,162,58,83,176
"2011","Leeds 097G","E01032488","Total",1824,154,91,63,1670,68,258,465,290,91,174,324
"2011","Leeds 098A","E01011627","Total",1403,155,100,55,1248,136,182,250,244,77,140,219
"2011","Leeds 098B","E01011628","Total",1328,169,109,60,1159,52,248,234,240,56,85,244
"2011","Leeds 098C","E01011629","Total",1302,200,94,106,1102,134,150,227,234,37,71,249
"2011","Leeds 098D","E01011632","Total",1335,213,105,108,1122,126,134,278,210,95,126,153
"2011","Leeds 098E","E01011633","Total",1437,168,84,84,1269,55,180,368,260,22,104,280
"2011","Leeds 099A","E01011490","Total",2514,422,77,345,2092,156,130,660,610,69,197,270
"2011","Leeds 099C","E01011502","Total",1333,192,92,100,1141,130,148,304,198,66,106,189
"2011","Leeds 099E","E01032497","Total",1496,203,60,143,1293,250,94,275,240,155,132,147
"2011","Leeds 099F","E01032498","Total",1524,214,112,102,1310,74,282,264,240,45,130,275
"2011","Leeds 100A","E01011496","Total",1500,129,21,108,1371,86,72,509,332,66,115,191
"2011","Leeds 100B","E01011630","Total",2064,212,67,145,1852,124,170,621,476,52,107,302
"2011","Leeds 100C","E01011634","Total",1499,201,91,110,1298,99,224,249,270,82,187,187
"2011","Leeds 100D","E01011636","Total",1592,215,111,104,1377,42,284,300,276,58,176,241
"2011","Leeds 100E","E01011639","Total",1523,184,96,88,1339,154,172,273,230,103,130,277
"2011","Leeds 101A","E01011491","Total",1357,225,80,145,1132,211,90,247,170,68,185,161
"2011","Leeds 101B","E01011492","Total",1344,184,84,100,1160,192,110,224,118,118,213,185
"2011","Leeds 101C","E01011493","Total",1528,196,65,131,1332,218,128,299,196,101,171,219
"2011","Leeds 101D","E01011494","Total",1304,153,72,81,1151,186,72,291,188,73,136,205
"2011","Leeds 101E","E01011497","Total",1608,221,83,138,1387,215,112,313,182,126,206,233
"2011","Leeds 102B","E01011540","Total",1439,203,87,116,1236,143,144,310,258,95,132,154
"2011","Leeds 102F","E01032489","Total",1923,297,73,224,1626,128,120,362,514,49,200,253
"2011","Leeds 102G","E01032490","Total",1396,142,23,119,1254,75,64,430,300,81,133,171
"2011","Leeds 102H","E01032491","Total",1230,89,20,69,1141,76,76,378,282,63,90,176
"2011","Leeds 102I","E01032492","Total",1967,420,89,331,1547,198,130,342,448,113,147,169
"2011","Leeds 103A","E01011307","Total",1492,148,63,85,1344,118,166,273,258,102,164,263
"2011","Leeds 103B","E01011308","Total",1518,181,107,74,1337,100,224,338,222,94,127,232
"2011","Leeds 103C","E01011393","Total",1707,184,99,85,1523,58,166,534,258,115,180,212
"2011","Leeds 103D","E01011394","Total",1182,133,72,61,1049,31,136,279,204,67,131,201
"2011","Leeds 103E","E01011395","Total",1184,102,18,84,1082,77,56,418,218,74,97,142
"2011","Leeds 104A","E01011533","Total",1294,305,102,203,989,91,134,200,316,37,91,120
"2011","Leeds 104B","E01011541","Total",1690,557,234,323,1133,82,168,243,394,25,67,154
"2011","Leeds 104C","E01011545","Total",1388,240,78,162,1148,94,104,304,300,41,128,177
"2011","Leeds 104D","E01011547","Total",1773,310,113,197,1463,119,138,375,372,110,147,202
"2011","Leeds 105C","E01011499","Total",2560,279,51,228,2281,161,122,769,532,143,281,273
"2011","Leeds 105D","E01011500","Total",1560,188,110,78,1372,78,194,299,318,57,132,294
"2011","Leeds 105E","E01032495","Total",2399,174,44,130,2225,232,70,739,528,141,271,244
"2011","Leeds 105F","E01032496","Total",2044,236,74,162,1808,134,160,597,410,75,139,293
"2011","Leeds 106A","E01011530","Total",1460,166,62,104,1294,48,216,333,356,53,109,179
"2011","Leeds 106B","E01011534","Total",1421,255,92,163,1166,84,148,325,292,63,69,185
"2011","Leeds 106C","E01011546","Total",1649,238,69,169,1411,119,128,379,342,79,109,255
"2011","Leeds 106D","E01011548","Total",1445,180,90,90,1265,59,228,318,254,62,120,224
"2011","Leeds 106E","E01011550","Total",1404,113,50,63,1291,63,148,351,240,63,193,233
"2011","Leeds 107A","E01011537","Total",2023,307,138,169,1716,82,346,364,382,87,167,288
"2011","Leeds 107B","E01011538","Total",1497,217,107,110,1280,125,164,292,234,76,179,210
"2011","Leeds 107C","E01011551","Total",1565,156,27,129,1409,101,90,454,330,83,128,223
"2011","Leeds 107D","E01011552","Total",1467,146,71,75,1321,107,134,336,182,131,214,217
"2011","Leeds 108A","E01011535","Total",1664,125,64,61,1539,69,218,445,246,70,164,327
"2011","Leeds 108B","E01011536","Total",1587,151,77,74,1436,68,224,382,254,47,156,305
"2011","Leeds 108C","E01011549","Total",1503,51,9,42,1452,27,42,472,250,46,202,413
"2011","Leeds 108D","E01011553","Total",1436,139,50,89,1297,84,168,320,314,61,101,249
"2011","Leeds 109A","E01011685","Total",1715,275,69,206,1440,25,130,304,392,85,133,371
"2011","Leeds 109B","E01011687","Total",1469,134,62,72,1335,41,146,299,248,62,204,335
"2011","Leeds 109C","E01011690","Total",1351,277,124,153,1074,30,134,146,298,50,89,327
"2011","Leeds 109D","E01011692","Total",1382,251,62,189,1131,28,106,248,372,61,70,246
"2011","Leeds 109E","E01011693","Total",1504,266,47,219,1238,48,48,132,472,20,51,467
"2011","Leeds 109F","E01011694","Total",1803,129,59,70,1674,34,94,226,250,77,169,824
"2011","Leeds 109G","E01032876","Total",1339,127,39,88,1212,28,164,225,254,70,107,364
"2011","Leeds 110A","E01011442","Total",1615,154,18,136,1461,13,20,36,292,24,59,1017
"2011","Leeds 110B","E01011443","Total",1372,193,22,171,1179,22,10,21,212,21,59,834
"2011","Leeds 110C","E01011444","Total",1836,196,16,180,1640,24,6,24,224,16,89,1257
"2011","Leeds 110D","E01011451","Total",937,208,43,165,729,19,34,76,276,36,35,253
"2011","Leeds 110E","E01011668","Total",1607,136,14,122,1471,56,16,52,228,22,60,1037
"2011","Leeds 110F","E01011669","Total",1255,187,15,172,1068,54,16,146,242,22,65,523
"2011","Leeds 110G","E01032946","Total",1866,302,128,174,1564,24,64,84,376,35,84,897
"2011","Leeds 111A","E01033008","Total",1092,364,4,360,728,6,6,65,596,5,10,40
"2011","Leeds 111B","E01033010","Total",1047,400,3,397,647,0,2,54,492,5,4,90
"2011","Leeds 111C","E01033011","Total",1172,415,12,403,757,12,0,18,610,0,13,104
"2011","Leeds 111D","E01033015","Total",1167,299,4,295,868,4,2,81,714,0,5,62
"2011","Leeds 111E","E01033016","Total",1015,441,5,436,574,0,8,51,468,0,9,38
"2011","Leeds 112A","E01011467","Total",1379,252,54,198,1127,149,60,287,284,76,113,158
"2011","Leeds 112B","E01011468","Total",1500,338,108,230,1162,178,134,192,188,94,145,231
"2011","Leeds 112C","E01011470","Total",1266,222,80,142,1044,121,118,191,270,47,105,192
"2011","Leeds 112D","E01033018","Total",1136,363,1,362,773,10,4,66,652,5,0,36
"2011","Leeds 112E","E01033019","Total",1214,365,3,362,849,19,2,61,702,0,0,65
"2011","Wakefield 001A","E01011740","Total",1499,193,85,108,1306,214,148,313,238,67,100,226
"2011","Wakefield 001B","E01011741","Total",1486,153,83,70,1333,71,234,265,272,75,126,290
"2011","Wakefield 001C","E01011742","Total",1629,244,146,98,1385,146,156,298,234,84,191,276
"2011","Wakefield 001D","E01011745","Total",1745,187,62,125,1558,246,120,318,234,231,145,264
"2011","Wakefield 001E","E01011746","Total",1400,147,48,99,1253,189,96,246,212,130,140,240
"2011","Wakefield 002A","E01011752","Total",1547,249,82,167,1298,115,128,310,310,71,115,249
"2011","Wakefield 002B","E01011753","Total",1369,215,97,118,1154,81,150,241,238,58,116,270
"2011","Wakefield 002C","E01011756","Total",1431,351,172,179,1080,98,212,133,246,74,76,241
"2011","Wakefield 002D","E01011760","Total",1674,287,91,196,1387,126,114,317,366,62,100,302
"2011","Wakefield 002E","E01011762","Total",1572,248,80,168,1324,104,160,342,324,48,96,250
"2011","Wakefield 003A","E01011743","Total",1466,102,63,39,1364,25,256,291,266,46,126,354
"2011","Wakefield 003B","E01011744","Total",1621,140,78,62,1481,38,234,482,288,30,113,296
"2011","Wakefield 003C","E01011747","Total",1624,252,93,159,1372,179,126,404,240,86,152,185
"2011","Wakefield 003D","E01011750","Total",1572,176,66,110,1396,186,110,238,194,216,203,249
"2011","Wakefield 003E","E01011754","Total",1452,173,118,55,1279,89,180,247,264,77,132,290
"2011","Wakefield 004A","E01011757","Total",1851,178,84,94,1673,163,168,485,306,112,149,290
"2011","Wakefield 004B","E01011759","Total",1877,276,110,166,1601,162,186,324,286,88,158,397
"2011","Wakefield 004C","E01011761","Total",1820,205,83,122,1615,67,238,361,400,84,187,278
"2011","Wakefield 004D","E01011763","Total",1443,326,156,170,1117,107,182,276,240,20,94,198
"2011","Wakefield 004E","E01011764","Total",1492,284,105,179,1208,102,148,326,220,79,87,246
"2011","Wakefield 005A","E01011748","Total",1627,136,56,80,1491,79,204,339,276,82,152,359
"2011","Wakefield 005B","E01011749","Total",2116,300,91,209,1816,180,136,491,474,52,133,350
"2011","Wakefield 005C","E01011751","Total",1281,108,37,71,1173,41,86,293,298,50,148,257
"2011","Wakefield 005D","E01011755","Total",1647,132,57,75,1515,49,186,338,372,62,156,352
"2011","Wakefield 006A","E01011873","Total",1575,172,49,123,1403,53,114,463,364,47,119,243
"2011","Wakefield 006B","E01011877","Total",1372,101,42,59,1271,60,150,357,238,36,128,302
"2011","Wakefield 006C","E01011894","Total",1390,96,39,57,1294,48,138,369,238,30,163,308
"2011","Wakefield 006D","E01011895","Total",1482,139,50,89,1343,47,126,363,234,80,171,322
"2011","Wakefield 007A","E01011875","Total",1435,259,118,141,1176,110,148,329,262,76,75,176
"2011","Wakefield 007B","E01011876","Total",1401,246,118,128,1155,101,134,299,256,42,123,200
"2011","Wakefield 007C","E01011878","Total",1560,171,57,114,1389,71,150,337,328,40,140,323
"2011","Wakefield 007D","E01011880","Total",1478,173,55,118,1305,66,174,417,318,30,66,234
"2011","Wakefield 008A","E01011881","Total",1468,185,75,110,1283,97,216,311,272,57,82,248
"2011","Wakefield 008B","E01011887","Total",1217,117,56,61,1100,59,140,273,196,57,109,266
"2011","Wakefield 008C","E01011893","Total",1361,127,55,72,1234,39,154,343,300,30,164,204
"2011","Wakefield 008D","E01011896","Total",1376,198,114,84,1178,96,188,261,230,37,125,241
"2011","Wakefield 008E","E01011897","Total",1423,288,159,129,1135,101,192,234,240,50,139,179
"2011","Wakefield 009A","E01011874","Total",1611,141,70,71,1470,25,242,360,298,108,123,314
"2011","Wakefield 009B","E01011879","Total",1447,180,71,109,1267,71,154,349,276,56,100,261
"2011","Wakefield 009C","E01011882","Total",1511,148,94,54,1363,21,292,317,242,55,124,312
"2011","Wakefield 009D","E01011883","Total",1414,226,118,108,1188,54,178,295,222,45,151,243
"2011","Wakefield 010A","E01011805","Total",1400,306,114,192,1094,86,166,181,244,57,133,227
"2011","Wakefield 010B","E01011807","Total",1425,258,104,154,1167,94,88,279,258,109,107,232
"2011","Wakefield 010C","E01011808","Total",1707,247,119,128,1460,103,234,257,306,103,164,293
"2011","Wakefield 010D","E01011810","Total",1527,109,47,62,1418,92,126,294,248,94,211,353
"2011","Wakefield 011A","E01011803","Total",1379,168,58,110,1211,139,112,262,222,82,165,229
"2011","Wakefield 011B","E01011804","Total",1618,180,87,93,1438,104,220,360,310,100,111,233
"2011","Wakefield 011C","E01011806","Total",1496,193,72,121,1303,82,168,300,290,49,121,293
"2011","Wakefield 011D","E01011809","Total",1474,308,159,149,1166,53,186,200,272,78,152,225
"2011","Wakefield 011E","E01011811","Total",1561,186,79,107,1375,191,112,262,288,75,238,209
"2011","Wakefield 012A","E01011835","Total",1466,136,58,78,1330,67,236,271,330,36,74,316
"2011","Wakefield 012B","E01011836","Total",1424,113,36,77,1311,100,100,370,336,79,119,207
"2011","Wakefield 012C","E01011839","Total",1612,113,52,61,1499,134,224,359,230,83,122,347
"2011","Wakefield 012D","E01011843","Total",1643,135,57,78,1508,186,144,392,256,80,183,267
"2011","Wakefield 012E","E01011844","Total",1918,110,35,75,1808,85,108,725,384,96,131,279
"2011","Wakefield 013A","E01011758","Total",1334,207,78,129,1127,109,130,243,236,47,131,231
"2011","Wakefield 013B","E01011812","Total",2595,194,58,136,2401,105,156,759,548,141,288,404
"2011","Wakefield 013C","E01011820","Total",1477,184,78,106,1293,74,120,409,276,60,130,224
"2011","Wakefield 013D","E01011821","Total",1305,203,111,92,1102,54,178,265,202,30,117,256
"2011","Wakefield 014A","E01011885","Total",1370,145,89,56,1225,66,228,259,250,36,97,289
"2011","Wakefield 014B","E01011886","Total",1475,178,85,93,1297,60,206,297,274,38,134,288
"2011","Wakefield 014C","E01011888","Total",1430,124,64,60,1306,28,238,321,250,45,76,348
"2011","Wakefield 014D","E01011890","Total",1269,83,35,48,1186,54,142,324,210,63,110,283
"2011","Wakefield 014E","E01011891","Total",1493,262,138,124,1231,98,204,241,260,56,127,245
"2011","Wakefield 015A","E01011834","Total",1527,135,49,86,1392,132,108,436,276,118,132,190
"2011","Wakefield 015B","E01011837","Total",1438,188,64,124,1250,73,154,216,248,119,142,298
"2011","Wakefield 015C","E01011838","Total",1935,580,161,419,1355,122,146,268,452,59,125,183
"2011","Wakefield 015D","E01011841","Total",1522,243,119,124,1279,52,206,293,262,52,149,265
"2011","Wakefield 015E","E01011842","Total",1424,285,122,163,1139,168,146,266,206,73,102,178
"2011","Wakefield 016A","E01011813","Total",1576,247,128,119,1329,147,146,335,214,132,123,232
"2011","Wakefield 016B","E01011814","Total",1698,330,72,258,1368,137,116,342,290,86,156,241
"2011","Wakefield 016C","E01011815","Total",1523,209,110,99,1314,119,170,251,324,74,123,253
"2011","Wakefield 016D","E01011816","Total",1392,240,133,107,1152,117,154,228,180,68,197,208
"2011","Wakefield 016E","E01011819","Total",1562,243,81,162,1319,69,104,341,316,42,135,312
"2011","Wakefield 016F","E01011822","Total",1428,193,69,124,1235,152,142,269,260,82,105,225
"2011","Wakefield 017A","E01011884","Total",2262,258,54,204,2004,112,176,570,502,86,225,333
"2011","Wakefield 017B","E01011912","Total",1543,338,115,223,1205,38,94,142,226,83,363,259
"2011","Wakefield 017C","E01011913","Total",1621,157,57,100,1464,56,54,215,148,189,401,401
"2011","Wakefield 017D","E01011916","Total",1980,746,211,535,1234,46,136,135,442,40,162,273
"2011","Wakefield 018A","E01011840","Total",1540,207,106,101,1333,125,176,302,290,83,126,231
"2011","Wakefield 018B","E01011850","Total",1522,172,84,88,1350,194,148,229,198,90,206,285
"2011","Wakefield 018C","E01011852","Total",1626,159,89,70,1467,219,116,373,216,132,155,256
"2011","Wakefield 018D","E01011853","Total",1461,170,118,52,1291,86,162,241,164,133,178,327
"2011","Wakefield 019A","E01011920","Total",1555,291,66,225,1264,78,94,234,288,94,250,226
"2011","Wakefield 019B","E01011923","Total",1633,213,57,156,1420,72,182,315,338,100,165,248
"2011","Wakefield 019C","E01011924","Total",1536,201,62,139,1335,81,162,264,272,87,198,271
"2011","Wakefield 019D","E01011925","Total",1692,180,70,110,1512,224,104,375,218,188,163,240
"2011","Wakefield 020A","E01011909","Total",1404,151,70,81,1253,74,166,185,292,89,159,288
"2011","Wakefield 020B","E01011910","Total",1481,351,150,201,1130,91,182,189,188,102,201,177
"2011","Wakefield 020C","E01011911","Total",1526,195,71,124,1331,213,104,283,186,139,173,233
"2011","Wakefield 020D","E01011914","Total",1547,224,64,160,1323,176,96,289,264,109,158,231
"2011","Wakefield 020E","E01011915","Total",1611,195,38,157,1416,108,84,351,226,106,314,227
"2011","Wakefield 021A","E01011823","Total",1350,186,77,109,1164,52,182,303,274,46,71,236
"2011","Wakefield 021B","E01011824","Total",1520,184,85,99,1336,165,84,346,218,127,177,219
"2011","Wakefield 021C","E01011825","Total",1838,194,84,110,1644,133,136,568,370,104,126,207
"2011","Wakefield 021D","E01011826","Total",1434,124,73,51,1310,64,222,365,244,41,121,253
"2011","Wakefield 021E","E01011827","Total",1177,134,81,53,1043,47,226,192,220,40,74,244
"2011","Wakefield 021F","E01011828","Total",1427,165,62,103,1262,93,154,328,316,72,83,216
"2011","Wakefield 022A","E01011889","Total",1303,89,28,61,1214,79,116,434,208,50,123,204
"2011","Wakefield 022B","E01011892","Total",1797,251,131,120,1546,115,160,476,278,89,157,271
"2011","Wakefield 022C","E01011919","Total",1824,309,70,239,1515,143,116,370,354,100,176,256
"2011","Wakefield 022D","E01011921","Total",1468,142,83,59,1326,91,198,284,250,84,140,279
"2011","Wakefield 022E","E01011926","Total",1598,202,59,143,1396,124,96,277,234,169,252,244
"2011","Wakefield 022F","E01011927","Total",1302,187,85,102,1115,94,112,253,196,88,155,217
"2011","Wakefield 023A","E01011845","Total",1367,149,107,42,1218,21,294,220,316,25,110,232
"2011","Wakefield 023B","E01011846","Total",1362,156,72,84,1206,59,218,285,224,41,133,246
"2011","Wakefield 023C","E01011847","Total",1428,150,89,61,1278,59,214,335,266,16,120,268
"2011","Wakefield 023D","E01011848","Total",1443,141,89,52,1302,72,312,262,228,36,134,258
"2011","Wakefield 023E","E01011851","Total",1429,275,148,127,1154,70,156,236,268,65,125,234
"2011","Wakefield 024A","E01011775","Total",2855,221,77,144,2634,93,182,873,638,196,291,361
"2011","Wakefield 024B","E01011776","Total",1546,155,73,82,1391,148,166,305,220,120,192,240
"2011","Wakefield 024C","E01011777","Total",1317,202,93,109,1115,65,206,254,246,35,95,214
"2011","Wakefield 024D","E01011778","Total",1550,150,78,72,1400,132,168,352,280,85,89,294
"2011","Wakefield 024E","E01011817","Total",1332,149,76,73,1183,129,122,269,206,70,146,241
"2011","Wakefield 024F","E01011818","Total",1331,147,73,74,1184,83,174,262,308,53,73,231
"2011","Wakefield 025A","E01011829","Total",1426,160,65,95,1266,77,140,357,274,67,81,270
"2011","Wakefield 025B","E01011830","Total",1254,274,158,116,980,33,258,224,222,30,73,140
"2011","Wakefield 025C","E01011831","Total",1708,248,88,160,1460,106,176,366,322,88,103,299
"2011","Wakefield 025D","E01011832","Total",1393,194,105,89,1199,83,164,289,230,59,103,271
"2011","Wakefield 025E","E01011833","Total",1507,197,72,125,1310,61,182,401,270,26,92,278
"2011","Wakefield 026A","E01011899","Total",1506,96,39,57,1410,193,124,282,156,133,266,256
"2011","Wakefield 026B","E01011900","Total",1531,329,146,183,1202,105,164,235,242,94,147,215
"2011","Wakefield 026C","E01011901","Total",1645,114,46,68,1531,247,118,311,142,192,249,272
"2011","Wakefield 026D","E01011904","Total",1427,92,41,51,1335,197,106,291,146,202,198,195
"2011","Wakefield 026E","E01011918","Total",1543,158,67,91,1385,180,144,319,258,134,133,217
"2011","Wakefield 026F","E01011922","Total",1397,258,77,181,1139,107,90,224,216,120,189,193
"2011","Wakefield 027A","E01011779","Total",1508,143,76,67,1365,122,162,280,180,75,168,378
"2011","Wakefield 027B","E01011780","Total",1832,345,170,175,1487,203,246,302,246,92,176,222
"2011","Wakefield 027C","E01011781","Total",1703,286,114,172,1417,179,170,391,304,50,111,212
"2011","Wakefield 027D","E01011782","Total",1490,171,94,77,1319,69,200,312,226,55,157,300
"2011","Wakefield 027E","E01011783","Total",1303,194,56,138,1109,90,144,256,238,21,119,241
"2011","Wakefield 028A","E01011902","Total",1388,263,134,129,1125,74,196,213,238,37,100,267
"2011","Wakefield 028B","E01011903","Total",1214,250,101,149,964,58,194,146,228,30,103,205
"2011","Wakefield 028C","E01011905","Total",1618,172,111,61,1446,39,296,375,240,73,172,251
"2011","Wakefield 028D","E01011907","Total",1764,397,135,262,1367,64,160,248,306,66,171,352
"2011","Wakefield 029A","E01011793","Total",1621,192,108,84,1429,67,280,309,330,41,103,299
"2011","Wakefield 029B","E01011794","Total",1399,192,86,106,1207,85,142,278,218,74,165,245
"2011","Wakefield 029C","E01011795","Total",1278,196,105,91,1082,78,158,289,250,51,67,189
"2011","Wakefield 029D","E01011796","Total",1440,116,62,54,1324,74,166,354,268,77,120,265
"2011","Wakefield 029E","E01011799","Total",1580,303,208,95,1277,117,236,300,232,38,130,224
"2011","Wakefield 029F","E01011800","Total",1658,202,71,131,1456,95,188,393,292,104,86,298
"2011","Wakefield 030A","E01011898","Total",1456,309,40,269,1147,110,80,271,296,65,96,229
"2011","Wakefield 030B","E01011906","Total",1584,226,74,152,1358,263,98,334,192,116,163,192
"2011","Wakefield 030C","E01011908","Total",2184,299,103,196,1885,126,140,416,424,127,325,327
"2011","Wakefield 030D","E01011917","Total",1590,286,74,212,1304,113,62,206,292,147,253,231
"2011","Wakefield 030E","E01011944","Total",1389,180,35,145,1209,125,82,313,246,95,117,231
"2011","Wakefield 031A","E01011797","Total",1717,156,77,79,1561,78,226,505,294,46,129,283
"2011","Wakefield 031B","E01011798","Total",1301,257,94,163,1044,49,146,260,320,37,61,171
"2011","Wakefield 031C","E01011801","Total",1514,178,55,123,1336,145,120,303,274,109,123,262
"2011","Wakefield 031D","E01011802","Total",1452,176,87,89,1276,103,194,225,300,37,110,307
"2011","Wakefield 032A","E01011765","Total",1545,173,82,91,1372,73,172,308,234,76,183,326
"2011","Wakefield 032B","E01011766","Total",1523,106,48,58,1417,101,136,420,204,68,140,348
"2011","Wakefield 032C","E01011773","Total",1490,110,70,40,1380,45,268,261,252,40,126,388
"2011","Wakefield 032D","E01011774","Total",1387,156,80,76,1231,55,162,319,240,52,137,266
"2011","Wakefield 033A","E01011939","Total",1483,138,92,46,1345,40,296,340,258,61,60,290
"2011","Wakefield 033B","E01011945","Total",1444,209,135,74,1235,36,228,263,254,32,183,239
"2011","Wakefield 033C","E01011947","Total",1580,113,82,31,1467,25,428,268,268,59,119,300
"2011","Wakefield 033D","E01011948","Total",1590,135,92,43,1455,27,300,345,278,86,103,316
"2011","Wakefield 034A","E01011767","Total",1757,171,94,77,1586,44,314,312,312,102,174,328
"2011","Wakefield 034B","E01011768","Total",1374,121,51,70,1253,60,222,290,268,56,110,247
"2011","Wakefield 034C","E01011769","Total",2133,238,75,163,1895,101,180,589,502,86,135,302
"2011","Wakefield 034D","E01011770","Total",1827,226,124,102,1601,122,218,365,316,101,161,318
"2011","Wakefield 034E","E01011849","Total",1570,202,119,83,1368,21,372,266,302,50,115,242
"2011","Wakefield 034F","E01011857","Total",1641,165,100,65,1476,52,332,335,316,56,94,291
"2011","Wakefield 035A","E01011928","Total",1334,198,111,87,1136,72,214,245,242,49,78,236
"2011","Wakefield 035B","E01011931","Total",1506,142,76,66,1364,71,228,359,294,62,115,235
"2011","Wakefield 035C","E01011932","Total",1417,136,60,76,1281,57,202,259,294,82,130,257
"2011","Wakefield 035D","E01011938","Total",1391,134,66,68,1257,47,138,333,280,80,123,256
"2011","Wakefield 036A","E01011929","Total",1595,204,110,94,1391,46,284,257,378,26,126,274
"2011","Wakefield 036B","E01011930","Total",1711,167,64,103,1544,59,190,449,350,94,126,276
"2011","Wakefield 036C","E01011933","Total",1583,144,46,98,1439,99,182,356,322,90,141,249
"2011","Wakefield 036D","E01011937","Total",1420,152,68,84,1268,26,208,308,256,30,151,289
"2011","Wakefield 037A","E01011934","Total",1408,180,68,112,1228,25,184,294,258,37,127,303
"2011","Wakefield 037B","E01011936","Total",1476,221,124,97,1255,89,170,320,198,70,161,247
"2011","Wakefield 037C","E01011940","Total",1439,169,72,97,1270,116,142,296,234,72,122,288
"2011","Wakefield 037D","E01011943","Total",1741,298,154,144,1443,203,166,311,254,114,127,268
"2011","Wakefield 038A","E01011935","Total",1798,185,64,121,1613,49,164,549,392,65,147,247
"2011","Wakefield 038B","E01011941","Total",1449,178,124,54,1271,39,254,307,258,26,129,258
"2011","Wakefield 038C","E01011942","Total",1246,133,74,59,1113,31,260,224,256,88,66,188
"2011","Wakefield 038D","E01011946","Total",1440,150,68,82,1290,55,210,297,254,10,108,356
"2011","Wakefield 039A","E01011785","Total",1558,131,49,82,1427,120,148,309,236,109,244,261
"2011","Wakefield 039B","E01011789","Total",1183,168,80,88,1015,92,134,196,140,58,139,256
"2011","Wakefield 039C","E01011791","Total",1475,173,100,73,1302,145,182,245,222,90,155,263
"2011","Wakefield 039D","E01011792","Total",1516,200,81,119,1316,189,150,246,178,92,233,228
"2011","Wakefield 040A","E01011771","Total",1301,222,148,74,1079,101,218,156,182,51,133,238
"2011","Wakefield 040B","E01011772","Total",1566,174,64,110,1392,94,184,322,366,41,128,257
"2011","Wakefield 040C","E01011784","Total",1817,217,94,123,1600,157,192,319,314,122,189,307
"2011","Wakefield 040D","E01011786","Total",1610,120,34,86,1490,138,114,316,282,128,188,324
"2011","Wakefield 041A","E01011854","Total",1214,148,60,88,1066,97,88,290,196,83,119,193
"2011","Wakefield 041B","E01011855","Total",1591,197,90,107,1394,118,170,321,286,83,161,255
"2011","Wakefield 041C","E01011856","Total",1425,170,78,92,1255,110,170,235,274,89,118,259
"2011","Wakefield 041D","E01011858","Total",1588,170,87,83,1418,72,158,406,196,84,229,273
"2011","Wakefield 042A","E01011787","Total",1704,208,94,114,1496,92,234,351,342,46,119,312
"2011","Wakefield 042B","E01011788","Total",1672,177,90,87,1495,54,254,303,348,35,162,339
"2011","Wakefield 042C","E01011790","Total",1628,284,126,158,1344,121,170,304,240,76,153,280
"2011","Wakefield 042D","E01011865","Total",1676,263,156,107,1413,133,232,291,194,80,161,322
"2011","Wakefield 042E","E01011867","Total",1634,187,78,109,1447,119,154,304,278,77,241,274
"2011","Wakefield 043A","E01011859","Total",1461,263,163,100,1198,123,234,183,186,95,158,219
"2011","Wakefield 043B","E01011869","Total",1435,259,96,163,1176,142,104,266,252,92,89,231
"2011","Wakefield 043C","E01011870","Total",1407,188,102,86,1219,34,248,238,240,36,94,329
"2011","Wakefield 043D","E01011871","Total",1557,180,59,121,1377,104,136,297,310,93,179,258
"2011","Wakefield 044A","E01011860","Total",1514,159,88,71,1355,59,218,326,250,47,155,300
"2011","Wakefield 044B","E01011861","Total",2017,193,76,117,1824,131,208,504,308,113,238,322
"2011","Wakefield 044C","E01011862","Total",1425,186,77,109,1239,122,118,289,228,94,160,228
"2011","Wakefield 044D","E01011863","Total",1307,222,133,89,1085,121,130,227,206,73,97,231
"2011","Wakefield 045A","E01011864","Total",1642,190,90,100,1452,125,152,305,188,129,226,327
"2011","Wakefield 045B","E01011866","Total",1567,174,90,84,1393,112,176,247,234,142,202,280
"2011","Wakefield 045C","E01011868","Total",1883,264,101,163,1619,151,164,415,302,136,197,254
"2011","Wakefield 045D","E01011872","Total",1550,156,75,81,1394,153,150,303,214,113,149,312
"2011","Derby 001A","E01013461","Total",1635,194,112,82,1441,33,294,361,294,71,149,239
"2011","Derby 001B","E01013462","Total",1524,174,111,63,1350,45,200,442,210,86,109,258
"2011","Derby 001C","E01013463","Total",1524,117,62,55,1407,54,226,395,224,52,174,282
"2011","Derby 001D","E01013464","Total",1452,177,133,44,1275,35,326,312,158,65,126,253
"2011","Derby 002A","E01013465","Total",1661,188,127,61,1473,27,332,358,162,166,128,300
"2011","Derby 002B","E01013466","Total",1542,154,109,45,1388,35,274,397,236,48,119,279
"2011","Derby 002C","E01013467","Total",1389,162,95,67,1227,56,336,297,166,76,132,164
"2011","Derby 002D","E01013468","Total",1614,192,137,55,1422,30,354,315,198,79,132,314
"2011","Derby 002E","E01013469","Total",1280,333,228,105,947,10,344,128,216,27,50,172
"2011","Derby 003A","E01013574","Total",1355,98,40,58,1257,28,156,328,262,41,155,287
"2011","Derby 003B","E01013575","Total",1404,148,44,104,1256,32,122,352,356,78,103,213
"2011","Derby 003C","E01013576","Total",1461,106,26,80,1355,45,100,404,292,64,143,307
"2011","Derby 003D","E01013577","Total",1583,120,22,98,1463,39,104,471,270,120,196,263
"2011","Derby 003E","E01013578","Total",1383,112,22,90,1271,57,76,418,324,87,114,195
"2011","Derby 003F","E01013579","Total",1456,180,56,124,1276,90,160,347,266,47,160,206
"2011","Derby 003G","E01013580","Total",1448,244,48,196,1204,81,136,327,358,52,85,165
"2011","Derby 004A","E01013530","Total",1530,145,53,92,1385,117,136,353,292,141,163,183
"2011","Derby 004B","E01013531","Total",1415,174,90,84,1241,101,172,315,212,81,113,247
"2011","Derby 004C","E01013532","Total",1491,174,93,81,1317,154,176,283,210,110,147,237
"2011","Derby 004D","E01013581","Total",1556,147,62,85,1409,248,124,352,202,124,158,201
"2011","Derby 005A","E01013526","Total",1610,229,110,119,1381,59,234,361,318,97,119,193
"2011","Derby 005B","E01013527","Total",1474,178,91,87,1296,48,194,343,290,93,139,189
"2011","Derby 005C","E01013528","Total",1600,275,114,161,1325,53,158,351,274,78,129,282
"2011","Derby 005D","E01013529","Total",2285,374,183,191,1911,144,146,483,450,92,168,428
"2011","Derby 006A","E01013505","Total",1508,149,67,82,1359,64,146,353,222,105,150,319
"2011","Derby 006B","E01013506","Total",1592,201,129,72,1391,79,292,212,234,106,171,297
"2011","Derby 006C","E01013513","Total",1292,119,61,58,1173,129,148,192,166,112,184,242
"2011","Derby 006D","E01013534","Total",1654,181,87,94,1473,102,152,406,202,146,167,298
"2011","Derby 006E","E01013582","Total",1556,213,112,101,1343,131,206,352,230,48,120,256
"2011","Derby 007A","E01013533","Total",1645,259,108,151,1386,256,80,366,186,116,167,215
"2011","Derby 007B","E01013535","Total",1615,83,30,53,1532,321,58,292,114,220,270,257
"2011","Derby 007C","E01013536","Total",1571,236,47,189,1335,214,74,300,248,151,135,213
"2011","Derby 007D","E01013537","Total",1632,227,116,111,1405,111,218,301,270,82,167,256
"2011","Derby 007E","E01013538","Total",1458,192,67,125,1266,142,118,229,224,110,167,276
"2011","Derby 008A","E01013522","Total",1734,424,112,312,1310,166,100,214,412,25,55,338
"2011","Derby 008B","E01013523","Total",1541,436,107,329,1105,66,92,162,344,21,95,325
"2011","Derby 008C","E01013524","Total",1213,353,51,302,860,38,52,118,330,10,36,276
"2011","Derby 008D","E01013525","Total",1986,454,86,368,1532,103,96,294,636,85,48,270
"2011","Derby 009A","E01013548","Total",1506,200,128,72,1306,97,168,229,214,98,187,313
"2011","Derby 009B","E01013549","Total",1431,186,120,66,1245,116,176,310,196,79,115,253
"2011","Derby 009C","E01013552","Total",1671,255,156,99,1416,142,178,326,238,132,155,245
"2011","Derby 009D","E01013553","Total",1488,185,108,77,1303,137,184,225,256,97,160,244
"2011","Derby 009E","E01013555","Total",1532,162,97,65,1370,93,128,320,190,95,246,298
"2011","Derby 010A","E01013592","Total",1401,189,83,106,1212,50,206,323,268,62,75,228
"2011","Derby 010B","E01013594","Total",1353,191,115,76,1162,28,334,188,212,49,128,223
"2011","Derby 010C","E01013596","Total",1526,204,107,97,1322,51,304,300,230,61,116,260
"2011","Derby 010D","E01013599","Total",1388,162,100,62,1226,47,266,201,254,49,119,290
"2011","Derby 011A","E01013547","Total",1725,281,59,222,1444,105,84,202,432,47,75,499
"2011","Derby 011B","E01013550","Total",1279,162,63,99,1117,116,102,208,234,100,157,200
"2011","Derby 011C","E01013551","Total",1555,210,41,169,1345,82,40,214,374,31,49,555
"2011","Derby 011D","E01013554","Total",1630,325,70,255,1305,149,72,243,336,26,67,412
"2011","Derby 012A","E01013507","Total",1527,152,74,78,1375,62,196,299,300,67,172,279
"2011","Derby 012B","E01013508","Total",1261,117,64,53,1144,111,130,256,144,91,234,178
"2011","Derby 012C","E01013509","Total",1669,191,81,110,1478,108,192,377,298,117,118,268
"2011","Derby 012D","E01013510","Total",1509,180,93,87,1329,163,154,274,184,137,170,247
"2011","Derby 012E","E01013511","Total",1561,147,87,60,1414,52,268,309,200,89,130,366
"2011","Derby 012F","E01013512","Total",1451,194,58,136,1257,123,162,293,218,102,156,203
"2011","Derby 013A","E01013453","Total",2317,510,78,432,1807,170,70,262,436,68,119,682
"2011","Derby 013B","E01013454","Total",1236,167,53,114,1069,117,62,218,250,72,110,240
"2011","Derby 013C","E01013456","Total",2042,506,125,381,1536,203,76,285,386,76,116,394
"2011","Derby 013D","E01013457","Total",1800,279,64,215,1521,161,86,308,414,71,157,324
"2011","Derby 013E","E01013460","Total",1893,364,39,325,1529,157,54,194,440,31,113,540
"2011","Derby 013F","E01013479","Total",1967,702,69,633,1265,72,30,215,398,21,77,452
"2011","Derby 014A","E01013593","Total",1378,135,77,58,1243,30,254,264,256,73,108,258
"2011","Derby 014B","E01013595","Total",2250,293,108,185,1957,184,186,527,382,194,190,294
"2011","Derby 014C","E01013597","Total",1436,215,130,85,1221,100,206,229,210,73,146,257
"2011","Derby 014D","E01013598","Total",1535,168,77,91,1367,103,168,306,232,69,241,248
"2011","Derby 015A","E01013556","Total",1430,149,65,84,1281,67,202,327,272,49,127,237
"2011","Derby 015B","E01013557","Total",1363,148,110,38,1215,12,354,242,214,68,79,246
"2011","Derby 015C","E01013558","Total",2038,217,111,106,1821,143,296,416,338,129,197,302
"2011","Derby 015D","E01013559","Total",1368,131,61,70,1237,69,222,267,250,37,95,297
"2011","Derby 015E","E01013564","Total",1981,169,85,84,1812,41,274,463,348,102,187,397
"2011","Derby 016A","E01013480","Total",1961,651,144,507,1310,85,82,217,310,79,170,367
"2011","Derby 016B","E01013483","Total",2086,203,39,164,1883,106,80,340,202,228,560,367
"2011","Derby 016C","E01013485","Total",2063,137,34,103,1926,153,52,308,178,306,586,343
"2011","Derby 016D","E01013565","Total",1714,138,27,111,1576,130,74,295,90,262,455,270
"2011","Derby 016E","E01013566","Total",2019,266,88,178,1753,135,50,220,168,322,528,330
"2011","Derby 017A","E01013455","Total",1862,274,84,190,1588,134,152,360,322,94,205,321
"2011","Derby 017B","E01013458","Total",1517,188,87,101,1329,33,154,136,160,107,347,392
"2011","Derby 017C","E01013542","Total",1683,220,92,128,1463,64,188,356,226,139,217,273
"2011","Derby 017D","E01013546","Total",1673,147,83,64,1526,39,218,326,230,179,227,307
"2011","Derby 018A","E01013481","Total",1885,166,39,127,1719,147,44,222,132,193,637,344
"2011","Derby 018C","E01013484","Total",1956,226,68,158,1730,159,76,311,162,277,493,252
"2011","Derby 018D","E01013486","Total",1962,135,30,105,1827,91,38,254,122,284,700,338
"2011","Derby 018E","E01013487","Total",2254,236,42,194,2018,205,44,396,188,285,620,280
"2011","Derby 018F","E01033166","Total",971,356,61,295,615,45,40,163,202,26,72,67
"2011","Derby 018G","E01033167","Total",1136,364,107,257,772,76,52,127,178,63,113,163
"2011","Derby 019A","E01013540","Total",1558,178,98,80,1380,48,186,340,242,79,167,318
"2011","Derby 019B","E01013560","Total",1509,120,67,53,1389,36,158,323,278,79,166,349
"2011","Derby 019C","E01013561","Total",1533,185,120,65,1348,33,284,325,296,62,96,252
"2011","Derby 019D","E01013562","Total",1327,335,221,114,992,30,264,191,220,47,75,165
"2011","Derby 019E","E01013563","Total",1358,204,78,126,1154,30,154,244,298,40,137,251
"2011","Derby 020A","E01013459","Total",1966,110,47,63,1856,105,132,296,148,207,635,333
"2011","Derby 020B","E01013567","Total",2018,158,37,121,1860,165,50,288,134,316,512,395
"2011","Derby 020C","E01013568","Total",2065,240,68,172,1825,204,110,259,190,224,538,300
"2011","Derby 020D","E01013569","Total",1581,146,66,80,1435,103,112,259,108,205,349,299
"2011","Derby 021A","E01013539","Total",2476,63,11,52,2413,62,66,763,214,228,575,505
"2011","Derby 021B","E01013541","Total",1625,165,28,137,1460,209,68,464,264,123,177,155
"2011","Derby 021C","E01013543","Total",1785,98,52,46,1687,51,144,493,244,155,270,330
"2011","Derby 021D","E01013544","Total",1844,118,46,72,1726,38,196,483,238,89,302,380
"2011","Derby 021E","E01013545","Total",1627,242,102,140,1385,108,198,342,216,78,206,237
"2011","Derby 022A","E01013488","Total",1563,118,73,45,1445,32,214,266,166,86,250,431
"2011","Derby 022B","E01013489","Total",1527,163,100,63,1364,38,260,206,184,121,222,333
"2011","Derby 022C","E01013490","Total",1521,128,77,51,1393,58,220,256,186,56,259,358
"2011","Derby 022D","E01013491","Total",1637,159,89,70,1478,57,178,279,154,152,363,295
"2011","Derby 023A","E01013570","Total",1964,198,63,135,1766,170,80,294,176,283,432,331
"2011","Derby 023B","E01013571","Total",1782,175,62,113,1607,212,138,304,192,195,311,255
"2011","Derby 023C","E01013572","Total",1650,242,126,116,1408,51,188,308,186,145,225,305
"2011","Derby 023D","E01013573","Total",2073,246,44,202,1827,299,88,403,236,224,305,272
"2011","Derby 024A","E01013470","Total",1446,180,93,87,1266,98,214,253,222,83,106,290
"2011","Derby 024B","E01013474","Total",1495,286,109,177,1209,75,182,311,248,84,109,200
"2011","Derby 024C","E01013476","Total",1447,262,76,186,1185,63,148,300,386,46,37,205
"2011","Derby 024E","E01033171","Total",1399,201,72,129,1198,109,120,245,394,75,67,188
"2011","Derby 024F","E01033172","Total",1454,304,52,252,1150,158,60,273,360,75,76,148
"2011","Derby 025A","E01013471","Total",1858,264,70,194,1594,212,98,394,324,122,163,281
"2011","Derby 025B","E01013473","Total",1512,231,109,122,1281,163,120,286,232,97,129,254
"2011","Derby 025C","E01013475","Total",1587,130,38,92,1457,166,68,290,192,219,263,259
"2011","Derby 025D","E01013477","Total",1783,233,95,138,1550,128,170,333,294,121,153,351
"2011","Derby 025E","E01013502","Total",1429,204,113,91,1225,124,134,284,198,79,191,215
"2011","Derby 025F","E01013503","Total",1525,152,72,80,1373,108,170,295,216,108,184,292
"2011","Derby 026A","E01013472","Total",2093,393,122,271,1700,280,156,377,258,170,206,253
"2011","Derby 026B","E01013497","Total",1533,179,76,103,1354,203,90,250,216,176,157,262
"2011","Derby 026C","E01013504","Total",1908,186,61,125,1722,214,114,355,242,216,298,283
"2011","Derby 026D","E01013583","Total",1622,129,52,77,1493,180,100,301,214,229,248,221
"2011","Derby 026E","E01013590","Total",1774,190,63,127,1584,278,64,302,150,218,321,251
"2011","Derby 026F","E01013591","Total",2035,243,59,184,1792,308,68,478,282,197,170,289
"2011","Derby 027A","E01013492","Total",1565,128,68,60,1437,28,246,285,174,90,257,357
"2011","Derby 027B","E01013493","Total",1517,216,114,102,1301,93,180,274,188,98,141,327
"2011","Derby 027C","E01013494","Total",1860,241,123,118,1619,163,210,420,270,128,186,242
"2011","Derby 027D","E01013495","Total",1766,191,81,110,1575,112,184,390,262,118,203,306
"2011","Derby 028A","E01013496","Total",1545,219,79,140,1326,210,120,303,210,199,136,148
"2011","Derby 028B","E01013498","Total",1439,141,80,61,1298,52,208,281,206,96,156,299
"2011","Derby 028C","E01013499","Total",1384,249,142,107,1135,59,188,248,190,67,155,228
"2011","Derby 028D","E01013500","Total",1690,181,103,78,1509,100,312,284,260,76,140,337
"2011","Derby 028E","E01013501","Total",1366,193,128,65,1173,42,202,278,252,20,108,271
"2011","Derby 029A","E01013584","Total",1870,141,32,109,1729,246,78,380,150,222,388,265
"2011","Derby 029B","E01013585","Total",1751,199,75,124,1552,161,74,372,192,205,259,289
"2011","Derby 029C","E01013586","Total",1514,175,40,135,1339,285,56,344,204,111,168,171
"2011","Derby 029D","E01013587","Total",1528,154,57,97,1374,95,132,255,198,105,264,325
"2011","Derby 029E","E01013588","Total",1532,242,94,148,1290,117,150,232,192,170,207,222
"2011","Derby 029F","E01013589","Total",1423,131,52,79,1292,37,156,274,204,73,182,366
"2011","Derby 030B","E01013517","Total",1389,236,131,105,1153,53,282,195,240,85,75,223
"2011","Derby 030C","E01013518","Total",1355,155,85,70,1200,44,222,257,218,56,131,272
"2011","Derby 030D","E01013521","Total",1346,346,169,177,1000,76,150,210,190,57,138,179
"2011","Derby 030E","E01033168","Total",1331,79,29,50,1252,81,134,434,212,103,125,163
"2011","Derby 030F","E01033169","Total",1774,53,3,50,1721,90,30,822,216,168,229,166
"2011","Derby 030G","E01033170","Total",1232,199,72,127,1033,66,148,366,214,43,98,98
"2011","Derby 031A","E01013514","Total",1632,188,99,89,1444,104,178,328,256,95,151,332
"2011","Derby 031B","E01013515","Total",1839,225,135,90,1614,136,130,483,198,85,257,325
"2011","Derby 031C","E01013519","Total",1648,101,16,85,1547,192,52,568,222,143,189,181
"2011","Derby 031D","E01013520","Total",1532,162,89,73,1370,58,202,368,266,60,147,269
"2011","Leicester 001A","E01013615","Total",1526,82,20,62,1444,49,48,418,278,58,267,326
"2011","Leicester 001B","E01013616","Total",1564,204,26,178,1360,177,78,357,334,85,148,181
"2011","Leicester 001C","E01013618","Total",1564,237,69,168,1327,138,90,304,264,66,155,310
"2011","Leicester 001D","E01013619","Total",1744,178,36,142,1566,235,80,279,178,163,373,258
"2011","Leicester 002A","E01013733","Total",1606,155,30,125,1451,132,78,426,248,153,179,235
"2011","Leicester 002B","E01013734","Total",1484,119,73,46,1365,18,138,189,156,91,263,510
"2011","Leicester 002C","E01013735","Total",1328,95,59,36,1233,14,120,154,124,36,252,533
"2011","Leicester 002D","E01013736","Total",1708,220,84,136,1488,60,198,358,244,124,188,316
"2011","Leicester 002E","E01013737","Total",1437,65,30,35,1372,51,86,251,140,58,319,467
"2011","Leicester 003A","E01013600","Total",1921,233,96,137,1688,284,142,298,174,181,288,321
"2011","Leicester 003B","E01013601","Total",1684,207,98,109,1477,140,94,217,160,223,302,341
"2011","Leicester 003C","E01013602","Total",1774,283,79,204,1491,236,112,340,264,85,185,269
"2011","Leicester 003D","E01013603","Total",1712,331,77,254,1381,246,130,279,210,82,228,206
"2011","Leicester 003E","E01013604","Total",1629,201,88,113,1428,178,112,319,162,115,257,285
"2011","Leicester 003F","E01013605","Total",1774,209,60,149,1565,173,124,315,220,100,286,347
"2011","Leicester 004A","E01013617","Total",2504,231,32,199,2273,138,62,587,414,159,428,485
"2011","Leicester 004B","E01013620","Total",1812,212,35,177,1600,330,64,328,164,187,290,237
"2011","Leicester 004C","E01013621","Total",1891,276,50,226,1615,287,56,334,166,201,331,240
"2011","Leicester 004D","E01013622","Total",1617,312,50,262,1305,205,78,280,188,156,190,208
"2011","Leicester 004E","E01013623","Total",2160,169,31,138,1991,110,126,464,366,140,318,467
"2011","Leicester 005A","E01013732","Total",2107,155,55,100,1952,91,150,457,238,211,363,442
"2011","Leicester 005B","E01013739","Total",1460,166,87,79,1294,58,144,193,140,97,245,417
"2011","Leicester 005C","E01013740","Total",1513,83,47,36,1430,34,140,205,136,65,337,513
"2011","Leicester 005D","E01013741","Total",1675,95,53,42,1580,61,90,239,108,101,476,505
"2011","Leicester 006A","E01013625","Total",1790,205,60,145,1585,68,116,312,174,51,312,552
"2011","Leicester 006B","E01013628","Total",1479,255,83,172,1224,85,100,224,208,100,221,286
"2011","Leicester 006C","E01013715","Total",1314,90,49,41,1224,19,110,167,100,38,334,456
"2011","Leicester 006D","E01013716","Total",1812,97,50,47,1715,38,112,278,130,74,492,591
"2011","Leicester 006E","E01013738","Total",1548,80,52,28,1468,40,160,133,118,89,399,529
"2011","Leicester 007A","E01013624","Total",1464,116,63,53,1348,87,106,191,128,139,310,387
"2011","Leicester 007B","E01013626","Total",1844,103,42,61,1741,66,74,360,132,133,471,505
"2011","Leicester 007C","E01013627","Total",1301,74,35,39,1227,17,86,153,100,48,313,510
"2011","Leicester 007D","E01013629","Total",1715,87,40,47,1628,95,66,221,126,110,438,572
"2011","Leicester 007E","E01013630","Total",1825,84,33,51,1741,96,86,362,132,150,390,525
"2011","Leicester 008A","E01013606","Total",1744,189,96,93,1555,83,240,297,186,95,263,391
"2011","Leicester 008B","E01013607","Total",2573,419,78,341,2154,88,128,414,498,83,347,596
"2011","Leicester 008C","E01013680","Total",2088,213,73,140,1875,106,140,440,352,103,317,417
"2011","Leicester 008D","E01013685","Total",1476,159,69,90,1317,54,186,342,238,51,139,307
"2011","Leicester 008E","E01013686","Total",1850,160,99,61,1690,56,210,321,256,64,315,468
"2011","Leicester 009A","E01013696","Total",2442,143,45,98,2299,169,130,628,246,190,490,446
"2011","Leicester 009B","E01013697","Total",2544,251,98,153,2293,130,134,495,304,177,534,519
"2011","Leicester 009C","E01013699","Total",1709,182,97,85,1527,51,156,269,192,78,310,471
"2011","Leicester 009E","E01032862","Total",2010,133,8,125,1877,189,14,593,286,251,309,235
"2011","Leicester 009F","E01032863","Total",1708,132,5,127,1576,122,28,439,304,141,273,269
"2011","Leicester 009G","E01032865","Total",2120,105,12,93,2015,88,32,660,244,101,477,413
"2011","Leicester 010A","E01013713","Total",1543,97,51,46,1446,40,88,193,108,37,439,541
"2011","Leicester 010B","E01013714","Total",1724,72,47,25,1652,29,120,183,62,91,483,684
"2011","Leicester 010C","E01013717","Total",1569,83,29,54,1486,83,72,299,124,131,397,380
"2011","Leicester 010D","E01013718","Total",1587,153,73,80,1434,74,84,199,148,84,385,460
"2011","Leicester 010E","E01013719","Total",1562,65,28,37,1497,23,98,189,114,96,435,542
"2011","Leicester 010F","E01013720","Total",1334,255,154,101,1079,80,180,148,122,39,182,328
"2011","Leicester 011A","E01013651","Total",1716,197,53,144,1519,154,94,378,148,193,288,264
"2011","Leicester 011B","E01013652","Total",1791,120,45,75,1671,208,48,339,154,242,409,271
"2011","Leicester 011C","E01013653","Total",1899,179,77,102,1720,169,108,326,198,162,372,385
"2011","Leicester 011D","E01013655","Total",2003,227,57,170,1776,151,64,394,164,185,394,424
"2011","Leicester 012A","E01013721","Total",1563,207,95,112,1356,68,186,298,234,130,220,220
"2011","Leicester 012B","E01013723","Total",1379,106,52,54,1273,227,92,182,130,142,247,253
"2011","Leicester 012C","E01013725","Total",1400,166,81,85,1234,224,68,303,118,159,191,171
"2011","Leicester 012D","E01013726","Total",1708,421,166,255,1287,314,136,288,208,82,107,152
"2011","Leicester 012E","E01013728","Total",1616,115,50,65,1501,185,86,306,138,217,266,303
"2011","Leicester 013A","E01013694","Total",1647,172,77,95,1475,191,128,441,166,111,202,236
"2011","Leicester 013B","E01013700","Total",1485,197,113,84,1288,77,132,263,194,96,230,296
"2011","Leicester 013C","E01013770","Total",1376,173,101,72,1203,74,172,215,130,99,260,253
"2011","Leicester 013D","E01013771","Total",1588,97,44,53,1491,30,102,288,138,141,331,461
"2011","Leicester 013E","E01013773","Total",1480,181,109,72,1299,66,144,257,128,133,207,364
"2011","Leicester 016A","E01013681","Total",1813,234,43,191,1579,184,40,362,362,72,197,362
"2011","Leicester 016B","E01013682","Total",1787,230,44,186,1557,245,54,343,372,72,191,280
"2011","Leicester 016C","E01013683","Total",2078,355,56,299,1723,197,80,399,516,96,141,294
"2011","Leicester 016D","E01013684","Total",1950,348,77,271,1602,188,42,379,372,46,176,399
"2011","Leicester 017A","E01013654","Total",2168,312,117,195,1856,242,110,350,204,221,420,309
"2011","Leicester 017B","E01013656","Total",1828,78,26,52,1750,40,54,281,108,166,637,464
"2011","Leicester 017C","E01013657","Total",1800,108,38,70,1692,69,58,237,108,287,576,357
"2011","Leicester 017D","E01013658","Total",1870,104,24,80,1766,58,64,373,150,213,497,411
"2011","Leicester 017E","E01013659","Total",2001,110,49,61,1891,44,64,304,114,309,662,394
"2011","Leicester 017F","E01013743","Total",1620,63,21,42,1557,41,56,153,74,124,632,477
"2011","Leicester 017G","E01013745","Total",1674,58,22,36,1616,11,46,140,76,206,702,435
"2011","Leicester 018A","E01013742","Total",1822,60,29,31,1762,35,56,200,64,242,675,490
"2011","Leicester 018B","E01013744","Total",1983,49,23,26,1934,38,74,190,60,233,835,504
"2011","Leicester 018C","E01013746","Total",1857,282,65,217,1575,48,98,265,172,217,424,351
"2011","Leicester 018D","E01013748","Total",1991,223,67,156,1768,47,82,275,178,226,554,406
"2011","Leicester 018E","E01013754","Total",2058,229,91,138,1829,233,86,460,102,425,319,204
"2011","Leicester 018F","E01013755","Total",2216,188,77,111,2028,317,58,550,118,427,348,210
"2011","Leicester 019A","E01013660","Total",1814,196,79,117,1618,114,46,320,170,195,356,417
"2011","Leicester 019B","E01013661","Total",1635,203,54,149,1432,194,76,259,190,129,348,236
"2011","Leicester 019C","E01013664","Total",1830,291,73,218,1539,168,84,375,220,115,277,300
"2011","Leicester 019D","E01013665","Total",1835,159,52,107,1676,84,96,280,154,178,439,445
"2011","Leicester 019E","E01013667","Total",1568,282,136,146,1286,70,156,219,142,123,322,254
"2011","Leicester 019F","E01013668","Total",1548,169,73,96,1379,69,110,332,162,151,294,261
"2011","Leicester 020A","E01013729","Total",1296,147,75,72,1149,95,132,260,236,72,127,227
"2011","Leicester 020B","E01013780","Total",1497,169,77,92,1328,55,138,371,268,47,156,293
"2011","Leicester 020C","E01013783","Total",1554,165,67,98,1389,43,150,340,234,71,232,319
"2011","Leicester 020D","E01013785","Total",1436,111,61,50,1325,10,164,260,220,131,204,336
"2011","Leicester 020E","E01013786","Total",1518,255,75,180,1263,78,110,234,324,83,156,278
"2011","Leicester 021A","E01013662","Total",1792,79,26,53,1713,27,90,245,118,192,568,473
"2011","Leicester 021B","E01013663","Total",1798,66,42,24,1732,48,104,277,102,140,619,442
"2011","Leicester 021C","E01013747","Total",1891,77,42,35,1814,65,80,233,116,269,600,451
"2011","Leicester 021D","E01013749","Total",1616,76,41,35,1540,24,74,233,78,195,566,370
"2011","Leicester 021E","E01013750","Total",1522,70,27,43,1452,30,82,162,62,143,590,383
"2011","Leicester 021F","E01013758","Total",1641,51,26,25,1590,39,82,123,78,217,615,436
"2011","Leicester 022A","E01013751","Total",1884,82,37,45,1802,43,66,264,128,229,649,423
"2011","Leicester 022B","E01013752","Total",1570,83,50,33,1487,32,74,203,66,178,516,418
"2011","Leicester 022C","E01013753","Total",1717,112,28,84,1605,78,48,298,94,247,397,443
"2011","Leicester 022D","E01013760","Total",1888,285,38,247,1603,49,42,186,204,114,387,621
"2011","Leicester 022E","E01013761","Total",2094,142,47,95,1952,176,46,396,98,373,495,368
"2011","Leicester 022F","E01013762","Total",1873,119,33,86,1754,69,70,189,128,206,554,538
"2011","Leicester 023A","E01013774","Total",1749,194,32,162,1555,117,40,205,338,16,134,705
"2011","Leicester 023B","E01013776","Total",1670,336,39,297,1334,66,34,181,270,41,105,637
"2011","Leicester 023C","E01013778","Total",1998,397,55,342,1601,126,42,244,428,86,174,501
"2011","Leicester 023D","E01013779","Total",1928,360,36,324,1568,90,26,255,440,47,87,623
"2011","Leicester 023E","E01013781","Total",1555,366,32,334,1189,57,38,162,356,34,115,427
"2011","Leicester 023F","E01013782","Total",1456,277,109,168,1179,66,82,266,266,60,122,317
"2011","Leicester 023G","E01013784","Total",1342,164,49,115,1178,35,62,157,200,20,137,567
"2011","Leicester 025A","E01013666","Total",1588,131,95,36,1457,21,270,199,154,56,286,471
"2011","Leicester 025B","E01013669","Total",1429,68,52,16,1361,23,184,178,92,73,349,462
"2011","Leicester 025C","E01013670","Total",1757,238,129,109,1519,46,200,239,202,88,309,435
"2011","Leicester 025D","E01013671","Total",1751,127,71,56,1624,53,118,271,170,171,492,349
"2011","Leicester 025E","E01013672","Total",1371,132,95,37,1239,17,220,181,116,43,374,288
"2011","Leicester 026A","E01013631","Total",1548,107,46,61,1441,154,94,348,180,162,270,233
"2011","Leicester 026B","E01013632","Total",1871,273,104,169,1598,256,100,238,158,196,378,272
"2011","Leicester 026C","E01013638","Total",1729,200,95,105,1529,294,78,284,142,222,225,284
"2011","Leicester 026D","E01013640","Total",1950,121,33,88,1829,331,48,401,166,375,281,227
"2011","Leicester 027A","E01013756","Total",1919,183,45,138,1736,83,104,266,216,182,381,504
"2011","Leicester 027B","E01013757","Total",1643,96,55,41,1547,18,112,204,98,174,514,427
"2011","Leicester 027C","E01013759","Total",1956,68,44,24,1888,38,106,189,104,277,684,490
"2011","Leicester 027D","E01013763","Total",2028,353,49,304,1675,84,40,225,250,167,256,653
"2011","Leicester 027E","E01013764","Total",1636,70,37,33,1566,53,74,171,90,106,556,516
"2011","Leicester 027F","E01013765","Total",1673,150,37,113,1523,51,40,197,116,137,339,643
"2011","Leicester 027G","E01013766","Total",1848,96,36,60,1752,26,76,166,74,231,679,500
"2011","Leicester 028A","E01013633","Total",1650,231,88,143,1419,160,108,299,198,162,204,288
"2011","Leicester 028B","E01013634","Total",1533,200,125,75,1333,150,148,277,144,107,171,336
"2011","Leicester 028C","E01013637","Total",1821,290,121,169,1531,188,104,293,210,174,317,245
"2011","Leicester 028D","E01013639","Total",1464,116,34,82,1348,183,52,359,204,173,205,172
"2011","Leicester 028E","E01013641","Total",1609,168,36,132,1441,86,74,232,260,87,239,463
"2011","Leicester 029A","E01013635","Total",1487,164,61,103,1323,38,144,250,206,52,181,452
"2011","Leicester 029B","E01013636","Total",1354,93,37,56,1261,32,152,189,176,31,245,436
"2011","Leicester 029C","E01013775","Total",2155,310,29,281,1845,134,64,394,516,15,141,581
"2011","Leicester 029D","E01013777","Total",1575,238,41,197,1337,146,56,247,416,37,104,331
"2011","Leicester 030A","E01013642","Total",1791,337,52,285,1454,40,116,265,392,45,119,477
"2011","Leicester 030B","E01013643","Total",1844,217,63,154,1627,38,74,267,338,41,122,747
"2011","Leicester 030C","E01013649","Total",1301,322,83,239,979,8,60,135,378,31,47,320
"2011","Leicester 030D","E01013650","Total",1808,197,47,150,1611,50,42,187,432,21,31,848
"2011","Leicester 030E","E01013702","Total",1573,182,77,105,1391,39,132,301,226,80,179,434
"2011","Leicester 030F","E01013710","Total",1389,356,106,250,1033,19,98,266,286,62,127,175
"2011","Leicester 030G","E01013711","Total",1428,359,106,253,1069,26,140,192,252,99,112,248
"2011","Leicester 031A","E01013613","Total",1619,281,48,233,1338,212,80,357,396,34,83,176
"2011","Leicester 031B","E01013614","Total",1552,226,75,151,1326,135,140,302,344,92,89,224
"2011","Leicester 031C","E01013687","Total",1529,298,33,265,1231,156,46,290,332,26,124,257
"2011","Leicester 031D","E01013688","Total",1450,291,71,220,1159,91,62,300,268,44,70,324
"2011","Leicester 032A","E01013703","Total",1285,117,43,74,1168,32,166,287,208,87,97,291
"2011","Leicester 032B","E01013704","Total",1362,198,70,128,1164,40,108,273,272,83,149,239
"2011","Leicester 032C","E01013706","Total",1628,165,79,86,1463,30,168,391,260,112,189,313
"2011","Leicester 032D","E01013707","Total",1598,135,66,69,1463,52,146,469,206,129,209,252
"2011","Leicester 032E","E01013712","Total",1263,212,114,98,1051,14,178,246,196,51,181,185
"2011","Leicester 034A","E01013608","Total",1547,134,66,68,1413,70,180,375,284,82,138,284
"2011","Leicester 034B","E01013609","Total",1560,271,116,155,1289,53,230,295,254,40,105,312
"2011","Leicester 034C","E01013610","Total",1662,271,131,140,1391,115,140,363,260,79,166,268
"2011","Leicester 034D","E01013611","Total",1482,176,67,109,1306,100,150,230,210,134,207,275
"2011","Leicester 034E","E01013612","Total",1486,175,73,102,1311,66,176,307,268,96,115,283
"2011","Leicester 035A","E01013678","Total",1626,161,81,80,1465,149,168,336,202,162,140,308
"2011","Leicester 035B","E01013679","Total",1559,110,37,73,1449,214,62,240,124,238,286,285
"2011","Leicester 035C","E01013691","Total",1659,161,43,118,1498,259,114,229,154,168,335,239
"2011","Leicester 035D","E01013692","Total",1413,111,42,69,1302,202,70,254,108,165,301,202
"2011","Leicester 035E","E01013693","Total",1477,124,56,68,1353,232,94,199,130,132,287,279
"2011","Leicester 036A","E01013673","Total",1517,199,105,94,1318,157,122,288,142,131,221,257
"2011","Leicester 036B","E01013674","Total",1621,330,192,138,1291,168,188,201,216,121,159,238
"2011","Leicester 036C","E01013675","Total",1634,185,95,90,1449,183,138,240,244,132,231,281
"2011","Leicester 036D","E01013676","Total",1971,261,89,172,1710,271,102,405,300,181,250,201
"2011","Leicester 036E","E01013677","Total",1523,231,94,137,1292,171,128,252,226,124,153,238
"2011","Leicester 037A","E01013695","Total",1525,166,96,70,1359,206,142,240,172,130,195,274
"2011","Leicester 037B","E01013698","Total",1537,148,93,55,1389,157,146,277,170,98,202,339
"2011","Leicester 037C","E01013767","Total",1537,139,81,58,1398,97,174,214,128,112,243,430
"2011","Leicester 037D","E01013768","Total",1471,290,159,131,1181,126,246,203,168,72,138,228
"2011","Leicester 037E","E01013772","Total",1601,167,83,84,1434,187,134,314,180,93,277,249
"2011","Leicester 037F","E01032597","Total",1440,258,114,144,1182,177,152,268,170,104,173,138
"2011","Leicester 038A","E01013689","Total",1246,182,42,140,1064,31,40,130,200,36,86,541
"2011","Leicester 038B","E01013690","Total",1540,197,46,151,1343,104,118,270,248,70,139,394
"2011","Leicester 038C","E01013705","Total",1566,240,90,150,1326,76,142,323,184,85,208,308
"2011","Leicester 038D","E01013709","Total",1576,120,66,54,1456,39,184,280,140,99,316,398
"2011","Leicester 038E","E01032599","Total",1579,118,69,49,1461,67,182,350,192,84,245,341
"2011","Leicester 039A","E01013722","Total",1714,143,74,69,1571,202,114,365,138,206,256,290
"2011","Leicester 039B","E01013727","Total",1491,237,84,153,1254,147,98,275,220,107,195,212
"2011","Leicester 039C","E01013730","Total",1569,329,73,256,1240,313,78,323,208,110,75,133
"2011","Leicester 039D","E01013731","Total",1600,170,30,140,1430,203,72,435,256,107,167,190
"2011","Leicester 039E","E01032602","Total",1672,157,64,93,1515,219,102,301,130,197,270,296
"2011","Leicester 040A","E01013646","Total",2108,624,62,562,1484,11,58,152,420,11,166,666
"2011","Leicester 040B","E01013647","Total",1658,581,68,513,1077,70,42,90,272,37,54,512
"2011","Leicester 040C","E01013648","Total",2095,183,26,157,1912,138,30,180,232,47,166,1119
"2011","Leicester 040D","E01032875","Total",1034,181,13,168,853,26,6,37,128,5,33,618
"2011","Leicester 041A","E01032867","Total",1350,466,26,440,884,22,14,150,430,18,41,209
"2011","Leicester 041B","E01032868","Total",1029,198,2,196,831,36,0,68,308,6,15,398
"2011","Leicester 041C","E01032872","Total",1206,445,6,439,761,8,2,81,516,10,8,136
"2011","Leicester 041D","E01032873","Total",1330,604,41,563,726,8,0,74,364,10,9,261
"2011","Nottingham 001A","E01013887","Total",1534,118,58,60,1416,56,290,251,272,45,160,342
"2011","Nottingham 001B","E01013892","Total",1414,128,67,61,1286,44,330,203,198,51,161,299
"2011","Nottingham 001C","E01013893","Total",1349,184,25,159,1165,255,78,264,180,80,164,144
"2011","Nottingham 001D","E01013894","Total",1474,169,72,97,1305,71,250,211,236,58,167,312
"2011","Nottingham 002A","E01013879","Total",1293,194,72,122,1099,229,86,216,190,103,125,150
"2011","Nottingham 002B","E01013880","Total",1490,244,124,120,1246,182,140,250,234,108,141,191
"2011","Nottingham 002C","E01013881","Total",1477,217,99,118,1260,200,102,312,210,94,150,192
"2011","Nottingham 002D","E01013882","Total",1377,214,90,124,1163,198,114,215,220,68,118,230
"2011","Nottingham 002E","E01013885","Total",1662,304,102,202,1358,244,108,282,274,100,182,168
"2011","Nottingham 004A","E01013886","Total",1450,221,73,148,1229,96,134,275,262,47,132,283
"2011","Nottingham 004B","E01013888","Total",1491,260,114,146,1231,80,168,254,242,86,141,260
"2011","Nottingham 004C","E01013889","Total",1646,205,102,103,1441,101,214,302,302,67,182,273
"2011","Nottingham 004D","E01013890","Total",1546,181,52,129,1365,148,140,337,274,78,104,284
"2011","Nottingham 004E","E01013891","Total",1634,273,68,205,1361,166,100,304,222,111,183,275
"2011","Nottingham 005A","E01013875","Total",1371,98,41,57,1273,73,98,324,250,81,163,284
"2011","Nottingham 005B","E01013876","Total",1726,258,84,174,1468,179,116,351,274,105,224,219
"2011","Nottingham 005C","E01013877","Total",1394,318,81,237,1076,283,82,184,144,157,87,139
"2011","Nottingham 005D","E01013878","Total",1296,175,52,123,1121,219,74,195,160,138,170,165
"2011","Nottingham 005E","E01013883","Total",1507,230,67,163,1277,175,118,275,272,53,161,223
"2011","Nottingham 005F","E01013884","Total",1350,252,64,188,1098,216,88,252,226,63,97,156
"2011","Nottingham 006A","E01013853","Total",1435,217,79,138,1218,59,224,282,204,67,166,216
"2011","Nottingham 006B","E01013854","Total",1429,235,63,172,1194,165,104,261,202,87,158,217
"2011","Nottingham 006C","E01013855","Total",1602,171,34,137,1431,337,74,394,200,176,130,120
"2011","Nottingham 006D","E01013856","Total",1597,182,75,107,1415,173,98,346,220,120,210,248
"2011","Nottingham 006F","E01033397","Total",1770,161,24,137,1609,215,70,499,292,91,201,241
"2011","Nottingham 006G","E01033398","Total",1150,330,31,299,820,101,32,240,256,38,62,91
"2011","Nottingham 007A","E01013963","Total",1569,262,113,149,1307,220,108,272,262,72,155,218
"2011","Nottingham 007B","E01013964","Total",1679,153,64,89,1526,137,156,389,284,98,177,285
"2011","Nottingham 007C","E01013965","Total",1483,202,98,104,1281,117,114,241,208,152,157,292
"2011","Nottingham 007D","E01013966","Total",1416,169,52,117,1247,134,78,286,198,99,205,247
"2011","Nottingham 007E","E01013967","Total",1141,149,53,96,992,60,90,231,188,56,144,223
"2011","Nottingham 008A","E01013827","Total",1481,188,74,114,1293,201,64,368,196,99,161,204
"2011","Nottingham 008B","E01013828","Total",1640,296,92,204,1344,144,122,297,356,41,132,252
"2011","Nottingham 008C","E01013834","Total",1600,184,94,90,1416,268,92,296,192,129,193,246
"2011","Nottingham 008D","E01013835","Total",1593,237,85,152,1356,198,124,298,260,93,132,251
"2011","Nottingham 008E","E01013836","Total",1876,322,85,237,1554,255,80,414,364,138,123,180
"2011","Nottingham 009A","E01013829","Total",1625,325,97,228,1300,160,110,313,330,68,139,180
"2011","Nottingham 009B","E01013830","Total",1669,186,83,103,1483,119,206,248,270,107,224,309
"2011","Nottingham 009C","E01013831","Total",1553,184,72,112,1369,65,174,340,290,82,118,300
"2011","Nottingham 009D","E01013832","Total",1572,307,79,228,1265,126,132,224,260,79,182,262
"2011","Nottingham 009E","E01013833","Total",1341,173,59,114,1168,167,80,216,188,90,161,266
"2011","Nottingham 010A","E01013935","Total",1493,284,96,188,1209,55,244,305,292,58,54,201
"2011","Nottingham 010B","E01013968","Total",1249,324,188,136,925,22,194,176,214,43,77,199
"2011","Nottingham 010C","E01013969","Total",1598,328,61,267,1270,78,108,236,404,36,125,283
"2011","Nottingham 010D","E01013970","Total",1554,212,39,173,1342,66,82,391,324,63,162,254
"2011","Nottingham 010E","E01013971","Total",1476,363,74,289,1113,71,60,288,354,47,38,255
"2011","Nottingham 011A","E01013817","Total",1707,156,56,100,1551,432,70,334,162,198,172,183
"2011","Nottingham 011B","E01013818","Total",1774,112,29,83,1662,330,62,250,150,216,443,211
"2011","Nottingham 011C","E01013822","Total",1705,153,44,109,1552,420,58,307,184,156,246,181
"2011","Nottingham 011D","E01013825","Total",1850,154,54,100,1696,264,92,334,232,210,247,317
"2011","Nottingham 011E","E01013826","Total",1947,160,35,125,1787,469,66,412,164,233,267,176
"2011","Nottingham 012A","E01013837","Total",1772,208,58,150,1564,70,134,394,316,132,178,340
"2011","Nottingham 012B","E01013838","Total",1587,182,64,118,1405,66,158,326,310,146,170,229
"2011","Nottingham 012C","E01013839","Total",1747,373,84,289,1374,203,60,337,346,117,122,189
"2011","Nottingham 012D","E01013840","Total",2195,348,50,298,1847,148,94,441,480,150,205,329
"2011","Nottingham 012E","E01013841","Total",1580,243,31,212,1337,177,48,314,310,129,156,203
"2011","Nottingham 013A","E01013819","Total",1720,263,97,166,1457,250,120,310,198,167,212,200
"2011","Nottingham 013B","E01013820","Total",1781,140,46,94,1641,340,64,432,198,154,219,234
"2011","Nottingham 013C","E01013821","Total",1679,144,32,112,1535,355,84,354,160,131,227,224
"2011","Nottingham 013D","E01013823","Total",1853,146,52,94,1707,233,90,389,182,190,341,282
"2011","Nottingham 013E","E01013824","Total",1606,120,42,78,1486,317,76,355,202,195,112,229
"2011","Nottingham 014A","E01013864","Total",1524,268,30,238,1256,309,50,391,214,67,113,112
"2011","Nottingham 014B","E01013865","Total",1552,344,179,165,1208,179,156,206,184,110,169,204
"2011","Nottingham 014C","E01013866","Total",1482,215,98,117,1267,120,150,255,146,85,246,265
"2011","Nottingham 014D","E01013867","Total",1581,132,47,85,1449,240,92,310,198,162,227,220
"2011","Nottingham 015A","E01013937","Total",1690,230,51,179,1460,82,162,328,376,114,143,255
"2011","Nottingham 015B","E01013938","Total",1533,292,84,208,1241,31,112,282,292,88,215,221
"2011","Nottingham 015C","E01013941","Total",1473,415,95,320,1058,42,94,200,428,31,51,212
"2011","Nottingham 015D","E01013943","Total",1561,408,33,375,1153,58,50,176,372,57,80,360
"2011","Nottingham 015E","E01013972","Total",1424,290,62,228,1134,85,62,251,330,44,105,257
"2011","Nottingham 016A","E01013936","Total",2150,367,67,300,1783,164,142,383,620,61,154,259
"2011","Nottingham 016B","E01013939","Total",1524,316,89,227,1208,83,142,231,340,44,138,230
"2011","Nottingham 016C","E01013940","Total",1726,271,35,236,1455,275,62,304,296,127,208,183
"2011","Nottingham 016D","E01013942","Total",2083,400,91,309,1683,241,102,343,312,207,218,260
"2011","Nottingham 017A","E01013843","Total",1419,304,63,241,1115,38,62,148,278,97,154,338
"2011","Nottingham 017B","E01013844","Total",1473,240,49,191,1233,80,24,223,266,137,208,295
"2011","Nottingham 017C","E01013845","Total",1688,163,33,130,1525,62,46,326,256,286,289,260
"2011","Nottingham 017D","E01013847","Total",1373,112,31,81,1261,43,34,61,150,86,464,423
"2011","Nottingham 018A","E01013810","Total",1657,186,45,141,1471,129,52,325,198,206,309,252
"2011","Nottingham 018B","E01013811","Total",1455,253,35,218,1202,83,36,149,150,169,206,409
"2011","Nottingham 018C","E01013812","Total",1618,161,18,143,1457,169,52,210,154,139,369,364
"2011","Nottingham 018D","E01013842","Total",1673,197,33,164,1476,135,40,252,264,208,290,287
"2011","Nottingham 018E","E01013846","Total",1723,295,64,231,1428,55,30,157,232,188,334,432
"2011","Nottingham 019A","E01013930","Total",1980,214,41,173,1766,125,110,334,248,255,423,271
"2011","Nottingham 019B","E01013931","Total",1690,176,125,51,1514,31,254,172,128,178,409,342
"2011","Nottingham 019C","E01013932","Total",1744,183,99,84,1561,53,204,184,188,227,362,343
"2011","Nottingham 019D","E01013933","Total",1840,277,83,194,1563,251,100,319,224,134,268,267
"2011","Nottingham 019E","E01013934","Total",1531,227,128,99,1304,74,142,242,190,77,226,353
"2011","Nottingham 020A","E01013859","Total",1454,315,172,143,1139,48,200,208,246,77,114,246
"2011","Nottingham 020B","E01013861","Total",1520,313,183,130,1207,121,224,166,198,110,217,171
"2011","Nottingham 020C","E01013868","Total",1530,237,111,126,1293,156,154,159,126,187,272,239
"2011","Nottingham 020D","E01013929","Total",1812,239,113,126,1573,108,164,259,252,112,355,323
"2011","Nottingham 021A","E01013954","Total",1339,223,54,169,1116,176,74,166,220,93,191,196
"2011","Nottingham 021B","E01013959","Total",1834,341,91,250,1493,280,118,310,216,153,179,237
"2011","Nottingham 021C","E01013960","Total",1569,387,83,304,1182,203,70,293,148,74,176,218
"2011","Nottingham 021D","E01013962","Total",1808,357,90,267,1451,226,116,298,274,68,164,305
"2011","Nottingham 022A","E01013813","Total",1505,430,55,375,1075,85,32,129,192,45,61,531
"2011","Nottingham 022B","E01013814","Total",1828,383,15,368,1445,40,8,50,464,53,104,726
"2011","Nottingham 022C","E01013815","Total",1559,285,18,267,1274,29,14,40,250,50,91,800
"2011","Nottingham 022D","E01013816","Total",1979,381,53,328,1598,39,46,73,528,86,97,729
"2011","Nottingham 023C","E01013958","Total",1806,342,101,241,1464,258,94,273,274,122,199,244
"2011","Nottingham 023D","E01013961","Total",2283,290,64,226,1993,144,56,154,270,150,123,1096
"2011","Nottingham 023E","E01033399","Total",1059,310,43,267,749,70,26,84,210,57,52,250
"2011","Nottingham 023F","E01033401","Total",1021,243,8,235,778,50,14,76,416,6,47,169
"2011","Nottingham 023G","E01033405","Total",1026,455,20,435,571,36,18,37,372,0,5,103
"2011","Nottingham 023H","E01033409","Total",909,432,34,398,477,14,36,12,228,0,17,170
"2011","Nottingham 023I","E01033411","Total",1066,332,101,231,734,117,40,147,104,103,63,160
"2011","Nottingham 024A","E01013913","Total",1762,193,85,108,1569,77,182,280,230,114,315,371
"2011","Nottingham 024B","E01013914","Total",1738,140,64,76,1598,62,186,264,210,171,373,332
"2011","Nottingham 024C","E01013915","Total",1560,216,113,103,1344,88,230,230,168,110,247,271
"2011","Nottingham 024D","E01013916","Total",1503,185,60,125,1318,227,98,283,200,110,211,189
"2011","Nottingham 024E","E01013917","Total",1752,288,62,226,1464,146,80,365,294,100,237,242
"2011","Nottingham 025A","E01013858","Total",1457,176,77,99,1281,107,158,278,178,120,233,207
"2011","Nottingham 025B","E01013860","Total",1577,273,182,91,1304,110,182,236,204,137,161,274
"2011","Nottingham 025C","E01013862","Total",1573,231,103,128,1342,168,94,250,150,194,245,241
"2011","Nottingham 025D","E01013863","Total",1464,189,96,93,1275,97,138,256,246,91,199,248
"2011","Nottingham 026A","E01013944","Total",1728,215,79,136,1513,55,112,263,182,228,325,348
"2011","Nottingham 026B","E01013945","Total",1558,217,38,179,1341,123,34,193,212,165,241,373
"2011","Nottingham 026D","E01013947","Total",1928,272,55,217,1656,109,38,290,284,124,258,553
"2011","Nottingham 026E","E01013948","Total",1281,500,52,448,781,110,8,142,176,69,106,170
"2011","Nottingham 026F","E01013953","Total",1728,109,25,84,1619,25,6,84,186,28,57,1233
"2011","Nottingham 026G","E01033395","Total",1138,274,3,271,864,43,6,43,240,10,25,497
"2011","Nottingham 026H","E01033396","Total",1097,267,62,205,830,101,30,131,188,53,49,278
"2011","Nottingham 027A","E01013977","Total",1879,210,102,108,1669,45,222,441,282,139,193,347
"2011","Nottingham 027B","E01013978","Total",1682,189,106,83,1493,58,134,380,246,136,232,307
"2011","Nottingham 027C","E01013979","Total",1600,131,63,68,1469,41,152,462,228,101,226,259
"2011","Nottingham 027D","E01013981","Total",1672,148,80,68,1524,49,172,297,300,112,269,325
"2011","Nottingham 028E","E01032520","Total",2092,378,64,314,1714,12,130,196,804,37,61,474
"2011","Nottingham 028F","E01032522","Total",2012,403,60,343,1609,19,100,191,668,46,45,540
"2011","Nottingham 028G","E01033404","Total",3855,435,63,372,3420,48,44,84,380,49,175,2640
"2011","Nottingham 029A","E01013918","Total",1932,255,52,203,1677,141,56,351,314,203,255,357
"2011","Nottingham 029B","E01013919","Total",2039,285,33,252,1754,150,64,273,378,138,352,399
"2011","Nottingham 029C","E01013920","Total",2226,670,127,543,1556,184,122,293,358,143,125,331
"2011","Nottingham 029D","E01013921","Total",2199,342,86,256,1857,225,46,312,284,382,304,304
"2011","Nottingham 029E","E01013957","Total",1552,214,44,170,1338,191,64,310,214,115,207,237
"2011","Nottingham 030A","E01013980","Total",1629,165,92,73,1464,33,214,390,276,101,197,253
"2011","Nottingham 030B","E01013982","Total",1591,145,98,47,1446,33,236,328,222,118,232,277
"2011","Nottingham 030C","E01013983","Total",1419,359,114,245,1060,137,130,197,206,51,132,207
"2011","Nottingham 030D","E01013984","Total",1459,180,138,42,1279,27,342,225,184,92,159,250
"2011","Nottingham 030E","E01013985","Total",1798,214,134,80,1584,36,312,385,170,87,238,356
"2011","Nottingham 031C","E01013924","Total",1648,435,73,362,1213,27,22,52,110,0,26,976
"2011","Nottingham 031E","E01013926","Total",1661,217,46,171,1444,63,36,102,224,66,116,837
"2011","Nottingham 031G","E01013928","Total",1568,115,22,93,1453,19,30,175,226,55,63,885
"2011","Nottingham 031H","E01033408","Total",3157,324,56,268,2833,37,96,112,202,62,166,2158
"2011","Nottingham 031I","E01033410","Total",2657,205,63,142,2452,22,64,92,212,80,71,1911
"2011","Nottingham 032A","E01013973","Total",776,190,54,136,586,71,34,157,138,20,50,116
"2011","Nottingham 032B","E01013974","Total",1549,246,132,114,1303,18,200,165,186,71,115,548
"2011","Nottingham 032C","E01013975","Total",1099,126,65,61,973,23,130,171,132,40,174,303
"2011","Nottingham 032D","E01013976","Total",1614,185,38,147,1429,162,62,381,322,113,118,271
"2011","Nottingham 034A","E01013895","Total",1507,155,115,40,1352,32,294,257,204,94,130,341
"2011","Nottingham 034B","E01013896","Total",1268,249,71,178,1019,124,120,185,164,90,145,191
"2011","Nottingham 034C","E01013901","Total",1458,194,65,129,1264,51,150,332,304,64,134,229
"2011","Nottingham 034D","E01013902","Total",1463,205,108,97,1258,28,212,320,322,36,109,231
"2011","Nottingham 035A","E01013897","Total",1432,223,106,117,1209,109,174,181,220,51,214,260
"2011","Nottingham 035B","E01013898","Total",989,162,85,77,827,46,70,141,150,56,141,223
"2011","Nottingham 035C","E01013899","Total",1271,120,63,57,1151,134,88,175,182,113,158,301
"2011","Nottingham 035D","E01013900","Total",1473,245,80,165,1228,102,124,237,266,131,127,241
"2011","Nottingham 035E","E01013903","Total",1249,107,62,45,1142,55,160,171,174,81,179,322
"2011","Nottingham 035F","E01013907","Total",1467,378,198,180,1089,122,156,205,174,79,143,210
"2011","Nottingham 036A","E01013905","Total",1548,187,96,91,1361,107,114,302,234,117,235,252
"2011","Nottingham 036B","E01013908","Total",1685,286,200,86,1399,164,272,334,152,92,153,232
"2011","Nottingham 036C","E01013909","Total",1529,366,130,236,1163,175,150,217,230,64,101,226
"2011","Nottingham 036D","E01013912","Total",1572,177,86,91,1395,75,176,254,276,76,129,409
"2011","Nottingham 037A","E01013904","Total",1550,174,101,73,1376,146,156,231,206,124,246,267
"2011","Nottingham 037B","E01013906","Total",1611,226,113,113,1385,125,140,301,216,97,159,347
"2011","Nottingham 037C","E01013910","Total",1456,207,112,95,1249,115,146,265,186,124,113,300
"2011","Nottingham 037D","E01013911","Total",1520,252,122,130,1268,110,202,270,218,71,177,220
"2011","Nottingham 038A","E01013849","Total",1541,262,103,159,1279,261,96,244,206,123,129,220
"2011","Nottingham 038B","E01013850","Total",1462,316,114,202,1146,135,202,143,170,93,199,204
"2011","Nottingham 038C","E01013851","Total",1571,348,126,222,1223,268,100,212,234,62,142,205
"2011","Nottingham 038D","E01013852","Total",1550,323,125,198,1227,94,200,256,242,92,88,255
"2011","Nottingham 038E","E01032621","Total",1540,253,91,162,1287,99,226,208,196,91,155,312
"2011","Nottingham 039A","E01013874","Total",1470,258,47,211,1212,76,66,203,342,59,105,361
"2011","Nottingham 039B","E01033400","Total",1309,234,35,199,1075,122,34,149,310,94,145,221
"2011","Nottingham 039C","E01033402","Total",1015,328,2,326,687,2,4,58,470,5,8,140
"2011","Nottingham 039D","E01033403","Total",1052,334,14,320,718,36,10,66,440,20,42,104
"2011","Nottingham 039E","E01033406","Total",1049,277,1,276,772,6,0,14,500,0,31,221
"2011","Nottingham 039F","E01033407","Total",1070,309,15,294,761,10,20,48,496,16,0,171
"2011","Nottingham 040A","E01013870","Total",2018,476,115,361,1542,169,82,281,464,106,199,241
"2011","Nottingham 040B","E01013871","Total",1711,437,174,263,1274,178,112,258,182,129,199,216
"2011","Nottingham 040C","E01013872","Total",1798,360,86,274,1438,120,82,290,260,143,248,295
"2011","Nottingham 040D","E01013873","Total",1676,158,22,136,1518,170,44,181,270,112,290,451
"2011","Rutland 001A","E01013788","Total",2447,231,117,114,2216,74,352,729,428,171,185,277
"2011","Rutland 001B","E01013789","Total",1367,146,72,74,1221,39,244,203,296,90,142,207
"2011","Rutland 001C","E01013790","Total",1201,106,51,55,1095,25,194,220,228,68,100,260
"2011","Rutland 001D","E01013796","Total",1360,130,68,62,1230,37,194,399,228,98,102,172
"2011","Rutland 002A","E01013793","Total",1371,163,78,85,1208,60,314,261,230,80,114,149
"2011","Rutland 002B","E01013800","Total",1536,175,92,83,1361,49,262,265,230,108,133,314
"2011","Rutland 002C","E01013801","Total",1633,254,112,142,1379,109,166,298,256,148,131,271
"2011","Rutland 002D","E01013809","Total",1253,102,50,52,1151,37,254,243,238,58,109,212
"2011","Rutland 003A","E01013798","Total",1424,122,53,69,1302,71,174,349,254,79,116,259
"2011","Rutland 003B","E01013799","Total",1276,298,132,166,978,92,102,240,248,73,85,138
"2011","Rutland 003C","E01013802","Total",2511,359,213,146,2152,81,578,486,412,112,166,317
"2011","Rutland 003D","E01013803","Total",2259,261,162,99,1998,107,400,421,350,177,166,377
"2011","Rutland 004A","E01013791","Total",1100,146,97,49,954,52,220,235,152,66,75,154
"2011","Rutland 004B","E01013792","Total",1638,158,91,67,1480,53,300,393,260,96,141,237
"2011","Rutland 004C","E01013797","Total",1675,179,94,85,1496,48,254,456,338,70,106,224
"2011","Rutland 004D","E01013804","Total",1544,168,81,87,1376,66,234,288,260,69,123,336
"2011","Rutland 004E","E01013805","Total",1283,128,79,49,1155,58,176,284,236,85,110,206
"2011","Rutland 005A","E01013787","Total",1269,151,79,72,1118,40,200,212,224,94,190,158
"2011","Rutland 005B","E01013794","Total",1274,122,55,67,1152,26,274,258,276,57,89,172
"2011","Rutland 005C","E01013795","Total",1068,122,77,45,946,23,240,161,222,52,66,182
"2011","Rutland 005D","E01013806","Total",1078,164,76,88,914,37,152,231,208,35,106,145
"2011","Rutland 005E","E01013807","Total",1387,207,98,109,1180,94,218,294,226,74,125,149
"2011","Rutland 005F","E01013808","Total",1298,219,115,104,1079,94,192,289,232,35,75,162
"2011","Amber Valley 001A","E01019400","Total",1590,166,61,105,1424,114,174,270,328,127,179,232
"2011","Amber Valley 001B","E01019401","Total",1588,317,154,163,1271,87,182,252,246,59,154,291
"2011","Amber Valley 001C","E01019402","Total",1580,145,59,86,1435,79,148,353,330,107,111,307
"2011","Amber Valley 001D","E01019404","Total",1602,271,127,144,1331,76,222,275,312,52,114,280
"2011","Amber Valley 002A","E01019406","Total",1025,143,82,61,882,40,204,157,228,30,103,120
"2011","Amber Valley 002B","E01019423","Total",1209,163,72,91,1046,26,214,273,242,32,74,185
"2011","Amber Valley 002C","E01019424","Total",1181,134,80,54,1047,38,174,219,236,69,112,199
"2011","Amber Valley 002D","E01019477","Total",2177,289,165,124,1888,68,408,370,456,100,142,344
"2011","Amber Valley 003A","E01019403","Total",1459,259,133,126,1200,113,184,247,200,77,199,180
"2011","Amber Valley 003B","E01019444","Total",1331,205,77,128,1126,199,104,245,210,103,111,154
"2011","Amber Valley 003C","E01019468","Total",1538,172,71,101,1366,83,148,289,326,111,158,251
"2011","Amber Valley 003D","E01019469","Total",1654,153,57,96,1501,168,106,394,274,170,163,226
"2011","Amber Valley 003E","E01019471","Total",1405,248,99,149,1157,131,96,260,246,103,134,187
"2011","Amber Valley 004A","E01019443","Total",1519,212,134,78,1307,54,290,270,296,46,87,264
"2011","Amber Valley 004B","E01019470","Total",1658,183,67,116,1475,81,150,356,362,96,132,298
"2011","Amber Valley 004C","E01019473","Total",1317,91,51,40,1226,31,128,327,306,15,115,304
"2011","Amber Valley 004D","E01019474","Total",1193,120,37,83,1073,26,144,291,280,21,96,215
"2011","Amber Valley 004E","E01019475","Total",1176,173,79,94,1003,51,148,252,190,36,84,242
"2011","Amber Valley 004F","E01019476","Total",1366,201,126,75,1165,17,284,234,252,26,129,223
"2011","Amber Valley 005A","E01019420","Total",1292,206,76,130,1086,61,150,208,240,66,105,256
"2011","Amber Valley 005B","E01019442","Total",1537,155,49,106,1382,52,166,273,360,75,154,302
"2011","Amber Valley 005C","E01019445","Total",1400,212,59,153,1188,61,118,298,302,45,100,264
"2011","Amber Valley 005D","E01019455","Total",1323,218,76,142,1105,54,126,249,310,61,102,203
"2011","Amber Valley 005E","E01019456","Total",1774,220,69,151,1554,96,154,385,348,116,199,256
"2011","Amber Valley 005F","E01019457","Total",1335,118,67,51,1217,55,194,253,228,57,172,258
"2011","Amber Valley 006A","E01019429","Total",1590,190,88,102,1400,35,242,303,318,48,144,310
"2011","Amber Valley 006B","E01019454","Total",1422,163,93,70,1259,32,288,271,260,41,115,252
"2011","Amber Valley 006C","E01019460","Total",1625,153,62,91,1472,57,160,395,304,73,153,330
"2011","Amber Valley 006D","E01019461","Total",1410,235,151,84,1175,44,190,248,256,72,105,260
"2011","Amber Valley 006E","E01019462","Total",1213,131,77,54,1082,20,248,241,254,47,57,215
"2011","Amber Valley 007A","E01019405","Total",1419,114,67,47,1305,11,334,230,244,41,190,255
"2011","Amber Valley 007B","E01019414","Total",1594,161,100,61,1433,21,308,299,346,30,137,292
"2011","Amber Valley 007C","E01019428","Total",1465,160,81,79,1305,60,230,282,266,80,152,235
"2011","Amber Valley 007D","E01019430","Total",1926,169,101,68,1757,61,246,460,414,60,179,337
"2011","Amber Valley 008A","E01019421","Total",1928,200,97,103,1728,66,268,375,336,58,180,445
"2011","Amber Valley 008B","E01019422","Total",1553,158,82,76,1395,58,250,293,260,66,154,314
"2011","Amber Valley 008C","E01019432","Total",1979,198,121,77,1781,76,342,385,376,91,188,323
"2011","Amber Valley 008D","E01019458","Total",1538,230,78,152,1308,106,132,345,336,31,109,249
"2011","Amber Valley 008E","E01019459","Total",1368,197,91,106,1171,104,154,217,186,78,158,274
"2011","Amber Valley 008F","E01019463","Total",1544,200,99,101,1344,157,142,271,166,139,177,292
"2011","Amber Valley 009A","E01019408","Total",1500,162,64,98,1338,75,186,352,274,71,112,268
"2011","Amber Valley 009B","E01019409","Total",1744,166,91,75,1578,65,334,380,302,75,113,309
"2011","Amber Valley 009C","E01019412","Total",1570,96,29,67,1474,39,110,500,250,109,171,295
"2011","Amber Valley 009D","E01019413","Total",1423,124,24,100,1299,80,88,509,210,51,201,160
"2011","Amber Valley 009E","E01019416","Total",1433,176,97,79,1257,26,280,254,252,77,119,249
"2011","Amber Valley 010A","E01019407","Total",2020,416,126,290,1604,90,208,404,448,68,152,234
"2011","Amber Valley 010B","E01019415","Total",1742,264,115,149,1478,89,208,386,364,82,120,229
"2011","Amber Valley 010C","E01019417","Total",1933,344,165,179,1589,171,214,324,338,92,165,285
"2011","Amber Valley 010D","E01019419","Total",1878,295,97,198,1583,83,244,394,492,27,120,223
"2011","Amber Valley 011A","E01019410","Total",1469,161,61,100,1308,58,122,366,324,55,105,278
"2011","Amber Valley 011B","E01019411","Total",1516,189,90,99,1327,55,176,315,248,94,169,270
"2011","Amber Valley 011C","E01019418","Total",1777,153,57,96,1624,82,188,488,280,111,171,304
"2011","Amber Valley 011D","E01019447","Total",1482,173,94,79,1309,51,272,287,284,70,144,201
"2011","Amber Valley 011E","E01019449","Total",1744,231,88,143,1513,73,202,350,388,78,153,269
"2011","Amber Valley 012A","E01019431","Total",1507,135,74,61,1372,94,132,327,278,81,175,285
"2011","Amber Valley 012B","E01019433","Total",1846,179,85,94,1667,114,228,373,346,110,198,298
"2011","Amber Valley 012C","E01019438","Total",1690,162,56,106,1528,73,134,428,252,145,188,308
"2011","Amber Valley 012D","E01019451","Total",1943,225,69,156,1718,106,176,433,396,97,174,336
"2011","Amber Valley 012E","E01019464","Total",1969,156,77,79,1813,61,258,542,346,91,160,355
"2011","Amber Valley 013A","E01019434","Total",1196,157,61,96,1039,82,174,217,230,57,91,188
"2011","Amber Valley 013B","E01019435","Total",1644,145,49,96,1499,73,118,430,354,126,162,236
"2011","Amber Valley 013C","E01019436","Total",1307,151,57,94,1156,48,152,287,228,64,131,246
"2011","Amber Valley 013D","E01019439","Total",1308,118,51,67,1190,57,114,262,212,55,182,308
"2011","Amber Valley 013E","E01019440","Total",1499,186,95,91,1313,57,188,350,300,63,94,261
"2011","Amber Valley 015A","E01019446","Total",1222,104,40,64,1118,31,136,252,304,48,114,233
"2011","Amber Valley 015B","E01019448","Total",1705,148,65,83,1557,30,242,394,308,137,154,292
"2011","Amber Valley 015C","E01019450","Total",1436,199,75,124,1237,112,166,303,242,80,99,235
"2011","Amber Valley 015D","E01019465","Total",1142,176,106,70,966,38,198,162,184,65,122,197
"2011","Amber Valley 015E","E01019467","Total",1472,166,87,79,1306,19,270,258,308,61,159,231
"2011","Amber Valley 016A","E01019425","Total",1639,132,98,34,1507,56,312,371,162,116,220,270
"2011","Amber Valley 016B","E01019426","Total",1491,236,163,73,1255,43,250,261,200,122,179,200
"2011","Amber Valley 016C","E01019427","Total",1856,187,101,86,1669,74,212,488,198,214,242,241
"2011","Amber Valley 016D","E01019472","Total",2643,273,129,144,2370,55,486,460,444,130,263,532
"2011","Amber Valley 017A","E01019437","Total",1483,171,96,75,1312,38,216,269,206,84,242,257
"2011","Amber Valley 017B","E01019441","Total",1483,220,99,121,1263,142,146,301,264,79,91,240
"2011","Amber Valley 017C","E01019452","Total",1630,240,120,120,1390,145,216,286,260,101,143,239
"2011","Amber Valley 017D","E01019453","Total",1832,256,84,172,1576,219,144,429,286,87,153,258
"2011","Amber Valley 017E","E01032613","Total",1190,153,68,85,1037,34,220,219,210,35,125,194
"2011","Bolsover 001A","E01019478","Total",1541,159,53,106,1382,70,202,398,296,89,100,227
"2011","Bolsover 001B","E01019479","Total",1720,168,80,88,1552,43,204,445,256,109,190,305
"2011","Bolsover 001C","E01019491","Total",2231,285,100,185,1946,126,240,548,404,94,230,304
"2011","Bolsover 001D","E01019493","Total",1573,155,62,93,1418,70,196,325,304,42,187,294
"2011","Bolsover 001E","E01019494","Total",1971,309,159,150,1662,67,320,301,338,46,234,356
"2011","Bolsover 002A","E01019492","Total",1740,255,136,119,1485,109,236,329,314,67,166,264
"2011","Bolsover 002B","E01019495","Total",1616,170,76,94,1446,80,264,259,328,73,158,284
"2011","Bolsover 002C","E01019524","Total",1360,150,76,74,1210,56,218,279,258,39,119,241
"2011","Bolsover 002D","E01019525","Total",1479,181,99,82,1298,92,180,302,280,41,114,289
"2011","Bolsover 003A","E01019496","Total",1355,208,66,142,1147,100,146,269,288,79,90,175
"2011","Bolsover 003B","E01019497","Total",1390,214,130,84,1176,81,230,187,248,51,122,257
"2011","Bolsover 003C","E01019498","Total",1791,187,53,134,1604,204,100,369,314,141,219,257
"2011","Bolsover 003D","E01019523","Total",1018,193,87,106,825,86,114,169,196,53,64,143
"2011","Bolsover 004A","E01019483","Total",2097,225,72,153,1872,191,150,457,352,181,221,320
"2011","Bolsover 004B","E01019484","Total",1950,239,99,140,1711,81,278,289,388,65,254,356
"2011","Bolsover 004C","E01019485","Total",1169,191,111,80,978,37,200,219,212,63,68,179
"2011","Bolsover 004D","E01019488","Total",1446,234,65,169,1212,155,88,307,230,97,149,186
"2011","Bolsover 005A","E01019486","Total",1057,100,51,49,957,33,130,234,196,55,76,233
"2011","Bolsover 005B","E01019487","Total",1544,283,174,109,1261,91,156,243,216,122,174,259
"2011","Bolsover 005C","E01019489","Total",1177,138,72,66,1039,33,242,235,228,55,38,208
"2011","Bolsover 005D","E01019490","Total",1130,116,56,60,1014,37,120,234,226,62,152,183
"2011","Bolsover 005E","E01019502","Total",1503,224,136,88,1279,57,250,287,292,71,120,202
"2011","Bolsover 005F","E01019504","Total",1292,206,116,90,1086,48,192,235,252,37,115,207
"2011","Bolsover 006A","E01019508","Total",1957,237,150,87,1720,116,290,344,248,114,223,385
"2011","Bolsover 006B","E01019509","Total",1185,137,74,63,1048,142,102,246,140,75,157,186
"2011","Bolsover 006C","E01019510","Total",1257,197,133,64,1060,66,194,150,150,76,154,270
"2011","Bolsover 006D","E01019512","Total",2590,283,124,159,2307,133,256,572,512,100,322,412
"2011","Bolsover 007A","E01019503","Total",2304,306,139,167,1998,93,358,389,514,156,179,309
"2011","Bolsover 007B","E01019505","Total",1481,161,59,102,1320,74,130,288,228,147,127,326
"2011","Bolsover 007C","E01019506","Total",1345,144,73,71,1201,74,182,240,220,75,132,278
"2011","Bolsover 007D","E01019507","Total",1683,298,130,168,1385,86,174,356,212,82,195,280
"2011","Bolsover 007E","E01019511","Total",2117,206,90,116,1911,157,184,410,320,159,237,444
"2011","Bolsover 008A","E01019480","Total",1490,203,95,108,1287,68,272,286,254,51,141,215
"2011","Bolsover 008B","E01019482","Total",1492,184,99,85,1308,44,234,282,318,64,112,254
"2011","Bolsover 008C","E01019520","Total",1762,175,78,97,1587,76,194,373,326,108,178,332
"2011","Bolsover 008D","E01019521","Total",1547,194,88,106,1353,57,190,347,242,91,136,290
"2011","Bolsover 008E","E01019522","Total",1503,202,86,116,1301,96,120,356,266,104,135,224
"2011","Bolsover 009A","E01019481","Total",1342,153,87,66,1189,106,128,291,174,121,146,223
"2011","Bolsover 009B","E01019514","Total",1564,180,67,113,1384,86,134,363,304,89,175,233
"2011","Bolsover 009C","E01019515","Total",1642,205,106,99,1437,115,144,345,220,125,199,289
"2011","Bolsover 009D","E01019516","Total",1465,215,86,129,1250,95,208,231,320,58,116,222
"2011","Bolsover 009E","E01019519","Total",1822,232,107,125,1590,137,180,448,296,109,126,294
"2011","Bolsover 010A","E01019499","Total",1296,200,84,116,1096,68,142,236,262,62,102,224
"2011","Bolsover 010B","E01019500","Total",1422,167,87,80,1255,85,154,295,226,75,129,291
"2011","Bolsover 010C","E01019501","Total",1461,180,104,76,1281,44,220,295,300,53,110,259
"2011","Bolsover 010D","E01019513","Total",1262,159,53,106,1103,46,154,294,258,68,93,190
"2011","Bolsover 010E","E01019517","Total",1528,161,56,105,1367,64,126,423,340,47,111,256
"2011","Bolsover 010F","E01019518","Total",1584,152,27,125,1432,41,162,441,344,69,164,211
"2011","Chesterfield 001A","E01019526","Total",1382,190,58,132,1192,90,164,288,258,56,109,227
"2011","Chesterfield 001B","E01019528","Total",1559,198,104,94,1361,54,240,286,326,95,91,269
"2011","Chesterfield 001C","E01019572","Total",1322,265,120,145,1057,109,156,258,168,60,111,195
"2011","Chesterfield 001D","E01019573","Total",1438,228,71,157,1210,61,152,286,336,51,110,214
"2011","Chesterfield 001E","E01019574","Total",1339,234,128,106,1105,58,216,268,226,67,88,182
"2011","Chesterfield 002A","E01019563","Total",1682,163,63,100,1519,142,158,308,218,150,296,247
"2011","Chesterfield 002B","E01019564","Total",1483,163,88,75,1320,55,244,256,300,66,179,220
"2011","Chesterfield 002C","E01019565","Total",1422,231,113,118,1191,107,134,256,226,104,106,258
"2011","Chesterfield 002D","E01019566","Total",1634,259,72,187,1375,160,148,261,238,126,213,229
"2011","Chesterfield 002E","E01019568","Total",1531,130,68,62,1401,152,96,293,174,190,244,252
"2011","Chesterfield 003A","E01019527","Total",1465,285,96,189,1180,156,132,257,228,121,134,152
"2011","Chesterfield 003B","E01019529","Total",1484,195,72,123,1289,62,166,371,268,89,94,239
"2011","Chesterfield 003C","E01019530","Total",1443,257,61,196,1186,116,84,293,324,60,116,193
"2011","Chesterfield 003D","E01019531","Total",1436,190,52,138,1246,125,118,306,282,77,138,200
"2011","Chesterfield 003E","E01019553","Total",1788,191,76,115,1597,83,138,518,340,149,174,195
"2011","Chesterfield 004A","E01019541","Total",1524,198,93,105,1326,105,228,278,230,91,138,256
"2011","Chesterfield 004B","E01019542","Total",1629,370,88,282,1259,140,148,336,318,71,64,182
"2011","Chesterfield 004C","E01019543","Total",1557,307,118,189,1250,136,192,285,270,100,77,190
"2011","Chesterfield 004D","E01019544","Total",1559,239,142,97,1320,109,254,264,244,79,116,254
"2011","Chesterfield 004E","E01019571","Total",1463,204,109,95,1259,152,170,291,184,114,124,224
"2011","Chesterfield 005A","E01019532","Total",1219,144,63,81,1075,66,140,285,230,35,82,237
"2011","Chesterfield 005B","E01019533","Total",1403,161,64,97,1242,35,188,347,338,30,91,213
"2011","Chesterfield 005C","E01019534","Total",1316,207,141,66,1109,32,258,200,198,25,121,275
"2011","Chesterfield 005D","E01019535","Total",1442,162,82,80,1280,54,274,261,248,46,143,254
"2011","Chesterfield 005E","E01019536","Total",1720,319,140,179,1401,167,166,379,268,86,138,197
"2011","Chesterfield 006A","E01019549","Total",1351,128,64,64,1223,93,160,192,194,161,187,236
"2011","Chesterfield 006B","E01019550","Total",1633,161,99,62,1472,69,248,319,258,113,214,251
"2011","Chesterfield 006C","E01019551","Total",1576,161,82,79,1415,41,340,256,322,49,121,286
"2011","Chesterfield 006D","E01019552","Total",1286,135,67,68,1151,68,128,228,222,95,190,220
"2011","Chesterfield 006E","E01019567","Total",1708,271,127,144,1437,159,192,329,246,93,150,268
"2011","Chesterfield 007A","E01019537","Total",1473,159,106,53,1314,49,248,270,250,83,151,263
"2011","Chesterfield 007B","E01019569","Total",1584,391,103,288,1193,69,158,298,370,21,62,215
"2011","Chesterfield 007C","E01019570","Total",1241,212,136,76,1029,57,234,158,208,36,130,206
"2011","Chesterfield 007D","E01019580","Total",1451,239,90,149,1212,105,164,256,238,87,158,204
"2011","Chesterfield 007E","E01019581","Total",1387,320,113,207,1067,105,122,233,224,73,142,168
"2011","Chesterfield 008A","E01019557","Total",1477,183,62,121,1294,50,132,376,226,78,185,247
"2011","Chesterfield 008B","E01019558","Total",1433,110,45,65,1323,19,166,295,314,50,135,344
"2011","Chesterfield 008C","E01019559","Total",1167,115,52,63,1052,23,158,259,230,45,72,265
"2011","Chesterfield 008D","E01019560","Total",1384,179,98,81,1205,121,202,279,246,53,88,216
"2011","Chesterfield 008E","E01019561","Total",1281,412,133,279,869,113,108,160,232,63,64,129
"2011","Chesterfield 008F","E01019562","Total",1207,275,121,154,932,85,180,158,202,41,93,173
"2011","Chesterfield 009A","E01019539","Total",1623,255,124,131,1368,41,258,320,270,86,119,274
"2011","Chesterfield 009B","E01019540","Total",1411,170,74,96,1241,68,200,310,282,16,116,249
"2011","Chesterfield 009C","E01019555","Total",1536,334,187,147,1202,109,180,330,236,32,140,175
"2011","Chesterfield 009D","E01019590","Total",1818,250,135,115,1568,33,408,320,320,64,112,311
"2011","Chesterfield 009E","E01019591","Total",1524,200,92,108,1324,71,168,345,240,92,202,206
"2011","Chesterfield 010A","E01019538","Total",1623,320,94,226,1303,64,134,290,398,50,128,239
"2011","Chesterfield 010B","E01019554","Total",1377,319,74,245,1058,118,72,261,318,41,79,169
"2011","Chesterfield 010C","E01019556","Total",1464,285,97,188,1179,152,108,192,278,58,127,264
"2011","Chesterfield 010D","E01019579","Total",1646,330,79,251,1316,124,92,291,310,110,165,224
"2011","Chesterfield 010F","E01033387","Total",1148,283,23,260,865,76,48,243,342,16,44,96
"2011","Chesterfield 010G","E01033388","Total",1367,211,61,150,1156,114,110,278,316,72,105,161
"2011","Chesterfield 011A","E01019586","Total",1349,176,75,101,1173,31,248,256,262,63,82,231
"2011","Chesterfield 011B","E01019587","Total",1498,180,70,110,1318,33,180,366,270,75,145,249
"2011","Chesterfield 011C","E01019588","Total",1424,140,87,53,1284,34,314,223,244,52,126,291
"2011","Chesterfield 011D","E01019589","Total",1353,147,93,54,1206,54,280,274,268,27,99,204
"2011","Chesterfield 011E","E01019592","Total",1615,172,107,65,1443,47,320,322,220,99,153,282
"2011","Chesterfield 011F","E01019593","Total",1101,138,96,42,963,24,238,226,190,41,70,174
"2011","Chesterfield 012A","E01019545","Total",1388,166,102,64,1222,50,248,274,240,37,137,236
"2011","Chesterfield 012B","E01019546","Total",1438,183,69,114,1255,63,166,310,300,32,120,264
"2011","Chesterfield 012C","E01019547","Total",1393,246,85,161,1147,148,86,327,260,41,156,129
"2011","Chesterfield 012D","E01019548","Total",2282,246,87,159,2036,102,288,610,382,95,230,329
"2011","Chesterfield 012E","E01019582","Total",1429,171,72,99,1258,59,186,308,316,45,118,226
"2011","Chesterfield 012F","E01019583","Total",1430,134,52,82,1296,93,176,350,300,40,128,209
"2011","Chesterfield 012G","E01019585","Total",2155,312,88,224,1843,103,230,418,516,86,159,331
"2011","Chesterfield 013A","E01019575","Total",1687,185,84,101,1502,240,126,380,238,106,160,252
"2011","Chesterfield 013B","E01019576","Total",1574,241,86,155,1333,94,218,240,264,63,193,261
"2011","Chesterfield 013C","E01019577","Total",1545,286,111,175,1259,56,224,312,308,40,89,230
"2011","Chesterfield 013D","E01019578","Total",1604,391,134,257,1213,197,116,195,274,116,182,133
"2011","Derbyshire Dales 001A","E01019602","Total",1839,263,129,134,1576,63,312,322,338,93,163,285
"2011","Derbyshire Dales 001B","E01019614","Total",1701,186,102,84,1515,19,270,412,306,120,142,246
"2011","Derbyshire Dales 001C","E01019615","Total",2134,275,170,105,1859,56,314,430,370,146,181,362
"2011","Derbyshire Dales 001D","E01019631","Total",1826,244,122,122,1582,64,224,422,324,113,140,295
"2011","Derbyshire Dales 002A","E01019600","Total",1590,280,139,141,1310,47,294,230,264,62,133,280
"2011","Derbyshire Dales 002B","E01019604","Total",1770,222,131,91,1548,42,400,295,362,95,114,240
"2011","Derbyshire Dales 002C","E01019606","Total",1664,248,153,95,1416,48,372,288,290,131,82,205
"2011","Derbyshire Dales 002D","E01019618","Total",1636,191,106,85,1445,21,340,326,316,77,126,239
"2011","Derbyshire Dales 003A","E01019599","Total",1444,184,123,61,1260,37,332,246,248,88,105,204
"2011","Derbyshire Dales 003B","E01019601","Total",1500,268,186,82,1232,40,290,232,222,89,118,241
"2011","Derbyshire Dales 003C","E01019613","Total",1662,168,99,69,1494,42,234,244,306,119,194,355
"2011","Derbyshire Dales 003D","E01019617","Total",1552,230,133,97,1322,33,220,245,288,104,102,330
"2011","Derbyshire Dales 004A","E01019608","Total",1674,263,157,106,1411,117,250,359,260,82,95,248
"2011","Derbyshire Dales 004B","E01019610","Total",1550,169,103,66,1381,61,272,299,280,70,123,276
"2011","Derbyshire Dales 004C","E01019630","Total",1872,200,101,99,1672,82,248,394,336,102,198,312
"2011","Derbyshire Dales 005A","E01019609","Total",2083,267,123,144,1816,56,346,422,450,76,174,292
"2011","Derbyshire Dales 005B","E01019621","Total",1258,146,57,89,1112,37,164,252,262,56,113,228
"2011","Derbyshire Dales 005C","E01019622","Total",1550,197,86,111,1353,78,222,323,294,60,116,260
"2011","Derbyshire Dales 005D","E01019624","Total",1215,111,51,60,1104,44,210,238,266,71,56,219
"2011","Derbyshire Dales 005E","E01019627","Total",1180,132,73,59,1048,33,176,208,240,43,88,260
"2011","Derbyshire Dales 005F","E01019628","Total",1104,129,78,51,975,57,212,224,218,46,44,174
"2011","Derbyshire Dales 006A","E01019619","Total",1433,233,91,142,1200,45,290,196,296,57,94,222
"2011","Derbyshire Dales 006B","E01019620","Total",1529,201,69,132,1328,34,190,321,312,52,140,279
"2011","Derbyshire Dales 006C","E01019623","Total",1261,322,121,201,939,55,128,202,246,44,81,183
"2011","Derbyshire Dales 006D","E01019625","Total",1592,221,151,70,1371,131,160,323,208,144,183,222
"2011","Derbyshire Dales 006E","E01019626","Total",1463,218,112,106,1245,37,212,263,276,61,122,274
"2011","Derbyshire Dales 006F","E01019632","Total",1669,195,103,92,1474,42,304,275,316,88,152,297
"2011","Derbyshire Dales 007A","E01019633","Total",1536,162,91,71,1374,77,214,324,208,94,138,319
"2011","Derbyshire Dales 007B","E01019634","Total",1505,199,85,114,1306,45,228,273,274,127,106,253
"2011","Derbyshire Dales 007C","E01019635","Total",1213,183,95,88,1030,21,240,199,248,64,93,165
"2011","Derbyshire Dales 007D","E01019636","Total",1542,261,135,126,1281,59,176,275,280,96,152,243
"2011","Derbyshire Dales 008A","E01019595","Total",2025,291,118,173,1734,84,294,384,386,94,183,309
"2011","Derbyshire Dales 008B","E01019605","Total",1877,185,78,107,1692,59,296,414,340,136,139,308
"2011","Derbyshire Dales 008C","E01019611","Total",1714,174,82,92,1540,31,260,279,278,127,199,366
"2011","Derbyshire Dales 008D","E01019616","Total",1774,162,88,74,1612,59,356,359,334,78,177,249
"2011","Derbyshire Dales 009A","E01019594","Total",1778,232,147,85,1546,135,250,374,244,113,158,272
"2011","Derbyshire Dales 009B","E01019596","Total",1570,242,154,88,1328,50,218,380,256,74,169,181
"2011","Derbyshire Dales 009C","E01019597","Total",1477,121,58,63,1356,87,172,356,252,47,184,258
"2011","Derbyshire Dales 009D","E01019598","Total",1687,217,75,142,1470,145,118,413,328,121,129,216
"2011","Derbyshire Dales 010A","E01019603","Total",1647,173,85,88,1474,65,272,356,286,128,103,264
"2011","Derbyshire Dales 010B","E01019607","Total",1817,171,94,77,1646,36,314,366,330,118,170,312
"2011","Derbyshire Dales 010C","E01019612","Total",1949,224,129,95,1725,74,290,433,312,140,153,323
"2011","Derbyshire Dales 010D","E01019629","Total",1700,139,73,66,1561,50,238,352,296,126,200,299
"2011","Erewash 001A","E01019644","Total",1451,280,102,178,1171,102,164,285,280,38,93,209
"2011","Erewash 001B","E01019646","Total",1523,170,48,122,1353,184,104,293,248,143,127,254
"2011","Erewash 001C","E01019663","Total",1469,288,133,155,1181,187,130,258,184,140,117,165
"2011","Erewash 001D","E01019664","Total",1298,127,61,66,1171,144,106,240,168,144,182,187
"2011","Erewash 001E","E01019665","Total",1376,194,92,102,1182,97,254,206,212,74,106,233
"2011","Erewash 003A","E01019657","Total",1755,246,112,134,1509,140,170,346,304,123,100,326
"2011","Erewash 003B","E01019660","Total",1866,258,101,157,1608,81,230,386,390,53,178,290
"2011","Erewash 003C","E01019661","Total",1309,198,66,132,1111,86,126,269,268,26,116,220
"2011","Erewash 003D","E01019662","Total",1532,331,87,244,1201,123,120,344,290,65,83,176
"2011","Erewash 003E","E01019672","Total",1585,250,92,158,1335,118,154,319,290,51,133,270
"2011","Erewash 003F","E01019690","Total",1219,179,57,122,1040,104,110,315,214,41,59,197
"2011","Erewash 004A","E01019670","Total",1821,172,76,96,1649,62,258,496,312,81,146,294
"2011","Erewash 004B","E01019671","Total",1750,205,121,84,1545,42,338,384,332,35,83,331
"2011","Erewash 004C","E01019701","Total",2089,292,164,128,1797,75,328,343,374,100,213,364
"2011","Erewash 005A","E01019673","Total",1257,119,82,37,1138,24,218,275,176,45,146,254
"2011","Erewash 005B","E01019702","Total",1845,149,88,61,1696,58,264,362,338,118,141,415
"2011","Erewash 005C","E01019703","Total",1551,149,67,82,1402,45,188,320,320,87,140,302
"2011","Erewash 005D","E01019704","Total",1475,151,89,62,1324,24,260,307,268,67,119,279
"2011","Erewash 006A","E01019658","Total",1856,228,58,170,1628,140,112,543,378,95,125,235
"2011","Erewash 006B","E01019659","Total",1745,154,57,97,1591,79,202,426,330,82,175,297
"2011","Erewash 006C","E01019674","Total",1183,129,67,62,1054,54,194,223,206,33,93,251
"2011","Erewash 006D","E01019688","Total",1466,215,78,137,1251,114,130,257,252,85,139,274
"2011","Erewash 006E","E01019689","Total",1495,180,86,94,1315,64,172,335,262,98,108,276
"2011","Erewash 007A","E01019666","Total",1513,169,104,65,1344,133,168,314,174,120,186,249
"2011","Erewash 007B","E01019667","Total",1645,178,103,75,1467,156,210,330,278,106,116,271
"2011","Erewash 007C","E01019668","Total",1419,274,170,104,1145,101,192,225,188,89,153,197
"2011","Erewash 007D","E01019669","Total",1563,189,115,74,1374,29,280,257,266,45,171,326
"2011","Erewash 008A","E01019656","Total",1145,134,84,50,1011,7,190,239,226,46,108,195
"2011","Erewash 008B","E01019691","Total",1598,147,74,73,1451,71,208,408,214,64,130,356
"2011","Erewash 008C","E01019692","Total",1505,221,106,115,1284,125,156,280,208,144,146,225
"2011","Erewash 008D","E01019693","Total",1835,294,104,190,1541,182,154,321,368,118,157,241
"2011","Erewash 008E","E01019694","Total",1186,100,49,51,1086,39,202,193,222,36,104,290
"2011","Erewash 008F","E01019696","Total",1303,157,82,75,1146,21,226,234,264,42,121,238
"2011","Erewash 009A","E01019683","Total",1287,116,59,57,1171,56,226,273,248,16,103,249
"2011","Erewash 009B","E01019684","Total",1637,170,67,103,1467,65,170,421,344,57,122,288
"2011","Erewash 009C","E01019685","Total",1451,208,97,111,1243,35,246,281,250,42,97,292
"2011","Erewash 009D","E01019686","Total",1364,157,100,57,1207,33,270,344,234,10,126,190
"2011","Erewash 009E","E01019687","Total",1497,211,149,62,1286,124,210,256,224,77,147,248
"2011","Erewash 010A","E01019648","Total",1545,166,76,90,1379,76,180,326,266,100,160,271
"2011","Erewash 010B","E01019649","Total",1759,268,66,202,1491,135,112,411,364,70,139,260
"2011","Erewash 010C","E01019650","Total",1645,291,130,161,1354,160,184,329,186,81,169,245
"2011","Erewash 010D","E01019651","Total",1451,167,92,75,1284,69,180,318,270,70,134,243
"2011","Erewash 010E","E01019695","Total",1376,154,50,104,1222,72,154,296,288,39,132,241
"2011","Erewash 011A","E01019641","Total",1405,152,79,73,1253,17,290,262,264,41,112,267
"2011","Erewash 011B","E01019652","Total",1555,180,75,105,1375,89,146,315,224,125,166,310
"2011","Erewash 011C","E01019653","Total",1366,144,74,70,1222,36,230,257,260,27,123,289
"2011","Erewash 011D","E01019707","Total",1473,160,37,123,1313,81,94,374,362,43,102,257
"2011","Erewash 011E","E01019708","Total",1635,107,57,50,1528,51,210,440,278,74,160,315
"2011","Erewash 012A","E01019647","Total",1889,420,105,315,1469,238,114,378,380,68,85,206
"2011","Erewash 012B","E01019675","Total",1570,288,89,199,1282,136,126,357,308,45,143,167
"2011","Erewash 012C","E01019679","Total",1711,207,51,156,1504,146,148,363,344,82,135,286
"2011","Erewash 012D","E01019682","Total",1498,374,124,250,1124,160,94,262,298,40,51,219
"2011","Erewash 013A","E01019642","Total",1408,198,119,79,1210,57,260,270,206,54,115,248
"2011","Erewash 013B","E01019643","Total",1584,204,109,95,1380,39,288,317,264,48,157,267
"2011","Erewash 013C","E01019654","Total",1551,216,90,126,1335,59,216,323,312,87,85,253
"2011","Erewash 013D","E01019655","Total",1539,187,47,140,1352,140,134,349,312,55,110,252
"2011","Erewash 014A","E01019676","Total",1452,193,67,126,1259,99,174,342,266,52,82,244
"2011","Erewash 014B","E01019677","Total",1424,177,87,90,1247,49,232,261,278,48,104,275
"2011","Erewash 014C","E01019678","Total",1594,164,28,136,1430,83,120,430,338,61,164,234
"2011","Erewash 014D","E01019680","Total",1509,190,69,121,1319,76,146,378,306,93,117,203
"2011","Erewash 014E","E01019681","Total",1485,181,86,95,1304,54,274,255,302,32,98,289
"2011","Erewash 014F","E01019698","Total",1357,166,56,110,1191,62,168,282,318,50,90,221
"2011","Erewash 015A","E01019697","Total",1495,142,50,92,1353,95,234,333,240,91,133,227
"2011","Erewash 015B","E01019699","Total",1512,294,181,113,1218,146,208,222,192,106,131,213
"2011","Erewash 015C","E01019700","Total",2258,278,142,136,1980,102,358,465,416,75,211,353
"2011","Erewash 015D","E01019705","Total",1789,244,78,166,1545,114,150,420,390,108,110,253
"2011","Erewash 015E","E01019706","Total",1243,114,58,56,1129,28,214,299,188,72,123,205
"2011","Erewash 015F","E01019709","Total",1259,148,55,93,1111,128,82,280,202,68,127,224
"2011","Erewash 016A","E01019638","Total",1302,101,43,58,1201,36,150,310,218,57,193,237
"2011","Erewash 016B","E01019639","Total",1098,88,36,52,1010,73,92,235,188,86,143,193
"2011","Erewash 016C","E01019640","Total",1481,118,20,98,1363,45,58,530,336,77,108,209
"2011","Erewash 016D","E01019645","Total",1556,216,92,124,1340,71,184,324,316,48,148,249
"2011","Erewash 016E","E01032614","Total",1301,78,19,59,1223,53,72,443,246,31,119,259
"2011","High Peak 001A","E01019733","Total",1474,182,88,94,1292,96,184,301,272,47,130,262
"2011","High Peak 001B","E01019752","Total",1319,158,37,121,1161,86,68,368,254,113,91,181
"2011","High Peak 001C","E01019753","Total",1475,167,59,108,1308,82,100,313,332,71,143,267
"2011","High Peak 001D","E01019763","Total",2090,283,111,172,1807,93,174,432,414,140,233,321
"2011","High Peak 002A","E01019728","Total",1221,197,100,97,1024,145,80,255,112,137,143,152
"2011","High Peak 002B","E01019729","Total",1310,155,54,101,1155,159,104,246,136,125,158,227
"2011","High Peak 002C","E01019730","Total",1935,274,112,162,1661,185,176,385,310,133,198,274
"2011","High Peak 002D","E01019731","Total",1305,89,47,42,1216,38,128,342,190,81,170,267
"2011","High Peak 002E","E01019732","Total",1486,145,75,70,1341,73,158,285,232,70,167,356
"2011","High Peak 003A","E01019738","Total",1364,203,61,142,1161,101,86,311,284,59,108,212
"2011","High Peak 003B","E01019739","Total",1592,334,100,234,1258,103,156,268,392,35,118,186
"2011","High Peak 003C","E01019740","Total",1177,161,50,111,1016,61,98,341,250,16,64,186
"2011","High Peak 003D","E01019750","Total",1256,186,101,85,1070,70,152,225,238,56,116,213
"2011","High Peak 003E","E01019751","Total",2240,203,83,120,2037,68,172,710,394,169,221,303
"2011","High Peak 003F","E01019768","Total",2199,393,160,233,1806,143,236,460,416,105,158,288
"2011","High Peak 004A","E01019727","Total",1703,207,130,77,1496,17,364,285,248,65,162,355
"2011","High Peak 004B","E01019749","Total",1252,92,41,51,1160,33,142,261,224,87,116,297
"2011","High Peak 004C","E01019754","Total",1781,209,108,101,1572,35,260,328,332,93,158,366
"2011","High Peak 004D","E01019756","Total",1828,64,28,36,1764,84,108,632,264,102,191,383
"2011","High Peak 004E","E01019757","Total",1340,113,55,58,1227,67,184,271,254,89,103,259
"2011","High Peak 004F","E01019758","Total",1504,91,35,56,1413,40,180,378,288,60,144,323
"2011","High Peak 005A","E01019746","Total",1587,204,49,155,1383,47,180,367,308,63,160,258
"2011","High Peak 005B","E01019747","Total",1178,136,66,70,1042,35,180,220,258,58,98,193
"2011","High Peak 005C","E01019748","Total",1462,220,61,159,1242,49,100,338,314,60,109,272
"2011","High Peak 005D","E01019755","Total",1968,198,68,130,1770,34,280,424,414,77,189,352
"2011","High Peak 005E","E01019766","Total",1443,145,66,79,1298,47,184,289,308,87,106,277
"2011","High Peak 006A","E01019711","Total",1322,179,84,95,1143,57,152,298,274,46,68,248
"2011","High Peak 006B","E01019734","Total",2054,278,135,143,1776,76,248,487,388,114,125,338
"2011","High Peak 006C","E01019743","Total",1376,197,109,88,1179,122,114,254,202,111,119,257
"2011","High Peak 006D","E01019744","Total",1441,199,93,106,1242,48,202,289,264,61,117,261
"2011","High Peak 006E","E01019745","Total",1069,176,89,87,893,66,94,219,208,52,80,174
"2011","High Peak 008A","E01019712","Total",1467,142,72,70,1325,49,206,290,270,68,181,261
"2011","High Peak 008B","E01019713","Total",1054,95,56,39,959,23,174,155,188,84,113,222
"2011","High Peak 008C","E01019764","Total",1593,179,112,67,1414,54,212,408,184,79,149,328
"2011","High Peak 008D","E01019765","Total",1790,325,105,220,1465,106,156,370,388,73,125,247
"2011","High Peak 008E","E01019767","Total",1621,166,75,91,1455,68,222,336,256,133,139,301
"2011","High Peak 010A","E01019710","Total",1917,344,135,209,1573,76,202,373,352,97,115,358
"2011","High Peak 010B","E01019715","Total",1476,287,88,199,1189,102,84,265,300,47,83,308
"2011","High Peak 010C","E01019717","Total",1121,400,167,233,721,60,114,109,218,21,60,139
"2011","High Peak 010D","E01019722","Total",1859,164,60,104,1695,77,166,456,322,129,159,386
"2011","High Peak 010E","E01019723","Total",1664,405,205,200,1259,48,314,201,308,47,78,263
"2011","High Peak 011A","E01019716","Total",1275,155,58,97,1120,64,166,230,242,82,144,192
"2011","High Peak 011B","E01019724","Total",1221,169,67,102,1052,96,122,279,150,88,99,218
"2011","High Peak 011C","E01019759","Total",1506,205,88,117,1301,128,186,284,244,46,177,236
"2011","High Peak 011D","E01019760","Total",1461,181,96,85,1280,88,158,293,232,86,117,306
"2011","High Peak 011E","E01019761","Total",1606,112,46,66,1494,208,86,365,190,235,189,221
"2011","High Peak 012A","E01019714","Total",2536,224,99,125,2312,137,266,637,472,164,251,385
"2011","High Peak 012B","E01019725","Total",1406,131,51,80,1275,59,178,321,254,67,147,249
"2011","High Peak 012C","E01019726","Total",1339,133,43,90,1206,60,124,353,242,94,143,190
"2011","High Peak 012D","E01019762","Total",1764,211,117,94,1553,18,362,331,254,83,184,321
"2011","High Peak 013E","E01019718","Total",2233,241,112,129,1992,131,284,460,396,133,173,415
"2011","High Peak 013F","E01019719","Total",1518,220,88,132,1298,96,182,303,252,104,101,260
"2011","High Peak 013G","E01019720","Total",1457,204,131,73,1253,37,242,242,286,62,137,247
"2011","High Peak 013H","E01019721","Total",1143,106,56,50,1037,38,176,240,202,88,87,206
"2011","High Peak 013A","E01019735","Total",1527,157,92,65,1370,49,268,301,278,60,145,269
"2011","High Peak 013B","E01019736","Total",1163,128,59,69,1035,26,162,180,278,68,134,187
"2011","High Peak 013C","E01019737","Total",1168,189,124,65,979,53,238,198,204,54,82,150
"2011","High Peak 013I","E01019741","Total",1113,120,54,66,993,53,166,216,178,66,96,218
"2011","High Peak 013D","E01019742","Total",1118,131,51,80,987,46,122,224,190,78,120,207
"2011","North East Derbyshire 001A","E01019801","Total",1096,106,29,77,990,47,100,187,244,30,92,290
"2011","North East Derbyshire 001B","E01019802","Total",1308,133,64,69,1175,30,152,287,236,35,134,301
"2011","North East Derbyshire 001C","E01019803","Total",1280,120,59,61,1160,96,144,277,190,63,160,230
"2011","North East Derbyshire 001D","E01019804","Total",1333,111,35,76,1222,33,86,295,284,48,146,330
"2011","North East Derbyshire 001E","E01019805","Total",1382,107,43,64,1275,64,102,383,224,38,175,289
"2011","North East Derbyshire 001F","E01019806","Total",1492,159,73,86,1333,63,164,244,308,45,126,383
"2011","North East Derbyshire 001G","E01019807","Total",1499,185,97,88,1314,112,118,244,210,112,204,314
"2011","North East Derbyshire 002A","E01019778","Total",1697,186,141,45,1511,37,440,320,240,78,115,281
"2011","North East Derbyshire 002B","E01019779","Total",1587,203,129,74,1384,36,480,288,228,46,80,226
"2011","North East Derbyshire 002C","E01019790","Total",1952,238,75,163,1714,56,200,381,412,65,178,422
"2011","North East Derbyshire 002D","E01019816","Total",1750,205,106,99,1545,34,294,334,300,41,215,327
"2011","North East Derbyshire 004A","E01019780","Total",1429,175,93,82,1254,123,158,342,206,71,143,211
"2011","North East Derbyshire 004B","E01019781","Total",1371,189,103,86,1182,43,244,291,250,41,110,203
"2011","North East Derbyshire 004C","E01019782","Total",1244,254,124,130,990,49,164,243,168,60,111,195
"2011","North East Derbyshire 004D","E01019786","Total",1518,284,137,147,1234,100,208,270,266,61,119,210
"2011","North East Derbyshire 004E","E01019827","Total",1876,221,127,94,1655,84,288,350,288,72,225,348
"2011","North East Derbyshire 005A","E01019770","Total",1891,232,127,105,1659,46,368,381,302,75,157,330
"2011","North East Derbyshire 005B","E01019787","Total",1774,210,109,101,1564,41,314,390,278,94,138,309
"2011","North East Derbyshire 005C","E01019788","Total",1621,136,80,56,1485,21,342,325,270,71,140,316
"2011","North East Derbyshire 005D","E01019794","Total",1416,114,80,34,1302,16,354,249,234,64,114,271
"2011","North East Derbyshire 006A","E01019783","Total",1259,104,55,49,1155,38,240,329,174,41,93,240
"2011","North East Derbyshire 006B","E01019784","Total",1257,111,44,67,1146,29,194,343,186,71,106,217
"2011","North East Derbyshire 006C","E01019785","Total",1292,85,48,37,1207,28,242,297,204,71,107,258
"2011","North East Derbyshire 006D","E01019793","Total",1441,155,93,62,1286,24,286,256,280,40,116,284
"2011","North East Derbyshire 006E","E01019795","Total",2215,261,153,108,1954,77,274,602,378,72,173,378
"2011","North East Derbyshire 007A","E01019798","Total",1401,145,84,61,1256,33,210,283,268,32,109,321
"2011","North East Derbyshire 007B","E01019821","Total",1348,166,95,71,1182,54,252,204,232,25,132,283
"2011","North East Derbyshire 007C","E01019822","Total",1582,196,92,104,1386,32,190,305,290,76,200,293
"2011","North East Derbyshire 007D","E01019823","Total",1118,210,111,99,908,53,130,238,146,30,120,191
"2011","North East Derbyshire 008A","E01019771","Total",2088,306,179,127,1782,48,400,376,318,84,192,364
"2011","North East Derbyshire 008B","E01019772","Total",1545,133,76,57,1412,56,250,301,246,86,147,326
"2011","North East Derbyshire 008C","E01019828","Total",1412,190,145,45,1222,11,430,181,236,20,86,258
"2011","North East Derbyshire 008D","E01019829","Total",1437,159,85,74,1278,28,218,295,278,73,110,276
"2011","North East Derbyshire 009A","E01019796","Total",1111,156,82,74,955,97,132,217,150,69,88,202
"2011","North East Derbyshire 009B","E01019797","Total",1338,200,61,139,1138,74,122,258,250,61,136,237
"2011","North East Derbyshire 009C","E01019799","Total",1937,318,119,199,1619,211,238,294,342,125,188,221
"2011","North East Derbyshire 009D","E01019800","Total",1719,165,78,87,1554,107,190,341,288,42,233,353
"2011","North East Derbyshire 009E","E01019808","Total",1593,203,102,101,1390,154,168,307,304,109,151,197
"2011","North East Derbyshire 009F","E01019826","Total",1417,230,123,107,1187,83,154,297,188,84,151,230
"2011","North East Derbyshire 010A","E01019769","Total",1867,186,100,86,1681,43,376,301,310,60,219,372
"2011","North East Derbyshire 010B","E01019774","Total",1539,213,144,69,1326,27,448,182,256,27,100,286
"2011","North East Derbyshire 010C","E01019824","Total",1175,147,81,66,1028,34,196,198,180,49,120,251
"2011","North East Derbyshire 010D","E01019830","Total",1261,93,57,36,1168,39,234,257,250,60,74,254
"2011","North East Derbyshire 010E","E01019831","Total",1375,142,55,87,1233,37,164,349,312,73,101,197
"2011","North East Derbyshire 011A","E01019809","Total",1135,173,91,82,962,30,188,188,232,21,92,211
"2011","North East Derbyshire 011B","E01019810","Total",1418,257,68,189,1161,94,130,222,340,44,108,223
"2011","North East Derbyshire 011C","E01019811","Total",1552,168,71,97,1384,36,214,378,316,48,111,281
"2011","North East Derbyshire 011D","E01019812","Total",1783,194,76,118,1589,70,234,372,384,87,121,321
"2011","North East Derbyshire 011E","E01019813","Total",1704,262,125,137,1442,94,152,368,264,139,208,217
"2011","North East Derbyshire 011F","E01019825","Total",1370,100,49,51,1270,40,178,302,266,83,164,237
"2011","North East Derbyshire 012A","E01019773","Total",2363,400,185,215,1963,138,228,461,472,120,182,362
"2011","North East Derbyshire 012B","E01019775","Total",1738,305,101,204,1433,95,160,303,314,124,144,293
"2011","North East Derbyshire 012C","E01019776","Total",1328,205,84,121,1123,47,220,201,260,40,101,254
"2011","North East Derbyshire 012D","E01019777","Total",2381,343,169,174,2038,185,260,479,394,135,233,352
"2011","North East Derbyshire 013A","E01019814","Total",1664,218,130,88,1446,45,248,377,348,37,98,293
"2011","North East Derbyshire 013B","E01019817","Total",1211,164,88,76,1047,62,158,257,162,79,145,184
"2011","North East Derbyshire 013C","E01019818","Total",1541,186,92,94,1355,108,174,315,214,136,163,245
"2011","North East Derbyshire 013D","E01019819","Total",1423,157,68,89,1266,38,246,285,300,30,123,244
"2011","North East Derbyshire 013E","E01019820","Total",1414,132,59,73,1282,49,294,240,288,54,120,237
"2011","North East Derbyshire 014A","E01019791","Total",1707,236,118,118,1471,105,202,270,266,86,193,349
"2011","North East Derbyshire 014B","E01019792","Total",1967,305,139,166,1662,130,252,335,256,117,209,363
"2011","North East Derbyshire 014C","E01019815","Total",2655,272,101,171,2383,129,230,728,480,151,258,407
"2011","North East Derbyshire 014D","E01032586","Total",1643,239,142,97,1404,94,250,302,238,67,133,320
"2011","South Derbyshire 001A","E01019839","Total",1758,125,37,88,1633,31,180,483,328,106,201,304
"2011","South Derbyshire 001B","E01019845","Total",1324,161,54,107,1163,49,130,352,260,70,130,172
"2011","South Derbyshire 001C","E01019846","Total",1239,176,95,81,1063,64,132,255,216,65,106,225
"2011","South Derbyshire 001D","E01019866","Total",2202,183,79,104,2019,60,328,501,412,104,213,401
"2011","South Derbyshire 002A","E01019840","Total",1586,180,110,70,1406,98,244,348,216,119,133,248
"2011","South Derbyshire 002B","E01019841","Total",1491,149,91,58,1342,36,316,278,238,82,142,250
"2011","South Derbyshire 002C","E01019847","Total",1356,159,88,71,1197,41,230,290,216,87,127,206
"2011","South Derbyshire 002D","E01019848","Total",2126,139,11,128,1987,100,68,779,424,129,221,266
"2011","South Derbyshire 002F","E01033532","Total",1463,108,20,88,1355,91,60,504,278,137,135,150
"2011","South Derbyshire 002G","E01033533","Total",1696,92,15,77,1604,98,68,706,268,131,147,186
"2011","South Derbyshire 002H","E01033534","Total",1073,189,6,183,884,71,8,345,250,56,88,66
"2011","South Derbyshire 003A","E01019873","Total",1461,146,25,121,1315,111,80,331,264,127,187,215
"2011","South Derbyshire 003B","E01019874","Total",1449,123,44,79,1326,62,174,289,288,69,133,311
"2011","South Derbyshire 003C","E01019875","Total",1418,79,11,68,1339,73,56,312,182,61,269,386
"2011","South Derbyshire 003D","E01019881","Total",1343,131,72,59,1212,33,242,241,230,74,111,281
"2011","South Derbyshire 003E","E01019882","Total",1565,195,96,99,1370,75,220,274,280,101,164,256
"2011","South Derbyshire 004A","E01019832","Total",1687,257,99,158,1430,49,252,329,396,60,109,235
"2011","South Derbyshire 004B","E01019833","Total",1820,173,101,72,1647,55,276,520,282,90,161,263
"2011","South Derbyshire 004C","E01019834","Total",1506,169,91,78,1337,45,238,358,254,70,135,237
"2011","South Derbyshire 004D","E01019835","Total",1621,107,27,80,1514,42,98,465,300,83,199,327
"2011","South Derbyshire 005A","E01019867","Total",1408,151,77,74,1257,27,248,261,306,54,93,268
"2011","South Derbyshire 005B","E01019868","Total",1611,168,92,76,1443,54,204,315,270,147,179,274
"2011","South Derbyshire 005C","E01019869","Total",1229,160,65,95,1069,29,170,288,200,61,97,224
"2011","South Derbyshire 005D","E01019880","Total",1607,148,61,87,1459,48,200,376,288,117,128,302
"2011","South Derbyshire 006A","E01019843","Total",1495,196,93,103,1299,49,234,286,300,76,132,222
"2011","South Derbyshire 006B","E01019853","Total",1543,147,70,77,1396,49,200,351,272,117,175,232
"2011","South Derbyshire 006C","E01019854","Total",1741,363,175,188,1378,75,218,386,282,80,101,236
"2011","South Derbyshire 006D","E01019855","Total",1544,164,71,93,1380,59,230,332,252,98,182,227
"2011","South Derbyshire 007A","E01019844","Total",1548,154,99,55,1394,89,302,272,236,100,142,253
"2011","South Derbyshire 007B","E01019856","Total",1496,194,97,97,1302,140,164,306,192,70,145,285
"2011","South Derbyshire 007C","E01019857","Total",1268,82,23,59,1186,56,86,394,232,73,110,235
"2011","South Derbyshire 007D","E01019858","Total",1621,139,78,61,1482,193,188,315,234,147,125,280
"2011","South Derbyshire 007E","E01019859","Total",1674,169,97,72,1505,75,284,312,306,66,161,301
"2011","South Derbyshire 008A","E01019860","Total",1322,86,50,36,1236,35,158,287,248,89,170,249
"2011","South Derbyshire 008B","E01019861","Total",1783,209,89,120,1574,92,206,375,314,91,153,343
"2011","South Derbyshire 008C","E01019862","Total",1452,170,84,86,1282,80,244,247,282,51,127,251
"2011","South Derbyshire 008D","E01019863","Total",1593,281,92,189,1312,161,154,275,224,123,150,225
"2011","South Derbyshire 008E","E01019864","Total",1492,154,38,116,1338,85,120,346,246,69,158,314
"2011","South Derbyshire 008F","E01019865","Total",1308,105,43,62,1203,86,98,290,270,126,89,244
"2011","South Derbyshire 009A","E01019876","Total",1928,234,115,119,1694,93,244,376,284,167,189,341
"2011","South Derbyshire 009B","E01019877","Total",1543,367,162,205,1176,109,142,251,256,60,136,222
"2011","South Derbyshire 009C","E01019878","Total",1530,166,75,91,1364,95,158,312,306,75,133,285
"2011","South Derbyshire 009D","E01019879","Total",1851,149,64,85,1702,24,178,405,428,55,193,419
"2011","South Derbyshire 011A","E01019850","Total",1554,151,95,56,1403,25,250,283,314,78,130,323
"2011","South Derbyshire 011B","E01019851","Total",1614,168,64,104,1446,102,190,269,316,126,133,310
"2011","South Derbyshire 011C","E01019852","Total",1792,181,57,124,1611,72,196,361,344,132,203,303
"2011","South Derbyshire 011D","E01019870","Total",1497,171,96,75,1326,51,272,281,236,78,125,283
"2011","South Derbyshire 011E","E01019871","Total",1768,183,97,86,1585,87,274,345,342,139,143,255
"2011","South Derbyshire 011F","E01019872","Total",1868,229,94,135,1639,73,246,441,400,70,134,275
"2011","South Derbyshire 012A","E01019837","Total",1910,219,52,167,1691,169,140,501,386,120,124,251
"2011","South Derbyshire 012B","E01019838","Total",1653,247,94,153,1406,131,154,336,268,114,154,249
"2011","South Derbyshire 012C","E01033531","Total",1596,191,15,176,1405,83,24,533,372,111,120,162
"2011","South Derbyshire 012D","E01033536","Total",1648,173,33,140,1475,120,90,509,298,100,150,208
"2011","South Derbyshire 012E","E01033537","Total",1663,167,68,99,1496,135,170,344,356,115,129,247
"2011","South Derbyshire 013A","E01019842","Total",1712,160,77,83,1552,158,174,366,238,109,241,266
"2011","South Derbyshire 013B","E01019883","Total",2845,341,78,263,2504,219,160,792,594,255,224,260
"2011","South Derbyshire 013C","E01019885","Total",1701,198,53,145,1503,72,118,405,392,102,123,291
"2011","South Derbyshire 013D","E01033535","Total",1541,83,17,66,1458,85,90,491,250,128,196,218
"2011","Blaby 002A","E01025631","Total",1212,115,61,54,1097,61,152,343,172,60,109,200
"2011","Blaby 002B","E01025632","Total",1457,46,14,32,1411,55,60,489,152,74,254,327
"2011","Blaby 002C","E01025633","Total",1716,174,92,82,1542,62,222,348,328,84,207,291
"2011","Blaby 002D","E01025635","Total",1169,113,62,51,1056,44,168,228,204,46,131,235
"2011","Blaby 003A","E01025634","Total",1422,111,56,55,1311,32,164,392,188,86,199,250
"2011","Blaby 003B","E01025638","Total",1442,179,126,53,1263,27,348,235,164,74,165,250
"2011","Blaby 003C","E01025639","Total",1228,161,90,71,1067,33,234,223,158,83,142,194
"2011","Blaby 003D","E01025640","Total",1557,187,103,84,1370,60,214,337,240,112,188,219
"2011","Blaby 003E","E01025645","Total",1145,105,44,61,1040,45,156,239,196,55,147,202
"2011","Blaby 004A","E01025666","Total",1466,179,86,93,1287,86,190,265,224,79,175,268
"2011","Blaby 004B","E01025667","Total",1180,148,90,58,1032,38,158,216,142,85,150,243
"2011","Blaby 004C","E01025668","Total",2359,193,33,160,2166,143,110,708,556,111,232,306
"2011","Blaby 004D","E01025669","Total",2101,197,13,184,1904,120,30,704,500,99,234,217
"2011","Blaby 005A","E01025636","Total",1341,213,131,82,1128,50,230,212,166,75,140,255
"2011","Blaby 005B","E01025637","Total",1310,143,66,77,1167,84,172,241,218,58,163,231
"2011","Blaby 005C","E01025652","Total",1345,96,51,45,1249,71,138,251,180,52,183,374
"2011","Blaby 005D","E01025653","Total",1568,216,96,120,1352,104,136,304,230,98,180,300
"2011","Blaby 005E","E01025654","Total",1270,125,86,39,1145,46,198,239,166,59,187,250
"2011","Blaby 005F","E01025655","Total",1561,156,65,91,1405,87,182,269,218,83,267,299
"2011","Blaby 005G","E01025656","Total",1339,114,57,57,1225,49,132,252,150,79,251,312
"2011","Blaby 006A","E01025625","Total",1229,201,96,105,1028,143,136,228,200,59,89,173
"2011","Blaby 006B","E01025626","Total",1244,186,56,130,1058,53,96,267,284,61,91,206
"2011","Blaby 006C","E01025627","Total",2158,231,101,130,1927,137,238,528,338,72,203,411
"2011","Blaby 006D","E01025651","Total",1602,165,75,90,1437,54,150,362,264,83,201,323
"2011","Blaby 006E","E01025657","Total",1861,267,146,121,1594,40,182,350,316,108,203,395
"2011","Blaby 006F","E01025660","Total",1661,173,76,97,1488,50,252,381,228,77,214,286
"2011","Blaby 007A","E01025641","Total",1766,240,102,138,1526,51,240,383,326,106,158,262
"2011","Blaby 007B","E01025642","Total",1941,258,117,141,1683,136,194,519,338,73,192,231
"2011","Blaby 007C","E01025643","Total",1590,138,40,98,1452,72,170,400,254,96,164,296
"2011","Blaby 007D","E01025649","Total",1571,174,75,99,1397,38,230,325,274,66,147,317
"2011","Blaby 007E","E01025650","Total",1574,76,22,54,1498,104,102,426,254,86,209,317
"2011","Blaby 008A","E01025610","Total",1564,188,104,84,1376,140,200,289,212,80,200,255
"2011","Blaby 008B","E01025611","Total",1532,139,71,68,1393,70,260,280,210,136,165,272
"2011","Blaby 008C","E01025612","Total",1609,170,99,71,1439,60,302,294,258,70,158,297
"2011","Blaby 008D","E01025658","Total",1826,176,55,121,1650,121,160,370,306,122,201,370
"2011","Blaby 008E","E01025659","Total",1758,311,150,161,1447,73,294,264,346,79,154,237
"2011","Blaby 009A","E01025615","Total",1602,76,24,52,1526,70,98,508,226,113,223,288
"2011","Blaby 009B","E01025646","Total",1629,273,116,157,1356,143,168,386,248,86,109,216
"2011","Blaby 009C","E01025647","Total",1586,242,102,140,1344,101,180,343,258,87,111,264
"2011","Blaby 009D","E01025648","Total",2048,119,21,98,1929,100,162,692,248,151,224,352
"2011","Blaby 010A","E01025613","Total",1410,196,114,82,1214,24,248,215,190,93,200,244
"2011","Blaby 010B","E01025614","Total",1749,128,53,75,1621,96,212,439,304,109,161,300
"2011","Blaby 010C","E01025620","Total",1097,126,74,52,971,87,162,225,176,71,77,173
"2011","Blaby 010D","E01025621","Total",1051,97,39,58,954,38,208,188,186,45,114,175
"2011","Blaby 010E","E01025644","Total",1401,127,47,80,1274,89,178,291,228,88,133,267
"2011","Blaby 011A","E01025616","Total",1642,139,75,64,1503,40,212,360,236,120,166,369
"2011","Blaby 011B","E01025617","Total",1696,186,94,92,1510,74,274,348,298,72,166,278
"2011","Blaby 011C","E01025618","Total",1666,234,114,120,1432,56,246,394,242,99,156,239
"2011","Blaby 011D","E01025619","Total",1610,176,75,101,1434,37,274,309,306,84,162,262
"2011","Blaby 012A","E01025661","Total",1762,123,36,87,1639,120,160,513,312,104,189,241
"2011","Blaby 012B","E01025662","Total",1508,238,103,135,1270,112,206,268,258,50,148,228
"2011","Blaby 012C","E01025663","Total",1436,118,65,53,1318,34,212,358,256,51,124,283
"2011","Blaby 012D","E01025664","Total",1226,147,86,61,1079,22,238,228,198,39,90,264
"2011","Blaby 012E","E01025665","Total",1479,150,80,70,1329,36,298,327,280,46,110,232
"2011","Blaby 013A","E01025622","Total",1653,247,120,127,1406,83,240,323,310,91,144,215
"2011","Blaby 013B","E01025623","Total",1547,195,114,81,1352,75,242,306,246,50,143,290
"2011","Blaby 013C","E01025624","Total",1798,140,52,88,1658,69,154,404,296,110,218,407
"2011","Blaby 013D","E01025629","Total",1508,192,106,86,1316,85,236,241,218,94,164,278
"2011","Blaby 013E","E01025630","Total",1696,171,96,75,1525,35,288,338,238,89,179,358
"2011","Blaby 013F","E01032603","Total",1420,191,128,63,1229,51,324,151,222,41,142,298
"2011","Charnwood 001B","E01025692","Total",1996,191,63,128,1805,104,150,437,412,106,188,408
"2011","Charnwood 001C","E01025693","Total",1859,248,113,135,1611,57,272,385,398,71,92,336
"2011","Charnwood 001E","E01033386","Total",2199,263,73,190,1936,95,226,380,446,80,191,518
"2011","Charnwood 002A","E01025699","Total",1397,487,138,349,910,114,84,116,230,58,134,174
"2011","Charnwood 002B","E01025700","Total",1786,263,28,235,1523,153,56,381,266,148,223,296
"2011","Charnwood 002C","E01025701","Total",1566,266,85,181,1300,88,92,254,248,207,198,213
"2011","Charnwood 002D","E01025703","Total",1943,318,56,262,1625,78,86,292,382,90,282,415
"2011","Charnwood 002E","E01025704","Total",1324,202,46,156,1122,51,94,219,260,68,155,275
"2011","Charnwood 002F","E01025705","Total",1326,144,22,122,1182,105,44,231,240,118,197,247
"2011","Charnwood 002G","E01025706","Total",1671,301,81,220,1370,109,90,321,282,131,217,220
"2011","Charnwood 003A","E01025720","Total",1807,216,53,163,1591,51,74,163,220,51,45,987
"2011","Charnwood 003B","E01025721","Total",1621,154,88,66,1467,22,96,104,174,40,86,945
"2011","Charnwood 003C","E01025722","Total",1026,109,53,56,917,36,138,140,166,52,121,264
"2011","Charnwood 003D","E01025723","Total",1752,136,39,97,1616,66,88,207,230,33,155,837
"2011","Charnwood 003E","E01025724","Total",1542,132,37,95,1410,38,24,123,232,31,54,908
"2011","Charnwood 003F","E01025725","Total",1316,258,114,144,1058,93,118,162,194,99,168,224
"2011","Charnwood 004A","E01025695","Total",1492,186,54,132,1306,30,228,233,312,53,150,300
"2011","Charnwood 004B","E01025696","Total",1402,109,36,73,1293,23,154,327,232,83,200,274
"2011","Charnwood 004C","E01025697","Total",1318,324,198,126,994,52,210,132,212,18,97,273
"2011","Charnwood 004D","E01025698","Total",1554,176,80,96,1378,59,162,267,292,71,180,347
"2011","Charnwood 005A","E01025744","Total",1898,147,66,81,1751,62,242,466,362,96,156,367
"2011","Charnwood 005B","E01025745","Total",1430,170,78,92,1260,35,250,273,260,57,111,274
"2011","Charnwood 005C","E01025746","Total",1748,237,100,137,1511,125,210,341,292,68,192,283
"2011","Charnwood 005D","E01025747","Total",1830,233,105,128,1597,125,212,403,310,100,176,271
"2011","Charnwood 006A","E01025740","Total",1454,230,62,168,1224,106,182,265,292,41,77,261
"2011","Charnwood 006B","E01025741","Total",1529,168,62,106,1361,25,184,347,272,74,121,338
"2011","Charnwood 006C","E01025742","Total",1538,206,90,116,1332,98,180,297,240,122,152,243
"2011","Charnwood 006D","E01025743","Total",1794,248,71,177,1546,98,180,387,386,82,157,256
"2011","Charnwood 007A","E01025689","Total",1954,199,85,114,1755,86,182,225,266,111,247,638
"2011","Charnwood 007B","E01025690","Total",1444,144,40,104,1300,81,96,198,128,149,201,447
"2011","Charnwood 007C","E01025707","Total",1418,137,74,63,1281,21,208,275,158,75,135,409
"2011","Charnwood 007D","E01025709","Total",1249,100,55,45,1149,15,170,254,154,67,136,353
"2011","Charnwood 008A","E01025760","Total",1347,109,64,45,1238,34,198,355,242,58,132,219
"2011","Charnwood 008B","E01025761","Total",1789,154,73,81,1635,45,206,525,332,165,111,251
"2011","Charnwood 008C","E01025768","Total",1421,146,71,75,1275,32,222,292,232,86,171,240
"2011","Charnwood 008D","E01025769","Total",1466,106,53,53,1360,24,218,310,244,127,153,284
"2011","Charnwood 009A","E01025702","Total",1230,127,48,79,1103,35,176,212,252,42,94,292
"2011","Charnwood 009B","E01025715","Total",1522,151,58,93,1371,153,118,304,206,111,166,313
"2011","Charnwood 009C","E01025716","Total",1568,164,73,91,1404,98,158,323,176,147,166,336
"2011","Charnwood 009D","E01025717","Total",2200,172,46,126,2028,207,132,505,338,222,305,319
"2011","Charnwood 009E","E01025718","Total",1323,339,116,223,984,85,82,128,246,47,104,292
"2011","Charnwood 009F","E01025719","Total",1526,162,82,80,1364,30,168,259,212,94,178,423
"2011","Charnwood 010A","E01025708","Total",1265,102,63,39,1163,26,292,220,180,65,101,279
"2011","Charnwood 010B","E01025710","Total",1206,141,96,45,1065,11,194,266,168,85,129,212
"2011","Charnwood 010C","E01025711","Total",1573,151,115,36,1422,29,336,298,184,92,180,303
"2011","Charnwood 010D","E01025712","Total",1353,163,124,39,1190,26,310,259,172,30,140,253
"2011","Charnwood 010E","E01025713","Total",1232,113,68,45,1119,30,144,324,168,33,152,268
"2011","Charnwood 010F","E01025714","Total",2126,158,36,122,1968,71,96,653,360,178,231,379
"2011","Charnwood 011A","E01025674","Total",1517,173,79,94,1344,52,198,301,278,82,128,305
"2011","Charnwood 011B","E01025675","Total",1508,182,68,114,1326,65,240,345,290,40,93,253
"2011","Charnwood 011C","E01025676","Total",2126,186,76,110,1940,90,224,609,336,145,229,307
"2011","Charnwood 011D","E01025677","Total",1357,212,109,103,1145,52,176,308,216,41,175,177
"2011","Charnwood 012A","E01025732","Total",1569,164,53,111,1405,56,150,453,280,59,113,294
"2011","Charnwood 012B","E01025733","Total",1498,239,102,137,1259,56,250,300,296,71,103,183
"2011","Charnwood 012C","E01025734","Total",1545,160,101,59,1385,24,282,344,194,102,160,279
"2011","Charnwood 012D","E01025735","Total",1780,341,136,205,1439,75,192,369,380,93,72,258
"2011","Charnwood 013A","E01025748","Total",2126,272,74,198,1854,112,162,486,436,93,234,331
"2011","Charnwood 013B","E01025749","Total",1574,149,68,81,1425,113,200,285,198,115,185,329
"2011","Charnwood 013C","E01025750","Total",1421,151,69,82,1270,60,168,329,264,91,79,279
"2011","Charnwood 013D","E01025751","Total",2075,246,76,170,1829,120,164,498,434,132,163,318
"2011","Charnwood 014A","E01025726","Total",1846,227,48,179,1619,117,110,523,352,76,146,295
"2011","Charnwood 014B","E01025727","Total",1556,218,90,128,1338,151,134,309,252,65,183,244
"2011","Charnwood 014C","E01025728","Total",1847,166,90,76,1681,103,270,436,284,97,179,312
"2011","Charnwood 014D","E01025729","Total",1614,154,47,107,1460,65,198,426,280,92,126,273
"2011","Charnwood 014E","E01025737","Total",1865,196,81,115,1669,92,184,583,282,118,148,262
"2011","Charnwood 014F","E01025739","Total",1399,189,101,88,1210,31,280,228,298,59,139,175
"2011","Charnwood 015A","E01025685","Total",1349,123,65,58,1226,83,174,304,190,62,145,268
"2011","Charnwood 015B","E01025686","Total",1460,83,39,44,1377,35,138,356,250,82,189,327
"2011","Charnwood 015C","E01025730","Total",1488,185,86,99,1303,44,278,275,250,51,130,275
"2011","Charnwood 015D","E01025731","Total",1530,174,119,55,1356,27,280,236,204,74,182,353
"2011","Charnwood 016A","E01025687","Total",1575,166,96,70,1409,29,308,285,278,86,110,313
"2011","Charnwood 016B","E01025688","Total",1526,198,85,113,1328,52,194,355,258,88,129,252
"2011","Charnwood 016C","E01025736","Total",1460,139,94,45,1321,45,266,253,292,60,165,240
"2011","Charnwood 016D","E01025738","Total",1423,112,65,47,1311,25,240,276,234,92,163,281
"2011","Charnwood 017A","E01025756","Total",1871,287,82,205,1584,175,158,393,344,81,179,254
"2011","Charnwood 017B","E01025757","Total",1486,105,25,80,1381,107,78,357,252,71,219,297
"2011","Charnwood 017C","E01025758","Total",1767,130,59,71,1637,62,148,417,256,86,302,366
"2011","Charnwood 017D","E01025759","Total",1366,345,179,166,1021,52,216,198,202,56,90,207
"2011","Charnwood 018A","E01025752","Total",1951,193,92,101,1758,69,198,443,366,72,214,396
"2011","Charnwood 018B","E01025753","Total",1520,246,160,86,1274,136,166,280,214,95,92,291
"2011","Charnwood 018C","E01025754","Total",1270,106,49,57,1164,40,190,268,220,56,100,290
"2011","Charnwood 018D","E01025755","Total",1491,151,65,86,1340,47,208,348,226,50,153,308
"2011","Charnwood 019A","E01025679","Total",2501,231,132,99,2270,149,310,645,324,114,281,447
"2011","Charnwood 019B","E01025680","Total",1666,127,87,40,1539,47,290,400,198,88,151,365
"2011","Charnwood 019C","E01025681","Total",1579,163,100,63,1416,53,278,245,276,49,213,302
"2011","Charnwood 019D","E01025682","Total",1457,165,107,58,1292,34,320,213,216,31,158,320
"2011","Charnwood 020A","E01025678","Total",1735,142,81,61,1593,44,194,431,206,66,273,379
"2011","Charnwood 020B","E01025683","Total",1687,175,100,75,1512,98,172,381,212,93,223,333
"2011","Charnwood 020C","E01025684","Total",1878,217,118,99,1661,127,188,418,244,100,232,352
"2011","Charnwood 021A","E01025762","Total",1444,197,73,124,1247,86,198,278,244,65,114,262
"2011","Charnwood 021B","E01025763","Total",1620,234,108,126,1386,38,226,319,244,63,192,304
"2011","Charnwood 021C","E01025764","Total",1391,96,61,35,1295,47,196,231,122,71,218,410
"2011","Charnwood 021D","E01025765","Total",1604,126,71,55,1478,43,240,215,178,72,258,472
"2011","Charnwood 021E","E01025766","Total",2083,265,92,173,1818,135,144,435,326,188,258,332
"2011","Charnwood 021F","E01025767","Total",1467,178,77,101,1289,55,162,220,226,47,217,362
"2011","Charnwood 022A","E01025670","Total",1312,137,79,58,1175,64,188,271,188,36,187,241
"2011","Charnwood 022B","E01025671","Total",1847,194,85,109,1653,126,238,373,278,126,185,327
"2011","Charnwood 022C","E01025672","Total",1771,182,97,85,1589,99,234,382,296,70,150,358
"2011","Charnwood 022D","E01025673","Total",1591,301,153,148,1290,91,224,298,266,58,142,211
"2011","Harborough 002A","E01025770","Total",1863,217,92,125,1646,53,316,338,312,165,159,303
"2011","Harborough 002B","E01025809","Total",2275,223,104,119,2052,50,342,586,352,178,247,297
"2011","Harborough 002C","E01025815","Total",2030,222,82,140,1808,48,286,402,340,123,240,369
"2011","Harborough 003A","E01025781","Total",1572,133,52,81,1439,81,178,328,220,139,216,277
"2011","Harborough 003B","E01025782","Total",1303,228,144,84,1075,40,206,295,198,33,99,204
"2011","Harborough 003C","E01025783","Total",1483,133,66,67,1350,21,298,319,218,67,181,246
"2011","Harborough 003D","E01025785","Total",2125,260,99,161,1865,104,228,547,386,170,145,285
"2011","Harborough 003E","E01025786","Total",1592,210,143,67,1382,86,170,304,226,102,193,301
"2011","Harborough 003F","E01025787","Total",1654,193,98,95,1461,38,288,296,298,86,161,294
"2011","Harborough 004A","E01025772","Total",2324,175,52,123,2149,162,116,827,370,137,249,288
"2011","Harborough 004B","E01025773","Total",1512,66,18,48,1446,45,92,501,244,114,245,205
"2011","Harborough 004C","E01025774","Total",1328,63,26,37,1265,39,104,373,220,81,148,300
"2011","Harborough 004D","E01025775","Total",1772,230,126,104,1542,49,238,373,286,79,192,325
"2011","Harborough 004E","E01025776","Total",1971,157,66,91,1814,59,198,475,354,134,217,377
"2011","Harborough 005A","E01025771","Total",2508,225,92,133,2283,94,352,568,474,187,230,378
"2011","Harborough 005B","E01025778","Total",1946,219,90,129,1727,92,138,517,342,153,189,296
"2011","Harborough 005C","E01025779","Total",1609,141,55,86,1468,65,140,383,240,146,187,307
"2011","Harborough 005D","E01025780","Total",1332,98,49,49,1234,34,194,315,234,72,150,235
"2011","Harborough 005E","E01025784","Total",1330,115,60,55,1215,29,170,285,230,128,124,249
"2011","Harborough 005F","E01025788","Total",1157,91,48,43,1066,32,172,222,222,76,126,216
"2011","Harborough 006A","E01025777","Total",2200,214,103,111,1986,47,330,472,414,99,237,387
"2011","Harborough 006B","E01025808","Total",2559,238,110,128,2321,49,334,668,422,195,223,430
"2011","Harborough 006C","E01025810","Total",2333,184,100,84,2149,41,324,466,424,130,293,471
"2011","Harborough 006D","E01025816","Total",2238,170,80,90,2068,76,324,579,384,137,218,350
"2011","Harborough 007A","E01025789","Total",1096,127,52,75,969,33,148,245,212,59,92,180
"2011","Harborough 007B","E01025794","Total",1848,159,71,88,1689,42,204,484,298,149,221,291
"2011","Harborough 007C","E01025797","Total",1688,175,96,79,1513,71,290,402,262,97,128,263
"2011","Harborough 007D","E01025802","Total",1330,188,94,94,1142,32,306,276,206,30,107,185
"2011","Harborough 007E","E01025803","Total",1556,86,47,39,1470,23,200,415,278,137,171,246
"2011","Harborough 007F","E01025805","Total",1546,170,102,68,1376,34,282,306,244,119,118,273
"2011","Harborough 008A","E01025795","Total",1680,371,181,190,1309,50,252,311,274,59,111,252
"2011","Harborough 008B","E01025796","Total",1929,286,132,154,1643,107,188,410,348,127,160,303
"2011","Harborough 008C","E01025801","Total",1197,288,119,169,909,69,134,198,230,48,86,144
"2011","Harborough 008D","E01025806","Total",1509,272,162,110,1237,82,130,321,210,89,187,218
"2011","Harborough 009A","E01025798","Total",1764,288,148,140,1476,42,300,414,316,40,123,241
"2011","Harborough 009B","E01025799","Total",2137,77,13,64,2060,93,108,914,256,231,210,248
"2011","Harborough 009C","E01025800","Total",1154,169,46,123,985,47,132,282,276,53,79,116
"2011","Harborough 009D","E01025804","Total",1906,238,139,99,1668,70,344,396,302,130,158,268
"2011","Harborough 009E","E01025807","Total",1385,166,46,120,1219,96,80,350,306,85,153,149
"2011","Harborough 010A","E01025790","Total",2328,194,118,76,2134,68,300,581,360,171,235,419
"2011","Harborough 010B","E01025791","Total",2194,249,163,86,1945,87,376,410,338,156,218,360
"2011","Harborough 010C","E01025792","Total",2297,422,210,212,1875,82,300,455,406,124,153,355
"2011","Harborough 010D","E01025793","Total",2501,202,73,129,2299,113,284,564,424,173,322,419
"2011","Harborough 011A","E01025812","Total",1696,202,121,81,1494,82,282,335,262,78,178,277
"2011","Harborough 011B","E01025813","Total",1604,108,76,32,1496,22,290,348,168,77,270,321
"2011","Harborough 011C","E01025814","Total",1524,148,96,52,1376,33,276,300,200,98,178,291
"2011","Harborough 011D","E01032598","Total",2123,205,108,97,1918,61,304,397,314,148,243,451
"2011","Hinckley and Bosworth 001A","E01025868","Total",1467,207,118,89,1260,47,262,227,252,65,165,242
"2011","Hinckley and Bosworth 001B","E01025869","Total",1478,303,155,148,1175,67,226,224,286,46,94,232
"2011","Hinckley and Bosworth 001C","E01025870","Total",1462,144,98,46,1318,60,244,281,214,103,200,216
"2011","Hinckley and Bosworth 001D","E01025871","Total",1205,133,77,56,1072,49,160,240,250,20,121,232
"2011","Hinckley and Bosworth 001E","E01025878","Total",2605,235,99,136,2370,138,238,676,472,223,247,376
"2011","Hinckley and Bosworth 002A","E01025846","Total",2029,174,98,76,1855,67,292,494,326,105,198,373
"2011","Hinckley and Bosworth 002B","E01025847","Total",1658,134,32,102,1524,110,114,396,324,60,167,353
"2011","Hinckley and Bosworth 002C","E01025848","Total",1512,221,117,104,1291,54,292,253,280,66,104,242
"2011","Hinckley and Bosworth 003A","E01025845","Total",1597,147,94,53,1450,45,270,274,206,62,198,395
"2011","Hinckley and Bosworth 003B","E01025877","Total",1627,233,96,137,1394,116,174,372,306,101,119,206
"2011","Hinckley and Bosworth 003C","E01025879","Total",1246,148,77,71,1098,96,142,228,196,65,156,215
"2011","Hinckley and Bosworth 003D","E01025880","Total",1595,141,80,61,1454,68,172,449,264,89,124,288
"2011","Hinckley and Bosworth 004A","E01025819","Total",1650,192,87,105,1458,108,244,325,268,58,166,289
"2011","Hinckley and Bosworth 004B","E01025820","Total",1600,148,63,85,1452,74,146,369,320,68,155,320
"2011","Hinckley and Bosworth 004C","E01025837","Total",2013,192,74,118,1821,72,280,479,380,99,188,323
"2011","Hinckley and Bosworth 004D","E01025838","Total",1418,207,130,77,1211,13,306,247,264,48,99,234
"2011","Hinckley and Bosworth 004E","E01025882","Total",1631,171,72,99,1460,62,260,365,280,90,163,240
"2011","Hinckley and Bosworth 005A","E01025872","Total",1494,149,83,66,1345,24,314,206,282,47,119,353
"2011","Hinckley and Bosworth 005B","E01025873","Total",1563,140,61,79,1423,36,242,303,298,71,143,330
"2011","Hinckley and Bosworth 005C","E01025874","Total",1552,184,104,80,1368,82,260,236,250,82,160,298
"2011","Hinckley and Bosworth 005D","E01025875","Total",1506,222,118,104,1284,80,174,290,244,100,146,250
"2011","Hinckley and Bosworth 005E","E01025876","Total",1802,161,70,91,1641,54,264,401,360,114,165,283
"2011","Hinckley and Bosworth 006A","E01025839","Total",1615,187,51,136,1428,93,164,336,328,64,133,310
"2011","Hinckley and Bosworth 006B","E01025840","Total",1513,203,81,122,1310,70,202,240,316,71,99,312
"2011","Hinckley and Bosworth 006C","E01025841","Total",1700,202,118,84,1498,43,326,320,326,33,155,295
"2011","Hinckley and Bosworth 006D","E01025842","Total",1835,229,85,144,1606,183,140,425,298,198,123,239
"2011","Hinckley and Bosworth 006E","E01025843","Total",1573,246,80,166,1327,78,200,278,306,96,126,243
"2011","Hinckley and Bosworth 006F","E01025844","Total",1716,262,69,193,1454,186,134,256,292,156,222,208
"2011","Hinckley and Bosworth 007A","E01025821","Total",1654,298,75,223,1356,159,114,354,364,51,92,222
"2011","Hinckley and Bosworth 007B","E01025822","Total",1424,227,120,107,1197,131,168,204,244,77,94,279
"2011","Hinckley and Bosworth 007C","E01025823","Total",1551,156,64,92,1395,119,134,356,310,106,135,235
"2011","Hinckley and Bosworth 007D","E01025824","Total",1447,189,89,100,1258,93,164,215,262,72,177,275
"2011","Hinckley and Bosworth 007E","E01025825","Total",1454,153,61,92,1301,44,192,244,258,64,195,304
"2011","Hinckley and Bosworth 007F","E01025826","Total",1397,155,51,104,1242,48,120,338,274,70,151,241
"2011","Hinckley and Bosworth 008A","E01025817","Total",1964,202,97,105,1762,61,332,390,348,119,131,381
"2011","Hinckley and Bosworth 008B","E01025818","Total",1343,120,49,71,1223,57,206,227,252,97,117,267
"2011","Hinckley and Bosworth 008C","E01025864","Total",1591,152,56,96,1439,60,126,493,306,115,133,206
"2011","Hinckley and Bosworth 008D","E01025881","Total",1373,159,105,54,1214,21,298,225,256,86,92,236
"2011","Hinckley and Bosworth 009A","E01025859","Total",1383,136,75,61,1247,36,186,286,244,45,155,295
"2011","Hinckley and Bosworth 009B","E01025860","Total",1429,81,42,39,1348,29,128,378,286,41,103,383
"2011","Hinckley and Bosworth 009C","E01025861","Total",1679,219,92,127,1460,78,194,312,346,72,159,299
"2011","Hinckley and Bosworth 009D","E01025862","Total",1451,154,102,52,1297,50,354,231,266,30,105,261
"2011","Hinckley and Bosworth 010A","E01025850","Total",1369,214,91,123,1155,75,146,293,236,47,131,227
"2011","Hinckley and Bosworth 010B","E01025852","Total",1642,394,69,325,1248,137,112,364,328,46,86,175
"2011","Hinckley and Bosworth 010C","E01025858","Total",1807,362,85,277,1445,121,156,397,398,40,108,225
"2011","Hinckley and Bosworth 010D","E01025863","Total",1645,190,108,82,1455,83,232,360,282,86,147,265
"2011","Hinckley and Bosworth 010E","E01025865","Total",1765,231,89,142,1534,99,170,429,322,103,127,284
"2011","Hinckley and Bosworth 011A","E01025853","Total",2787,264,47,217,2523,200,206,828,588,157,194,350
"2011","Hinckley and Bosworth 011B","E01025854","Total",1749,155,50,105,1594,107,146,504,390,66,138,243
"2011","Hinckley and Bosworth 011C","E01025855","Total",1409,150,54,96,1259,105,122,318,286,51,116,261
"2011","Hinckley and Bosworth 011D","E01025866","Total",1582,233,80,153,1349,118,200,281,276,64,168,242
"2011","Hinckley and Bosworth 011E","E01025867","Total",1522,187,55,132,1335,63,168,337,314,79,131,243
"2011","Hinckley and Bosworth 012A","E01025849","Total",1633,306,105,201,1327,96,180,283,352,46,142,228
"2011","Hinckley and Bosworth 012B","E01025851","Total",1297,106,51,55,1191,49,208,307,198,76,102,251
"2011","Hinckley and Bosworth 012C","E01025856","Total",1292,287,143,144,1005,119,138,273,186,35,80,174
"2011","Hinckley and Bosworth 012D","E01025857","Total",1453,143,51,92,1310,50,118,384,300,62,109,287
"2011","Hinckley and Bosworth 013A","E01025827","Total",1408,267,187,80,1141,77,290,174,230,51,132,187
"2011","Hinckley and Bosworth 013B","E01025828","Total",1420,152,79,73,1268,36,308,267,208,63,131,255
"2011","Hinckley and Bosworth 013C","E01025829","Total",1442,236,119,117,1206,74,170,306,184,81,166,225
"2011","Hinckley and Bosworth 013D","E01025830","Total",1396,221,101,120,1175,91,226,368,230,47,74,139
"2011","Hinckley and Bosworth 014A","E01025831","Total",1292,209,98,111,1083,42,172,295,246,66,93,169
"2011","Hinckley and Bosworth 014B","E01025832","Total",1585,109,38,71,1476,48,158,459,290,82,116,323
"2011","Hinckley and Bosworth 014C","E01025833","Total",1603,177,83,94,1426,102,220,375,272,71,140,246
"2011","Hinckley and Bosworth 014D","E01025834","Total",1497,134,55,79,1363,42,176,402,296,66,164,217
"2011","Hinckley and Bosworth 014E","E01025835","Total",1583,191,128,63,1392,25,340,266,292,48,122,299
"2011","Hinckley and Bosworth 014F","E01025836","Total",1295,137,77,60,1158,42,194,241,252,45,126,258
"2011","Melton 001A","E01025885","Total",1831,147,88,59,1684,29,292,449,308,107,195,304
"2011","Melton 001B","E01025886","Total",1756,267,156,111,1489,52,328,434,254,45,120,256
"2011","Melton 001C","E01025887","Total",1803,211,91,120,1592,47,262,360,390,89,162,282
"2011","Melton 001D","E01025890","Total",1265,160,72,88,1105,64,168,262,196,88,111,216
"2011","Melton 001E","E01025891","Total",1312,133,64,69,1179,58,170,308,236,95,127,185
"2011","Melton 001F","E01025892","Total",1649,155,70,85,1494,38,178,496,280,103,186,213
"2011","Melton 002A","E01025901","Total",1697,262,171,91,1435,54,338,287,266,51,102,337
"2011","Melton 002B","E01025902","Total",1622,166,97,69,1456,32,312,340,316,51,158,247
"2011","Melton 002C","E01025903","Total",1750,297,74,223,1453,141,106,344,450,74,107,231
"2011","Melton 002D","E01025904","Total",2026,180,93,87,1846,73,332,571,354,152,143,221
"2011","Melton 002E","E01025906","Total",1755,110,44,66,1645,62,142,537,256,111,212,325
"2011","Melton 003A","E01025883","Total",1568,173,62,111,1395,82,232,258,362,64,99,298
"2011","Melton 003B","E01025884","Total",1718,228,109,119,1490,113,158,430,322,94,154,219
"2011","Melton 003C","E01025888","Total",1757,175,75,100,1582,19,272,375,352,70,212,282
"2011","Melton 003D","E01025909","Total",1896,200,97,103,1696,71,238,372,394,114,147,360
"2011","Melton 004A","E01025896","Total",1624,141,83,58,1483,63,242,309,264,105,206,294
"2011","Melton 004B","E01025897","Total",2026,338,142,196,1688,166,130,505,392,75,151,269
"2011","Melton 004C","E01025898","Total",1287,146,70,76,1141,77,130,249,218,122,135,210
"2011","Melton 004D","E01025899","Total",1089,168,31,137,921,64,66,214,214,67,103,193
"2011","Melton 004E","E01025900","Total",1499,169,87,82,1330,148,140,308,234,121,103,276
"2011","Melton 004F","E01025905","Total",1727,205,93,112,1522,175,190,295,254,161,184,263
"2011","Melton 005A","E01025893","Total",2067,191,101,90,1876,73,298,413,366,80,242,404
"2011","Melton 005B","E01025894","Total",1503,388,194,194,1115,79,196,184,294,71,148,143
"2011","Melton 005C","E01025895","Total",1712,225,57,168,1487,88,156,335,324,93,217,274
"2011","Melton 005D","E01025907","Total",1741,180,80,100,1561,130,178,304,238,138,222,351
"2011","Melton 005E","E01025908","Total",1741,175,83,92,1566,24,264,330,362,124,162,300
"2011","Melton 006A","E01025889","Total",1747,160,70,90,1587,22,302,328,320,125,163,327
"2011","Melton 006B","E01025910","Total",1719,205,95,110,1514,48,254,295,356,97,164,300
"2011","Melton 006C","E01025911","Total",1501,169,77,92,1332,49,202,326,314,77,97,267
"2011","Melton 006D","E01025912","Total",1528,178,66,112,1350,63,204,298,316,46,169,254
"2011","North West Leicestershire 001A","E01025924","Total",1029,118,50,68,911,51,124,212,228,43,89,164
"2011","North West Leicestershire 001B","E01025925","Total",2476,440,131,309,2036,94,280,596,526,46,176,318
"2011","North West Leicestershire 001C","E01025926","Total",1567,152,62,90,1415,59,204,339,290,98,158,267
"2011","North West Leicestershire 001D","E01025927","Total",1619,178,91,87,1441,130,236,258,212,107,189,309
"2011","North West Leicestershire 001E","E01025928","Total",1524,126,52,74,1398,33,194,439,288,67,112,265
"2011","North West Leicestershire 002A","E01025923","Total",1370,139,63,76,1231,35,234,281,266,83,98,234
"2011","North West Leicestershire 002B","E01025944","Total",1487,162,75,87,1325,40,210,365,256,71,105,278
"2011","North West Leicestershire 002C","E01025945","Total",1522,189,87,102,1333,51,212,265,284,83,103,335
"2011","North West Leicestershire 002D","E01025946","Total",1655,222,109,113,1433,80,168,296,278,93,120,398
"2011","North West Leicestershire 003A","E01025915","Total",1242,180,104,76,1062,17,176,289,204,83,80,213
"2011","North West Leicestershire 003B","E01025916","Total",1467,193,71,122,1274,58,154,344,316,48,95,259
"2011","North West Leicestershire 003C","E01025917","Total",2042,215,59,156,1827,127,204,586,362,144,131,273
"2011","North West Leicestershire 003D","E01025918","Total",1553,244,97,147,1309,128,132,322,266,100,166,195
"2011","North West Leicestershire 004A","E01025960","Total",1455,149,75,74,1306,33,222,270,284,95,106,296
"2011","North West Leicestershire 004B","E01025961","Total",1473,166,95,71,1307,57,246,258,276,71,113,286
"2011","North West Leicestershire 004C","E01025962","Total",1389,171,85,86,1218,90,184,212,218,93,133,288
"2011","North West Leicestershire 004D","E01025965","Total",1270,179,65,114,1091,27,176,242,272,41,79,254
"2011","North West Leicestershire 005A","E01025955","Total",1369,141,65,76,1228,29,246,260,212,134,127,220
"2011","North West Leicestershire 005B","E01025956","Total",1125,137,65,72,988,47,140,264,190,37,118,192
"2011","North West Leicestershire 005C","E01025963","Total",1538,143,61,82,1395,61,176,372,276,134,116,260
"2011","North West Leicestershire 005D","E01025964","Total",1652,159,78,81,1493,24,204,371,272,102,188,332
"2011","North West Leicestershire 006A","E01025914","Total",1386,97,56,41,1289,22,198,403,176,87,154,249
"2011","North West Leicestershire 006B","E01025919","Total",1446,151,84,67,1295,50,180,327,196,98,159,285
"2011","North West Leicestershire 006C","E01025920","Total",1624,181,104,77,1443,55,216,352,218,175,162,265
"2011","North West Leicestershire 006D","E01025921","Total",1577,229,135,94,1348,65,254,306,262,50,141,270
"2011","North West Leicestershire 007A","E01025966","Total",1557,167,99,68,1390,86,188,269,240,114,179,314
"2011","North West Leicestershire 007B","E01025967","Total",1652,190,134,56,1462,34,402,263,238,63,123,339
"2011","North West Leicestershire 007C","E01025968","Total",1852,187,79,108,1665,69,242,421,352,93,146,342
"2011","North West Leicestershire 007D","E01025969","Total",1780,291,119,172,1489,99,122,398,334,67,175,294
"2011","North West Leicestershire 008A","E01025950","Total",1683,240,112,128,1443,156,148,335,246,122,203,233
"2011","North West Leicestershire 008B","E01025951","Total",1769,150,65,85,1619,65,182,446,276,96,225,329
"2011","North West Leicestershire 008C","E01025952","Total",1450,171,106,65,1279,56,292,212,264,80,106,269
"2011","North West Leicestershire 008D","E01025953","Total",1121,121,65,56,1000,69,100,258,218,71,98,186
"2011","North West Leicestershire 008E","E01025954","Total",1516,152,46,106,1364,76,132,432,244,104,129,247
"2011","North West Leicestershire 009A","E01025932","Total",1454,134,61,73,1320,97,98,243,160,182,208,332
"2011","North West Leicestershire 009B","E01025933","Total",1352,103,44,59,1249,73,166,261,240,66,146,297
"2011","North West Leicestershire 009C","E01025934","Total",1576,199,50,149,1377,188,116,271,206,159,190,247
"2011","North West Leicestershire 009D","E01025935","Total",1172,144,102,42,1028,26,308,153,212,31,74,224
"2011","North West Leicestershire 009E","E01025936","Total",1262,183,138,45,1079,54,218,176,180,85,153,213
"2011","North West Leicestershire 010A","E01025929","Total",2106,212,68,144,1894,91,142,471,346,165,320,359
"2011","North West Leicestershire 010B","E01025930","Total",1584,266,63,203,1318,127,136,312,260,101,115,267
"2011","North West Leicestershire 010C","E01025931","Total",1734,272,98,174,1462,113,144,372,318,62,130,323
"2011","North West Leicestershire 010D","E01025957","Total",1846,235,77,158,1611,155,114,480,294,145,171,252
"2011","North West Leicestershire 011B","E01025937","Total",1565,185,73,112,1380,78,178,333,302,97,155,237
"2011","North West Leicestershire 011C","E01025958","Total",1622,149,54,95,1473,73,152,399,284,105,184,276
"2011","North West Leicestershire 011D","E01025959","Total",2116,215,119,96,1901,88,278,443,348,150,187,407
"2011","North West Leicestershire 011E","E01033102","Total",1621,155,39,116,1466,86,88,541,336,92,136,187
"2011","North West Leicestershire 011F","E01033103","Total",1752,105,38,67,1647,63,126,529,310,84,257,278
"2011","North West Leicestershire 012A","E01025913","Total",2204,223,114,109,1981,52,324,512,392,129,209,363
"2011","North West Leicestershire 012B","E01025947","Total",1799,181,101,80,1618,55,278,323,306,97,153,406
"2011","North West Leicestershire 012C","E01025948","Total",1736,156,50,106,1580,122,114,493,282,133,208,228
"2011","North West Leicestershire 012D","E01025949","Total",1674,233,89,144,1441,136,204,302,236,128,178,257
"2011","North West Leicestershire 013A","E01025938","Total",1239,140,69,71,1099,32,130,301,270,61,107,198
"2011","North West Leicestershire 013B","E01025939","Total",1977,194,65,129,1783,93,174,500,356,170,214,276
"2011","North West Leicestershire 013C","E01025940","Total",1957,235,98,137,1722,95,220,516,336,115,152,288
"2011","North West Leicestershire 013D","E01025941","Total",1512,136,64,72,1376,49,246,284,278,81,173,265
"2011","North West Leicestershire 013E","E01025942","Total",1782,126,61,65,1656,58,194,414,338,66,214,372
"2011","North West Leicestershire 013F","E01025943","Total",1818,276,127,149,1542,157,228,331,258,113,166,289
"2011","Oadby and Wigston 003A","E01025970","Total",1414,88,61,27,1326,17,216,241,138,87,272,355
"2011","Oadby and Wigston 003B","E01025971","Total",1226,127,102,25,1099,37,164,163,128,63,230,314
"2011","Oadby and Wigston 003C","E01025972","Total",1228,95,63,32,1133,35,188,229,114,71,179,317
"2011","Oadby and Wigston 003D","E01025976","Total",1352,195,125,70,1157,54,194,191,148,109,206,255
"2011","Oadby and Wigston 003E","E01025977","Total",1333,223,152,71,1110,31,210,197,200,71,153,248
"2011","Oadby and Wigston 003F","E01025978","Total",1510,236,114,122,1274,59,214,188,242,73,179,319
"2011","Oadby and Wigston 005A","E01025992","Total",1465,322,174,148,1143,106,190,264,246,25,106,206
"2011","Oadby and Wigston 005B","E01025994","Total",1536,143,84,59,1393,99,148,263,168,162,250,303
"2011","Oadby and Wigston 005C","E01025997","Total",1447,165,104,61,1282,70,134,271,174,107,182,344
"2011","Oadby and Wigston 005D","E01025999","Total",1426,193,64,129,1233,133,162,305,222,74,121,216
"2011","Oadby and Wigston 005E","E01026005","Total",1670,226,139,87,1444,43,248,288,244,76,213,332
"2011","Oadby and Wigston 006A","E01025985","Total",1312,168,132,36,1144,21,354,155,130,55,95,334
"2011","Oadby and Wigston 006B","E01025986","Total",1409,151,101,50,1258,32,300,252,200,47,132,295
"2011","Oadby and Wigston 006C","E01025987","Total",1441,220,71,149,1221,143,82,316,236,90,159,195
"2011","Oadby and Wigston 006D","E01025988","Total",1567,218,44,174,1349,147,70,450,272,71,156,183
"2011","Oadby and Wigston 006E","E01025989","Total",1644,261,77,184,1383,112,126,367,300,100,133,245
"2011","Oadby and Wigston 007A","E01025990","Total",1352,171,109,62,1181,22,256,214,186,36,140,327
"2011","Oadby and Wigston 007B","E01025991","Total",1475,95,55,40,1380,52,252,266,228,58,225,299
"2011","Oadby and Wigston 007C","E01025993","Total",1503,98,74,24,1405,49,268,305,196,127,152,308
"2011","Oadby and Wigston 007D","E01025998","Total",1766,178,54,124,1588,58,160,378,384,116,128,364
"2011","Oadby and Wigston 007E","E01026000","Total",1321,105,46,59,1216,22,208,264,224,57,150,291
"2011","Oadby and Wigston 007F","E01026001","Total",1379,154,76,78,1225,42,184,247,252,70,128,302
"2011","Oadby and Wigston 008A","E01025995","Total",1495,145,89,56,1350,36,228,254,148,99,255,330
"2011","Oadby and Wigston 008B","E01026003","Total",1603,174,109,65,1429,41,262,305,164,71,229,357
"2011","Oadby and Wigston 008C","E01026004","Total",1731,142,88,54,1589,23,284,343,240,122,183,394
"2011","Oadby and Wigston 008D","E01032600","Total",1954,211,129,82,1743,46,308,371,226,128,234,430
"2011","Oadby and Wigston 008E","E01032601","Total",1453,120,78,42,1333,28,226,326,172,35,216,330
"2011","Oadby and Wigston 009A","E01025973","Total",1742,54,39,15,1688,11,132,96,90,98,691,570
"2011","Oadby and Wigston 009B","E01025974","Total",1476,141,61,80,1335,78,128,384,204,61,206,274
"2011","Oadby and Wigston 009C","E01025975","Total",1471,97,73,24,1374,16,212,313,96,58,367,312
"2011","Oadby and Wigston 009E","E01025979","Total",1400,94,57,37,1306,52,154,298,140,82,289,291
"2011","Oadby and Wigston 009D","E01025980","Total",1399,86,65,21,1313,30,146,168,74,55,415,425
"2011","Oadby and Wigston 009F","E01025981","Total",1624,135,84,51,1489,37,176,284,160,88,347,397
"2011","Oadby and Wigston 009G","E01025982","Total",1934,52,16,36,1882,46,100,517,244,133,449,393
"2011","Oadby and Wigston 009H","E01025983","Total",1226,127,66,61,1099,44,114,236,168,44,246,247
"2011","Oadby and Wigston 009I","E01025984","Total",1481,78,56,22,1403,29,138,261,138,88,424,325
"2011","Boston 001A","E01026007","Total",1106,112,66,46,994,26,212,226,190,36,95,209
"2011","Boston 001B","E01026008","Total",1171,131,75,56,1040,30,252,197,236,37,95,193
"2011","Boston 001C","E01026009","Total",1269,113,65,48,1156,37,216,212,206,64,181,240
"2011","Boston 001D","E01026023","Total",1375,136,84,52,1239,55,274,181,248,48,137,296
"2011","Boston 001E","E01026024","Total",2022,190,128,62,1832,82,334,353,310,175,211,367
"2011","Boston 002A","E01026010","Total",1478,221,92,129,1257,125,70,372,180,78,216,216
"2011","Boston 002B","E01026011","Total",2990,257,89,168,2733,248,194,618,388,203,554,528
"2011","Boston 002C","E01026030","Total",2176,394,201,193,1782,190,226,327,256,117,294,372
"2011","Boston 002D","E01026032","Total",2031,225,102,123,1806,88,178,363,238,79,438,422
"2011","Boston 002E","E01026037","Total",1322,243,110,133,1079,109,110,171,180,106,188,215
"2011","Boston 003A","E01026006","Total",2540,431,95,336,2109,178,120,443,486,54,380,448
"2011","Boston 003B","E01026021","Total",1730,243,128,115,1487,45,262,329,272,80,200,299
"2011","Boston 003C","E01026025","Total",2127,368,74,294,1759,177,116,455,398,36,249,328
"2011","Boston 003D","E01026036","Total",1581,238,69,169,1343,61,112,228,266,67,206,403
"2011","Boston 004A","E01026012","Total",1150,185,134,51,965,82,256,179,152,50,107,139
"2011","Boston 004B","E01026015","Total",1447,182,50,132,1265,96,128,407,326,36,108,164
"2011","Boston 004C","E01026026","Total",1954,285,165,120,1669,179,186,325,218,176,234,351
"2011","Boston 004D","E01026027","Total",1836,208,89,119,1628,109,204,365,286,89,222,353
"2011","Boston 004E","E01026028","Total",1800,333,192,141,1467,88,238,294,278,79,207,283
"2011","Boston 006A","E01026016","Total",2312,237,122,115,2075,90,414,402,426,139,247,357
"2011","Boston 006B","E01026033","Total",1987,150,63,87,1837,85,324,344,356,124,267,337
"2011","Boston 006C","E01026034","Total",1786,230,126,104,1556,55,316,375,292,72,170,276
"2011","Boston 007A","E01026017","Total",1571,184,109,75,1387,71,262,211,310,74,180,279
"2011","Boston 007B","E01026018","Total",1646,151,85,66,1495,45,354,251,360,30,188,267
"2011","Boston 007C","E01026019","Total",2754,331,186,145,2423,202,324,621,388,155,318,415
"2011","Boston 007D","E01026020","Total",2195,218,98,120,1977,119,342,462,388,90,248,328
"2011","Boston 007E","E01026041","Total",1300,228,150,78,1072,86,210,213,172,77,111,203
"2011","Boston 008A","E01026013","Total",1446,160,103,57,1286,17,250,311,254,56,105,293
"2011","Boston 008B","E01026014","Total",1904,186,105,81,1718,96,274,453,334,66,226,269
"2011","Boston 008C","E01026022","Total",2071,187,126,61,1884,62,460,430,284,95,227,326
"2011","Boston 008D","E01026038","Total",1256,160,72,88,1096,51,186,251,278,32,97,201
"2011","Boston 008E","E01026040","Total",1242,108,54,54,1134,43,162,284,198,72,135,240
"2011","Boston 009A","E01026029","Total",2517,210,99,111,2307,128,296,668,442,136,255,382
"2011","Boston 009B","E01026031","Total",1387,146,100,46,1241,35,310,204,274,25,147,246
"2011","Boston 009C","E01026035","Total",2063,188,123,65,1875,59,372,403,376,52,228,385
"2011","Boston 009D","E01026039","Total",1194,107,65,42,1087,27,220,259,176,59,98,248
"2011","East Lindsey 001A","E01026045","Total",1813,257,152,105,1556,38,422,274,338,52,142,290
"2011","East Lindsey 001B","E01026061","Total",1201,101,58,43,1100,53,210,219,228,37,100,253
"2011","East Lindsey 001C","E01026062","Total",1227,147,64,83,1080,75,168,311,162,60,92,212
"2011","East Lindsey 001D","E01026063","Total",1263,130,79,51,1133,34,280,216,220,43,74,266
"2011","East Lindsey 001E","E01026080","Total",1933,209,122,87,1724,56,380,293,362,70,189,374
"2011","East Lindsey 001F","E01026106","Total",1164,117,62,55,1047,41,212,237,222,49,86,200
"2011","East Lindsey 001G","E01026107","Total",1177,111,43,68,1066,24,138,223,244,73,152,212
"2011","East Lindsey 002A","E01026058","Total",2181,191,100,91,1990,66,396,441,412,120,215,340
"2011","East Lindsey 002B","E01026076","Total",2194,212,120,92,1982,54,404,340,444,126,212,402
"2011","East Lindsey 002C","E01026079","Total",1963,195,115,80,1768,62,416,343,310,82,214,341
"2011","East Lindsey 003A","E01026077","Total",1133,155,94,61,978,80,180,212,168,47,124,167
"2011","East Lindsey 003B","E01026078","Total",1107,138,69,69,969,37,134,237,192,81,142,146
"2011","East Lindsey 003C","E01026087","Total",1183,135,65,70,1048,121,112,298,174,151,57,135
"2011","East Lindsey 003D","E01026088","Total",1255,125,73,52,1130,43,252,266,240,64,97,168
"2011","East Lindsey 003E","E01026090","Total",1307,190,81,109,1117,60,242,235,220,64,86,210
"2011","East Lindsey 003F","E01026091","Total",1080,123,71,52,957,26,170,238,220,31,96,176
"2011","East Lindsey 003G","E01026108","Total",2404,330,116,214,2074,226,270,484,378,170,230,316
"2011","East Lindsey 004A","E01026081","Total",2325,490,193,297,1835,132,256,482,436,89,134,306
"2011","East Lindsey 004C","E01026089","Total",1987,354,163,191,1633,91,350,304,358,108,146,276
"2011","East Lindsey 004D","E01032986","Total",1106,276,93,183,830,82,118,178,238,47,63,104
"2011","East Lindsey 004E","E01032987","Total",1279,244,104,140,1035,111,134,254,300,42,59,135
"2011","East Lindsey 005A","E01026072","Total",1863,298,163,135,1565,82,454,266,256,82,147,278
"2011","East Lindsey 005B","E01026073","Total",1975,343,194,149,1632,104,408,229,304,101,225,261
"2011","East Lindsey 005C","E01026074","Total",2010,298,180,118,1712,63,560,195,356,96,190,252
"2011","East Lindsey 005D","E01026099","Total",2042,211,122,89,1831,97,440,282,348,96,207,361
"2011","East Lindsey 006A","E01026103","Total",1965,361,251,110,1604,78,618,167,304,53,174,210
"2011","East Lindsey 006B","E01026104","Total",2264,286,214,72,1978,85,784,247,374,83,170,235
"2011","East Lindsey 006C","E01026109","Total",2156,449,221,228,1707,52,646,146,376,75,143,269
"2011","East Lindsey 007A","E01026071","Total",2127,242,109,133,1885,79,424,329,466,110,178,299
"2011","East Lindsey 007B","E01026082","Total",2230,241,149,92,1989,58,554,310,410,83,198,376
"2011","East Lindsey 007C","E01026121","Total",2463,324,171,153,2139,65,488,423,406,149,244,364
"2011","East Lindsey 008A","E01026042","Total",1502,207,98,109,1295,127,198,292,244,100,116,218
"2011","East Lindsey 008B","E01026043","Total",1607,213,126,87,1394,125,286,275,252,115,111,230
"2011","East Lindsey 008C","E01026044","Total",1337,155,100,55,1182,24,304,204,196,58,138,258
"2011","East Lindsey 008D","E01026113","Total",2020,222,130,92,1798,52,460,223,368,137,231,327
"2011","East Lindsey 008E","E01026117","Total",1795,199,107,92,1596,24,374,295,308,73,175,347
"2011","East Lindsey 009A","E01026060","Total",1275,132,77,55,1143,27,298,153,266,53,133,213
"2011","East Lindsey 009B","E01026068","Total",2090,250,118,132,1840,55,414,317,432,110,214,298
"2011","East Lindsey 009C","E01026070","Total",1891,201,98,103,1690,40,376,346,364,72,118,374
"2011","East Lindsey 009D","E01026105","Total",2162,239,122,117,1923,48,474,348,412,94,209,338
"2011","East Lindsey 010A","E01026048","Total",1486,251,135,116,1235,70,408,147,266,31,80,233
"2011","East Lindsey 010B","E01026049","Total",1537,217,114,103,1320,39,370,215,292,54,128,222
"2011","East Lindsey 010C","E01026050","Total",1601,226,174,52,1375,62,512,109,332,30,123,207
"2011","East Lindsey 010D","E01026069","Total",1989,325,184,141,1664,123,456,185,426,58,177,239
"2011","East Lindsey 011A","E01026064","Total",1455,224,92,132,1231,103,182,284,240,75,141,206
"2011","East Lindsey 011B","E01026065","Total",1763,251,154,97,1512,32,424,397,308,41,121,189
"2011","East Lindsey 011C","E01026066","Total",1892,246,143,103,1646,88,478,364,320,51,113,232
"2011","East Lindsey 011D","E01026067","Total",1874,407,178,229,1467,76,232,374,302,87,167,229
"2011","East Lindsey 012A","E01026084","Total",1550,218,108,110,1332,87,220,312,214,65,188,246
"2011","East Lindsey 012B","E01026085","Total",2192,324,194,130,1868,122,620,272,436,78,54,286
"2011","East Lindsey 012C","E01026115","Total",1684,265,145,120,1419,102,362,236,294,87,155,183
"2011","East Lindsey 012D","E01026116","Total",1670,197,89,108,1473,91,220,268,300,115,194,285
"2011","East Lindsey 013A","E01026046","Total",1135,154,83,71,981,55,238,192,212,45,90,149
"2011","East Lindsey 013B","E01026047","Total",1190,177,115,62,1013,35,360,160,198,15,58,187
"2011","East Lindsey 013C","E01026055","Total",1117,116,75,41,1001,6,244,186,216,50,128,171
"2011","East Lindsey 013D","E01026059","Total",1081,98,64,34,983,18,218,126,198,85,151,187
"2011","East Lindsey 013E","E01026100","Total",1782,258,109,149,1524,150,218,430,300,97,133,196
"2011","East Lindsey 013F","E01026101","Total",1210,244,139,105,966,93,174,223,170,68,87,151
"2011","East Lindsey 014A","E01026092","Total",1407,231,71,160,1176,96,118,278,228,64,175,217
"2011","East Lindsey 014B","E01026093","Total",1628,427,124,303,1201,117,134,249,266,57,158,220
"2011","East Lindsey 014C","E01026095","Total",1078,164,65,99,914,62,124,195,170,50,145,168
"2011","East Lindsey 014D","E01026114","Total",1416,335,140,195,1081,89,168,231,232,52,101,208
"2011","East Lindsey 015A","E01026083","Total",1770,292,128,164,1478,126,214,309,232,157,208,232
"2011","East Lindsey 015B","E01026094","Total",1668,306,182,124,1362,122,322,238,318,75,131,156
"2011","East Lindsey 015C","E01026096","Total",1462,157,79,78,1305,42,208,382,222,98,157,196
"2011","East Lindsey 015D","E01026097","Total",1487,320,191,129,1167,67,342,150,220,41,135,212
"2011","East Lindsey 016A","E01026051","Total",1244,125,53,72,1119,32,212,234,212,66,100,263
"2011","East Lindsey 016B","E01026052","Total",1496,143,65,78,1353,59,246,453,292,60,97,146
"2011","East Lindsey 016C","E01026053","Total",2042,131,46,85,1911,172,156,709,312,189,130,243
"2011","East Lindsey 016D","E01026054","Total",1597,254,120,134,1343,91,174,327,288,73,185,205
"2011","East Lindsey 016E","E01026118","Total",1682,199,137,62,1483,47,522,297,262,79,98,178
"2011","East Lindsey 016F","E01026119","Total",1076,137,96,41,939,23,346,160,144,44,86,136
"2011","East Lindsey 016G","E01026120","Total",1404,226,137,89,1178,80,286,208,216,74,149,165
"2011","East Lindsey 017A","E01026056","Total",1171,94,58,36,1077,31,232,188,192,64,164,206
"2011","East Lindsey 017B","E01026110","Total",1439,168,107,61,1271,77,302,196,268,30,172,226
"2011","East Lindsey 017C","E01026111","Total",1563,149,83,66,1414,63,276,278,262,91,182,262
"2011","East Lindsey 017D","E01026112","Total",1149,164,82,82,985,117,114,176,192,99,125,162
"2011","East Lindsey 018A","E01026057","Total",1920,186,95,91,1734,40,374,290,370,85,193,382
"2011","East Lindsey 018B","E01026075","Total",2123,228,132,96,1895,34,434,363,392,64,226,382
"2011","East Lindsey 018C","E01026098","Total",1979,240,145,95,1739,77,400,338,336,105,183,300
"2011","East Lindsey 018D","E01026102","Total",2335,204,115,89,2131,80,366,402,412,144,297,430
"2011","Lincoln 001A","E01026149","Total",1631,312,108,204,1319,141,150,338,298,52,108,232
"2011","Lincoln 001B","E01026150","Total",1418,384,128,256,1034,152,140,292,204,47,71,128
"2011","Lincoln 001C","E01026166","Total",1194,178,90,88,1016,109,132,189,194,71,150,171
"2011","Lincoln 001D","E01026168","Total",1422,198,68,130,1224,203,134,247,188,105,140,207
"2011","Lincoln 002A","E01026153","Total",2392,362,129,233,2030,144,226,451,548,146,218,297
"2011","Lincoln 002B","E01026155","Total",1611,229,55,174,1382,64,140,373,418,41,142,204
"2011","Lincoln 002C","E01026157","Total",1335,222,96,126,1113,155,220,227,212,71,73,155
"2011","Lincoln 002D","E01026165","Total",1376,332,159,173,1044,105,178,236,202,63,61,199
"2011","Lincoln 003A","E01026125","Total",1070,173,47,126,897,71,82,240,226,42,65,171
"2011","Lincoln 003B","E01026144","Total",1500,208,63,145,1292,38,70,191,274,82,75,562
"2011","Lincoln 003C","E01026147","Total",2255,298,95,203,1957,72,202,557,594,65,130,337
"2011","Lincoln 003D","E01026148","Total",1753,437,152,285,1316,105,162,176,420,43,62,348
"2011","Lincoln 003E","E01026151","Total",1832,295,116,179,1537,79,194,349,378,103,161,273
"2011","Lincoln 003F","E01026164","Total",1243,164,98,66,1079,31,220,234,240,47,153,154
"2011","Lincoln 003G","E01026167","Total",1460,338,148,190,1122,28,274,174,314,41,90,201
"2011","Lincoln 004A","E01026122","Total",1547,287,74,213,1260,63,74,259,414,40,89,321
"2011","Lincoln 004B","E01026123","Total",2291,338,77,261,1953,200,138,468,478,128,269,272
"2011","Lincoln 004C","E01026124","Total",1527,189,44,145,1338,111,74,271,306,65,117,394
"2011","Lincoln 004D","E01026126","Total",1607,429,100,329,1178,68,96,195,346,45,111,317
"2011","Lincoln 004E","E01026152","Total",1543,141,53,88,1402,226,82,312,152,175,237,218
"2011","Lincoln 004F","E01026154","Total",1408,117,60,57,1291,91,98,221,186,122,274,299
"2011","Lincoln 004G","E01026156","Total",1263,97,49,48,1166,128,104,271,154,102,164,243
"2011","Lincoln 005A","E01026132","Total",1305,426,98,328,879,61,60,120,398,11,45,184
"2011","Lincoln 005B","E01026143","Total",1636,264,43,221,1372,38,80,177,346,33,82,616
"2011","Lincoln 005C","E01026145","Total",1521,188,50,138,1333,48,106,229,274,42,113,521
"2011","Lincoln 005D","E01026146","Total",1577,322,136,186,1255,54,56,95,242,31,29,748
"2011","Lincoln 006A","E01026134","Total",1484,349,119,230,1135,86,92,278,298,77,67,237
"2011","Lincoln 006B","E01026176","Total",1656,467,70,397,1189,86,58,202,354,10,137,342
"2011","Lincoln 006C","E01026177","Total",1855,224,48,176,1631,137,62,334,370,36,148,544
"2011","Lincoln 006D","E01026178","Total",1634,309,81,228,1325,111,114,252,304,36,144,364
"2011","Lincoln 007A","E01026127","Total",1386,235,97,138,1151,201,90,267,218,81,110,184
"2011","Lincoln 007B","E01026128","Total",2646,351,113,238,2295,208,246,621,572,151,205,292
"2011","Lincoln 007C","E01026129","Total",1771,196,36,160,1575,293,42,418,254,208,191,169
"2011","Lincoln 007D","E01026131","Total",1389,170,78,92,1219,107,182,242,204,109,99,276
"2011","Lincoln 008A","E01026133","Total",2164,347,90,257,1817,147,160,383,432,116,166,413
"2011","Lincoln 008B","E01026135","Total",1631,161,91,70,1470,31,220,356,304,87,192,280
"2011","Lincoln 008C","E01026136","Total",1434,156,98,58,1278,42,238,295,236,57,149,261
"2011","Lincoln 008D","E01026174","Total",1334,212,38,174,1122,102,72,251,274,63,128,232
"2011","Lincoln 009A","E01026130","Total",1312,142,64,78,1170,49,282,221,258,56,76,228
"2011","Lincoln 009B","E01026158","Total",1431,184,103,81,1247,39,258,280,270,70,100,230
"2011","Lincoln 009C","E01026159","Total",1452,199,66,133,1253,111,92,318,326,81,127,198
"2011","Lincoln 009D","E01026160","Total",1352,174,71,103,1178,62,156,306,308,51,129,166
"2011","Lincoln 009E","E01026162","Total",1430,165,76,89,1265,57,218,272,246,86,119,267
"2011","Lincoln 009F","E01026163","Total",1362,146,35,111,1216,71,128,326,354,21,100,216
"2011","Lincoln 010A","E01026161","Total",1339,288,120,168,1051,123,136,220,256,39,62,215
"2011","Lincoln 010B","E01026170","Total",1449,154,70,84,1295,145,144,240,222,97,187,260
"2011","Lincoln 010C","E01026172","Total",1423,186,71,115,1237,92,112,307,168,133,172,253
"2011","Lincoln 010D","E01026173","Total",1562,290,80,210,1272,204,110,301,152,198,137,170
"2011","Lincoln 010E","E01026175","Total",1780,373,63,310,1407,148,96,434,344,39,142,204
"2011","Lincoln 011A","E01026137","Total",1192,92,42,50,1100,34,106,330,196,62,120,252
"2011","Lincoln 011B","E01026138","Total",1479,157,70,87,1322,20,164,316,304,92,145,281
"2011","Lincoln 011C","E01026139","Total",1180,100,68,32,1080,40,218,217,210,36,116,243
"2011","Lincoln 011D","E01026140","Total",1260,257,85,172,1003,111,92,233,256,77,88,146
"2011","Lincoln 011E","E01026141","Total",1452,118,58,60,1334,47,136,421,216,94,177,243
"2011","Lincoln 011F","E01026142","Total",1269,120,54,66,1149,124,108,187,210,37,209,274
"2011","Lincoln 011G","E01026169","Total",1628,256,152,104,1372,58,286,187,270,85,209,277
"2011","Lincoln 011H","E01026171","Total",1427,190,136,54,1237,29,300,228,282,52,75,271
"2011","North Kesteven 001A","E01026186","Total",1556,161,98,63,1395,41,328,268,310,41,146,261
"2011","North Kesteven 001B","E01026187","Total",1932,146,39,107,1786,98,120,594,370,142,166,296
"2011","North Kesteven 001C","E01026189","Total",1753,204,122,82,1549,54,424,333,334,55,75,274
"2011","North Kesteven 001D","E01026203","Total",1745,223,138,85,1522,49,402,335,270,35,139,292
"2011","North Kesteven 001E","E01026204","Total",1665,180,103,77,1485,32,378,293,312,55,158,257
"2011","North Kesteven 001F","E01026206","Total",1892,202,102,100,1690,63,214,445,326,103,225,314
"2011","North Kesteven 003B","E01026182","Total",1399,131,60,71,1268,63,178,353,274,66,150,184
"2011","North Kesteven 003C","E01026193","Total",1402,148,71,77,1254,66,238,251,312,68,111,208
"2011","North Kesteven 003D","E01026199","Total",2275,220,107,113,2055,56,396,502,412,118,224,347
"2011","North Kesteven 003E","E01026225","Total",1606,182,69,113,1424,84,158,449,284,66,180,203
"2011","North Kesteven 003F","E01026226","Total",1775,208,145,63,1567,24,444,247,340,54,139,319
"2011","North Kesteven 003G","E01032990","Total",2346,176,13,163,2170,155,58,795,576,202,212,172
"2011","North Kesteven 003H","E01032994","Total",1295,143,59,84,1152,65,130,332,276,36,105,208
"2011","North Kesteven 004A","E01026184","Total",1487,58,34,24,1429,51,68,659,218,184,115,134
"2011","North Kesteven 004B","E01026185","Total",1734,274,168,106,1460,55,338,283,272,47,205,260
"2011","North Kesteven 004C","E01026188","Total",2168,399,199,200,1769,118,248,555,394,101,154,199
"2011","North Kesteven 004D","E01026190","Total",1450,197,119,78,1253,74,258,309,192,72,95,253
"2011","North Kesteven 004E","E01026237","Total",1101,127,71,56,974,69,206,166,202,23,92,216
"2011","North Kesteven 004F","E01026238","Total",1343,101,57,44,1242,43,146,338,250,90,144,231
"2011","North Kesteven 005A","E01026191","Total",1689,150,74,76,1539,95,224,385,308,131,158,238
"2011","North Kesteven 005B","E01026205","Total",1434,214,139,75,1220,83,264,228,236,114,87,208
"2011","North Kesteven 005C","E01026211","Total",1843,126,54,72,1717,63,226,430,438,115,176,269
"2011","North Kesteven 005D","E01026212","Total",1577,142,81,61,1435,117,250,332,306,71,137,222
"2011","North Kesteven 005E","E01026213","Total",1664,269,167,102,1395,56,348,262,276,78,127,248
"2011","North Kesteven 006A","E01026192","Total",1169,115,51,64,1054,41,180,255,240,62,102,174
"2011","North Kesteven 006B","E01026194","Total",1840,200,114,86,1640,104,354,435,306,84,113,244
"2011","North Kesteven 006C","E01026195","Total",1930,185,90,95,1745,75,328,430,370,124,176,242
"2011","North Kesteven 006D","E01026196","Total",1466,180,96,84,1286,78,264,272,268,77,120,207
"2011","North Kesteven 007A","E01026180","Total",1437,137,61,76,1300,46,238,289,274,119,103,231
"2011","North Kesteven 007B","E01026183","Total",2519,302,154,148,2217,139,450,441,426,159,266,336
"2011","North Kesteven 007C","E01026210","Total",2223,223,116,107,2000,74,380,368,486,133,238,321
"2011","North Kesteven 007D","E01026224","Total",1712,256,146,110,1456,126,242,287,236,127,189,249
"2011","North Kesteven 008A","E01026179","Total",1175,82,29,53,1093,26,78,450,202,123,111,103
"2011","North Kesteven 008B","E01026197","Total",1372,161,60,101,1211,67,230,251,270,61,122,210
"2011","North Kesteven 008C","E01026198","Total",1279,47,6,41,1232,53,30,583,266,136,75,89
"2011","North Kesteven 008D","E01026223","Total",2089,215,121,94,1874,74,388,397,376,88,214,337
"2011","North Kesteven 009A","E01026209","Total",2080,265,172,93,1815,69,520,330,338,67,169,322
"2011","North Kesteven 009B","E01026221","Total",2321,285,132,153,2036,96,400,421,474,145,227,273
"2011","North Kesteven 009C","E01026222","Total",1820,210,119,91,1610,71,448,310,294,86,187,214
"2011","North Kesteven 010A","E01026227","Total",1392,374,141,233,1018,75,128,269,244,26,99,177
"2011","North Kesteven 010B","E01026230","Total",1231,173,82,91,1058,91,140,200,194,120,134,179
"2011","North Kesteven 010C","E01026231","Total",2627,258,98,160,2369,132,228,696,502,137,241,433
"2011","North Kesteven 010D","E01026232","Total",2125,370,181,189,1755,90,292,433,382,93,166,299
"2011","North Kesteven 010E","E01026235","Total",1573,273,113,160,1300,152,178,289,236,81,139,225
"2011","North Kesteven 011A","E01026228","Total",1485,149,41,108,1336,88,130,358,310,97,144,209
"2011","North Kesteven 011B","E01026229","Total",1543,126,46,80,1417,109,146,399,280,72,180,231
"2011","North Kesteven 011C","E01026233","Total",1717,179,97,82,1538,59,230,445,284,72,161,287
"2011","North Kesteven 011D","E01026234","Total",2691,184,56,128,2507,92,300,729,476,154,291,465
"2011","North Kesteven 011E","E01026236","Total",1158,146,87,59,1012,53,270,180,176,48,107,178
"2011","North Kesteven 012A","E01026200","Total",1566,186,79,107,1380,61,236,370,294,40,111,268
"2011","North Kesteven 012B","E01026201","Total",2000,210,105,105,1790,104,374,408,336,103,206,259
"2011","North Kesteven 012C","E01026202","Total",1751,271,188,83,1480,55,470,307,276,45,91,236
"2011","North Kesteven 012D","E01026207","Total",1191,130,62,68,1061,32,244,207,200,48,109,221
"2011","North Kesteven 012E","E01026208","Total",1597,131,65,66,1466,61,224,326,344,114,174,223
"2011","North Kesteven 013A","E01026220","Total",2239,272,188,84,1967,77,518,345,380,82,212,353
"2011","North Kesteven 013B","E01032988","Total",1369,181,79,102,1188,109,124,296,246,50,145,218
"2011","North Kesteven 013C","E01032989","Total",1352,119,9,110,1233,118,34,404,336,87,110,144
"2011","North Kesteven 013D","E01032993","Total",1433,167,95,72,1266,25,272,245,238,56,172,258
"2011","North Kesteven 014A","E01026214","Total",1157,150,80,70,1007,59,184,235,188,63,85,193
"2011","North Kesteven 014B","E01026215","Total",1101,111,86,25,990,12,244,211,150,61,133,179
"2011","North Kesteven 014C","E01026218","Total",1150,190,120,70,960,29,268,146,204,20,86,207
"2011","North Kesteven 014D","E01026219","Total",1221,109,61,48,1112,36,234,271,164,60,87,260
"2011","North Kesteven 014E","E01032991","Total",1433,178,95,83,1255,50,228,302,254,47,156,218
"2011","North Kesteven 014F","E01032992","Total",1315,171,90,81,1144,61,254,235,218,42,71,263
"2011","South Holland 001A","E01026242","Total",1470,140,79,61,1330,46,274,239,260,53,180,278
"2011","South Holland 001B","E01026243","Total",1335,152,81,71,1183,64,204,255,214,73,158,215
"2011","South Holland 001C","E01026244","Total",1310,111,64,47,1199,30,230,191,254,87,128,279
"2011","South Holland 001D","E01026247","Total",1860,215,121,94,1645,77,374,303,308,89,158,336
"2011","South Holland 001E","E01026276","Total",2369,196,104,92,2173,36,404,409,450,102,307,465
"2011","South Holland 002A","E01026246","Total",2304,182,100,82,2122,53,418,352,466,142,296,395
"2011","South Holland 002B","E01026248","Total",2233,176,77,99,2057,71,288,385,428,160,247,478
"2011","South Holland 002C","E01026257","Total",1886,224,154,70,1662,39,520,282,302,110,155,254
"2011","South Holland 003A","E01026250","Total",1777,291,162,129,1486,158,208,302,348,62,157,251
"2011","South Holland 003B","E01026251","Total",1790,219,153,66,1571,67,356,307,292,96,168,285
"2011","South Holland 003C","E01026252","Total",1719,233,160,73,1486,81,358,271,274,82,180,240
"2011","South Holland 003D","E01026253","Total",1764,221,132,89,1543,113,336,378,292,75,129,220
"2011","South Holland 004A","E01026281","Total",1317,102,59,43,1215,25,242,274,250,39,165,220
"2011","South Holland 004B","E01026282","Total",1712,179,120,59,1533,68,302,314,246,98,214,291
"2011","South Holland 004C","E01026283","Total",1726,160,92,68,1566,51,334,338,294,100,153,296
"2011","South Holland 004D","E01026285","Total",1439,133,77,56,1306,34,286,209,282,93,169,233
"2011","South Holland 004E","E01026286","Total",1273,94,54,40,1179,73,196,226,196,119,123,246
"2011","South Holland 005A","E01026241","Total",1957,139,36,103,1818,105,184,477,424,114,188,326
"2011","South Holland 005B","E01026258","Total",1751,158,103,55,1593,17,376,285,320,81,160,354
"2011","South Holland 005C","E01026259","Total",1710,150,80,70,1560,52,232,302,336,102,176,360
"2011","South Holland 005D","E01026260","Total",1966,246,154,92,1720,136,322,327,294,85,225,331
"2011","South Holland 006B","E01026266","Total",1988,349,139,210,1639,87,158,428,354,43,171,398
"2011","South Holland 006C","E01026273","Total",1651,174,110,64,1477,43,344,293,274,81,167,275
"2011","South Holland 006D","E01026274","Total",1932,156,59,97,1776,115,208,570,264,148,171,300
"2011","South Holland 006E","E01026275","Total",1977,238,149,89,1739,98,298,411,336,57,187,352
"2011","South Holland 006F","E01032995","Total",1384,306,147,159,1078,67,162,201,242,32,144,230
"2011","South Holland 006G","E01032996","Total",1353,113,72,41,1240,30,212,334,200,68,116,280
"2011","South Holland 007A","E01026268","Total",1958,270,181,89,1688,139,266,376,332,72,174,329
"2011","South Holland 007B","E01026269","Total",2157,219,132,87,1938,52,460,363,346,66,253,398
"2011","South Holland 007C","E01026270","Total",1902,183,70,113,1719,191,184,324,244,149,225,402
"2011","South Holland 007D","E01026271","Total",1774,259,154,105,1515,96,160,335,236,74,245,369
"2011","South Holland 007E","E01026272","Total",1238,182,90,92,1056,45,194,211,184,51,114,257
"2011","South Holland 008A","E01026254","Total",1776,251,171,80,1525,55,422,265,330,60,150,243
"2011","South Holland 008B","E01026255","Total",1867,261,141,120,1606,78,370,342,332,47,131,306
"2011","South Holland 008C","E01026256","Total",1626,163,105,58,1463,53,268,265,300,88,219,270
"2011","South Holland 008D","E01026277","Total",1663,235,133,102,1428,146,174,263,230,130,200,285
"2011","South Holland 008E","E01026278","Total",1407,139,77,62,1268,42,262,268,268,73,126,229
"2011","South Holland 008F","E01026279","Total",1352,175,109,66,1177,74,300,220,198,65,123,197
"2011","South Holland 009A","E01026262","Total",1539,128,73,55,1411,29,270,259,268,94,119,372
"2011","South Holland 009B","E01026263","Total",1956,193,97,96,1763,96,194,587,362,97,166,261
"2011","South Holland 009C","E01026264","Total",1546,163,85,78,1383,99,198,307,224,96,171,288
"2011","South Holland 009D","E01026265","Total",1243,124,66,58,1119,52,164,262,190,53,139,259
"2011","South Holland 009E","E01026267","Total",2822,278,124,154,2544,156,358,635,532,104,374,385
"2011","South Holland 010A","E01026245","Total",2062,253,160,93,1809,60,428,322,398,93,174,334
"2011","South Holland 010B","E01026249","Total",1844,146,84,62,1698,36,352,325,384,76,180,345
"2011","South Holland 010C","E01026280","Total",2539,187,96,91,2352,78,402,491,492,142,311,436
"2011","South Holland 011A","E01026239","Total",1768,235,105,130,1533,77,240,468,308,77,163,200
"2011","South Holland 011B","E01026240","Total",2419,213,120,93,2206,71,334,584,394,151,268,404
"2011","South Holland 011C","E01026284","Total",1998,127,61,66,1871,76,318,431,332,153,202,359
"2011","South Kesteven 001A","E01026313","Total",1536,158,92,66,1378,47,226,317,300,102,128,258
"2011","South Kesteven 001B","E01026314","Total",1294,145,76,69,1149,74,210,337,222,52,100,154
"2011","South Kesteven 001C","E01026329","Total",1857,188,109,79,1669,76,370,341,300,116,234,232
"2011","South Kesteven 001D","E01026333","Total",2522,193,98,95,2329,92,342,637,496,160,227,375
"2011","South Kesteven 002A","E01026291","Total",1933,203,123,80,1730,52,394,402,340,82,180,280
"2011","South Kesteven 002B","E01026340","Total",2200,268,169,99,1932,113,444,408,310,127,186,344
"2011","South Kesteven 002C","E01026355","Total",2369,221,147,74,2148,86,478,508,378,165,195,338
"2011","South Kesteven 002D","E01026365","Total",2309,203,123,80,2106,48,554,438,416,105,199,346
"2011","South Kesteven 003A","E01026325","Total",1515,159,100,59,1356,127,170,316,196,149,147,251
"2011","South Kesteven 003B","E01026326","Total",1489,148,90,58,1341,64,212,279,218,114,158,296
"2011","South Kesteven 003C","E01026327","Total",1336,175,110,65,1161,74,236,215,252,43,131,210
"2011","South Kesteven 003D","E01026328","Total",1459,174,94,80,1285,173,126,287,186,107,179,227
"2011","South Kesteven 003E","E01026352","Total",1247,154,107,47,1093,24,246,246,214,42,87,234
"2011","South Kesteven 003F","E01026353","Total",1536,436,210,226,1100,119,174,232,280,30,87,178
"2011","South Kesteven 003G","E01026354","Total",1191,86,56,30,1105,33,202,223,258,51,120,218
"2011","South Kesteven 004A","E01026320","Total",1661,131,59,72,1530,24,228,399,268,94,219,298
"2011","South Kesteven 004B","E01026321","Total",1265,131,67,64,1134,24,194,241,234,72,166,203
"2011","South Kesteven 004C","E01026322","Total",1104,166,70,96,938,37,212,178,248,31,76,156
"2011","South Kesteven 004D","E01026323","Total",1825,452,186,266,1373,78,142,314,362,68,145,264
"2011","South Kesteven 004E","E01026324","Total",2242,180,81,99,2062,89,222,599,400,144,212,396
"2011","South Kesteven 005A","E01026308","Total",1484,162,38,124,1322,245,60,348,170,154,119,226
"2011","South Kesteven 005B","E01026309","Total",1567,196,80,116,1371,111,206,347,266,77,110,254
"2011","South Kesteven 005C","E01026310","Total",1235,81,35,46,1154,122,144,255,164,96,164,209
"2011","South Kesteven 005D","E01026311","Total",1636,164,71,93,1472,143,168,345,250,120,183,263
"2011","South Kesteven 005E","E01026312","Total",1409,62,21,41,1347,270,44,303,124,185,201,220
"2011","South Kesteven 006A","E01026317","Total",2053,364,77,287,1689,181,114,398,436,61,205,294
"2011","South Kesteven 006B","E01026318","Total",1926,286,81,205,1640,212,90,473,326,118,172,249
"2011","South Kesteven 006C","E01026319","Total",2088,249,98,151,1839,107,336,412,422,111,140,311
"2011","South Kesteven 006D","E01026343","Total",1808,404,104,300,1404,150,134,365,324,54,134,243
"2011","South Kesteven 006E","E01026344","Total",1503,224,66,158,1279,90,158,285,298,66,137,245
"2011","South Kesteven 006F","E01026345","Total",1460,189,104,85,1271,155,218,224,202,77,183,212
"2011","South Kesteven 007A","E01026292","Total",1422,135,59,76,1287,72,186,347,332,36,93,221
"2011","South Kesteven 007B","E01026293","Total",2041,179,64,115,1862,101,242,564,422,114,163,256
"2011","South Kesteven 007C","E01026294","Total",1648,111,21,90,1537,94,112,495,368,72,190,206
"2011","South Kesteven 007D","E01026316","Total",2417,255,132,123,2162,78,424,462,442,165,217,374
"2011","South Kesteven 007E","E01026332","Total",2224,240,139,101,1984,52,352,441,416,155,245,323
"2011","South Kesteven 008A","E01026290","Total",2211,180,89,91,2031,65,348,456,398,94,272,398
"2011","South Kesteven 008B","E01026341","Total",1479,145,87,58,1334,56,228,339,226,73,109,303
"2011","South Kesteven 008C","E01026342","Total",1459,116,37,79,1343,56,132,393,288,114,187,173
"2011","South Kesteven 008D","E01026361","Total",2604,291,132,159,2313,142,436,558,444,90,260,383
"2011","South Kesteven 009A","E01026315","Total",2084,237,130,107,1847,104,378,333,426,135,173,298
"2011","South Kesteven 009B","E01026331","Total",2424,259,127,132,2165,107,418,483,464,165,222,306
"2011","South Kesteven 009C","E01026338","Total",1237,118,52,66,1119,44,200,276,266,80,101,152
"2011","South Kesteven 009D","E01026339","Total",1206,168,57,111,1038,82,104,267,258,49,105,173
"2011","South Kesteven 010A","E01026299","Total",1667,219,112,107,1448,95,182,413,276,115,100,267
"2011","South Kesteven 010B","E01026300","Total",1516,131,93,38,1385,32,278,317,254,77,116,311
"2011","South Kesteven 010C","E01026301","Total",1547,182,109,73,1365,18,348,297,270,71,119,242
"2011","South Kesteven 010D","E01026302","Total",1214,111,52,59,1103,27,124,325,208,72,99,248
"2011","South Kesteven 011B","E01026296","Total",1549,131,77,54,1418,24,326,268,282,72,226,220
"2011","South Kesteven 011C","E01026297","Total",1326,170,107,63,1156,36,232,208,204,59,149,268
"2011","South Kesteven 011D","E01026298","Total",1759,370,199,171,1389,116,200,329,270,77,168,229
"2011","South Kesteven 011E","E01032997","Total",1214,100,18,82,1114,86,50,437,220,88,90,143
"2011","South Kesteven 011F","E01032998","Total",1289,103,13,90,1186,85,24,409,238,112,155,163
"2011","South Kesteven 011G","E01032999","Total",1169,148,89,59,1021,61,188,279,210,46,72,165
"2011","South Kesteven 012A","E01026330","Total",2170,165,77,88,2005,63,324,488,392,133,271,334
"2011","South Kesteven 012B","E01026360","Total",2153,185,106,79,1968,79,300,477,410,124,173,405
"2011","South Kesteven 012C","E01026362","Total",1758,120,58,62,1638,38,180,552,288,92,145,343
"2011","South Kesteven 012D","E01026363","Total",1285,116,48,68,1169,29,224,353,230,104,101,128
"2011","South Kesteven 012E","E01026364","Total",1731,153,81,72,1578,73,276,463,270,100,119,277
"2011","South Kesteven 013A","E01026334","Total",1586,112,60,52,1474,38,194,380,276,71,187,328
"2011","South Kesteven 013B","E01026335","Total",1502,248,131,117,1254,53,268,261,272,42,96,262
"2011","South Kesteven 013C","E01026336","Total",1579,217,84,133,1362,107,208,307,226,122,121,271
"2011","South Kesteven 013D","E01026337","Total",1531,155,87,68,1376,77,224,279,286,66,144,300
"2011","South Kesteven 014A","E01026303","Total",1393,91,25,66,1302,64,90,394,256,83,142,273
"2011","South Kesteven 014B","E01026304","Total",1454,106,47,59,1348,54,238,316,330,56,103,251
"2011","South Kesteven 014C","E01026305","Total",1361,164,24,140,1197,103,64,349,340,56,95,190
"2011","South Kesteven 014D","E01026306","Total",1538,228,142,86,1310,92,256,271,264,83,136,208
"2011","South Kesteven 014E","E01026307","Total",1283,129,64,65,1154,37,178,280,264,57,93,245
"2011","South Kesteven 015A","E01026287","Total",1448,175,75,100,1273,76,196,212,252,79,149,309
"2011","South Kesteven 015B","E01026288","Total",1629,255,134,121,1374,164,150,330,280,93,119,238
"2011","South Kesteven 015C","E01026289","Total",2033,212,80,132,1821,129,200,547,406,80,178,281
"2011","South Kesteven 015D","E01026346","Total",1183,140,51,89,1043,51,132,283,232,54,80,211
"2011","South Kesteven 015E","E01026347","Total",1575,367,199,168,1208,64,248,283,338,31,71,173
"2011","South Kesteven 015F","E01026348","Total",1179,97,56,41,1082,104,142,196,180,91,121,248
"2011","South Kesteven 016A","E01026349","Total",1564,324,162,162,1240,159,180,290,278,84,61,188
"2011","South Kesteven 016B","E01026350","Total",1492,415,196,219,1077,63,256,214,304,30,55,155
"2011","South Kesteven 016C","E01026351","Total",1416,456,175,281,960,46,212,186,318,32,33,133
"2011","South Kesteven 016D","E01026356","Total",1458,117,33,84,1341,76,94,430,312,66,121,242
"2011","South Kesteven 016E","E01026357","Total",1426,115,35,80,1311,64,164,305,314,78,105,281
"2011","South Kesteven 016F","E01026358","Total",1402,144,77,67,1258,42,262,303,292,41,100,218
"2011","South Kesteven 016G","E01026359","Total",1599,142,89,53,1457,56,296,378,266,117,105,239
"2011","West Lindsey 001A","E01026367","Total",1577,247,127,120,1330,70,272,259,274,68,115,272
"2011","West Lindsey 001B","E01026368","Total",1593,174,94,80,1419,96,218,325,292,61,126,301
"2011","West Lindsey 001C","E01026387","Total",2664,231,108,123,2433,58,374,483,532,179,305,502
"2011","West Lindsey 001D","E01026416","Total",1277,132,64,68,1145,26,228,273,258,76,97,187
"2011","West Lindsey 001G","E01032683","Total",2221,276,140,136,1945,91,368,339,456,127,179,385
"2011","West Lindsey 002A","E01026380","Total",1832,156,79,77,1676,113,200,429,352,93,212,277
"2011","West Lindsey 002B","E01026401","Total",1521,113,62,51,1408,46,254,352,286,72,117,281
"2011","West Lindsey 002C","E01026402","Total",1811,243,114,129,1568,86,276,391,382,78,122,233
"2011","West Lindsey 002D","E01026403","Total",1321,139,63,76,1182,40,186,233,268,100,163,192
"2011","West Lindsey 002E","E01026407","Total",1362,138,70,68,1224,20,186,300,230,101,174,213
"2011","West Lindsey 002F","E01026408","Total",1266,155,86,69,1111,55,222,263,270,10,80,211
"2011","West Lindsey 003A","E01026389","Total",1574,294,107,187,1280,118,242,269,318,83,98,152
"2011","West Lindsey 003B","E01026390","Total",1815,294,153,141,1521,129,296,294,246,90,135,331
"2011","West Lindsey 003C","E01026391","Total",1841,207,116,91,1634,69,396,311,338,62,159,299
"2011","West Lindsey 003D","E01026392","Total",2953,323,173,150,2630,94,496,592,560,172,259,457
"2011","West Lindsey 003E","E01026415","Total",975,110,36,74,865,57,106,208,168,91,90,145
"2011","West Lindsey 004A","E01026378","Total",1702,215,75,140,1487,181,142,344,274,131,161,254
"2011","West Lindsey 004B","E01026379","Total",1641,260,96,164,1381,87,172,303,272,117,152,278
"2011","West Lindsey 004C","E01026381","Total",1671,303,142,161,1368,134,182,297,310,81,132,232
"2011","West Lindsey 004D","E01026382","Total",1631,247,115,132,1384,114,190,333,300,91,137,219
"2011","West Lindsey 004E","E01026383","Total",1161,298,70,228,863,82,70,201,234,60,54,162
"2011","West Lindsey 004F","E01026384","Total",1764,422,152,270,1342,141,156,250,280,125,134,256
"2011","West Lindsey 005A","E01026385","Total",1154,124,71,53,1030,65,216,183,246,26,122,172
"2011","West Lindsey 005B","E01026386","Total",1318,115,31,84,1203,60,122,283,244,111,165,218
"2011","West Lindsey 005C","E01026399","Total",1451,138,67,71,1313,57,208,316,278,66,165,223
"2011","West Lindsey 005D","E01026411","Total",2452,254,110,144,2198,67,372,457,518,94,287,403
"2011","West Lindsey 006A","E01026374","Total",1449,219,74,145,1230,202,82,341,228,107,110,160
"2011","West Lindsey 006B","E01026375","Total",1548,216,75,141,1332,139,146,295,204,153,143,252
"2011","West Lindsey 006C","E01026376","Total",1750,256,130,126,1494,208,210,280,280,133,168,215
"2011","West Lindsey 006D","E01026377","Total",2177,244,116,128,1933,186,208,506,334,176,190,333
"2011","West Lindsey 007A","E01026388","Total",2118,217,150,67,1901,54,416,390,430,84,179,348
"2011","West Lindsey 007B","E01026404","Total",2220,251,136,115,1969,57,336,414,444,97,231,390
"2011","West Lindsey 007C","E01026409","Total",1168,118,53,65,1050,42,196,202,258,39,134,179
"2011","West Lindsey 007D","E01026410","Total",1584,181,119,62,1403,30,548,199,264,63,106,193
"2011","West Lindsey 008A","E01026372","Total",2438,259,155,104,2179,108,366,487,416,167,212,423
"2011","West Lindsey 008B","E01026412","Total",1649,213,130,83,1436,106,228,404,250,56,134,258
"2011","West Lindsey 008C","E01026413","Total",2248,171,92,79,2077,96,272,545,330,202,276,356
"2011","West Lindsey 008D","E01026414","Total",1686,131,56,75,1555,87,272,325,320,79,167,305
"2011","West Lindsey 009A","E01026396","Total",1221,119,78,41,1102,41,304,189,214,26,71,257
"2011","West Lindsey 009B","E01026397","Total",2267,255,69,186,2012,78,302,474,506,150,177,325
"2011","West Lindsey 009C","E01026398","Total",1489,239,134,105,1250,50,270,254,254,63,100,259
"2011","West Lindsey 009D","E01026400","Total",1718,86,22,64,1632,95,114,558,292,134,185,254
"2011","West Lindsey 010A","E01026393","Total",1428,173,125,48,1255,38,332,272,194,51,113,255
"2011","West Lindsey 010B","E01026394","Total",1738,207,101,106,1531,56,258,375,372,45,180,245
"2011","West Lindsey 010C","E01026395","Total",1417,197,128,69,1220,53,330,197,220,29,151,240
"2011","West Lindsey 010D","E01026405","Total",1359,94,52,42,1265,25,214,357,192,70,184,223
"2011","West Lindsey 010E","E01026406","Total",1268,97,58,39,1171,20,276,258,202,47,133,235
"2011","West Lindsey 011A","E01026366","Total",2029,251,129,122,1778,61,344,385,418,107,148,315
"2011","West Lindsey 011B","E01026369","Total",1051,149,101,48,902,52,202,149,174,42,93,190
"2011","West Lindsey 011C","E01026370","Total",2092,244,131,113,1848,67,454,443,370,98,145,271
"2011","West Lindsey 011D","E01026371","Total",1233,116,68,48,1117,33,260,259,208,60,91,206
"2011","West Lindsey 011E","E01026373","Total",1957,176,91,85,1781,74,304,385,406,158,143,311
"2011","Corby 001A","E01026971","Total",1724,216,123,93,1508,113,162,409,282,68,180,294
"2011","Corby 001B","E01026979","Total",1377,131,68,63,1246,57,168,301,266,101,137,216
"2011","Corby 001C","E01026980","Total",1560,140,86,54,1420,42,248,293,304,88,129,316
"2011","Corby 001D","E01026982","Total",1972,200,66,134,1772,237,120,455,296,120,198,346
"2011","Corby 002A","E01026969","Total",1644,331,173,158,1313,106,230,252,236,65,135,289
"2011","Corby 002B","E01026970","Total",1704,151,63,88,1553,140,106,383,248,113,178,385
"2011","Corby 002C","E01026972","Total",1828,210,80,130,1618,188,124,442,290,81,185,308
"2011","Corby 002D","E01026976","Total",1347,147,36,111,1200,144,80,216,202,123,166,269
"2011","Corby 002E","E01026981","Total",1147,99,55,44,1048,72,168,177,242,52,142,195
"2011","Corby 002F","E01026983","Total",1107,138,48,90,969,66,102,188,168,58,131,256
"2011","Corby 003A","E01026957","Total",1486,278,99,179,1208,84,162,263,292,57,102,248
"2011","Corby 003B","E01026958","Total",1796,198,40,158,1598,198,94,466,284,103,144,309
"2011","Corby 003C","E01026977","Total",1896,196,98,98,1700,78,304,415,440,62,160,241
"2011","Corby 003D","E01026978","Total",1442,160,76,84,1282,78,172,291,238,92,171,240
"2011","Corby 004A","E01026962","Total",1391,172,93,79,1219,141,164,218,208,33,127,328
"2011","Corby 004B","E01026973","Total",1422,159,80,79,1263,78,154,287,214,127,148,255
"2011","Corby 004C","E01026974","Total",1139,101,57,44,1038,55,210,164,176,46,132,255
"2011","Corby 004D","E01026975","Total",1356,244,130,114,1112,126,156,229,206,57,108,230
"2011","Corby 004E","E01026984","Total",1704,248,109,139,1456,101,214,347,230,77,196,291
"2011","Corby 004F","E01026985","Total",1484,165,75,90,1319,69,264,214,210,35,178,349
"2011","Corby 005A","E01026949","Total",1300,218,82,136,1082,91,170,192,248,26,157,198
"2011","Corby 005B","E01026950","Total",1550,175,60,115,1375,187,106,295,190,122,197,278
"2011","Corby 005C","E01026951","Total",1270,123,45,78,1147,110,96,265,154,90,194,238
"2011","Corby 005D","E01026952","Total",1166,143,62,81,1023,67,112,177,210,56,143,258
"2011","Corby 006A","E01026959","Total",1415,226,91,135,1189,140,114,241,228,72,128,266
"2011","Corby 006B","E01026960","Total",1506,175,64,111,1331,195,124,253,176,98,244,241
"2011","Corby 006C","E01026961","Total",1292,129,34,95,1163,140,88,234,178,125,188,210
"2011","Corby 006D","E01026965","Total",1034,130,24,106,904,134,56,143,148,68,174,181
"2011","Corby 006E","E01026966","Total",1393,142,58,84,1251,131,152,190,192,105,140,341
"2011","Corby 006F","E01026967","Total",1720,191,79,112,1529,126,182,299,216,155,202,349
"2011","Corby 006G","E01026968","Total",1374,239,47,192,1135,184,64,236,180,106,150,215
"2011","Corby 008A","E01026953","Total",1345,150,77,73,1195,38,210,197,288,74,133,255
"2011","Corby 008B","E01026954","Total",1365,119,36,83,1246,105,116,249,216,90,176,294
"2011","Corby 008C","E01026955","Total",1453,82,38,44,1371,34,148,292,288,58,187,364
"2011","Corby 008D","E01026956","Total",1947,236,64,172,1711,152,116,421,352,104,197,369
"2011","Corby 009A","E01026963","Total",1326,138,25,113,1188,176,62,333,236,83,103,195
"2011","Corby 009B","E01032963","Total",1575,116,18,98,1459,72,70,424,348,136,183,226
"2011","Corby 009C","E01032964","Total",1675,85,7,78,1590,111,64,524,274,129,274,214
"2011","Corby 009D","E01032965","Total",1371,65,6,59,1306,61,36,465,286,112,193,153
"2011","Corby 009E","E01032966","Total",1703,68,6,62,1635,92,46,629,330,126,163,249
"2011","Corby 009F","E01032967","Total",1684,62,3,59,1622,129,26,485,226,197,341,218
"2011","Daventry 001A","E01027005","Total",2044,166,75,91,1878,47,300,498,368,163,210,292
"2011","Daventry 001B","E01027026","Total",1921,187,92,95,1734,52,274,447,354,120,190,297
"2011","Daventry 001C","E01027030","Total",1755,180,93,87,1575,39,250,297,298,110,205,376
"2011","Daventry 002A","E01027000","Total",1461,170,95,75,1291,83,154,360,242,126,118,208
"2011","Daventry 002B","E01027001","Total",1523,58,16,42,1465,34,86,445,198,125,245,332
"2011","Daventry 002C","E01027002","Total",1622,133,59,74,1489,39,214,331,276,142,185,302
"2011","Daventry 002D","E01027003","Total",1401,159,56,103,1242,76,128,281,268,81,139,269
"2011","Daventry 002E","E01027022","Total",1796,177,93,84,1619,63,240,327,342,146,152,349
"2011","Daventry 003A","E01026994","Total",1009,121,85,36,888,19,174,185,226,50,88,146
"2011","Daventry 003D","E01026999","Total",1759,188,98,90,1571,74,300,361,372,50,142,272
"2011","Daventry 003E","E01027006","Total",1877,165,101,64,1712,74,234,465,286,116,214,323
"2011","Daventry 003F","E01032968","Total",2187,191,101,90,1996,87,402,394,388,117,217,391
"2011","Daventry 004A","E01026998","Total",1749,166,77,89,1583,33,270,270,388,72,201,349
"2011","Daventry 004B","E01027015","Total",1269,121,73,48,1148,30,180,253,224,40,164,257
"2011","Daventry 004C","E01027016","Total",1513,129,49,80,1384,63,166,312,320,100,136,287
"2011","Daventry 004D","E01027021","Total",1844,165,80,85,1679,46,310,422,348,119,191,243
"2011","Daventry 004E","E01027027","Total",2371,183,96,87,2188,86,264,657,334,205,273,369
"2011","Daventry 005A","E01026997","Total",1700,151,96,55,1549,44,230,319,304,108,216,328
"2011","Daventry 005B","E01027018","Total",1464,161,80,81,1303,29,278,233,224,81,184,274
"2011","Daventry 005C","E01027019","Total",1414,230,103,127,1184,45,184,293,238,40,137,247
"2011","Daventry 005D","E01027020","Total",1174,167,117,50,1007,49,208,178,180,36,123,233
"2011","Daventry 005E","E01027023","Total",2047,168,94,74,1879,58,296,437,358,190,194,346
"2011","Daventry 006A","E01026987","Total",1201,138,64,74,1063,49,176,205,200,58,119,256
"2011","Daventry 006B","E01026989","Total",1451,154,18,136,1297,130,84,412,254,119,124,174
"2011","Daventry 006C","E01026990","Total",2629,237,30,207,2392,196,140,733,562,142,205,414
"2011","Daventry 006D","E01027012","Total",1747,150,59,91,1597,123,272,319,332,145,130,276
"2011","Daventry 006E","E01027014","Total",2214,140,41,99,2074,128,118,705,348,169,316,290
"2011","Daventry 007A","E01026986","Total",2898,268,87,181,2630,216,182,822,448,250,289,423
"2011","Daventry 007B","E01026988","Total",1572,113,53,60,1459,160,150,342,228,138,192,249
"2011","Daventry 007C","E01026991","Total",1557,228,142,86,1329,29,406,206,326,20,83,259
"2011","Daventry 007D","E01026992","Total",1775,446,208,238,1329,107,182,289,318,88,95,250
"2011","Daventry 007E","E01027010","Total",1177,92,49,43,1085,30,212,190,234,67,106,246
"2011","Daventry 008A","E01027007","Total",1371,126,37,89,1245,118,98,285,216,101,168,259
"2011","Daventry 008B","E01027008","Total",1948,268,62,206,1680,89,196,425,462,82,129,297
"2011","Daventry 008C","E01027009","Total",1496,163,46,117,1333,121,92,366,236,136,194,188
"2011","Daventry 008D","E01027013","Total",1809,217,54,163,1592,234,78,346,220,204,263,247
"2011","Daventry 009A","E01027011","Total",1899,199,90,109,1700,35,330,339,386,128,150,332
"2011","Daventry 009B","E01027017","Total",1451,244,114,130,1207,94,218,245,192,42,153,263
"2011","Daventry 009C","E01027024","Total",1721,149,61,88,1572,42,248,405,354,97,126,300
"2011","Daventry 009D","E01027025","Total",1640,256,98,158,1384,99,184,364,330,110,100,197
"2011","Daventry 010A","E01026993","Total",1915,190,106,84,1725,39,346,389,376,63,158,354
"2011","Daventry 010B","E01027004","Total",1827,187,95,92,1640,36,308,414,318,125,137,302
"2011","Daventry 010C","E01027028","Total",2108,234,82,152,1874,100,222,479,396,113,203,361
"2011","Daventry 010D","E01027029","Total",1580,218,80,138,1362,112,132,371,236,133,171,207
"2011","East Northamptonshire 001A","E01027033","Total",1810,216,114,102,1594,75,266,354,390,77,170,262
"2011","East Northamptonshire 001B","E01027043","Total",1930,179,86,93,1751,70,346,403,328,111,182,311
"2011","East Northamptonshire 001C","E01027050","Total",1912,181,93,88,1731,55,322,484,330,125,184,231
"2011","East Northamptonshire 002A","E01027031","Total",2077,169,78,91,1908,49,298,501,388,138,233,301
"2011","East Northamptonshire 002B","E01027044","Total",2004,182,104,78,1822,45,336,474,390,121,167,289
"2011","East Northamptonshire 002C","E01027046","Total",1296,114,48,66,1182,52,150,359,190,72,146,213
"2011","East Northamptonshire 002D","E01027047","Total",1286,145,76,69,1141,34,208,257,244,50,110,238
"2011","East Northamptonshire 002E","E01027048","Total",1330,205,84,121,1125,94,212,238,218,74,107,182
"2011","East Northamptonshire 002F","E01027049","Total",922,174,97,77,748,22,152,189,130,40,89,126
"2011","East Northamptonshire 003A","E01027032","Total",1840,185,90,95,1655,63,272,384,388,109,182,257
"2011","East Northamptonshire 003B","E01027045","Total",1898,202,106,96,1696,62,308,366,374,118,156,312
"2011","East Northamptonshire 003C","E01027075","Total",2101,161,48,113,1940,102,200,666,322,152,247,251
"2011","East Northamptonshire 003D","E01027076","Total",2157,266,121,145,1891,102,256,518,398,136,209,272
"2011","East Northamptonshire 003E","E01027077","Total",1981,128,45,83,1853,83,130,565,368,145,245,317
"2011","East Northamptonshire 004A","E01027057","Total",1697,169,60,109,1528,50,248,382,342,86,167,253
"2011","East Northamptonshire 004B","E01027074","Total",2146,160,79,81,1986,81,290,479,396,94,238,408
"2011","East Northamptonshire 004C","E01027078","Total",2086,216,110,106,1870,86,318,378,406,127,218,337
"2011","East Northamptonshire 005A","E01027051","Total",1733,224,99,125,1509,89,144,376,352,123,155,270
"2011","East Northamptonshire 005B","E01027052","Total",1422,128,47,81,1294,62,164,339,262,100,131,236
"2011","East Northamptonshire 005C","E01027053","Total",1503,144,64,80,1359,45,190,244,320,112,159,289
"2011","East Northamptonshire 005D","E01027054","Total",1213,125,67,58,1088,20,198,191,226,76,117,260
"2011","East Northamptonshire 005E","E01027055","Total",1139,102,42,60,1037,52,166,252,182,74,115,196
"2011","East Northamptonshire 005F","E01027056","Total",1518,166,74,92,1352,91,160,331,222,126,162,260
"2011","East Northamptonshire 006A","E01027038","Total",1584,172,59,113,1412,123,208,307,280,107,144,243
"2011","East Northamptonshire 006B","E01027039","Total",1718,241,75,166,1477,117,178,407,250,95,204,226
"2011","East Northamptonshire 006C","E01027040","Total",1617,193,62,131,1424,43,196,400,342,92,141,210
"2011","East Northamptonshire 006D","E01027041","Total",1617,259,106,153,1358,141,176,293,276,129,124,219
"2011","East Northamptonshire 006E","E01027042","Total",1874,114,33,81,1760,109,122,533,424,84,188,300
"2011","East Northamptonshire 007A","E01027034","Total",1605,282,159,123,1323,58,182,299,274,103,150,257
"2011","East Northamptonshire 007B","E01027035","Total",1378,153,74,79,1225,89,174,232,268,124,116,222
"2011","East Northamptonshire 007D","E01027037","Total",2189,152,60,92,2037,73,218,647,378,193,231,297
"2011","East Northamptonshire 007E","E01033244","Total",2397,170,71,99,2227,85,200,779,442,135,226,360
"2011","East Northamptonshire 007F","E01033245","Total",1009,103,39,64,906,48,94,253,224,57,81,149
"2011","East Northamptonshire 008A","E01027061","Total",1777,213,82,131,1564,127,168,439,298,135,120,277
"2011","East Northamptonshire 008B","E01027062","Total",2192,264,111,153,1928,151,194,492,412,183,178,318
"2011","East Northamptonshire 008C","E01027063","Total",1799,142,60,82,1657,64,206,419,390,101,158,319
"2011","East Northamptonshire 008D","E01027064","Total",1537,116,53,63,1421,40,300,309,308,95,125,244
"2011","East Northamptonshire 008E","E01027072","Total",1649,115,53,62,1534,179,170,330,182,226,201,246
"2011","East Northamptonshire 008F","E01027073","Total",2033,265,127,138,1768,109,236,428,370,150,179,296
"2011","East Northamptonshire 009A","E01027058","Total",1498,167,78,89,1331,149,196,249,242,110,161,224
"2011","East Northamptonshire 009B","E01027059","Total",1691,249,89,160,1442,119,156,382,302,145,121,217
"2011","East Northamptonshire 009C","E01027060","Total",1712,348,134,214,1364,137,156,332,346,87,128,178
"2011","East Northamptonshire 009D","E01027065","Total",1735,350,104,246,1385,130,130,321,368,111,153,172
"2011","East Northamptonshire 009E","E01027069","Total",1523,354,139,215,1169,73,180,255,350,53,53,205
"2011","East Northamptonshire 010A","E01027066","Total",2181,135,70,65,2046,48,262,597,346,192,262,339
"2011","East Northamptonshire 010B","E01027067","Total",1562,151,94,57,1411,28,382,297,236,83,116,269
"2011","East Northamptonshire 010C","E01027068","Total",2907,194,53,141,2713,97,224,854,600,191,339,408
"2011","East Northamptonshire 010D","E01027070","Total",1641,159,71,88,1482,66,216,382,330,92,152,244
"2011","East Northamptonshire 010E","E01027071","Total",1484,132,63,69,1352,43,190,292,256,85,200,286
"2011","Kettering 001A","E01027090","Total",1401,166,65,101,1235,32,226,280,278,61,123,235
"2011","Kettering 001B","E01027103","Total",1629,147,78,69,1482,81,260,324,312,109,125,271
"2011","Kettering 001C","E01027129","Total",2165,247,127,120,1918,55,354,418,454,126,156,355
"2011","Kettering 002B","E01027094","Total",1481,181,112,69,1300,39,260,284,274,71,149,223
"2011","Kettering 002C","E01027095","Total",1451,137,57,80,1314,63,152,347,258,94,188,212
"2011","Kettering 002D","E01027107","Total",1269,152,64,88,1117,100,160,253,266,52,64,222
"2011","Kettering 002E","E01027108","Total",1273,85,48,37,1188,11,288,205,220,77,93,294
"2011","Kettering 002F","E01027109","Total",1259,114,39,75,1145,55,174,281,192,95,128,220
"2011","Kettering 002G","E01032969","Total",1287,92,6,86,1195,86,32,513,274,110,90,90
"2011","Kettering 002H","E01032970","Total",1482,134,45,89,1348,123,108,395,232,148,155,187
"2011","Kettering 002I","E01032971","Total",1047,202,59,143,845,87,72,283,222,62,47,72
"2011","Kettering 003A","E01027123","Total",1595,168,96,72,1427,80,254,266,234,134,181,278
"2011","Kettering 003B","E01027124","Total",2176,375,119,256,1801,151,218,399,374,170,203,286
"2011","Kettering 003C","E01027125","Total",1807,128,67,61,1679,49,232,433,328,101,152,384
"2011","Kettering 003D","E01027126","Total",2110,367,141,226,1743,186,226,360,394,155,146,276
"2011","Kettering 004A","E01027079","Total",1738,214,81,133,1524,134,164,361,286,106,167,306
"2011","Kettering 004B","E01027080","Total",1910,159,74,85,1751,62,246,465,298,89,219,372
"2011","Kettering 004C","E01027087","Total",1180,125,43,82,1055,51,142,296,206,67,110,183
"2011","Kettering 004D","E01027088","Total",1288,85,32,53,1203,52,100,356,198,103,145,249
"2011","Kettering 004E","E01027089","Total",2015,170,84,86,1845,108,228,566,366,144,170,263
"2011","Kettering 005A","E01027081","Total",1450,199,82,117,1251,119,102,280,232,183,163,172
"2011","Kettering 005B","E01027082","Total",1593,234,51,183,1359,177,80,294,312,102,196,198
"2011","Kettering 005C","E01027083","Total",1415,235,71,164,1180,196,122,314,202,81,96,169
"2011","Kettering 005D","E01027127","Total",1869,234,103,131,1635,182,182,300,278,149,280,264
"2011","Kettering 005E","E01027128","Total",1720,165,74,91,1555,210,160,289,226,177,189,304
"2011","Kettering 006A","E01027105","Total",2056,336,62,274,1720,114,74,441,436,152,220,283
"2011","Kettering 006B","E01027106","Total",1931,324,56,268,1607,155,82,466,374,115,168,247
"2011","Kettering 006C","E01027111","Total",2009,319,58,261,1690,202,88,432,434,74,151,309
"2011","Kettering 006D","E01027112","Total",2116,304,75,229,1812,216,118,470,414,97,199,298
"2011","Kettering 007A","E01027104","Total",2303,444,152,292,1859,173,176,474,436,140,190,270
"2011","Kettering 007B","E01027110","Total",1731,712,287,425,1019,88,158,233,314,47,52,127
"2011","Kettering 007C","E01027113","Total",2054,396,183,213,1658,96,238,390,312,104,232,286
"2011","Kettering 007D","E01027115","Total",1156,112,78,34,1044,28,224,295,168,70,84,175
"2011","Kettering 007E","E01027116","Total",2178,148,27,121,2030,130,104,781,384,146,178,307
"2011","Kettering 007F","E01027117","Total",1300,189,80,109,1111,33,218,284,274,31,87,184
"2011","Kettering 008A","E01027096","Total",1192,92,48,44,1100,55,166,266,162,97,167,187
"2011","Kettering 008B","E01027097","Total",1367,146,50,96,1221,48,228,293,254,46,123,229
"2011","Kettering 008C","E01027098","Total",1218,113,47,66,1105,55,100,326,202,89,131,202
"2011","Kettering 008D","E01027099","Total",1464,202,124,78,1262,43,294,271,258,100,95,201
"2011","Kettering 008E","E01027122","Total",1182,125,77,48,1057,42,196,251,196,61,99,212
"2011","Kettering 009A","E01027100","Total",1580,195,103,92,1385,63,212,359,262,84,161,244
"2011","Kettering 009B","E01027114","Total",1595,186,81,105,1409,73,162,357,312,112,133,260
"2011","Kettering 009C","E01027130","Total",1825,227,115,112,1598,102,226,397,290,135,100,348
"2011","Kettering 009D","E01027131","Total",1950,467,130,337,1483,181,108,374,392,117,121,190
"2011","Kettering 010A","E01027084","Total",1455,162,113,49,1293,49,358,274,206,67,137,202
"2011","Kettering 010B","E01027085","Total",1246,118,64,54,1128,56,224,268,178,63,137,202
"2011","Kettering 010C","E01027086","Total",1669,146,74,72,1523,53,278,400,254,105,181,252
"2011","Kettering 010D","E01027120","Total",1342,122,25,97,1220,68,68,383,236,74,147,244
"2011","Kettering 010E","E01027121","Total",1455,59,35,24,1396,38,220,317,232,100,182,307
"2011","Kettering 011A","E01027091","Total",1855,206,82,124,1649,127,194,435,270,116,204,303
"2011","Kettering 011B","E01027092","Total",1482,153,70,83,1329,44,202,285,282,127,137,252
"2011","Kettering 011C","E01027101","Total",2422,293,128,165,2129,146,202,640,432,183,202,324
"2011","Kettering 011D","E01027102","Total",1658,159,82,77,1499,85,222,420,248,87,166,271
"2011","Kettering 011F","E01027119","Total",1708,215,126,89,1493,90,254,367,306,81,151,244
"2011","Kettering 011G","E01032972","Total",1426,109,55,54,1317,42,180,293,302,94,112,294
"2011","Kettering 011H","E01032973","Total",1699,90,10,80,1609,83,44,744,298,193,119,128
"2011","Kettering 011I","E01032974","Total",1287,119,40,79,1168,75,124,372,276,70,82,169
"2011","Northampton 001A","E01027145","Total",1402,122,67,55,1280,46,214,199,252,69,209,291
"2011","Northampton 001B","E01027148","Total",1453,116,49,67,1337,53,144,345,254,97,113,331
"2011","Northampton 001C","E01027149","Total",1422,168,65,103,1254,61,162,230,290,62,143,306
"2011","Northampton 001D","E01027232","Total",1454,187,78,109,1267,121,138,227,224,49,191,317
"2011","Northampton 002A","E01027218","Total",1540,185,104,81,1355,38,334,215,292,75,126,275
"2011","Northampton 002B","E01027219","Total",1683,253,177,76,1430,33,402,210,278,61,162,284
"2011","Northampton 002C","E01027221","Total",1729,210,107,103,1519,67,244,339,268,98,156,347
"2011","Northampton 002D","E01027222","Total",1261,89,29,60,1172,40,130,283,244,25,121,329
"2011","Northampton 003A","E01027143","Total",1237,131,62,69,1106,56,206,237,206,65,95,241
"2011","Northampton 003B","E01027144","Total",1504,137,76,61,1367,24,252,259,288,36,159,349
"2011","Northampton 003C","E01027146","Total",1495,155,83,72,1340,67,258,333,214,56,132,280
"2011","Northampton 003D","E01027147","Total",1643,337,180,157,1306,122,194,265,300,78,129,218
"2011","Northampton 004A","E01027195","Total",1552,213,33,180,1339,177,62,241,152,172,260,275
"2011","Northampton 004B","E01027245","Total",1573,197,32,165,1376,153,100,373,268,106,152,224
"2011","Northampton 004C","E01027247","Total",1565,154,31,123,1411,127,84,306,260,174,214,246
"2011","Northampton 004D","E01027248","Total",1534,148,41,107,1386,242,68,250,188,168,194,276
"2011","Northampton 004E","E01027249","Total",1801,179,35,144,1622,283,84,280,200,238,240,297
"2011","Northampton 005A","E01027174","Total",1317,93,36,57,1224,43,154,257,268,52,207,243
"2011","Northampton 005B","E01027175","Total",1539,149,27,122,1390,193,56,315,248,144,173,261
"2011","Northampton 005C","E01027178","Total",2047,195,49,146,1852,389,74,410,296,187,225,271
"2011","Northampton 005D","E01027200","Total",1466,165,48,117,1301,219,84,336,180,132,184,166
"2011","Northampton 005E","E01027246","Total",1854,241,42,199,1613,294,54,387,252,147,251,228
"2011","Northampton 006A","E01027171","Total",1438,266,118,148,1172,76,184,243,224,88,143,214
"2011","Northampton 006B","E01027172","Total",1546,206,123,83,1340,76,202,310,218,74,192,268
"2011","Northampton 006C","E01027182","Total",1428,165,105,60,1263,42,208,217,254,87,196,259
"2011","Northampton 006D","E01027183","Total",1357,171,105,66,1186,12,316,147,210,47,125,329
"2011","Northampton 007A","E01027196","Total",1538,85,32,53,1453,127,134,226,186,155,309,316
"2011","Northampton 007B","E01027197","Total",1402,212,76,136,1190,97,114,252,208,93,221,205
"2011","Northampton 007C","E01027198","Total",1561,231,40,191,1330,211,60,330,182,113,199,235
"2011","Northampton 007D","E01027199","Total",1400,124,48,76,1276,277,46,217,146,219,169,202
"2011","Northampton 008A","E01027190","Total",1531,329,170,159,1202,48,236,223,270,98,43,284
"2011","Northampton 008B","E01027191","Total",1774,251,55,196,1523,161,102,314,336,138,158,314
"2011","Northampton 008C","E01027193","Total",1430,158,64,94,1272,55,186,309,296,47,116,263
"2011","Northampton 008D","E01027194","Total",1347,194,114,80,1153,18,290,235,228,58,107,217
"2011","Northampton 009A","E01027192","Total",1388,132,34,98,1256,81,82,259,234,101,164,335
"2011","Northampton 009B","E01027229","Total",1560,178,66,112,1382,146,110,299,176,115,196,340
"2011","Northampton 009C","E01027230","Total",1542,154,51,103,1388,269,72,325,226,126,109,261
"2011","Northampton 009D","E01027231","Total",1783,320,109,211,1463,177,106,347,238,90,172,333
"2011","Northampton 010A","E01027179","Total",1867,238,104,134,1629,134,176,336,254,161,258,310
"2011","Northampton 010B","E01027180","Total",1542,256,161,95,1286,88,216,276,222,92,115,277
"2011","Northampton 010C","E01027181","Total",1605,282,207,75,1323,27,328,294,250,65,126,233
"2011","Northampton 011A","E01027140","Total",1241,131,46,85,1110,143,58,197,158,147,252,155
"2011","Northampton 011B","E01027142","Total",1367,203,81,122,1164,89,166,258,248,107,174,122
"2011","Northampton 011C","E01027176","Total",1462,152,53,99,1310,62,124,319,290,72,170,273
"2011","Northampton 011D","E01027177","Total",1543,200,55,145,1343,246,98,260,202,214,146,177
"2011","Northampton 012A","E01027168","Total",1668,294,93,201,1374,212,90,309,182,168,189,224
"2011","Northampton 012B","E01027169","Total",1626,127,49,78,1499,84,128,366,202,191,224,304
"2011","Northampton 012C","E01027170","Total",1558,181,63,118,1377,257,88,337,172,104,204,215
"2011","Northampton 012D","E01027173","Total",1595,136,51,85,1459,172,120,309,182,135,229,312
"2011","Northampton 013A","E01027136","Total",1707,321,83,238,1386,69,72,358,320,111,143,313
"2011","Northampton 013B","E01027186","Total",1760,153,47,106,1607,53,156,401,260,130,224,383
"2011","Northampton 013C","E01027188","Total",1809,202,81,121,1607,190,134,333,226,147,247,330
"2011","Northampton 013D","E01027220","Total",1292,190,121,69,1102,20,296,186,190,60,105,245
"2011","Northampton 014A","E01027208","Total",1463,144,64,80,1319,74,156,375,268,77,144,225
"2011","Northampton 014B","E01027209","Total",1195,179,40,139,1016,81,78,303,280,51,90,133
"2011","Northampton 014C","E01027211","Total",1380,162,89,73,1218,51,270,214,312,45,96,230
"2011","Northampton 014D","E01027212","Total",1408,124,18,106,1284,55,84,361,318,55,181,230
"2011","Northampton 015A","E01027184","Total",1358,217,82,135,1141,84,68,302,316,32,108,231
"2011","Northampton 015B","E01027185","Total",1283,245,82,163,1038,85,108,225,198,95,115,212
"2011","Northampton 015C","E01027187","Total",1292,180,53,127,1112,48,92,148,252,56,198,318
"2011","Northampton 015D","E01027189","Total",1593,260,89,171,1333,94,134,283,324,81,137,280
"2011","Northampton 016A","E01027137","Total",1369,219,73,146,1150,172,94,238,288,95,138,125
"2011","Northampton 016B","E01027138","Total",1481,161,63,98,1320,59,176,286,350,102,158,189
"2011","Northampton 016C","E01027139","Total",1484,180,28,152,1304,104,62,331,294,103,162,248
"2011","Northampton 016D","E01027141","Total",1456,84,32,52,1372,59,162,294,218,58,218,363
"2011","Northampton 016E","E01027259","Total",1568,87,35,52,1481,44,164,332,288,73,232,348
"2011","Northampton 017A","E01027239","Total",1687,248,100,148,1439,207,86,243,160,219,340,184
"2011","Northampton 017B","E01027241","Total",1741,225,57,168,1516,164,78,339,270,182,218,265
"2011","Northampton 017C","E01027242","Total",1575,142,71,71,1433,193,102,235,222,135,292,254
"2011","Northampton 017D","E01027243","Total",1546,229,86,143,1317,199,134,269,206,159,159,191
"2011","Northampton 017E","E01027244","Total",1624,253,41,212,1371,319,70,335,160,166,216,105
"2011","Northampton 018A","E01027213","Total",1499,207,71,136,1292,80,160,302,208,109,170,263
"2011","Northampton 018B","E01027214","Total",1545,307,116,191,1238,123,190,224,272,90,159,180
"2011","Northampton 018C","E01027216","Total",1614,278,132,146,1336,38,278,253,306,22,120,319
"2011","Northampton 018D","E01027240","Total",1269,150,59,91,1119,153,126,197,146,129,175,193
"2011","Northampton 019A","E01027207","Total",1373,153,96,57,1220,29,322,228,194,85,89,273
"2011","Northampton 019B","E01027210","Total",1141,97,57,40,1044,51,164,236,150,66,148,229
"2011","Northampton 019C","E01027215","Total",1461,136,83,53,1325,61,200,310,264,73,159,258
"2011","Northampton 019D","E01027217","Total",2095,278,172,106,1817,101,356,429,374,80,154,323
"2011","Northampton 020A","E01027255","Total",1347,100,55,45,1247,35,260,275,194,60,140,283
"2011","Northampton 020B","E01027256","Total",1443,184,114,70,1259,33,248,254,246,91,174,213
"2011","Northampton 020C","E01027258","Total",1431,65,13,52,1366,32,98,428,202,103,224,279
"2011","Northampton 020D","E01027260","Total",1419,127,68,59,1292,33,280,220,210,69,155,325
"2011","Northampton 021B","E01027152","Total",1738,253,50,203,1485,155,58,303,332,113,102,422
"2011","Northampton 021C","E01027153","Total",1769,575,124,451,1194,121,68,209,350,43,155,248
"2011","Northampton 021D","E01027154","Total",1757,260,52,208,1497,167,76,349,346,107,146,306
"2011","Northampton 021E","E01032978","Total",1375,451,68,383,924,124,32,184,328,78,59,119
"2011","Northampton 021F","E01032979","Total",1299,414,32,382,885,164,26,222,260,64,58,91
"2011","Northampton 022A","E01027132","Total",2016,358,62,296,1658,121,66,330,512,64,216,349
"2011","Northampton 022B","E01027133","Total",1706,240,70,170,1466,110,112,371,368,84,86,335
"2011","Northampton 022C","E01027134","Total",1757,200,44,156,1557,84,98,325,296,76,281,397
"2011","Northampton 022D","E01027135","Total",1751,190,83,107,1561,69,138,449,304,96,169,336
"2011","Northampton 023A","E01027155","Total",2191,373,75,298,1818,175,42,326,474,90,276,435
"2011","Northampton 023B","E01027225","Total",1652,276,29,247,1376,100,42,234,344,63,203,390
"2011","Northampton 023C","E01027227","Total",1577,213,34,179,1364,142,46,251,316,104,173,332
"2011","Northampton 023D","E01027228","Total",1906,390,73,317,1516,114,50,263,492,50,186,361
"2011","Northampton 024A","E01027151","Total",1609,279,58,221,1330,133,66,286,304,50,214,277
"2011","Northampton 024B","E01027236","Total",1457,251,137,114,1206,22,220,273,252,65,133,241
"2011","Northampton 024C","E01027237","Total",1976,274,88,186,1702,131,160,427,438,98,152,296
"2011","Northampton 024D","E01027238","Total",1948,410,114,296,1538,176,116,372,386,81,147,260
"2011","Northampton 025A","E01027223","Total",1949,574,73,501,1375,116,70,230,554,41,74,290
"2011","Northampton 025B","E01027224","Total",1724,439,78,361,1285,111,92,286,374,90,97,235
"2011","Northampton 025C","E01027226","Total",1734,375,82,293,1359,124,88,242,364,36,181,324
"2011","Northampton 025D","E01027257","Total",1090,118,83,35,972,24,236,246,182,56,87,141
"2011","Northampton 026A","E01027233","Total",1324,89,8,81,1235,232,30,285,212,156,147,173
"2011","Northampton 026B","E01027234","Total",1400,150,58,92,1250,101,94,392,336,106,89,132
"2011","Northampton 026C","E01027235","Total",1456,228,79,149,1228,252,84,243,200,99,214,136
"2011","Northampton 026D","E01027252","Total",1547,174,52,122,1373,210,98,366,266,118,139,176
"2011","Northampton 027A","E01027156","Total",1257,141,46,95,1116,144,76,227,204,103,190,172
"2011","Northampton 027B","E01027159","Total",1273,105,55,50,1168,42,180,258,208,78,143,259
"2011","Northampton 027C","E01027160","Total",1826,161,34,127,1665,66,92,553,326,129,228,271
"2011","Northampton 027D","E01027161","Total",1542,232,117,115,1310,192,124,280,196,94,186,238
"2011","Northampton 028B","E01027158","Total",1464,186,75,111,1278,141,110,310,318,50,128,221
"2011","Northampton 028C","E01027201","Total",2083,235,91,144,1848,139,242,621,346,109,129,262
"2011","Northampton 028D","E01027202","Total",1554,171,93,78,1383,67,264,322,254,98,104,274
"2011","Northampton 028E","E01032980","Total",1437,282,20,262,1155,159,12,251,468,27,75,163
"2011","Northampton 028F","E01032981","Total",1506,201,26,175,1305,151,70,307,340,58,99,280
"2011","Northampton 029A","E01027250","Total",1371,154,44,110,1217,37,170,284,294,83,106,243
"2011","Northampton 029C","E01027253","Total",1829,127,36,91,1702,122,218,395,362,89,233,283
"2011","Northampton 029D","E01027254","Total",1766,109,33,76,1657,72,146,541,284,96,200,318
"2011","Northampton 029E","E01032975","Total",1706,122,11,111,1584,94,38,654,370,81,160,187
"2011","Northampton 029F","E01032976","Total",1221,296,171,125,925,104,136,286,242,37,45,75
"2011","Northampton 029G","E01032977","Total",1780,195,6,189,1585,270,28,502,324,167,147,147
"2011","Northampton 030A","E01027162","Total",1556,221,31,190,1335,99,82,406,330,73,142,203
"2011","Northampton 030B","E01027163","Total",1401,126,65,61,1275,28,180,315,260,101,169,222
"2011","Northampton 030C","E01027164","Total",1513,162,13,149,1351,115,38,463,316,45,153,221
"2011","Northampton 030D","E01027165","Total",1333,63,16,47,1270,72,76,409,268,87,121,237
"2011","Northampton 030E","E01027166","Total",1613,115,11,104,1498,92,74,497,338,87,180,230
"2011","Northampton 030F","E01027167","Total",1406,142,61,81,1264,55,136,358,240,99,129,247
"2011","Northampton 031A","E01027203","Total",1619,76,8,68,1543,120,58,605,222,95,242,201
"2011","Northampton 031B","E01027204","Total",1684,138,64,74,1546,118,146,439,226,121,196,300
"2011","Northampton 031C","E01027205","Total",2259,89,18,71,2170,123,50,929,260,269,335,204
"2011","Northampton 031D","E01027206","Total",2878,158,65,93,2720,86,254,1025,368,206,395,386
"2011","South Northamptonshire 001A","E01027282","Total",1634,143,77,66,1491,80,184,299,300,97,237,294
"2011","South Northamptonshire 001B","E01027283","Total",1560,111,69,42,1449,22,212,376,294,77,208,260
"2011","South Northamptonshire 001C","E01027285","Total",1709,144,80,64,1565,77,268,297,288,118,205,312
"2011","South Northamptonshire 001D","E01027286","Total",1546,161,103,58,1385,52,278,303,232,92,130,298
"2011","South Northamptonshire 001E","E01027287","Total",1637,152,95,57,1485,62,322,313,272,112,162,242
"2011","South Northamptonshire 002A","E01027273","Total",1753,186,95,91,1567,95,338,351,322,88,172,201
"2011","South Northamptonshire 002B","E01027274","Total",1574,117,61,56,1457,77,192,358,292,82,170,286
"2011","South Northamptonshire 002C","E01027275","Total",1436,139,71,68,1297,48,288,266,202,92,141,260
"2011","South Northamptonshire 002D","E01027308","Total",1591,175,88,87,1416,54,226,329,340,103,120,244
"2011","South Northamptonshire 003A","E01027263","Total",1785,210,111,99,1575,54,354,319,326,68,156,298
"2011","South Northamptonshire 003C","E01027279","Total",1643,225,131,94,1418,53,282,268,288,91,132,304
"2011","South Northamptonshire 003D","E01027284","Total",1933,144,66,78,1789,47,206,430,382,98,213,413
"2011","South Northamptonshire 003E","E01027294","Total",1853,155,56,99,1698,92,214,406,342,139,173,332
"2011","South Northamptonshire 003F","E01032982","Total",1215,155,39,116,1060,83,52,347,194,87,143,154
"2011","South Northamptonshire 003G","E01032983","Total",1527,83,10,73,1444,75,36,667,224,160,167,115
"2011","South Northamptonshire 003H","E01032984","Total",1600,84,5,79,1516,54,28,720,228,174,149,163
"2011","South Northamptonshire 003I","E01032985","Total",1528,125,65,60,1403,35,246,358,256,80,177,251
"2011","South Northamptonshire 004A","E01027262","Total",1601,160,63,97,1441,22,228,387,330,67,127,280
"2011","South Northamptonshire 004B","E01027277","Total",1833,163,61,102,1670,81,248,441,394,73,182,251
"2011","South Northamptonshire 004C","E01027289","Total",1640,173,92,81,1467,45,276,345,326,85,119,271
"2011","South Northamptonshire 004D","E01027300","Total",1406,80,33,47,1326,45,108,323,270,87,166,327
"2011","South Northamptonshire 004E","E01027303","Total",1459,203,68,135,1256,37,138,317,280,83,143,258
"2011","South Northamptonshire 005A","E01027297","Total",1681,146,84,62,1535,34,268,396,312,96,129,300
"2011","South Northamptonshire 005B","E01027298","Total",1302,95,48,47,1207,29,138,327,258,50,142,263
"2011","South Northamptonshire 005C","E01027299","Total",1457,172,65,107,1285,61,164,331,256,51,154,268
"2011","South Northamptonshire 005D","E01027301","Total",2154,272,77,195,1882,109,140,673,412,107,216,225
"2011","South Northamptonshire 005E","E01027302","Total",1440,265,140,125,1175,99,122,303,224,100,112,215
"2011","South Northamptonshire 006A","E01027291","Total",1452,138,93,45,1314,30,234,311,214,103,172,250
"2011","South Northamptonshire 006B","E01027292","Total",1149,117,78,39,1032,42,158,229,150,72,147,234
"2011","South Northamptonshire 006C","E01027293","Total",1199,98,56,42,1101,38,154,292,208,49,104,256
"2011","South Northamptonshire 006D","E01027304","Total",1743,167,78,89,1576,45,258,401,328,128,163,253
"2011","South Northamptonshire 006E","E01027305","Total",1807,188,97,91,1619,55,252,346,374,124,141,327
"2011","South Northamptonshire 007A","E01027261","Total",2004,168,80,88,1836,47,224,536,296,92,255,386
"2011","South Northamptonshire 007B","E01027295","Total",2155,174,66,108,1981,85,262,558,394,108,211,363
"2011","South Northamptonshire 007C","E01027306","Total",1702,189,75,114,1513,56,240,358,314,103,152,290
"2011","South Northamptonshire 008A","E01027276","Total",2516,255,104,151,2261,105,334,627,424,156,241,374
"2011","South Northamptonshire 008B","E01027280","Total",2415,142,39,103,2273,74,192,719,432,187,250,419
"2011","South Northamptonshire 008C","E01027281","Total",1696,165,84,81,1531,72,204,360,264,138,202,291
"2011","South Northamptonshire 008D","E01027307","Total",2040,165,95,70,1875,54,342,428,364,89,174,424
"2011","South Northamptonshire 009A","E01027265","Total",1481,200,122,78,1281,70,214,350,272,51,93,231
"2011","South Northamptonshire 009B","E01027266","Total",1320,66,42,24,1254,24,176,302,198,120,167,267
"2011","South Northamptonshire 009C","E01027270","Total",1656,82,16,66,1574,58,78,668,248,123,184,215
"2011","South Northamptonshire 009D","E01027271","Total",1568,153,42,111,1415,67,94,565,292,88,151,158
"2011","South Northamptonshire 009E","E01027272","Total",1581,100,31,69,1481,67,96,410,328,146,195,239
"2011","South Northamptonshire 010A","E01027264","Total",1424,193,73,120,1231,56,200,239,308,72,100,256
"2011","South Northamptonshire 010B","E01027267","Total",1122,191,98,93,931,53,74,261,208,68,125,142
"2011","South Northamptonshire 010C","E01027268","Total",1262,115,38,77,1147,42,128,315,254,60,119,229
"2011","South Northamptonshire 010D","E01027269","Total",1458,276,103,173,1182,84,158,240,242,129,112,217
"2011","South Northamptonshire 011A","E01027288","Total",2116,253,132,121,1863,102,256,393,374,147,216,375
"2011","South Northamptonshire 011B","E01027290","Total",2136,216,100,116,1920,38,346,571,434,102,171,258
"2011","South Northamptonshire 011C","E01027296","Total",1998,215,96,119,1783,53,280,421,382,144,176,327
"2011","Wellingborough 001A","E01027326","Total",1485,237,101,136,1248,78,274,273,284,49,126,164
"2011","Wellingborough 001B","E01027327","Total",1473,268,91,177,1205,63,162,233,262,73,132,280
"2011","Wellingborough 001C","E01027328","Total",1344,167,73,94,1177,95,164,269,242,112,115,180
"2011","Wellingborough 001D","E01027338","Total",2263,255,133,122,2008,68,396,403,444,107,205,385
"2011","Wellingborough 002A","E01027330","Total",1667,142,42,100,1525,211,106,332,240,129,255,252
"2011","Wellingborough 002B","E01027331","Total",1392,234,96,138,1158,163,148,251,176,118,140,162
"2011","Wellingborough 002C","E01027332","Total",1496,165,104,61,1331,32,332,220,254,90,176,227
"2011","Wellingborough 002D","E01027333","Total",2342,127,28,99,2215,88,198,646,358,146,383,396
"2011","Wellingborough 002E","E01027334","Total",1375,146,21,125,1229,348,32,290,158,130,112,159
"2011","Wellingborough 003A","E01027343","Total",1476,165,66,99,1311,62,184,346,244,45,152,278
"2011","Wellingborough 003B","E01027344","Total",1375,199,100,99,1176,51,212,241,242,35,120,275
"2011","Wellingborough 003C","E01027345","Total",1366,63,25,38,1303,45,132,325,228,81,201,291
"2011","Wellingborough 003D","E01027346","Total",1477,123,24,99,1354,82,88,414,270,81,158,261
"2011","Wellingborough 003E","E01027347","Total",1936,135,55,80,1801,52,214,423,340,110,290,372
"2011","Wellingborough 004A","E01027313","Total",1627,186,63,123,1441,86,102,290,206,88,277,392
"2011","Wellingborough 004B","E01027314","Total",1886,360,90,270,1526,99,134,350,376,90,166,311
"2011","Wellingborough 004C","E01027315","Total",2227,404,93,311,1823,211,134,474,460,42,195,307
"2011","Wellingborough 004D","E01027316","Total",1501,210,74,136,1291,113,116,287,268,80,201,226
"2011","Wellingborough 005A","E01027339","Total",1347,169,66,103,1178,209,104,226,138,98,193,210
"2011","Wellingborough 005B","E01027340","Total",1484,214,103,111,1270,167,230,215,188,125,107,238
"2011","Wellingborough 005C","E01027341","Total",1530,158,52,106,1372,171,122,309,180,168,223,199
"2011","Wellingborough 005D","E01027342","Total",1412,255,85,170,1157,184,82,321,210,109,82,169
"2011","Wellingborough 006A","E01027349","Total",1539,470,115,355,1069,91,106,220,292,50,121,189
"2011","Wellingborough 006B","E01027350","Total",1416,243,112,131,1173,77,204,197,252,36,155,252
"2011","Wellingborough 006C","E01027351","Total",1559,349,169,180,1210,167,192,235,220,82,77,237
"2011","Wellingborough 006D","E01027352","Total",1390,253,102,151,1137,65,128,262,210,99,144,229
"2011","Wellingborough 007A","E01027309","Total",1497,162,98,64,1335,46,304,286,250,46,110,293
"2011","Wellingborough 007B","E01027310","Total",1505,204,42,162,1301,245,66,309,152,169,168,192
"2011","Wellingborough 007C","E01027311","Total",1261,102,38,64,1159,47,138,269,182,70,212,241
"2011","Wellingborough 007D","E01027312","Total",1418,188,89,99,1230,120,190,327,224,86,84,199
"2011","Wellingborough 008A","E01027317","Total",1491,211,104,107,1280,124,170,308,184,73,202,219
"2011","Wellingborough 008B","E01027318","Total",1487,156,46,110,1331,283,88,361,160,170,122,147
"2011","Wellingborough 008C","E01027319","Total",1530,172,59,113,1358,134,118,320,182,144,215,245
"2011","Wellingborough 008D","E01027320","Total",1863,193,63,130,1670,134,178,463,264,157,215,259
"2011","Wellingborough 008E","E01027321","Total",1576,96,20,76,1480,84,114,483,270,104,197,228
"2011","Wellingborough 009A","E01027322","Total",1161,154,58,96,1007,46,102,262,238,43,122,194
"2011","Wellingborough 009B","E01027323","Total",1462,175,90,85,1287,110,158,351,208,92,148,220
"2011","Wellingborough 009C","E01027324","Total",1186,97,66,31,1089,31,242,248,238,56,62,212
"2011","Wellingborough 009D","E01027325","Total",1558,191,66,125,1367,98,188,333,282,133,127,206
"2011","Wellingborough 009E","E01027329","Total",1747,222,136,86,1525,55,346,299,330,68,146,281
"2011","Wellingborough 009F","E01027353","Total",1725,212,111,101,1513,63,308,323,340,59,112,308
"2011","Wellingborough 010A","E01027335","Total",1474,147,81,66,1327,59,256,256,270,60,128,298
"2011","Wellingborough 010B","E01027336","Total",1403,239,134,105,1164,99,154,253,244,83,96,235
"2011","Wellingborough 010C","E01027337","Total",1783,231,90,141,1552,92,250,436,306,88,127,253
"2011","Wellingborough 010D","E01027348","Total",2036,220,94,126,1816,81,306,448,470,108,174,229
"2011","Wellingborough 010E","E01027354","Total",2378,317,132,185,2061,154,242,547,478,134,187,319
"2011","Wellingborough 010F","E01027355","Total",1657,116,56,60,1541,35,264,393,292,159,111,287
"2011","Ashfield 001A","E01027979","Total",1512,193,97,96,1319,38,318,203,292,48,159,261
"2011","Ashfield 001B","E01027980","Total",1555,199,95,104,1356,178,132,300,226,117,199,204
"2011","Ashfield 001C","E01027981","Total",1559,164,85,79,1395,70,288,266,300,52,142,277
"2011","Ashfield 001D","E01027983","Total",1515,201,49,152,1314,99,136,284,248,121,179,247
"2011","Ashfield 002A","E01027970","Total",1406,162,58,104,1244,60,170,311,264,52,147,240
"2011","Ashfield 002B","E01027971","Total",1387,115,64,51,1272,53,274,206,296,38,117,288
"2011","Ashfield 002C","E01027982","Total",1408,225,114,111,1183,51,228,247,256,71,97,233
"2011","Ashfield 002D","E01027984","Total",1494,163,74,89,1331,42,208,355,270,44,145,267
"2011","Ashfield 003A","E01027966","Total",1366,262,145,117,1104,122,154,182,156,123,180,187
"2011","Ashfield 003B","E01027986","Total",1333,225,81,144,1108,64,164,239,240,68,119,214
"2011","Ashfield 003C","E01027987","Total",1813,194,82,112,1619,217,154,380,298,145,206,219
"2011","Ashfield 003D","E01027990","Total",1831,193,68,125,1638,89,178,480,410,66,128,287
"2011","Ashfield 004A","E01027967","Total",1668,252,71,181,1416,177,120,404,264,62,149,240
"2011","Ashfield 004B","E01027972","Total",2239,173,68,105,2066,181,220,533,374,148,258,352
"2011","Ashfield 004C","E01027977","Total",1867,217,91,126,1650,145,150,385,336,120,163,351
"2011","Ashfield 004D","E01027978","Total",1811,279,67,212,1532,210,102,413,282,110,147,268
"2011","Ashfield 004E","E01027985","Total",1837,199,71,128,1638,159,136,420,336,162,154,271
"2011","Ashfield 005A","E01027964","Total",1472,171,77,94,1301,95,162,263,224,116,206,235
"2011","Ashfield 005B","E01027965","Total",1317,171,85,86,1146,180,94,219,212,100,174,167
"2011","Ashfield 005C","E01027968","Total",1200,240,123,117,960,153,126,205,148,85,72,171
"2011","Ashfield 005D","E01027974","Total",1670,219,67,152,1451,201,136,179,178,225,279,253
"2011","Ashfield 005E","E01027976","Total",1584,337,167,170,1247,141,218,240,212,77,123,236
"2011","Ashfield 006A","E01027969","Total",1366,150,52,98,1216,119,130,297,254,59,126,231
"2011","Ashfield 006B","E01027975","Total",1659,190,80,110,1469,106,158,387,314,106,107,291
"2011","Ashfield 006C","E01027988","Total",1588,171,79,92,1417,72,248,360,280,46,136,275
"2011","Ashfield 006D","E01027989","Total",1598,197,110,87,1401,53,340,277,320,61,106,244
"2011","Ashfield 006E","E01027991","Total",1253,163,62,101,1090,72,140,230,190,85,129,244
"2011","Ashfield 006F","E01027992","Total",2220,138,22,116,2082,90,144,692,452,144,197,363
"2011","Ashfield 007A","E01027949","Total",1535,154,70,84,1381,72,208,301,286,103,146,265
"2011","Ashfield 007B","E01027951","Total",1595,179,48,131,1416,252,136,268,210,173,195,182
"2011","Ashfield 007C","E01027953","Total",1495,136,80,56,1359,70,252,244,294,78,154,267
"2011","Ashfield 007D","E01027954","Total",1604,169,38,131,1435,168,112,408,280,91,142,234
"2011","Ashfield 007E","E01027973","Total",1618,121,84,37,1497,25,262,463,264,55,152,276
"2011","Ashfield 008A","E01027952","Total",1811,292,120,172,1519,167,124,378,260,133,150,307
"2011","Ashfield 008B","E01027955","Total",1229,123,33,90,1106,106,94,248,240,87,127,204
"2011","Ashfield 008C","E01027956","Total",1500,247,150,97,1253,132,178,261,206,105,143,228
"2011","Ashfield 008D","E01027958","Total",1432,180,76,104,1252,159,100,299,200,106,157,231
"2011","Ashfield 009A","E01027947","Total",1674,172,81,91,1502,83,200,359,284,107,196,273
"2011","Ashfield 009B","E01027948","Total",1853,216,83,133,1637,68,192,420,360,90,172,335
"2011","Ashfield 009C","E01027950","Total",1987,276,129,147,1711,95,286,373,404,93,152,308
"2011","Ashfield 009D","E01027957","Total",1263,134,73,61,1129,74,154,283,208,43,111,256
"2011","Ashfield 009E","E01027959","Total",1491,83,34,49,1408,41,92,378,248,100,239,310
"2011","Ashfield 010A","E01027995","Total",1557,158,81,77,1399,86,206,277,374,55,118,283
"2011","Ashfield 010B","E01027996","Total",2017,236,112,124,1781,149,192,415,338,45,244,398
"2011","Ashfield 010C","E01027997","Total",1664,190,102,88,1474,58,286,241,348,85,119,337
"2011","Ashfield 010D","E01027998","Total",1834,244,122,122,1590,122,322,295,338,63,165,285
"2011","Ashfield 011A","E01027960","Total",1635,238,100,138,1397,95,252,306,242,45,157,300
"2011","Ashfield 011B","E01027961","Total",1849,183,92,91,1666,59,300,315,358,87,194,353
"2011","Ashfield 011C","E01027962","Total",1498,136,56,80,1362,88,144,341,286,91,117,295
"2011","Ashfield 011D","E01027963","Total",1683,146,73,73,1537,95,178,338,238,154,258,276
"2011","Ashfield 012A","E01027945","Total",1688,201,82,119,1487,127,200,334,276,90,155,305
"2011","Ashfield 012B","E01027946","Total",1451,157,73,84,1294,65,200,240,254,54,106,375
"2011","Ashfield 012C","E01027993","Total",1526,161,76,85,1365,45,258,315,280,66,153,248
"2011","Ashfield 012D","E01027994","Total",1427,196,110,86,1231,58,224,262,234,93,134,226
"2011","Ashfield 013A","E01027929","Total",2392,288,94,194,2104,187,188,611,542,89,168,319
"2011","Ashfield 013B","E01027931","Total",1960,295,99,196,1665,191,198,348,392,89,193,254
"2011","Ashfield 013C","E01027934","Total",1379,156,57,99,1223,76,112,384,256,77,95,223
"2011","Ashfield 013D","E01027935","Total",1234,120,44,76,1114,52,114,258,230,51,188,221
"2011","Ashfield 013E","E01027936","Total",1485,142,94,48,1343,40,318,326,294,47,118,200
"2011","Ashfield 014A","E01027927","Total",1997,349,151,198,1648,155,192,443,336,109,181,232
"2011","Ashfield 014B","E01027928","Total",1853,340,88,252,1513,120,158,429,356,88,147,215
"2011","Ashfield 014C","E01027932","Total",2152,242,63,179,1910,213,172,518,378,137,221,271
"2011","Ashfield 014D","E01027933","Total",1479,206,80,126,1273,111,130,359,278,35,114,246
"2011","Ashfield 014E","E01027937","Total",1348,264,105,159,1084,129,124,295,212,70,84,170
"2011","Ashfield 015A","E01027925","Total",1827,161,93,68,1666,99,294,421,240,104,163,345
"2011","Ashfield 015B","E01027938","Total",1325,87,27,60,1238,48,68,374,236,67,163,282
"2011","Ashfield 015C","E01027940","Total",1329,112,50,62,1217,51,192,284,286,50,116,238
"2011","Ashfield 015D","E01027943","Total",1380,152,75,77,1228,80,164,302,260,62,123,237
"2011","Ashfield 015E","E01027944","Total",1531,163,92,71,1368,81,226,313,272,42,130,304
"2011","Ashfield 016A","E01027926","Total",1450,180,91,89,1270,64,262,259,268,40,116,261
"2011","Ashfield 016B","E01027930","Total",1543,267,83,184,1276,158,128,322,232,113,95,228
"2011","Ashfield 016C","E01027939","Total",1464,179,98,81,1285,168,126,236,184,104,182,285
"2011","Ashfield 016D","E01027941","Total",1288,173,69,104,1115,71,156,190,242,81,138,237
"2011","Ashfield 016E","E01027942","Total",1353,111,47,64,1242,170,140,248,196,121,118,249
"2011","Bassetlaw 001A","E01028000","Total",2155,253,146,107,1902,51,362,441,424,72,178,374
"2011","Bassetlaw 001B","E01028024","Total",1819,203,98,105,1616,98,246,382,314,61,214,301
"2011","Bassetlaw 001C","E01028025","Total",1510,183,72,111,1327,134,120,253,284,98,210,228
"2011","Bassetlaw 001D","E01028026","Total",1530,200,116,84,1330,127,198,277,218,116,178,216
"2011","Bassetlaw 001E","E01028027","Total",1439,147,61,86,1292,94,162,280,250,90,173,243
"2011","Bassetlaw 001F","E01028028","Total",1582,188,107,81,1394,98,210,351,270,107,172,186
"2011","Bassetlaw 002A","E01027999","Total",2252,255,134,121,1997,46,434,463,424,143,135,352
"2011","Bassetlaw 002B","E01028005","Total",1892,187,95,92,1705,43,380,297,370,103,142,370
"2011","Bassetlaw 002C","E01028031","Total",1085,129,66,63,956,39,180,209,178,79,72,199
"2011","Bassetlaw 002D","E01028032","Total",1374,123,67,56,1251,28,190,322,252,102,157,200
"2011","Bassetlaw 002E","E01028035","Total",2289,210,102,108,2079,77,360,438,460,150,229,365
"2011","Bassetlaw 003A","E01028023","Total",2274,204,101,103,2070,71,346,493,450,132,163,415
"2011","Bassetlaw 003B","E01028034","Total",2346,235,120,115,2111,84,420,457,442,127,192,389
"2011","Bassetlaw 003C","E01028036","Total",1973,239,112,127,1734,47,298,376,388,85,228,312
"2011","Bassetlaw 004A","E01028001","Total",1292,217,123,94,1075,142,138,234,194,81,138,148
"2011","Bassetlaw 004B","E01028002","Total",1387,150,83,67,1237,63,224,234,244,82,108,282
"2011","Bassetlaw 004C","E01028003","Total",1380,148,77,71,1232,63,220,241,260,66,114,268
"2011","Bassetlaw 004D","E01028004","Total",1529,156,111,45,1373,38,310,223,330,45,110,317
"2011","Bassetlaw 004E","E01028029","Total",1170,157,84,73,1013,81,152,182,208,48,115,227
"2011","Bassetlaw 004F","E01028030","Total",1296,92,47,45,1204,76,116,293,208,86,144,281
"2011","Bassetlaw 005A","E01028013","Total",1744,260,156,104,1484,108,270,259,266,106,236,239
"2011","Bassetlaw 005B","E01028014","Total",1512,343,193,150,1169,84,200,249,228,93,124,191
"2011","Bassetlaw 005C","E01028015","Total",1491,136,60,76,1355,49,172,368,310,35,120,301
"2011","Bassetlaw 005D","E01028016","Total",1336,174,103,71,1162,54,298,240,226,50,101,193
"2011","Bassetlaw 006A","E01028046","Total",1547,168,73,95,1379,66,202,369,302,44,86,310
"2011","Bassetlaw 006B","E01028047","Total",2143,101,10,91,2042,81,92,751,334,155,368,261
"2011","Bassetlaw 006C","E01028048","Total",1663,81,30,51,1582,77,112,490,318,100,175,310
"2011","Bassetlaw 006D","E01028049","Total",1714,237,134,103,1477,89,198,363,284,117,161,265
"2011","Bassetlaw 006E","E01028050","Total",1907,150,57,93,1757,81,116,545,314,80,243,378
"2011","Bassetlaw 008A","E01028008","Total",1307,112,44,68,1195,167,112,261,174,111,173,197
"2011","Bassetlaw 008B","E01028009","Total",1399,151,81,70,1248,31,370,216,234,47,78,272
"2011","Bassetlaw 008C","E01028010","Total",1363,108,47,61,1255,23,218,337,196,53,115,313
"2011","Bassetlaw 008D","E01028011","Total",1556,357,118,239,1199,142,156,250,296,62,121,172
"2011","Bassetlaw 008E","E01028012","Total",1338,209,88,121,1129,90,132,254,258,65,105,225
"2011","Bassetlaw 008F","E01028022","Total",1507,195,51,144,1312,114,118,337,286,64,146,247
"2011","Bassetlaw 009A","E01028055","Total",1451,369,93,276,1082,148,118,288,254,20,75,179
"2011","Bassetlaw 009B","E01028056","Total",1251,118,60,58,1133,79,108,297,214,83,132,220
"2011","Bassetlaw 009C","E01028058","Total",1804,159,68,91,1645,79,186,490,368,71,170,281
"2011","Bassetlaw 009D","E01028059","Total",1822,78,27,51,1744,74,82,576,316,178,196,322
"2011","Bassetlaw 010A","E01028017","Total",1300,226,128,98,1074,69,226,169,226,102,124,158
"2011","Bassetlaw 010B","E01028018","Total",1470,146,57,89,1324,86,162,306,318,41,156,255
"2011","Bassetlaw 010C","E01028019","Total",1445,197,86,111,1248,132,170,264,234,103,159,186
"2011","Bassetlaw 010D","E01028020","Total",1793,351,75,276,1442,126,120,393,370,116,102,215
"2011","Bassetlaw 010E","E01028021","Total",1508,220,121,99,1288,56,210,346,246,63,136,231
"2011","Bassetlaw 012A","E01028057","Total",1248,242,43,199,1006,130,52,224,266,25,109,200
"2011","Bassetlaw 012B","E01028065","Total",1732,229,103,126,1503,268,94,351,230,171,163,226
"2011","Bassetlaw 012C","E01028066","Total",1674,209,82,127,1465,204,104,269,260,192,202,234
"2011","Bassetlaw 012D","E01028068","Total",1693,353,118,235,1340,121,134,347,284,97,118,239
"2011","Bassetlaw 013A","E01028060","Total",1685,161,102,59,1524,32,370,312,274,67,168,301
"2011","Bassetlaw 013B","E01028061","Total",1487,161,57,104,1326,44,170,426,298,37,148,203
"2011","Bassetlaw 013C","E01028062","Total",1882,342,102,240,1540,116,208,338,392,100,119,267
"2011","Bassetlaw 013D","E01028067","Total",1513,201,69,132,1312,79,136,291,216,113,188,289
"2011","Bassetlaw 014A","E01028040","Total",1020,113,56,57,907,67,138,241,174,37,103,147
"2011","Bassetlaw 014B","E01028041","Total",1029,123,72,51,906,41,164,145,192,30,102,232
"2011","Bassetlaw 014C","E01028043","Total",1450,126,77,49,1324,55,246,271,242,26,199,285
"2011","Bassetlaw 014D","E01028063","Total",1779,155,79,76,1624,40,288,366,314,77,183,356
"2011","Bassetlaw 014E","E01028064","Total",1313,135,66,69,1178,80,152,250,186,95,160,255
"2011","Bassetlaw 015A","E01028006","Total",1226,140,72,68,1086,35,192,263,260,43,110,183
"2011","Bassetlaw 015B","E01028007","Total",1114,99,51,48,1015,43,162,237,192,48,133,200
"2011","Bassetlaw 015C","E01028033","Total",1992,186,99,87,1806,49,298,391,394,114,203,357
"2011","Bassetlaw 015D","E01028037","Total",1637,160,63,97,1477,72,230,331,314,96,160,274
"2011","Bassetlaw 015E","E01028038","Total",1450,199,91,108,1251,78,180,264,238,90,126,275
"2011","Bassetlaw 015F","E01028039","Total",1163,118,70,48,1045,33,202,189,256,82,84,199
"2011","Bassetlaw 016E","E01028042","Total",1436,129,79,50,1307,72,136,323,226,54,212,284
"2011","Bassetlaw 016F","E01028044","Total",1523,318,176,142,1205,107,182,265,250,87,118,196
"2011","Bassetlaw 016G","E01028045","Total",1913,283,183,100,1630,69,242,383,322,103,185,326
"2011","Bassetlaw 016A","E01028051","Total",1477,267,136,131,1210,46,260,243,310,48,72,231
"2011","Bassetlaw 016B","E01028052","Total",1664,146,95,51,1518,48,300,332,266,49,203,320
"2011","Bassetlaw 016C","E01028053","Total",1514,336,107,229,1178,80,182,258,320,85,66,187
"2011","Bassetlaw 016D","E01028054","Total",1420,114,59,55,1306,26,230,278,216,74,128,354
"2011","Broxtowe 001A","E01028092","Total",1286,123,68,55,1163,56,150,237,232,110,108,270
"2011","Broxtowe 001B","E01028093","Total",1006,114,66,48,892,8,188,155,226,45,87,183
"2011","Broxtowe 001C","E01028107","Total",1565,129,54,75,1436,32,160,349,336,86,114,359
"2011","Broxtowe 001D","E01028108","Total",1485,181,94,87,1304,49,212,282,290,41,126,304
"2011","Broxtowe 001E","E01028114","Total",1434,214,97,117,1220,63,230,252,254,62,96,263
"2011","Broxtowe 002A","E01028110","Total",1433,198,78,120,1235,90,156,291,218,130,127,223
"2011","Broxtowe 002B","E01028111","Total",1403,177,81,96,1226,99,204,220,286,59,89,269
"2011","Broxtowe 002C","E01028112","Total",1536,296,116,180,1240,113,116,258,292,105,86,270
"2011","Broxtowe 002D","E01028113","Total",1491,183,97,86,1308,73,160,253,182,175,172,293
"2011","Broxtowe 003A","E01028109","Total",1697,199,113,86,1498,52,248,300,350,83,144,321
"2011","Broxtowe 003B","E01028115","Total",1478,160,92,68,1318,43,326,245,286,42,94,282
"2011","Broxtowe 003C","E01028116","Total",1559,204,100,104,1355,64,200,385,274,57,131,244
"2011","Broxtowe 003D","E01028117","Total",1534,79,24,55,1455,26,114,420,268,104,189,334
"2011","Broxtowe 003E","E01028118","Total",1639,210,135,75,1429,19,446,238,288,42,132,264
"2011","Broxtowe 004A","E01028102","Total",1370,140,61,79,1230,77,150,238,296,49,144,276
"2011","Broxtowe 004B","E01028103","Total",1146,206,69,137,940,84,112,184,198,60,106,196
"2011","Broxtowe 004C","E01028104","Total",1446,151,61,90,1295,42,168,321,316,37,150,261
"2011","Broxtowe 004D","E01028122","Total",1584,272,167,105,1312,81,200,326,252,40,159,254
"2011","Broxtowe 004E","E01028123","Total",1901,158,50,108,1743,47,242,436,348,105,188,377
"2011","Broxtowe 004F","E01028124","Total",1512,164,95,69,1348,40,272,270,206,76,174,310
"2011","Broxtowe 007A","E01028087","Total",1574,184,103,81,1390,8,292,303,256,71,163,297
"2011","Broxtowe 007B","E01028088","Total",1472,152,93,59,1320,19,276,317,252,51,109,296
"2011","Broxtowe 007C","E01028089","Total",1341,101,59,42,1240,18,250,303,202,75,109,283
"2011","Broxtowe 007D","E01028090","Total",1382,215,123,92,1167,49,188,277,236,70,120,227
"2011","Broxtowe 007E","E01028091","Total",1477,138,93,45,1339,39,260,282,258,98,114,288
"2011","Broxtowe 008A","E01028125","Total",1632,166,73,93,1466,68,250,326,276,105,110,331
"2011","Broxtowe 008B","E01028126","Total",1444,150,68,82,1294,114,140,307,214,99,180,240
"2011","Broxtowe 008C","E01028127","Total",1696,239,95,144,1457,216,230,317,212,91,138,253
"2011","Broxtowe 008D","E01028134","Total",1466,184,67,117,1282,125,102,330,272,81,85,287
"2011","Broxtowe 009A","E01028076","Total",1239,202,68,134,1037,64,150,182,288,52,92,209
"2011","Broxtowe 009B","E01028077","Total",1456,168,96,72,1288,79,120,217,242,113,186,331
"2011","Broxtowe 009C","E01028078","Total",1593,137,57,80,1456,71,128,303,298,102,174,380
"2011","Broxtowe 009D","E01028079","Total",1364,160,69,91,1204,27,98,197,210,120,95,457
"2011","Broxtowe 009E","E01028084","Total",1797,187,80,107,1610,39,194,467,370,121,168,251
"2011","Broxtowe 010A","E01028128","Total",1742,171,85,86,1571,51,248,417,280,62,150,363
"2011","Broxtowe 010B","E01028129","Total",1471,197,97,100,1274,57,196,297,194,92,158,280
"2011","Broxtowe 010C","E01028130","Total",1757,284,142,142,1473,154,186,333,292,133,112,263
"2011","Broxtowe 010D","E01028131","Total",1491,153,70,83,1338,60,202,342,228,83,132,291
"2011","Broxtowe 010E","E01028132","Total",1057,126,55,71,931,82,92,244,148,70,108,187
"2011","Broxtowe 010F","E01028133","Total",1457,198,42,156,1259,114,118,310,270,56,139,252
"2011","Broxtowe 011A","E01028073","Total",1472,381,221,160,1091,37,164,151,244,42,67,386
"2011","Broxtowe 011B","E01028074","Total",1583,263,139,124,1320,56,144,163,258,32,91,576
"2011","Broxtowe 011C","E01028075","Total",1661,194,78,116,1467,76,74,300,356,93,89,479
"2011","Broxtowe 011D","E01028085","Total",1985,302,125,177,1683,40,176,403,466,111,142,345
"2011","Broxtowe 011E","E01028086","Total",1478,295,99,196,1183,44,128,298,320,45,83,265
"2011","Broxtowe 012A","E01028080","Total",1701,229,54,175,1472,116,120,327,434,36,106,333
"2011","Broxtowe 012B","E01028081","Total",1168,207,87,120,961,48,222,189,206,30,66,200
"2011","Broxtowe 012C","E01028082","Total",1257,117,51,66,1140,24,128,326,206,36,116,304
"2011","Broxtowe 012D","E01028083","Total",1298,229,42,187,1069,79,76,232,260,47,89,286
"2011","Broxtowe 013A","E01028097","Total",1446,121,60,61,1325,36,264,297,294,43,72,319
"2011","Broxtowe 013B","E01028098","Total",1759,211,78,133,1548,99,162,528,272,128,170,189
"2011","Broxtowe 013C","E01028099","Total",1353,186,89,97,1167,42,242,260,256,40,77,250
"2011","Broxtowe 013D","E01028100","Total",1683,268,164,104,1415,89,274,294,260,79,137,282
"2011","Broxtowe 013E","E01028101","Total",1427,153,51,102,1274,235,128,251,204,63,141,252
"2011","Broxtowe 014A","E01028069","Total",1183,134,69,65,1049,46,158,271,260,41,56,217
"2011","Broxtowe 014B","E01028070","Total",1105,111,71,40,994,21,254,190,192,40,107,190
"2011","Broxtowe 014C","E01028094","Total",1712,219,113,106,1493,64,200,348,338,131,145,267
"2011","Broxtowe 014D","E01028095","Total",1452,164,94,70,1288,50,224,322,212,96,102,282
"2011","Broxtowe 014E","E01028096","Total",1729,230,132,98,1499,42,274,383,288,91,157,264
"2011","Broxtowe 015A","E01028135","Total",1403,121,82,39,1282,27,222,333,208,61,146,285
"2011","Broxtowe 015B","E01028136","Total",1714,137,83,54,1577,36,254,428,204,107,219,329
"2011","Broxtowe 015C","E01028137","Total",2473,210,37,173,2263,110,106,846,552,114,207,328
"2011","Broxtowe 015D","E01028138","Total",1167,216,101,115,951,42,166,184,200,55,95,209
"2011","Broxtowe 015E","E01028139","Total",1443,112,52,60,1331,75,148,414,248,51,143,252
"2011","Broxtowe 016A","E01028105","Total",1238,117,50,67,1121,60,174,214,196,83,151,243
"2011","Broxtowe 016B","E01028106","Total",1453,209,91,118,1244,49,218,257,288,46,96,290
"2011","Broxtowe 016C","E01028119","Total",2175,154,26,128,2021,76,114,545,382,133,397,374
"2011","Broxtowe 016D","E01028120","Total",1588,124,77,47,1464,31,284,344,252,35,205,313
"2011","Broxtowe 016E","E01028121","Total",1474,129,58,71,1345,44,162,437,206,70,150,276
"2011","Broxtowe 016F","E01033412","Total",2378,225,136,89,2153,78,394,447,448,63,243,480
"2011","Broxtowe 016G","E01033413","Total",2199,245,97,148,1954,106,252,484,436,52,238,386
"2011","Gedling 001A","E01028189","Total",2280,260,107,153,2020,86,246,460,414,79,300,435
"2011","Gedling 001B","E01028198","Total",1397,149,106,43,1248,38,288,298,256,30,121,217
"2011","Gedling 001C","E01028199","Total",1457,147,100,47,1310,27,414,251,250,47,110,211
"2011","Gedling 001D","E01028200","Total",1613,164,78,86,1449,66,272,320,296,61,151,283
"2011","Gedling 001E","E01028201","Total",1159,124,81,43,1035,9,230,286,154,52,73,231
"2011","Gedling 002A","E01028150","Total",1355,161,95,66,1194,41,264,203,276,48,106,256
"2011","Gedling 002B","E01028151","Total",1125,98,48,50,1027,53,154,269,214,20,89,228
"2011","Gedling 002C","E01028152","Total",1513,155,72,83,1358,81,198,311,234,53,183,298
"2011","Gedling 002D","E01028153","Total",1295,196,104,92,1099,125,140,230,212,86,87,219
"2011","Gedling 002E","E01028154","Total",1722,148,67,81,1574,140,150,369,308,105,153,349
"2011","Gedling 002F","E01028213","Total",1872,312,114,198,1560,30,394,313,292,102,182,247
"2011","Gedling 004A","E01028143","Total",1293,257,134,123,1036,80,196,208,198,88,89,177
"2011","Gedling 004B","E01028205","Total",1266,132,61,71,1134,84,138,253,210,56,136,257
"2011","Gedling 004C","E01028206","Total",1462,159,78,81,1303,82,220,265,274,52,132,278
"2011","Gedling 004D","E01028207","Total",1320,99,64,35,1221,46,226,257,216,79,157,240
"2011","Gedling 004E","E01028208","Total",1084,145,68,77,939,80,148,247,190,46,111,117
"2011","Gedling 005A","E01028173","Total",1001,177,95,82,824,122,84,141,102,65,183,127
"2011","Gedling 005B","E01028174","Total",1547,138,67,71,1409,131,124,353,178,135,214,274
"2011","Gedling 005C","E01028175","Total",1798,246,105,141,1552,111,234,418,308,77,132,272
"2011","Gedling 005D","E01028209","Total",1444,186,83,103,1258,155,128,265,236,68,111,295
"2011","Gedling 006A","E01028144","Total",1508,197,81,116,1311,173,158,301,236,77,138,228
"2011","Gedling 006B","E01028165","Total",1473,335,160,175,1138,106,174,245,234,89,114,176
"2011","Gedling 006C","E01028166","Total",1701,212,70,142,1489,145,182,302,244,99,232,285
"2011","Gedling 006D","E01028167","Total",1828,286,77,209,1542,139,146,362,338,79,185,293
"2011","Gedling 007A","E01028179","Total",1436,138,51,87,1298,41,204,313,228,52,136,324
"2011","Gedling 007B","E01028180","Total",1474,175,81,94,1299,81,244,322,236,50,95,271
"2011","Gedling 007C","E01028181","Total",1362,246,71,175,1116,57,112,292,320,15,102,218
"2011","Gedling 007D","E01028182","Total",1593,166,65,101,1427,68,168,300,276,119,220,276
"2011","Gedling 007E","E01028183","Total",1252,187,120,67,1065,55,274,202,242,68,59,165
"2011","Gedling 008A","E01028148","Total",1979,190,116,74,1789,42,420,474,282,102,155,314
"2011","Gedling 008B","E01028149","Total",1623,257,151,106,1366,56,242,414,252,43,110,249
"2011","Gedling 008C","E01028178","Total",2099,271,129,142,1828,64,374,331,362,133,269,295
"2011","Gedling 009A","E01028176","Total",1524,144,81,63,1380,40,222,330,252,82,213,241
"2011","Gedling 009B","E01028177","Total",1552,251,99,152,1301,104,220,302,322,48,72,233
"2011","Gedling 009C","E01028214","Total",1464,182,105,77,1282,39,222,335,228,77,147,234
"2011","Gedling 009D","E01028215","Total",1347,101,55,46,1246,34,146,367,180,91,118,310
"2011","Gedling 009E","E01028216","Total",1290,110,68,42,1180,37,182,295,202,46,166,252
"2011","Gedling 009F","E01028217","Total",1263,211,79,132,1052,15,162,226,248,71,149,181
"2011","Gedling 009G","E01028218","Total",1502,180,105,75,1322,24,322,269,244,71,135,257
"2011","Gedling 010A","E01028193","Total",1354,304,171,133,1050,38,142,253,224,69,121,203
"2011","Gedling 010B","E01028194","Total",1461,216,70,146,1245,55,108,359,278,84,99,262
"2011","Gedling 010C","E01028195","Total",1396,180,59,121,1216,62,124,326,314,41,107,242
"2011","Gedling 010D","E01028196","Total",1428,128,51,77,1300,33,162,309,272,94,159,271
"2011","Gedling 010E","E01028197","Total",1375,178,98,80,1197,67,234,261,218,72,129,216
"2011","Gedling 010F","E01028204","Total",1339,142,58,84,1197,51,224,273,234,40,88,287
"2011","Gedling 011A","E01028172","Total",1142,106,50,56,1036,46,138,287,176,57,108,224
"2011","Gedling 011B","E01028190","Total",1594,146,64,82,1448,98,170,377,258,51,176,318
"2011","Gedling 011C","E01028202","Total",1456,205,112,93,1251,44,246,252,218,73,139,279
"2011","Gedling 011D","E01028203","Total",1391,164,71,93,1227,71,188,249,246,69,118,286
"2011","Gedling 011E","E01028212","Total",1589,140,62,78,1449,188,134,335,238,94,215,245
"2011","Gedling 012A","E01028168","Total",1280,142,78,64,1138,45,180,303,222,65,116,207
"2011","Gedling 012B","E01028169","Total",1456,124,68,56,1332,38,290,288,222,46,166,282
"2011","Gedling 012C","E01028170","Total",1417,199,119,80,1218,56,172,253,204,79,157,297
"2011","Gedling 012D","E01028171","Total",1348,157,57,100,1191,73,128,256,244,69,207,214
"2011","Gedling 012E","E01028191","Total",1824,182,71,111,1642,117,150,398,328,129,229,291
"2011","Gedling 012F","E01028192","Total",1544,183,63,120,1361,148,136,320,240,87,194,236
"2011","Gedling 013A","E01028160","Total",1519,205,67,138,1314,80,136,349,246,67,151,285
"2011","Gedling 013B","E01028161","Total",1469,221,70,151,1248,109,122,300,278,95,112,232
"2011","Gedling 013C","E01028162","Total",1496,183,67,116,1313,148,128,321,232,83,154,247
"2011","Gedling 013D","E01028163","Total",1482,184,77,107,1298,37,212,291,246,72,133,307
"2011","Gedling 013E","E01028211","Total",1361,164,73,91,1197,82,188,229,230,59,135,274
"2011","Gedling 014A","E01028155","Total",1414,210,102,108,1204,84,144,236,214,71,160,295
"2011","Gedling 014B","E01028156","Total",1308,276,120,156,1032,71,154,205,256,69,99,178
"2011","Gedling 014C","E01028157","Total",1299,97,50,47,1202,32,154,230,210,86,205,285
"2011","Gedling 014D","E01028158","Total",1559,303,119,184,1256,104,162,226,322,87,131,224
"2011","Gedling 014E","E01028159","Total",1301,228,84,144,1073,95,132,216,212,91,114,213
"2011","Gedling 014F","E01028164","Total",1285,203,76,127,1082,134,108,186,178,66,152,258
"2011","Gedling 014G","E01028210","Total",1382,283,130,153,1099,111,128,291,270,50,104,145
"2011","Gedling 015A","E01028184","Total",1166,107,25,82,1059,38,138,260,242,69,130,182
"2011","Gedling 015B","E01028185","Total",1852,330,118,212,1522,212,182,346,324,76,181,201
"2011","Gedling 015C","E01028186","Total",1515,336,84,252,1179,147,78,335,276,30,118,195
"2011","Gedling 015D","E01028187","Total",1420,233,32,201,1187,252,46,328,312,41,70,138
"2011","Gedling 015E","E01028188","Total",1445,189,22,167,1256,124,46,372,368,36,103,207
"2011","Gedling 016A","E01028142","Total",1905,223,104,119,1682,99,324,350,402,97,158,252
"2011","Gedling 016B","E01028146","Total",1503,181,31,150,1322,131,78,302,338,55,92,326
"2011","Gedling 016C","E01028147","Total",1057,179,23,156,878,139,54,214,152,81,113,125
"2011","Gedling 016D","E01032622","Total",1354,118,49,69,1236,45,178,262,218,73,135,325
"2011","Mansfield 001A","E01028224","Total",1466,186,114,72,1280,46,298,236,206,85,135,274
"2011","Mansfield 001B","E01028257","Total",1625,109,61,48,1516,126,130,367,198,120,275,300
"2011","Mansfield 001C","E01028258","Total",1651,221,138,83,1430,58,288,244,228,84,168,360
"2011","Mansfield 001D","E01028259","Total",1493,115,58,57,1378,98,114,274,234,129,223,306
"2011","Mansfield 002A","E01028223","Total",965,159,80,79,806,46,94,201,148,46,118,153
"2011","Mansfield 002B","E01028225","Total",1558,165,110,55,1393,60,214,283,246,86,213,291
"2011","Mansfield 002C","E01028226","Total",1484,158,52,106,1326,139,114,349,218,113,169,224
"2011","Mansfield 002D","E01028260","Total",1662,194,116,78,1468,55,202,271,374,60,183,323
"2011","Mansfield 003A","E01028251","Total",1645,114,61,53,1531,31,210,390,302,81,157,360
"2011","Mansfield 003B","E01028252","Total",1944,217,92,125,1727,129,264,444,304,77,199,310
"2011","Mansfield 003C","E01028253","Total",1684,153,84,69,1531,44,290,399,300,57,132,309
"2011","Mansfield 003D","E01028277","Total",1199,125,73,52,1074,22,216,190,236,41,67,302
"2011","Mansfield 003E","E01028278","Total",1411,190,112,78,1221,76,212,255,240,35,107,296
"2011","Mansfield 004A","E01028271","Total",1669,309,104,205,1360,160,138,296,300,74,186,206
"2011","Mansfield 004B","E01028279","Total",1382,251,159,92,1131,66,200,197,212,40,128,288
"2011","Mansfield 004C","E01028280","Total",1340,152,95,57,1188,76,136,206,188,90,207,285
"2011","Mansfield 004D","E01028281","Total",1466,149,56,93,1317,182,70,352,196,96,186,235
"2011","Mansfield 004E","E01028283","Total",1826,187,79,108,1639,95,234,410,342,99,153,306
"2011","Mansfield 005A","E01028242","Total",1504,218,61,157,1286,56,162,321,334,60,72,281
"2011","Mansfield 005B","E01028250","Total",1471,120,41,79,1351,74,210,325,244,49,125,324
"2011","Mansfield 005C","E01028272","Total",1597,237,97,140,1360,119,190,331,286,59,115,260
"2011","Mansfield 005D","E01028273","Total",1483,143,45,98,1340,92,142,292,300,52,134,328
"2011","Mansfield 006A","E01028229","Total",1442,273,139,134,1169,42,228,185,280,30,121,283
"2011","Mansfield 006B","E01028232","Total",1513,170,96,74,1343,75,262,248,268,86,118,286
"2011","Mansfield 006E","E01028267","Total",1947,157,71,86,1790,169,138,381,234,171,298,399
"2011","Mansfield 006F","E01028282","Total",1140,166,104,62,974,104,124,181,204,72,108,181
"2011","Mansfield 006G","E01033392","Total",2164,315,158,157,1849,130,236,387,394,90,253,359
"2011","Mansfield 007A","E01028237","Total",1544,151,75,76,1393,34,256,294,270,61,111,367
"2011","Mansfield 007B","E01028238","Total",1582,123,72,51,1459,127,176,308,150,123,218,357
"2011","Mansfield 007C","E01028239","Total",1598,155,65,90,1443,110,172,359,268,69,152,313
"2011","Mansfield 007D","E01028240","Total",1479,135,57,78,1344,50,216,351,294,56,104,273
"2011","Mansfield 007E","E01028241","Total",2283,160,49,111,2123,100,178,717,414,92,256,366
"2011","Mansfield 007F","E01028243","Total",1792,258,177,81,1534,85,292,300,300,89,181,287
"2011","Mansfield 008A","E01028227","Total",1329,201,94,107,1128,137,138,302,218,25,107,201
"2011","Mansfield 008B","E01028228","Total",1154,150,74,76,1004,68,172,205,192,52,130,185
"2011","Mansfield 008C","E01028247","Total",1683,321,60,261,1362,204,68,293,266,67,169,295
"2011","Mansfield 008D","E01028268","Total",1639,292,45,247,1347,161,72,353,304,35,148,274
"2011","Mansfield 008E","E01028269","Total",1418,230,45,185,1188,106,72,341,280,94,75,220
"2011","Mansfield 008F","E01028284","Total",1579,258,113,145,1321,123,178,293,242,84,175,226
"2011","Mansfield 009A","E01028233","Total",1816,249,56,193,1567,187,120,375,340,74,178,293
"2011","Mansfield 009B","E01028234","Total",1726,306,148,158,1420,231,124,367,240,83,213,162
"2011","Mansfield 009C","E01028274","Total",1333,337,70,267,996,59,74,235,268,58,138,164
"2011","Mansfield 009D","E01028275","Total",1604,209,72,137,1395,212,70,415,214,124,134,226
"2011","Mansfield 009E","E01028276","Total",1558,352,123,229,1206,174,124,269,228,95,116,200
"2011","Mansfield 010A","E01028230","Total",1432,146,69,77,1286,149,142,272,208,121,147,247
"2011","Mansfield 010B","E01028231","Total",1430,231,130,101,1199,118,164,242,200,49,170,256
"2011","Mansfield 010C","E01028244","Total",1486,196,74,122,1290,51,174,353,310,58,110,234
"2011","Mansfield 010D","E01028245","Total",1312,199,102,97,1113,106,116,283,214,60,135,199
"2011","Mansfield 010E","E01028246","Total",1684,167,80,87,1517,56,212,327,374,46,162,340
"2011","Mansfield 010F","E01028248","Total",1476,180,91,89,1296,103,194,243,226,79,176,275
"2011","Mansfield 010G","E01028249","Total",1354,149,83,66,1205,54,168,275,212,65,163,268
"2011","Mansfield 011A","E01028235","Total",1572,162,71,91,1410,50,208,366,324,59,138,265
"2011","Mansfield 011B","E01028236","Total",1715,180,66,114,1535,92,182,416,278,83,155,329
"2011","Mansfield 011C","E01028262","Total",1496,127,63,64,1369,34,200,292,306,73,158,306
"2011","Mansfield 011D","E01028264","Total",1911,159,80,79,1752,49,296,413,318,82,205,389
"2011","Mansfield 012A","E01028254","Total",1322,137,55,82,1185,74,228,218,218,81,120,246
"2011","Mansfield 012B","E01028256","Total",1591,402,75,327,1189,128,104,267,226,123,141,200
"2011","Mansfield 012C","E01028261","Total",1708,203,53,150,1505,161,126,295,234,175,223,291
"2011","Mansfield 012D","E01028263","Total",1584,362,135,227,1222,183,142,225,230,128,143,171
"2011","Mansfield 013A","E01028219","Total",1354,167,100,67,1187,34,282,236,284,30,89,232
"2011","Mansfield 013B","E01028220","Total",1769,209,78,131,1560,80,178,354,414,36,156,342
"2011","Mansfield 013D","E01028222","Total",1562,170,119,51,1392,22,312,264,264,72,161,297
"2011","Mansfield 013E","E01028255","Total",1316,133,89,44,1183,24,356,202,236,26,88,251
"2011","Mansfield 013F","E01028270","Total",1509,185,106,79,1324,55,184,338,264,31,189,263
"2011","Mansfield 013G","E01033389","Total",1329,169,26,143,1160,71,60,432,360,56,76,105
"2011","Mansfield 013H","E01033390","Total",1548,102,7,95,1446,92,30,572,344,118,155,135
"2011","Mansfield 013I","E01033391","Total",1179,123,76,47,1056,34,206,283,200,20,90,223
"2011","Newark and Sherwood 001A","E01028301","Total",1904,185,46,139,1719,207,110,374,256,206,234,332
"2011","Newark and Sherwood 001B","E01028302","Total",1543,198,89,109,1345,71,226,272,308,36,177,255
"2011","Newark and Sherwood 001C","E01028338","Total",1599,185,108,77,1414,94,170,354,220,48,184,344
"2011","Newark and Sherwood 001D","E01028339","Total",1781,183,60,123,1598,151,150,373,288,100,236,300
"2011","Newark and Sherwood 001E","E01028340","Total",1501,277,154,123,1224,90,168,252,244,51,147,272
"2011","Newark and Sherwood 001F","E01028341","Total",1578,242,104,138,1336,18,334,230,310,22,153,269
"2011","Newark and Sherwood 002A","E01028313","Total",1927,258,132,126,1669,155,260,355,330,141,184,244
"2011","Newark and Sherwood 002B","E01028314","Total",2674,179,59,120,2495,156,142,754,438,227,358,420
"2011","Newark and Sherwood 002C","E01028321","Total",1533,201,109,92,1332,30,312,268,326,31,110,255
"2011","Newark and Sherwood 002D","E01028322","Total",1960,255,159,96,1705,93,374,323,318,53,167,377
"2011","Newark and Sherwood 002E","E01028323","Total",1612,171,63,108,1441,135,138,428,276,88,152,224
"2011","Newark and Sherwood 003A","E01028303","Total",1527,169,102,67,1358,45,302,250,276,77,142,266
"2011","Newark and Sherwood 003B","E01028312","Total",2242,193,115,78,2049,47,384,401,454,121,249,393
"2011","Newark and Sherwood 003C","E01028337","Total",1524,111,66,45,1413,39,294,316,284,72,182,226
"2011","Newark and Sherwood 003D","E01028349","Total",1494,142,68,74,1352,45,230,276,300,65,156,280
"2011","Newark and Sherwood 003E","E01028350","Total",1171,140,76,64,1031,48,176,199,176,111,109,212
"2011","Newark and Sherwood 004A","E01028315","Total",1419,195,122,73,1224,25,310,266,224,66,98,235
"2011","Newark and Sherwood 004B","E01028316","Total",1466,233,137,96,1233,53,318,198,288,105,83,188
"2011","Newark and Sherwood 004C","E01028317","Total",1612,120,59,61,1492,38,268,304,280,114,188,300
"2011","Newark and Sherwood 004D","E01028353","Total",2731,280,151,129,2451,121,436,659,472,109,272,382
"2011","Newark and Sherwood 005A","E01028295","Total",1970,158,68,90,1812,73,332,422,340,85,256,304
"2011","Newark and Sherwood 005B","E01028297","Total",1934,252,119,133,1682,187,188,348,290,143,245,281
"2011","Newark and Sherwood 005C","E01028327","Total",1599,181,104,77,1418,42,272,354,220,98,183,249
"2011","Newark and Sherwood 005D","E01028328","Total",1700,192,126,66,1508,37,324,388,278,71,131,279
"2011","Newark and Sherwood 005E","E01028329","Total",1609,111,58,53,1498,42,238,328,276,135,190,289
"2011","Newark and Sherwood 006A","E01028296","Total",1290,164,79,85,1126,49,140,289,220,103,95,230
"2011","Newark and Sherwood 006B","E01028298","Total",1559,181,71,110,1378,104,152,339,270,66,142,305
"2011","Newark and Sherwood 006C","E01028299","Total",1281,130,47,83,1151,105,100,310,218,61,126,231
"2011","Newark and Sherwood 006D","E01028300","Total",1555,220,100,120,1335,116,174,296,254,128,154,213
"2011","Newark and Sherwood 006E","E01028342","Total",1508,169,33,136,1339,135,76,374,264,93,128,269
"2011","Newark and Sherwood 006F","E01028343","Total",2046,270,160,110,1776,81,302,410,310,87,195,391
"2011","Newark and Sherwood 006G","E01028344","Total",1420,144,55,89,1276,57,160,320,322,46,136,235
"2011","Newark and Sherwood 007A","E01028294","Total",1731,320,105,215,1411,137,164,375,296,78,129,232
"2011","Newark and Sherwood 007B","E01028304","Total",1451,241,81,160,1210,145,102,273,238,137,134,181
"2011","Newark and Sherwood 007C","E01028305","Total",1336,150,57,93,1186,83,94,260,308,71,132,238
"2011","Newark and Sherwood 007D","E01028306","Total",1614,203,98,105,1411,126,160,320,282,109,134,280
"2011","Newark and Sherwood 007E","E01028307","Total",1264,97,21,76,1167,88,74,289,246,72,110,288
"2011","Newark and Sherwood 007F","E01028310","Total",1673,411,109,302,1262,145,98,282,392,52,73,220
"2011","Newark and Sherwood 007G","E01028311","Total",1493,459,124,335,1034,61,132,179,308,83,59,212
"2011","Newark and Sherwood 008A","E01028345","Total",2096,362,219,143,1734,89,406,324,320,146,167,282
"2011","Newark and Sherwood 008B","E01028346","Total",2133,235,140,95,1898,78,402,434,348,127,179,330
"2011","Newark and Sherwood 008C","E01028347","Total",1531,164,93,71,1367,48,282,329,182,108,176,242
"2011","Newark and Sherwood 008D","E01028348","Total",1172,149,91,58,1023,61,222,201,156,126,99,158
"2011","Newark and Sherwood 009A","E01028292","Total",2293,165,68,97,2128,59,288,625,434,240,152,330
"2011","Newark and Sherwood 009B","E01028293","Total",1906,258,76,182,1648,138,170,505,384,126,83,242
"2011","Newark and Sherwood 009C","E01028333","Total",1311,197,86,111,1114,95,164,267,250,31,89,218
"2011","Newark and Sherwood 009D","E01028334","Total",1570,146,72,74,1424,155,132,248,204,177,236,272
"2011","Newark and Sherwood 009E","E01028335","Total",1695,391,134,257,1304,93,156,275,332,86,134,228
"2011","Newark and Sherwood 010A","E01028308","Total",1605,233,127,106,1372,78,256,240,316,87,107,288
"2011","Newark and Sherwood 010B","E01028309","Total",1402,171,90,81,1231,37,248,223,278,38,119,288
"2011","Newark and Sherwood 010C","E01028318","Total",1537,181,92,89,1356,124,158,195,212,137,240,290
"2011","Newark and Sherwood 010D","E01028319","Total",1919,310,165,145,1609,203,180,305,274,180,187,280
"2011","Newark and Sherwood 010E","E01028320","Total",1660,294,130,164,1366,209,160,258,222,143,167,207
"2011","Newark and Sherwood 011A","E01028285","Total",1226,145,39,106,1081,77,114,312,228,38,114,198
"2011","Newark and Sherwood 011B","E01028286","Total",1250,226,157,69,1024,38,230,246,180,46,85,199
"2011","Newark and Sherwood 011C","E01028287","Total",1450,186,107,79,1264,59,262,326,218,77,76,246
"2011","Newark and Sherwood 011D","E01028288","Total",1501,147,78,69,1354,62,252,344,276,67,135,218
"2011","Newark and Sherwood 011E","E01028289","Total",1326,218,91,127,1108,57,210,281,266,26,48,220
"2011","Newark and Sherwood 011F","E01028290","Total",1455,154,108,46,1301,69,212,323,244,80,125,248
"2011","Newark and Sherwood 011G","E01028291","Total",1549,145,63,82,1404,130,172,303,256,100,160,283
"2011","Newark and Sherwood 012B","E01028325","Total",1196,113,63,50,1083,42,218,262,274,77,57,153
"2011","Newark and Sherwood 012C","E01028326","Total",1274,162,98,64,1112,58,250,212,258,50,112,172
"2011","Newark and Sherwood 012D","E01028336","Total",1104,115,53,62,989,37,192,213,208,45,154,140
"2011","Newark and Sherwood 012E","E01028352","Total",1214,73,35,38,1141,11,206,279,206,109,126,204
"2011","Newark and Sherwood 012F","E01033393","Total",2128,202,8,194,1926,138,84,715,478,169,139,203
"2011","Newark and Sherwood 012G","E01033394","Total",1242,152,84,68,1090,48,224,250,246,45,90,187
"2011","Newark and Sherwood 013A","E01028330","Total",1619,171,97,74,1448,48,306,334,236,56,172,296
"2011","Newark and Sherwood 013B","E01028331","Total",1394,161,81,80,1233,37,216,315,224,74,119,248
"2011","Newark and Sherwood 013C","E01028332","Total",1709,162,86,76,1547,42,260,363,268,142,147,325
"2011","Newark and Sherwood 013D","E01028351","Total",1228,84,50,34,1144,13,246,233,184,127,143,198
"2011","Rushcliffe 001A","E01028371","Total",1911,183,98,85,1728,61,400,385,332,139,147,264
"2011","Rushcliffe 001B","E01028403","Total",2173,267,154,113,1906,91,374,447,320,145,207,322
"2011","Rushcliffe 001C","E01028411","Total",2077,168,76,92,1909,54,272,520,438,95,187,343
"2011","Rushcliffe 002A","E01028357","Total",1488,152,104,48,1336,39,304,305,218,72,122,276
"2011","Rushcliffe 002B","E01028358","Total",1298,241,114,127,1057,85,228,240,170,82,66,186
"2011","Rushcliffe 002C","E01028359","Total",1696,132,45,87,1564,46,206,554,300,112,141,205
"2011","Rushcliffe 002D","E01028360","Total",1799,183,30,153,1616,152,132,491,424,96,122,199
"2011","Rushcliffe 002E","E01028361","Total",1404,169,78,91,1235,89,130,375,256,86,98,201
"2011","Rushcliffe 002F","E01028362","Total",1415,189,98,91,1226,107,158,263,168,83,194,253
"2011","Rushcliffe 003A","E01028393","Total",1137,129,79,50,1008,18,256,196,194,40,115,189
"2011","Rushcliffe 003B","E01028394","Total",1464,235,162,73,1229,50,256,319,258,56,91,199
"2011","Rushcliffe 003C","E01028395","Total",1440,109,41,68,1331,55,150,485,274,92,93,182
"2011","Rushcliffe 003D","E01028413","Total",1649,284,173,111,1365,102,200,408,206,93,127,229
"2011","Rushcliffe 003E","E01028414","Total",1503,203,101,102,1300,37,344,333,238,70,80,198
"2011","Rushcliffe 003F","E01028415","Total",1558,118,66,52,1440,39,270,354,268,96,176,237
"2011","Rushcliffe 004A","E01028354","Total",1555,136,59,77,1419,30,152,465,246,150,136,240
"2011","Rushcliffe 004B","E01028355","Total",1516,211,108,103,1305,47,124,455,280,70,71,258
"2011","Rushcliffe 004C","E01028384","Total",1714,180,37,143,1534,27,116,501,258,126,127,379
"2011","Rushcliffe 004D","E01028385","Total",1751,155,65,90,1596,57,142,492,270,192,147,296
"2011","Rushcliffe 004E","E01028386","Total",1616,164,33,131,1452,57,86,436,270,91,174,338
"2011","Rushcliffe 005A","E01028396","Total",1521,177,48,129,1344,49,88,442,334,110,76,245
"2011","Rushcliffe 005B","E01028398","Total",1440,273,125,148,1167,97,70,347,324,72,64,193
"2011","Rushcliffe 005C","E01028399","Total",1369,139,50,89,1230,38,50,378,164,156,137,307
"2011","Rushcliffe 005D","E01028416","Total",1558,314,114,200,1244,47,48,179,236,67,65,602
"2011","Rushcliffe 005E","E01028417","Total",1523,243,22,221,1280,33,28,235,292,89,122,481
"2011","Rushcliffe 005F","E01028418","Total",1445,320,107,213,1125,29,74,269,246,25,106,376
"2011","Rushcliffe 006A","E01028356","Total",1493,146,74,72,1347,61,152,376,220,79,138,321
"2011","Rushcliffe 006B","E01028375","Total",1798,245,37,208,1553,169,84,473,390,114,152,171
"2011","Rushcliffe 006C","E01028376","Total",1534,199,69,130,1335,32,186,369,312,89,162,185
"2011","Rushcliffe 006D","E01028377","Total",1955,164,60,104,1791,46,108,713,298,131,200,295
"2011","Rushcliffe 006E","E01028397","Total",1743,161,73,88,1582,51,174,452,320,152,156,277
"2011","Rushcliffe 007A","E01028363","Total",1489,77,20,57,1412,31,88,410,200,95,228,360
"2011","Rushcliffe 007B","E01028364","Total",1731,161,57,104,1570,41,128,587,278,78,178,280
"2011","Rushcliffe 007C","E01028365","Total",1658,214,76,138,1444,44,108,349,310,110,202,321
"2011","Rushcliffe 007D","E01028391","Total",1965,216,140,76,1749,40,322,440,300,73,222,352
"2011","Rushcliffe 007E","E01028392","Total",1947,380,229,151,1567,103,248,387,298,107,182,242
"2011","Rushcliffe 008A","E01028372","Total",1188,229,119,110,959,54,158,254,142,58,98,195
"2011","Rushcliffe 008B","E01028373","Total",1404,123,85,38,1281,18,280,259,178,123,175,248
"2011","Rushcliffe 008C","E01028374","Total",1289,213,156,57,1076,73,202,264,132,73,176,156
"2011","Rushcliffe 008D","E01028400","Total",1612,104,58,46,1508,14,162,454,236,103,230,309
"2011","Rushcliffe 008E","E01028401","Total",1308,90,28,62,1218,33,152,381,156,79,158,259
"2011","Rushcliffe 009A","E01028366","Total",1327,122,54,68,1205,144,104,280,156,106,142,273
"2011","Rushcliffe 009B","E01028367","Total",1355,119,63,56,1236,54,166,306,232,76,118,284
"2011","Rushcliffe 009C","E01028368","Total",1491,157,69,88,1334,80,138,306,320,80,93,317
"2011","Rushcliffe 009D","E01028369","Total",1467,151,46,105,1316,147,100,348,236,53,203,229
"2011","Rushcliffe 009E","E01028370","Total",1444,193,80,113,1251,81,200,269,262,54,142,243
"2011","Rushcliffe 010A","E01028402","Total",1888,154,80,74,1734,51,294,478,372,77,163,299
"2011","Rushcliffe 010B","E01028419","Total",2392,284,122,162,2108,73,314,599,470,70,168,414
"2011","Rushcliffe 010C","E01028420","Total",1378,137,67,70,1241,45,260,292,196,104,102,242
"2011","Rushcliffe 011A","E01028404","Total",1532,193,94,99,1339,60,232,316,278,68,153,232
"2011","Rushcliffe 011B","E01028405","Total",1935,320,153,167,1615,183,176,468,350,78,116,244
"2011","Rushcliffe 011C","E01028406","Total",1629,194,88,106,1435,77,214,415,300,82,145,202
"2011","Rushcliffe 011D","E01028407","Total",1999,213,74,139,1786,79,268,460,420,100,166,293
"2011","Rushcliffe 012A","E01028379","Total",1637,174,129,45,1463,10,460,250,222,60,205,256
"2011","Rushcliffe 012B","E01028412","Total",1883,171,115,56,1712,27,394,456,300,80,134,321
"2011","Rushcliffe 012C","E01028421","Total",2159,152,85,67,2007,39,392,496,362,150,203,365
"2011","Rushcliffe 013A","E01028380","Total",1238,170,66,104,1068,127,122,222,162,125,96,214
"2011","Rushcliffe 013B","E01028381","Total",1342,161,100,61,1181,26,282,249,196,40,106,282
"2011","Rushcliffe 013C","E01028382","Total",1435,170,101,69,1265,31,306,341,210,56,134,187
"2011","Rushcliffe 013D","E01028383","Total",1081,157,101,56,924,6,254,150,164,57,69,224
"2011","Rushcliffe 014A","E01028378","Total",1994,251,123,128,1743,80,352,321,370,88,162,370
"2011","Rushcliffe 014B","E01028387","Total",1746,139,93,46,1607,137,200,427,194,152,162,335
"2011","Rushcliffe 014C","E01028408","Total",2060,198,104,94,1862,83,300,485,370,112,144,368
"2011","Rushcliffe 015A","E01028388","Total",1652,117,49,68,1535,19,200,497,244,120,202,253
"2011","Rushcliffe 015B","E01028389","Total",1447,197,136,61,1250,39,328,258,224,26,108,267
"2011","Rushcliffe 015C","E01028390","Total",1610,168,107,61,1442,59,290,292,260,73,125,343
"2011","Rushcliffe 015D","E01028409","Total",1269,99,48,51,1170,35,192,291,208,67,123,254
"2011","Rushcliffe 015E","E01028410","Total",1280,107,62,45,1173,28,212,332,238,56,100,207
"2011","Herefordshire 001A","E01013998","Total",1329,154,108,46,1175,46,314,158,274,75,98,210
"2011","Herefordshire 001B","E01014051","Total",1704,197,108,89,1507,113,280,356,274,105,145,234
"2011","Herefordshire 001C","E01014052","Total",1496,165,84,81,1331,43,298,231,272,100,122,265
"2011","Herefordshire 001D","E01014096","Total",1493,153,85,68,1340,69,284,249,294,50,143,251
"2011","Herefordshire 002A","E01014041","Total",1472,261,159,102,1211,59,274,284,256,62,79,197
"2011","Herefordshire 002B","E01014042","Total",1653,209,83,126,1444,187,82,337,224,175,221,218
"2011","Herefordshire 002C","E01014043","Total",1109,161,114,47,948,36,266,174,148,56,76,192
"2011","Herefordshire 002D","E01014044","Total",1473,159,76,83,1314,81,146,307,212,114,146,308
"2011","Herefordshire 003A","E01014045","Total",1555,197,93,104,1358,68,202,309,290,57,138,294
"2011","Herefordshire 003B","E01014046","Total",1445,164,90,74,1281,36,260,267,208,51,170,289
"2011","Herefordshire 003C","E01014047","Total",1437,186,80,106,1251,106,200,244,182,93,211,215
"2011","Herefordshire 003D","E01014048","Total",1410,384,140,244,1026,94,154,204,278,42,107,147
"2011","Herefordshire 004A","E01013999","Total",1394,169,110,59,1225,22,274,232,254,103,127,213
"2011","Herefordshire 004B","E01014017","Total",1475,155,87,68,1320,54,290,233,242,81,188,232
"2011","Herefordshire 004C","E01014024","Total",1286,118,56,62,1168,34,246,194,250,62,152,230
"2011","Herefordshire 004D","E01014025","Total",1396,151,95,56,1245,47,304,187,196,82,135,294
"2011","Herefordshire 004E","E01014055","Total",1583,174,87,87,1409,71,288,263,226,73,193,295
"2011","Herefordshire 004F","E01014097","Total",1315,141,87,54,1174,29,254,206,248,61,155,221
"2011","Herefordshire 005A","E01014000","Total",1352,117,57,60,1235,39,288,226,218,61,132,271
"2011","Herefordshire 005B","E01014001","Total",1433,167,79,88,1266,20,252,220,252,72,161,289
"2011","Herefordshire 005C","E01014002","Total",1319,200,143,57,1119,24,308,191,186,49,134,227
"2011","Herefordshire 005D","E01014003","Total",1445,154,82,72,1291,51,184,317,222,76,181,260
"2011","Herefordshire 005E","E01014004","Total",1395,131,73,58,1264,32,258,257,280,72,146,219
"2011","Herefordshire 005F","E01014005","Total",1542,348,165,183,1194,160,164,264,272,37,78,219
"2011","Herefordshire 005G","E01014015","Total",1636,136,61,75,1500,46,240,317,268,79,193,357
"2011","Herefordshire 006A","E01014008","Total",1594,204,122,82,1390,27,296,296,272,56,156,287
"2011","Herefordshire 006B","E01014009","Total",1498,156,87,69,1342,35,336,218,258,87,204,204
"2011","Herefordshire 006C","E01014033","Total",1698,248,137,111,1450,64,338,273,266,112,122,275
"2011","Herefordshire 006D","E01014034","Total",1480,240,110,130,1240,112,178,280,252,109,97,212
"2011","Herefordshire 006E","E01014056","Total",1450,143,75,68,1307,19,272,295,230,87,150,254
"2011","Herefordshire 007A","E01014006","Total",1579,144,73,71,1435,35,290,314,234,58,204,300
"2011","Herefordshire 007B","E01014012","Total",1599,188,114,74,1411,18,314,248,268,68,160,335
"2011","Herefordshire 007C","E01014013","Total",1841,133,65,68,1708,101,142,623,210,212,193,227
"2011","Herefordshire 007D","E01014016","Total",1510,207,135,72,1303,74,320,230,174,107,176,222
"2011","Herefordshire 007E","E01014100","Total",1538,171,81,90,1367,17,238,270,298,91,194,259
"2011","Herefordshire 007F","E01014101","Total",1075,114,41,73,961,10,220,163,160,108,93,207
"2011","Herefordshire 008A","E01014022","Total",2030,141,64,77,1889,74,262,411,342,139,246,415
"2011","Herefordshire 008B","E01014023","Total",1740,130,50,80,1610,94,190,406,298,110,201,311
"2011","Herefordshire 008C","E01014081","Total",1440,140,81,59,1300,23,252,291,222,76,137,299
"2011","Herefordshire 008D","E01014082","Total",1707,161,93,68,1546,71,296,283,228,113,222,333
"2011","Herefordshire 009A","E01014027","Total",1215,129,64,65,1086,26,250,193,232,61,99,225
"2011","Herefordshire 009B","E01014028","Total",1391,159,94,65,1232,31,318,211,244,45,101,282
"2011","Herefordshire 009C","E01014029","Total",1418,215,128,87,1203,30,312,263,192,64,136,206
"2011","Herefordshire 009D","E01014030","Total",1388,139,78,61,1249,27,264,277,232,57,127,265
"2011","Herefordshire 010A","E01014083","Total",1597,212,131,81,1385,45,292,312,244,91,146,255
"2011","Herefordshire 010B","E01014084","Total",1537,295,167,128,1242,70,140,289,276,65,158,244
"2011","Herefordshire 010C","E01014085","Total",1415,154,78,76,1261,94,128,242,232,94,183,288
"2011","Herefordshire 010D","E01014087","Total",1467,263,73,190,1204,41,162,302,336,46,73,244
"2011","Herefordshire 010E","E01014088","Total",1414,264,80,184,1150,75,124,301,340,47,59,204
"2011","Herefordshire 010F","E01014089","Total",1473,120,57,63,1353,120,182,290,210,47,181,323
"2011","Herefordshire 011A","E01013987","Total",1555,180,95,85,1375,41,266,315,242,53,146,312
"2011","Herefordshire 011B","E01013988","Total",1797,393,232,161,1404,28,358,220,256,61,135,346
"2011","Herefordshire 011C","E01014007","Total",1658,131,78,53,1527,41,278,312,280,75,214,327
"2011","Herefordshire 011D","E01014095","Total",1494,131,69,62,1363,108,186,315,160,82,195,317
"2011","Herefordshire 012A","E01013986","Total",1702,228,100,128,1474,96,158,333,260,147,165,315
"2011","Herefordshire 012B","E01013989","Total",1437,165,74,91,1272,76,102,290,238,123,163,280
"2011","Herefordshire 012C","E01014010","Total",1566,442,111,331,1124,98,92,190,306,36,127,275
"2011","Herefordshire 012D","E01014011","Total",1469,239,95,144,1230,98,96,319,190,58,142,327
"2011","Herefordshire 012E","E01014086","Total",1439,312,93,219,1127,118,96,281,258,62,97,215
"2011","Herefordshire 012F","E01014092","Total",1800,375,134,241,1425,92,190,313,376,55,142,257
"2011","Herefordshire 013A","E01014075","Total",1650,201,95,106,1449,77,176,315,264,100,185,332
"2011","Herefordshire 013B","E01014076","Total",2178,406,120,286,1772,142,154,489,402,97,139,349
"2011","Herefordshire 013C","E01014077","Total",1555,221,114,107,1334,42,248,334,294,67,134,215
"2011","Herefordshire 013D","E01014078","Total",1461,172,98,74,1289,58,192,250,188,151,180,270
"2011","Herefordshire 014A","E01014090","Total",1499,144,108,36,1355,28,250,356,132,71,190,328
"2011","Herefordshire 014B","E01014091","Total",1473,160,118,42,1313,42,306,233,234,87,177,234
"2011","Herefordshire 014C","E01014093","Total",1365,183,102,81,1182,73,200,258,182,42,160,267
"2011","Herefordshire 014D","E01014094","Total",1525,120,73,47,1405,52,242,294,192,101,185,339
"2011","Herefordshire 015A","E01014068","Total",1472,149,81,68,1323,52,222,248,242,75,158,326
"2011","Herefordshire 015B","E01014070","Total",2245,234,120,114,2011,72,176,563,376,123,279,422
"2011","Herefordshire 015C","E01014072","Total",2061,208,82,126,1853,154,176,419,330,161,280,333
"2011","Herefordshire 015D","E01014073","Total",1899,257,97,160,1642,179,110,580,246,154,141,232
"2011","Herefordshire 015E","E01014074","Total",1582,288,135,153,1294,181,120,236,200,73,171,313
"2011","Herefordshire 016A","E01013996","Total",1544,198,71,127,1346,66,144,383,322,86,141,204
"2011","Herefordshire 016B","E01013997","Total",1983,211,66,145,1772,85,138,538,388,86,173,364
"2011","Herefordshire 016C","E01014079","Total",1614,131,66,65,1483,38,260,331,238,107,164,345
"2011","Herefordshire 016D","E01014080","Total",1352,176,115,61,1176,49,282,207,196,29,175,238
"2011","Herefordshire 017A","E01013992","Total",1434,166,45,121,1268,108,70,319,248,89,167,267
"2011","Herefordshire 017B","E01013993","Total",1598,121,57,64,1477,140,188,284,216,133,247,269
"2011","Herefordshire 017C","E01013994","Total",1568,165,70,95,1403,159,128,341,204,102,192,277
"2011","Herefordshire 017D","E01013995","Total",1709,212,70,142,1497,320,108,372,226,130,139,202
"2011","Herefordshire 017E","E01014071","Total",1448,194,79,115,1254,148,126,240,180,114,155,291
"2011","Herefordshire 018A","E01013990","Total",1654,220,131,89,1434,72,318,237,286,96,136,289
"2011","Herefordshire 018B","E01013991","Total",1315,129,64,65,1186,49,178,280,216,73,185,205
"2011","Herefordshire 018C","E01014014","Total",1803,165,87,78,1638,43,230,376,320,106,198,365
"2011","Herefordshire 018D","E01014054","Total",1351,143,70,73,1208,32,250,247,262,42,127,248
"2011","Herefordshire 019A","E01014035","Total",1695,318,157,161,1377,101,178,369,214,83,157,275
"2011","Herefordshire 019B","E01014036","Total",1489,228,155,73,1261,35,312,215,234,73,102,290
"2011","Herefordshire 019C","E01014037","Total",1467,257,191,66,1210,31,376,231,228,27,119,198
"2011","Herefordshire 019D","E01014038","Total",1465,172,80,92,1293,52,230,306,236,94,153,222
"2011","Herefordshire 019E","E01014039","Total",1791,160,61,99,1631,98,224,517,312,165,131,184
"2011","Herefordshire 019F","E01014040","Total",1591,269,167,102,1322,51,278,273,294,67,114,245
"2011","Herefordshire 020A","E01014018","Total",1497,161,87,74,1336,42,276,199,218,127,198,276
"2011","Herefordshire 020B","E01014019","Total",1560,195,100,95,1365,54,242,227,250,139,163,290
"2011","Herefordshire 020C","E01014020","Total",1560,156,87,69,1404,54,242,279,238,117,177,297
"2011","Herefordshire 020D","E01014021","Total",1430,185,105,80,1245,44,288,297,190,51,125,250
"2011","Herefordshire 021A","E01014026","Total",2106,231,105,126,1875,54,378,392,330,111,201,409
"2011","Herefordshire 021B","E01014059","Total",1950,185,104,81,1765,28,316,347,280,149,258,387
"2011","Herefordshire 021C","E01014060","Total",1583,141,79,62,1442,43,266,244,276,111,197,305
"2011","Herefordshire 021D","E01014069","Total",1844,237,48,189,1607,141,102,580,358,106,150,170
"2011","Herefordshire 021E","E01014098","Total",1569,108,66,42,1461,84,186,374,194,102,215,306
"2011","Herefordshire 021F","E01014099","Total",1772,170,96,74,1602,50,322,303,284,81,240,322
"2011","Herefordshire 022A","E01014061","Total",1505,190,127,63,1315,23,378,283,222,51,131,227
"2011","Herefordshire 022B","E01014062","Total",1595,353,185,168,1242,87,214,254,314,33,106,234
"2011","Herefordshire 022C","E01014063","Total",1702,207,120,87,1495,101,252,345,256,101,158,282
"2011","Herefordshire 022D","E01014064","Total",1600,339,119,220,1261,130,110,295,278,95,119,234
"2011","Herefordshire 022E","E01014065","Total",1460,168,62,106,1292,89,204,265,260,50,165,259
"2011","Herefordshire 022F","E01014066","Total",1089,224,115,109,865,44,160,179,180,32,72,198
"2011","Herefordshire 022G","E01014067","Total",1448,140,94,46,1308,34,254,308,210,73,160,269
"2011","Herefordshire 023A","E01014031","Total",1472,174,73,101,1298,33,242,266,252,119,151,235
"2011","Herefordshire 023B","E01014032","Total",1585,185,107,78,1400,37,284,293,268,76,158,284
"2011","Herefordshire 023C","E01014049","Total",1540,154,85,69,1386,45,308,291,288,86,125,243
"2011","Herefordshire 023D","E01014050","Total",1739,139,70,69,1600,49,296,335,282,81,232,325
"2011","Herefordshire 023E","E01014053","Total",1734,180,78,102,1554,31,306,335,294,82,199,307
"2011","Herefordshire 023F","E01014057","Total",1675,172,101,71,1503,68,328,302,298,83,178,246
"2011","Herefordshire 023G","E01014058","Total",1586,151,90,61,1435,14,388,293,312,56,142,230
"2011","Shropshire 025A","E01028853","Total",1503,202,104,98,1301,141,176,204,204,101,194,281
"2011","Shropshire 025B","E01028854","Total",1490,193,78,115,1297,40,212,272,298,45,130,300
"2011","Shropshire 025C","E01028855","Total",1511,162,94,68,1349,67,214,330,284,45,102,307
"2011","Shropshire 025D","E01028856","Total",1240,219,94,125,1021,52,158,231,268,52,88,172
"2011","Shropshire 025E","E01028857","Total",1712,199,99,100,1513,65,268,316,310,86,141,327
"2011","Shropshire 027A","E01028826","Total",1650,245,143,102,1405,76,260,233,308,71,138,319
"2011","Shropshire 027B","E01028827","Total",1537,133,84,49,1404,73,200,392,176,126,142,295
"2011","Shropshire 027C","E01028844","Total",1307,62,27,35,1245,40,108,571,214,113,84,115
"2011","Shropshire 027D","E01028845","Total",1926,260,180,80,1666,26,450,303,290,64,197,336
"2011","Shropshire 029A","E01028838","Total",1427,207,100,107,1220,88,192,265,256,67,132,220
"2011","Shropshire 029B","E01028839","Total",1318,117,70,47,1201,36,206,337,248,35,101,238
"2011","Shropshire 029C","E01028840","Total",1304,115,61,54,1189,45,166,271,240,88,76,303
"2011","Shropshire 029D","E01028841","Total",1534,206,97,109,1328,67,168,257,318,84,131,303
"2011","Shropshire 029E","E01028850","Total",2218,221,71,150,1997,42,256,528,480,78,183,430
"2011","Shropshire 029F","E01028851","Total",1647,198,119,79,1449,62,296,268,338,90,125,270
"2011","Shropshire 029G","E01028852","Total",1596,206,119,87,1390,63,270,294,254,93,135,281
"2011","Shropshire 031A","E01028830","Total",1457,257,119,138,1200,23,254,252,298,57,128,188
"2011","Shropshire 031B","E01028831","Total",1486,143,82,61,1343,57,286,342,258,57,95,248
"2011","Shropshire 031C","E01028836","Total",1485,269,132,137,1216,88,174,284,202,68,154,246
"2011","Shropshire 031D","E01028837","Total",1468,206,107,99,1262,30,220,262,246,77,128,299
"2011","Shropshire 033A","E01028832","Total",1626,388,133,255,1238,63,186,307,408,31,80,163
"2011","Shropshire 033B","E01028833","Total",1406,236,124,112,1170,39,252,248,234,47,104,246
"2011","Shropshire 033C","E01028834","Total",1517,161,92,69,1356,50,250,257,278,113,153,255
"2011","Shropshire 033D","E01028835","Total",1461,172,85,87,1289,47,222,287,244,61,112,316
"2011","Shropshire 034A","E01028828","Total",1642,155,80,75,1487,39,232,363,284,101,192,276
"2011","Shropshire 034B","E01028829","Total",1311,144,86,58,1167,35,296,209,212,44,141,230
"2011","Shropshire 034C","E01028842","Total",1620,155,81,74,1465,28,272,267,258,87,216,337
"2011","Shropshire 034D","E01028847","Total",1459,146,73,73,1313,19,236,268,276,53,162,299
"2011","Shropshire 034E","E01028859","Total",1575,137,61,76,1438,36,302,292,288,97,152,271
"2011","Shropshire 035A","E01028843","Total",1661,157,93,64,1504,41,266,350,266,95,192,294
"2011","Shropshire 035B","E01028846","Total",1751,166,81,85,1585,53,290,325,310,105,194,308
"2011","Shropshire 035C","E01028848","Total",1644,138,76,62,1506,53,362,283,270,88,170,280
"2011","Shropshire 035D","E01028849","Total",1961,295,139,156,1666,138,266,447,304,89,160,262
"2011","Shropshire 035E","E01028858","Total",2005,177,91,86,1828,42,416,314,336,58,270,392
"2011","Shropshire 001A","E01028891","Total",1701,389,141,248,1312,92,150,281,294,128,164,203
"2011","Shropshire 001B","E01028892","Total",1359,146,86,60,1213,38,258,219,258,71,106,263
"2011","Shropshire 001C","E01028894","Total",1528,191,99,92,1337,47,172,364,232,84,144,294
"2011","Shropshire 001D","E01028895","Total",1636,195,82,113,1441,89,186,282,264,89,245,286
"2011","Shropshire 001E","E01028896","Total",2034,257,88,169,1777,102,240,544,368,130,145,248
"2011","Shropshire 001F","E01028897","Total",1460,177,112,65,1283,72,210,280,216,77,190,238
"2011","Shropshire 002A","E01028880","Total",1601,150,79,71,1451,53,220,312,236,184,156,290
"2011","Shropshire 002B","E01028881","Total",1262,118,91,27,1144,14,224,172,216,80,155,283
"2011","Shropshire 002C","E01028882","Total",1523,113,56,57,1410,35,206,332,290,94,144,309
"2011","Shropshire 002D","E01028893","Total",1491,135,71,64,1356,16,222,276,258,86,175,323
"2011","Shropshire 002E","E01028899","Total",1521,146,71,75,1375,28,266,313,306,65,137,260
"2011","Shropshire 004A","E01028864","Total",1450,169,81,88,1281,17,184,245,276,99,174,286
"2011","Shropshire 004B","E01028865","Total",1716,177,98,79,1539,63,280,442,254,105,137,258
"2011","Shropshire 004C","E01028866","Total",1303,202,87,115,1101,57,176,262,206,74,133,193
"2011","Shropshire 004D","E01028867","Total",1297,226,148,78,1071,74,210,225,186,68,122,186
"2011","Shropshire 004E","E01028872","Total",1408,105,47,58,1303,46,216,249,242,81,167,302
"2011","Shropshire 005A","E01028873","Total",1766,331,134,197,1435,150,176,339,300,120,174,176
"2011","Shropshire 005B","E01028874","Total",1326,173,106,67,1153,33,338,192,222,73,72,223
"2011","Shropshire 005C","E01028875","Total",2453,206,81,125,2247,102,304,698,428,186,209,320
"2011","Shropshire 005D","E01028876","Total",1727,352,183,169,1375,96,194,369,270,91,128,227
"2011","Shropshire 005E","E01028877","Total",1298,126,69,57,1172,42,204,301,198,58,151,218
"2011","Shropshire 005F","E01028878","Total",1565,199,81,118,1366,75,242,278,274,113,149,235
"2011","Shropshire 005G","E01028879","Total",1557,188,69,119,1369,82,158,297,242,132,143,315
"2011","Shropshire 008A","E01028886","Total",1682,244,103,141,1438,128,172,397,302,126,122,191
"2011","Shropshire 008B","E01028887","Total",1348,167,115,52,1181,48,266,258,208,90,106,205
"2011","Shropshire 008C","E01028889","Total",1306,218,141,77,1088,25,270,169,212,92,75,245
"2011","Shropshire 008D","E01028890","Total",1395,242,123,119,1153,62,182,291,214,97,104,203
"2011","Shropshire 009A","E01028868","Total",1490,119,62,57,1371,39,246,294,236,129,149,278
"2011","Shropshire 009B","E01028869","Total",1443,115,50,65,1328,29,144,306,236,102,197,314
"2011","Shropshire 009C","E01028871","Total",1204,118,53,65,1086,42,156,229,192,65,169,233
"2011","Shropshire 009D","E01028885","Total",2151,132,52,80,2019,119,190,599,324,202,242,343
"2011","Shropshire 010A","E01028860","Total",1809,170,100,70,1639,68,254,453,222,110,209,323
"2011","Shropshire 010B","E01028862","Total",1587,134,71,63,1453,33,256,317,292,83,180,292
"2011","Shropshire 010C","E01028863","Total",1272,93,50,43,1179,34,182,314,218,76,124,231
"2011","Shropshire 010D","E01028888","Total",1615,112,51,61,1503,41,184,295,244,143,292,304
"2011","Shropshire 010E","E01028898","Total",1424,96,58,38,1328,23,184,225,292,113,207,284
"2011","Shropshire 013A","E01028861","Total",1238,127,74,53,1111,42,202,226,224,55,98,264
"2011","Shropshire 013B","E01028870","Total",1506,89,39,50,1417,24,214,396,258,106,162,257
"2011","Shropshire 013C","E01028883","Total",1348,91,48,43,1257,42,146,390,260,70,147,202
"2011","Shropshire 013D","E01028884","Total",1522,176,106,70,1346,83,218,282,232,109,168,254
"2011","Shropshire 003A","E01028910","Total",1191,125,87,38,1066,26,192,232,214,75,97,230
"2011","Shropshire 003B","E01028911","Total",1293,128,80,48,1165,21,204,210,206,57,163,304
"2011","Shropshire 003C","E01028912","Total",1145,166,75,91,979,115,108,218,178,64,122,174
"2011","Shropshire 003D","E01028920","Total",1276,139,83,56,1137,50,166,231,214,99,99,278
"2011","Shropshire 003E","E01028921","Total",1566,136,70,66,1430,39,186,384,292,124,135,270
"2011","Shropshire 003F","E01028925","Total",1255,135,62,73,1120,22,188,196,236,65,149,264
"2011","Shropshire 003G","E01028926","Total",1380,171,82,89,1209,85,172,315,228,63,120,226
"2011","Shropshire 006C","E01028902","Total",1084,171,103,68,913,30,192,139,170,57,117,208
"2011","Shropshire 006D","E01028903","Total",1267,252,147,105,1015,81,242,205,178,36,77,196
"2011","Shropshire 006E","E01028904","Total",1482,134,74,60,1348,64,144,338,230,84,222,266
"2011","Shropshire 006F","E01028905","Total",1749,219,80,139,1530,147,108,410,282,110,203,270
"2011","Shropshire 006G","E01028909","Total",1427,180,88,92,1247,97,154,257,200,93,121,325
"2011","Shropshire 006H","E01033528","Total",2517,277,85,192,2240,114,182,718,484,113,209,420
"2011","Shropshire 007A","E01028906","Total",1190,361,105,256,829,54,70,197,252,59,56,141
"2011","Shropshire 007B","E01028907","Total",1681,296,166,130,1385,71,264,302,308,67,114,259
"2011","Shropshire 007C","E01028908","Total",1499,350,70,280,1149,157,108,251,234,70,128,201
"2011","Shropshire 007D","E01028916","Total",1515,202,143,59,1313,36,376,275,200,55,81,290
"2011","Shropshire 007E","E01028917","Total",1413,234,81,153,1179,41,186,334,206,89,147,176
"2011","Shropshire 007F","E01028924","Total",1601,143,61,82,1458,65,138,425,280,120,191,239
"2011","Shropshire 011A","E01028913","Total",1546,151,83,68,1395,15,260,341,262,54,184,279
"2011","Shropshire 011B","E01028918","Total",1439,122,45,77,1317,45,194,343,248,84,139,264
"2011","Shropshire 011C","E01028919","Total",1245,111,55,56,1134,57,154,322,188,98,128,187
"2011","Shropshire 011D","E01028927","Total",1043,89,47,42,954,25,186,221,182,47,122,171
"2011","Shropshire 011E","E01028928","Total",1536,169,90,79,1367,53,224,290,250,83,180,287
"2011","Shropshire 012A","E01028914","Total",1077,100,54,46,977,21,230,179,174,26,96,251
"2011","Shropshire 012B","E01028915","Total",1359,146,76,70,1213,33,266,296,218,60,122,218
"2011","Shropshire 012C","E01028922","Total",1249,93,45,48,1156,25,194,226,216,74,151,270
"2011","Shropshire 012D","E01028923","Total",1579,141,67,74,1438,40,292,247,254,93,156,356
"2011","Shropshire 014A","E01028929","Total",1464,125,56,69,1339,47,210,362,260,62,156,242
"2011","Shropshire 014B","E01028969","Total",1418,100,53,47,1318,48,198,285,206,136,164,281
"2011","Shropshire 014C","E01028970","Total",1223,126,57,69,1097,24,194,226,152,81,178,242
"2011","Shropshire 014D","E01028971","Total",2097,252,146,106,1845,49,366,454,348,84,244,300
"2011","Shropshire 014E","E01028978","Total",1532,139,55,84,1393,84,214,318,240,87,172,278
"2011","Shropshire 014F","E01028979","Total",1233,136,59,77,1097,39,172,290,172,70,114,240
"2011","Shropshire 015A","E01028933","Total",1611,163,72,91,1448,95,170,375,234,75,182,317
"2011","Shropshire 015B","E01028934","Total",1615,160,80,80,1455,219,130,330,170,209,163,234
"2011","Shropshire 015C","E01028956","Total",1538,148,90,58,1390,41,284,328,212,95,137,293
"2011","Shropshire 015D","E01028957","Total",1637,203,67,136,1434,206,120,263,156,214,248,227
"2011","Shropshire 015E","E01028958","Total",1832,197,107,90,1635,134,188,368,284,101,157,403
"2011","Shropshire 016A","E01028932","Total",1891,186,68,118,1705,49,180,472,402,66,172,364
"2011","Shropshire 016B","E01028981","Total",1621,161,77,84,1460,82,182,342,310,81,162,301
"2011","Shropshire 016C","E01028982","Total",1612,138,72,66,1474,113,190,345,268,138,150,270
"2011","Shropshire 016D","E01028983","Total",2011,236,109,127,1775,152,182,336,254,161,289,401
"2011","Shropshire 017A","E01028930","Total",1608,191,65,126,1417,84,118,443,284,91,152,245
"2011","Shropshire 017B","E01028931","Total",1895,375,91,284,1520,133,128,380,432,72,106,269
"2011","Shropshire 017C","E01028944","Total",1663,357,128,229,1306,110,208,253,300,30,143,262
"2011","Shropshire 017D","E01028945","Total",2045,412,121,291,1633,179,110,422,492,57,88,285
"2011","Shropshire 018A","E01028965","Total",1382,256,117,139,1126,107,146,220,208,108,148,189
"2011","Shropshire 018B","E01028966","Total",1264,94,55,39,1170,4,190,303,178,81,125,289
"2011","Shropshire 018C","E01028967","Total",1573,217,98,119,1356,169,156,278,154,108,228,263
"2011","Shropshire 018D","E01028968","Total",1363,151,76,75,1212,109,130,265,154,123,193,238
"2011","Shropshire 018E","E01028988","Total",1664,203,75,128,1461,113,140,393,292,95,113,315
"2011","Shropshire 018F","E01028989","Total",1711,141,64,77,1570,147,148,373,242,152,195,313
"2011","Shropshire 019A","E01028946","Total",1938,585,130,455,1353,67,232,193,490,33,137,201
"2011","Shropshire 019B","E01028972","Total",1707,209,133,76,1498,33,294,411,248,104,121,287
"2011","Shropshire 019C","E01028973","Total",1888,447,165,282,1441,75,164,349,382,86,120,265
"2011","Shropshire 019D","E01028987","Total",1969,530,225,305,1439,52,148,320,432,72,152,263
"2011","Shropshire 020A","E01028941","Total",1786,313,135,178,1473,110,166,368,314,66,139,310
"2011","Shropshire 020B","E01028942","Total",1442,79,32,47,1363,38,134,478,178,93,199,243
"2011","Shropshire 020C","E01028943","Total",2073,453,134,319,1620,108,224,436,446,65,79,262
"2011","Shropshire 020D","E01028951","Total",1528,202,98,104,1326,78,266,291,234,109,125,223
"2011","Shropshire 020E","E01028953","Total",1501,195,139,56,1306,30,250,318,198,148,138,224
"2011","Shropshire 021A","E01028947","Total",1396,177,137,40,1219,12,354,289,196,69,74,225
"2011","Shropshire 021B","E01028948","Total",1461,204,105,99,1257,56,242,206,174,95,159,325
"2011","Shropshire 021C","E01028949","Total",1477,177,95,82,1300,45,248,321,262,51,106,267
"2011","Shropshire 021D","E01028985","Total",1314,221,106,115,1093,32,236,231,222,46,71,255
"2011","Shropshire 022A","E01028938","Total",1625,432,171,261,1193,85,168,251,322,79,101,187
"2011","Shropshire 022B","E01028939","Total",1540,320,91,229,1220,125,114,270,332,55,109,215
"2011","Shropshire 022C","E01028984","Total",1371,267,116,151,1104,85,174,255,304,32,79,175
"2011","Shropshire 022D","E01028986","Total",1515,153,100,53,1362,56,286,283,182,62,162,331
"2011","Shropshire 023A","E01028940","Total",1585,179,110,69,1406,66,212,376,270,62,186,234
"2011","Shropshire 023B","E01028952","Total",1681,291,122,169,1390,72,184,401,330,76,74,253
"2011","Shropshire 023C","E01028962","Total",1665,213,92,121,1452,212,124,247,188,131,177,373
"2011","Shropshire 023D","E01028963","Total",1631,163,83,80,1468,49,216,400,262,107,160,274
"2011","Shropshire 023E","E01028964","Total",1633,156,85,71,1477,51,260,352,260,101,153,300
"2011","Shropshire 023F","E01028974","Total",1203,142,67,75,1061,36,156,262,206,102,92,207
"2011","Shropshire 024A","E01028935","Total",1489,142,95,47,1347,36,308,280,216,52,127,328
"2011","Shropshire 024B","E01028936","Total",2027,198,121,77,1829,63,388,330,318,103,218,409
"2011","Shropshire 024C","E01028937","Total",1504,171,91,80,1333,72,208,295,214,35,200,309
"2011","Shropshire 024D","E01028959","Total",2509,321,138,183,2188,59,328,551,496,118,265,371
"2011","Shropshire 026A","E01028954","Total",1266,114,65,49,1152,33,238,192,200,72,158,259
"2011","Shropshire 026B","E01028955","Total",1085,161,83,78,924,47,182,220,174,62,62,177
"2011","Shropshire 026C","E01028975","Total",1750,194,109,85,1556,68,230,373,266,137,203,279
"2011","Shropshire 026D","E01028976","Total",1682,141,80,61,1541,28,312,293,282,106,205,315
"2011","Shropshire 026E","E01028977","Total",1908,235,142,93,1673,69,292,348,314,106,211,333
"2011","Shropshire 028A","E01028950","Total",2285,264,138,126,2021,93,398,435,348,156,209,382
"2011","Shropshire 028B","E01028960","Total",1314,130,64,66,1184,22,218,262,212,53,164,253
"2011","Shropshire 028C","E01028961","Total",1341,111,52,59,1230,33,174,329,210,65,187,232
"2011","Shropshire 028D","E01028980","Total",2172,244,121,123,1928,67,382,367,384,151,180,397
"2011","Shropshire 030A","E01028991","Total",1224,138,69,69,1086,45,210,197,196,74,181,183
"2011","Shropshire 030B","E01028992","Total",1476,246,126,120,1230,71,220,236,246,53,174,230
"2011","Shropshire 030D","E01033529","Total",1034,96,48,48,938,18,162,186,198,52,102,220
"2011","Shropshire 030E","E01033530","Total",2004,225,100,125,1779,65,272,348,330,157,228,379
"2011","Shropshire 032A","E01028990","Total",1206,86,54,32,1120,29,202,236,180,88,150,235
"2011","Shropshire 032B","E01028997","Total",2223,347,233,114,1876,60,634,300,340,80,169,293
"2011","Shropshire 032C","E01028998","Total",2314,364,217,147,1950,70,506,366,408,99,176,325
"2011","Shropshire 036A","E01028993","Total",1532,121,56,65,1411,29,274,307,266,103,173,259
"2011","Shropshire 036B","E01029004","Total",1002,107,52,55,895,31,190,183,212,12,66,201
"2011","Shropshire 036C","E01029013","Total",1675,234,111,123,1441,44,358,278,298,60,131,272
"2011","Shropshire 036D","E01029014","Total",1211,158,80,78,1053,136,120,230,136,117,110,204
"2011","Shropshire 036E","E01029015","Total",1399,147,59,88,1252,26,248,206,268,114,133,257
"2011","Shropshire 037A","E01028994","Total",1212,179,106,73,1033,13,266,192,176,112,104,170
"2011","Shropshire 037B","E01029003","Total",2309,287,136,151,2022,48,490,334,432,159,191,368
"2011","Shropshire 037C","E01029005","Total",1247,170,83,87,1077,25,240,242,208,89,117,156
"2011","Shropshire 037D","E01029016","Total",1373,147,75,72,1226,29,298,227,236,78,135,223
"2011","Shropshire 038A","E01029006","Total",1561,268,175,93,1293,50,368,230,220,112,108,205
"2011","Shropshire 038B","E01029007","Total",1139,168,59,109,971,105,138,203,154,115,112,144
"2011","Shropshire 038D","E01029009","Total",1144,180,104,76,964,36,244,198,226,42,58,160
"2011","Shropshire 038E","E01029010","Total",1390,162,61,101,1228,93,128,239,276,144,129,219
"2011","Shropshire 038F","E01029011","Total",1457,224,118,106,1233,80,234,243,274,74,104,224
"2011","Shropshire 038G","E01029012","Total",1918,194,70,124,1724,124,290,419,314,214,173,190
"2011","Shropshire 038H","E01033526","Total",993,363,165,198,630,37,136,83,192,34,29,119
"2011","Shropshire 038I","E01033527","Total",1196,327,185,142,869,24,310,118,212,26,49,130
"2011","Shropshire 039A","E01028995","Total",1557,157,93,64,1400,42,250,343,222,82,198,263
"2011","Shropshire 039B","E01028996","Total",1286,152,78,74,1134,32,280,241,212,40,120,209
"2011","Shropshire 039C","E01028999","Total",1560,157,92,65,1403,34,272,219,276,102,205,295
"2011","Shropshire 039D","E01029000","Total",1108,111,58,53,997,20,236,119,212,61,130,219
"2011","Shropshire 039E","E01029001","Total",1968,166,70,96,1802,73,354,432,290,131,234,288
"2011","Shropshire 039F","E01029002","Total",1320,156,81,75,1164,75,190,245,180,85,173,216
"2011","Stoke-on-Trent 001A","E01014257","Total",1472,185,77,108,1287,106,146,249,288,140,97,261
"2011","Stoke-on-Trent 001B","E01014258","Total",1517,80,22,58,1437,50,60,405,254,88,257,323
"2011","Stoke-on-Trent 001C","E01014259","Total",1415,179,85,94,1236,74,214,223,296,51,107,271
"2011","Stoke-on-Trent 001D","E01014260","Total",1338,215,109,106,1123,102,172,201,218,107,127,196
"2011","Stoke-on-Trent 001E","E01014264","Total",1891,193,100,93,1698,124,186,438,292,86,235,337
"2011","Stoke-on-Trent 002A","E01014357","Total",1449,270,131,139,1179,136,204,226,222,83,117,191
"2011","Stoke-on-Trent 002B","E01014358","Total",1405,193,75,118,1212,232,106,232,176,104,146,216
"2011","Stoke-on-Trent 002C","E01014359","Total",1829,216,79,137,1613,179,186,368,262,113,247,258
"2011","Stoke-on-Trent 002D","E01014360","Total",2011,156,67,89,1855,155,132,567,382,131,183,305
"2011","Stoke-on-Trent 003A","E01014261","Total",1404,180,65,115,1224,228,80,230,168,159,131,228
"2011","Stoke-on-Trent 003B","E01014262","Total",1359,146,77,69,1213,115,136,225,158,115,205,259
"2011","Stoke-on-Trent 003C","E01014263","Total",1699,130,30,100,1569,158,84,378,222,196,209,322
"2011","Stoke-on-Trent 003D","E01014333","Total",1448,123,53,70,1325,67,190,319,294,53,116,286
"2011","Stoke-on-Trent 003E","E01014334","Total",1428,322,245,77,1106,34,318,129,250,40,89,246
"2011","Stoke-on-Trent 004A","E01014331","Total",1538,186,74,112,1352,172,158,286,204,116,191,225
"2011","Stoke-on-Trent 004B","E01014332","Total",1673,240,153,87,1433,44,344,287,304,37,125,292
"2011","Stoke-on-Trent 004C","E01014335","Total",1699,223,79,144,1476,81,220,369,296,68,171,271
"2011","Stoke-on-Trent 004D","E01014336","Total",1611,274,86,188,1337,147,126,275,244,153,201,191
"2011","Stoke-on-Trent 004E","E01014337","Total",1715,205,94,111,1510,122,190,351,252,142,137,316
"2011","Stoke-on-Trent 005A","E01014354","Total",1757,374,136,238,1383,222,156,321,238,97,175,174
"2011","Stoke-on-Trent 005B","E01014355","Total",1909,250,84,166,1659,130,100,343,268,187,372,259
"2011","Stoke-on-Trent 005C","E01014356","Total",1765,243,64,179,1522,147,144,335,256,114,284,242
"2011","Stoke-on-Trent 005D","E01014361","Total",1588,221,39,182,1367,220,62,287,222,88,276,212
"2011","Stoke-on-Trent 006A","E01014241","Total",1528,201,83,118,1327,130,136,202,240,138,178,303
"2011","Stoke-on-Trent 006B","E01014242","Total",1465,201,98,103,1264,146,158,282,180,91,175,232
"2011","Stoke-on-Trent 006C","E01014243","Total",1400,159,72,87,1241,41,208,259,236,37,161,299
"2011","Stoke-on-Trent 006D","E01014244","Total",1573,157,65,92,1416,250,100,330,202,165,200,169
"2011","Stoke-on-Trent 006E","E01014245","Total",1731,201,81,120,1530,76,156,394,262,122,270,250
"2011","Stoke-on-Trent 006F","E01014248","Total",1474,234,51,183,1240,124,90,364,244,46,125,247
"2011","Stoke-on-Trent 007A","E01014214","Total",1452,134,84,50,1318,33,302,252,256,45,88,342
"2011","Stoke-on-Trent 007B","E01014215","Total",1520,143,88,55,1377,60,202,351,192,121,93,358
"2011","Stoke-on-Trent 007C","E01014216","Total",1406,179,125,54,1227,71,226,283,274,32,78,263
"2011","Stoke-on-Trent 007D","E01014265","Total",1538,179,91,88,1359,49,240,358,288,33,106,285
"2011","Stoke-on-Trent 007E","E01014267","Total",2333,335,112,223,1998,154,236,542,492,106,153,315
"2011","Stoke-on-Trent 007F","E01014272","Total",1448,200,98,102,1248,78,220,261,258,62,89,280
"2011","Stoke-on-Trent 008A","E01014246","Total",1591,267,99,168,1324,147,156,287,250,81,177,226
"2011","Stoke-on-Trent 008B","E01014266","Total",1214,206,91,115,1008,103,154,253,194,43,83,178
"2011","Stoke-on-Trent 008C","E01014268","Total",2084,390,202,188,1694,167,208,532,342,104,131,210
"2011","Stoke-on-Trent 008D","E01014270","Total",1541,159,92,67,1382,92,230,309,244,47,161,299
"2011","Stoke-on-Trent 008E","E01014271","Total",1525,149,61,88,1376,97,178,320,196,137,135,313
"2011","Stoke-on-Trent 009A","E01014247","Total",1676,285,86,199,1391,164,142,258,304,118,164,241
"2011","Stoke-on-Trent 009B","E01014250","Total",1137,230,94,136,907,119,118,189,132,85,99,165
"2011","Stoke-on-Trent 009C","E01014251","Total",1833,425,103,322,1408,136,134,346,332,121,187,152
"2011","Stoke-on-Trent 009D","E01014252","Total",1660,253,52,201,1407,165,104,341,308,82,151,256
"2011","Stoke-on-Trent 009E","E01014255","Total",1903,221,57,164,1682,130,88,316,208,326,404,210
"2011","Stoke-on-Trent 010A","E01014269","Total",1629,220,103,117,1409,189,122,352,160,131,221,234
"2011","Stoke-on-Trent 010B","E01014324","Total",1451,226,127,99,1225,75,266,205,230,46,112,291
"2011","Stoke-on-Trent 010C","E01014325","Total",1335,101,29,72,1234,48,80,262,236,57,158,393
"2011","Stoke-on-Trent 010D","E01014326","Total",1483,115,43,72,1368,53,148,299,262,58,155,393
"2011","Stoke-on-Trent 011A","E01014249","Total",1730,372,93,279,1358,151,114,216,188,187,321,181
"2011","Stoke-on-Trent 011B","E01014253","Total",1551,188,77,111,1363,82,146,347,254,62,159,313
"2011","Stoke-on-Trent 011C","E01014254","Total",1569,242,46,196,1327,152,76,297,184,179,212,227
"2011","Stoke-on-Trent 011D","E01014256","Total",1621,304,122,182,1317,132,182,274,276,105,157,191
"2011","Stoke-on-Trent 012A","E01014210","Total",1490,183,82,101,1307,115,180,213,176,112,216,295
"2011","Stoke-on-Trent 012B","E01014211","Total",1484,184,91,93,1300,137,146,227,212,130,183,265
"2011","Stoke-on-Trent 012C","E01014212","Total",1291,240,134,106,1051,106,136,249,162,72,91,235
"2011","Stoke-on-Trent 012D","E01014213","Total",1238,140,40,100,1098,117,118,217,204,74,137,231
"2011","Stoke-on-Trent 012E","E01014217","Total",1418,233,92,141,1185,199,150,300,146,61,113,216
"2011","Stoke-on-Trent 013A","E01014323","Total",1274,223,59,164,1051,139,96,252,230,62,67,205
"2011","Stoke-on-Trent 013B","E01014327","Total",1452,233,70,163,1219,113,130,340,252,51,135,198
"2011","Stoke-on-Trent 013C","E01014328","Total",1441,240,72,168,1201,104,98,252,232,59,162,294
"2011","Stoke-on-Trent 013D","E01014329","Total",1532,265,128,137,1267,149,146,323,262,75,121,191
"2011","Stoke-on-Trent 013E","E01014330","Total",1578,558,147,411,1020,111,82,218,222,77,136,174
"2011","Stoke-on-Trent 014A","E01014218","Total",1509,183,78,105,1326,193,116,246,170,131,189,281
"2011","Stoke-on-Trent 014B","E01014219","Total",1272,181,87,94,1091,49,190,213,232,47,133,227
"2011","Stoke-on-Trent 014C","E01014225","Total",1465,194,94,100,1271,78,238,279,266,37,112,261
"2011","Stoke-on-Trent 014D","E01014226","Total",1441,320,224,96,1121,72,188,176,220,73,156,236
"2011","Stoke-on-Trent 014E","E01014228","Total",1311,113,61,52,1198,52,262,185,288,45,84,282
"2011","Stoke-on-Trent 014F","E01014230","Total",1494,233,102,131,1261,116,180,277,252,67,97,272
"2011","Stoke-on-Trent 015A","E01014281","Total",1653,219,27,192,1434,90,52,186,174,161,241,530
"2011","Stoke-on-Trent 015B","E01014285","Total",2207,323,96,227,1884,131,102,444,342,214,275,376
"2011","Stoke-on-Trent 015C","E01014286","Total",1378,222,58,164,1156,98,86,192,122,167,242,249
"2011","Stoke-on-Trent 015D","E01014287","Total",1484,275,51,224,1209,138,102,179,148,177,214,251
"2011","Stoke-on-Trent 016B","E01014231","Total",1488,628,144,484,860,53,86,177,276,57,95,116
"2011","Stoke-on-Trent 016D","E01014282","Total",974,293,41,252,681,51,62,53,100,58,135,222
"2011","Stoke-on-Trent 016E","E01014283","Total",2041,284,40,244,1757,48,56,143,308,98,141,963
"2011","Stoke-on-Trent 016F","E01014284","Total",1470,76,10,66,1394,12,24,65,186,60,113,934
"2011","Stoke-on-Trent 016G","E01033216","Total",2395,450,147,303,1945,124,280,422,510,83,126,400
"2011","Stoke-on-Trent 017A","E01014220","Total",1637,251,101,150,1386,239,120,324,218,107,147,231
"2011","Stoke-on-Trent 017B","E01014221","Total",1588,205,62,143,1383,189,108,286,202,117,203,278
"2011","Stoke-on-Trent 017C","E01014222","Total",1524,228,77,151,1296,225,96,269,172,116,186,232
"2011","Stoke-on-Trent 017D","E01014223","Total",1604,300,84,216,1304,232,142,254,218,90,144,224
"2011","Stoke-on-Trent 017E","E01014224","Total",1521,232,91,141,1289,212,162,267,172,130,130,216
"2011","Stoke-on-Trent 017F","E01014229","Total",1778,248,108,140,1530,287,140,414,256,131,161,141
"2011","Stoke-on-Trent 018A","E01014288","Total",1596,251,68,183,1345,98,96,305,336,74,122,314
"2011","Stoke-on-Trent 018B","E01014289","Total",1555,171,62,109,1384,49,176,288,340,92,143,296
"2011","Stoke-on-Trent 018C","E01014290","Total",1524,216,58,158,1308,90,126,350,294,83,127,238
"2011","Stoke-on-Trent 018D","E01014291","Total",1357,247,70,177,1110,63,92,230,258,92,122,253
"2011","Stoke-on-Trent 018E","E01014292","Total",1602,210,58,152,1392,77,132,280,324,96,156,327
"2011","Stoke-on-Trent 018F","E01014294","Total",1287,252,85,167,1035,82,106,187,200,54,234,172
"2011","Stoke-on-Trent 019A","E01014293","Total",1650,289,42,247,1361,132,82,285,356,65,112,329
"2011","Stoke-on-Trent 019B","E01014295","Total",1706,281,124,157,1425,64,272,366,260,69,140,254
"2011","Stoke-on-Trent 019C","E01014339","Total",1659,317,70,247,1342,151,92,346,334,65,67,287
"2011","Stoke-on-Trent 019D","E01014340","Total",1884,306,92,214,1578,178,120,414,362,78,138,288
"2011","Stoke-on-Trent 019E","E01014345","Total",1718,449,93,356,1269,130,104,262,306,116,94,257
"2011","Stoke-on-Trent 020A","E01014274","Total",1800,304,90,214,1496,226,164,388,336,100,103,179
"2011","Stoke-on-Trent 020B","E01014275","Total",1417,390,159,231,1027,168,120,203,198,74,118,146
"2011","Stoke-on-Trent 020C","E01014276","Total",1549,268,75,193,1281,140,136,344,268,48,115,230
"2011","Stoke-on-Trent 020D","E01014277","Total",1558,228,88,140,1330,85,174,316,304,64,113,274
"2011","Stoke-on-Trent 020E","E01014279","Total",1730,299,55,244,1431,152,134,346,326,81,170,222
"2011","Stoke-on-Trent 021A","E01014273","Total",1280,193,34,159,1087,193,68,272,224,68,117,145
"2011","Stoke-on-Trent 021B","E01014278","Total",1354,177,52,125,1177,107,126,251,266,75,120,232
"2011","Stoke-on-Trent 021C","E01014280","Total",1313,191,74,117,1122,77,178,228,264,22,95,258
"2011","Stoke-on-Trent 021D","E01014297","Total",1305,71,16,55,1234,65,78,276,258,59,144,354
"2011","Stoke-on-Trent 022A","E01014296","Total",1420,163,54,109,1257,75,138,274,272,99,126,273
"2011","Stoke-on-Trent 022B","E01014298","Total",1589,231,70,161,1358,152,118,305,244,104,224,211
"2011","Stoke-on-Trent 022C","E01014300","Total",1417,211,100,111,1206,162,116,272,204,53,157,242
"2011","Stoke-on-Trent 022D","E01014302","Total",1817,416,174,242,1401,149,214,269,298,110,171,190
"2011","Stoke-on-Trent 023A","E01014338","Total",1487,244,77,167,1243,44,180,284,246,49,162,278
"2011","Stoke-on-Trent 023B","E01014341","Total",1760,254,70,184,1506,50,152,293,330,141,173,367
"2011","Stoke-on-Trent 023C","E01014342","Total",1516,170,94,76,1346,170,134,256,172,134,212,268
"2011","Stoke-on-Trent 023D","E01014343","Total",1770,327,84,243,1443,119,104,366,362,135,114,243
"2011","Stoke-on-Trent 023E","E01014344","Total",1509,181,68,113,1328,117,118,303,200,141,195,254
"2011","Stoke-on-Trent 024A","E01014363","Total",1350,173,112,61,1177,57,308,162,242,54,120,234
"2011","Stoke-on-Trent 024B","E01014364","Total",1402,173,75,98,1229,79,168,309,252,66,164,191
"2011","Stoke-on-Trent 024C","E01014365","Total",1445,155,91,64,1290,59,302,209,246,16,152,306
"2011","Stoke-on-Trent 024D","E01014369","Total",1295,132,67,65,1163,96,190,204,260,54,135,224
"2011","Stoke-on-Trent 025A","E01014299","Total",1417,136,46,90,1281,78,114,288,330,53,117,301
"2011","Stoke-on-Trent 025B","E01014301","Total",1753,122,32,90,1631,80,86,562,294,62,241,306
"2011","Stoke-on-Trent 025C","E01014303","Total",1596,139,38,101,1457,85,114,405,354,68,148,283
"2011","Stoke-on-Trent 025D","E01014304","Total",1457,196,93,103,1261,77,226,265,232,81,149,231
"2011","Stoke-on-Trent 025E","E01014362","Total",1420,114,60,54,1306,46,202,322,290,59,131,256
"2011","Stoke-on-Trent 026A","E01014233","Total",1407,177,108,69,1230,47,278,224,234,71,135,241
"2011","Stoke-on-Trent 026B","E01014234","Total",1582,108,46,62,1474,177,90,342,190,149,272,254
"2011","Stoke-on-Trent 026C","E01014239","Total",1470,149,74,75,1321,46,182,288,226,101,209,269
"2011","Stoke-on-Trent 026D","E01014240","Total",1529,178,83,95,1351,82,148,300,224,150,156,291
"2011","Stoke-on-Trent 027A","E01014308","Total",1658,262,151,111,1396,44,284,260,252,34,164,358
"2011","Stoke-on-Trent 027B","E01014309","Total",1218,259,121,138,959,89,184,215,158,47,113,153
"2011","Stoke-on-Trent 027C","E01014311","Total",1319,217,90,127,1102,103,178,189,232,62,118,220
"2011","Stoke-on-Trent 027D","E01014313","Total",1567,402,250,152,1165,78,268,249,200,80,98,192
"2011","Stoke-on-Trent 028A","E01014321","Total",1425,192,68,124,1233,56,174,275,268,67,124,269
"2011","Stoke-on-Trent 028B","E01014366","Total",1885,311,105,206,1574,174,184,343,194,211,223,245
"2011","Stoke-on-Trent 028C","E01014367","Total",1460,267,102,165,1193,157,126,274,182,111,175,168
"2011","Stoke-on-Trent 028D","E01014368","Total",1597,206,87,119,1391,178,158,294,196,119,168,278
"2011","Stoke-on-Trent 029A","E01014305","Total",1339,157,48,109,1182,87,72,183,106,219,349,166
"2011","Stoke-on-Trent 029B","E01014306","Total",1396,182,44,138,1214,143,66,234,168,97,278,228
"2011","Stoke-on-Trent 029C","E01014307","Total",1382,129,33,96,1253,147,58,162,114,190,413,169
"2011","Stoke-on-Trent 029D","E01014312","Total",1425,173,83,90,1252,82,176,262,200,92,184,256
"2011","Stoke-on-Trent 030A","E01014346","Total",1559,217,129,88,1342,35,298,283,292,36,72,326
"2011","Stoke-on-Trent 030B","E01014348","Total",1366,163,106,57,1203,31,322,268,230,68,84,200
"2011","Stoke-on-Trent 030C","E01014349","Total",1418,182,123,59,1236,48,280,281,234,21,117,255
"2011","Stoke-on-Trent 030D","E01014353","Total",1708,202,93,109,1506,191,116,382,258,110,177,272
"2011","Stoke-on-Trent 031A","E01014310","Total",2062,146,56,90,1916,84,184,582,286,154,341,285
"2011","Stoke-on-Trent 031B","E01014314","Total",1409,86,26,60,1323,28,128,338,228,90,197,314
"2011","Stoke-on-Trent 031C","E01014316","Total",1552,196,81,115,1356,215,80,306,156,171,250,178
"2011","Stoke-on-Trent 031D","E01014317","Total",1557,255,127,128,1302,184,146,299,186,112,139,236
"2011","Stoke-on-Trent 031E","E01014322","Total",1662,179,59,120,1483,106,136,277,252,151,315,246
"2011","Stoke-on-Trent 032A","E01014235","Total",1585,343,128,215,1242,129,176,221,194,92,166,264
"2011","Stoke-on-Trent 032B","E01014236","Total",2344,331,99,232,2013,238,132,570,342,170,288,273
"2011","Stoke-on-Trent 032C","E01014237","Total",1592,377,83,294,1215,152,114,262,184,106,192,205
"2011","Stoke-on-Trent 032D","E01014238","Total",1523,259,71,188,1264,147,120,215,218,199,157,208
"2011","Stoke-on-Trent 033A","E01014315","Total",1331,131,76,55,1200,20,284,232,290,26,85,263
"2011","Stoke-on-Trent 033B","E01014318","Total",1448,146,69,77,1302,36,156,359,242,51,148,310
"2011","Stoke-on-Trent 033C","E01014319","Total",1508,135,65,70,1373,96,152,416,208,53,201,247
"2011","Stoke-on-Trent 033D","E01014320","Total",1291,75,18,57,1216,51,84,313,208,65,161,334
"2011","Stoke-on-Trent 034A","E01014347","Total",1413,123,45,78,1290,38,134,307,308,32,138,333
"2011","Stoke-on-Trent 034B","E01014350","Total",1370,98,56,42,1272,35,232,276,248,30,160,291
"2011","Stoke-on-Trent 034C","E01014351","Total",1315,144,37,107,1171,33,130,311,278,56,82,281
"2011","Stoke-on-Trent 034D","E01014352","Total",1386,116,66,50,1270,17,174,349,318,30,74,308
"2011","Telford and Wrekin 001A","E01014171","Total",1419,174,95,79,1245,110,170,253,186,61,80,385
"2011","Telford and Wrekin 001B","E01014172","Total",1407,81,40,41,1326,39,146,306,214,88,152,381
"2011","Telford and Wrekin 001C","E01014173","Total",1515,201,106,95,1314,60,186,307,262,84,92,323
"2011","Telford and Wrekin 001D","E01014174","Total",1594,102,54,48,1492,27,170,462,236,103,195,299
"2011","Telford and Wrekin 002A","E01014112","Total",1553,121,72,49,1432,33,236,339,248,63,165,348
"2011","Telford and Wrekin 002B","E01014131","Total",1531,108,67,41,1423,13,180,269,272,118,188,383
"2011","Telford and Wrekin 002C","E01014132","Total",1080,98,66,32,982,36,210,199,154,36,97,250
"2011","Telford and Wrekin 002D","E01014135","Total",1215,83,31,52,1132,32,192,229,198,68,141,272
"2011","Telford and Wrekin 003A","E01014175","Total",1140,149,78,71,991,57,152,250,186,56,67,223
"2011","Telford and Wrekin 003B","E01014176","Total",1465,165,94,71,1300,51,260,225,232,79,116,337
"2011","Telford and Wrekin 003C","E01014177","Total",1384,148,84,64,1236,50,206,241,228,54,139,318
"2011","Telford and Wrekin 003D","E01014178","Total",1421,249,109,140,1172,64,132,212,308,38,93,325
"2011","Telford and Wrekin 004A","E01014111","Total",1540,134,75,59,1406,34,248,339,260,109,137,279
"2011","Telford and Wrekin 004B","E01014167","Total",1949,106,37,69,1843,102,104,644,276,138,254,325
"2011","Telford and Wrekin 004C","E01014168","Total",1389,57,22,35,1332,62,126,410,230,87,199,218
"2011","Telford and Wrekin 004D","E01014170","Total",1482,187,120,67,1295,69,282,277,234,66,150,217
"2011","Telford and Wrekin 005A","E01014125","Total",1562,224,71,153,1338,109,118,274,228,144,189,276
"2011","Telford and Wrekin 005B","E01014126","Total",1454,160,90,70,1294,94,226,224,192,100,225,233
"2011","Telford and Wrekin 005C","E01014127","Total",1711,148,42,106,1563,151,106,359,236,213,214,284
"2011","Telford and Wrekin 005D","E01014128","Total",2021,209,101,108,1812,109,160,506,350,154,235,298
"2011","Telford and Wrekin 005E","E01014169","Total",1737,166,30,136,1571,165,60,484,356,150,178,178
"2011","Telford and Wrekin 006A","E01014129","Total",1012,247,110,137,765,42,166,162,160,58,44,133
"2011","Telford and Wrekin 006B","E01014130","Total",1412,129,58,71,1283,73,154,286,274,75,165,256
"2011","Telford and Wrekin 006C","E01014179","Total",1192,102,63,39,1090,47,210,248,182,51,108,244
"2011","Telford and Wrekin 006D","E01014180","Total",1300,186,107,79,1114,55,222,217,176,70,117,257
"2011","Telford and Wrekin 006E","E01014189","Total",1537,107,43,64,1430,93,120,365,282,116,186,268
"2011","Telford and Wrekin 006F","E01014190","Total",1702,83,23,60,1619,61,114,432,266,66,283,397
"2011","Telford and Wrekin 007A","E01014102","Total",1803,110,47,63,1693,41,170,497,314,97,256,318
"2011","Telford and Wrekin 007B","E01014103","Total",1235,100,55,45,1135,22,112,270,188,85,150,308
"2011","Telford and Wrekin 007C","E01014138","Total",1486,173,75,98,1313,115,128,257,232,130,200,251
"2011","Telford and Wrekin 007D","E01014140","Total",1463,195,54,141,1268,106,114,270,214,84,203,277
"2011","Telford and Wrekin 008A","E01014205","Total",1382,145,88,57,1237,17,250,225,270,86,100,289
"2011","Telford and Wrekin 008B","E01014206","Total",1322,100,41,59,1222,99,156,233,186,116,200,232
"2011","Telford and Wrekin 008C","E01014207","Total",1291,83,39,44,1208,47,140,284,236,65,188,248
"2011","Telford and Wrekin 008D","E01014208","Total",1218,162,76,86,1056,109,152,214,214,100,130,137
"2011","Telford and Wrekin 008E","E01014209","Total",1458,159,94,65,1299,56,210,236,178,81,215,323
"2011","Telford and Wrekin 009A","E01014137","Total",1525,59,21,38,1466,52,112,479,188,94,222,319
"2011","Telford and Wrekin 009B","E01014139","Total",1396,147,94,53,1249,78,90,290,150,150,238,253
"2011","Telford and Wrekin 009C","E01014141","Total",2795,237,62,175,2558,293,140,764,490,185,278,408
"2011","Telford and Wrekin 009D","E01014142","Total",1402,89,45,44,1313,174,74,197,118,225,284,241
"2011","Telford and Wrekin 009E","E01014143","Total",1476,179,89,90,1297,103,146,300,184,103,213,248
"2011","Telford and Wrekin 010A","E01014136","Total",1535,195,111,84,1340,35,288,286,272,56,120,283
"2011","Telford and Wrekin 010B","E01014148","Total",1478,226,58,168,1252,42,168,248,394,66,123,211
"2011","Telford and Wrekin 010C","E01014149","Total",1030,95,46,49,935,32,124,199,250,50,88,192
"2011","Telford and Wrekin 010D","E01014202","Total",2361,167,59,108,2194,77,232,595,420,147,304,419
"2011","Telford and Wrekin 010E","E01014203","Total",1532,149,88,61,1383,38,234,389,192,51,234,245
"2011","Telford and Wrekin 010F","E01014204","Total",1981,147,61,86,1834,60,206,458,296,163,226,425
"2011","Telford and Wrekin 011A","E01014104","Total",1700,125,53,72,1575,113,170,315,272,150,291,264
"2011","Telford and Wrekin 011B","E01014105","Total",1925,174,64,110,1751,173,130,316,212,250,329,341
"2011","Telford and Wrekin 011C","E01014113","Total",1604,232,87,145,1372,88,90,209,232,184,299,270
"2011","Telford and Wrekin 011D","E01014114","Total",1391,228,113,115,1163,28,192,212,280,62,179,210
"2011","Telford and Wrekin 012A","E01014133","Total",1733,232,79,153,1501,105,266,311,282,68,129,340
"2011","Telford and Wrekin 012B","E01014134","Total",1297,166,119,47,1131,31,286,227,210,73,100,204
"2011","Telford and Wrekin 012C","E01014144","Total",1506,206,102,104,1300,114,218,267,198,102,170,231
"2011","Telford and Wrekin 012D","E01014145","Total",1767,355,111,244,1412,122,134,342,390,91,138,195
"2011","Telford and Wrekin 013A","E01014185","Total",1641,308,159,149,1333,122,214,218,278,61,179,261
"2011","Telford and Wrekin 013B","E01014186","Total",1429,187,87,100,1242,113,120,297,270,85,120,237
"2011","Telford and Wrekin 013C","E01014187","Total",1471,210,65,145,1261,70,182,301,284,47,154,223
"2011","Telford and Wrekin 013D","E01014188","Total",1511,123,48,75,1388,58,124,374,322,53,158,299
"2011","Telford and Wrekin 014A","E01014150","Total",1644,150,53,97,1494,57,188,340,366,71,186,286
"2011","Telford and Wrekin 014B","E01014151","Total",1504,192,98,94,1312,116,152,329,204,103,173,235
"2011","Telford and Wrekin 014C","E01014152","Total",1299,173,103,70,1126,111,224,201,198,37,138,217
"2011","Telford and Wrekin 014D","E01014153","Total",1703,285,106,179,1418,94,164,354,288,62,133,323
"2011","Telford and Wrekin 014E","E01014154","Total",1677,156,47,109,1521,65,142,433,320,81,154,326
"2011","Telford and Wrekin 014F","E01014155","Total",1648,169,83,86,1479,106,180,366,250,109,186,282
"2011","Telford and Wrekin 015A","E01014181","Total",2003,81,15,66,1922,60,72,677,288,153,292,380
"2011","Telford and Wrekin 015B","E01014182","Total",1232,82,31,51,1150,44,112,277,244,67,170,236
"2011","Telford and Wrekin 015C","E01014183","Total",1558,106,53,53,1452,43,236,344,254,68,167,340
"2011","Telford and Wrekin 015D","E01014184","Total",1452,81,37,44,1371,77,136,428,196,100,159,275
"2011","Telford and Wrekin 016A","E01014146","Total",2101,122,29,93,1979,127,142,650,380,168,233,279
"2011","Telford and Wrekin 016B","E01014147","Total",2071,128,46,82,1943,114,124,539,440,166,208,352
"2011","Telford and Wrekin 016C","E01014156","Total",2160,171,37,134,1989,173,70,603,324,212,261,346
"2011","Telford and Wrekin 016D","E01014157","Total",1504,88,23,65,1416,35,74,349,246,98,254,360
"2011","Telford and Wrekin 016E","E01014158","Total",1561,171,47,124,1390,80,86,452,312,91,133,236
"2011","Telford and Wrekin 017A","E01014124","Total",1671,276,122,154,1395,163,156,253,278,129,169,247
"2011","Telford and Wrekin 017B","E01014163","Total",1459,106,44,62,1353,184,120,253,136,129,236,295
"2011","Telford and Wrekin 017C","E01014164","Total",1627,220,73,147,1407,211,142,275,204,188,162,225
"2011","Telford and Wrekin 017D","E01014165","Total",1419,186,61,125,1233,121,86,269,188,107,164,298
"2011","Telford and Wrekin 017E","E01014166","Total",1581,165,70,95,1416,88,134,348,266,105,204,271
"2011","Telford and Wrekin 018A","E01014191","Total",1742,225,46,179,1517,147,90,257,322,142,181,378
"2011","Telford and Wrekin 018B","E01014192","Total",1437,70,27,43,1367,106,80,300,156,148,196,381
"2011","Telford and Wrekin 018C","E01014193","Total",1668,106,36,70,1562,164,108,352,232,137,233,336
"2011","Telford and Wrekin 018D","E01014194","Total",1520,139,47,92,1381,137,116,283,232,114,237,262
"2011","Telford and Wrekin 018E","E01014195","Total",1447,80,36,44,1367,47,120,290,234,117,188,371
"2011","Telford and Wrekin 018F","E01014196","Total",1543,192,105,87,1351,123,146,240,234,136,172,300
"2011","Telford and Wrekin 019A","E01014119","Total",1658,156,89,67,1502,63,190,312,292,120,219,306
"2011","Telford and Wrekin 019B","E01014120","Total",1750,270,129,141,1480,147,142,322,240,167,175,287
"2011","Telford and Wrekin 019C","E01014121","Total",1388,171,78,93,1217,48,216,203,238,52,140,320
"2011","Telford and Wrekin 019D","E01014122","Total",1562,240,34,206,1322,142,84,320,382,61,133,200
"2011","Telford and Wrekin 019E","E01014123","Total",1532,126,39,87,1406,75,92,403,332,60,152,292
"2011","Telford and Wrekin 020A","E01014106","Total",1584,145,46,99,1439,111,140,325,240,157,224,242
"2011","Telford and Wrekin 020B","E01014107","Total",1178,79,35,44,1099,21,180,198,260,71,113,256
"2011","Telford and Wrekin 020C","E01014108","Total",1467,241,34,207,1226,191,68,287,208,129,177,166
"2011","Telford and Wrekin 020D","E01014109","Total",1193,81,17,64,1112,128,92,273,226,64,121,208
"2011","Telford and Wrekin 020E","E01014110","Total",1499,62,17,45,1437,226,48,303,134,172,277,277
"2011","Telford and Wrekin 021A","E01014197","Total",1486,102,42,60,1384,185,118,284,210,150,191,246
"2011","Telford and Wrekin 021B","E01014198","Total",1091,95,43,52,996,161,72,190,130,117,179,147
"2011","Telford and Wrekin 021C","E01014199","Total",1673,131,34,97,1542,233,60,367,206,193,230,253
"2011","Telford and Wrekin 021D","E01014200","Total",1307,73,25,48,1234,209,72,270,132,178,161,212
"2011","Telford and Wrekin 021E","E01014201","Total",1304,73,29,44,1231,208,72,228,168,195,175,185
"2011","Telford and Wrekin 022A","E01014159","Total",1231,232,114,118,999,72,156,222,198,52,113,186
"2011","Telford and Wrekin 022B","E01014160","Total",1311,108,42,66,1203,49,154,242,242,60,180,276
"2011","Telford and Wrekin 022C","E01014161","Total",1138,135,53,82,1003,63,126,216,230,37,105,226
"2011","Telford and Wrekin 022D","E01014162","Total",1588,371,183,188,1217,98,164,219,282,98,147,209
"2011","Telford and Wrekin 023A","E01014115","Total",1341,144,60,84,1197,96,128,239,222,146,129,237
"2011","Telford and Wrekin 023B","E01014116","Total",1662,268,142,126,1394,184,250,282,262,130,122,164
"2011","Telford and Wrekin 023C","E01014117","Total",1183,78,37,41,1105,45,252,171,214,48,124,251
"2011","Telford and Wrekin 023D","E01014118","Total",1215,105,38,67,1110,183,54,217,138,150,144,224
"2011","Cannock Chase 001A","E01029368","Total",1226,79,49,30,1147,24,298,215,198,10,94,308
"2011","Cannock Chase 001B","E01029369","Total",1250,95,41,54,1155,66,150,328,214,62,136,199
"2011","Cannock Chase 001C","E01029370","Total",1366,126,61,65,1240,12,252,212,254,52,173,285
"2011","Cannock Chase 001D","E01029371","Total",1550,122,41,81,1428,73,138,360,282,110,168,297
"2011","Cannock Chase 001E","E01029402","Total",1946,212,125,87,1734,41,330,477,336,76,163,311
"2011","Cannock Chase 002A","E01029372","Total",1358,147,44,103,1211,110,54,266,178,133,236,234
"2011","Cannock Chase 002B","E01029373","Total",2252,231,85,146,2021,98,168,576,296,172,344,367
"2011","Cannock Chase 002C","E01029401","Total",1605,145,69,76,1460,90,150,367,302,76,164,311
"2011","Cannock Chase 002D","E01029403","Total",1500,166,74,92,1334,76,152,350,238,95,150,273
"2011","Cannock Chase 002E","E01029404","Total",1437,403,175,228,1034,111,158,189,284,74,73,145
"2011","Cannock Chase 003A","E01029345","Total",1626,157,66,91,1469,110,148,340,282,132,209,248
"2011","Cannock Chase 003B","E01029346","Total",1699,248,125,123,1451,179,156,395,222,112,195,192
"2011","Cannock Chase 003C","E01029347","Total",1432,154,94,60,1278,28,302,260,282,32,58,316
"2011","Cannock Chase 003D","E01029348","Total",1751,146,82,64,1605,82,250,347,272,103,199,352
"2011","Cannock Chase 003E","E01029374","Total",2349,223,94,129,2126,166,210,585,376,125,228,436
"2011","Cannock Chase 004A","E01029383","Total",1570,107,38,69,1463,56,132,428,324,57,164,302
"2011","Cannock Chase 004B","E01029385","Total",1479,120,57,63,1359,32,168,293,344,60,135,327
"2011","Cannock Chase 004C","E01029388","Total",1373,205,111,94,1168,93,118,289,248,102,87,231
"2011","Cannock Chase 004D","E01029390","Total",1124,134,49,85,990,103,82,148,170,102,159,226
"2011","Cannock Chase 005A","E01029384","Total",1936,207,87,120,1729,73,212,461,362,87,208,326
"2011","Cannock Chase 005B","E01029386","Total",1436,154,58,96,1282,99,178,322,214,84,98,287
"2011","Cannock Chase 005C","E01029387","Total",1478,187,83,104,1291,55,170,241,264,101,162,298
"2011","Cannock Chase 005D","E01029389","Total",1642,268,74,194,1374,87,178,330,372,54,128,225
"2011","Cannock Chase 006A","E01029379","Total",1767,105,30,75,1662,83,64,621,288,96,214,296
"2011","Cannock Chase 006B","E01029398","Total",1680,156,86,70,1524,55,250,359,268,93,158,341
"2011","Cannock Chase 006C","E01029399","Total",1526,195,50,145,1331,55,122,336,276,69,218,255
"2011","Cannock Chase 006D","E01029400","Total",1670,141,50,91,1529,54,114,366,300,118,247,330
"2011","Cannock Chase 007A","E01029354","Total",1548,176,105,71,1372,72,170,296,268,86,233,247
"2011","Cannock Chase 007B","E01029355","Total",1557,209,109,100,1348,107,146,323,220,84,206,262
"2011","Cannock Chase 007C","E01029356","Total",1497,194,107,87,1303,117,168,318,198,101,133,268
"2011","Cannock Chase 007D","E01029357","Total",1354,135,57,78,1219,77,146,214,214,84,159,325
"2011","Cannock Chase 007E","E01029358","Total",1316,138,51,87,1178,127,92,241,152,229,193,144
"2011","Cannock Chase 008A","E01029349","Total",1280,211,103,108,1069,72,204,219,244,37,108,185
"2011","Cannock Chase 008B","E01029350","Total",1526,226,96,130,1300,88,186,271,236,96,169,254
"2011","Cannock Chase 008C","E01029351","Total",1503,223,56,167,1280,179,112,260,220,71,215,223
"2011","Cannock Chase 008D","E01029352","Total",1351,122,38,84,1229,66,114,272,266,77,106,328
"2011","Cannock Chase 008E","E01029393","Total",1671,241,109,132,1430,67,240,290,284,46,146,357
"2011","Cannock Chase 009A","E01029380","Total",1539,88,24,64,1451,48,92,534,228,53,139,357
"2011","Cannock Chase 009B","E01029381","Total",1478,234,104,130,1244,73,214,285,282,48,107,235
"2011","Cannock Chase 009C","E01029382","Total",1596,258,112,146,1338,64,190,309,260,78,133,304
"2011","Cannock Chase 009D","E01029391","Total",1651,152,64,88,1499,42,226,325,278,81,196,351
"2011","Cannock Chase 009E","E01029392","Total",1963,111,47,64,1852,74,148,593,308,107,263,359
"2011","Cannock Chase 010A","E01029375","Total",2504,114,15,99,2390,106,96,851,486,159,275,417
"2011","Cannock Chase 010B","E01029376","Total",1860,167,22,145,1693,113,42,554,356,99,242,287
"2011","Cannock Chase 010C","E01029377","Total",1449,71,7,64,1378,56,34,466,240,80,230,272
"2011","Cannock Chase 010D","E01029378","Total",1701,125,29,96,1576,56,96,488,334,103,191,308
"2011","Cannock Chase 011A","E01029353","Total",1403,250,122,128,1153,58,254,244,248,64,48,237
"2011","Cannock Chase 011B","E01029364","Total",1601,214,97,117,1387,39,302,265,280,85,107,309
"2011","Cannock Chase 011C","E01029365","Total",1530,180,79,101,1350,44,192,294,268,56,192,304
"2011","Cannock Chase 011D","E01029366","Total",1687,157,110,47,1530,25,436,285,248,16,145,375
"2011","Cannock Chase 011E","E01029367","Total",2140,293,137,156,1847,84,256,470,374,125,193,345
"2011","Cannock Chase 012A","E01029359","Total",1608,279,81,198,1329,137,98,344,298,78,189,185
"2011","Cannock Chase 012B","E01029360","Total",1466,322,152,170,1144,112,168,252,228,62,98,224
"2011","Cannock Chase 012C","E01029361","Total",1545,184,71,113,1361,64,196,286,190,133,197,295
"2011","Cannock Chase 012D","E01029362","Total",1562,233,70,163,1329,180,104,322,198,83,168,274
"2011","Cannock Chase 012E","E01029363","Total",1404,246,119,127,1158,43,224,276,210,54,102,249
"2011","Cannock Chase 013A","E01029394","Total",1462,152,78,74,1310,60,282,214,258,83,110,303
"2011","Cannock Chase 013B","E01029395","Total",1571,169,73,96,1402,45,258,293,276,31,128,371
"2011","Cannock Chase 013C","E01029396","Total",1712,169,72,97,1543,66,186,384,350,63,163,331
"2011","Cannock Chase 013D","E01029397","Total",2728,264,122,142,2464,225,178,763,346,232,333,387
"2011","East Staffordshire 001A","E01029405","Total",1587,134,60,74,1453,22,238,290,288,111,201,303
"2011","East Staffordshire 001B","E01029406","Total",1227,91,41,50,1136,21,142,268,208,78,150,269
"2011","East Staffordshire 001C","E01029422","Total",1138,100,46,54,1038,29,204,230,188,65,120,202
"2011","East Staffordshire 001D","E01029423","Total",1569,192,79,113,1377,117,154,324,246,79,190,267
"2011","East Staffordshire 001E","E01029467","Total",2048,247,124,123,1801,44,338,413,360,106,159,381
"2011","East Staffordshire 002A","E01029430","Total",1474,133,74,59,1341,43,176,372,276,55,119,300
"2011","East Staffordshire 002B","E01029431","Total",1622,205,89,116,1417,129,148,321,272,113,197,237
"2011","East Staffordshire 002C","E01029432","Total",1475,156,87,69,1319,70,270,244,230,68,148,289
"2011","East Staffordshire 002D","E01029433","Total",1586,164,84,80,1422,111,128,296,212,145,223,307
"2011","East Staffordshire 003A","E01029459","Total",1574,150,42,108,1424,73,106,471,272,99,155,248
"2011","East Staffordshire 003B","E01029460","Total",1729,295,153,142,1434,62,182,393,262,93,203,239
"2011","East Staffordshire 003C","E01029461","Total",1915,291,124,167,1624,87,186,367,338,122,277,247
"2011","East Staffordshire 003D","E01029462","Total",1524,228,115,113,1296,55,188,307,266,92,153,235
"2011","East Staffordshire 004A","E01029443","Total",1677,162,95,67,1515,33,318,405,274,73,139,273
"2011","East Staffordshire 004B","E01029444","Total",1590,215,142,73,1375,41,306,296,278,60,97,297
"2011","East Staffordshire 004C","E01029463","Total",1236,115,55,60,1121,23,206,250,218,77,156,191
"2011","East Staffordshire 004D","E01029464","Total",1573,224,122,102,1349,90,206,304,236,85,100,328
"2011","East Staffordshire 004E","E01029465","Total",1502,210,108,102,1292,64,242,286,328,42,74,256
"2011","East Staffordshire 004F","E01029466","Total",1560,124,69,55,1436,47,216,349,262,117,176,269
"2011","East Staffordshire 005A","E01029454","Total",1638,108,68,40,1530,22,268,338,252,80,187,383
"2011","East Staffordshire 005B","E01029455","Total",1827,185,117,68,1642,60,234,473,258,90,234,293
"2011","East Staffordshire 005C","E01029456","Total",1487,299,132,167,1188,84,226,283,282,62,105,146
"2011","East Staffordshire 005D","E01029457","Total",1370,111,45,66,1259,68,84,389,228,72,134,284
"2011","East Staffordshire 005E","E01029458","Total",1495,133,82,51,1362,53,242,287,236,80,144,320
"2011","East Staffordshire 006A","E01029411","Total",1287,105,51,54,1182,28,238,277,214,64,150,211
"2011","East Staffordshire 006B","E01029412","Total",1286,164,88,76,1122,28,208,259,256,67,101,203
"2011","East Staffordshire 006C","E01029424","Total",1005,103,61,42,902,13,186,198,180,34,93,198
"2011","East Staffordshire 006D","E01029425","Total",1475,124,59,65,1351,42,230,298,242,52,157,330
"2011","East Staffordshire 006E","E01029473","Total",1364,129,75,54,1235,24,228,271,236,99,163,214
"2011","East Staffordshire 006F","E01029474","Total",1207,130,78,52,1077,37,234,284,196,51,111,164
"2011","East Staffordshire 007A","E01029434","Total",1567,177,67,110,1390,134,118,345,212,109,220,252
"2011","East Staffordshire 007B","E01029435","Total",1484,194,119,75,1290,52,256,247,194,100,163,278
"2011","East Staffordshire 007C","E01029436","Total",1843,334,113,221,1509,185,176,293,268,99,258,230
"2011","East Staffordshire 007D","E01029437","Total",2237,269,111,158,1968,258,112,514,340,175,251,318
"2011","East Staffordshire 007E","E01029438","Total",1512,158,94,64,1354,59,258,346,222,49,138,282
"2011","East Staffordshire 008A","E01029426","Total",1727,250,69,181,1477,130,86,375,246,177,249,214
"2011","East Staffordshire 008B","E01029427","Total",1521,235,83,152,1286,139,122,213,208,176,212,216
"2011","East Staffordshire 008C","E01029428","Total",1584,163,33,130,1421,131,106,439,300,100,142,203
"2011","East Staffordshire 008D","E01029429","Total",1347,127,38,89,1220,93,106,237,142,121,288,233
"2011","East Staffordshire 009A","E01029445","Total",1932,329,64,265,1603,165,98,348,302,116,245,329
"2011","East Staffordshire 009B","E01029446","Total",1707,232,73,159,1475,90,188,307,316,113,225,236
"2011","East Staffordshire 009C","E01029447","Total",1739,174,34,140,1565,109,42,278,204,210,488,234
"2011","East Staffordshire 009D","E01029448","Total",1628,305,169,136,1323,99,128,232,268,134,253,209
"2011","East Staffordshire 010A","E01029468","Total",1655,241,79,162,1414,191,106,282,200,199,212,224
"2011","East Staffordshire 010B","E01029469","Total",1837,174,104,70,1663,71,316,355,318,137,183,283
"2011","East Staffordshire 010C","E01029470","Total",1562,157,62,95,1405,138,178,340,232,84,205,228
"2011","East Staffordshire 010D","E01029471","Total",1642,188,66,122,1454,38,182,383,298,105,186,262
"2011","East Staffordshire 010E","E01029472","Total",1631,167,78,89,1464,153,208,231,234,110,218,310
"2011","East Staffordshire 011A","E01029407","Total",1454,155,52,103,1299,150,102,210,148,113,296,280
"2011","East Staffordshire 011B","E01029408","Total",2118,238,41,197,1880,163,84,399,336,211,348,339
"2011","East Staffordshire 011C","E01029409","Total",1681,233,54,179,1448,96,86,344,192,163,297,270
"2011","East Staffordshire 011D","E01029410","Total",1514,196,61,135,1318,80,78,277,200,162,273,248
"2011","East Staffordshire 011F","E01032896","Total",1052,272,24,248,780,68,36,166,272,22,49,167
"2011","East Staffordshire 011G","E01032897","Total",1172,234,75,159,938,55,106,290,256,36,67,128
"2011","East Staffordshire 011H","E01032898","Total",1231,297,82,215,934,111,56,154,182,116,162,153
"2011","East Staffordshire 012A","E01029418","Total",2101,147,49,98,1954,44,210,544,404,101,189,462
"2011","East Staffordshire 012B","E01029419","Total",1547,154,66,88,1393,47,208,355,300,51,183,249
"2011","East Staffordshire 012C","E01029420","Total",1691,223,133,90,1468,67,212,389,270,86,151,293
"2011","East Staffordshire 013A","E01029413","Total",1488,208,80,128,1280,72,154,271,256,56,165,306
"2011","East Staffordshire 013B","E01029414","Total",1634,209,55,154,1425,41,110,385,332,110,180,267
"2011","East Staffordshire 013C","E01029415","Total",1622,131,24,107,1491,80,62,520,320,89,228,192
"2011","East Staffordshire 013D","E01029416","Total",1244,142,74,68,1102,43,212,234,196,61,122,234
"2011","East Staffordshire 013E","E01029417","Total",1218,121,76,45,1097,57,218,259,244,58,114,147
"2011","East Staffordshire 014A","E01029449","Total",1602,195,79,116,1407,75,172,287,332,49,130,362
"2011","East Staffordshire 014B","E01029450","Total",1502,199,73,126,1303,122,132,219,174,94,242,320
"2011","East Staffordshire 014C","E01029451","Total",1745,355,151,204,1390,122,198,287,310,119,164,190
"2011","East Staffordshire 014D","E01029452","Total",1574,316,127,189,1258,123,174,259,236,61,147,258
"2011","East Staffordshire 014E","E01029453","Total",1506,279,101,178,1227,163,152,272,204,109,139,188
"2011","East Staffordshire 015A","E01029439","Total",1445,157,95,62,1288,54,272,259,268,45,131,259
"2011","East Staffordshire 015B","E01029440","Total",1293,119,55,64,1174,37,180,331,226,94,113,193
"2011","East Staffordshire 015C","E01029441","Total",1510,200,122,78,1310,66,216,309,258,57,138,266
"2011","East Staffordshire 015D","E01029442","Total",1342,142,92,50,1200,46,214,322,202,67,160,189
"2011","Lichfield 001A","E01029480","Total",1809,172,60,112,1637,64,192,485,340,67,174,315
"2011","Lichfield 001B","E01029481","Total",1789,228,119,109,1561,69,296,333,354,88,112,309
"2011","Lichfield 001C","E01029482","Total",1625,124,65,59,1501,107,220,356,254,88,202,274
"2011","Lichfield 001D","E01029498","Total",1764,131,80,51,1633,33,312,297,302,97,179,413
"2011","Lichfield 002A","E01029477","Total",1547,139,73,66,1408,34,290,372,262,78,138,234
"2011","Lichfield 002B","E01029478","Total",1582,153,104,49,1429,46,272,351,204,125,179,252
"2011","Lichfield 002C","E01029479","Total",2818,163,60,103,2655,105,214,861,520,211,330,414
"2011","Lichfield 002D","E01029509","Total",1623,149,89,60,1474,38,280,285,290,75,194,312
"2011","Lichfield 003A","E01029486","Total",1419,140,76,64,1279,23,288,262,242,20,130,314
"2011","Lichfield 003B","E01029507","Total",1690,77,32,45,1613,10,250,353,310,125,193,372
"2011","Lichfield 003C","E01029508","Total",2313,178,71,107,2135,67,312,609,384,142,224,397
"2011","Lichfield 003D","E01029515","Total",1823,154,97,57,1669,39,426,292,302,48,170,392
"2011","Lichfield 004A","E01029492","Total",2006,170,66,104,1836,278,176,397,212,153,243,377
"2011","Lichfield 004B","E01029499","Total",1758,233,126,107,1525,130,218,241,214,118,265,339
"2011","Lichfield 004C","E01029501","Total",1539,132,82,50,1407,85,238,267,220,110,178,309
"2011","Lichfield 004E","E01029526","Total",1560,441,214,227,1119,54,194,217,280,35,139,200
"2011","Lichfield 004F","E01032899","Total",1437,441,276,165,996,43,264,166,242,36,54,191
"2011","Lichfield 004G","E01032900","Total",2055,176,23,153,1879,150,40,781,412,175,116,205
"2011","Lichfield 005A","E01029483","Total",1553,94,48,46,1459,9,270,276,312,97,158,337
"2011","Lichfield 005B","E01029484","Total",1739,291,106,185,1448,61,246,361,346,49,143,242
"2011","Lichfield 005C","E01029485","Total",1495,152,62,90,1343,38,212,272,340,73,96,312
"2011","Lichfield 005D","E01029500","Total",1740,194,71,123,1546,33,210,290,308,53,206,446
"2011","Lichfield 005E","E01029520","Total",1579,80,49,31,1499,11,256,348,270,108,145,361
"2011","Lichfield 005F","E01029524","Total",1669,206,81,125,1463,71,228,260,308,98,184,314
"2011","Lichfield 005G","E01029525","Total",1747,181,114,67,1566,45,352,288,272,75,146,388
"2011","Lichfield 006A","E01029487","Total",1626,214,123,91,1412,98,204,295,256,121,175,263
"2011","Lichfield 006B","E01029493","Total",1971,184,74,110,1787,68,230,476,380,102,222,309
"2011","Lichfield 006C","E01029494","Total",1499,200,108,92,1299,53,176,326,232,50,175,287
"2011","Lichfield 006D","E01029495","Total",1658,120,61,59,1538,37,206,418,354,77,152,294
"2011","Lichfield 006E","E01029497","Total",1967,271,154,117,1696,79,242,349,304,115,232,375
"2011","Lichfield 007A","E01029491","Total",1774,233,103,130,1541,98,262,328,268,112,142,331
"2011","Lichfield 007B","E01029511","Total",1599,178,98,80,1421,31,270,403,254,69,126,268
"2011","Lichfield 007C","E01029512","Total",1857,191,91,100,1666,84,218,540,318,74,179,253
"2011","Lichfield 007D","E01029518","Total",2706,252,111,141,2454,93,320,733,510,173,242,383
"2011","Lichfield 007E","E01029519","Total",2124,282,103,179,1842,99,230,495,416,109,165,328
"2011","Lichfield 008A","E01029516","Total",1872,132,64,68,1740,38,324,386,328,152,194,318
"2011","Lichfield 008B","E01029517","Total",1648,128,60,68,1520,31,254,308,310,128,121,368
"2011","Lichfield 008C","E01029530","Total",1716,148,63,85,1568,123,192,412,274,100,190,277
"2011","Lichfield 008D","E01029531","Total",1678,123,81,42,1555,43,330,407,242,47,161,325
"2011","Lichfield 009A","E01029475","Total",2007,188,105,83,1819,31,352,456,340,113,157,370
"2011","Lichfield 009B","E01029476","Total",1367,161,94,67,1206,24,278,260,208,21,125,290
"2011","Lichfield 009C","E01029489","Total",1556,138,97,41,1418,43,294,277,232,62,125,385
"2011","Lichfield 009D","E01029490","Total",1458,143,59,84,1315,53,198,309,252,50,149,304
"2011","Lichfield 009E","E01029505","Total",1530,142,81,61,1388,49,280,307,276,58,120,298
"2011","Lichfield 009F","E01029506","Total",1831,131,74,57,1700,13,464,281,266,97,167,412
"2011","Lichfield 010A","E01029496","Total",1837,213,111,102,1624,171,158,326,264,139,263,303
"2011","Lichfield 010B","E01029527","Total",1282,170,92,78,1112,85,140,260,166,113,116,232
"2011","Lichfield 010C","E01029528","Total",1294,125,59,66,1169,69,174,322,170,87,97,250
"2011","Lichfield 010D","E01029529","Total",1281,100,27,73,1181,69,96,373,208,124,110,201
"2011","Lichfield 011A","E01029513","Total",1355,69,35,34,1286,42,254,213,160,73,255,289
"2011","Lichfield 011B","E01029514","Total",1506,132,88,44,1374,30,318,203,208,56,185,374
"2011","Lichfield 011C","E01029521","Total",1686,152,100,52,1534,24,322,328,262,76,194,328
"2011","Lichfield 011D","E01029522","Total",1509,148,73,75,1361,59,220,244,254,58,205,321
"2011","Lichfield 011E","E01029523","Total",1546,114,64,50,1432,56,296,322,230,50,154,324
"2011","Lichfield 012A","E01029488","Total",1696,147,66,81,1549,65,248,324,314,89,201,308
"2011","Lichfield 012B","E01029502","Total",1692,126,71,55,1566,88,196,324,244,155,206,353
"2011","Lichfield 012C","E01029503","Total",1554,136,89,47,1418,77,286,297,238,73,152,295
"2011","Lichfield 012D","E01029504","Total",1532,234,109,125,1298,99,190,263,274,70,112,290
"2011","Newcastle-under-Lyme 001A","E01029562","Total",1353,112,41,71,1241,45,130,379,210,91,136,250
"2011","Newcastle-under-Lyme 001B","E01029565","Total",1260,77,18,59,1183,38,84,313,212,74,119,343
"2011","Newcastle-under-Lyme 001C","E01029581","Total",1577,175,72,103,1402,44,214,411,262,40,113,318
"2011","Newcastle-under-Lyme 001D","E01029582","Total",1829,205,109,96,1624,56,254,368,336,108,161,341
"2011","Newcastle-under-Lyme 001E","E01029586","Total",1223,112,61,51,1111,25,230,243,280,20,59,254
"2011","Newcastle-under-Lyme 001F","E01029587","Total",1244,138,69,69,1106,37,186,317,212,65,66,223
"2011","Newcastle-under-Lyme 002A","E01029561","Total",1472,144,82,62,1328,145,200,293,190,94,152,254
"2011","Newcastle-under-Lyme 002B","E01029563","Total",1391,168,86,82,1223,50,206,258,210,72,143,284
"2011","Newcastle-under-Lyme 002C","E01029564","Total",1346,138,55,83,1208,116,120,242,204,93,191,242
"2011","Newcastle-under-Lyme 002D","E01029588","Total",1532,295,111,184,1237,80,108,276,296,58,132,287
"2011","Newcastle-under-Lyme 003A","E01029540","Total",1396,207,129,78,1189,45,234,247,206,47,106,304
"2011","Newcastle-under-Lyme 003B","E01029541","Total",1573,164,83,81,1409,130,116,297,228,141,238,259
"2011","Newcastle-under-Lyme 003C","E01029542","Total",1335,229,74,155,1106,80,178,240,264,45,72,227
"2011","Newcastle-under-Lyme 003D","E01029543","Total",1234,116,62,54,1118,67,134,177,152,90,249,249
"2011","Newcastle-under-Lyme 003E","E01029595","Total",1232,175,67,108,1057,34,236,212,276,21,55,223
"2011","Newcastle-under-Lyme 003F","E01029597","Total",1481,196,79,117,1285,83,140,307,198,110,231,216
"2011","Newcastle-under-Lyme 004A","E01029536","Total",1517,143,75,68,1374,38,282,304,270,55,179,246
"2011","Newcastle-under-Lyme 004B","E01029544","Total",1338,117,42,75,1221,32,84,245,238,109,179,334
"2011","Newcastle-under-Lyme 004C","E01029545","Total",1559,118,34,84,1441,75,172,389,276,57,167,305
"2011","Newcastle-under-Lyme 004D","E01029546","Total",1434,53,15,38,1381,38,54,374,248,118,187,362
"2011","Newcastle-under-Lyme 004E","E01029596","Total",1152,131,85,46,1021,38,294,122,196,20,112,239
"2011","Newcastle-under-Lyme 005A","E01029532","Total",1465,210,100,110,1255,34,158,296,256,94,163,254
"2011","Newcastle-under-Lyme 005B","E01029533","Total",1526,163,83,80,1363,28,194,275,336,67,191,272
"2011","Newcastle-under-Lyme 005C","E01029534","Total",1518,180,81,99,1338,53,230,285,290,82,116,282
"2011","Newcastle-under-Lyme 005D","E01029535","Total",1414,185,79,106,1229,109,120,269,210,63,204,254
"2011","Newcastle-under-Lyme 005E","E01029556","Total",2477,349,188,161,2128,136,332,466,422,93,205,474
"2011","Newcastle-under-Lyme 006A","E01029537","Total",1571,165,80,85,1406,103,160,310,200,116,203,314
"2011","Newcastle-under-Lyme 006B","E01029538","Total",1598,281,103,178,1317,81,150,331,190,147,170,248
"2011","Newcastle-under-Lyme 006C","E01029539","Total",1565,144,75,69,1421,57,200,397,202,101,193,271
"2011","Newcastle-under-Lyme 006D","E01029552","Total",1463,176,96,80,1287,88,160,299,266,51,120,303
"2011","Newcastle-under-Lyme 006E","E01029558","Total",1667,148,63,85,1519,176,136,388,210,172,202,235
"2011","Newcastle-under-Lyme 007A","E01029547","Total",1407,227,72,155,1180,171,84,315,204,119,125,162
"2011","Newcastle-under-Lyme 007B","E01029548","Total",1475,226,91,135,1249,170,140,270,226,81,132,230
"2011","Newcastle-under-Lyme 007C","E01029559","Total",1428,149,45,104,1279,64,118,326,242,57,168,304
"2011","Newcastle-under-Lyme 007D","E01029560","Total",1566,213,69,144,1353,215,126,247,226,164,129,246
"2011","Newcastle-under-Lyme 007E","E01029568","Total",1464,196,85,111,1268,97,152,248,242,98,163,268
"2011","Newcastle-under-Lyme 008A","E01029583","Total",1431,260,112,148,1171,78,160,269,264,49,152,199
"2011","Newcastle-under-Lyme 008B","E01029584","Total",1181,184,98,86,997,33,140,290,198,70,50,216
"2011","Newcastle-under-Lyme 008C","E01029585","Total",1464,240,74,166,1224,106,144,277,202,42,155,298
"2011","Newcastle-under-Lyme 008D","E01029609","Total",1666,249,92,157,1417,149,140,371,342,54,100,261
"2011","Newcastle-under-Lyme 008E","E01029611","Total",1612,349,117,232,1263,151,124,346,286,75,118,163
"2011","Newcastle-under-Lyme 009A","E01029577","Total",1513,189,76,113,1324,63,220,319,338,46,121,217
"2011","Newcastle-under-Lyme 009B","E01029579","Total",1643,245,119,126,1398,79,216,406,324,40,108,225
"2011","Newcastle-under-Lyme 009C","E01029580","Total",1430,126,55,71,1304,59,154,319,250,77,176,269
"2011","Newcastle-under-Lyme 009D","E01029610","Total",1303,184,76,108,1119,44,130,299,252,55,89,250
"2011","Newcastle-under-Lyme 009E","E01029612","Total",1201,121,56,65,1080,40,172,285,172,73,116,222
"2011","Newcastle-under-Lyme 010A","E01029553","Total",1433,195,73,122,1238,110,160,240,154,112,186,276
"2011","Newcastle-under-Lyme 010B","E01029554","Total",1203,320,115,205,883,80,146,177,170,62,109,139
"2011","Newcastle-under-Lyme 010C","E01029566","Total",1232,139,48,91,1093,224,88,287,138,85,137,134
"2011","Newcastle-under-Lyme 010D","E01029567","Total",1590,244,105,139,1346,75,162,372,276,52,130,279
"2011","Newcastle-under-Lyme 010E","E01029598","Total",1796,203,75,128,1593,167,122,392,276,118,155,363
"2011","Newcastle-under-Lyme 010F","E01029599","Total",1441,332,158,174,1109,63,200,238,200,58,100,250
"2011","Newcastle-under-Lyme 011A","E01029555","Total",1768,248,106,142,1520,110,140,287,286,69,171,457
"2011","Newcastle-under-Lyme 011B","E01029578","Total",1562,393,132,261,1169,47,186,293,222,93,84,244
"2011","Newcastle-under-Lyme 011C","E01029602","Total",1856,392,142,250,1464,85,138,251,474,22,88,406
"2011","Newcastle-under-Lyme 011D","E01029603","Total",1455,327,79,248,1128,66,162,204,266,11,127,292
"2011","Newcastle-under-Lyme 011E","E01029604","Total",1589,546,147,399,1043,85,114,178,286,34,34,312
"2011","Newcastle-under-Lyme 012A","E01029576","Total",1222,192,57,135,1030,43,176,278,152,103,76,202
"2011","Newcastle-under-Lyme 012B","E01029593","Total",1785,247,110,137,1538,119,128,322,236,164,161,408
"2011","Newcastle-under-Lyme 012C","E01029594","Total",1830,305,150,155,1525,106,246,334,326,38,138,337
"2011","Newcastle-under-Lyme 013A","E01029557","Total",1230,154,63,91,1076,20,208,220,250,26,125,227
"2011","Newcastle-under-Lyme 013B","E01029573","Total",1461,194,95,99,1267,41,182,354,258,65,126,241
"2011","Newcastle-under-Lyme 013C","E01029574","Total",1375,189,97,92,1186,37,234,208,216,72,136,283
"2011","Newcastle-under-Lyme 013D","E01029575","Total",1017,122,59,63,895,54,118,198,188,81,72,184
"2011","Newcastle-under-Lyme 014A","E01029549","Total",1684,305,170,135,1379,93,290,266,202,84,117,327
"2011","Newcastle-under-Lyme 014B","E01029551","Total",1610,165,81,84,1445,62,184,463,230,62,141,303
"2011","Newcastle-under-Lyme 014C","E01029591","Total",1511,317,148,169,1194,158,186,221,162,71,121,275
"2011","Newcastle-under-Lyme 014D","E01029600","Total",1419,177,106,71,1242,41,248,302,220,77,101,253
"2011","Newcastle-under-Lyme 014E","E01029605","Total",1264,146,82,64,1118,31,154,299,242,73,108,211
"2011","Newcastle-under-Lyme 014F","E01029607","Total",1416,220,102,118,1196,73,218,256,190,85,123,251
"2011","Newcastle-under-Lyme 015B","E01029589","Total",1209,130,74,56,1079,20,180,222,214,30,88,325
"2011","Newcastle-under-Lyme 015C","E01029590","Total",1353,169,111,58,1184,58,276,180,214,42,100,314
"2011","Newcastle-under-Lyme 015E","E01029601","Total",1484,223,149,74,1261,22,344,259,194,42,135,265
"2011","Newcastle-under-Lyme 015F","E01029606","Total",1499,138,88,50,1361,34,160,396,196,117,156,302
"2011","Newcastle-under-Lyme 015G","E01029608","Total",1480,172,92,80,1308,15,348,265,174,35,140,331
"2011","Newcastle-under-Lyme 015H","E01033257","Total",2494,345,125,220,2149,137,294,540,442,83,212,441
"2011","Newcastle-under-Lyme 016A","E01029569","Total",1407,144,74,70,1263,21,240,231,256,75,165,275
"2011","Newcastle-under-Lyme 016B","E01029570","Total",2468,224,128,96,2244,38,502,463,414,149,225,453
"2011","Newcastle-under-Lyme 016C","E01029571","Total",1375,133,76,57,1242,53,236,233,178,97,132,313
"2011","Newcastle-under-Lyme 016D","E01029572","Total",1664,114,64,50,1550,35,230,331,318,144,213,279
"2011","South Staffordshire 001A","E01029655","Total",1971,274,171,103,1697,87,370,350,278,66,138,408
"2011","South Staffordshire 001B","E01029656","Total",1789,138,70,68,1651,17,322,321,336,77,201,377
"2011","South Staffordshire 001C","E01029657","Total",1789,78,28,50,1711,62,98,516,276,111,214,434
"2011","South Staffordshire 001D","E01029658","Total",1325,161,79,82,1164,66,216,245,186,73,144,234
"2011","South Staffordshire 001E","E01029659","Total",1384,115,76,39,1269,33,254,244,270,97,134,237
"2011","South Staffordshire 001F","E01029660","Total",2036,232,92,140,1804,75,282,363,354,60,197,473
"2011","South Staffordshire 002A","E01029621","Total",1479,145,81,64,1334,58,188,269,224,53,179,363
"2011","South Staffordshire 002B","E01029646","Total",1393,132,45,87,1261,72,138,340,228,76,135,272
"2011","South Staffordshire 002C","E01029647","Total",2205,214,71,143,1991,121,134,599,364,138,285,350
"2011","South Staffordshire 002D","E01029648","Total",1494,116,66,50,1378,106,166,303,242,81,135,345
"2011","South Staffordshire 003A","E01029617","Total",1669,147,91,56,1522,41,308,293,254,93,187,346
"2011","South Staffordshire 003B","E01029618","Total",1540,270,168,102,1270,86,300,234,196,50,106,298
"2011","South Staffordshire 003C","E01029668","Total",1217,115,65,50,1102,31,226,243,242,35,118,207
"2011","South Staffordshire 003D","E01029669","Total",1290,155,103,52,1135,78,204,202,210,57,107,277
"2011","South Staffordshire 003E","E01029670","Total",1573,134,72,62,1439,24,212,349,314,75,128,337
"2011","South Staffordshire 004A","E01029620","Total",1286,101,56,45,1185,70,168,237,192,73,148,297
"2011","South Staffordshire 004B","E01029622","Total",1520,172,82,90,1348,58,212,293,174,57,178,376
"2011","South Staffordshire 004C","E01029623","Total",1196,119,67,52,1077,59,136,193,188,42,183,276
"2011","South Staffordshire 004D","E01029624","Total",1517,84,30,54,1433,43,116,433,240,45,201,355
"2011","South Staffordshire 004E","E01029625","Total",1124,108,68,40,1016,39,244,208,174,56,84,211
"2011","South Staffordshire 004F","E01029641","Total",1681,139,56,83,1542,65,230,304,302,56,175,410
"2011","South Staffordshire 004G","E01029642","Total",1470,143,83,60,1327,50,316,224,198,56,124,359
"2011","South Staffordshire 005A","E01029638","Total",1996,264,166,98,1732,87,332,309,264,57,200,483
"2011","South Staffordshire 005B","E01029639","Total",1424,76,41,35,1348,44,140,280,206,46,217,415
"2011","South Staffordshire 005C","E01029640","Total",1483,91,27,64,1392,88,88,388,280,89,185,274
"2011","South Staffordshire 005D","E01029643","Total",1469,195,116,79,1274,119,214,187,182,98,167,307
"2011","South Staffordshire 005E","E01029644","Total",1448,137,92,45,1311,46,250,165,224,37,210,379
"2011","South Staffordshire 006A","E01029616","Total",1475,201,107,94,1274,36,290,249,280,67,130,222
"2011","South Staffordshire 006B","E01029619","Total",1883,241,152,89,1642,48,350,374,304,46,164,356
"2011","South Staffordshire 006C","E01029636","Total",1440,140,66,74,1300,39,220,248,216,40,213,324
"2011","South Staffordshire 006D","E01029637","Total",1746,133,36,97,1613,31,142,466,300,82,262,330
"2011","South Staffordshire 007A","E01029632","Total",1597,105,58,47,1492,24,202,267,248,64,214,473
"2011","South Staffordshire 007B","E01029633","Total",1727,124,78,46,1603,42,234,376,236,93,197,425
"2011","South Staffordshire 007C","E01029634","Total",1414,155,82,73,1259,105,174,267,196,59,153,305
"2011","South Staffordshire 007D","E01029635","Total",1743,220,86,134,1523,118,148,365,248,98,197,349
"2011","South Staffordshire 008A","E01029613","Total",1377,198,111,87,1179,30,244,266,206,21,124,288
"2011","South Staffordshire 008B","E01029614","Total",1730,178,102,76,1552,103,204,358,242,82,219,344
"2011","South Staffordshire 008C","E01029615","Total",1216,202,103,99,1014,123,184,211,176,69,85,166
"2011","South Staffordshire 008D","E01029627","Total",1384,267,163,104,1117,95,188,239,192,47,82,274
"2011","South Staffordshire 009A","E01029626","Total",1423,179,109,70,1244,46,242,211,184,76,185,300
"2011","South Staffordshire 009B","E01029628","Total",1192,122,85,37,1070,7,252,250,184,60,103,214
"2011","South Staffordshire 009C","E01029629","Total",1218,104,77,27,1114,23,244,254,162,72,121,238
"2011","South Staffordshire 009D","E01029630","Total",1332,137,66,71,1195,21,224,240,178,91,173,268
"2011","South Staffordshire 009E","E01029631","Total",1443,126,60,66,1317,30,188,310,244,67,179,299
"2011","South Staffordshire 010A","E01029654","Total",2246,226,120,106,2020,64,388,494,370,61,187,456
"2011","South Staffordshire 010B","E01029661","Total",1885,179,74,105,1706,77,244,327,338,71,223,426
"2011","South Staffordshire 010C","E01029663","Total",1456,140,53,87,1316,33,138,378,242,88,94,343
"2011","South Staffordshire 010D","E01029665","Total",1810,205,65,140,1605,85,130,402,352,50,177,409
"2011","South Staffordshire 011A","E01029662","Total",2279,124,49,75,2155,70,206,538,330,109,285,617
"2011","South Staffordshire 011B","E01029664","Total",1595,188,58,130,1407,73,128,349,302,46,172,337
"2011","South Staffordshire 011C","E01029666","Total",1552,343,138,205,1209,119,92,278,274,67,166,213
"2011","South Staffordshire 012A","E01029671","Total",1490,198,154,44,1292,44,268,245,210,66,129,330
"2011","South Staffordshire 012B","E01029673","Total",1597,201,110,91,1396,59,258,278,202,91,213,295
"2011","South Staffordshire 012C","E01029676","Total",1057,199,144,55,858,47,214,155,150,25,91,176
"2011","South Staffordshire 012D","E01029679","Total",1442,192,67,125,1250,120,156,274,222,74,155,249
"2011","South Staffordshire 012E","E01029680","Total",1529,167,94,73,1362,72,204,255,188,88,176,379
"2011","South Staffordshire 013A","E01029645","Total",1913,239,119,120,1674,48,468,229,326,84,155,364
"2011","South Staffordshire 013B","E01029667","Total",2184,212,90,122,1972,35,394,370,288,109,288,488
"2011","South Staffordshire 013C","E01029672","Total",1556,136,88,48,1420,15,230,300,268,78,194,335
"2011","South Staffordshire 013D","E01029674","Total",1849,124,73,51,1725,33,216,466,234,109,235,432
"2011","South Staffordshire 013E","E01029675","Total",1476,219,158,61,1257,17,338,248,160,26,125,343
"2011","South Staffordshire 013F","E01029677","Total",1314,142,83,59,1172,48,238,229,180,68,120,289
"2011","South Staffordshire 013G","E01029678","Total",1752,122,44,78,1630,44,164,453,312,85,119,453
"2011","South Staffordshire 014A","E01029649","Total",1158,244,142,102,914,55,226,187,194,10,58,184
"2011","South Staffordshire 014B","E01029650","Total",1503,172,85,87,1331,34,300,234,242,57,162,302
"2011","South Staffordshire 014C","E01029651","Total",1440,140,86,54,1300,46,300,294,240,41,108,271
"2011","South Staffordshire 014D","E01029652","Total",1701,111,61,50,1590,25,326,247,268,67,238,419
"2011","South Staffordshire 014E","E01029653","Total",1265,129,74,55,1136,79,176,275,186,58,166,196
"2011","Stafford 001A","E01029702","Total",1475,204,112,92,1271,69,246,261,242,64,123,266
"2011","Stafford 001B","E01029703","Total",1517,159,57,102,1358,28,186,345,250,91,162,296
"2011","Stafford 001C","E01029704","Total",1386,144,87,57,1242,32,292,235,218,85,137,243
"2011","Stafford 001D","E01029705","Total",1466,145,103,42,1321,44,340,224,220,62,148,283
"2011","Stafford 002A","E01029681","Total",1207,138,62,76,1069,40,122,234,204,145,118,206
"2011","Stafford 002B","E01029682","Total",1559,198,128,70,1361,22,350,269,260,72,119,269
"2011","Stafford 002C","E01029683","Total",1284,149,84,65,1135,39,222,213,222,84,184,171
"2011","Stafford 002D","E01029748","Total",1358,137,73,64,1221,36,234,270,258,35,127,261
"2011","Stafford 002E","E01029749","Total",1627,221,126,95,1406,64,292,290,310,80,128,242
"2011","Stafford 003A","E01029740","Total",1675,211,113,98,1464,131,190,325,226,144,189,259
"2011","Stafford 003B","E01029744","Total",2260,302,88,214,1958,81,176,673,458,120,176,274
"2011","Stafford 003C","E01029745","Total",1677,437,204,233,1240,70,254,294,274,56,114,178
"2011","Stafford 003D","E01029746","Total",1526,209,93,116,1317,93,206,345,216,50,142,265
"2011","Stafford 003E","E01029753","Total",1305,260,139,121,1045,44,246,243,200,57,67,188
"2011","Stafford 003F","E01029756","Total",1687,274,69,205,1413,106,106,373,314,113,190,211
"2011","Stafford 004A","E01029733","Total",1877,165,92,73,1712,38,282,412,346,89,188,357
"2011","Stafford 004B","E01029739","Total",1610,86,37,49,1524,44,182,457,252,56,154,379
"2011","Stafford 004C","E01029741","Total",1705,161,49,112,1544,100,114,489,318,112,133,278
"2011","Stafford 004D","E01029754","Total",1330,135,59,76,1195,28,200,334,242,57,84,250
"2011","Stafford 004E","E01029755","Total",1406,178,108,70,1228,8,324,251,268,42,123,212
"2011","Stafford 005A","E01029695","Total",1948,315,153,162,1633,57,362,332,338,75,169,300
"2011","Stafford 005B","E01029696","Total",1505,157,82,75,1348,33,236,270,294,70,150,295
"2011","Stafford 005C","E01029697","Total",1350,127,56,71,1223,16,188,248,204,100,176,291
"2011","Stafford 005D","E01029698","Total",1533,188,102,86,1345,63,272,251,284,72,135,268
"2011","Stafford 005E","E01029747","Total",1453,137,48,89,1316,45,174,284,270,69,169,305
"2011","Stafford 006A","E01029690","Total",1550,154,55,99,1396,75,176,379,260,71,173,262
"2011","Stafford 006B","E01029718","Total",1962,184,99,85,1778,38,308,410,312,108,195,407
"2011","Stafford 006C","E01029743","Total",1389,139,81,58,1250,32,328,203,276,64,119,228
"2011","Stafford 006D","E01029751","Total",1563,225,124,101,1338,59,338,207,226,63,165,280
"2011","Stafford 007A","E01029719","Total",1559,248,167,81,1311,42,288,238,264,97,116,266
"2011","Stafford 007B","E01029720","Total",1630,183,60,123,1447,207,112,389,238,79,203,219
"2011","Stafford 007C","E01029721","Total",1550,155,68,87,1395,53,170,356,276,71,163,306
"2011","Stafford 007D","E01029750","Total",1558,194,78,116,1364,159,138,344,272,123,108,220
"2011","Stafford 007E","E01029752","Total",1288,141,48,93,1147,138,112,318,158,111,122,188
"2011","Stafford 008A","E01029687","Total",1870,185,96,89,1685,40,368,358,396,46,182,295
"2011","Stafford 008B","E01029710","Total",1434,142,79,63,1292,38,286,286,316,41,70,255
"2011","Stafford 008C","E01029711","Total",1471,120,54,66,1351,46,200,365,324,63,122,231
"2011","Stafford 008D","E01029712","Total",1870,193,96,97,1677,74,214,424,346,99,208,312
"2011","Stafford 008E","E01029713","Total",1580,200,110,90,1380,79,242,330,260,77,127,265
"2011","Stafford 009A","E01029692","Total",1592,221,100,121,1371,144,148,330,194,97,173,285
"2011","Stafford 009B","E01029693","Total",1696,371,20,351,1325,87,32,466,268,63,113,296
"2011","Stafford 009C","E01029722","Total",1646,213,86,127,1433,88,116,321,266,37,156,449
"2011","Stafford 009D","E01029725","Total",1458,326,139,187,1132,30,114,228,206,88,72,394
"2011","Stafford 010A","E01029689","Total",1616,367,58,309,1249,78,82,315,392,20,38,324
"2011","Stafford 010B","E01029691","Total",1197,375,142,233,822,58,106,190,284,10,25,149
"2011","Stafford 010C","E01029694","Total",1445,193,30,163,1252,34,52,351,320,72,120,303
"2011","Stafford 010D","E01029699","Total",1915,413,172,241,1502,116,122,369,392,61,137,305
"2011","Stafford 010E","E01029701","Total",1933,609,139,470,1324,131,106,277,500,57,48,205
"2011","Stafford 011A","E01029686","Total",1421,157,100,57,1264,37,246,356,222,55,123,225
"2011","Stafford 011B","E01029700","Total",1274,130,42,88,1144,60,114,290,268,37,111,264
"2011","Stafford 011C","E01029723","Total",1586,173,64,109,1413,41,260,336,274,64,117,321
"2011","Stafford 011D","E01029724","Total",1702,152,70,82,1550,61,198,341,258,57,203,432
"2011","Stafford 011E","E01029732","Total",1482,121,49,72,1361,71,196,252,314,122,131,275
"2011","Stafford 012A","E01029714","Total",1589,129,49,80,1460,43,156,416,334,68,104,339
"2011","Stafford 012B","E01029736","Total",1490,115,34,81,1375,43,128,423,332,31,156,262
"2011","Stafford 012C","E01029737","Total",1533,210,93,117,1323,65,220,259,216,80,173,310
"2011","Stafford 012D","E01029738","Total",1363,145,62,83,1218,40,198,316,270,68,124,202
"2011","Stafford 012E","E01029742","Total",1982,194,114,80,1788,31,440,343,386,105,146,337
"2011","Stafford 013A","E01029715","Total",1631,293,93,200,1338,152,90,361,348,51,120,216
"2011","Stafford 013B","E01029716","Total",1592,219,102,117,1373,140,190,257,196,121,183,286
"2011","Stafford 013C","E01029717","Total",1779,240,76,164,1539,263,152,312,274,125,193,220
"2011","Stafford 013D","E01029727","Total",1552,267,92,175,1285,148,152,249,176,111,206,243
"2011","Stafford 013E","E01029728","Total",1429,177,106,71,1252,81,198,352,206,56,121,238
"2011","Stafford 014A","E01029684","Total",1488,136,78,58,1352,26,238,389,190,68,146,295
"2011","Stafford 014B","E01029685","Total",1568,142,108,34,1426,39,314,308,194,88,195,288
"2011","Stafford 014C","E01029730","Total",1082,76,47,29,1006,32,260,224,158,45,65,222
"2011","Stafford 014D","E01029731","Total",1637,114,69,45,1523,68,268,459,184,82,146,316
"2011","Stafford 014E","E01029757","Total",1604,147,72,75,1457,87,166,428,246,88,166,276
"2011","Stafford 014F","E01029758","Total",1535,135,84,51,1400,44,340,330,250,63,136,237
"2011","Stafford 014G","E01029759","Total",1715,166,103,63,1549,63,278,408,288,42,123,347
"2011","Stafford 014H","E01029760","Total",1570,158,118,40,1412,22,390,299,178,94,167,262
"2011","Stafford 015A","E01029688","Total",2224,208,108,100,2016,50,402,445,360,168,227,364
"2011","Stafford 015B","E01029706","Total",1547,142,75,67,1405,25,252,301,336,87,115,289
"2011","Stafford 015C","E01029707","Total",1446,234,124,110,1212,90,222,292,230,77,101,200
"2011","Stafford 015D","E01029708","Total",1907,152,77,75,1755,55,286,380,356,82,211,385
"2011","Stafford 015E","E01029709","Total",1483,153,74,79,1330,47,208,239,258,71,151,356
"2011","Stafford 016A","E01029726","Total",1709,165,94,71,1544,67,264,291,266,168,169,319
"2011","Stafford 016B","E01029729","Total",1604,428,132,296,1176,79,164,281,312,69,104,167
"2011","Stafford 016C","E01029734","Total",2242,331,102,229,1911,296,136,515,270,178,269,247
"2011","Stafford 016D","E01029735","Total",2345,239,87,152,2106,111,236,535,384,125,261,454
"2011","Staffordshire Moorlands 001A","E01029797","Total",1536,144,62,82,1392,18,182,234,310,91,230,327
"2011","Staffordshire Moorlands 001B","E01029806","Total",1465,200,117,83,1265,53,268,250,284,61,102,247
"2011","Staffordshire Moorlands 001C","E01029808","Total",1418,231,98,133,1187,117,214,273,212,39,109,223
"2011","Staffordshire Moorlands 001D","E01029809","Total",1458,181,87,94,1277,103,190,272,180,69,180,283
"2011","Staffordshire Moorlands 001E","E01029810","Total",1337,153,66,87,1184,99,130,251,204,176,131,193
"2011","Staffordshire Moorlands 002A","E01029767","Total",1640,189,106,83,1451,19,272,297,330,60,130,343
"2011","Staffordshire Moorlands 002B","E01029769","Total",1664,181,111,70,1483,31,404,199,328,77,113,331
"2011","Staffordshire Moorlands 002C","E01029770","Total",1925,206,107,99,1719,49,282,444,382,55,110,397
"2011","Staffordshire Moorlands 002D","E01029802","Total",1760,166,80,86,1594,34,266,301,344,66,191,392
"2011","Staffordshire Moorlands 003A","E01029763","Total",1580,217,90,127,1363,178,146,304,194,117,201,223
"2011","Staffordshire Moorlands 003B","E01029764","Total",1814,114,31,83,1700,148,70,597,234,147,210,294
"2011","Staffordshire Moorlands 003C","E01029765","Total",1390,143,76,67,1247,81,138,293,160,110,218,247
"2011","Staffordshire Moorlands 003D","E01029766","Total",1506,192,100,92,1314,84,134,270,214,104,215,293
"2011","Staffordshire Moorlands 003E","E01029774","Total",1974,325,101,224,1649,168,210,386,360,103,182,240
"2011","Staffordshire Moorlands 004A","E01029768","Total",1374,172,94,78,1202,28,290,199,236,73,95,281
"2011","Staffordshire Moorlands 004B","E01029771","Total",1592,192,128,64,1400,32,410,269,250,68,104,267
"2011","Staffordshire Moorlands 004C","E01029772","Total",1750,210,95,115,1540,53,262,345,326,56,157,341
"2011","Staffordshire Moorlands 004D","E01029773","Total",1530,157,92,65,1373,50,278,273,278,63,157,274
"2011","Staffordshire Moorlands 005A","E01029804","Total",1763,432,94,338,1331,177,118,291,342,52,115,236
"2011","Staffordshire Moorlands 005B","E01029807","Total",1075,238,103,135,837,45,136,230,200,21,93,112
"2011","Staffordshire Moorlands 005C","E01029811","Total",1519,191,90,101,1328,101,188,329,252,83,120,255
"2011","Staffordshire Moorlands 005D","E01029812","Total",1986,438,125,313,1548,161,142,435,362,123,105,220
"2011","Staffordshire Moorlands 005E","E01029814","Total",1685,289,77,212,1396,100,154,381,322,77,125,237
"2011","Staffordshire Moorlands 006A","E01029792","Total",2334,286,96,190,2048,50,268,516,472,159,305,278
"2011","Staffordshire Moorlands 006B","E01029793","Total",1625,178,86,92,1447,71,240,357,248,90,156,285
"2011","Staffordshire Moorlands 006C","E01029805","Total",1655,235,131,104,1420,50,238,363,238,77,150,304
"2011","Staffordshire Moorlands 006D","E01029813","Total",2165,213,101,112,1952,69,306,529,372,132,201,343
"2011","Staffordshire Moorlands 006E","E01029815","Total",1497,190,111,79,1307,41,278,289,254,30,132,283
"2011","Staffordshire Moorlands 006F","E01029816","Total",1436,151,97,54,1285,21,224,298,238,60,166,278
"2011","Staffordshire Moorlands 007A","E01029801","Total",1798,197,103,94,1601,41,292,383,338,70,170,307
"2011","Staffordshire Moorlands 007B","E01029803","Total",1795,218,97,121,1577,31,282,282,324,41,246,371
"2011","Staffordshire Moorlands 007C","E01029817","Total",1835,272,117,155,1563,29,240,310,340,85,145,414
"2011","Staffordshire Moorlands 008A","E01029762","Total",1591,159,95,64,1432,44,278,289,250,70,187,314
"2011","Staffordshire Moorlands 008B","E01029775","Total",1531,156,106,50,1375,40,362,238,242,65,131,297
"2011","Staffordshire Moorlands 008C","E01029776","Total",1800,159,107,52,1641,34,390,333,222,107,171,384
"2011","Staffordshire Moorlands 008D","E01029777","Total",1500,168,108,60,1332,63,222,328,218,89,140,272
"2011","Staffordshire Moorlands 009A","E01029779","Total",1616,198,152,46,1418,32,356,298,254,62,100,316
"2011","Staffordshire Moorlands 009B","E01029780","Total",1517,159,82,77,1358,89,254,328,226,84,108,269
"2011","Staffordshire Moorlands 009C","E01029794","Total",1392,143,79,64,1249,35,234,212,236,70,166,296
"2011","Staffordshire Moorlands 009D","E01029818","Total",1486,122,55,67,1364,55,180,336,324,52,115,302
"2011","Staffordshire Moorlands 009E","E01029819","Total",1667,197,124,73,1470,41,278,283,286,46,151,385
"2011","Staffordshire Moorlands 010A","E01029761","Total",1344,173,93,80,1171,39,262,240,208,36,132,254
"2011","Staffordshire Moorlands 010B","E01029782","Total",1945,272,126,146,1673,122,210,395,292,140,189,325
"2011","Staffordshire Moorlands 010C","E01029795","Total",1659,255,111,144,1404,42,258,289,324,62,181,248
"2011","Staffordshire Moorlands 010D","E01029796","Total",1478,187,93,94,1291,49,196,253,252,85,146,310
"2011","Staffordshire Moorlands 011A","E01029781","Total",1524,175,81,94,1349,72,232,285,248,52,146,314
"2011","Staffordshire Moorlands 011B","E01029783","Total",1412,231,134,97,1181,103,194,234,198,92,136,224
"2011","Staffordshire Moorlands 011C","E01029786","Total",1435,115,52,63,1320,46,190,289,294,36,167,298
"2011","Staffordshire Moorlands 011D","E01029787","Total",1634,304,141,163,1330,88,232,264,236,63,141,306
"2011","Staffordshire Moorlands 012A","E01029778","Total",1681,164,84,80,1517,51,264,263,286,66,177,410
"2011","Staffordshire Moorlands 012B","E01029789","Total",1026,127,78,49,899,23,142,164,202,75,107,186
"2011","Staffordshire Moorlands 012C","E01029798","Total",1688,208,98,110,1480,100,242,343,266,59,101,369
"2011","Staffordshire Moorlands 012D","E01029799","Total",1841,198,107,91,1643,59,350,329,322,57,161,365
"2011","Staffordshire Moorlands 012E","E01029800","Total",1547,174,98,76,1373,29,214,346,288,82,112,302
"2011","Staffordshire Moorlands 013A","E01029784","Total",2170,202,110,92,1968,54,362,456,352,119,225,400
"2011","Staffordshire Moorlands 013B","E01029785","Total",1809,149,76,73,1660,42,252,446,306,89,184,341
"2011","Staffordshire Moorlands 013C","E01029788","Total",1356,106,42,64,1250,11,202,303,238,53,151,292
"2011","Staffordshire Moorlands 013D","E01029790","Total",1941,183,88,95,1758,84,232,423,300,147,190,382
"2011","Staffordshire Moorlands 013E","E01029791","Total",1389,162,48,114,1227,60,190,268,266,45,113,285
"2011","Tamworth 001A","E01029846","Total",1267,104,63,41,1163,54,216,244,210,57,129,253
"2011","Tamworth 001B","E01029847","Total",1295,101,51,50,1194,35,190,241,238,21,127,342
"2011","Tamworth 001C","E01029848","Total",1231,108,64,44,1123,30,226,244,222,62,109,230
"2011","Tamworth 001D","E01029852","Total",1743,229,138,91,1514,133,264,295,238,154,132,298
"2011","Tamworth 001E","E01029853","Total",1598,190,99,91,1408,113,214,275,230,88,222,266
"2011","Tamworth 001F","E01029854","Total",1513,130,98,32,1383,29,312,270,266,47,126,333
"2011","Tamworth 002A","E01029835","Total",1633,641,342,299,992,68,256,137,282,21,69,159
"2011","Tamworth 002B","E01029836","Total",1263,196,65,131,1067,87,136,311,250,46,52,185
"2011","Tamworth 002C","E01029849","Total",1470,239,125,114,1231,204,182,285,192,41,153,174
"2011","Tamworth 002D","E01029850","Total",1310,199,94,105,1111,95,138,250,174,93,168,193
"2011","Tamworth 002E","E01029851","Total",2120,341,161,180,1779,122,220,396,452,81,195,313
"2011","Tamworth 003A","E01029820","Total",1558,117,35,82,1441,99,138,309,234,135,196,330
"2011","Tamworth 003B","E01029821","Total",1456,183,79,104,1273,50,214,235,296,72,120,286
"2011","Tamworth 003C","E01029822","Total",1576,59,10,49,1517,63,62,510,208,90,284,300
"2011","Tamworth 003D","E01029824","Total",1832,225,61,164,1607,226,84,290,220,154,304,329
"2011","Tamworth 003E","E01029841","Total",1451,149,62,87,1302,46,180,248,294,78,154,302
"2011","Tamworth 004A","E01029823","Total",1483,170,102,68,1313,46,298,291,240,31,124,283
"2011","Tamworth 004B","E01029831","Total",1494,189,75,114,1305,94,166,306,214,90,154,281
"2011","Tamworth 004C","E01029832","Total",1628,193,135,58,1435,75,254,315,232,63,183,313
"2011","Tamworth 004D","E01029834","Total",1541,214,115,99,1327,128,206,287,216,89,146,255
"2011","Tamworth 004E","E01029844","Total",1244,94,37,57,1150,57,124,313,250,58,92,256
"2011","Tamworth 005A","E01029833","Total",1693,149,33,116,1544,91,100,442,382,102,150,277
"2011","Tamworth 005B","E01029837","Total",1591,236,65,171,1355,84,128,412,270,68,148,245
"2011","Tamworth 005C","E01029838","Total",1568,222,68,154,1346,79,146,387,344,20,137,233
"2011","Tamworth 005D","E01029839","Total",1235,51,14,37,1184,42,76,415,242,50,97,262
"2011","Tamworth 006A","E01029825","Total",1338,101,37,64,1237,56,96,283,236,57,189,320
"2011","Tamworth 006B","E01029826","Total",1546,137,69,68,1409,78,248,283,262,80,145,313
"2011","Tamworth 006C","E01029827","Total",1395,143,76,67,1252,142,88,272,164,139,181,266
"2011","Tamworth 006D","E01029828","Total",1328,117,27,90,1211,129,72,230,150,186,217,227
"2011","Tamworth 006E","E01029830","Total",1164,186,62,124,978,114,112,232,220,41,81,178
"2011","Tamworth 007A","E01029840","Total",1360,83,23,60,1277,193,66,202,158,216,229,213
"2011","Tamworth 007B","E01029842","Total",1354,134,28,106,1220,183,58,286,176,125,188,204
"2011","Tamworth 007C","E01029843","Total",1497,115,40,75,1382,125,102,292,194,189,217,263
"2011","Tamworth 007D","E01029845","Total",1113,183,84,99,930,126,74,167,104,161,162,136
"2011","Tamworth 007E","E01029859","Total",1834,225,61,164,1609,295,80,387,222,146,210,269
"2011","Tamworth 008A","E01029855","Total",1543,74,23,51,1469,112,96,352,254,102,259,294
"2011","Tamworth 008B","E01029856","Total",1465,133,35,98,1332,54,80,332,330,90,125,321
"2011","Tamworth 008C","E01029857","Total",1418,138,40,98,1280,129,78,240,260,166,157,250
"2011","Tamworth 008D","E01029858","Total",1590,143,34,109,1447,42,110,407,326,65,198,299
"2011","Tamworth 008E","E01029865","Total",1676,88,21,67,1588,50,88,367,310,114,205,454
"2011","Tamworth 009A","E01029860","Total",1329,105,45,60,1224,24,172,316,222,63,114,313
"2011","Tamworth 009B","E01029861","Total",1348,175,129,46,1173,56,230,260,182,39,128,278
"2011","Tamworth 009C","E01029862","Total",1340,67,22,45,1273,44,70,407,230,57,153,312
"2011","Tamworth 009D","E01029863","Total",1753,193,75,118,1560,56,216,438,360,72,146,272
"2011","Tamworth 009E","E01029864","Total",1605,117,37,80,1488,42,204,362,316,93,102,369
"2011","Tamworth 010A","E01029829","Total",1995,147,39,108,1848,171,134,510,410,132,202,289
"2011","Tamworth 010C","E01029867","Total",1675,171,74,97,1504,154,156,334,260,106,171,323
"2011","Tamworth 010D","E01029868","Total",1430,57,15,42,1373,24,80,334,250,92,225,368
"2011","Tamworth 010E","E01029869","Total",1618,166,76,90,1452,95,160,378,238,109,133,339
"2011","Tamworth 010F","E01032901","Total",1607,141,20,121,1466,127,62,501,316,146,133,181
"2011","Tamworth 010G","E01032902","Total",1332,178,51,127,1154,80,132,295,270,46,100,231
"2011","North Warwickshire 001A","E01031035","Total",1900,150,73,77,1750,86,240,384,300,114,191,435
"2011","North Warwickshire 001B","E01031036","Total",1527,127,74,53,1400,54,214,325,290,93,130,294
"2011","North Warwickshire 001C","E01031037","Total",1490,187,97,90,1303,69,232,290,216,84,163,249
"2011","North Warwickshire 001D","E01031038","Total",2002,133,83,50,1869,78,232,437,294,205,243,380
"2011","North Warwickshire 001E","E01031039","Total",1692,101,50,51,1591,41,266,362,278,88,223,333
"2011","North Warwickshire 001F","E01031040","Total",1773,201,73,128,1572,103,164,403,328,70,119,385
"2011","North Warwickshire 002A","E01031016","Total",1571,184,107,77,1387,109,232,240,266,86,153,301
"2011","North Warwickshire 002B","E01031025","Total",1553,206,100,106,1347,74,210,303,282,68,127,283
"2011","North Warwickshire 002C","E01031026","Total",1614,111,42,69,1503,104,122,357,216,131,204,369
"2011","North Warwickshire 002D","E01031031","Total",2583,238,92,146,2345,157,260,611,410,164,334,409
"2011","North Warwickshire 002E","E01031032","Total",1339,121,67,54,1218,56,150,281,194,91,149,297
"2011","North Warwickshire 003A","E01031009","Total",2184,287,103,184,1897,121,226,447,454,120,110,419
"2011","North Warwickshire 003B","E01031010","Total",1722,378,101,277,1344,152,66,381,316,124,140,165
"2011","North Warwickshire 003C","E01031011","Total",1955,167,93,74,1788,70,276,454,310,71,200,407
"2011","North Warwickshire 003D","E01031012","Total",1418,197,116,81,1221,72,228,235,202,77,194,213
"2011","North Warwickshire 003E","E01031013","Total",1043,151,88,63,892,24,196,163,176,35,77,221
"2011","North Warwickshire 003F","E01031014","Total",1204,112,68,44,1092,33,192,212,234,52,152,217
"2011","North Warwickshire 003G","E01031015","Total",1403,188,89,99,1215,102,146,264,194,123,165,221
"2011","North Warwickshire 004A","E01031023","Total",1578,128,59,69,1450,22,306,312,208,63,170,369
"2011","North Warwickshire 004B","E01031024","Total",1617,147,81,66,1470,28,244,269,330,41,209,349
"2011","North Warwickshire 004C","E01031033","Total",1851,204,105,99,1647,90,308,265,258,82,266,378
"2011","North Warwickshire 004D","E01031034","Total",1879,157,69,88,1722,53,204,377,408,93,208,379
"2011","North Warwickshire 005A","E01031005","Total",1429,151,77,74,1278,97,148,326,198,56,199,254
"2011","North Warwickshire 005B","E01031008","Total",1353,180,66,114,1173,117,98,249,228,81,175,225
"2011","North Warwickshire 005C","E01031017","Total",1283,112,43,69,1171,21,192,296,224,62,134,242
"2011","North Warwickshire 005D","E01031018","Total",1093,128,55,73,965,39,148,202,176,67,116,217
"2011","North Warwickshire 005E","E01031029","Total",1460,118,50,68,1342,75,154,349,246,99,140,279
"2011","North Warwickshire 005F","E01031030","Total",2227,309,127,182,1918,136,256,404,396,108,220,398
"2011","North Warwickshire 006A","E01031019","Total",1709,135,63,72,1574,84,166,415,288,76,219,326
"2011","North Warwickshire 006B","E01031020","Total",1524,220,92,128,1304,65,208,308,286,62,110,265
"2011","North Warwickshire 006C","E01031021","Total",1540,321,152,169,1219,84,218,265,260,15,85,292
"2011","North Warwickshire 006D","E01031022","Total",1596,217,111,106,1379,37,220,273,224,67,195,363
"2011","North Warwickshire 006E","E01031041","Total",1677,220,89,131,1457,35,184,319,294,57,231,337
"2011","North Warwickshire 006F","E01031042","Total",1733,189,103,86,1544,74,224,331,256,48,197,414
"2011","North Warwickshire 007A","E01031006","Total",1471,189,69,120,1282,106,134,365,250,85,104,238
"2011","North Warwickshire 007B","E01031007","Total",1218,106,55,51,1112,24,148,265,236,77,128,234
"2011","North Warwickshire 007C","E01031027","Total",1402,130,62,68,1272,32,238,275,222,35,170,300
"2011","North Warwickshire 007D","E01031028","Total",1855,176,76,100,1679,54,258,354,332,88,232,361
"2011","Nuneaton and Bedworth 001A","E01031110","Total",1506,188,115,73,1318,30,276,238,220,93,194,267
"2011","Nuneaton and Bedworth 001B","E01031111","Total",1122,61,34,27,1061,17,144,177,162,48,197,316
"2011","Nuneaton and Bedworth 001C","E01031112","Total",1623,156,95,61,1467,103,248,381,206,75,168,286
"2011","Nuneaton and Bedworth 001D","E01031113","Total",1462,136,78,58,1326,34,268,321,214,63,135,291
"2011","Nuneaton and Bedworth 001E","E01031114","Total",1507,317,168,149,1190,66,158,249,274,42,144,257
"2011","Nuneaton and Bedworth 002C","E01031073","Total",1884,238,126,112,1646,118,232,396,326,115,160,299
"2011","Nuneaton and Bedworth 002D","E01031074","Total",1550,269,85,184,1281,107,158,336,254,94,126,206
"2011","Nuneaton and Bedworth 002E","E01031075","Total",1646,217,78,139,1429,190,118,323,274,95,176,253
"2011","Nuneaton and Bedworth 002F","E01032890","Total",2195,177,67,110,2018,310,126,374,296,260,308,344
"2011","Nuneaton and Bedworth 003A","E01031100","Total",1357,80,33,47,1277,38,110,290,244,52,197,346
"2011","Nuneaton and Bedworth 003B","E01031101","Total",1442,71,40,31,1371,20,138,324,212,89,237,351
"2011","Nuneaton and Bedworth 003C","E01031102","Total",1319,170,50,120,1149,76,134,285,274,86,80,214
"2011","Nuneaton and Bedworth 003D","E01031103","Total",1305,72,46,26,1233,17,190,272,202,75,187,290
"2011","Nuneaton and Bedworth 003E","E01031104","Total",1440,167,137,30,1273,15,390,205,188,41,131,303
"2011","Nuneaton and Bedworth 004A","E01031081","Total",1693,147,41,106,1546,136,104,418,272,154,236,226
"2011","Nuneaton and Bedworth 004B","E01031082","Total",1386,84,20,64,1302,61,54,338,226,94,182,347
"2011","Nuneaton and Bedworth 004C","E01031083","Total",1552,141,52,89,1411,84,194,397,230,62,198,246
"2011","Nuneaton and Bedworth 004D","E01031084","Total",2227,189,37,152,2038,139,116,605,402,155,220,401
"2011","Nuneaton and Bedworth 004E","E01031085","Total",1375,72,19,53,1303,46,126,340,280,64,109,338
"2011","Nuneaton and Bedworth 005A","E01031043","Total",1644,512,139,373,1132,93,124,202,280,68,202,163
"2011","Nuneaton and Bedworth 005B","E01031044","Total",1664,256,80,176,1408,160,104,410,276,67,150,241
"2011","Nuneaton and Bedworth 005C","E01031045","Total",1693,262,109,153,1431,86,178,322,300,98,185,262
"2011","Nuneaton and Bedworth 005D","E01031046","Total",1728,238,58,180,1490,127,58,368,244,92,236,365
"2011","Nuneaton and Bedworth 005E","E01031047","Total",1934,332,80,252,1602,106,98,370,312,195,272,249
"2011","Nuneaton and Bedworth 006A","E01031057","Total",1566,274,103,171,1292,210,92,328,154,144,132,232
"2011","Nuneaton and Bedworth 006B","E01031058","Total",1453,157,60,97,1296,157,190,236,252,62,112,287
"2011","Nuneaton and Bedworth 006C","E01031059","Total",1470,195,76,119,1275,100,140,315,242,83,123,272
"2011","Nuneaton and Bedworth 006D","E01031060","Total",1442,196,94,102,1246,85,202,238,224,84,136,277
"2011","Nuneaton and Bedworth 006E","E01031061","Total",1521,142,47,95,1379,81,80,400,272,87,169,290
"2011","Nuneaton and Bedworth 007A","E01031090","Total",1447,212,57,155,1235,164,92,239,228,180,125,207
"2011","Nuneaton and Bedworth 007B","E01031091","Total",1450,147,71,76,1303,68,212,329,222,104,137,231
"2011","Nuneaton and Bedworth 007C","E01031092","Total",1466,189,72,117,1277,150,138,298,230,132,123,206
"2011","Nuneaton and Bedworth 007D","E01031093","Total",1348,109,49,60,1239,52,174,262,230,57,190,274
"2011","Nuneaton and Bedworth 007E","E01031094","Total",1162,155,45,110,1007,80,108,300,186,100,97,136
"2011","Nuneaton and Bedworth 008A","E01031048","Total",1265,113,41,72,1152,50,102,299,242,68,110,281
"2011","Nuneaton and Bedworth 008B","E01031049","Total",2209,254,107,147,1955,111,190,531,418,123,265,317
"2011","Nuneaton and Bedworth 008C","E01031050","Total",1824,210,47,163,1614,128,124,442,380,83,154,303
"2011","Nuneaton and Bedworth 008D","E01031051","Total",1368,149,90,59,1219,53,200,224,248,88,120,286
"2011","Nuneaton and Bedworth 009A","E01031115","Total",1755,237,100,137,1518,83,134,286,244,143,287,341
"2011","Nuneaton and Bedworth 009B","E01031116","Total",1679,246,106,140,1433,246,156,298,194,116,186,237
"2011","Nuneaton and Bedworth 009C","E01031117","Total",1472,155,79,76,1317,144,140,277,210,127,197,222
"2011","Nuneaton and Bedworth 009D","E01031118","Total",1202,122,69,53,1080,130,116,198,186,84,163,203
"2011","Nuneaton and Bedworth 009E","E01031119","Total",1613,312,113,199,1301,92,132,264,218,149,224,222
"2011","Nuneaton and Bedworth 010A","E01031052","Total",1512,192,60,132,1320,156,68,362,280,93,152,209
"2011","Nuneaton and Bedworth 010B","E01031053","Total",1338,353,173,180,985,52,182,221,192,54,96,188
"2011","Nuneaton and Bedworth 010C","E01031054","Total",1561,168,82,86,1393,125,186,307,256,84,124,311
"2011","Nuneaton and Bedworth 010D","E01031055","Total",1654,158,27,131,1496,127,82,559,302,80,145,201
"2011","Nuneaton and Bedworth 010E","E01031056","Total",1500,154,66,88,1346,112,204,287,238,64,184,257
"2011","Nuneaton and Bedworth 011A","E01031120","Total",1395,144,53,91,1251,40,158,299,258,53,147,296
"2011","Nuneaton and Bedworth 011B","E01031121","Total",1202,59,27,32,1143,22,176,234,196,45,141,329
"2011","Nuneaton and Bedworth 011C","E01031122","Total",1482,134,88,46,1348,31,246,292,254,31,130,364
"2011","Nuneaton and Bedworth 011D","E01031123","Total",1260,86,49,37,1174,9,238,256,222,23,140,286
"2011","Nuneaton and Bedworth 011E","E01031124","Total",1537,137,86,51,1400,26,326,266,228,78,159,317
"2011","Nuneaton and Bedworth 012A","E01031105","Total",1398,162,79,83,1236,66,176,314,216,74,152,238
"2011","Nuneaton and Bedworth 012B","E01031106","Total",1437,166,76,90,1271,62,256,267,214,53,144,275
"2011","Nuneaton and Bedworth 012C","E01031107","Total",1158,106,34,72,1052,62,106,302,190,48,118,226
"2011","Nuneaton and Bedworth 012D","E01031108","Total",1389,116,41,75,1273,57,106,343,234,73,155,305
"2011","Nuneaton and Bedworth 012E","E01031109","Total",1623,275,122,153,1348,138,138,340,228,99,123,282
"2011","Nuneaton and Bedworth 013A","E01031062","Total",1237,87,60,27,1150,50,238,233,178,70,108,273
"2011","Nuneaton and Bedworth 013B","E01031063","Total",1304,277,106,171,1027,129,190,182,192,48,99,187
"2011","Nuneaton and Bedworth 013C","E01031064","Total",1164,237,136,101,927,46,166,163,178,37,156,181
"2011","Nuneaton and Bedworth 013D","E01031065","Total",1494,176,71,105,1318,95,156,259,238,77,212,281
"2011","Nuneaton and Bedworth 013E","E01031066","Total",1392,245,128,117,1147,156,144,247,172,118,110,200
"2011","Nuneaton and Bedworth 014A","E01031067","Total",1487,282,143,139,1205,79,292,191,226,42,127,248
"2011","Nuneaton and Bedworth 014B","E01031068","Total",1686,201,123,78,1485,42,352,302,246,83,139,321
"2011","Nuneaton and Bedworth 014C","E01031069","Total",1475,189,140,49,1286,23,374,278,202,48,127,234
"2011","Nuneaton and Bedworth 014D","E01031070","Total",1489,151,86,65,1338,20,358,217,246,51,96,350
"2011","Nuneaton and Bedworth 015A","E01031095","Total",1247,104,50,54,1143,158,136,279,172,84,95,219
"2011","Nuneaton and Bedworth 015B","E01031096","Total",1380,191,46,145,1189,113,100,264,230,56,128,298
"2011","Nuneaton and Bedworth 015C","E01031097","Total",1644,279,114,165,1365,141,142,302,254,92,173,261
"2011","Nuneaton and Bedworth 015D","E01031098","Total",1493,123,53,70,1370,80,116,365,186,78,228,317
"2011","Nuneaton and Bedworth 015E","E01031099","Total",2270,248,39,209,2022,103,152,586,416,95,271,399
"2011","Nuneaton and Bedworth 016A","E01031086","Total",1827,215,130,85,1612,130,198,339,284,157,154,350
"2011","Nuneaton and Bedworth 016B","E01031087","Total",2210,238,113,125,1972,207,168,532,334,128,231,372
"2011","Nuneaton and Bedworth 016C","E01031088","Total",1942,177,66,111,1765,96,162,515,318,131,191,352
"2011","Nuneaton and Bedworth 016D","E01031089","Total",1445,163,104,59,1282,50,268,223,266,57,91,327
"2011","Nuneaton and Bedworth 018A","E01031077","Total",1448,190,80,110,1258,177,90,296,224,62,168,241
"2011","Nuneaton and Bedworth 018B","E01031078","Total",2006,200,83,117,1806,95,214,402,322,136,214,423
"2011","Nuneaton and Bedworth 018C","E01031079","Total",1476,197,100,97,1279,71,250,230,196,36,186,310
"2011","Nuneaton and Bedworth 018D","E01031080","Total",1517,230,103,127,1287,143,160,287,214,64,189,230
"2011","Nuneaton and Bedworth 018E","E01032588","Total",1365,154,82,72,1211,35,208,237,210,85,191,245
"2011","Rugby 001B","E01031129","Total",1125,164,76,88,961,36,206,215,170,48,120,166
"2011","Rugby 001C","E01031159","Total",1642,156,86,70,1486,71,280,298,288,92,166,291
"2011","Rugby 001D","E01031160","Total",2134,237,112,125,1897,49,320,405,374,97,213,439
"2011","Rugby 001E","E01031182","Total",2128,155,85,70,1973,59,274,561,362,147,222,348
"2011","Rugby 001F","E01032891","Total",1681,188,8,180,1493,50,22,535,424,109,163,190
"2011","Rugby 001G","E01032892","Total",1919,185,81,104,1734,36,186,549,320,136,197,310
"2011","Rugby 002A","E01031137","Total",1167,202,47,155,965,67,96,232,266,43,111,150
"2011","Rugby 002B","E01031138","Total",1196,56,13,43,1140,66,76,309,264,37,154,234
"2011","Rugby 002C","E01031139","Total",1838,96,14,82,1742,32,130,517,386,115,213,349
"2011","Rugby 002D","E01031140","Total",1369,102,46,56,1267,88,172,243,234,78,135,317
"2011","Rugby 002E","E01031141","Total",1799,196,48,148,1603,140,100,528,366,139,107,223
"2011","Rugby 002F","E01031142","Total",1672,223,25,198,1449,253,44,334,260,177,167,214
"2011","Rugby 003A","E01031171","Total",1491,160,53,107,1331,73,144,303,258,127,186,240
"2011","Rugby 003B","E01031172","Total",1667,234,112,122,1433,196,172,306,272,156,133,198
"2011","Rugby 003C","E01031173","Total",1788,557,220,337,1231,125,116,246,302,123,104,215
"2011","Rugby 003D","E01031174","Total",1709,270,63,207,1439,105,112,295,246,107,231,343
"2011","Rugby 004A","E01031151","Total",1554,126,78,48,1428,20,306,313,196,96,158,339
"2011","Rugby 004B","E01031152","Total",1104,140,75,65,964,31,188,165,208,40,102,230
"2011","Rugby 004C","E01031153","Total",1416,154,68,86,1262,97,178,341,212,100,129,205
"2011","Rugby 004D","E01031154","Total",1750,191,72,119,1559,56,266,344,394,99,147,253
"2011","Rugby 004E","E01031181","Total",1812,163,89,74,1649,48,254,478,264,88,187,330
"2011","Rugby 005A","E01031130","Total",1764,214,33,181,1550,158,86,413,380,78,136,299
"2011","Rugby 005B","E01031131","Total",1629,232,50,182,1397,139,88,317,226,120,142,365
"2011","Rugby 005C","E01031132","Total",1911,310,82,228,1601,123,108,375,378,80,184,353
"2011","Rugby 005D","E01031133","Total",1589,253,69,184,1336,136,106,338,288,107,125,236
"2011","Rugby 006A","E01031167","Total",1346,143,57,86,1203,66,138,280,224,69,154,272
"2011","Rugby 006B","E01031168","Total",2766,338,100,238,2428,313,162,654,466,192,269,372
"2011","Rugby 006C","E01031169","Total",2003,327,55,272,1676,156,102,440,428,106,161,283
"2011","Rugby 006D","E01031170","Total",1606,314,122,192,1292,138,92,246,286,112,138,280
"2011","Rugby 007A","E01031125","Total",1472,188,68,120,1284,48,196,305,312,84,106,233
"2011","Rugby 007C","E01031127","Total",1580,171,67,104,1409,183,116,344,216,172,124,254
"2011","Rugby 007D","E01031164","Total",2000,212,57,155,1788,68,226,523,414,111,175,271
"2011","Rugby 007E","E01031165","Total",1595,204,95,109,1391,148,178,349,252,102,133,229
"2011","Rugby 007F","E01032893","Total",1872,52,15,37,1820,71,58,722,208,228,313,220
"2011","Rugby 007G","E01032894","Total",1362,72,7,65,1290,98,46,607,214,92,126,107
"2011","Rugby 007H","E01032895","Total",1440,90,32,58,1350,53,130,441,242,92,141,251
"2011","Rugby 008A","E01031155","Total",1408,96,54,42,1312,25,196,370,232,82,156,251
"2011","Rugby 008B","E01031156","Total",1464,178,76,102,1286,44,182,352,330,64,143,171
"2011","Rugby 008C","E01031157","Total",1956,212,90,122,1744,97,184,526,264,86,254,333
"2011","Rugby 008D","E01031158","Total",1085,138,93,45,947,34,244,216,128,58,78,189
"2011","Rugby 009A","E01031143","Total",1526,148,85,63,1378,32,288,308,264,46,141,299
"2011","Rugby 009B","E01031144","Total",1235,222,90,132,1013,84,110,246,238,62,107,166
"2011","Rugby 009C","E01031145","Total",888,282,142,140,606,38,96,114,140,45,71,102
"2011","Rugby 009D","E01031146","Total",1472,166,99,67,1306,100,260,255,220,89,133,249
"2011","Rugby 010A","E01031161","Total",1962,252,141,111,1710,63,360,346,340,103,202,296
"2011","Rugby 010B","E01031162","Total",1727,179,106,73,1548,76,258,358,292,75,173,316
"2011","Rugby 010C","E01031163","Total",1527,290,140,150,1237,89,272,235,206,109,105,221
"2011","Rugby 010D","E01031179","Total",1730,163,89,74,1567,64,216,419,242,99,237,290
"2011","Rugby 010E","E01031180","Total",2018,257,136,121,1761,91,262,426,282,145,221,334
"2011","Rugby 011A","E01031134","Total",1658,192,123,69,1466,30,402,258,224,104,120,328
"2011","Rugby 011B","E01031135","Total",1607,250,172,78,1357,50,426,242,234,40,155,210
"2011","Rugby 011C","E01031136","Total",1620,214,117,97,1406,56,234,366,296,82,105,267
"2011","Rugby 011D","E01031175","Total",1351,121,88,33,1230,24,374,252,164,65,118,233
"2011","Rugby 011E","E01031176","Total",1490,154,57,97,1336,106,124,286,234,140,208,238
"2011","Rugby 011F","E01031177","Total",1442,182,72,110,1260,173,100,316,228,117,128,198
"2011","Rugby 011G","E01031178","Total",1386,215,122,93,1171,68,254,244,206,52,72,275
"2011","Rugby 012A","E01031147","Total",1529,178,135,43,1351,25,388,279,196,93,196,174
"2011","Rugby 012B","E01031148","Total",1654,210,134,76,1444,87,338,329,244,77,140,229
"2011","Rugby 012C","E01031149","Total",1483,143,73,70,1340,39,238,266,298,78,150,271
"2011","Rugby 012D","E01031150","Total",1158,119,81,38,1039,32,198,212,212,51,116,218
"2011","Rugby 012E","E01031166","Total",1908,148,84,64,1760,68,330,402,372,93,237,258
"2011","Stratford-on-Avon 001A","E01031213","Total",1836,156,71,85,1680,75,294,350,334,82,186,359
"2011","Stratford-on-Avon 001B","E01031243","Total",1960,142,92,50,1818,14,422,370,302,116,219,375
"2011","Stratford-on-Avon 001C","E01031244","Total",1817,154,83,71,1663,34,360,301,302,116,225,325
"2011","Stratford-on-Avon 002A","E01031195","Total",2245,192,130,62,2053,47,414,528,358,154,181,371
"2011","Stratford-on-Avon 002B","E01031202","Total",1554,314,191,123,1240,51,284,263,294,62,109,177
"2011","Stratford-on-Avon 002C","E01031203","Total",1507,258,135,123,1249,61,240,263,226,72,120,267
"2011","Stratford-on-Avon 002D","E01031204","Total",1318,209,155,54,1109,25,374,208,198,68,89,147
"2011","Stratford-on-Avon 003A","E01031239","Total",1570,201,79,122,1369,67,212,331,280,75,145,259
"2011","Stratford-on-Avon 003B","E01031240","Total",1330,162,85,77,1168,77,232,239,192,77,135,216
"2011","Stratford-on-Avon 003C","E01031241","Total",1430,127,66,61,1303,89,240,262,230,84,150,248
"2011","Stratford-on-Avon 003D","E01031242","Total",1494,200,104,96,1294,89,252,267,174,79,143,290
"2011","Stratford-on-Avon 004A","E01031219","Total",1507,200,88,112,1307,100,156,362,216,138,173,162
"2011","Stratford-on-Avon 004B","E01031220","Total",1529,137,79,58,1392,42,196,366,184,96,200,308
"2011","Stratford-on-Avon 004C","E01031221","Total",1532,234,121,113,1298,117,198,286,238,68,138,253
"2011","Stratford-on-Avon 004D","E01031222","Total",1923,247,91,156,1676,76,268,390,322,71,194,355
"2011","Stratford-on-Avon 004E","E01031223","Total",1347,106,47,59,1241,52,160,329,222,91,176,211
"2011","Stratford-on-Avon 004F","E01031224","Total",1144,95,39,56,1049,49,164,239,166,108,90,233
"2011","Stratford-on-Avon 005A","E01031197","Total",1202,138,67,71,1064,23,176,216,222,51,170,206
"2011","Stratford-on-Avon 005B","E01031198","Total",1283,124,59,65,1159,51,180,331,198,114,104,181
"2011","Stratford-on-Avon 005C","E01031199","Total",1460,145,76,69,1315,39,204,299,224,78,155,316
"2011","Stratford-on-Avon 005D","E01031200","Total",1583,145,48,97,1438,69,200,419,260,62,123,305
"2011","Stratford-on-Avon 005E","E01031201","Total",1566,150,95,55,1416,55,348,381,216,41,104,271
"2011","Stratford-on-Avon 005F","E01031210","Total",1258,104,63,41,1154,25,212,272,242,52,158,193
"2011","Stratford-on-Avon 005G","E01031211","Total",1049,116,52,64,933,65,166,240,164,35,120,143
"2011","Stratford-on-Avon 006A","E01031183","Total",1648,286,123,163,1362,101,272,257,326,51,88,267
"2011","Stratford-on-Avon 006B","E01031184","Total",1507,197,115,82,1310,70,222,331,194,60,165,268
"2011","Stratford-on-Avon 006C","E01031185","Total",1370,216,92,124,1154,101,182,217,200,69,163,222
"2011","Stratford-on-Avon 006D","E01031186","Total",1498,223,152,71,1275,101,210,274,208,46,176,260
"2011","Stratford-on-Avon 007A","E01031187","Total",1881,218,130,88,1663,49,318,421,322,93,156,304
"2011","Stratford-on-Avon 007B","E01031188","Total",2213,195,101,94,2018,59,474,373,328,133,232,419
"2011","Stratford-on-Avon 007C","E01031208","Total",1977,256,120,136,1721,54,376,366,322,99,129,375
"2011","Stratford-on-Avon 008A","E01031217","Total",1201,115,68,47,1086,35,252,253,204,47,111,184
"2011","Stratford-on-Avon 008B","E01031218","Total",1172,93,45,48,1079,25,148,294,168,70,137,237
"2011","Stratford-on-Avon 008C","E01031249","Total",1201,133,71,62,1068,64,124,277,238,68,69,228
"2011","Stratford-on-Avon 008D","E01031250","Total",1476,182,92,90,1294,44,310,278,228,45,91,298
"2011","Stratford-on-Avon 008E","E01031251","Total",1199,107,67,40,1092,20,254,286,168,37,69,258
"2011","Stratford-on-Avon 008F","E01031252","Total",1161,151,85,66,1010,40,164,249,218,40,102,197
"2011","Stratford-on-Avon 008G","E01031253","Total",1522,190,110,80,1332,73,224,366,242,87,138,202
"2011","Stratford-on-Avon 009A","E01031228","Total",1589,207,125,82,1382,25,346,276,236,69,101,329
"2011","Stratford-on-Avon 009B","E01031229","Total",1751,484,200,284,1267,42,302,210,418,36,71,188
"2011","Stratford-on-Avon 009C","E01031230","Total",2406,238,85,153,2168,135,204,584,436,145,213,451
"2011","Stratford-on-Avon 009D","E01031231","Total",2098,398,98,300,1700,163,130,423,492,54,156,282
"2011","Stratford-on-Avon 009E","E01031236","Total",1573,150,61,89,1423,71,168,377,290,46,113,358
"2011","Stratford-on-Avon 009F","E01031238","Total",1325,263,121,142,1062,78,148,202,206,62,101,265
"2011","Stratford-on-Avon 010A","E01031225","Total",1590,221,125,96,1369,34,310,300,206,105,90,324
"2011","Stratford-on-Avon 010C","E01031227","Total",1961,309,182,127,1652,47,350,431,276,64,167,317
"2011","Stratford-on-Avon 010D","E01033250","Total",1394,131,25,106,1263,76,70,463,256,140,111,147
"2011","Stratford-on-Avon 010E","E01033251","Total",1154,95,15,80,1059,95,78,342,224,92,111,117
"2011","Stratford-on-Avon 010F","E01033252","Total",1286,126,91,35,1160,25,302,262,176,77,125,193
"2011","Stratford-on-Avon 011A","E01031232","Total",2325,292,112,180,2033,80,290,475,388,172,187,441
"2011","Stratford-on-Avon 011B","E01031233","Total",1622,226,96,130,1396,83,240,283,266,55,136,333
"2011","Stratford-on-Avon 011C","E01031234","Total",1669,514,296,218,1155,68,254,264,302,37,49,181
"2011","Stratford-on-Avon 011D","E01031235","Total",1801,415,241,174,1386,72,314,307,308,30,59,296
"2011","Stratford-on-Avon 011E","E01031237","Total",1412,133,85,48,1279,38,266,253,198,57,100,367
"2011","Stratford-on-Avon 012A","E01031189","Total",1456,154,80,74,1302,62,230,325,240,54,134,257
"2011","Stratford-on-Avon 012B","E01031190","Total",1702,158,69,89,1544,121,174,436,216,90,158,349
"2011","Stratford-on-Avon 012C","E01031191","Total",1822,140,75,65,1682,50,258,422,258,84,241,369
"2011","Stratford-on-Avon 012D","E01031192","Total",1904,260,122,138,1644,69,278,451,356,98,158,234
"2011","Stratford-on-Avon 012E","E01031248","Total",2170,220,130,90,1950,37,460,446,308,148,196,355
"2011","Stratford-on-Avon 013A","E01031194","Total",2317,211,94,117,2106,86,318,624,470,132,137,339
"2011","Stratford-on-Avon 013B","E01031205","Total",1533,188,84,104,1345,45,204,370,240,66,137,283
"2011","Stratford-on-Avon 013C","E01031206","Total",1422,187,77,110,1235,55,206,330,170,91,130,253
"2011","Stratford-on-Avon 013D","E01031207","Total",1257,139,51,88,1118,61,164,232,248,84,110,219
"2011","Stratford-on-Avon 013E","E01031247","Total",2287,229,135,94,2058,38,404,427,418,134,224,413
"2011","Stratford-on-Avon 014A","E01031196","Total",2395,232,106,126,2163,96,364,574,364,137,256,372
"2011","Stratford-on-Avon 014B","E01031212","Total",2614,270,110,160,2344,157,354,647,466,141,227,352
"2011","Stratford-on-Avon 014C","E01031245","Total",1219,153,95,58,1066,22,266,221,174,67,94,222
"2011","Stratford-on-Avon 014D","E01031246","Total",1077,121,79,42,956,30,158,251,194,46,72,205
"2011","Stratford-on-Avon 015A","E01031193","Total",2143,270,144,126,1873,68,372,425,362,73,221,352
"2011","Stratford-on-Avon 015B","E01031209","Total",2112,280,162,118,1832,56,436,431,408,76,145,280
"2011","Stratford-on-Avon 015C","E01031214","Total",1827,187,107,80,1640,55,354,416,276,145,148,246
"2011","Stratford-on-Avon 015D","E01031215","Total",1730,349,170,179,1381,70,238,327,330,43,103,270
"2011","Stratford-on-Avon 015E","E01031216","Total",1440,236,147,89,1204,67,238,238,228,56,97,280
"2011","Warwick 001A","E01031254","Total",1508,145,88,57,1363,16,224,387,254,41,129,312
"2011","Warwick 001B","E01031255","Total",1487,155,88,67,1332,37,246,387,254,92,128,188
"2011","Warwick 001C","E01031256","Total",1623,274,137,137,1349,51,374,258,276,66,86,238
"2011","Warwick 001D","E01031257","Total",1381,272,79,193,1109,71,96,266,282,68,119,207
"2011","Warwick 001E","E01031258","Total",1502,345,189,156,1157,60,212,295,260,57,92,181
"2011","Warwick 002A","E01031296","Total",1645,210,74,136,1435,97,130,399,348,88,134,239
"2011","Warwick 002B","E01031297","Total",1949,303,100,203,1646,119,206,465,320,111,173,252
"2011","Warwick 002C","E01031298","Total",1654,292,179,113,1362,62,254,391,274,35,111,235
"2011","Warwick 002D","E01031299","Total",1424,87,54,33,1337,36,278,325,196,86,163,253
"2011","Warwick 002E","E01031300","Total",1716,157,64,93,1559,42,238,481,314,87,156,241
"2011","Warwick 003A","E01031303","Total",1472,293,151,142,1179,84,208,255,220,102,87,223
"2011","Warwick 003B","E01031304","Total",1505,153,96,57,1352,79,248,312,150,120,147,296
"2011","Warwick 003C","E01031305","Total",1492,169,138,31,1323,19,378,283,190,72,130,251
"2011","Warwick 003D","E01031306","Total",1494,152,75,77,1342,51,208,337,194,121,171,260
"2011","Warwick 003E","E01031307","Total",1445,209,112,97,1236,24,310,261,190,68,121,262
"2011","Warwick 004A","E01031281","Total",1483,157,69,88,1326,32,208,303,288,93,142,260
"2011","Warwick 004B","E01031282","Total",1468,215,92,123,1253,55,246,282,260,70,117,223
"2011","Warwick 004C","E01031283","Total",1270,120,51,69,1150,41,176,245,250,55,164,219
"2011","Warwick 004D","E01031284","Total",1220,103,48,55,1117,47,204,237,214,87,82,246
"2011","Warwick 005A","E01031277","Total",1557,162,91,71,1395,46,244,394,208,85,111,307
"2011","Warwick 005B","E01031278","Total",1445,117,53,64,1328,23,230,326,202,102,189,256
"2011","Warwick 005C","E01031279","Total",1329,193,113,80,1136,46,324,209,172,64,91,230
"2011","Warwick 005D","E01031280","Total",1305,105,45,60,1200,33,182,310,200,60,99,316
"2011","Warwick 005E","E01031301","Total",1420,126,76,50,1294,52,234,209,276,102,140,281
"2011","Warwick 005F","E01031302","Total",1022,120,61,59,902,50,110,209,172,37,113,211
"2011","Warwick 005G","E01031308","Total",1843,304,99,205,1539,46,282,372,286,88,177,288
"2011","Warwick 006A","E01031273","Total",1326,299,32,267,1027,173,84,208,194,67,103,198
"2011","Warwick 006B","E01031274","Total",1459,193,87,106,1266,186,134,270,188,94,128,266
"2011","Warwick 006C","E01031275","Total",1252,131,76,55,1121,27,248,233,172,61,143,237
"2011","Warwick 006D","E01031276","Total",1542,178,83,95,1364,145,124,276,256,79,218,266
"2011","Warwick 007B","E01031272","Total",1790,259,60,199,1531,65,162,237,398,120,130,419
"2011","Warwick 007C","E01031285","Total",2006,445,196,249,1561,28,308,301,444,80,99,301
"2011","Warwick 007D","E01031286","Total",1463,263,147,116,1200,77,162,379,246,63,70,203
"2011","Warwick 007E","E01031287","Total",1561,122,80,42,1439,46,182,393,170,121,192,335
"2011","Warwick 007F","E01031288","Total",1607,228,124,104,1379,30,272,346,246,106,130,249
"2011","Warwick 007G","E01031289","Total",1485,111,58,53,1374,51,148,431,246,77,168,253
"2011","Warwick 007H","E01033253","Total",1437,362,64,298,1075,50,70,109,406,5,23,412
"2011","Warwick 007I","E01033256","Total",1243,396,88,308,847,23,50,137,320,10,26,281
"2011","Warwick 008A","E01031309","Total",1726,253,88,165,1473,118,160,408,306,86,165,230
"2011","Warwick 008B","E01031310","Total",1342,138,79,59,1204,57,194,256,220,64,140,273
"2011","Warwick 008C","E01031311","Total",1327,175,74,101,1152,88,166,270,176,82,135,235
"2011","Warwick 008D","E01031312","Total",1192,179,47,132,1013,105,110,278,202,37,111,170
"2011","Warwick 008E","E01031313","Total",1358,147,91,56,1211,38,206,248,276,52,80,311
"2011","Warwick 008F","E01031314","Total",1338,185,65,120,1153,41,150,306,282,35,96,243
"2011","Warwick 009A","E01031290","Total",1636,340,68,272,1296,63,144,287,436,46,110,210
"2011","Warwick 009B","E01031291","Total",1488,408,62,346,1080,43,86,164,322,15,45,405
"2011","Warwick 009C","E01031292","Total",1495,174,69,105,1321,80,146,374,328,73,90,230
"2011","Warwick 009D","E01031293","Total",1555,249,92,157,1306,92,134,345,300,84,150,201
"2011","Warwick 009E","E01031294","Total",1461,224,76,148,1237,42,140,315,254,110,123,253
"2011","Warwick 009F","E01031295","Total",1167,129,77,52,1038,2,268,196,150,72,135,215
"2011","Warwick 010A","E01031271","Total",1749,403,180,223,1346,46,192,246,320,98,95,349
"2011","Warwick 010B","E01031332","Total",1368,140,41,99,1228,145,96,222,148,72,257,288
"2011","Warwick 010C","E01031333","Total",1344,106,33,73,1238,62,108,207,170,78,287,326
"2011","Warwick 010D","E01031334","Total",1522,181,76,105,1341,116,98,364,334,65,125,239
"2011","Warwick 010E","E01031335","Total",1415,247,31,216,1168,37,52,221,322,48,129,359
"2011","Warwick 010F","E01031336","Total",2109,342,46,296,1767,60,54,146,324,57,72,1054
"2011","Warwick 010G","E01031337","Total",1494,261,63,198,1233,103,74,243,354,53,87,319
"2011","Warwick 011A","E01031321","Total",1332,111,37,74,1221,113,86,394,178,121,134,195
"2011","Warwick 011B","E01031322","Total",1831,292,97,195,1539,94,168,386,388,92,129,282
"2011","Warwick 011C","E01031323","Total",1562,343,145,198,1219,58,190,311,336,36,90,198
"2011","Warwick 011D","E01031324","Total",2017,698,167,531,1319,121,178,203,544,37,52,184
"2011","Warwick 011E","E01031325","Total",1400,202,99,103,1198,134,112,291,232,67,120,242
"2011","Warwick 011G","E01033254","Total",1440,112,5,107,1328,100,28,569,368,69,98,96
"2011","Warwick 011H","E01033255","Total",1656,132,41,91,1524,76,122,460,316,109,187,254
"2011","Warwick 012A","E01031315","Total",2198,148,46,102,2050,147,140,613,306,152,319,373
"2011","Warwick 012B","E01031316","Total",1435,372,197,175,1063,55,210,232,252,51,104,159
"2011","Warwick 012C","E01031317","Total",1444,316,157,159,1128,42,298,268,236,80,57,147
"2011","Warwick 012D","E01031318","Total",1920,112,31,81,1808,75,162,696,242,113,270,250
"2011","Warwick 012E","E01031319","Total",1952,277,89,188,1675,89,182,508,358,92,183,263
"2011","Warwick 012F","E01031320","Total",1417,195,60,135,1222,47,152,281,298,84,85,275
"2011","Warwick 013A","E01031261","Total",1547,182,65,117,1365,109,86,167,196,91,186,530
"2011","Warwick 013B","E01031262","Total",1430,258,72,186,1172,94,44,280,236,56,120,342
"2011","Warwick 013C","E01031263","Total",1868,146,49,97,1722,99,64,177,214,57,246,865
"2011","Warwick 013D","E01031264","Total",1699,150,78,72,1549,153,110,282,196,171,216,421
"2011","Warwick 013E","E01031265","Total",1439,118,50,68,1321,122,72,219,154,127,152,475
"2011","Warwick 013F","E01031266","Total",1845,423,61,362,1422,70,40,146,366,20,163,617
"2011","Warwick 014A","E01031259","Total",1370,93,27,66,1277,60,122,423,196,42,140,294
"2011","Warwick 014B","E01031260","Total",1180,138,61,77,1042,67,198,235,194,61,127,160
"2011","Warwick 014C","E01031267","Total",1776,148,79,69,1628,38,332,348,304,112,122,372
"2011","Warwick 014D","E01031268","Total",2732,246,68,178,2486,149,188,944,476,177,185,367
"2011","Warwick 014E","E01031269","Total",1663,209,82,127,1454,63,270,355,312,81,121,252
"2011","Warwick 015A","E01031327","Total",1531,181,91,90,1350,136,160,305,182,76,195,296
"2011","Warwick 015B","E01031328","Total",2184,199,89,110,1985,110,272,504,350,91,206,452
"2011","Warwick 015C","E01031329","Total",2561,210,84,126,2351,182,196,720,428,128,301,396
"2011","Warwick 015D","E01031330","Total",1459,155,72,83,1304,103,146,301,262,66,160,266
"2011","Warwick 015E","E01031331","Total",1786,228,122,106,1558,66,184,425,244,63,206,370
"2011","Birmingham 001A","E01009417","Total",1492,174,130,44,1318,48,180,394,182,94,189,231
"2011","Birmingham 001B","E01009418","Total",1471,184,97,87,1287,103,234,308,196,60,149,237
"2011","Birmingham 001C","E01009419","Total",1322,185,89,96,1137,51,236,223,140,70,169,248
"2011","Birmingham 001D","E01009433","Total",1759,187,121,66,1572,58,290,381,264,97,99,383
"2011","Birmingham 002A","E01009415","Total",1613,168,107,61,1445,40,276,399,230,68,126,306
"2011","Birmingham 002B","E01009422","Total",1894,291,152,139,1603,63,368,419,268,114,132,239
"2011","Birmingham 002C","E01009423","Total",1677,287,153,134,1390,97,230,233,218,87,226,299
"2011","Birmingham 002D","E01009425","Total",1693,352,206,146,1341,64,332,264,228,85,164,204
"2011","Birmingham 003A","E01009416","Total",2669,233,80,153,2436,168,200,830,350,218,336,334
"2011","Birmingham 003B","E01009420","Total",1537,160,111,49,1377,74,192,388,222,99,149,253
"2011","Birmingham 003C","E01009426","Total",1449,142,104,38,1307,39,320,314,180,48,168,238
"2011","Birmingham 003D","E01009429","Total",1493,115,63,52,1378,34,296,409,178,97,113,251
"2011","Birmingham 003E","E01009431","Total",1583,116,76,40,1467,46,266,386,202,100,209,258
"2011","Birmingham 004A","E01009421","Total",1635,112,77,35,1523,4,322,326,216,83,201,371
"2011","Birmingham 004B","E01009424","Total",1456,262,94,168,1194,60,154,310,270,77,123,200
"2011","Birmingham 004C","E01009427","Total",1494,265,121,144,1229,44,210,218,248,83,150,276
"2011","Birmingham 004D","E01009428","Total",1644,96,70,26,1548,42,352,297,258,88,159,352
"2011","Birmingham 004E","E01009430","Total",1609,139,92,47,1470,26,300,294,230,82,206,332
"2011","Birmingham 004F","E01009468","Total",1473,184,99,85,1289,13,294,270,134,66,178,334
"2011","Birmingham 005A","E01009445","Total",1682,221,98,123,1461,267,82,310,176,142,271,213
"2011","Birmingham 005B","E01009446","Total",2404,304,130,174,2100,143,188,613,374,109,321,352
"2011","Birmingham 005C","E01009447","Total",1601,168,87,81,1433,74,192,346,176,126,273,246
"2011","Birmingham 005D","E01009448","Total",1631,201,110,91,1430,178,158,269,184,72,234,335
"2011","Birmingham 005E","E01009452","Total",1645,193,122,71,1452,83,198,329,218,79,193,352
"2011","Birmingham 005F","E01009455","Total",1322,361,130,231,961,95,148,234,224,16,96,148
"2011","Birmingham 006A","E01009432","Total",1508,185,75,110,1323,132,194,298,178,120,131,270
"2011","Birmingham 006B","E01009435","Total",1826,148,37,111,1678,44,138,532,334,97,223,310
"2011","Birmingham 006C","E01009437","Total",1780,293,148,145,1487,66,254,359,222,117,162,307
"2011","Birmingham 006D","E01009444","Total",1538,130,89,41,1408,19,300,323,214,88,140,324
"2011","Birmingham 006E","E01009454","Total",1511,196,50,146,1315,43,162,408,268,70,130,234
"2011","Birmingham 007A","E01009221","Total",1483,154,74,80,1329,86,158,280,164,110,201,330
"2011","Birmingham 007B","E01009464","Total",1385,110,70,40,1275,28,212,240,150,81,228,336
"2011","Birmingham 007C","E01009465","Total",1378,91,51,40,1287,51,152,330,164,51,237,302
"2011","Birmingham 007D","E01009467","Total",1559,175,94,81,1384,52,246,296,240,68,166,316
"2011","Birmingham 008A","E01009220","Total",1560,164,67,97,1396,138,118,380,224,55,224,257
"2011","Birmingham 008B","E01009222","Total",1576,177,62,115,1399,195,94,274,160,197,204,275
"2011","Birmingham 008C","E01009224","Total",1469,177,100,77,1292,79,250,246,154,93,224,246
"2011","Birmingham 008D","E01009233","Total",1534,188,77,111,1346,178,98,304,202,131,195,238
"2011","Birmingham 009A","E01009449","Total",1815,428,183,245,1387,84,180,278,420,83,116,226
"2011","Birmingham 009B","E01009451","Total",1431,270,93,177,1161,74,80,333,232,80,176,186
"2011","Birmingham 009C","E01009453","Total",1467,98,54,44,1369,51,114,331,172,101,207,393
"2011","Birmingham 009D","E01009466","Total",1615,165,82,83,1450,33,196,376,274,79,151,341
"2011","Birmingham 009E","E01009471","Total",1674,219,109,110,1455,30,160,310,258,103,196,398
"2011","Birmingham 010A","E01009135","Total",1422,169,82,87,1253,44,186,209,230,42,176,366
"2011","Birmingham 010B","E01009469","Total",1437,145,69,76,1292,29,254,278,196,72,130,333
"2011","Birmingham 010C","E01009470","Total",1439,83,55,28,1356,14,234,274,178,66,178,412
"2011","Birmingham 010D","E01009472","Total",1659,136,73,63,1523,64,216,374,188,168,165,348
"2011","Birmingham 010E","E01009473","Total",1595,224,113,111,1371,63,140,367,236,114,184,267
"2011","Birmingham 010F","E01009474","Total",1590,167,103,64,1423,51,138,397,220,97,166,354
"2011","Birmingham 011A","E01009127","Total",1571,169,62,107,1402,264,78,262,122,132,263,281
"2011","Birmingham 011B","E01009128","Total",1374,159,56,103,1215,139,96,187,158,190,228,217
"2011","Birmingham 011C","E01009130","Total",1505,194,84,110,1311,191,86,218,210,120,260,226
"2011","Birmingham 011D","E01009131","Total",1448,132,46,86,1316,147,68,216,144,181,293,267
"2011","Birmingham 011E","E01009133","Total",1492,206,71,135,1286,180,122,220,158,145,238,223
"2011","Birmingham 011F","E01009134","Total",1560,239,102,137,1321,184,146,220,160,119,215,277
"2011","Birmingham 011G","E01009137","Total",1606,141,60,81,1465,210,106,263,148,182,299,257
"2011","Birmingham 012A","E01009434","Total",1567,153,39,114,1414,56,118,467,270,112,169,222
"2011","Birmingham 012B","E01009436","Total",1441,99,68,31,1342,14,192,323,190,98,182,343
"2011","Birmingham 012C","E01009438","Total",1450,163,48,115,1287,30,136,348,264,60,133,316
"2011","Birmingham 012D","E01009440","Total",1525,168,115,53,1357,31,202,315,228,98,127,356
"2011","Birmingham 012E","E01009450","Total",1635,185,90,95,1450,48,230,316,212,50,213,381
"2011","Birmingham 013A","E01009223","Total",1527,230,101,129,1297,67,152,322,232,84,150,290
"2011","Birmingham 013B","E01009225","Total",1606,330,202,128,1276,166,210,229,172,92,200,207
"2011","Birmingham 013C","E01009227","Total",1618,206,91,115,1412,90,162,299,290,89,212,270
"2011","Birmingham 013D","E01009228","Total",1657,193,106,87,1464,133,148,365,206,92,212,308
"2011","Birmingham 014A","E01009121","Total",2300,270,129,141,2030,282,214,420,256,226,301,331
"2011","Birmingham 014B","E01009122","Total",1598,258,114,144,1340,201,96,229,158,151,247,258
"2011","Birmingham 014C","E01009129","Total",1628,162,62,100,1466,232,68,241,136,194,313,282
"2011","Birmingham 014D","E01009132","Total",1555,201,94,107,1354,218,78,289,158,186,190,235
"2011","Birmingham 014E","E01009136","Total",1597,370,173,197,1227,116,158,202,234,94,177,246
"2011","Birmingham 015A","E01009457","Total",1519,108,69,39,1411,32,320,209,224,109,159,358
"2011","Birmingham 015B","E01009459","Total",1636,160,68,92,1476,40,234,399,244,103,148,308
"2011","Birmingham 015C","E01009461","Total",1332,94,55,39,1238,20,232,270,206,65,159,286
"2011","Birmingham 015D","E01009463","Total",1458,165,106,59,1293,33,244,225,236,58,169,328
"2011","Birmingham 016A","E01009235","Total",1607,134,69,65,1473,104,184,346,206,90,174,369
"2011","Birmingham 016B","E01009243","Total",1518,173,101,72,1345,90,152,282,224,99,173,325
"2011","Birmingham 016C","E01009245","Total",1449,149,73,76,1300,89,140,342,124,88,149,368
"2011","Birmingham 016D","E01009246","Total",1577,156,66,90,1421,86,206,361,202,85,145,336
"2011","Birmingham 016E","E01009247","Total",1504,135,74,61,1369,87,138,314,182,87,262,299
"2011","Birmingham 017A","E01009226","Total",1458,209,88,121,1249,156,138,305,246,68,102,234
"2011","Birmingham 017B","E01009229","Total",1578,167,84,83,1411,84,146,325,220,95,187,354
"2011","Birmingham 017C","E01009230","Total",1508,196,86,110,1312,76,188,298,236,80,173,261
"2011","Birmingham 017D","E01009231","Total",1879,212,128,84,1667,105,202,324,236,114,244,442
"2011","Birmingham 018A","E01009001","Total",1529,215,82,133,1314,114,180,360,288,41,103,228
"2011","Birmingham 018B","E01009003","Total",1549,254,81,173,1295,54,176,193,238,68,166,400
"2011","Birmingham 018C","E01009456","Total",1665,172,85,87,1493,43,162,444,234,105,207,298
"2011","Birmingham 018D","E01009458","Total",1485,399,264,135,1086,44,266,238,146,30,167,195
"2011","Birmingham 018E","E01009460","Total",1638,370,106,264,1268,76,146,329,332,26,145,214
"2011","Birmingham 018F","E01009462","Total",1667,303,138,165,1364,79,142,346,340,25,121,311
"2011","Birmingham 019A","E01009234","Total",1520,155,47,108,1365,139,112,370,254,87,160,243
"2011","Birmingham 019B","E01009236","Total",1551,173,91,82,1378,116,140,361,212,121,131,297
"2011","Birmingham 019C","E01009244","Total",1436,212,92,120,1224,105,120,379,178,95,163,184
"2011","Birmingham 019D","E01009248","Total",1767,139,55,84,1628,159,144,382,294,120,201,328
"2011","Birmingham 020A","E01009403","Total",1506,202,71,131,1304,171,108,235,160,127,262,241
"2011","Birmingham 020B","E01009404","Total",1552,176,68,108,1376,203,106,279,198,102,211,277
"2011","Birmingham 020C","E01009405","Total",1406,209,91,118,1197,120,120,264,186,104,139,264
"2011","Birmingham 020D","E01009406","Total",1648,339,160,179,1309,134,124,300,218,99,195,239
"2011","Birmingham 020E","E01009407","Total",1690,273,90,183,1417,185,118,278,200,131,182,323
"2011","Birmingham 021A","E01009439","Total",1384,179,114,65,1205,52,266,278,226,62,126,195
"2011","Birmingham 021B","E01009441","Total",1445,196,86,110,1249,77,160,231,266,70,109,336
"2011","Birmingham 021C","E01009442","Total",1472,154,112,42,1318,44,226,312,186,64,151,335
"2011","Birmingham 021D","E01009443","Total",1220,151,61,90,1069,73,126,278,248,46,100,198
"2011","Birmingham 022A","E01009123","Total",1437,219,82,137,1218,153,114,242,170,88,214,237
"2011","Birmingham 022B","E01009124","Total",1607,177,49,128,1430,443,44,248,166,116,243,170
"2011","Birmingham 022C","E01009125","Total",1757,198,89,109,1559,186,130,293,210,160,291,289
"2011","Birmingham 022D","E01009232","Total",1490,154,72,82,1336,102,170,312,208,84,191,269
"2011","Birmingham 023A","E01009002","Total",1470,237,75,162,1233,310,72,284,146,104,124,193
"2011","Birmingham 023C","E01009006","Total",1519,326,74,252,1193,139,98,285,330,70,72,199
"2011","Birmingham 023D","E01009007","Total",1604,358,104,254,1246,180,60,267,248,109,119,263
"2011","Birmingham 023F","E01033632","Total",2245,409,155,254,1836,322,168,346,236,165,262,337
"2011","Birmingham 024A","E01009237","Total",1468,206,87,119,1262,115,136,321,120,117,238,215
"2011","Birmingham 024B","E01009238","Total",1631,186,112,74,1445,59,180,203,174,133,322,374
"2011","Birmingham 024C","E01009240","Total",1580,143,57,86,1437,111,146,330,220,126,207,297
"2011","Birmingham 024D","E01009241","Total",1703,136,64,72,1567,110,130,319,160,166,329,353
"2011","Birmingham 024E","E01009242","Total",1785,142,81,61,1643,71,110,305,146,208,338,465
"2011","Birmingham 025A","E01009005","Total",1286,288,121,167,998,70,132,241,218,82,92,163
"2011","Birmingham 025B","E01009009","Total",1467,198,72,126,1269,83,174,268,236,71,178,259
"2011","Birmingham 025C","E01009098","Total",2083,330,134,196,1753,159,204,451,304,121,233,281
"2011","Birmingham 025D","E01009100","Total",2040,272,126,146,1768,207,144,402,276,123,318,298
"2011","Birmingham 025E","E01009105","Total",1613,167,71,96,1446,65,196,388,232,91,165,309
"2011","Birmingham 026A","E01009126","Total",1412,120,63,57,1292,86,126,267,210,113,191,299
"2011","Birmingham 026B","E01009408","Total",1711,204,92,112,1507,120,94,270,176,168,348,331
"2011","Birmingham 026C","E01009409","Total",1641,274,104,170,1367,170,128,232,220,138,149,330
"2011","Birmingham 026D","E01009410","Total",1748,297,142,155,1451,138,148,242,210,74,278,361
"2011","Birmingham 028A","E01009008","Total",1484,170,96,74,1314,61,178,232,206,76,233,328
"2011","Birmingham 028B","E01009011","Total",1760,287,129,158,1473,88,198,286,216,113,183,389
"2011","Birmingham 028C","E01009012","Total",1457,166,67,99,1291,96,124,250,208,73,200,340
"2011","Birmingham 028D","E01009102","Total",1491,207,80,127,1284,166,92,292,188,108,191,247
"2011","Birmingham 028E","E01009104","Total",1541,231,84,147,1310,218,80,302,164,147,174,225
"2011","Birmingham 029A","E01009096","Total",1651,319,112,207,1332,150,202,198,206,110,219,247
"2011","Birmingham 029B","E01009097","Total",1958,239,106,133,1719,317,146,303,212,127,314,300
"2011","Birmingham 029C","E01009099","Total",1777,306,79,227,1471,362,110,271,244,102,205,177
"2011","Birmingham 029D","E01009101","Total",1553,193,114,79,1360,186,132,283,132,99,236,292
"2011","Birmingham 029E","E01009103","Total",1536,229,115,114,1307,233,146,225,164,66,261,212
"2011","Birmingham 029F","E01009106","Total",1351,184,88,96,1167,65,180,242,174,63,144,299
"2011","Birmingham 030A","E01008915","Total",1374,138,48,90,1236,132,64,250,142,218,195,235
"2011","Birmingham 030B","E01009411","Total",1818,373,68,305,1445,145,96,377,322,88,207,210
"2011","Birmingham 030C","E01009412","Total",1710,211,79,132,1499,107,94,260,186,99,379,374
"2011","Birmingham 030D","E01009413","Total",1652,203,51,152,1449,111,118,283,188,102,286,361
"2011","Birmingham 030E","E01009414","Total",1905,232,39,193,1673,191,90,327,290,155,259,361
"2011","Birmingham 031A","E01008998","Total",1827,186,70,116,1641,159,88,219,142,290,423,320
"2011","Birmingham 031B","E01008999","Total",1545,151,59,92,1394,92,94,168,104,165,415,356
"2011","Birmingham 031C","E01009000","Total",1614,380,74,306,1234,137,100,206,266,57,209,259
"2011","Birmingham 031D","E01009013","Total",1880,373,94,279,1507,146,98,318,252,138,251,304
"2011","Birmingham 031E","E01009400","Total",1404,152,49,103,1252,144,100,217,144,107,236,304
"2011","Birmingham 031F","E01009401","Total",1651,219,46,173,1432,176,82,216,156,153,331,318
"2011","Birmingham 031H","E01033630","Total",1118,274,22,252,844,115,8,201,302,35,70,113
"2011","Birmingham 031I","E01033646","Total",1544,404,89,315,1140,150,58,228,190,70,205,239
"2011","Birmingham 032A","E01009049","Total",1628,173,64,109,1455,103,98,189,130,132,473,330
"2011","Birmingham 032B","E01009056","Total",2026,297,39,258,1729,126,66,272,158,161,542,404
"2011","Birmingham 032C","E01009263","Total",1602,255,74,181,1347,106,72,226,168,65,371,339
"2011","Birmingham 032D","E01009264","Total",988,352,69,283,636,94,32,139,176,31,83,81
"2011","Birmingham 032E","E01009265","Total",1731,158,48,110,1573,102,88,168,122,76,500,517
"2011","Birmingham 033A","E01009051","Total",1620,104,35,69,1516,89,38,124,96,237,463,469
"2011","Birmingham 033B","E01009053","Total",1481,91,32,59,1390,125,50,170,76,248,398,323
"2011","Birmingham 033C","E01009054","Total",1642,51,26,25,1591,30,82,166,48,230,603,432
"2011","Birmingham 033D","E01009058","Total",1668,76,32,44,1592,62,58,260,94,250,541,327
"2011","Birmingham 033E","E01009061","Total",1801,70,28,42,1731,58,54,119,60,219,891,330
"2011","Birmingham 033F","E01009239","Total",1195,188,59,129,1007,98,60,115,144,60,193,337
"2011","Birmingham 034A","E01009266","Total",1711,163,49,114,1548,152,86,255,152,140,341,422
"2011","Birmingham 034B","E01009269","Total",1535,133,53,80,1402,165,72,308,130,149,274,304
"2011","Birmingham 034C","E01009270","Total",1966,186,62,124,1780,191,56,228,114,211,564,416
"2011","Birmingham 034D","E01009271","Total",1522,137,48,89,1385,151,96,256,94,176,321,291
"2011","Birmingham 034E","E01009273","Total",1603,121,64,57,1482,89,98,156,92,197,426,424
"2011","Birmingham 035A","E01009050","Total",1815,211,72,139,1604,190,78,254,100,133,412,437
"2011","Birmingham 035D","E01009057","Total",2057,197,47,150,1860,178,82,253,96,293,602,356
"2011","Birmingham 035E","E01009059","Total",1793,193,48,145,1600,165,48,163,70,242,605,307
"2011","Birmingham 035F","E01009060","Total",1591,103,25,78,1488,99,32,143,66,199,640,309
"2011","Birmingham 035G","E01033621","Total",2858,223,61,162,2635,230,90,277,152,308,893,685
"2011","Birmingham 036A","E01009268","Total",1517,57,31,26,1460,42,98,211,82,119,446,462
"2011","Birmingham 036B","E01009272","Total",1401,126,42,84,1275,126,60,277,98,124,306,284
"2011","Birmingham 036C","E01009274","Total",2140,239,66,173,1901,173,78,291,106,159,600,494
"2011","Birmingham 036D","E01009349","Total",1679,154,39,115,1525,252,56,276,146,186,328,281
"2011","Birmingham 036E","E01009351","Total",1693,114,34,80,1579,220,82,282,122,152,382,339
"2011","Birmingham 036F","E01009354","Total",1467,167,60,107,1300,138,66,154,100,150,376,316
"2011","Birmingham 037A","E01008899","Total",1204,200,61,139,1004,127,42,192,104,171,247,121
"2011","Birmingham 037C","E01008901","Total",1686,171,60,111,1515,118,94,152,138,234,508,271
"2011","Birmingham 037E","E01008916","Total",1531,103,30,73,1428,142,44,222,104,374,377,165
"2011","Birmingham 037F","E01033636","Total",3385,153,74,79,3232,128,108,264,108,571,1465,588
"2011","Birmingham 038A","E01009079","Total",1629,278,42,236,1351,303,110,220,158,147,193,220
"2011","Birmingham 038B","E01009080","Total",1113,113,25,88,1000,207,34,236,86,124,175,138
"2011","Birmingham 038C","E01009081","Total",1301,232,89,143,1069,186,70,141,106,138,237,191
"2011","Birmingham 038D","E01009083","Total",1488,182,101,81,1306,280,78,237,110,158,247,196
"2011","Birmingham 039A","E01009275","Total",1576,114,38,76,1462,137,58,159,102,151,533,322
"2011","Birmingham 039B","E01009350","Total",1554,82,28,54,1472,154,64,218,68,191,442,335
"2011","Birmingham 039C","E01009352","Total",1703,105,28,77,1598,101,66,129,62,167,689,384
"2011","Birmingham 039D","E01009353","Total",1615,100,26,74,1515,72,82,128,78,167,609,379
"2011","Birmingham 039E","E01009355","Total",1575,181,35,146,1394,91,58,144,92,97,601,311
"2011","Birmingham 039H","E01033635","Total",2889,220,73,147,2669,271,134,494,186,255,734,595
"2011","Birmingham 040A","E01008905","Total",1701,72,16,56,1629,72,46,156,50,326,691,288
"2011","Birmingham 040B","E01008907","Total",1630,195,64,131,1435,147,46,183,126,221,459,253
"2011","Birmingham 040C","E01009047","Total",1804,182,60,122,1622,119,74,131,78,171,698,351
"2011","Birmingham 040D","E01009048","Total",1697,217,31,186,1480,86,50,162,98,130,608,346
"2011","Birmingham 040E","E01009062","Total",1729,108,34,74,1621,116,38,165,78,284,690,250
"2011","Birmingham 041D","E01008909","Total",1633,101,34,67,1532,160,38,206,90,363,497,178
"2011","Birmingham 041F","E01033628","Total",2430,245,105,140,2185,157,74,296,102,369,831,356
"2011","Birmingham 041G","E01033637","Total",2812,249,103,146,2563,207,100,274,120,427,964,471
"2011","Birmingham 042A","E01009084","Total",1742,103,58,45,1639,104,126,191,76,255,598,289
"2011","Birmingham 042B","E01009085","Total",1977,69,41,28,1908,79,116,132,94,286,851,350
"2011","Birmingham 042C","E01009087","Total",1514,154,90,64,1360,44,180,249,172,156,248,311
"2011","Birmingham 042D","E01009089","Total",1527,95,63,32,1432,68,138,265,92,203,359,307
"2011","Birmingham 042E","E01009090","Total",1797,120,61,59,1677,92,128,180,106,240,577,354
"2011","Birmingham 043A","E01009201","Total",1716,277,116,161,1439,176,112,193,148,219,354,237
"2011","Birmingham 043B","E01009202","Total",1503,205,61,144,1298,220,82,222,130,205,251,188
"2011","Birmingham 043C","E01009203","Total",2837,431,85,346,2406,611,78,587,178,357,379,216
"2011","Birmingham 044A","E01009082","Total",1411,114,54,60,1297,138,124,241,110,159,258,267
"2011","Birmingham 044B","E01009086","Total",1846,145,64,81,1701,82,146,266,126,262,505,314
"2011","Birmingham 044C","E01009480","Total",1756,145,72,73,1611,177,82,244,146,347,388,227
"2011","Birmingham 044D","E01009481","Total",2289,173,88,85,2116,124,96,291,132,454,691,328
"2011","Birmingham 044E","E01009486","Total",2004,132,40,92,1872,114,66,287,122,366,612,305
"2011","Birmingham 044F","E01009487","Total",2165,141,45,96,2024,98,70,245,92,397,872,250
"2011","Birmingham 045A","E01009088","Total",1610,267,153,114,1343,131,230,176,170,126,226,284
"2011","Birmingham 045B","E01009091","Total",1526,224,83,141,1302,136,160,274,210,91,213,218
"2011","Birmingham 045C","E01009305","Total",1610,308,100,208,1302,276,100,309,204,79,161,173
"2011","Birmingham 045D","E01009307","Total",1529,334,142,192,1195,219,154,261,184,55,111,211
"2011","Birmingham 045E","E01009309","Total",1365,288,104,184,1077,188,92,216,172,56,169,184
"2011","Birmingham 046A","E01009304","Total",1807,332,158,174,1475,186,138,353,240,81,256,221
"2011","Birmingham 046B","E01009306","Total",1550,232,119,113,1318,157,160,257,194,112,146,292
"2011","Birmingham 046C","E01009308","Total",1943,263,109,154,1680,280,138,414,210,192,239,207
"2011","Birmingham 046D","E01009310","Total",1858,268,123,145,1590,233,162,279,240,176,246,254
"2011","Birmingham 047A","E01009348","Total",1957,259,63,196,1698,251,94,324,284,155,262,328
"2011","Birmingham 047B","E01009358","Total",2009,252,43,209,1757,130,60,187,150,250,604,376
"2011","Birmingham 047C","E01009359","Total",1958,184,56,128,1774,205,84,276,206,198,365,440
"2011","Birmingham 047D","E01009360","Total",2432,267,61,206,2165,362,92,421,256,253,378,403
"2011","Birmingham 047E","E01009361","Total",2086,275,89,186,1811,305,88,450,188,150,344,286
"2011","Birmingham 048A","E01009478","Total",1835,207,65,142,1628,189,72,269,170,348,357,223
"2011","Birmingham 048B","E01009479","Total",2190,147,78,69,2043,118,62,196,100,478,740,349
"2011","Birmingham 048C","E01009482","Total",1721,107,28,79,1614,87,38,215,68,358,574,274
"2011","Birmingham 048D","E01009484","Total",1715,154,53,101,1561,141,46,181,82,290,623,198
"2011","Birmingham 048E","E01009485","Total",1835,103,35,68,1732,89,80,167,62,330,753,251
"2011","Birmingham 049A","E01008906","Total",1763,101,34,67,1662,123,42,208,48,365,651,225
"2011","Birmingham 049B","E01008911","Total",1609,195,30,165,1414,305,32,233,108,271,291,174
"2011","Birmingham 049D","E01009347","Total",1752,294,62,232,1458,289,90,258,196,158,218,249
"2011","Birmingham 049E","E01033559","Total",1262,374,8,366,888,44,8,105,602,0,14,115
"2011","Birmingham 049F","E01033638","Total",1747,260,71,189,1487,291,64,212,116,256,359,189
"2011","Birmingham 050A","E01008910","Total",1812,242,52,190,1570,245,24,291,104,258,460,188
"2011","Birmingham 050B","E01008913","Total",1481,339,61,278,1142,212,64,213,122,161,233,137
"2011","Birmingham 050C","E01008914","Total",2049,387,49,338,1662,322,30,315,238,181,224,352
"2011","Birmingham 050E","E01033561","Total",1111,212,46,166,899,135,16,81,184,61,150,272
"2011","Birmingham 050F","E01033617","Total",847,165,11,154,682,17,0,35,288,5,14,323
"2011","Birmingham 051A","E01009194","Total",2828,141,49,92,2687,140,36,210,80,503,1233,485
"2011","Birmingham 051B","E01009483","Total",1851,114,35,79,1737,148,52,204,88,312,728,205
"2011","Birmingham 051C","E01009488","Total",2157,181,71,110,1976,235,94,250,146,397,562,292
"2011","Birmingham 051D","E01009489","Total",1985,84,25,59,1901,154,58,240,100,428,645,276
"2011","Birmingham 051E","E01009491","Total",1794,101,33,68,1693,43,62,142,88,404,668,286
"2011","Birmingham 052B","E01009192","Total",2743,76,25,51,2667,118,76,185,80,460,1294,454
"2011","Birmingham 052D","E01009199","Total",1415,221,31,190,1194,131,30,311,144,135,250,193
"2011","Birmingham 052E","E01009204","Total",1793,280,66,214,1513,289,58,271,122,264,322,187
"2011","Birmingham 052F","E01033644","Total",2998,149,35,114,2849,241,70,245,144,492,1146,511
"2011","Birmingham 053A","E01009151","Total",2007,132,42,90,1875,151,76,291,130,344,564,319
"2011","Birmingham 053B","E01009152","Total",2163,177,42,135,1986,91,54,160,128,205,801,547
"2011","Birmingham 053C","E01009153","Total",2141,303,67,236,1838,213,100,209,256,146,408,506
"2011","Birmingham 053D","E01009345","Total",1497,145,38,107,1352,251,34,219,96,221,319,212
"2011","Birmingham 053E","E01009346","Total",1682,134,28,106,1548,176,44,288,114,232,438,256
"2011","Birmingham 054A","E01009092","Total",1675,181,62,119,1494,362,54,295,138,187,250,208
"2011","Birmingham 054B","E01009093","Total",1603,192,67,125,1411,287,88,400,184,123,136,193
"2011","Birmingham 054C","E01009094","Total",1429,131,39,92,1298,193,102,256,148,165,196,238
"2011","Birmingham 054D","E01009298","Total",1578,130,37,93,1448,283,78,305,162,123,297,200
"2011","Birmingham 054E","E01009311","Total",1658,126,44,82,1532,251,84,338,158,188,256,257
"2011","Birmingham 054F","E01009511","Total",1486,149,63,86,1337,156,100,169,98,186,411,217
"2011","Birmingham 055A","E01009475","Total",2072,129,47,82,1943,199,82,224,90,441,623,284
"2011","Birmingham 055B","E01009476","Total",1889,181,66,115,1708,76,70,200,74,500,575,213
"2011","Birmingham 055C","E01009477","Total",1692,132,46,86,1560,173,82,275,166,240,318,306
"2011","Birmingham 055D","E01009490","Total",1927,216,70,146,1711,175,84,250,148,265,515,274
"2011","Birmingham 055E","E01009492","Total",1754,131,43,88,1623,136,66,257,116,357,446,245
"2011","Birmingham 056A","E01009095","Total",1700,199,76,123,1501,97,132,291,146,219,368,248
"2011","Birmingham 056B","E01009507","Total",1486,270,107,163,1216,150,90,153,110,119,356,238
"2011","Birmingham 056C","E01009508","Total",1536,181,65,116,1355,89,166,234,156,174,242,294
"2011","Birmingham 056D","E01009509","Total",1743,226,55,171,1517,104,102,199,148,201,524,239
"2011","Birmingham 056E","E01009510","Total",1563,266,140,126,1297,149,166,192,120,153,227,290
"2011","Birmingham 057A","E01009297","Total",1606,263,122,141,1343,143,190,232,228,67,178,305
"2011","Birmingham 057B","E01009299","Total",1637,201,86,115,1436,193,108,252,160,159,246,318
"2011","Birmingham 057C","E01009300","Total",1803,206,80,126,1597,304,88,276,218,198,217,296
"2011","Birmingham 057D","E01009301","Total",1604,381,127,254,1223,197,138,267,214,81,141,185
"2011","Birmingham 057E","E01009303","Total",1479,309,98,211,1170,141,142,303,210,56,129,189
"2011","Birmingham 058A","E01009195","Total",2600,114,49,65,2486,160,70,269,132,589,948,318
"2011","Birmingham 058C","E01009197","Total",1673,77,23,54,1596,115,40,230,88,357,577,189
"2011","Birmingham 058D","E01009198","Total",1761,72,22,50,1689,143,38,196,78,534,525,175
"2011","Birmingham 058E","E01033647","Total",1398,81,27,54,1317,126,58,221,86,337,389,100
"2011","Birmingham 058F","E01033649","Total",1801,75,33,42,1726,108,40,264,78,466,565,205
"2011","Birmingham 060A","E01009138","Total",1646,122,36,86,1524,55,82,294,178,111,404,400
"2011","Birmingham 060B","E01009139","Total",1583,158,37,121,1425,97,80,262,184,125,291,386
"2011","Birmingham 060C","E01009140","Total",1900,272,61,211,1628,89,114,204,198,99,389,535
"2011","Birmingham 060D","E01009145","Total",1972,240,41,199,1732,123,70,315,166,160,433,465
"2011","Birmingham 060E","E01009147","Total",1556,305,29,276,1251,82,42,158,180,77,265,447
"2011","Birmingham 062A","E01009512","Total",1616,152,68,84,1464,167,136,271,170,141,288,291
"2011","Birmingham 062B","E01009514","Total",1444,228,86,142,1216,181,84,197,114,122,257,261
"2011","Birmingham 062C","E01009516","Total",1394,144,71,73,1250,92,110,250,158,129,264,247
"2011","Birmingham 062D","E01009517","Total",1707,204,102,102,1503,129,86,363,176,140,300,309
"2011","Birmingham 063A","E01009325","Total",1797,89,30,59,1708,140,88,178,74,369,638,221
"2011","Birmingham 063D","E01009342","Total",1638,81,35,46,1557,62,62,175,68,244,624,322
"2011","Birmingham 063E","E01009343","Total",1706,135,40,95,1571,139,54,235,112,309,466,256
"2011","Birmingham 063F","E01033642","Total",3105,139,65,74,2966,212,128,350,126,568,1148,434
"2011","Birmingham 064A","E01008986","Total",1755,407,41,366,1348,117,56,271,324,80,177,323
"2011","Birmingham 064B","E01008987","Total",1540,256,89,167,1284,74,52,117,206,55,120,660
"2011","Birmingham 064C","E01008988","Total",1965,503,50,453,1462,56,42,207,400,81,289,387
"2011","Birmingham 064D","E01008989","Total",1597,539,128,411,1058,105,70,215,334,22,116,196
"2011","Birmingham 064E","E01008990","Total",1037,160,65,95,877,15,116,169,224,69,103,181
"2011","Birmingham 064F","E01008991","Total",1495,150,80,70,1345,27,248,331,162,76,251,250
"2011","Birmingham 066A","E01008882","Total",1747,238,88,150,1509,209,92,336,150,227,217,278
"2011","Birmingham 066B","E01008896","Total",1575,161,49,112,1414,150,88,271,120,243,291,251
"2011","Birmingham 066C","E01008898","Total",1674,146,55,91,1528,136,94,297,116,249,440,196
"2011","Birmingham 066D","E01009326","Total",1919,123,54,69,1796,138,68,221,108,412,537,312
"2011","Birmingham 066E","E01009341","Total",1554,165,53,112,1389,168,92,213,114,233,398,171
"2011","Birmingham 066F","E01009513","Total",1720,178,76,102,1542,134,88,279,150,270,345,276
"2011","Birmingham 067A","E01008881","Total",1599,216,104,112,1383,138,136,180,150,195,298,286
"2011","Birmingham 067B","E01008897","Total",1686,158,62,96,1528,80,124,223,168,219,384,330
"2011","Birmingham 067C","E01009515","Total",1521,240,115,125,1281,71,180,186,156,81,334,273
"2011","Birmingham 067D","E01009518","Total",1589,256,138,118,1333,84,166,206,224,93,259,301
"2011","Birmingham 067E","E01009521","Total",1640,146,67,79,1494,81,150,284,200,123,257,399
"2011","Birmingham 069A","E01009302","Total",1422,194,94,100,1228,103,222,208,224,52,122,297
"2011","Birmingham 069B","E01009314","Total",1561,219,128,91,1342,144,180,223,194,99,232,270
"2011","Birmingham 069C","E01009321","Total",1840,286,148,138,1554,303,132,326,192,137,231,233
"2011","Birmingham 069D","E01009322","Total",1386,229,84,145,1157,168,78,232,180,90,236,173
"2011","Birmingham 069E","E01009323","Total",1471,169,92,77,1302,119,128,218,162,124,281,270
"2011","Birmingham 070A","E01009329","Total",2341,159,38,121,2182,129,58,194,124,287,946,444
"2011","Birmingham 070B","E01009334","Total",1884,76,44,32,1808,56,54,110,30,251,941,366
"2011","Birmingham 070C","E01009337","Total",1788,117,27,90,1671,87,36,185,60,415,622,266
"2011","Birmingham 070D","E01009338","Total",1556,73,22,51,1483,94,40,162,72,233,607,275
"2011","Birmingham 070E","E01009380","Total",1700,92,26,66,1608,155,44,186,94,322,606,201
"2011","Birmingham 071A","E01009362","Total",1316,216,33,183,1100,147,40,188,92,197,265,171
"2011","Birmingham 071B","E01009363","Total",1544,198,57,141,1346,102,70,205,118,192,409,250
"2011","Birmingham 071C","E01009364","Total",1329,185,23,162,1144,233,50,181,92,186,247,155
"2011","Birmingham 071D","E01009365","Total",1669,190,41,149,1479,102,52,110,120,221,522,352
"2011","Birmingham 071E","E01009379","Total",1663,347,156,191,1316,105,100,136,98,221,445,211
"2011","Birmingham 072A","E01009312","Total",1576,168,108,60,1408,66,180,263,166,122,264,347
"2011","Birmingham 072B","E01009324","Total",1641,228,131,97,1413,130,214,292,258,46,189,284
"2011","Birmingham 072C","E01009519","Total",1519,145,79,66,1374,74,196,335,180,75,157,357
"2011","Birmingham 072D","E01009520","Total",1752,222,119,103,1530,61,198,311,216,96,310,338
"2011","Birmingham 073A","E01009066","Total",1508,180,81,99,1328,4,178,297,178,87,234,350
"2011","Birmingham 073B","E01009070","Total",1613,231,93,138,1382,48,152,393,256,113,162,258
"2011","Birmingham 073C","E01009252","Total",1497,180,57,123,1317,36,146,309,278,72,196,280
"2011","Birmingham 073D","E01009260","Total",1530,233,137,96,1297,21,206,206,164,70,270,360
"2011","Birmingham 073E","E01009261","Total",1607,195,109,86,1412,76,178,311,238,101,165,343
"2011","Birmingham 074A","E01008984","Total",1767,363,108,255,1404,81,84,243,156,84,172,584
"2011","Birmingham 074B","E01008994","Total",1437,261,87,174,1176,50,118,214,284,86,117,307
"2011","Birmingham 074C","E01008996","Total",1570,227,89,138,1343,157,106,196,88,172,415,209
"2011","Birmingham 074D","E01008997","Total",1445,195,59,136,1250,71,150,226,192,103,217,291
"2011","Birmingham 075A","E01009065","Total",1581,207,73,134,1374,48,130,420,246,112,158,260
"2011","Birmingham 075B","E01009067","Total",1465,259,113,146,1206,47,130,342,298,77,128,184
"2011","Birmingham 075C","E01009068","Total",1543,271,89,182,1272,40,92,276,332,65,81,386
"2011","Birmingham 075D","E01009069","Total",1564,342,105,237,1222,53,104,264,472,40,26,263
"2011","Birmingham 075E","E01009072","Total",1599,318,95,223,1281,61,102,258,450,65,88,257
"2011","Birmingham 076A","E01008885","Total",1308,117,64,53,1191,115,114,260,172,72,179,279
"2011","Birmingham 076B","E01008886","Total",1564,282,115,167,1282,146,118,292,230,102,144,250
"2011","Birmingham 076C","E01008888","Total",1658,158,67,91,1500,85,128,351,232,135,270,299
"2011","Birmingham 076D","E01009313","Total",1571,178,82,96,1393,119,190,299,150,78,226,331
"2011","Birmingham 077A","E01009368","Total",1465,137,27,110,1328,66,22,122,62,151,641,264
"2011","Birmingham 077D","E01009371","Total",1777,86,21,65,1691,120,38,209,76,276,653,319
"2011","Birmingham 077E","E01009397","Total",1759,67,15,52,1692,156,52,152,82,259,651,340
"2011","Birmingham 077F","E01033650","Total",2596,132,60,72,2464,91,84,256,96,474,1028,435
"2011","Birmingham 078A","E01008883","Total",1797,180,74,106,1617,138,102,347,164,224,298,344
"2011","Birmingham 078B","E01008884","Total",1870,205,78,127,1665,265,50,341,184,224,340,261
"2011","Birmingham 078C","E01008887","Total",1475,199,72,127,1276,179,92,271,218,137,163,216
"2011","Birmingham 078D","E01008889","Total",1666,242,82,160,1424,81,122,250,186,208,329,248
"2011","Birmingham 079A","E01008982","Total",1336,307,54,253,1029,43,66,180,290,65,95,290
"2011","Birmingham 079C","E01008992","Total",1175,161,66,95,1014,13,122,205,188,77,192,217
"2011","Birmingham 079E","E01009283","Total",1448,182,50,132,1266,75,96,303,246,51,152,343
"2011","Birmingham 079F","E01033631","Total",2106,263,59,204,1843,10,182,292,354,117,310,578
"2011","Birmingham 080A","E01009249","Total",1586,146,77,69,1440,128,190,341,218,131,153,279
"2011","Birmingham 080B","E01009250","Total",1615,183,71,112,1432,135,226,249,258,88,188,288
"2011","Birmingham 080C","E01009251","Total",1499,150,82,68,1349,63,184,299,284,67,154,298
"2011","Birmingham 080D","E01009253","Total",1540,145,68,77,1395,94,190,323,226,81,179,302
"2011","Birmingham 080E","E01009255","Total",1553,175,84,91,1378,156,112,301,210,138,166,295
"2011","Birmingham 080F","E01009257","Total",1522,165,68,97,1357,145,138,288,158,185,188,255
"2011","Birmingham 081A","E01009315","Total",1580,314,142,172,1266,81,294,218,210,67,100,296
"2011","Birmingham 081B","E01009316","Total",1647,207,88,119,1440,93,158,292,246,107,238,306
"2011","Birmingham 081C","E01009317","Total",1670,259,99,160,1411,234,178,276,242,64,156,261
"2011","Birmingham 081D","E01009318","Total",1533,157,77,80,1376,87,174,289,248,97,174,307
"2011","Birmingham 081E","E01009319","Total",1634,163,65,98,1471,57,170,311,258,94,202,379
"2011","Birmingham 081F","E01009320","Total",1544,149,76,73,1395,62,190,266,190,111,202,374
"2011","Birmingham 082A","E01009372","Total",1822,50,19,31,1772,56,38,197,72,366,743,300
"2011","Birmingham 082B","E01009373","Total",1838,77,34,43,1761,62,50,224,76,342,710,297
"2011","Birmingham 082D","E01009396","Total",2153,80,17,63,2073,42,54,78,64,247,1120,468
"2011","Birmingham 082F","E01033643","Total",3083,147,59,88,2936,208,92,316,154,525,1150,491
"2011","Birmingham 083A","E01009367","Total",1634,146,43,103,1488,63,54,174,98,210,597,292
"2011","Birmingham 083B","E01009375","Total",1899,120,29,91,1779,99,30,210,82,356,712,290
"2011","Birmingham 083C","E01009377","Total",1366,138,27,111,1228,150,46,156,98,315,293,170
"2011","Birmingham 083D","E01009383","Total",1452,114,25,89,1338,52,46,86,90,172,517,375
"2011","Birmingham 083E","E01009399","Total",1590,64,28,36,1526,87,38,194,86,377,470,274
"2011","Birmingham 084A","E01009366","Total",1581,151,47,104,1430,76,68,206,134,288,488,170
"2011","Birmingham 084B","E01009374","Total",1147,164,46,118,983,120,62,88,78,181,298,156
"2011","Birmingham 084C","E01009376","Total",1665,210,54,156,1455,142,52,151,124,204,560,222
"2011","Birmingham 084F","E01033648","Total",2712,253,46,207,2459,149,68,275,174,326,1048,419
"2011","Birmingham 085A","E01009073","Total",1614,183,43,140,1431,445,64,324,148,138,158,154
"2011","Birmingham 085B","E01009074","Total",1672,229,50,179,1443,249,76,247,176,183,280,232
"2011","Birmingham 085C","E01009254","Total",1558,235,102,133,1323,123,166,271,190,49,217,307
"2011","Birmingham 085D","E01009256","Total",1565,202,86,116,1363,153,154,302,228,66,222,238
"2011","Birmingham 085E","E01009258","Total",1526,248,106,142,1278,230,112,222,152,112,243,207
"2011","Birmingham 087B","E01009071","Total",1568,374,171,203,1194,90,154,249,254,71,121,255
"2011","Birmingham 087C","E01009075","Total",1634,441,171,270,1193,113,110,168,194,71,90,447
"2011","Birmingham 087E","E01009078","Total",1433,212,65,147,1221,70,82,211,256,48,56,498
"2011","Birmingham 087F","E01033562","Total",2460,367,111,256,2093,115,194,404,334,79,222,745
"2011","Birmingham 088C","E01009183","Total",1604,150,44,106,1454,22,126,234,214,100,370,388
"2011","Birmingham 088D","E01009186","Total",1699,264,81,183,1435,51,146,361,354,89,175,259
"2011","Birmingham 088E","E01033645","Total",3383,171,47,124,3212,133,70,256,150,399,1437,767
"2011","Birmingham 089A","E01008890","Total",1698,267,79,188,1431,110,72,291,254,164,294,246
"2011","Birmingham 089B","E01008891","Total",1560,237,88,149,1323,103,148,309,232,93,157,281
"2011","Birmingham 089C","E01008892","Total",1527,106,31,75,1421,151,86,229,160,154,336,305
"2011","Birmingham 089D","E01008893","Total",1704,261,57,204,1443,83,100,315,264,153,211,317
"2011","Birmingham 089E","E01008894","Total",1318,359,140,219,959,52,86,123,178,49,246,225
"2011","Birmingham 089F","E01008895","Total",1822,240,51,189,1582,113,98,396,350,137,216,272
"2011","Birmingham 089G","E01009015","Total",1710,335,123,212,1375,99,122,298,246,98,237,275
"2011","Birmingham 090A","E01009014","Total",2023,134,49,85,1889,162,102,335,182,294,428,386
"2011","Birmingham 090B","E01009018","Total",1591,275,96,179,1316,111,170,162,192,86,281,314
"2011","Birmingham 090C","E01009026","Total",1578,147,45,102,1431,265,88,287,150,200,261,180
"2011","Birmingham 090D","E01009028","Total",1790,160,61,99,1630,195,114,320,162,282,324,233
"2011","Birmingham 090E","E01009029","Total",1517,138,61,77,1379,147,72,276,130,191,313,250
"2011","Birmingham 092A","E01009182","Total",1546,361,43,318,1185,66,52,130,132,42,457,306
"2011","Birmingham 092B","E01009184","Total",1544,328,79,249,1216,34,46,178,332,71,262,293
"2011","Birmingham 092C","E01009187","Total",1513,303,109,194,1210,34,138,227,214,115,241,241
"2011","Birmingham 092D","E01009188","Total",1523,270,78,192,1253,50,98,274,224,83,257,267
"2011","Birmingham 092E","E01009384","Total",1325,421,98,323,904,92,24,124,254,79,163,168
"2011","Birmingham 092F","E01009385","Total",1231,301,67,234,930,48,52,110,290,57,181,192
"2011","Birmingham 093A","E01009185","Total",1595,323,111,212,1272,32,124,210,288,46,225,347
"2011","Birmingham 093B","E01009389","Total",1741,93,23,70,1648,40,120,116,74,110,764,424
"2011","Birmingham 093C","E01009390","Total",1465,328,24,304,1137,83,40,108,236,71,417,182
"2011","Birmingham 093D","E01009394","Total",1719,383,84,299,1336,47,78,125,260,106,479,241
"2011","Birmingham 094A","E01008918","Total",1726,328,127,201,1398,196,116,252,168,142,327,197
"2011","Birmingham 094B","E01008920","Total",1389,124,66,58,1265,122,150,301,200,57,153,282
"2011","Birmingham 094C","E01008921","Total",1426,205,72,133,1221,126,142,225,230,87,131,280
"2011","Birmingham 094D","E01008931","Total",1439,245,84,161,1194,194,104,267,180,102,174,173
"2011","Birmingham 094E","E01009259","Total",1599,222,74,148,1377,265,122,245,162,119,231,233
"2011","Birmingham 095A","E01008919","Total",1573,268,119,149,1305,140,106,294,224,93,171,277
"2011","Birmingham 095B","E01009064","Total",1477,181,65,116,1296,144,122,297,176,80,216,261
"2011","Birmingham 095C","E01009077","Total",1676,206,85,121,1470,110,214,376,268,86,131,285
"2011","Birmingham 095D","E01009291","Total",1537,164,60,104,1373,174,118,333,226,76,180,266
"2011","Birmingham 095E","E01009500","Total",1529,209,76,133,1320,164,120,269,196,149,187,235
"2011","Birmingham 096A","E01009284","Total",1830,153,46,107,1677,73,100,123,244,55,102,980
"2011","Birmingham 096C","E01009286","Total",2191,55,25,30,2136,23,24,61,48,47,41,1892
"2011","Birmingham 096E","E01009289","Total",2096,86,29,57,2010,41,28,45,96,10,93,1697
"2011","Birmingham 096F","E01009290","Total",2000,49,18,31,1951,8,22,39,66,32,47,1737
"2011","Birmingham 096G","E01033634","Total",3292,90,22,68,3202,93,16,94,158,57,54,2730
"2011","Birmingham 097A","E01009017","Total",1669,93,51,42,1576,77,106,166,108,226,546,347
"2011","Birmingham 097B","E01009043","Total",1964,191,94,97,1773,106,122,222,140,215,553,415
"2011","Birmingham 097C","E01009044","Total",1624,96,32,64,1528,70,80,189,80,257,533,319
"2011","Birmingham 097D","E01009045","Total",1712,180,103,77,1532,89,130,232,102,184,436,359
"2011","Birmingham 097E","E01009046","Total",1794,157,112,45,1637,36,130,259,154,224,411,423
"2011","Birmingham 097F","E01009395","Total",1664,213,36,177,1451,68,92,146,92,189,573,291
"2011","Birmingham 098A","E01009016","Total",1559,354,186,168,1205,68,130,241,174,113,225,254
"2011","Birmingham 098B","E01009022","Total",1742,146,65,81,1596,118,102,277,160,138,387,414
"2011","Birmingham 098C","E01009023","Total",1673,109,63,46,1564,130,124,304,160,219,246,381
"2011","Birmingham 098D","E01009030","Total",1475,99,56,43,1376,56,150,206,96,107,387,374
"2011","Birmingham 099A","E01009281","Total",1358,278,148,130,1080,52,168,327,186,62,65,220
"2011","Birmingham 099B","E01009292","Total",1648,169,54,115,1479,44,156,360,270,111,136,402
"2011","Birmingham 099C","E01009294","Total",1819,263,90,173,1556,180,186,354,296,135,119,286
"2011","Birmingham 099D","E01009295","Total",1723,254,155,99,1469,63,118,172,148,104,158,706
"2011","Birmingham 100A","E01009280","Total",1312,194,71,123,1118,75,112,258,210,77,99,287
"2011","Birmingham 100B","E01009282","Total",1534,209,74,135,1325,79,90,249,240,85,133,449
"2011","Birmingham 100C","E01009288","Total",993,139,54,85,854,35,162,122,148,67,78,242
"2011","Birmingham 100D","E01009293","Total",1516,172,74,98,1344,52,96,200,248,77,172,499
"2011","Birmingham 100E","E01009296","Total",1475,176,47,129,1299,71,62,176,250,48,190,502
"2011","Birmingham 101A","E01008924","Total",1370,221,76,145,1149,89,172,255,210,58,159,206
"2011","Birmingham 101B","E01009501","Total",1564,190,69,121,1374,250,106,225,172,89,236,296
"2011","Birmingham 101C","E01009502","Total",1508,240,107,133,1268,182,130,225,166,177,189,199
"2011","Birmingham 101D","E01009503","Total",1541,175,63,112,1366,181,102,266,206,120,208,283
"2011","Birmingham 101E","E01009505","Total",1651,238,109,129,1413,199,142,276,178,133,186,299
"2011","Birmingham 102A","E01008917","Total",1335,125,49,76,1210,89,102,240,196,71,198,314
"2011","Birmingham 102B","E01008923","Total",1340,260,98,162,1080,193,128,239,176,95,115,134
"2011","Birmingham 102C","E01008925","Total",1301,103,34,69,1198,51,134,258,222,54,168,311
"2011","Birmingham 102D","E01008927","Total",1389,262,80,182,1127,191,98,188,172,84,162,232
"2011","Birmingham 102E","E01008928","Total",1485,272,116,156,1213,193,152,202,158,96,199,213
"2011","Birmingham 103A","E01009019","Total",1611,193,58,135,1418,177,78,327,158,109,330,239
"2011","Birmingham 103B","E01009020","Total",1511,140,76,64,1371,98,122,248,184,125,290,304
"2011","Birmingham 103C","E01009021","Total",1620,198,69,129,1422,216,98,366,208,123,225,186
"2011","Birmingham 103D","E01009024","Total",1600,169,59,110,1431,186,120,293,158,128,262,284
"2011","Birmingham 103E","E01009025","Total",1514,188,79,109,1326,131,86,282,150,113,338,226
"2011","Birmingham 103F","E01009033","Total",1770,203,55,148,1567,186,98,266,194,201,315,307
"2011","Birmingham 104A","E01009175","Total",1462,163,36,127,1299,67,82,287,276,104,165,318
"2011","Birmingham 104B","E01009177","Total",1578,215,61,154,1363,62,64,355,290,138,220,234
"2011","Birmingham 104C","E01009178","Total",1594,248,90,158,1346,135,52,313,332,94,176,244
"2011","Birmingham 104D","E01009179","Total",1720,180,83,97,1540,35,176,296,196,137,299,401
"2011","Birmingham 104E","E01009189","Total",1491,186,62,124,1305,79,108,340,224,83,223,248
"2011","Birmingham 105A","E01008933","Total",1556,121,46,75,1435,97,124,263,154,128,296,373
"2011","Birmingham 105B","E01008934","Total",1405,166,88,78,1239,77,138,196,152,91,253,332
"2011","Birmingham 105C","E01009031","Total",1653,170,84,86,1483,34,164,275,146,102,406,356
"2011","Birmingham 105D","E01009037","Total",1620,249,137,112,1371,50,192,263,218,136,166,346
"2011","Birmingham 105E","E01009176","Total",1650,233,105,128,1417,88,168,223,186,76,339,337
"2011","Birmingham 106C","E01008929","Total",1461,291,122,169,1170,154,114,287,154,119,132,210
"2011","Birmingham 106D","E01008930","Total",1498,156,45,111,1342,176,78,343,246,101,132,266
"2011","Birmingham 106E","E01009495","Total",1225,136,58,78,1089,168,118,206,148,107,144,198
"2011","Birmingham 106F","E01033629","Total",2402,385,162,223,2017,275,248,466,266,81,288,393
"2011","Birmingham 107A","E01008953","Total",1564,186,48,138,1378,124,112,333,240,70,244,255
"2011","Birmingham 107B","E01008963","Total",1357,197,65,132,1160,97,92,262,206,72,243,188
"2011","Birmingham 107C","E01008964","Total",1418,239,108,131,1179,85,118,256,234,100,166,220
"2011","Birmingham 107D","E01008965","Total",1499,131,52,79,1368,60,126,293,276,114,186,313
"2011","Birmingham 107E","E01008966","Total",1674,245,92,153,1429,145,98,344,210,127,258,247
"2011","Birmingham 108A","E01009032","Total",1794,120,71,49,1674,69,148,255,148,152,461,441
"2011","Birmingham 108B","E01009034","Total",1662,98,55,43,1564,43,148,225,142,140,468,398
"2011","Birmingham 108C","E01009035","Total",1812,139,72,67,1673,93,138,296,200,222,323,401
"2011","Birmingham 108D","E01009036","Total",1514,125,57,68,1389,45,182,238,152,112,333,327
"2011","Birmingham 109A","E01009494","Total",1626,168,89,79,1458,332,136,268,120,140,220,242
"2011","Birmingham 109B","E01009496","Total",1481,173,111,62,1308,67,244,227,184,66,156,364
"2011","Birmingham 109C","E01009497","Total",1767,226,96,130,1541,135,152,382,244,157,217,254
"2011","Birmingham 109D","E01009504","Total",1443,183,111,72,1260,50,242,293,180,108,139,248
"2011","Birmingham 109E","E01009506","Total",1494,173,107,66,1321,49,262,257,192,73,176,312
"2011","Birmingham 110A","E01008967","Total",1679,185,91,94,1494,63,234,276,186,113,251,371
"2011","Birmingham 110B","E01008968","Total",1707,217,137,80,1490,52,160,416,222,88,213,339
"2011","Birmingham 110C","E01008970","Total",1541,164,61,103,1377,227,140,293,178,145,188,206
"2011","Birmingham 110D","E01008981","Total",1511,145,63,82,1366,21,190,332,198,115,215,295
"2011","Birmingham 111A","E01008932","Total",1544,252,84,168,1292,115,124,198,222,186,212,235
"2011","Birmingham 111B","E01008935","Total",1628,257,99,158,1371,177,88,243,188,156,277,242
"2011","Birmingham 111C","E01008936","Total",1563,229,100,129,1334,110,152,165,148,117,320,322
"2011","Birmingham 111D","E01008938","Total",1593,151,51,100,1442,169,102,247,158,178,244,344
"2011","Birmingham 111E","E01008939","Total",1543,235,100,135,1308,143,124,297,212,98,183,251
"2011","Birmingham 112A","E01008951","Total",1420,164,95,69,1256,92,112,369,184,99,141,259
"2011","Birmingham 112B","E01008952","Total",1595,299,58,241,1296,113,52,275,370,46,143,297
"2011","Birmingham 112C","E01008955","Total",1512,214,66,148,1298,66,108,319,312,47,141,305
"2011","Birmingham 112D","E01008956","Total",1463,158,96,62,1305,59,116,396,206,104,167,257
"2011","Birmingham 112E","E01008957","Total",1570,243,50,193,1327,130,64,294,310,92,137,300
"2011","Birmingham 113A","E01008950","Total",1431,305,119,186,1126,65,258,218,192,74,94,225
"2011","Birmingham 113B","E01008954","Total",1357,173,96,77,1184,76,218,203,188,76,146,277
"2011","Birmingham 113C","E01008958","Total",1549,365,213,152,1184,114,162,213,216,55,161,263
"2011","Birmingham 113D","E01009493","Total",1470,399,50,349,1071,194,36,278,270,53,53,187
"2011","Birmingham 115A","E01008937","Total",1426,215,102,113,1211,87,158,174,178,88,255,271
"2011","Birmingham 115B","E01008940","Total",1453,184,58,126,1269,224,118,237,176,106,184,224
"2011","Birmingham 115C","E01008941","Total",1522,161,84,77,1361,177,130,221,154,171,235,273
"2011","Birmingham 115D","E01008944","Total",1697,235,85,150,1462,174,172,347,236,112,150,271
"2011","Birmingham 116A","E01008959","Total",1710,295,169,126,1415,130,200,327,226,118,154,260
"2011","Birmingham 116B","E01008960","Total",1606,162,57,105,1444,79,72,404,274,138,199,278
"2011","Birmingham 116C","E01008961","Total",1451,331,105,226,1120,66,128,197,278,88,130,233
"2011","Birmingham 116D","E01008962","Total",1906,279,81,198,1627,268,112,389,262,178,151,267
"2011","Birmingham 117A","E01008942","Total",1597,170,73,97,1427,178,92,263,174,183,206,331
"2011","Birmingham 117B","E01008943","Total",1429,147,64,83,1282,141,94,275,208,79,187,298
"2011","Birmingham 117C","E01008969","Total",1646,208,109,99,1438,59,136,412,316,121,156,238
"2011","Birmingham 117D","E01008971","Total",1691,219,92,127,1472,135,160,275,266,133,220,283
"2011","Birmingham 118A","E01008972","Total",1780,228,82,146,1552,210,122,334,240,123,220,303
"2011","Birmingham 118B","E01008973","Total",1882,297,97,200,1585,146,172,426,296,79,190,276
"2011","Birmingham 118C","E01008974","Total",2876,327,73,254,2549,247,178,777,404,203,321,419
"2011","Birmingham 118D","E01008975","Total",1513,209,112,97,1304,66,170,297,284,66,163,258
"2011","Birmingham 119A","E01009172","Total",1413,157,72,85,1256,143,116,239,152,142,224,240
"2011","Birmingham 119B","E01009173","Total",1733,182,60,122,1551,195,74,283,242,190,304,263
"2011","Birmingham 119C","E01009174","Total",1255,189,56,133,1066,194,66,215,160,90,148,193
"2011","Birmingham 119D","E01009498","Total",1636,208,71,137,1428,243,114,301,234,66,209,261
"2011","Birmingham 119E","E01009499","Total",1740,175,64,111,1565,172,118,319,224,120,298,314
"2011","Birmingham 120A","E01009205","Total",1524,163,79,84,1361,80,180,267,208,112,194,320
"2011","Birmingham 120B","E01009206","Total",1624,173,97,76,1451,62,222,301,204,121,212,329
"2011","Birmingham 120C","E01009211","Total",1442,252,72,180,1190,52,120,267,262,42,126,321
"2011","Birmingham 120D","E01009218","Total",1490,198,132,66,1292,21,200,350,214,119,162,226
"2011","Birmingham 120E","E01009219","Total",1539,141,60,81,1398,219,146,297,232,88,188,228
"2011","Birmingham 121A","E01008976","Total",1541,252,126,126,1289,156,162,266,168,111,161,265
"2011","Birmingham 121B","E01008978","Total",1352,413,119,294,939,262,88,198,124,65,98,104
"2011","Birmingham 121C","E01008979","Total",1601,327,129,198,1274,176,164,237,192,91,140,274
"2011","Birmingham 121D","E01008980","Total",1621,256,106,150,1365,156,144,241,144,168,257,255
"2011","Birmingham 122A","E01008945","Total",1830,229,75,154,1601,165,136,303,248,171,250,328
"2011","Birmingham 122B","E01008946","Total",1485,233,107,126,1252,80,124,263,208,73,225,279
"2011","Birmingham 122C","E01008947","Total",1351,150,54,96,1201,86,92,280,192,136,121,294
"2011","Birmingham 122D","E01008948","Total",1459,166,94,72,1293,95,206,278,250,63,90,311
"2011","Birmingham 122E","E01008949","Total",1262,118,55,63,1144,45,170,272,184,35,138,300
"2011","Birmingham 123A","E01008977","Total",1551,240,67,173,1311,118,110,379,300,69,110,225
"2011","Birmingham 123B","E01009109","Total",1368,138,24,114,1230,389,42,207,124,201,150,117
"2011","Birmingham 123C","E01009119","Total",1378,241,113,128,1137,96,146,234,214,65,137,245
"2011","Birmingham 123D","E01009120","Total",1398,205,71,134,1193,145,138,276,232,54,108,240
"2011","Birmingham 124A","E01009162","Total",1588,164,90,74,1424,149,142,313,250,58,177,335
"2011","Birmingham 124B","E01009207","Total",1639,164,79,85,1475,61,180,338,272,93,219,312
"2011","Birmingham 124C","E01009208","Total",1531,144,65,79,1387,46,190,351,218,86,186,310
"2011","Birmingham 124D","E01009209","Total",2128,323,115,208,1805,199,210,407,378,78,190,343
"2011","Birmingham 124E","E01009213","Total",1477,268,124,144,1209,82,212,211,214,111,118,261
"2011","Birmingham 125B","E01009155","Total",1356,226,88,138,1130,155,98,152,226,74,170,255
"2011","Birmingham 125D","E01009157","Total",1510,211,62,149,1299,168,142,222,168,153,208,238
"2011","Birmingham 125E","E01009160","Total",1586,302,61,241,1284,270,86,287,194,80,176,191
"2011","Birmingham 125F","E01009161","Total",1412,202,76,126,1210,112,154,265,214,65,196,204
"2011","Birmingham 125G","E01033633","Total",2336,323,113,210,2013,240,186,391,326,218,279,373
"2011","Birmingham 126A","E01009117","Total",2060,279,104,175,1781,355,92,422,162,296,221,233
"2011","Birmingham 126B","E01009210","Total",1851,247,92,155,1604,189,162,358,288,113,196,298
"2011","Birmingham 126C","E01009212","Total",1678,286,101,185,1392,193,168,328,196,90,163,254
"2011","Birmingham 126D","E01009214","Total",1652,351,139,212,1301,201,110,280,206,101,195,208
"2011","Birmingham 126E","E01009215","Total",1649,439,145,294,1210,228,110,247,262,69,99,195
"2011","Birmingham 127A","E01009108","Total",1329,154,75,79,1175,88,204,175,206,105,157,240
"2011","Birmingham 127B","E01009111","Total",1380,128,47,81,1252,91,136,272,206,62,124,361
"2011","Birmingham 127C","E01009112","Total",1418,191,99,92,1227,148,170,222,170,95,204,218
"2011","Birmingham 127D","E01009116","Total",1412,157,113,44,1255,16,222,226,200,78,242,271
"2011","Birmingham 127E","E01009118","Total",1469,243,82,161,1226,81,180,265,248,41,190,221
"2011","Birmingham 128A","E01009107","Total",1741,350,106,244,1391,367,84,300,208,96,150,186
"2011","Birmingham 128B","E01009110","Total",1549,209,68,141,1340,182,108,308,218,72,180,272
"2011","Birmingham 128C","E01009113","Total",1518,249,122,127,1269,195,96,200,134,169,298,177
"2011","Birmingham 128D","E01009114","Total",1571,231,90,141,1340,176,144,242,228,106,176,268
"2011","Birmingham 128E","E01009115","Total",1405,204,82,122,1201,117,164,213,204,87,139,277
"2011","Birmingham 129A","E01009158","Total",1829,223,59,164,1606,202,134,466,240,128,167,269
"2011","Birmingham 129B","E01009163","Total",1446,207,92,115,1239,209,148,226,202,44,188,222
"2011","Birmingham 129C","E01009165","Total",1352,300,91,209,1052,144,78,259,210,91,125,145
"2011","Birmingham 129D","E01009169","Total",1680,179,78,101,1501,130,176,440,208,93,208,246
"2011","Birmingham 130A","E01009159","Total",1742,227,80,147,1515,126,120,400,330,92,157,290
"2011","Birmingham 130B","E01009164","Total",1484,187,71,116,1297,112,148,316,242,73,140,266
"2011","Birmingham 130C","E01009167","Total",1550,153,65,88,1397,87,106,397,216,121,194,276
"2011","Birmingham 130D","E01009171","Total",1591,240,106,134,1351,147,122,352,212,128,158,232
"2011","Birmingham 131A","E01009166","Total",1319,163,71,92,1156,149,102,254,212,100,119,220
"2011","Birmingham 131B","E01009168","Total",1489,165,65,100,1324,91,172,276,224,69,208,284
"2011","Birmingham 131C","E01009170","Total",1483,178,87,91,1305,68,166,322,230,63,156,300
"2011","Birmingham 131D","E01009216","Total",1968,240,100,140,1728,176,204,385,216,123,210,414
"2011","Birmingham 131E","E01009217","Total",1630,138,64,74,1492,81,236,361,250,74,206,284
"2011","Birmingham 132A","E01009039","Total",1705,159,89,70,1546,52,170,411,200,141,229,343
"2011","Birmingham 132B","E01009040","Total",1747,130,69,61,1617,57,182,368,214,131,344,321
"2011","Birmingham 132C","E01009041","Total",1661,143,61,82,1518,76,124,399,254,131,234,300
"2011","Birmingham 132D","E01009042","Total",1379,110,53,57,1269,123,108,334,236,69,142,257
"2011","Birmingham 132E","E01032589","Total",1399,201,114,87,1198,78,126,238,158,95,214,289
"2011","Birmingham 133A","E01009262","Total",1723,116,35,81,1607,48,76,194,112,98,570,509
"2011","Birmingham 133B","E01009267","Total",1734,150,94,56,1584,25,142,178,90,83,505,561
"2011","Birmingham 133C","E01009276","Total",1618,111,66,45,1507,50,122,174,116,106,439,500
"2011","Birmingham 133D","E01009278","Total",1729,98,41,57,1631,72,98,211,116,133,500,501
"2011","Birmingham 133E","E01009279","Total",1507,78,42,36,1429,54,78,224,88,117,441,427
"2011","Birmingham 133F","E01032591","Total",1645,71,43,28,1574,37,142,156,94,81,577,487
"2011","Birmingham 134A","E01008995","Total",1425,376,98,278,1049,201,80,180,180,142,107,159
"2011","Birmingham 134B","E01033557","Total",1362,416,8,408,946,10,10,135,648,5,17,121
"2011","Birmingham 134C","E01033624","Total",984,202,30,172,782,154,18,91,296,38,67,118
"2011","Birmingham 134D","E01033626","Total",1069,248,37,211,821,102,28,120,304,59,53,155
"2011","Birmingham 134E","E01033640","Total",1296,217,42,175,1079,235,38,239,158,121,147,141
"2011","Birmingham 135A","E01009378","Total",2017,523,109,414,1494,168,68,237,506,84,201,230
"2011","Birmingham 135B","E01033567","Total",1172,335,4,331,837,17,6,92,598,0,4,120
"2011","Birmingham 135C","E01033615","Total",1015,310,2,308,705,20,6,78,454,5,13,129
"2011","Birmingham 135D","E01033616","Total",1012,510,43,467,502,11,24,63,268,6,38,92
"2011","Birmingham 136A","E01009143","Total",1400,310,68,242,1090,228,48,196,152,113,196,157
"2011","Birmingham 136B","E01009146","Total",1340,607,77,530,733,121,42,136,220,31,44,139
"2011","Birmingham 136C","E01033564","Total",1231,448,8,440,783,23,12,127,454,17,29,121
"2011","Birmingham 136D","E01033639","Total",1803,326,37,289,1477,264,46,270,314,141,142,300
"2011","Birmingham 137A","E01009141","Total",1745,388,101,287,1357,296,80,202,178,142,207,252
"2011","Birmingham 137B","E01033565","Total",1021,282,3,279,739,7,4,56,578,0,9,85
"2011","Birmingham 137C","E01033618","Total",1191,397,7,390,794,13,16,117,518,11,15,104
"2011","Birmingham 137D","E01033619","Total",1134,246,19,227,888,76,18,111,462,30,41,150
"2011","Birmingham 137E","E01033627","Total",1078,292,54,238,786,104,40,153,236,45,85,123
"2011","Birmingham 138A","E01033620","Total",1019,439,16,423,580,15,2,51,418,0,0,94
"2011","Birmingham 138B","E01033622","Total",1509,428,21,407,1081,26,12,114,684,10,4,231
"2011","Birmingham 138C","E01033623","Total",1120,480,14,466,640,37,8,27,450,5,0,113
"2011","Birmingham 138D","E01033625","Total",1694,535,0,535,1159,0,10,144,848,0,4,153
"2011","Birmingham 139A","E01009200","Total",1682,236,36,200,1446,192,48,300,136,246,308,216
"2011","Birmingham 139B","E01009327","Total",1633,58,30,28,1575,72,48,183,80,444,490,258
"2011","Birmingham 139C","E01009328","Total",2366,77,27,50,2289,65,68,132,50,382,1120,472
"2011","Birmingham 139D","E01009331","Total",2145,105,39,66,2040,141,84,224,72,355,814,350
"2011","Birmingham 139E","E01009332","Total",1655,178,61,117,1477,147,52,203,92,276,440,267
"2011","Birmingham 139F","E01009333","Total",1654,73,18,55,1581,99,42,196,76,442,507,219
"2011","Birmingham 139G","E01009335","Total",1882,69,36,33,1813,122,66,178,90,343,677,337
"2011","Birmingham 139H","E01009344","Total",1615,112,32,80,1503,138,40,193,66,380,451,235
"2011","Birmingham 140A","E01009339","Total",1521,105,47,58,1416,106,68,184,78,324,373,283
"2011","Birmingham 140B","E01009340","Total",2692,263,57,206,2429,230,92,521,262,468,514,342
"2011","Birmingham 140C","E01009382","Total",1836,84,37,47,1752,73,54,134,54,220,859,358
"2011","Birmingham 140D","E01009391","Total",1622,125,31,94,1497,123,56,326,126,315,326,225
"2011","Birmingham 140E","E01009392","Total",1774,69,31,38,1705,65,64,160,62,258,699,397
"2011","Birmingham 140F","E01009393","Total",1645,87,23,64,1558,118,62,275,86,367,404,246
"2011","Birmingham 140G","E01033641","Total",3296,133,44,89,3163,148,120,446,198,629,1036,586
"2011","Coventry 001A","E01009589","Total",1425,175,49,126,1250,152,116,292,198,104,195,193
"2011","Coventry 001F","E01032536","Total",1897,328,104,224,1569,130,110,394,304,88,261,282
"2011","Coventry 001G","E01032537","Total",1929,260,115,145,1669,161,236,311,242,94,255,370
"2011","Coventry 001H","E01032538","Total",2171,375,110,265,1796,303,158,410,302,107,230,286
"2011","Coventry 002A","E01009590","Total",1312,120,73,47,1192,79,164,306,168,45,179,251
"2011","Coventry 002B","E01009591","Total",1540,131,52,79,1409,136,100,319,226,116,234,278
"2011","Coventry 002C","E01009593","Total",1641,154,82,72,1487,118,200,235,170,120,264,380
"2011","Coventry 002D","E01009598","Total",1617,168,113,55,1449,60,256,224,144,65,211,489
"2011","Coventry 004A","E01009604","Total",1459,152,69,83,1307,131,136,241,140,113,247,299
"2011","Coventry 004B","E01009605","Total",1495,216,81,135,1279,216,106,256,190,70,209,232
"2011","Coventry 004C","E01009607","Total",1495,423,115,308,1072,216,88,218,174,76,110,190
"2011","Coventry 004D","E01009608","Total",1571,152,73,79,1419,194,138,282,198,124,244,239
"2011","Coventry 004E","E01009610","Total",1464,230,91,139,1234,171,106,239,162,141,158,257
"2011","Coventry 005A","E01009564","Total",1657,164,42,122,1493,206,56,263,164,210,340,254
"2011","Coventry 005B","E01009575","Total",1306,126,42,84,1180,177,82,255,120,113,233,200
"2011","Coventry 005C","E01009606","Total",1465,122,57,65,1343,134,124,286,150,129,212,308
"2011","Coventry 005D","E01009609","Total",1589,147,68,79,1442,233,116,307,168,140,208,270
"2011","Coventry 006A","E01009524","Total",1486,271,161,110,1215,78,176,296,164,63,179,259
"2011","Coventry 006B","E01009525","Total",1435,153,109,44,1282,51,170,222,194,86,256,303
"2011","Coventry 006C","E01009527","Total",1610,187,71,116,1423,131,120,396,200,85,200,291
"2011","Coventry 006D","E01009594","Total",1377,96,49,47,1281,62,178,286,216,87,137,315
"2011","Coventry 007A","E01009577","Total",1254,197,54,143,1057,221,50,258,126,155,109,138
"2011","Coventry 007B","E01009579","Total",1681,220,86,134,1461,337,122,295,188,137,157,225
"2011","Coventry 007C","E01009581","Total",1539,206,113,93,1333,214,138,211,162,144,214,250
"2011","Coventry 007D","E01009584","Total",1418,176,85,91,1242,160,190,223,172,108,149,240
"2011","Coventry 007E","E01009585","Total",1062,97,26,71,965,248,54,181,100,136,128,118
"2011","Coventry 007F","E01009709","Total",1065,166,43,123,899,210,66,118,80,175,132,118
"2011","Coventry 008A","E01009576","Total",1552,224,99,125,1328,123,108,383,248,37,136,293
"2011","Coventry 008B","E01009578","Total",1421,115,51,64,1306,63,146,266,242,56,162,371
"2011","Coventry 008C","E01009582","Total",1725,210,103,107,1515,144,192,328,258,92,163,338
"2011","Coventry 008D","E01009583","Total",1608,184,78,106,1424,118,196,311,240,112,207,240
"2011","Coventry 008E","E01009586","Total",1671,146,78,68,1525,100,230,300,188,94,267,346
"2011","Coventry 009A","E01009565","Total",1715,77,44,33,1638,122,90,163,86,279,593,305
"2011","Coventry 009B","E01009566","Total",1559,154,20,134,1405,193,36,335,196,192,260,193
"2011","Coventry 009C","E01009567","Total",1826,226,76,150,1600,169,64,322,126,220,411,288
"2011","Coventry 009D","E01009568","Total",1788,96,30,66,1692,141,90,229,120,245,496,371
"2011","Coventry 010A","E01009523","Total",1466,140,86,54,1326,15,286,227,204,57,200,337
"2011","Coventry 010B","E01009526","Total",1559,124,71,53,1435,72,204,336,206,119,203,295
"2011","Coventry 010C","E01009528","Total",1587,174,100,74,1413,71,296,286,238,108,146,268
"2011","Coventry 010D","E01009531","Total",1535,306,155,151,1229,114,248,261,228,89,89,200
"2011","Coventry 011A","E01009587","Total",1535,142,61,81,1393,142,84,345,176,130,213,303
"2011","Coventry 011B","E01009624","Total",1628,146,61,85,1482,178,110,374,196,94,221,309
"2011","Coventry 011C","E01009625","Total",2346,198,83,115,2148,208,162,506,260,170,389,453
"2011","Coventry 011D","E01009626","Total",1638,165,67,98,1473,142,122,335,214,129,215,316
"2011","Coventry 012A","E01009622","Total",1737,167,66,101,1570,252,90,402,148,124,236,318
"2011","Coventry 012B","E01009623","Total",1523,258,88,170,1265,172,122,255,172,89,185,270
"2011","Coventry 012C","E01009627","Total",1561,269,103,166,1292,160,110,263,252,65,172,270
"2011","Coventry 012D","E01009628","Total",1511,196,107,89,1315,110,168,254,192,129,158,304
"2011","Coventry 013A","E01009599","Total",1237,237,105,132,1000,102,210,206,186,52,97,147
"2011","Coventry 013B","E01009663","Total",1438,200,127,73,1238,74,276,202,164,79,220,223
"2011","Coventry 013C","E01009710","Total",1380,233,91,142,1147,80,160,274,202,23,156,252
"2011","Coventry 013D","E01009711","Total",1381,182,112,70,1199,92,250,186,160,103,171,237
"2011","Coventry 014A","E01009522","Total",1434,248,165,83,1186,127,180,224,156,92,159,248
"2011","Coventry 014B","E01009529","Total",1541,164,81,83,1377,99,150,327,198,73,181,349
"2011","Coventry 014C","E01009530","Total",1385,149,83,66,1236,79,132,349,188,78,152,258
"2011","Coventry 014D","E01009645","Total",1474,126,52,74,1348,134,142,321,196,84,184,287
"2011","Coventry 015A","E01009569","Total",1309,146,35,111,1163,146,54,241,144,156,211,211
"2011","Coventry 015B","E01009570","Total",1778,152,38,114,1626,131,76,298,152,194,421,354
"2011","Coventry 015C","E01009571","Total",1599,304,77,227,1295,191,58,255,138,227,206,220
"2011","Coventry 015D","E01009572","Total",2176,200,43,157,1976,333,50,428,266,327,263,309
"2011","Coventry 015E","E01009573","Total",1544,143,39,104,1401,123,42,238,124,210,323,341
"2011","Coventry 015F","E01009574","Total",1529,175,58,117,1354,186,68,275,108,185,299,233
"2011","Coventry 016A","E01009655","Total",1853,241,92,149,1612,230,122,383,294,155,172,256
"2011","Coventry 016B","E01009656","Total",1583,249,97,152,1334,162,120,298,244,61,154,295
"2011","Coventry 016C","E01009659","Total",1724,298,78,220,1426,234,62,305,226,89,190,320
"2011","Coventry 016D","E01009662","Total",1440,202,57,145,1238,81,92,180,140,63,300,382
"2011","Coventry 016E","E01009664","Total",1511,148,42,106,1363,139,116,313,178,96,231,290
"2011","Coventry 017A","E01009643","Total",1499,128,59,69,1371,80,120,420,264,96,117,274
"2011","Coventry 017B","E01009644","Total",1657,173,87,86,1484,121,158,360,276,109,107,353
"2011","Coventry 017C","E01009647","Total",1715,296,127,169,1419,102,142,284,316,99,190,286
"2011","Coventry 017D","E01009648","Total",1545,129,54,75,1416,99,132,396,254,139,108,288
"2011","Coventry 017E","E01009652","Total",1446,194,108,86,1252,69,224,254,164,100,166,275
"2011","Coventry 017F","E01009653","Total",1574,161,100,61,1413,91,212,349,144,133,179,305
"2011","Coventry 018A","E01009613","Total",1308,121,65,56,1187,63,112,267,170,65,197,313
"2011","Coventry 018B","E01009657","Total",1672,140,55,85,1532,135,144,323,198,89,217,426
"2011","Coventry 018C","E01009712","Total",1597,145,75,70,1452,183,144,317,192,78,173,365
"2011","Coventry 018D","E01009714","Total",1539,121,59,62,1418,124,146,388,144,107,209,300
"2011","Coventry 018E","E01009716","Total",1738,152,78,74,1586,138,148,361,192,187,218,342
"2011","Coventry 019A","E01009580","Total",1191,193,104,89,998,76,196,179,160,56,134,197
"2011","Coventry 019B","E01009713","Total",1386,105,45,60,1281,93,126,310,192,62,221,277
"2011","Coventry 019C","E01009715","Total",1377,197,68,129,1180,66,122,299,198,116,142,237
"2011","Coventry 019D","E01009717","Total",1458,137,59,78,1321,48,140,385,252,68,154,274
"2011","Coventry 019E","E01009718","Total",1673,465,171,294,1208,186,124,247,202,69,128,252
"2011","Coventry 020A","E01009629","Total",2698,332,45,287,2366,206,100,529,396,214,349,572
"2011","Coventry 020B","E01009630","Total",1661,228,70,158,1433,208,90,322,240,124,141,308
"2011","Coventry 020C","E01009631","Total",1316,209,69,140,1107,190,70,210,190,79,92,276
"2011","Coventry 020D","E01009632","Total",1596,546,135,411,1050,107,68,162,384,38,43,248
"2011","Coventry 020E","E01009650","Total",1547,437,40,397,1110,56,44,108,268,43,98,493
"2011","Coventry 021A","E01009614","Total",1452,155,56,99,1297,123,138,260,208,101,202,265
"2011","Coventry 021B","E01009654","Total",1764,171,60,111,1593,151,152,482,282,87,165,274
"2011","Coventry 021C","E01009658","Total",1487,169,51,118,1318,99,124,273,148,111,161,402
"2011","Coventry 021D","E01009660","Total",1768,197,61,136,1571,78,102,269,182,124,347,469
"2011","Coventry 022A","E01009646","Total",1524,158,65,93,1366,95,146,352,240,105,180,248
"2011","Coventry 022B","E01009692","Total",1226,139,97,42,1087,46,298,214,144,47,123,215
"2011","Coventry 022C","E01009693","Total",1500,222,115,107,1278,111,220,294,246,82,77,248
"2011","Coventry 022D","E01009694","Total",1428,186,119,67,1242,44,242,282,210,101,131,232
"2011","Coventry 023A","E01009695","Total",1546,267,162,105,1279,48,352,292,226,41,121,199
"2011","Coventry 023B","E01009696","Total",1492,167,64,103,1325,43,286,289,208,74,116,309
"2011","Coventry 023C","E01009704","Total",1475,129,49,80,1346,53,188,292,244,83,132,354
"2011","Coventry 023D","E01009705","Total",1459,104,44,60,1355,47,264,303,212,50,165,314
"2011","Coventry 024A","E01009636","Total",2269,332,59,273,1937,203,58,374,400,112,259,531
"2011","Coventry 024B","E01009637","Total",1488,125,24,101,1363,183,48,232,74,232,347,247
"2011","Coventry 024C","E01009638","Total",1503,393,78,315,1110,184,18,269,142,135,191,171
"2011","Coventry 024D","E01009639","Total",1746,113,33,80,1633,109,112,259,114,182,525,332
"2011","Coventry 024E","E01009640","Total",1871,204,31,173,1667,293,70,315,212,233,311,233
"2011","Coventry 024F","E01009641","Total",2050,365,66,299,1685,164,56,179,388,137,162,599
"2011","Coventry 025A","E01009697","Total",1454,182,84,98,1272,73,234,292,238,66,119,250
"2011","Coventry 025B","E01009698","Total",1526,127,69,58,1399,44,294,304,224,67,156,310
"2011","Coventry 025C","E01009703","Total",2591,378,94,284,2213,237,92,614,554,186,198,332
"2011","Coventry 025D","E01009706","Total",1491,172,75,97,1319,71,290,274,226,95,107,256
"2011","Coventry 026A","E01009649","Total",1418,153,57,96,1265,76,162,337,204,83,107,296
"2011","Coventry 026B","E01009684","Total",1366,294,74,220,1072,135,120,193,216,80,116,212
"2011","Coventry 026C","E01009685","Total",1634,224,93,131,1410,92,164,334,266,71,160,323
"2011","Coventry 026D","E01009686","Total",1667,216,87,129,1451,68,132,375,244,61,195,376
"2011","Coventry 026E","E01009687","Total",1407,171,57,114,1236,75,116,320,280,48,116,281
"2011","Coventry 027A","E01009615","Total",1736,197,55,142,1539,102,120,236,262,67,283,469
"2011","Coventry 027B","E01009616","Total",1559,163,64,99,1396,91,114,265,220,105,266,335
"2011","Coventry 027C","E01009617","Total",1248,110,46,64,1138,87,100,249,176,90,156,280
"2011","Coventry 027D","E01009618","Total",1526,165,69,96,1361,70,132,366,224,47,221,301
"2011","Coventry 027E","E01009620","Total",1425,192,89,103,1233,104,160,294,196,85,148,246
"2011","Coventry 027F","E01009621","Total",1335,137,39,98,1198,149,110,230,190,75,175,269
"2011","Coventry 028A","E01009633","Total",1778,204,47,157,1574,150,78,217,252,141,125,611
"2011","Coventry 028B","E01009634","Total",1641,193,48,145,1448,83,66,214,296,71,70,648
"2011","Coventry 028C","E01009635","Total",2129,314,42,272,1815,164,58,159,266,56,95,1017
"2011","Coventry 028D","E01009661","Total",1822,271,66,205,1551,180,60,276,270,41,153,571
"2011","Coventry 029A","E01009674","Total",1496,228,72,156,1268,205,100,227,246,102,137,251
"2011","Coventry 029B","E01009699","Total",1430,177,102,75,1253,118,244,241,206,68,142,234
"2011","Coventry 029C","E01009700","Total",1614,404,103,301,1210,211,118,191,230,89,152,219
"2011","Coventry 029D","E01009701","Total",1519,279,112,167,1240,207,146,244,240,43,125,235
"2011","Coventry 029E","E01009702","Total",1444,325,91,234,1119,206,108,298,214,59,80,154
"2011","Coventry 030A","E01009688","Total",1479,193,59,134,1286,107,66,132,230,46,100,605
"2011","Coventry 030B","E01009689","Total",1465,288,44,244,1177,57,54,130,408,34,60,434
"2011","Coventry 030C","E01009690","Total",1471,234,58,176,1237,58,76,189,316,45,87,466
"2011","Coventry 030D","E01009691","Total",1360,206,36,170,1154,110,76,103,376,25,48,416
"2011","Coventry 031A","E01009548","Total",2143,414,112,302,1729,136,130,321,484,71,167,420
"2011","Coventry 031B","E01009553","Total",1459,348,39,309,1111,51,28,98,250,21,105,558
"2011","Coventry 031C","E01009642","Total",1736,470,95,375,1266,67,38,107,576,6,51,421
"2011","Coventry 031D","E01009651","Total",1565,519,83,436,1046,199,64,188,200,71,116,208
"2011","Coventry 032A","E01009676","Total",1482,151,65,86,1331,115,104,283,240,106,158,325
"2011","Coventry 032B","E01009681","Total",1259,151,65,86,1108,52,168,239,192,70,109,278
"2011","Coventry 032C","E01009682","Total",1531,140,69,71,1391,67,158,310,210,114,161,371
"2011","Coventry 032D","E01009683","Total",1354,154,55,99,1200,181,82,250,220,90,114,263
"2011","Coventry 033A","E01009532","Total",1319,173,97,76,1146,86,190,279,186,57,111,237
"2011","Coventry 033B","E01009535","Total",1330,109,69,40,1221,68,296,225,194,55,117,266
"2011","Coventry 033C","E01009536","Total",1472,160,97,63,1312,30,278,259,184,52,205,304
"2011","Coventry 033D","E01009543","Total",1737,43,9,34,1694,24,74,568,232,65,265,466
"2011","Coventry 033E","E01009707","Total",1869,160,53,107,1709,120,160,501,272,107,192,357
"2011","Coventry 033F","E01009708","Total",1457,181,78,103,1276,72,182,275,216,72,126,333
"2011","Coventry 034A","E01009554","Total",1296,186,64,122,1110,69,94,256,240,35,87,329
"2011","Coventry 034B","E01009555","Total",1452,131,72,59,1321,26,228,255,254,70,134,354
"2011","Coventry 034C","E01009556","Total",1508,376,103,273,1132,56,118,240,254,52,98,314
"2011","Coventry 034D","E01009557","Total",1314,96,66,30,1218,18,278,201,222,43,95,361
"2011","Coventry 034E","E01009558","Total",1472,196,34,162,1276,59,72,296,340,42,160,307
"2011","Coventry 034F","E01009559","Total",1337,234,143,91,1103,21,212,183,172,62,181,272
"2011","Coventry 035C","E01009537","Total",1449,184,91,93,1265,148,136,300,216,87,141,237
"2011","Coventry 035D","E01009538","Total",1447,160,77,83,1287,185,158,219,220,90,168,247
"2011","Coventry 035E","E01009611","Total",2138,181,51,130,1957,377,70,494,218,217,311,270
"2011","Coventry 035F","E01009612","Total",1402,169,59,110,1233,161,88,232,206,148,216,182
"2011","Coventry 035G","E01032527","Total",1571,159,52,107,1412,201,126,284,238,86,209,268
"2011","Coventry 035H","E01032528","Total",1519,219,112,107,1300,192,170,252,248,71,112,255
"2011","Coventry 036C","E01009679","Total",1463,216,115,101,1247,132,120,176,164,100,178,377
"2011","Coventry 036E","E01032531","Total",2600,426,170,256,2174,463,164,414,308,219,250,356
"2011","Coventry 036F","E01032532","Total",1282,139,68,71,1143,73,190,205,178,26,175,296
"2011","Coventry 036G","E01032533","Total",1857,106,35,71,1751,56,122,390,236,119,321,507
"2011","Coventry 037B","E01009549","Total",1619,191,105,86,1428,26,228,286,230,119,205,334
"2011","Coventry 037C","E01009550","Total",1854,201,79,122,1653,164,164,381,296,70,161,417
"2011","Coventry 037E","E01009552","Total",1595,272,164,108,1323,118,180,315,190,93,139,288
"2011","Coventry 037F","E01032534","Total",1854,241,95,146,1613,154,190,298,206,171,269,325
"2011","Coventry 037G","E01032535","Total",1177,129,71,58,1048,49,122,264,200,55,110,248
"2011","Coventry 038A","E01009544","Total",1506,321,143,178,1185,123,168,252,258,58,126,200
"2011","Coventry 038D","E01009619","Total",1852,290,73,217,1562,164,92,275,354,85,142,450
"2011","Coventry 038E","E01032529","Total",1238,327,113,214,911,123,138,172,264,15,45,154
"2011","Coventry 038F","E01032530","Total",1772,274,136,138,1498,90,180,411,338,40,102,337
"2011","Coventry 039A","E01009539","Total",1587,381,94,287,1206,233,82,309,136,82,185,179
"2011","Coventry 039B","E01009540","Total",1926,267,61,206,1659,347,92,371,168,243,255,183
"2011","Coventry 039C","E01009541","Total",1532,369,116,253,1163,148,218,168,244,33,109,243
"2011","Coventry 039D","E01009542","Total",1736,465,128,337,1271,211,112,240,210,143,146,209
"2011","Coventry 040A","E01009560","Total",1523,108,65,43,1415,10,218,277,150,94,302,364
"2011","Coventry 040B","E01009561","Total",1587,309,155,154,1278,95,246,280,214,56,115,272
"2011","Coventry 040C","E01009562","Total",1642,232,137,95,1410,51,260,297,180,93,122,407
"2011","Coventry 040D","E01009563","Total",1672,120,93,27,1552,27,236,377,176,152,205,379
"2011","Coventry 040E","E01009672","Total",2086,183,127,56,1903,39,394,343,212,120,315,480
"2011","Coventry 041A","E01009666","Total",1310,123,65,58,1187,39,162,308,138,88,210,242
"2011","Coventry 041B","E01009667","Total",1356,161,128,33,1195,15,328,172,136,35,205,304
"2011","Coventry 041C","E01009668","Total",1643,158,92,66,1485,62,144,391,188,148,236,316
"2011","Coventry 041D","E01009670","Total",1664,173,96,77,1491,96,178,386,226,144,171,290
"2011","Coventry 042A","E01009665","Total",1188,111,75,36,1077,9,224,158,154,43,167,322
"2011","Coventry 042B","E01009669","Total",1288,80,47,33,1208,44,108,364,164,76,232,220
"2011","Coventry 042C","E01009671","Total",1272,46,21,25,1226,23,134,170,152,115,262,370
"2011","Coventry 042F","E01033058","Total",2187,278,147,131,1909,57,286,217,292,82,190,785
"2011","Coventry 043A","E01009588","Total",1538,280,156,124,1258,159,128,258,154,99,185,275
"2011","Coventry 043B","E01009592","Total",1633,160,50,110,1473,285,70,364,228,109,166,251
"2011","Coventry 043C","E01009596","Total",1524,136,40,96,1388,180,112,269,148,110,268,301
"2011","Coventry 043D","E01009597","Total",1763,134,59,75,1629,223,136,267,188,155,291,369
"2011","Coventry 043E","E01032587","Total",1747,149,53,96,1598,222,126,383,234,142,231,260
"2011","Dudley 001A","E01009763","Total",1853,145,46,99,1708,148,120,478,246,213,214,289
"2011","Dudley 001B","E01009764","Total",1425,123,69,54,1302,49,184,251,224,42,210,342
"2011","Dudley 001C","E01009767","Total",1468,174,100,74,1294,58,212,286,198,104,181,255
"2011","Dudley 001D","E01009769","Total",1579,256,99,157,1323,193,126,290,204,106,162,242
"2011","Dudley 001E","E01009770","Total",1453,191,92,99,1262,87,174,271,238,77,160,255
"2011","Dudley 002A","E01009773","Total",1539,219,127,92,1320,77,200,298,192,103,191,259
"2011","Dudley 002B","E01009777","Total",1451,193,80,113,1258,78,164,266,186,98,184,282
"2011","Dudley 002C","E01009778","Total",1547,162,85,77,1385,77,162,322,206,73,203,342
"2011","Dudley 002D","E01009895","Total",1407,194,110,84,1213,75,202,292,172,68,170,234
"2011","Dudley 003A","E01009896","Total",1486,130,91,39,1356,34,280,272,208,48,185,329
"2011","Dudley 003B","E01009897","Total",1455,117,83,34,1338,28,362,302,162,52,110,322
"2011","Dudley 003C","E01009898","Total",1440,195,119,76,1245,22,308,242,206,40,113,314
"2011","Dudley 003D","E01009901","Total",1366,140,92,48,1226,30,292,270,178,20,136,300
"2011","Dudley 003E","E01009902","Total",1269,109,69,40,1160,26,256,238,210,37,112,281
"2011","Dudley 004A","E01009765","Total",1604,145,75,70,1459,69,214,352,222,94,170,338
"2011","Dudley 004B","E01009766","Total",1584,196,86,110,1388,95,166,312,236,72,174,333
"2011","Dudley 004C","E01009768","Total",1387,244,128,116,1143,82,164,247,168,54,180,248
"2011","Dudley 004D","E01009771","Total",1338,209,147,62,1129,26,338,238,174,20,84,249
"2011","Dudley 004E","E01009775","Total",1587,141,85,56,1446,83,176,312,148,92,315,320
"2011","Dudley 004F","E01009776","Total",1534,121,76,45,1413,53,212,309,204,67,216,352
"2011","Dudley 005A","E01009758","Total",1687,175,107,68,1512,164,158,298,194,102,274,322
"2011","Dudley 005B","E01009760","Total",1317,109,56,53,1208,95,164,270,124,94,189,272
"2011","Dudley 005C","E01009772","Total",1324,68,22,46,1256,139,86,281,206,107,172,265
"2011","Dudley 005D","E01009774","Total",1525,140,63,77,1385,70,258,373,224,73,142,245
"2011","Dudley 005E","E01009788","Total",1578,246,113,133,1332,79,152,331,240,104,132,294
"2011","Dudley 006B","E01009756","Total",1404,122,56,66,1282,93,120,281,160,70,274,284
"2011","Dudley 006C","E01009757","Total",1616,160,65,95,1456,115,152,270,244,132,202,341
"2011","Dudley 006D","E01009759","Total",1291,109,73,36,1182,19,262,189,188,77,130,317
"2011","Dudley 006F","E01009762","Total",1398,104,49,55,1294,188,80,267,112,159,249,239
"2011","Dudley 006G","E01033187","Total",2338,172,82,90,2166,383,164,386,234,311,321,367
"2011","Dudley 007A","E01009781","Total",1899,340,140,200,1559,99,176,425,320,83,181,275
"2011","Dudley 007B","E01009786","Total",1497,188,69,119,1309,130,114,319,210,131,162,243
"2011","Dudley 007C","E01009789","Total",1459,172,60,112,1287,38,216,262,284,35,129,323
"2011","Dudley 007D","E01009790","Total",1545,205,98,107,1340,100,160,279,248,59,190,304
"2011","Dudley 008A","E01009779","Total",1359,263,137,126,1096,40,212,254,234,35,59,262
"2011","Dudley 008B","E01009782","Total",1551,175,88,87,1376,145,142,348,178,99,133,331
"2011","Dudley 008C","E01009783","Total",1467,144,73,71,1323,124,178,251,194,61,191,324
"2011","Dudley 008D","E01009785","Total",1448,161,115,46,1287,12,328,235,204,55,148,305
"2011","Dudley 008E","E01009899","Total",1436,141,99,42,1295,24,346,270,206,43,133,273
"2011","Dudley 008F","E01009900","Total",1464,131,106,25,1333,17,430,249,184,57,147,249
"2011","Dudley 009A","E01009780","Total",2071,129,22,107,1942,66,78,696,330,103,290,379
"2011","Dudley 009B","E01009784","Total",1669,108,24,84,1561,53,84,493,332,62,225,312
"2011","Dudley 009C","E01009787","Total",1571,98,39,59,1473,16,160,394,260,49,258,336
"2011","Dudley 009D","E01009880","Total",1503,117,38,79,1386,57,110,430,230,67,160,332
"2011","Dudley 009E","E01009882","Total",1406,123,68,55,1283,82,142,277,194,104,206,278
"2011","Dudley 010A","E01009891","Total",1729,137,53,84,1592,192,114,318,194,229,240,305
"2011","Dudley 010B","E01009892","Total",1508,257,80,177,1251,135,98,165,184,138,266,265
"2011","Dudley 010C","E01009893","Total",1713,148,62,86,1565,207,88,391,148,233,254,244
"2011","Dudley 010D","E01009894","Total",1757,169,85,84,1588,115,170,376,250,149,200,328
"2011","Dudley 011A","E01009844","Total",1472,233,71,162,1239,118,118,223,146,175,285,174
"2011","Dudley 011B","E01009879","Total",1997,226,89,137,1771,134,128,365,336,148,278,382
"2011","Dudley 011C","E01009881","Total",2004,701,237,464,1303,102,118,308,256,111,207,201
"2011","Dudley 011D","E01009885","Total",1547,240,98,142,1307,109,198,253,186,64,215,282
"2011","Dudley 012A","E01009816","Total",1467,121,77,44,1346,49,266,303,238,58,120,312
"2011","Dudley 012B","E01009817","Total",1274,133,99,34,1141,43,262,279,160,56,113,228
"2011","Dudley 012C","E01009819","Total",1560,176,51,125,1384,84,164,428,282,53,105,268
"2011","Dudley 012D","E01009820","Total",1488,180,103,77,1308,78,204,304,238,31,169,284
"2011","Dudley 013A","E01009748","Total",1627,173,100,73,1454,201,140,291,184,82,256,300
"2011","Dudley 013B","E01009839","Total",1587,146,68,78,1441,78,142,252,192,166,290,321
"2011","Dudley 013C","E01009883","Total",1349,186,96,90,1163,112,128,296,144,100,150,233
"2011","Dudley 013D","E01009884","Total",1523,205,93,112,1318,97,162,328,210,107,194,220
"2011","Dudley 013E","E01009886","Total",1592,411,202,209,1181,79,244,272,168,69,147,202
"2011","Dudley 014A","E01009814","Total",1258,105,72,33,1153,28,244,271,180,30,152,248
"2011","Dudley 014B","E01009815","Total",1325,77,51,26,1248,34,188,254,182,77,187,326
"2011","Dudley 014C","E01009818","Total",1139,187,112,75,952,48,138,174,158,80,134,220
"2011","Dudley 014D","E01009821","Total",1400,135,94,41,1265,33,344,257,184,57,106,284
"2011","Dudley 014E","E01009822","Total",1467,195,117,78,1272,36,300,282,208,72,98,276
"2011","Dudley 015A","E01009887","Total",1759,146,68,78,1613,96,150,301,224,148,346,348
"2011","Dudley 015B","E01009888","Total",1598,179,76,103,1419,90,186,307,246,140,167,283
"2011","Dudley 015C","E01009889","Total",1815,213,66,147,1602,171,128,207,200,137,408,351
"2011","Dudley 015D","E01009890","Total",1693,198,87,111,1495,155,102,299,184,175,312,268
"2011","Dudley 016A","E01009749","Total",1412,142,56,86,1270,43,204,232,248,64,131,348
"2011","Dudley 016B","E01009750","Total",1521,118,71,47,1403,81,208,217,236,128,194,339
"2011","Dudley 016C","E01009823","Total",1401,86,45,41,1315,24,184,279,248,77,144,359
"2011","Dudley 016D","E01009824","Total",1648,219,126,93,1429,106,194,344,216,130,184,255
"2011","Dudley 017A","E01009751","Total",1492,207,88,119,1285,102,178,257,202,96,165,285
"2011","Dudley 017B","E01009752","Total",1504,158,73,85,1346,157,108,307,200,101,232,241
"2011","Dudley 017C","E01009753","Total",1578,164,87,77,1414,183,110,324,164,162,205,266
"2011","Dudley 017D","E01009754","Total",1641,149,78,71,1492,122,128,334,248,82,225,353
"2011","Dudley 017E","E01009841","Total",1580,188,70,118,1392,170,148,230,200,155,274,215
"2011","Dudley 018A","E01009840","Total",1393,163,52,111,1230,106,88,253,146,189,196,252
"2011","Dudley 018B","E01009842","Total",1828,428,105,323,1400,119,126,287,300,137,172,259
"2011","Dudley 018C","E01009843","Total",1569,173,94,79,1396,85,208,291,252,82,166,312
"2011","Dudley 018D","E01009871","Total",1844,285,80,205,1559,95,198,303,336,112,149,366
"2011","Dudley 018E","E01009875","Total",1512,162,82,80,1350,101,176,337,230,98,167,241
"2011","Dudley 019A","E01009825","Total",1435,177,90,87,1258,68,180,266,190,90,134,330
"2011","Dudley 019B","E01009826","Total",1469,144,104,40,1325,31,346,288,198,57,93,312
"2011","Dudley 019C","E01009827","Total",1600,128,102,26,1472,25,268,379,232,80,209,279
"2011","Dudley 019D","E01009828","Total",1378,126,66,60,1252,48,268,211,192,57,165,311
"2011","Dudley 019E","E01009829","Total",1547,142,94,48,1405,51,284,298,224,80,178,290
"2011","Dudley 019F","E01009830","Total",1575,115,72,43,1460,41,304,284,192,80,209,350
"2011","Dudley 020A","E01009872","Total",1499,231,79,152,1268,116,72,273,162,137,241,267
"2011","Dudley 020B","E01009873","Total",1509,151,80,71,1358,66,218,203,238,93,204,336
"2011","Dudley 020C","E01009874","Total",1615,120,54,66,1495,113,124,319,180,134,242,383
"2011","Dudley 020D","E01009876","Total",1668,144,75,69,1524,103,218,299,214,150,242,298
"2011","Dudley 020E","E01009877","Total",1566,183,83,100,1383,180,146,300,202,145,157,253
"2011","Dudley 021A","E01009911","Total",1354,180,65,115,1174,17,222,257,240,21,128,289
"2011","Dudley 021B","E01009912","Total",1689,144,60,84,1545,91,226,445,296,51,167,269
"2011","Dudley 021C","E01009913","Total",1544,163,111,52,1381,68,250,308,254,73,173,255
"2011","Dudley 021D","E01009914","Total",1429,111,70,41,1318,31,312,345,206,41,101,282
"2011","Dudley 021E","E01009915","Total",1598,207,59,148,1391,51,206,324,308,58,131,313
"2011","Dudley 021F","E01009916","Total",1695,227,97,130,1468,70,172,356,254,87,167,362
"2011","Dudley 022A","E01009741","Total",2291,551,102,449,1740,233,148,403,412,71,170,303
"2011","Dudley 022B","E01009744","Total",1861,338,66,272,1523,130,172,416,312,56,198,239
"2011","Dudley 022C","E01009746","Total",1622,275,124,151,1347,92,100,237,220,126,309,263
"2011","Dudley 022D","E01009747","Total",1475,214,54,160,1261,138,78,358,282,60,137,208
"2011","Dudley 023A","E01009731","Total",1538,213,55,158,1325,60,86,393,342,83,112,249
"2011","Dudley 023B","E01009740","Total",1682,170,41,129,1512,137,100,455,274,131,200,215
"2011","Dudley 023C","E01009742","Total",1568,188,106,82,1380,108,184,344,186,88,214,256
"2011","Dudley 023D","E01009743","Total",1794,190,98,92,1604,188,146,329,216,180,288,257
"2011","Dudley 023E","E01009745","Total",1698,193,91,102,1505,54,202,354,334,71,142,348
"2011","Dudley 024A","E01009917","Total",1266,83,45,38,1183,46,208,313,198,65,113,240
"2011","Dudley 024B","E01009918","Total",1424,147,97,50,1277,137,202,272,210,46,149,261
"2011","Dudley 024C","E01009919","Total",1240,86,54,32,1154,21,276,243,166,81,67,300
"2011","Dudley 024D","E01009920","Total",1409,178,54,124,1231,30,116,402,328,51,113,191
"2011","Dudley 025A","E01009864","Total",1636,91,46,45,1545,86,164,417,246,120,169,343
"2011","Dudley 025B","E01009865","Total",1491,212,134,78,1279,92,210,286,164,147,135,245
"2011","Dudley 025C","E01009866","Total",1647,233,93,140,1414,100,172,380,272,50,136,304
"2011","Dudley 025D","E01009867","Total",1734,158,80,78,1576,87,254,332,224,117,195,367
"2011","Dudley 025E","E01009878","Total",1980,153,72,81,1827,94,198,503,302,156,189,385
"2011","Dudley 026A","E01009791","Total",1509,228,111,117,1281,71,152,284,246,84,176,268
"2011","Dudley 026B","E01009792","Total",1583,182,76,106,1401,106,146,294,210,121,287,237
"2011","Dudley 026C","E01009795","Total",1657,239,66,173,1418,109,118,326,264,110,221,270
"2011","Dudley 026D","E01009796","Total",1503,171,92,79,1332,47,150,238,216,54,268,359
"2011","Dudley 026E","E01009798","Total",1691,210,87,123,1481,85,200,287,262,105,191,351
"2011","Dudley 027A","E01009719","Total",1443,107,44,63,1336,60,156,308,252,85,222,253
"2011","Dudley 027B","E01009722","Total",1370,188,68,120,1182,70,190,299,256,62,94,211
"2011","Dudley 027C","E01009727","Total",1353,78,31,47,1275,46,88,298,242,60,174,367
"2011","Dudley 027D","E01009728","Total",1351,88,40,48,1263,41,118,311,212,53,189,339
"2011","Dudley 027E","E01009729","Total",1570,140,84,56,1430,84,204,335,190,86,174,357
"2011","Dudley 028A","E01009720","Total",1416,89,29,60,1327,40,106,349,240,76,174,342
"2011","Dudley 028B","E01009723","Total",1258,74,19,55,1184,32,114,270,202,70,164,332
"2011","Dudley 028C","E01009724","Total",1497,153,51,102,1344,48,136,348,304,36,161,311
"2011","Dudley 028D","E01009730","Total",1488,158,26,132,1330,52,78,418,290,81,157,254
"2011","Dudley 029A","E01009903","Total",1439,141,83,58,1298,17,296,316,262,74,98,235
"2011","Dudley 029B","E01009904","Total",1401,190,126,64,1211,12,222,326,242,61,92,256
"2011","Dudley 029C","E01009909","Total",1362,217,123,94,1145,55,236,273,186,43,109,243
"2011","Dudley 029D","E01009910","Total",1579,238,128,110,1341,136,220,288,220,63,149,265
"2011","Dudley 030A","E01009793","Total",1387,106,50,56,1281,53,136,376,196,83,162,275
"2011","Dudley 030B","E01009794","Total",1477,160,114,46,1317,41,302,292,166,47,119,350
"2011","Dudley 030C","E01009797","Total",1348,255,141,114,1093,59,234,244,168,33,168,187
"2011","Dudley 030D","E01009801","Total",1634,156,90,66,1478,20,296,309,206,57,194,396
"2011","Dudley 031A","E01009721","Total",1844,302,135,167,1542,94,202,394,390,52,131,279
"2011","Dudley 031B","E01009725","Total",1439,173,59,114,1266,146,108,315,180,90,180,247
"2011","Dudley 031C","E01009726","Total",1332,108,40,68,1224,63,184,270,230,73,136,268
"2011","Dudley 031D","E01009834","Total",1605,218,94,124,1387,91,192,249,250,140,194,271
"2011","Dudley 032A","E01009833","Total",1382,144,47,97,1238,103,64,175,184,192,354,166
"2011","Dudley 032B","E01009835","Total",1496,95,38,57,1401,70,80,244,172,215,352,268
"2011","Dudley 032C","E01009869","Total",1590,187,63,124,1403,64,154,328,316,70,162,309
"2011","Dudley 032D","E01009870","Total",1446,219,49,170,1227,35,122,274,348,53,87,308
"2011","Dudley 033A","E01009809","Total",1628,207,115,92,1421,118,158,288,208,138,209,302
"2011","Dudley 033B","E01009813","Total",1600,160,90,70,1440,115,196,292,198,119,230,290
"2011","Dudley 033C","E01009861","Total",1545,187,68,119,1358,95,162,306,218,137,151,289
"2011","Dudley 033D","E01009862","Total",1733,210,73,137,1523,101,170,307,290,117,270,268
"2011","Dudley 033E","E01009863","Total",1844,151,41,110,1693,139,112,404,322,144,308,264
"2011","Dudley 033F","E01009868","Total",1560,205,84,121,1355,92,148,321,278,137,193,186
"2011","Dudley 034A","E01009734","Total",1524,233,123,110,1291,88,204,221,258,70,198,252
"2011","Dudley 034B","E01009735","Total",1495,159,61,98,1336,40,190,359,264,69,152,262
"2011","Dudley 034C","E01009736","Total",1390,157,85,72,1233,37,232,276,228,68,105,287
"2011","Dudley 034D","E01009737","Total",1479,207,96,111,1272,51,218,236,262,63,191,251
"2011","Dudley 034E","E01009738","Total",1558,162,90,72,1396,54,190,313,162,151,235,291
"2011","Dudley 035A","E01009856","Total",1978,341,121,220,1637,90,180,388,370,195,201,213
"2011","Dudley 035B","E01009905","Total",1389,206,87,119,1183,60,182,267,300,33,117,224
"2011","Dudley 035C","E01009906","Total",1621,440,180,260,1181,97,148,294,250,98,101,193
"2011","Dudley 035D","E01009907","Total",1425,214,86,128,1211,70,142,309,220,60,145,265
"2011","Dudley 035E","E01009908","Total",1640,185,75,110,1455,46,174,395,268,120,168,284
"2011","Dudley 036A","E01009800","Total",1529,187,116,71,1342,26,234,363,162,75,162,320
"2011","Dudley 036B","E01009802","Total",1619,187,107,80,1432,61,200,341,208,107,196,319
"2011","Dudley 036C","E01009803","Total",1631,149,117,32,1482,18,276,299,192,55,205,437
"2011","Dudley 036D","E01009804","Total",1286,132,55,77,1154,17,170,224,214,35,150,344
"2011","Dudley 037A","E01009831","Total",1469,227,113,114,1242,60,178,212,188,84,263,257
"2011","Dudley 037B","E01009836","Total",1834,425,122,303,1409,188,98,291,210,148,286,188
"2011","Dudley 037C","E01009837","Total",1589,191,67,124,1398,67,124,249,214,114,336,294
"2011","Dudley 037D","E01009838","Total",1668,153,74,79,1515,112,204,351,200,134,190,324
"2011","Dudley 038A","E01009847","Total",1465,140,81,59,1325,49,234,295,212,45,190,300
"2011","Dudley 038B","E01009848","Total",1430,199,95,104,1231,64,194,308,184,68,164,249
"2011","Dudley 038C","E01009849","Total",1541,192,74,118,1349,83,166,342,228,71,132,327
"2011","Dudley 038D","E01009851","Total",1423,181,104,77,1242,42,208,267,236,66,143,280
"2011","Dudley 039A","E01009732","Total",1736,213,92,121,1523,108,208,285,258,121,243,300
"2011","Dudley 039B","E01009733","Total",1762,496,169,327,1266,178,96,321,248,121,125,177
"2011","Dudley 039C","E01009739","Total",1537,153,63,90,1384,101,216,342,210,70,181,264
"2011","Dudley 039D","E01009799","Total",1497,185,119,66,1312,48,266,342,224,56,135,241
"2011","Dudley 039E","E01009805","Total",1394,185,79,106,1209,58,192,211,236,36,164,312
"2011","Dudley 039F","E01009806","Total",1451,223,89,134,1228,39,210,235,268,41,125,310
"2011","Dudley 040A","E01009854","Total",1502,132,83,49,1370,11,322,313,236,51,137,300
"2011","Dudley 040B","E01009857","Total",1613,240,96,144,1373,97,136,298,250,125,234,233
"2011","Dudley 040C","E01009858","Total",1143,250,125,125,893,34,172,200,234,20,75,158
"2011","Dudley 040D","E01009859","Total",1597,150,80,70,1447,27,242,378,250,94,201,255
"2011","Dudley 041A","E01009845","Total",1521,140,101,39,1381,12,318,279,214,110,146,302
"2011","Dudley 041B","E01009846","Total",1473,155,109,46,1318,69,236,232,212,69,133,367
"2011","Dudley 041C","E01009850","Total",1460,223,114,109,1237,30,226,337,242,86,135,181
"2011","Dudley 041D","E01009852","Total",1473,117,86,31,1356,26,316,302,206,73,133,300
"2011","Dudley 042A","E01009832","Total",1650,185,111,74,1465,128,184,301,174,155,234,289
"2011","Dudley 042B","E01009853","Total",1387,153,113,40,1234,15,392,251,198,51,52,275
"2011","Dudley 042C","E01009855","Total",1597,107,73,34,1490,23,366,277,204,75,161,384
"2011","Dudley 042D","E01009860","Total",1533,131,84,47,1402,28,340,254,238,88,123,331
"2011","Dudley 043A","E01009807","Total",1801,180,141,39,1621,28,364,394,220,58,188,369
"2011","Dudley 043B","E01009808","Total",1452,127,67,60,1325,28,220,309,284,57,147,280
"2011","Dudley 043C","E01009810","Total",1741,235,156,79,1506,82,276,384,240,57,166,301
"2011","Dudley 043D","E01009811","Total",1536,173,83,90,1363,54,262,345,216,58,140,288
"2011","Dudley 043E","E01009812","Total",1507,109,67,42,1398,32,196,338,218,78,184,352
"2011","Sandwell 001A","E01010085","Total",1507,169,75,94,1338,59,138,291,208,85,207,350
"2011","Sandwell 001B","E01010086","Total",1740,206,108,98,1534,140,94,325,242,130,325,278
"2011","Sandwell 001C","E01010087","Total",1689,121,63,58,1568,139,136,309,206,112,286,380
"2011","Sandwell 001D","E01010088","Total",1547,133,62,71,1414,92,100,264,172,115,292,379
"2011","Sandwell 001E","E01010089","Total",1864,173,98,75,1691,152,148,337,198,160,317,379
"2011","Sandwell 002A","E01009969","Total",1944,223,64,159,1721,188,102,529,242,80,325,255
"2011","Sandwell 002B","E01009970","Total",1498,181,103,78,1317,101,196,311,190,99,150,270
"2011","Sandwell 002C","E01009971","Total",1617,205,114,91,1412,170,96,400,190,108,169,279
"2011","Sandwell 002D","E01009973","Total",2439,122,39,83,2317,105,96,543,198,218,538,619
"2011","Sandwell 003A","E01009960","Total",1585,212,113,99,1373,83,156,273,164,134,208,355
"2011","Sandwell 003B","E01009961","Total",1238,136,76,60,1102,35,194,245,204,32,96,296
"2011","Sandwell 003C","E01009966","Total",1217,112,49,63,1105,157,98,224,144,91,168,223
"2011","Sandwell 003D","E01009967","Total",1807,220,99,121,1587,122,182,452,284,94,183,270
"2011","Sandwell 003E","E01010092","Total",1907,243,119,124,1664,133,204,339,230,112,317,329
"2011","Sandwell 004A","E01009962","Total",1336,108,60,48,1228,166,120,199,158,114,156,315
"2011","Sandwell 004B","E01009963","Total",1347,122,64,58,1225,124,104,227,126,123,207,314
"2011","Sandwell 004C","E01009964","Total",1524,136,63,73,1388,166,94,233,166,183,250,296
"2011","Sandwell 004D","E01009965","Total",1419,79,40,39,1340,116,94,288,120,192,266,264
"2011","Sandwell 005A","E01010090","Total",1623,231,77,154,1392,191,154,261,246,79,229,232
"2011","Sandwell 005B","E01010091","Total",1508,214,91,123,1294,74,146,200,238,68,290,278
"2011","Sandwell 005C","E01010096","Total",1479,294,160,134,1185,67,226,203,180,75,158,276
"2011","Sandwell 005D","E01010097","Total",1721,201,118,83,1520,72,296,240,238,67,258,349
"2011","Sandwell 006A","E01009968","Total",1471,237,103,134,1234,48,198,197,188,59,214,330
"2011","Sandwell 006B","E01009972","Total",1817,189,127,62,1628,38,304,334,186,69,289,408
"2011","Sandwell 006C","E01009974","Total",1492,155,95,60,1337,39,244,228,210,61,191,364
"2011","Sandwell 006D","E01009975","Total",1640,167,110,57,1473,55,248,346,176,70,205,373
"2011","Sandwell 007A","E01010030","Total",1493,231,84,147,1262,184,146,264,164,86,173,245
"2011","Sandwell 007B","E01010034","Total",1408,80,19,61,1328,36,66,339,236,56,182,413
"2011","Sandwell 007C","E01010035","Total",1368,127,56,71,1241,30,276,245,246,28,131,285
"2011","Sandwell 007D","E01010036","Total",1651,131,32,99,1520,189,68,431,216,138,218,260
"2011","Sandwell 009A","E01009982","Total",1534,101,44,57,1433,118,76,263,170,193,253,360
"2011","Sandwell 009B","E01009983","Total",1437,132,82,50,1305,113,154,244,200,105,206,283
"2011","Sandwell 009C","E01010029","Total",1399,142,73,69,1257,174,144,225,120,177,179,238
"2011","Sandwell 009D","E01010037","Total",1097,97,38,59,1000,143,86,150,98,139,180,204
"2011","Sandwell 010A","E01009991","Total",2103,222,97,125,1881,167,154,433,194,149,378,406
"2011","Sandwell 010B","E01009994","Total",1545,183,104,79,1362,110,122,266,202,98,236,328
"2011","Sandwell 010C","E01009995","Total",1573,136,51,85,1437,124,156,370,204,109,177,297
"2011","Sandwell 010D","E01009996","Total",1579,195,86,109,1384,133,176,247,182,83,204,359
"2011","Sandwell 010E","E01009997","Total",1701,149,50,99,1552,151,122,303,190,150,309,327
"2011","Sandwell 010F","E01009998","Total",1966,223,92,131,1743,179,132,424,200,166,331,311
"2011","Sandwell 011A","E01010008","Total",1588,174,98,76,1414,96,208,264,150,81,290,325
"2011","Sandwell 011B","E01010010","Total",1342,229,71,158,1113,163,104,196,186,81,165,218
"2011","Sandwell 011C","E01010011","Total",1645,213,97,116,1432,70,204,321,186,117,197,337
"2011","Sandwell 011D","E01010012","Total",1395,143,90,53,1252,52,210,288,166,54,151,331
"2011","Sandwell 012A","E01010007","Total",1281,126,55,71,1155,102,138,225,152,102,154,282
"2011","Sandwell 012B","E01010009","Total",1423,140,77,63,1283,110,128,258,164,83,271,269
"2011","Sandwell 012C","E01010013","Total",1247,125,79,46,1122,95,222,204,132,57,106,306
"2011","Sandwell 012D","E01010014","Total",1628,219,115,104,1409,58,276,280,224,66,184,321
"2011","Sandwell 013A","E01010093","Total",1095,168,66,102,927,70,86,214,168,56,143,190
"2011","Sandwell 013B","E01010094","Total",1465,75,28,47,1390,82,94,252,148,60,324,430
"2011","Sandwell 013C","E01010095","Total",1382,98,45,53,1284,96,102,220,148,133,269,316
"2011","Sandwell 013D","E01010098","Total",1712,269,148,121,1443,109,218,350,208,63,246,249
"2011","Sandwell 013E","E01010099","Total",1636,159,71,88,1477,69,214,341,220,58,217,358
"2011","Sandwell 013F","E01010100","Total",1760,164,61,103,1596,73,138,329,222,85,287,462
"2011","Sandwell 014A","E01009978","Total",1736,126,74,52,1610,46,172,265,176,91,371,489
"2011","Sandwell 014B","E01010031","Total",1566,265,87,178,1301,192,162,324,188,71,142,222
"2011","Sandwell 014C","E01010032","Total",1448,76,33,43,1372,193,62,220,142,299,246,210
"2011","Sandwell 014D","E01010033","Total",1523,353,127,226,1170,148,126,252,224,37,158,225
"2011","Sandwell 014E","E01010074","Total",2274,263,89,174,2011,225,178,529,404,141,197,337
"2011","Sandwell 015A","E01010066","Total",1498,257,140,117,1241,94,154,245,154,141,217,236
"2011","Sandwell 015B","E01010067","Total",1528,269,58,211,1259,123,78,228,174,179,288,189
"2011","Sandwell 015C","E01010068","Total",1557,181,92,89,1376,92,108,297,230,126,232,291
"2011","Sandwell 015D","E01010070","Total",1589,250,120,130,1339,94,160,290,266,88,159,282
"2011","Sandwell 015E","E01010075","Total",1458,63,16,47,1395,58,36,377,144,112,403,265
"2011","Sandwell 015F","E01010076","Total",1287,237,127,110,1050,79,156,203,120,108,154,230
"2011","Sandwell 016A","E01009976","Total",2510,247,45,202,2263,131,124,708,432,110,331,427
"2011","Sandwell 016B","E01009977","Total",1763,182,44,138,1581,133,122,393,298,126,205,304
"2011","Sandwell 016C","E01009979","Total",1550,413,152,261,1137,111,142,212,196,94,196,186
"2011","Sandwell 016D","E01009980","Total",2196,232,66,166,1964,143,120,435,254,158,417,437
"2011","Sandwell 016E","E01010069","Total",1832,119,33,86,1713,78,72,429,230,105,378,421
"2011","Sandwell 016F","E01010071","Total",1728,225,56,169,1503,119,100,330,204,95,320,335
"2011","Sandwell 017A","E01009947","Total",1937,246,120,126,1691,123,188,304,222,140,296,418
"2011","Sandwell 017B","E01009992","Total",1697,161,72,89,1536,128,118,285,156,120,343,386
"2011","Sandwell 017C","E01009993","Total",1829,235,93,142,1594,141,142,267,184,191,359,310
"2011","Sandwell 017D","E01010103","Total",1805,296,118,178,1509,179,118,278,200,139,223,372
"2011","Sandwell 017E","E01010104","Total",1629,420,185,235,1209,85,192,209,156,77,172,318
"2011","Sandwell 017F","E01010105","Total",1483,144,45,99,1339,60,102,196,88,51,378,464
"2011","Sandwell 018A","E01009981","Total",1797,207,92,115,1590,119,162,343,190,191,242,343
"2011","Sandwell 018C","E01009985","Total",1719,217,99,118,1502,101,188,238,140,175,367,293
"2011","Sandwell 018E","E01032887","Total",2734,305,103,202,2429,194,176,335,214,344,662,504
"2011","Sandwell 019A","E01009986","Total",1361,111,53,58,1250,55,110,113,96,173,348,355
"2011","Sandwell 019B","E01009987","Total",1230,148,80,68,1082,114,82,181,112,136,204,253
"2011","Sandwell 019C","E01009989","Total",1645,215,131,84,1430,97,122,248,154,150,295,364
"2011","Sandwell 019D","E01010106","Total",1495,142,56,86,1353,76,76,116,122,88,585,290
"2011","Sandwell 020A","E01009988","Total",1770,270,145,125,1500,139,148,274,192,169,319,259
"2011","Sandwell 020B","E01010101","Total",1825,396,123,273,1429,91,170,264,252,79,275,298
"2011","Sandwell 020C","E01010102","Total",1754,236,111,125,1518,122,160,218,152,131,395,340
"2011","Sandwell 020D","E01010107","Total",1731,280,73,207,1451,140,56,190,96,103,488,378
"2011","Sandwell 021A","E01010015","Total",1686,165,75,90,1521,66,156,261,168,117,350,403
"2011","Sandwell 021B","E01010016","Total",1626,162,42,120,1464,86,62,292,186,150,433,255
"2011","Sandwell 021C","E01010018","Total",2025,272,79,193,1753,214,124,490,306,69,231,319
"2011","Sandwell 021D","E01010072","Total",2290,292,74,218,1998,171,116,533,376,262,309,231
"2011","Sandwell 021E","E01010073","Total",1502,143,44,99,1359,128,112,310,230,61,201,317
"2011","Sandwell 022A","E01010077","Total",1531,203,97,106,1328,147,172,259,180,117,176,277
"2011","Sandwell 022B","E01010079","Total",1523,140,49,91,1383,51,202,315,222,80,202,311
"2011","Sandwell 022C","E01010080","Total",1741,198,39,159,1543,238,116,394,180,203,175,237
"2011","Sandwell 022D","E01010081","Total",1517,147,63,84,1370,65,162,319,256,76,124,368
"2011","Sandwell 022E","E01010082","Total",2303,193,66,127,2110,104,100,591,304,183,363,465
"2011","Sandwell 022F","E01010083","Total",1704,169,94,75,1535,115,170,384,220,153,161,332
"2011","Sandwell 022G","E01010084","Total",1550,106,52,54,1444,217,96,296,140,148,259,288
"2011","Sandwell 023A","E01010046","Total",2067,114,31,83,1953,128,38,344,126,272,751,294
"2011","Sandwell 023B","E01010047","Total",1850,144,52,92,1706,96,94,151,114,225,707,319
"2011","Sandwell 023C","E01010048","Total",1678,89,47,42,1589,103,92,210,108,119,491,466
"2011","Sandwell 023D","E01010049","Total",1624,135,45,90,1489,106,134,226,144,91,332,456
"2011","Sandwell 023E","E01010050","Total",1521,114,62,52,1407,64,102,203,86,115,393,444
"2011","Sandwell 023F","E01010052","Total",1410,133,61,72,1277,72,98,186,90,220,399,212
"2011","Sandwell 023G","E01010053","Total",1917,136,58,78,1781,191,54,242,100,222,675,297
"2011","Sandwell 024A","E01010017","Total",1895,362,145,217,1533,112,140,263,256,162,340,260
"2011","Sandwell 024B","E01010019","Total",1729,183,54,129,1546,112,76,302,170,268,322,296
"2011","Sandwell 024C","E01010020","Total",1887,137,80,57,1750,144,200,268,172,164,374,428
"2011","Sandwell 024D","E01010021","Total",1687,176,62,114,1511,144,118,306,192,89,330,332
"2011","Sandwell 025A","E01010039","Total",1374,108,64,44,1266,125,116,287,146,111,244,237
"2011","Sandwell 025B","E01010043","Total",1464,140,82,58,1324,60,226,299,162,69,160,348
"2011","Sandwell 025C","E01010044","Total",1395,163,88,75,1232,137,160,289,184,79,145,238
"2011","Sandwell 025D","E01010078","Total",1235,116,74,42,1119,19,256,187,178,45,121,313
"2011","Sandwell 026A","E01010059","Total",1926,133,24,109,1793,173,52,294,148,198,518,410
"2011","Sandwell 026B","E01010061","Total",1828,97,35,62,1731,120,66,214,112,240,618,361
"2011","Sandwell 026C","E01010062","Total",1580,276,109,167,1304,197,108,199,122,106,330,242
"2011","Sandwell 026D","E01010063","Total",2129,266,59,207,1863,311,62,309,166,276,493,246
"2011","Sandwell 026E","E01010064","Total",1777,254,113,141,1523,172,80,320,126,155,401,269
"2011","Sandwell 026F","E01010065","Total",2690,169,31,138,2521,259,54,468,254,389,704,393
"2011","Sandwell 027A","E01009934","Total",1439,189,76,113,1250,147,134,275,136,67,244,247
"2011","Sandwell 027B","E01009935","Total",1907,357,127,230,1550,165,238,394,180,64,224,285
"2011","Sandwell 027C","E01009936","Total",1638,155,82,73,1483,48,260,288,244,110,197,336
"2011","Sandwell 027D","E01010004","Total",1558,343,118,225,1215,117,180,209,240,88,181,200
"2011","Sandwell 028A","E01010054","Total",1841,427,179,248,1414,211,100,305,170,141,211,276
"2011","Sandwell 028B","E01010055","Total",1697,192,49,143,1505,103,70,387,140,143,330,332
"2011","Sandwell 028C","E01010056","Total",1600,218,127,91,1382,119,120,226,162,140,350,265
"2011","Sandwell 028D","E01010057","Total",1888,218,121,97,1670,75,118,257,104,196,487,433
"2011","Sandwell 028E","E01010060","Total",1967,213,47,166,1754,157,98,243,166,143,559,388
"2011","Sandwell 029A","E01010038","Total",1789,161,64,97,1628,158,146,411,192,115,285,321
"2011","Sandwell 029B","E01010040","Total",1429,120,65,55,1309,45,216,320,212,57,197,262
"2011","Sandwell 029C","E01010041","Total",1690,235,107,128,1455,151,202,314,252,117,186,233
"2011","Sandwell 029D","E01010045","Total",1599,172,82,90,1427,118,124,321,190,142,217,315
"2011","Sandwell 030A","E01010000","Total",1542,232,129,103,1310,73,190,263,224,54,222,284
"2011","Sandwell 030B","E01010002","Total",2082,213,61,152,1869,152,152,462,302,156,291,354
"2011","Sandwell 030C","E01010003","Total",1490,311,124,187,1179,125,92,219,228,69,175,271
"2011","Sandwell 030D","E01010005","Total",1506,163,63,100,1343,113,128,230,190,78,317,287
"2011","Sandwell 030E","E01010006","Total",1646,162,83,79,1484,64,164,316,220,95,267,358
"2011","Sandwell 031A","E01009938","Total",1703,176,94,82,1527,124,160,329,190,93,241,390
"2011","Sandwell 031B","E01009943","Total",1429,95,57,38,1334,113,114,176,124,138,359,310
"2011","Sandwell 031C","E01009944","Total",1503,177,108,69,1326,75,114,311,120,123,266,317
"2011","Sandwell 031D","E01010051","Total",1232,125,69,56,1107,113,86,185,118,104,214,287
"2011","Sandwell 031E","E01010058","Total",1641,237,107,130,1404,168,142,221,194,109,291,279
"2011","Sandwell 032A","E01009937","Total",1541,148,85,63,1393,128,138,316,192,124,224,271
"2011","Sandwell 032B","E01009939","Total",1753,173,93,80,1580,65,196,373,190,117,312,327
"2011","Sandwell 032C","E01009940","Total",1489,193,92,101,1296,89,152,307,168,86,199,295
"2011","Sandwell 032D","E01009941","Total",1533,171,97,74,1362,102,160,266,182,104,264,284
"2011","Sandwell 032E","E01009942","Total",1648,134,70,64,1514,119,162,325,188,94,203,423
"2011","Sandwell 033A","E01009929","Total",1708,238,132,106,1470,172,152,299,200,137,213,297
"2011","Sandwell 033B","E01009930","Total",1499,195,104,91,1304,96,172,327,188,103,171,247
"2011","Sandwell 033C","E01009931","Total",2240,204,76,128,2036,85,206,467,442,125,288,423
"2011","Sandwell 033D","E01009932","Total",1654,391,196,195,1263,113,122,278,196,120,143,291
"2011","Sandwell 033E","E01009999","Total",1372,113,46,67,1259,100,164,227,184,96,224,264
"2011","Sandwell 034A","E01009921","Total",1579,248,65,183,1331,113,78,343,342,40,141,274
"2011","Sandwell 034B","E01009922","Total",1267,142,82,60,1125,108,114,208,146,80,152,317
"2011","Sandwell 034C","E01009924","Total",1375,186,57,129,1189,75,120,336,310,66,76,206
"2011","Sandwell 034D","E01009925","Total",1349,156,56,100,1193,23,112,324,234,90,129,281
"2011","Sandwell 034E","E01009926","Total",1413,176,56,120,1237,84,90,368,314,48,135,198
"2011","Sandwell 034F","E01009927","Total",1564,281,91,190,1283,69,82,330,250,77,173,302
"2011","Sandwell 034G","E01009928","Total",1696,239,64,175,1457,183,88,348,350,48,171,269
"2011","Sandwell 035A","E01009933","Total",1494,114,55,59,1380,118,132,290,178,100,278,284
"2011","Sandwell 035B","E01009952","Total",1963,363,105,258,1600,179,92,342,300,207,210,270
"2011","Sandwell 035C","E01009955","Total",1856,315,112,203,1541,121,150,241,280,176,291,282
"2011","Sandwell 035D","E01009956","Total",1571,236,107,129,1335,96,144,314,218,116,202,245
"2011","Sandwell 035E","E01009959","Total",1438,131,69,62,1307,35,184,266,268,104,136,314
"2011","Sandwell 035F","E01010042","Total",1787,259,131,128,1528,99,194,343,278,115,226,273
"2011","Sandwell 036A","E01009923","Total",1446,137,66,71,1309,75,196,226,182,102,209,319
"2011","Sandwell 036B","E01010024","Total",1513,164,96,68,1349,37,212,308,210,71,191,320
"2011","Sandwell 036C","E01010026","Total",1727,197,136,61,1530,94,256,289,206,90,276,319
"2011","Sandwell 036D","E01010027","Total",1519,129,58,71,1390,47,204,296,194,83,264,302
"2011","Sandwell 037A","E01010001","Total",1717,228,136,92,1489,110,196,285,166,108,296,328
"2011","Sandwell 037B","E01010022","Total",1550,145,81,64,1405,107,216,301,200,73,214,294
"2011","Sandwell 037C","E01010023","Total",1751,254,145,109,1497,73,208,286,272,71,209,378
"2011","Sandwell 037D","E01010025","Total",1546,254,162,92,1292,98,162,290,164,112,211,255
"2011","Sandwell 037E","E01010028","Total",1394,211,83,128,1183,139,106,217,212,100,199,210
"2011","Sandwell 038A","E01009953","Total",1672,304,125,179,1368,121,150,317,314,72,151,243
"2011","Sandwell 038B","E01009954","Total",1678,218,128,90,1460,80,238,318,204,106,210,304
"2011","Sandwell 038C","E01009957","Total",1650,169,74,95,1481,174,100,305,200,191,219,292
"2011","Sandwell 038D","E01009958","Total",1593,150,75,75,1443,32,214,312,242,90,219,334
"2011","Sandwell 039A","E01009946","Total",1647,170,97,73,1477,58,212,292,230,97,253,335
"2011","Sandwell 039B","E01009948","Total",1472,120,59,61,1352,39,234,256,218,38,178,389
"2011","Sandwell 039C","E01009949","Total",1563,125,84,41,1438,33,228,289,160,71,281,376
"2011","Sandwell 039D","E01009950","Total",1655,148,74,74,1507,54,210,297,192,74,234,446
"2011","Sandwell 039E","E01009951","Total",1897,482,113,369,1415,247,116,411,282,41,142,176
"2011","Sandwell 039F","E01032592","Total",1759,171,97,74,1588,107,244,339,238,45,245,370
"2011","Solihull 001A","E01010118","Total",1277,116,52,64,1161,64,134,160,190,47,181,385
"2011","Solihull 001B","E01010120","Total",1293,283,113,170,1010,135,118,177,204,16,91,269
"2011","Solihull 001C","E01010121","Total",1416,172,111,61,1244,41,230,178,220,53,176,346
"2011","Solihull 001D","E01010122","Total",1380,164,93,71,1216,33,260,153,214,47,159,350
"2011","Solihull 002A","E01010235","Total",1495,166,40,126,1329,193,120,216,130,143,235,292
"2011","Solihull 002B","E01010236","Total",1512,235,66,169,1277,319,90,251,154,88,135,240
"2011","Solihull 002C","E01010239","Total",1568,179,72,107,1389,165,132,279,194,124,225,270
"2011","Solihull 002D","E01010240","Total",1334,213,68,145,1121,164,102,232,154,63,159,247
"2011","Solihull 003A","E01010117","Total",1383,86,46,40,1297,49,164,238,236,16,167,427
"2011","Solihull 003B","E01010119","Total",1506,151,117,34,1355,38,224,264,178,63,192,396
"2011","Solihull 003C","E01010123","Total",1420,166,116,50,1254,23,196,258,160,54,201,362
"2011","Solihull 003D","E01010124","Total",1516,132,92,40,1384,18,268,202,230,67,187,412
"2011","Solihull 004A","E01010146","Total",1616,177,84,93,1439,210,110,259,222,57,272,309
"2011","Solihull 004B","E01010234","Total",1218,192,58,134,1026,221,96,194,138,73,149,155
"2011","Solihull 004C","E01010237","Total",1884,180,82,98,1704,189,228,336,244,90,236,381
"2011","Solihull 004D","E01010238","Total",1408,264,69,195,1144,224,122,193,192,46,164,203
"2011","Solihull 005A","E01010145","Total",1514,203,104,99,1311,108,236,200,154,89,225,299
"2011","Solihull 005B","E01010147","Total",1463,205,43,162,1258,345,62,283,186,87,113,182
"2011","Solihull 005C","E01010148","Total",1831,233,86,147,1598,308,96,297,170,225,212,290
"2011","Solihull 005D","E01010149","Total",1444,130,70,60,1314,81,204,198,162,61,162,446
"2011","Solihull 006A","E01010125","Total",1468,316,125,191,1152,226,128,215,148,77,119,239
"2011","Solihull 006B","E01010129","Total",1496,265,107,158,1231,264,128,202,198,64,171,204
"2011","Solihull 006C","E01010139","Total",1030,97,54,43,933,62,132,132,132,105,170,200
"2011","Solihull 006D","E01010141","Total",1353,292,53,239,1061,218,62,260,168,53,145,155
"2011","Solihull 007A","E01010140","Total",1520,212,87,125,1308,202,126,237,166,111,177,289
"2011","Solihull 007B","E01010142","Total",1433,262,87,175,1171,253,100,233,114,70,184,217
"2011","Solihull 007C","E01010143","Total",1424,247,91,156,1177,199,156,284,154,68,122,194
"2011","Solihull 007D","E01010144","Total",1655,268,111,157,1387,92,188,358,206,99,146,298
"2011","Solihull 008A","E01010111","Total",1465,245,65,180,1220,232,110,221,208,76,186,187
"2011","Solihull 008B","E01010126","Total",1468,256,69,187,1212,229,134,237,154,56,192,210
"2011","Solihull 008C","E01010127","Total",1763,233,53,180,1530,187,162,372,222,159,168,260
"2011","Solihull 008D","E01010128","Total",1451,151,59,92,1300,160,174,284,154,58,213,257
"2011","Solihull 008E","E01010130","Total",1784,311,83,228,1473,344,170,305,184,126,91,253
"2011","Solihull 008F","E01010131","Total",1395,234,61,173,1161,216,134,231,152,74,139,215
"2011","Solihull 009A","E01010109","Total",1377,125,69,56,1252,44,190,220,192,91,161,354
"2011","Solihull 009B","E01010110","Total",1505,104,48,56,1401,78,206,258,208,56,252,343
"2011","Solihull 009C","E01010112","Total",1535,196,45,151,1339,119,128,345,300,66,165,216
"2011","Solihull 009D","E01010113","Total",1308,176,74,102,1132,132,158,191,164,94,154,239
"2011","Solihull 009E","E01010114","Total",1807,187,112,75,1620,50,256,304,232,89,275,414
"2011","Solihull 010A","E01010157","Total",1416,156,63,93,1260,71,136,377,262,66,100,248
"2011","Solihull 010B","E01010159","Total",1413,121,67,54,1292,83,146,353,148,78,168,316
"2011","Solihull 010C","E01010162","Total",1513,174,109,65,1339,51,218,248,184,101,197,340
"2011","Solihull 010D","E01010163","Total",1465,124,72,52,1341,52,154,333,178,140,160,324
"2011","Solihull 011A","E01010132","Total",1432,192,126,66,1240,97,210,234,178,97,131,293
"2011","Solihull 011B","E01010133","Total",1521,255,172,83,1266,61,302,238,138,36,210,281
"2011","Solihull 011C","E01010134","Total",1426,160,106,54,1266,62,204,336,170,56,170,268
"2011","Solihull 011D","E01010135","Total",1498,220,109,111,1278,71,208,252,198,45,212,292
"2011","Solihull 011E","E01010138","Total",1400,166,83,83,1234,62,206,280,220,67,153,246
"2011","Solihull 012A","E01010136","Total",1281,137,76,61,1144,60,130,355,194,85,122,198
"2011","Solihull 012B","E01010137","Total",1312,303,159,144,1009,70,162,203,140,56,117,261
"2011","Solihull 012C","E01010158","Total",1461,238,115,123,1223,134,132,283,166,105,179,224
"2011","Solihull 012D","E01010160","Total",1507,195,98,97,1312,65,200,225,178,87,223,334
"2011","Solihull 012E","E01010161","Total",1525,173,94,79,1352,34,202,293,188,78,244,313
"2011","Solihull 013A","E01010174","Total",1634,163,62,101,1471,95,200,271,220,104,223,358
"2011","Solihull 013B","E01010175","Total",1676,223,104,119,1453,69,230,324,200,88,201,341
"2011","Solihull 013C","E01010177","Total",1350,167,77,90,1183,46,202,291,190,73,132,249
"2011","Solihull 013D","E01010178","Total",1693,466,186,280,1227,115,152,266,270,73,202,149
"2011","Solihull 014A","E01010172","Total",1544,118,80,38,1426,37,204,376,192,81,175,361
"2011","Solihull 014B","E01010173","Total",1451,109,60,49,1342,22,208,367,198,104,217,226
"2011","Solihull 014C","E01010176","Total",1327,90,46,44,1237,37,160,309,106,92,202,331
"2011","Solihull 014D","E01010179","Total",1544,339,212,127,1205,43,238,229,222,35,154,284
"2011","Solihull 015A","E01010115","Total",1498,230,88,142,1268,79,174,319,200,50,172,274
"2011","Solihull 015B","E01010116","Total",1467,66,31,35,1401,19,152,273,254,73,263,367
"2011","Solihull 015C","E01010227","Total",1867,221,132,89,1646,42,298,331,316,44,216,399
"2011","Solihull 015D","E01010228","Total",1636,183,90,93,1453,67,206,380,240,81,220,259
"2011","Solihull 015E","E01010232","Total",2042,376,105,271,1666,218,156,466,306,123,156,241
"2011","Solihull 016A","E01010195","Total",1583,103,76,27,1480,16,262,392,166,127,217,300
"2011","Solihull 016B","E01010226","Total",1523,412,266,146,1111,59,290,272,216,17,55,202
"2011","Solihull 016C","E01010229","Total",1486,111,85,26,1375,10,238,345,138,105,195,344
"2011","Solihull 016D","E01010230","Total",1755,249,117,132,1506,121,216,386,230,78,193,282
"2011","Solihull 016E","E01010231","Total",1705,136,83,53,1569,26,314,371,184,77,283,314
"2011","Solihull 016F","E01010233","Total",1818,218,86,132,1600,85,196,369,322,120,216,292
"2011","Solihull 017A","E01010108","Total",1976,247,118,129,1729,36,320,447,320,112,192,302
"2011","Solihull 017B","E01010164","Total",1555,143,70,73,1412,41,306,311,236,66,130,322
"2011","Solihull 017C","E01010165","Total",1465,285,136,149,1180,62,232,275,224,57,99,231
"2011","Solihull 017D","E01010167","Total",1501,178,70,108,1323,52,182,281,288,68,171,281
"2011","Solihull 018A","E01010199","Total",1863,151,87,64,1712,50,288,470,182,161,298,263
"2011","Solihull 018B","E01010200","Total",1434,263,191,72,1171,60,222,293,160,90,112,234
"2011","Solihull 018C","E01010201","Total",1652,146,88,58,1506,47,224,291,156,125,294,369
"2011","Solihull 018D","E01010204","Total",1248,332,92,240,916,119,112,182,160,57,92,194
"2011","Solihull 018E","E01010205","Total",1493,102,59,43,1391,40,192,287,152,95,256,369
"2011","Solihull 018F","E01010206","Total",1691,135,77,58,1556,53,176,507,190,87,203,340
"2011","Solihull 019A","E01010192","Total",1518,232,117,115,1286,36,238,233,228,70,184,297
"2011","Solihull 019B","E01010196","Total",1675,102,81,21,1573,22,284,326,198,100,287,356
"2011","Solihull 019C","E01010197","Total",1676,128,101,27,1548,14,288,345,202,119,249,331
"2011","Solihull 019D","E01010198","Total",1584,279,183,96,1305,24,260,336,220,64,130,271
"2011","Solihull 021A","E01010218","Total",1282,255,113,142,1027,94,212,150,182,44,108,237
"2011","Solihull 021B","E01010219","Total",1605,221,113,108,1384,66,232,345,184,46,192,319
"2011","Solihull 021C","E01010221","Total",1436,274,146,128,1162,71,212,254,212,32,128,253
"2011","Solihull 021D","E01010222","Total",1460,179,73,106,1281,53,204,273,214,44,197,296
"2011","Solihull 022A","E01010191","Total",1844,223,120,103,1621,53,262,312,266,57,258,413
"2011","Solihull 022B","E01010202","Total",1567,151,86,65,1416,37,232,400,156,71,210,310
"2011","Solihull 022C","E01010203","Total",1725,240,104,136,1485,85,226,323,230,102,200,319
"2011","Solihull 022D","E01010209","Total",1719,180,91,89,1539,87,192,374,254,78,227,327
"2011","Solihull 022E","E01010213","Total",1552,194,93,101,1358,75,176,289,216,95,217,290
"2011","Solihull 023A","E01010208","Total",1528,179,131,48,1349,63,246,333,172,36,190,309
"2011","Solihull 023B","E01010210","Total",1567,145,100,45,1422,13,260,292,218,55,153,431
"2011","Solihull 023C","E01010211","Total",1402,247,158,89,1155,59,228,194,208,30,125,311
"2011","Solihull 023D","E01010217","Total",1515,149,88,61,1366,38,224,293,236,65,116,394
"2011","Solihull 024A","E01010190","Total",1698,160,70,90,1538,59,188,381,252,107,263,288
"2011","Solihull 024B","E01010193","Total",1376,48,23,25,1328,16,138,319,204,90,213,348
"2011","Solihull 024C","E01010194","Total",1642,150,53,97,1492,58,142,487,266,75,157,307
"2011","Solihull 024D","E01010207","Total",1450,168,95,73,1282,44,178,284,196,37,175,368
"2011","Solihull 025A","E01010166","Total",1450,86,59,27,1364,32,302,294,168,88,247,233
"2011","Solihull 025B","E01010168","Total",1871,228,110,118,1643,67,230,485,298,88,220,255
"2011","Solihull 025C","E01010169","Total",1622,162,92,70,1460,25,300,418,226,90,193,208
"2011","Solihull 025D","E01010170","Total",1524,81,48,33,1443,23,186,382,220,118,214,300
"2011","Solihull 025E","E01010171","Total",1344,122,70,52,1222,47,178,284,200,65,172,276
"2011","Solihull 026A","E01010151","Total",1545,370,218,152,1175,84,220,266,230,63,101,211
"2011","Solihull 026B","E01010152","Total",1378,67,39,28,1311,25,204,317,168,106,159,332
"2011","Solihull 026C","E01010153","Total",1512,142,86,56,1370,30,282,309,216,105,160,268
"2011","Solihull 026D","E01010154","Total",1583,182,119,63,1401,16,348,294,202,54,193,294
"2011","Solihull 026E","E01010155","Total",1556,178,107,71,1378,47,304,352,166,85,132,292
"2011","Solihull 026F","E01010156","Total",1553,144,89,55,1409,30,264,357,194,91,167,306
"2011","Solihull 027A","E01010212","Total",1369,77,32,45,1292,4,142,237,186,106,216,401
"2011","Solihull 027B","E01010214","Total",1217,105,39,66,1112,37,176,289,224,20,97,269
"2011","Solihull 027C","E01010215","Total",1623,179,58,121,1444,60,200,318,278,54,218,316
"2011","Solihull 027D","E01010216","Total",1524,151,38,113,1373,36,118,391,268,72,173,315
"2011","Solihull 028A","E01010150","Total",1625,142,96,46,1483,38,264,413,208,118,171,271
"2011","Solihull 028B","E01010184","Total",1429,199,101,98,1230,86,164,331,194,107,94,254
"2011","Solihull 028C","E01010185","Total",1557,120,98,22,1437,16,278,389,206,79,184,285
"2011","Solihull 028D","E01010186","Total",1923,219,119,100,1704,71,218,541,286,141,153,294
"2011","Solihull 028E","E01010187","Total",1516,64,29,35,1452,35,150,501,142,111,207,306
"2011","Solihull 028F","E01010188","Total",1740,143,107,36,1597,16,328,377,224,146,235,271
"2011","Solihull 029A","E01010180","Total",1264,133,71,62,1131,42,148,320,186,62,117,256
"2011","Solihull 029B","E01010181","Total",1951,152,43,109,1799,76,194,598,306,125,207,293
"2011","Solihull 029D","E01010183","Total",1356,106,54,52,1250,47,192,236,220,140,134,281
"2011","Solihull 029E","E01010189","Total",1604,130,71,59,1474,67,226,378,240,103,146,314
"2011","Solihull 029F","E01032885","Total",1197,316,6,310,881,77,28,250,366,31,56,73
"2011","Solihull 029G","E01032886","Total",1974,198,34,164,1776,95,100,595,318,123,233,312
"2011","Solihull 030A","E01010220","Total",1649,162,87,75,1487,65,164,450,238,71,187,312
"2011","Solihull 030B","E01010223","Total",1209,130,59,71,1079,63,140,229,152,86,152,257
"2011","Solihull 030C","E01010225","Total",1491,126,62,64,1365,93,148,408,198,54,215,249
"2011","Solihull 030D","E01032590","Total",1748,184,86,98,1564,57,156,333,210,133,313,362
"2011","Walsall 001A","E01010301","Total",1480,170,68,102,1310,150,178,239,250,80,144,269
"2011","Walsall 001B","E01010303","Total",1497,141,63,78,1356,66,182,276,238,86,166,342
"2011","Walsall 001C","E01010306","Total",1945,191,67,124,1754,94,194,440,286,165,200,375
"2011","Walsall 001D","E01010307","Total",1770,141,64,77,1629,83,120,560,270,94,242,260
"2011","Walsall 002A","E01010302","Total",1502,203,122,81,1299,88,176,250,210,63,216,296
"2011","Walsall 002B","E01010304","Total",1704,188,95,93,1516,57,316,299,280,79,210,275
"2011","Walsall 002C","E01010305","Total",1390,103,46,57,1287,95,168,253,160,120,205,286
"2011","Walsall 002D","E01010308","Total",1268,249,138,111,1019,71,122,195,174,112,116,229
"2011","Walsall 003A","E01010345","Total",1082,112,78,34,970,32,230,159,194,46,73,236
"2011","Walsall 003B","E01010346","Total",1393,84,39,45,1309,48,174,348,206,88,171,274
"2011","Walsall 003C","E01010347","Total",1497,205,111,94,1292,122,192,256,190,127,132,273
"2011","Walsall 003D","E01010350","Total",1463,126,61,65,1337,45,166,399,198,83,191,255
"2011","Walsall 004A","E01010249","Total",1773,207,63,144,1566,151,144,410,272,144,164,281
"2011","Walsall 004B","E01010250","Total",1381,136,77,59,1245,53,234,247,212,44,154,301
"2011","Walsall 004C","E01010252","Total",1767,210,102,108,1557,133,214,342,260,108,182,318
"2011","Walsall 004D","E01010254","Total",1471,187,94,93,1284,77,158,253,222,97,197,280
"2011","Walsall 005A","E01010348","Total",1434,166,93,73,1268,97,210,332,230,79,124,196
"2011","Walsall 005B","E01010349","Total",1259,247,146,101,1012,67,198,199,172,20,114,242
"2011","Walsall 005C","E01010351","Total",1680,205,101,104,1475,58,342,296,248,72,156,303
"2011","Walsall 005D","E01010352","Total",1601,135,86,49,1466,35,372,313,202,52,184,308
"2011","Walsall 006A","E01010284","Total",1524,221,118,103,1303,131,178,276,200,60,152,306
"2011","Walsall 006B","E01010285","Total",1716,201,133,68,1515,78,306,261,254,99,202,315
"2011","Walsall 006C","E01010286","Total",1703,180,78,102,1523,166,164,275,192,168,311,247
"2011","Walsall 006D","E01010290","Total",1621,292,144,148,1329,83,322,206,200,64,135,319
"2011","Walsall 007A","E01010251","Total",1412,68,32,36,1344,19,132,332,264,96,159,342
"2011","Walsall 007B","E01010253","Total",1224,167,93,74,1057,79,180,195,180,62,144,217
"2011","Walsall 007C","E01010255","Total",1337,174,122,52,1163,22,312,262,224,35,79,229
"2011","Walsall 007D","E01010256","Total",1529,221,97,124,1308,60,206,252,224,60,228,278
"2011","Walsall 007E","E01010257","Total",1218,123,74,49,1095,26,250,205,166,45,122,281
"2011","Walsall 008A","E01010292","Total",1571,384,108,276,1187,141,194,225,294,69,116,148
"2011","Walsall 008B","E01010294","Total",1527,267,111,156,1260,139,136,211,174,97,256,247
"2011","Walsall 008C","E01010296","Total",1454,128,31,97,1326,50,106,408,314,41,149,258
"2011","Walsall 008D","E01010297","Total",1439,113,76,37,1326,10,270,306,236,30,201,273
"2011","Walsall 009A","E01010291","Total",1418,130,70,60,1288,160,154,219,158,130,212,255
"2011","Walsall 009B","E01010293","Total",1511,286,158,128,1225,75,240,235,220,77,142,236
"2011","Walsall 009C","E01010298","Total",1172,128,69,59,1044,82,120,188,166,79,120,289
"2011","Walsall 009D","E01010299","Total",1601,139,80,59,1462,165,142,253,174,198,257,273
"2011","Walsall 009E","E01010300","Total",1492,233,130,103,1259,133,154,236,174,120,171,271
"2011","Walsall 010A","E01010319","Total",1402,67,27,40,1335,28,134,260,182,71,250,410
"2011","Walsall 010B","E01010321","Total",1593,171,83,88,1422,113,190,225,208,105,279,302
"2011","Walsall 010C","E01010353","Total",1461,199,110,89,1262,90,260,271,256,46,114,225
"2011","Walsall 010D","E01010354","Total",1534,161,87,74,1373,68,298,315,196,48,145,303
"2011","Walsall 011A","E01010395","Total",1376,70,29,41,1306,43,122,297,258,46,183,357
"2011","Walsall 011B","E01010397","Total",1656,126,62,64,1530,130,160,300,200,163,245,332
"2011","Walsall 011C","E01010398","Total",1652,119,58,61,1533,47,164,328,246,80,275,393
"2011","Walsall 011D","E01010399","Total",1577,158,49,109,1419,101,110,304,282,97,171,354
"2011","Walsall 012A","E01010282","Total",1317,132,54,78,1185,145,104,259,166,114,190,207
"2011","Walsall 012B","E01010287","Total",1384,233,111,122,1151,109,174,256,196,42,166,208
"2011","Walsall 012C","E01010288","Total",1653,163,70,93,1490,139,128,324,200,209,221,269
"2011","Walsall 012D","E01010289","Total",1653,152,82,70,1501,140,152,301,176,185,214,333
"2011","Walsall 013B","E01010277","Total",1614,156,73,83,1458,130,128,274,204,157,221,344
"2011","Walsall 013D","E01010283","Total",1932,142,61,81,1790,207,84,341,282,288,280,308
"2011","Walsall 013E","E01032889","Total",1935,179,74,105,1756,173,118,342,192,268,289,374
"2011","Walsall 014A","E01010393","Total",1497,120,72,48,1377,51,234,239,200,72,215,366
"2011","Walsall 014B","E01010394","Total",1448,100,58,42,1348,57,152,294,198,101,218,328
"2011","Walsall 014C","E01010396","Total",1558,154,86,68,1404,59,160,348,236,103,185,313
"2011","Walsall 014D","E01010400","Total",1884,375,154,221,1509,209,238,374,314,57,109,208
"2011","Walsall 015A","E01010241","Total",2160,379,178,201,1781,82,370,414,356,63,181,315
"2011","Walsall 015B","E01010242","Total",1648,340,180,160,1308,111,224,346,212,62,129,224
"2011","Walsall 015C","E01010243","Total",1511,227,171,56,1284,59,288,283,192,72,108,282
"2011","Walsall 015D","E01010244","Total",1508,188,94,94,1320,198,154,336,172,90,184,186
"2011","Walsall 016A","E01010320","Total",1342,181,81,100,1161,93,196,204,190,84,136,258
"2011","Walsall 016B","E01010322","Total",1527,208,101,107,1319,81,188,341,250,81,127,251
"2011","Walsall 016C","E01010323","Total",1479,162,89,73,1317,85,238,269,218,68,181,258
"2011","Walsall 016D","E01010324","Total",1507,223,93,130,1284,78,124,324,230,67,155,306
"2011","Walsall 017A","E01010271","Total",1803,181,59,122,1622,238,94,408,204,133,194,351
"2011","Walsall 017B","E01010272","Total",1518,290,96,194,1228,209,126,233,244,104,101,211
"2011","Walsall 017C","E01010273","Total",1547,185,101,84,1362,207,118,291,154,155,156,281
"2011","Walsall 017D","E01010295","Total",1474,196,86,110,1278,124,148,218,180,117,207,284
"2011","Walsall 018B","E01010279","Total",1679,233,85,148,1446,154,136,363,252,178,205,158
"2011","Walsall 018D","E01010374","Total",1740,181,42,139,1559,168,86,264,174,247,361,259
"2011","Walsall 018E","E01010375","Total",2208,206,38,168,2002,192,52,350,188,400,510,310
"2011","Walsall 018F","E01032888","Total",2618,288,141,147,2330,215,244,477,286,318,339,451
"2011","Walsall 019A","E01010378","Total",1261,90,37,53,1171,61,134,232,196,68,183,297
"2011","Walsall 019B","E01010379","Total",1319,132,78,54,1187,41,270,222,192,68,88,306
"2011","Walsall 019C","E01010382","Total",1540,171,84,87,1369,75,266,221,230,101,131,345
"2011","Walsall 019D","E01010383","Total",1422,291,115,176,1131,153,122,253,204,75,83,241
"2011","Walsall 020A","E01010376","Total",1364,70,28,42,1294,21,102,236,224,45,223,443
"2011","Walsall 020B","E01010377","Total",1547,161,94,67,1386,69,184,261,220,144,242,266
"2011","Walsall 020C","E01010380","Total",1505,186,122,64,1319,17,384,226,206,27,93,366
"2011","Walsall 020D","E01010381","Total",1486,225,75,150,1261,115,170,274,214,49,184,255
"2011","Walsall 021A","E01010267","Total",1710,182,88,94,1528,98,182,373,334,106,210,225
"2011","Walsall 021B","E01010268","Total",1775,137,41,96,1638,95,64,309,176,363,359,272
"2011","Walsall 021C","E01010274","Total",1579,148,90,58,1431,165,128,282,174,172,196,314
"2011","Walsall 021D","E01010275","Total",1522,200,108,92,1322,159,140,240,194,126,180,283
"2011","Walsall 022A","E01010245","Total",1536,187,134,53,1349,49,272,254,174,81,209,310
"2011","Walsall 022B","E01010246","Total",1567,136,80,56,1431,64,248,315,188,97,179,340
"2011","Walsall 022C","E01010247","Total",1659,191,118,73,1468,42,334,313,200,111,174,294
"2011","Walsall 022D","E01010248","Total",1638,124,77,47,1514,34,334,315,208,96,206,321
"2011","Walsall 022E","E01010388","Total",1442,109,64,45,1333,13,244,245,188,56,208,379
"2011","Walsall 023A","E01010258","Total",1746,203,106,97,1543,232,170,387,222,135,150,247
"2011","Walsall 023B","E01010259","Total",1582,159,94,65,1423,79,230,288,184,68,174,400
"2011","Walsall 023C","E01010260","Total",1594,211,122,89,1383,86,148,313,218,93,204,321
"2011","Walsall 023D","E01010266","Total",1398,95,47,48,1303,138,84,243,212,149,216,261
"2011","Walsall 024A","E01010317","Total",1600,186,104,82,1414,19,328,186,214,77,236,354
"2011","Walsall 024B","E01010318","Total",1537,381,99,282,1156,109,126,204,216,95,172,234
"2011","Walsall 024C","E01010325","Total",1648,264,79,185,1384,54,158,283,202,131,277,279
"2011","Walsall 024D","E01010369","Total",1795,456,77,379,1339,134,92,198,318,107,232,258
"2011","Walsall 025A","E01010401","Total",1463,182,82,100,1281,166,158,272,184,80,147,274
"2011","Walsall 025B","E01010403","Total",1710,208,48,160,1502,196,64,395,196,118,251,282
"2011","Walsall 025C","E01010404","Total",1797,210,73,137,1587,183,136,283,252,123,309,301
"2011","Walsall 025D","E01010407","Total",1641,130,68,62,1511,130,188,237,234,126,246,350
"2011","Walsall 025E","E01010408","Total",1548,204,49,155,1344,147,96,347,258,121,141,234
"2011","Walsall 026A","E01010269","Total",1654,148,45,103,1506,149,36,203,142,400,354,222
"2011","Walsall 026B","E01010270","Total",1782,203,90,113,1579,101,142,279,160,156,356,385
"2011","Walsall 026C","E01010362","Total",1758,157,80,77,1601,174,122,234,182,205,353,331
"2011","Walsall 026D","E01010363","Total",1870,269,74,195,1601,149,64,286,286,221,342,253
"2011","Walsall 027A","E01010402","Total",1704,163,63,100,1541,84,142,415,224,135,219,322
"2011","Walsall 027B","E01010405","Total",1656,238,74,164,1418,97,116,295,270,103,275,262
"2011","Walsall 027C","E01010406","Total",2568,375,105,270,2193,248,106,582,408,165,308,376
"2011","Walsall 027D","E01010409","Total",1602,156,50,106,1446,121,140,298,226,103,213,345
"2011","Walsall 028A","E01010385","Total",1560,174,104,70,1386,26,262,239,172,92,204,391
"2011","Walsall 028B","E01010386","Total",1601,235,177,58,1366,48,344,273,190,58,144,309
"2011","Walsall 028C","E01010387","Total",1569,129,88,41,1440,37,280,307,220,57,176,363
"2011","Walsall 028D","E01010392","Total",1521,171,87,84,1350,36,290,284,224,46,200,270
"2011","Walsall 029A","E01010326","Total",1641,129,61,68,1512,34,178,249,176,87,403,385
"2011","Walsall 029B","E01010327","Total",1676,130,37,93,1546,115,80,336,148,241,414,212
"2011","Walsall 029C","E01010328","Total",1472,113,88,25,1359,23,244,211,130,87,307,357
"2011","Walsall 029D","E01010330","Total",1489,280,116,164,1209,103,102,210,172,95,337,190
"2011","Walsall 030A","E01010368","Total",1891,564,82,482,1327,170,88,242,338,130,193,166
"2011","Walsall 030B","E01010370","Total",1813,410,77,333,1403,117,90,304,228,140,299,225
"2011","Walsall 030C","E01010371","Total",2282,371,80,291,1911,143,36,283,262,273,608,306
"2011","Walsall 030D","E01010372","Total",1585,234,80,154,1351,73,122,206,184,124,393,249
"2011","Walsall 030E","E01010373","Total",1456,130,52,78,1326,39,118,177,176,106,357,353
"2011","Walsall 031A","E01010361","Total",1442,144,50,94,1298,107,98,245,194,99,196,359
"2011","Walsall 031B","E01010364","Total",1533,112,45,67,1421,127,76,266,124,196,334,298
"2011","Walsall 031C","E01010365","Total",1481,243,85,158,1238,134,80,210,98,180,307,229
"2011","Walsall 031D","E01010366","Total",1760,202,91,111,1558,157,136,295,138,151,328,353
"2011","Walsall 031E","E01010367","Total",1724,161,79,82,1563,135,134,248,158,191,363,334
"2011","Walsall 032A","E01010384","Total",1491,115,67,48,1376,56,224,309,180,75,209,323
"2011","Walsall 032B","E01010389","Total",1487,140,73,67,1347,32,284,254,158,41,253,325
"2011","Walsall 032C","E01010390","Total",1728,167,80,87,1561,49,266,388,230,77,146,405
"2011","Walsall 032D","E01010391","Total",1984,172,81,91,1812,59,294,461,262,109,222,405
"2011","Walsall 033A","E01010261","Total",1609,198,56,142,1411,157,94,335,228,124,252,221
"2011","Walsall 033B","E01010263","Total",1666,105,24,81,1561,88,76,267,110,223,505,292
"2011","Walsall 033C","E01010264","Total",1579,208,90,118,1371,59,124,277,204,187,234,286
"2011","Walsall 033D","E01010265","Total",1840,162,46,116,1678,169,76,324,184,210,397,318
"2011","Walsall 034A","E01010336","Total",1617,136,56,80,1481,58,96,214,126,215,394,378
"2011","Walsall 034B","E01010340","Total",1749,163,45,118,1586,89,58,272,122,225,541,279
"2011","Walsall 034C","E01010341","Total",1713,98,35,63,1615,61,70,210,90,294,627,263
"2011","Walsall 034D","E01010342","Total",1620,111,26,85,1509,136,50,273,130,255,353,312
"2011","Walsall 034E","E01010343","Total",1589,93,29,64,1496,81,68,199,118,337,455,238
"2011","Walsall 034F","E01010344","Total",1703,168,75,93,1535,121,120,279,140,298,322,255
"2011","Walsall 035A","E01010331","Total",1682,112,82,30,1570,12,334,209,182,126,310,397
"2011","Walsall 035B","E01010332","Total",1846,145,83,62,1701,21,264,207,184,114,466,445
"2011","Walsall 035C","E01010333","Total",1614,179,98,81,1435,32,264,255,152,94,235,403
"2011","Walsall 035D","E01010334","Total",1561,117,85,32,1444,5,242,260,144,103,307,383
"2011","Walsall 036A","E01010262","Total",1585,197,66,131,1388,106,112,375,226,131,189,249
"2011","Walsall 036B","E01010309","Total",1881,211,63,148,1670,211,116,361,224,206,224,328
"2011","Walsall 036C","E01010311","Total",1647,267,104,163,1380,109,176,319,182,157,160,277
"2011","Walsall 036D","E01010316","Total",1677,158,74,84,1519,207,124,302,206,166,242,272
"2011","Walsall 037A","E01010335","Total",1709,187,73,114,1522,162,82,300,192,235,292,259
"2011","Walsall 037B","E01010337","Total",1420,165,77,88,1255,60,134,233,148,102,296,282
"2011","Walsall 037C","E01010338","Total",1778,116,53,63,1662,76,94,255,120,250,508,359
"2011","Walsall 037D","E01010339","Total",1532,99,62,37,1433,54,138,259,156,151,347,328
"2011","Walsall 038A","E01010310","Total",1750,121,71,50,1629,110,140,254,208,220,385,312
"2011","Walsall 038B","E01010312","Total",1747,216,106,110,1531,153,140,374,214,167,210,273
"2011","Walsall 038C","E01010313","Total",1494,113,56,57,1381,136,116,343,176,92,212,306
"2011","Walsall 038D","E01010314","Total",1566,204,114,90,1362,116,162,194,176,100,283,331
"2011","Walsall 038E","E01010315","Total",1285,180,75,105,1105,120,126,259,226,42,130,202
"2011","Walsall 039A","E01010329","Total",1590,162,119,43,1428,37,278,259,210,66,259,319
"2011","Walsall 039B","E01010355","Total",1465,172,118,54,1293,41,272,314,120,63,175,308
"2011","Walsall 039C","E01010356","Total",1551,153,100,53,1398,42,242,264,206,86,237,321
"2011","Walsall 039D","E01010357","Total",1868,172,76,96,1696,89,262,389,320,80,191,365
"2011","Walsall 039E","E01010358","Total",1461,187,112,75,1274,62,190,250,194,71,189,318
"2011","Walsall 039F","E01010359","Total",1566,171,85,86,1395,101,198,364,188,68,197,279
"2011","Walsall 039G","E01010360","Total",1505,155,96,59,1350,46,234,301,184,82,199,304
"2011","Wolverhampton 001A","E01010434","Total",1683,222,75,147,1461,151,178,321,268,78,174,291
"2011","Wolverhampton 001B","E01010436","Total",1436,160,81,79,1276,25,220,199,234,32,160,406
"2011","Wolverhampton 001C","E01010437","Total",1226,87,27,60,1139,16,134,303,230,36,94,326
"2011","Wolverhampton 001D","E01010438","Total",1373,199,114,85,1174,79,254,166,222,32,134,287
"2011","Wolverhampton 001E","E01010439","Total",1331,152,85,67,1179,97,174,165,150,93,241,259
"2011","Wolverhampton 001F","E01010440","Total",1540,298,157,141,1242,115,160,226,176,108,172,285
"2011","Wolverhampton 001G","E01010441","Total",1384,138,73,65,1246,160,128,231,200,76,165,286
"2011","Wolverhampton 002A","E01010495","Total",1679,284,162,122,1395,163,192,352,254,35,140,259
"2011","Wolverhampton 002B","E01010497","Total",1211,117,44,73,1094,29,82,227,190,42,201,323
"2011","Wolverhampton 002C","E01010499","Total",1367,118,44,74,1249,89,128,287,170,64,228,283
"2011","Wolverhampton 002D","E01010500","Total",1411,93,39,54,1318,213,74,221,114,154,259,283
"2011","Wolverhampton 003A","E01010496","Total",1441,248,104,144,1193,129,76,324,220,64,189,191
"2011","Wolverhampton 003B","E01010498","Total",1453,197,38,159,1256,61,128,244,344,67,136,276
"2011","Wolverhampton 003C","E01010541","Total",1461,245,83,162,1216,221,44,230,184,98,173,266
"2011","Wolverhampton 003D","E01010543","Total",1449,207,43,164,1242,230,62,285,164,101,188,212
"2011","Wolverhampton 004A","E01010456","Total",1469,76,25,51,1393,329,46,283,134,148,246,207
"2011","Wolverhampton 004B","E01010457","Total",1575,192,108,84,1383,64,186,371,216,70,194,282
"2011","Wolverhampton 004C","E01010462","Total",1568,200,81,119,1368,184,148,272,134,88,258,284
"2011","Wolverhampton 004D","E01010481","Total",1548,107,45,62,1441,219,116,203,118,194,248,343
"2011","Wolverhampton 005A","E01010555","Total",1499,278,131,147,1221,146,182,268,224,64,73,264
"2011","Wolverhampton 005B","E01010556","Total",1481,160,69,91,1321,83,180,307,192,82,206,271
"2011","Wolverhampton 005C","E01010557","Total",1440,131,91,40,1309,35,294,232,206,20,183,339
"2011","Wolverhampton 005D","E01010559","Total",1412,241,115,126,1171,73,254,280,188,15,146,215
"2011","Wolverhampton 005E","E01010560","Total",1670,291,144,147,1379,114,264,275,192,73,205,256
"2011","Wolverhampton 006A","E01010435","Total",1374,165,57,108,1209,198,80,288,120,80,185,258
"2011","Wolverhampton 006B","E01010501","Total",1488,181,85,96,1307,123,146,304,178,118,182,256
"2011","Wolverhampton 006C","E01010502","Total",1356,130,59,71,1226,45,130,249,162,85,249,306
"2011","Wolverhampton 006D","E01010503","Total",1331,253,92,161,1078,106,76,216,210,62,190,218
"2011","Wolverhampton 007A","E01010482","Total",1349,117,58,59,1232,162,136,189,130,174,189,252
"2011","Wolverhampton 007B","E01010483","Total",1432,91,34,57,1341,221,88,280,130,151,252,219
"2011","Wolverhampton 007C","E01010484","Total",1379,115,51,64,1264,154,68,243,148,151,212,288
"2011","Wolverhampton 007D","E01010485","Total",1665,155,42,113,1510,255,78,433,142,107,240,255
"2011","Wolverhampton 008A","E01010458","Total",1729,305,169,136,1424,106,146,324,228,105,168,347
"2011","Wolverhampton 008B","E01010459","Total",1629,146,68,78,1483,74,168,317,204,94,168,458
"2011","Wolverhampton 008C","E01010460","Total",1632,169,81,88,1463,59,180,328,192,59,303,342
"2011","Wolverhampton 008D","E01010461","Total",1574,156,80,76,1418,48,202,285,188,79,255,361
"2011","Wolverhampton 008E","E01010566","Total",1795,238,146,92,1557,106,210,326,210,112,326,267
"2011","Wolverhampton 009A","E01010539","Total",1600,177,60,117,1423,145,136,329,238,72,203,300
"2011","Wolverhampton 009B","E01010540","Total",1363,210,106,104,1153,28,264,250,170,53,128,260
"2011","Wolverhampton 009C","E01010542","Total",1527,174,68,106,1353,72,134,355,226,125,154,287
"2011","Wolverhampton 009D","E01010544","Total",1497,163,106,57,1334,38,256,251,174,48,259,308
"2011","Wolverhampton 009E","E01010545","Total",1673,150,62,88,1523,92,184,441,212,100,176,318
"2011","Wolverhampton 010A","E01010554","Total",1404,200,119,81,1204,40,268,239,188,36,162,271
"2011","Wolverhampton 010B","E01010558","Total",1631,203,138,65,1428,40,286,279,214,81,198,330
"2011","Wolverhampton 010C","E01010562","Total",1563,285,104,181,1278,116,242,264,214,46,164,232
"2011","Wolverhampton 010D","E01010563","Total",1493,264,87,177,1229,179,168,260,206,64,132,220
"2011","Wolverhampton 010E","E01010567","Total",1510,226,107,119,1284,105,146,276,206,64,176,311
"2011","Wolverhampton 011A","E01010478","Total",1372,156,33,123,1216,153,48,278,124,140,224,249
"2011","Wolverhampton 011B","E01010479","Total",1571,137,70,67,1434,123,118,265,158,59,334,377
"2011","Wolverhampton 011C","E01010480","Total",1261,120,36,84,1141,98,64,314,174,124,142,225
"2011","Wolverhampton 011D","E01010486","Total",1788,144,48,96,1644,303,60,365,170,241,263,242
"2011","Wolverhampton 012A","E01010474","Total",1527,174,93,81,1353,114,132,290,166,79,285,287
"2011","Wolverhampton 012B","E01010561","Total",1604,132,87,45,1472,48,238,293,208,85,254,346
"2011","Wolverhampton 012C","E01010564","Total",1951,247,60,187,1704,175,86,346,252,116,317,412
"2011","Wolverhampton 012D","E01010565","Total",1868,183,93,90,1685,76,234,334,282,61,295,403
"2011","Wolverhampton 013A","E01010522","Total",1743,199,28,171,1544,189,58,308,216,196,312,265
"2011","Wolverhampton 013B","E01010523","Total",1579,175,63,112,1404,98,84,277,202,99,271,373
"2011","Wolverhampton 013C","E01010524","Total",1535,244,85,159,1291,152,102,238,124,110,320,245
"2011","Wolverhampton 013D","E01010525","Total",1422,129,31,98,1293,154,66,296,148,137,237,255
"2011","Wolverhampton 014A","E01010546","Total",1389,101,71,30,1288,11,260,208,154,74,271,310
"2011","Wolverhampton 014B","E01010547","Total",1456,291,176,115,1165,49,292,207,262,30,82,243
"2011","Wolverhampton 014C","E01010548","Total",1415,314,225,89,1101,69,294,215,182,35,91,215
"2011","Wolverhampton 014D","E01010549","Total",1515,156,93,63,1359,54,206,335,190,30,230,314
"2011","Wolverhampton 014E","E01010553","Total",1565,175,107,68,1390,51,290,268,198,82,211,290
"2011","Wolverhampton 015A","E01010471","Total",1719,434,109,325,1285,207,92,335,178,51,211,211
"2011","Wolverhampton 015B","E01010472","Total",1895,238,62,176,1657,222,106,392,228,73,297,339
"2011","Wolverhampton 015C","E01010473","Total",2458,610,116,494,1848,334,72,387,260,233,323,239
"2011","Wolverhampton 015D","E01010475","Total",1623,202,81,121,1421,112,144,224,196,99,277,369
"2011","Wolverhampton 015E","E01010476","Total",1810,362,69,293,1448,190,112,353,292,99,160,242
"2011","Wolverhampton 015F","E01010477","Total",1706,211,59,152,1495,215,106,327,208,92,236,311
"2011","Wolverhampton 016A","E01010526","Total",1487,119,20,99,1368,120,44,214,126,216,330,318
"2011","Wolverhampton 016B","E01010527","Total",1874,311,78,233,1563,129,82,314,160,153,322,403
"2011","Wolverhampton 016C","E01010528","Total",1050,269,72,197,781,46,44,109,118,82,104,278
"2011","Wolverhampton 016D","E01010529","Total",1618,201,45,156,1417,70,58,138,148,108,229,666
"2011","Wolverhampton 017A","E01010506","Total",1622,496,56,440,1126,90,58,147,306,60,168,297
"2011","Wolverhampton 017B","E01010508","Total",1346,383,51,332,963,64,52,140,262,26,161,258
"2011","Wolverhampton 017C","E01010510","Total",1563,358,73,285,1205,69,114,218,304,62,160,278
"2011","Wolverhampton 017D","E01010511","Total",1598,175,42,133,1423,100,118,231,180,122,276,396
"2011","Wolverhampton 017E","E01010512","Total",1370,285,57,228,1085,62,104,217,172,67,180,283
"2011","Wolverhampton 018A","E01010442","Total",1266,150,52,98,1116,126,132,188,128,58,213,271
"2011","Wolverhampton 018B","E01010443","Total",1711,200,65,135,1511,233,114,314,148,203,219,280
"2011","Wolverhampton 018C","E01010444","Total",1320,218,82,136,1102,61,194,132,164,75,164,312
"2011","Wolverhampton 018D","E01010445","Total",1373,133,30,103,1240,179,80,220,120,105,267,269
"2011","Wolverhampton 018E","E01010447","Total",1798,374,145,229,1424,89,162,303,260,108,216,286
"2011","Wolverhampton 018F","E01010448","Total",1528,272,113,159,1256,107,168,254,218,79,140,290
"2011","Wolverhampton 019A","E01010509","Total",1478,325,159,166,1153,86,182,303,218,32,127,205
"2011","Wolverhampton 019B","E01010550","Total",1595,140,96,44,1455,14,322,243,224,98,215,339
"2011","Wolverhampton 019C","E01010551","Total",1628,285,130,155,1343,49,292,251,288,60,100,303
"2011","Wolverhampton 019D","E01010552","Total",1847,246,144,102,1601,115,258,358,258,74,185,353
"2011","Wolverhampton 020A","E01010463","Total",1633,322,55,267,1311,117,72,213,218,110,277,304
"2011","Wolverhampton 020B","E01010464","Total",1471,505,176,329,966,124,110,148,184,52,179,169
"2011","Wolverhampton 020C","E01010465","Total",1641,172,44,128,1469,154,104,283,166,133,311,318
"2011","Wolverhampton 020D","E01010466","Total",1492,187,55,132,1305,126,44,260,138,75,347,315
"2011","Wolverhampton 020E","E01010470","Total",1405,284,81,203,1121,96,102,211,128,101,244,239
"2011","Wolverhampton 020F","E01010521","Total",1886,562,68,494,1324,184,54,247,462,58,88,231
"2011","Wolverhampton 021A","E01010487","Total",1522,154,80,74,1368,43,168,418,190,109,121,319
"2011","Wolverhampton 021B","E01010488","Total",1436,220,130,90,1216,49,210,269,166,59,154,309
"2011","Wolverhampton 021C","E01010493","Total",1539,166,70,96,1373,73,180,340,196,124,189,271
"2011","Wolverhampton 021D","E01010504","Total",1218,159,89,70,1059,17,210,160,148,37,184,303
"2011","Wolverhampton 021E","E01010505","Total",1264,134,49,85,1130,38,184,220,156,62,157,313
"2011","Wolverhampton 021F","E01010507","Total",1416,216,129,87,1200,28,262,197,198,56,171,288
"2011","Wolverhampton 022A","E01010418","Total",1538,124,54,70,1414,48,144,292,222,94,238,376
"2011","Wolverhampton 022B","E01010421","Total",1584,160,77,83,1424,127,144,256,166,122,321,288
"2011","Wolverhampton 022C","E01010423","Total",1552,245,121,124,1307,179,114,222,156,45,294,297
"2011","Wolverhampton 022D","E01010424","Total",1579,141,71,70,1438,50,184,270,214,98,272,350
"2011","Wolverhampton 023A","E01010417","Total",1651,260,108,152,1391,133,200,264,164,119,226,285
"2011","Wolverhampton 023B","E01010419","Total",1437,162,82,80,1275,124,144,222,186,106,195,298
"2011","Wolverhampton 023C","E01010420","Total",1298,147,69,78,1151,115,130,175,144,106,231,250
"2011","Wolverhampton 023D","E01010425","Total",1351,136,71,65,1215,75,134,211,168,100,222,305
"2011","Wolverhampton 023E","E01010446","Total",1630,253,103,150,1377,92,174,214,208,102,229,358
"2011","Wolverhampton 026A","E01010467","Total",1487,223,71,152,1264,65,138,182,188,83,214,394
"2011","Wolverhampton 026B","E01010468","Total",1500,167,89,78,1333,53,158,285,180,102,223,332
"2011","Wolverhampton 026C","E01010469","Total",1415,180,60,120,1235,69,124,264,232,62,178,306
"2011","Wolverhampton 026D","E01010516","Total",1445,112,56,56,1333,46,154,283,152,94,242,362
"2011","Wolverhampton 026E","E01010518","Total",1603,182,121,61,1421,42,186,253,174,80,267,419
"2011","Wolverhampton 027A","E01010414","Total",1956,429,170,259,1527,231,144,326,280,87,186,273
"2011","Wolverhampton 027B","E01010415","Total",1710,107,44,63,1603,241,94,333,160,179,264,332
"2011","Wolverhampton 027C","E01010416","Total",1665,228,108,120,1437,200,180,234,194,129,213,287
"2011","Wolverhampton 027D","E01010422","Total",1639,194,94,100,1445,57,176,219,172,115,259,447
"2011","Wolverhampton 028A","E01010489","Total",1515,209,100,109,1306,73,218,239,200,62,222,292
"2011","Wolverhampton 028B","E01010490","Total",1728,491,174,317,1237,249,122,290,234,47,88,207
"2011","Wolverhampton 028C","E01010491","Total",1505,194,107,87,1311,109,170,329,152,119,146,286
"2011","Wolverhampton 028D","E01010492","Total",1340,95,49,46,1245,37,130,276,210,78,166,348
"2011","Wolverhampton 028E","E01010494","Total",1585,126,84,42,1459,38,208,375,200,102,218,318
"2011","Wolverhampton 029A","E01010449","Total",2308,267,67,200,2041,299,116,428,288,81,413,416
"2011","Wolverhampton 029B","E01010450","Total",1662,318,92,226,1344,191,118,242,200,113,198,282
"2011","Wolverhampton 029C","E01010451","Total",1577,170,43,127,1407,94,84,285,176,71,296,401
"2011","Wolverhampton 029D","E01010452","Total",1565,240,81,159,1325,179,134,335,204,82,147,244
"2011","Wolverhampton 029E","E01010455","Total",1835,363,120,243,1472,257,118,251,168,129,231,318
"2011","Wolverhampton 030A","E01010427","Total",1591,115,60,55,1476,64,132,215,136,82,381,466
"2011","Wolverhampton 030B","E01010431","Total",1606,76,49,27,1530,30,122,184,82,46,519,547
"2011","Wolverhampton 030C","E01010432","Total",1560,114,52,62,1446,25,144,179,66,63,411,558
"2011","Wolverhampton 030D","E01010519","Total",1471,124,36,88,1347,37,122,260,180,51,332,365
"2011","Wolverhampton 030E","E01010520","Total",1647,180,105,75,1467,60,238,262,202,51,247,407
"2011","Wolverhampton 031A","E01010513","Total",1457,204,150,54,1253,35,280,250,186,47,208,247
"2011","Wolverhampton 031B","E01010514","Total",1624,158,65,93,1466,55,168,416,278,89,208,252
"2011","Wolverhampton 031C","E01010515","Total",1638,180,90,90,1458,56,188,366,236,95,187,330
"2011","Wolverhampton 031D","E01010517","Total",1609,171,73,98,1438,89,156,308,180,62,289,354
"2011","Wolverhampton 032A","E01010533","Total",1696,259,95,164,1437,205,122,278,190,114,275,253
"2011","Wolverhampton 032B","E01010535","Total",1564,210,90,120,1354,198,164,270,124,100,226,272
"2011","Wolverhampton 032C","E01010536","Total",1645,129,93,36,1516,50,286,249,196,76,237,422
"2011","Wolverhampton 032D","E01010537","Total",1462,193,111,82,1269,27,312,269,212,43,135,271
"2011","Wolverhampton 033A","E01010410","Total",1670,317,112,205,1353,196,162,244,258,105,170,218
"2011","Wolverhampton 033B","E01010411","Total",1663,168,78,90,1495,146,138,305,186,130,284,306
"2011","Wolverhampton 033C","E01010412","Total",2036,241,83,158,1795,163,164,395,306,163,289,315
"2011","Wolverhampton 033D","E01010413","Total",1697,229,124,105,1468,181,212,318,220,134,172,231
"2011","Wolverhampton 034A","E01010531","Total",1762,250,141,109,1512,154,216,256,194,118,285,289
"2011","Wolverhampton 034B","E01010532","Total",1558,228,89,139,1330,128,140,327,202,51,209,273
"2011","Wolverhampton 034C","E01010534","Total",1592,66,27,39,1526,33,76,265,118,95,489,450
"2011","Wolverhampton 034D","E01010538","Total",1638,138,75,63,1500,110,164,316,216,108,252,334
"2011","Wolverhampton 035A","E01010426","Total",1347,182,67,115,1165,44,126,167,130,60,273,365
"2011","Wolverhampton 035B","E01010428","Total",1444,138,44,94,1306,85,68,248,128,108,290,379
"2011","Wolverhampton 035C","E01010429","Total",1267,115,38,77,1152,61,106,149,126,111,317,282
"2011","Wolverhampton 035D","E01010430","Total",1710,228,54,174,1482,115,122,279,142,147,291,386
"2011","Wolverhampton 035E","E01010433","Total",1102,153,81,72,949,63,90,187,74,91,166,278
"2011","Wolverhampton 035F","E01010453","Total",1924,177,94,83,1747,274,132,405,176,151,273,336
"2011","Wolverhampton 035G","E01010454","Total",1636,184,75,109,1452,166,100,267,164,131,285,339
"2011","Wolverhampton 035H","E01010530","Total",1382,157,41,116,1225,141,86,245,134,113,182,324
"2011","Bromsgrove 001A","E01032138","Total",1370,116,84,32,1254,24,274,350,158,95,109,244
"2011","Bromsgrove 001B","E01032139","Total",1670,169,110,59,1501,86,230,500,170,118,176,221
"2011","Bromsgrove 001C","E01032140","Total",1702,200,119,81,1502,88,278,363,176,169,181,247
"2011","Bromsgrove 001D","E01032141","Total",1445,152,78,74,1293,25,228,332,172,78,189,269
"2011","Bromsgrove 002A","E01032136","Total",1233,128,61,67,1105,8,168,302,190,60,128,249
"2011","Bromsgrove 002B","E01032137","Total",1496,208,110,98,1288,48,222,351,196,93,146,232
"2011","Bromsgrove 002C","E01032168","Total",1079,141,79,62,938,38,182,245,138,35,87,213
"2011","Bromsgrove 002D","E01032169","Total",1081,154,69,85,927,22,202,195,188,31,102,187
"2011","Bromsgrove 002E","E01032176","Total",2165,204,107,97,1961,41,346,393,416,93,198,474
"2011","Bromsgrove 003A","E01032126","Total",2048,195,125,70,1853,67,386,381,292,82,235,410
"2011","Bromsgrove 003B","E01032170","Total",1446,112,33,79,1334,80,142,340,208,67,192,305
"2011","Bromsgrove 003C","E01032171","Total",1517,148,109,39,1369,27,314,282,164,64,154,364
"2011","Bromsgrove 003D","E01032172","Total",1450,178,76,102,1272,77,190,271,244,47,152,291
"2011","Bromsgrove 004A","E01032133","Total",1647,234,137,97,1413,127,266,349,206,82,107,276
"2011","Bromsgrove 004B","E01032135","Total",1648,112,41,71,1536,48,218,357,270,66,230,347
"2011","Bromsgrove 004C","E01032145","Total",1436,157,97,60,1279,29,286,302,232,58,98,274
"2011","Bromsgrove 004D","E01032147","Total",1193,177,142,35,1016,25,300,168,170,30,97,226
"2011","Bromsgrove 005A","E01032134","Total",1465,175,100,75,1290,35,220,245,244,32,170,344
"2011","Bromsgrove 005B","E01032146","Total",1659,138,84,54,1521,45,310,281,242,102,184,357
"2011","Bromsgrove 005C","E01032177","Total",1125,115,58,57,1010,26,168,235,190,61,112,218
"2011","Bromsgrove 005D","E01032178","Total",1287,118,75,43,1169,22,320,246,158,31,123,269
"2011","Bromsgrove 006A","E01032142","Total",1531,111,70,41,1420,32,220,413,250,47,136,322
"2011","Bromsgrove 006B","E01032143","Total",1343,98,55,43,1245,23,242,287,206,56,110,321
"2011","Bromsgrove 006C","E01032144","Total",1774,224,135,89,1550,66,312,359,216,139,175,283
"2011","Bromsgrove 006D","E01032149","Total",1232,82,37,45,1150,19,172,298,198,76,150,237
"2011","Bromsgrove 007A","E01032127","Total",1584,192,96,96,1392,46,188,407,276,69,95,311
"2011","Bromsgrove 007B","E01032128","Total",1419,159,64,95,1260,96,170,273,274,50,144,253
"2011","Bromsgrove 007C","E01032129","Total",1416,99,52,47,1317,115,136,297,174,107,213,275
"2011","Bromsgrove 007D","E01032152","Total",1336,197,105,92,1139,120,180,267,204,53,129,186
"2011","Bromsgrove 008A","E01032148","Total",1066,112,50,62,954,9,164,231,156,67,149,178
"2011","Bromsgrove 008B","E01032150","Total",1489,130,65,65,1359,28,276,326,250,56,131,292
"2011","Bromsgrove 008C","E01032151","Total",1350,138,78,60,1212,15,200,329,246,30,118,274
"2011","Bromsgrove 008D","E01032153","Total",1428,154,77,77,1274,65,182,316,276,76,109,250
"2011","Bromsgrove 008E","E01032155","Total",1742,107,47,60,1635,74,218,534,240,86,184,299
"2011","Bromsgrove 009A","E01032122","Total",1919,174,87,87,1745,40,250,427,310,103,208,407
"2011","Bromsgrove 009B","E01032123","Total",1524,169,103,66,1355,15,352,201,240,56,188,303
"2011","Bromsgrove 009C","E01032124","Total",1499,215,114,101,1284,83,188,329,268,77,131,208
"2011","Bromsgrove 009D","E01032125","Total",1452,156,107,49,1296,55,224,319,232,93,104,269
"2011","Bromsgrove 010A","E01032154","Total",1770,114,25,89,1656,78,98,555,324,103,176,322
"2011","Bromsgrove 010B","E01032159","Total",1702,258,146,112,1444,43,248,285,296,84,185,303
"2011","Bromsgrove 010C","E01032160","Total",1682,234,110,124,1448,59,242,327,314,62,111,333
"2011","Bromsgrove 010D","E01032161","Total",1439,197,88,109,1242,124,158,287,194,63,175,241
"2011","Bromsgrove 011A","E01032156","Total",1349,325,94,231,1024,109,144,221,298,32,60,160
"2011","Bromsgrove 011B","E01032157","Total",1653,619,397,222,1034,91,244,191,276,48,69,115
"2011","Bromsgrove 011C","E01032173","Total",1676,125,54,71,1551,71,196,348,272,95,240,329
"2011","Bromsgrove 011D","E01032175","Total",1603,143,89,54,1460,51,212,303,302,50,187,355
"2011","Bromsgrove 012A","E01032158","Total",1454,155,101,54,1299,21,326,258,274,45,98,277
"2011","Bromsgrove 012B","E01032162","Total",1915,140,91,49,1775,94,324,495,256,135,137,334
"2011","Bromsgrove 012D","E01033059","Total",1592,107,17,90,1485,82,66,599,260,128,169,181
"2011","Bromsgrove 012E","E01033061","Total",1867,81,38,43,1786,57,158,666,258,152,226,269
"2011","Bromsgrove 013A","E01032130","Total",2649,322,89,233,2327,207,174,717,554,151,225,299
"2011","Bromsgrove 013B","E01032131","Total",1707,176,57,119,1531,196,98,327,210,195,176,329
"2011","Bromsgrove 013C","E01032132","Total",2167,347,196,151,1820,186,242,393,250,132,252,365
"2011","Bromsgrove 013D","E01032174","Total",1554,160,59,101,1394,107,180,405,240,74,112,276
"2011","Bromsgrove 014C","E01032166","Total",2089,304,131,173,1785,72,338,400,370,97,131,377
"2011","Bromsgrove 014E","E01033060","Total",1104,89,36,53,1015,20,154,236,198,46,122,239
"2011","Bromsgrove 014F","E01033062","Total",2356,147,50,97,2209,77,248,514,438,78,297,557
"2011","Bromsgrove 014G","E01033243","Total",1239,150,49,101,1089,27,144,246,268,50,109,245
"2011","Malvern Hills 001A","E01032193","Total",2170,195,108,87,1975,62,366,338,450,152,210,397
"2011","Malvern Hills 001B","E01032212","Total",1918,198,95,103,1720,65,334,392,308,124,147,350
"2011","Malvern Hills 001C","E01032213","Total",1502,156,90,66,1346,29,344,214,276,51,159,273
"2011","Malvern Hills 001D","E01032214","Total",2142,374,224,150,1768,120,348,387,322,132,149,310
"2011","Malvern Hills 002A","E01032181","Total",2027,233,119,114,1794,50,396,342,382,110,183,331
"2011","Malvern Hills 002B","E01032190","Total",1849,208,121,87,1641,54,318,385,258,97,180,349
"2011","Malvern Hills 002C","E01032199","Total",1752,190,114,76,1562,53,274,322,302,138,213,260
"2011","Malvern Hills 002D","E01032223","Total",2031,160,109,51,1871,52,370,409,358,117,227,338
"2011","Malvern Hills 003A","E01032179","Total",1673,162,81,81,1511,57,296,337,296,60,168,297
"2011","Malvern Hills 003B","E01032180","Total",1799,163,80,83,1636,34,338,344,356,55,204,305
"2011","Malvern Hills 003C","E01032182","Total",1960,172,108,64,1788,23,344,390,312,109,204,406
"2011","Malvern Hills 003D","E01032183","Total",1396,109,69,40,1287,52,268,326,208,51,141,241
"2011","Malvern Hills 004A","E01032194","Total",1431,236,115,121,1195,105,188,261,216,31,109,285
"2011","Malvern Hills 004B","E01032195","Total",1612,258,142,116,1354,73,258,322,264,81,134,222
"2011","Malvern Hills 004C","E01032196","Total",1546,280,134,146,1266,57,270,213,260,68,132,266
"2011","Malvern Hills 004D","E01032197","Total",1492,288,141,147,1204,83,202,248,228,64,152,227
"2011","Malvern Hills 005A","E01032205","Total",1066,139,101,38,927,32,192,186,164,57,83,213
"2011","Malvern Hills 005B","E01032206","Total",1180,168,107,61,1012,26,276,209,200,33,90,178
"2011","Malvern Hills 005C","E01032207","Total",1441,153,86,67,1288,56,260,311,250,85,101,225
"2011","Malvern Hills 005D","E01032217","Total",1468,177,94,83,1291,43,306,210,212,142,117,261
"2011","Malvern Hills 006A","E01032188","Total",1975,217,102,115,1758,127,226,447,258,146,257,297
"2011","Malvern Hills 006B","E01032189","Total",1982,201,110,91,1781,73,348,383,316,149,172,340
"2011","Malvern Hills 006C","E01032220","Total",1476,234,76,158,1242,52,158,247,272,110,133,270
"2011","Malvern Hills 006D","E01032221","Total",1230,159,55,104,1071,35,186,243,256,22,112,217
"2011","Malvern Hills 006E","E01032222","Total",1389,192,72,120,1197,107,118,314,230,86,128,214
"2011","Malvern Hills 007A","E01032201","Total",1580,172,91,81,1408,147,216,345,190,114,185,211
"2011","Malvern Hills 007B","E01032202","Total",1735,249,117,132,1486,165,188,382,184,116,207,244
"2011","Malvern Hills 007C","E01032203","Total",1494,267,121,146,1227,43,198,289,232,99,133,233
"2011","Malvern Hills 007D","E01032204","Total",1608,209,86,123,1399,218,100,367,168,169,173,204
"2011","Malvern Hills 008A","E01032191","Total",2267,189,118,71,2078,54,406,411,416,124,180,487
"2011","Malvern Hills 008B","E01032192","Total",1564,190,121,69,1374,88,268,255,264,109,122,268
"2011","Malvern Hills 008C","E01032211","Total",1741,203,127,76,1538,34,428,266,336,67,137,270
"2011","Malvern Hills 009A","E01032184","Total",1541,326,218,108,1215,46,396,176,214,52,118,213
"2011","Malvern Hills 009B","E01032185","Total",1428,140,91,49,1288,31,390,216,192,74,156,229
"2011","Malvern Hills 009C","E01032186","Total",1152,187,99,88,965,54,146,250,190,86,93,146
"2011","Malvern Hills 009D","E01032187","Total",1663,300,154,146,1363,127,204,340,256,64,160,212
"2011","Malvern Hills 010A","E01032208","Total",1379,321,136,185,1058,48,266,178,278,32,86,170
"2011","Malvern Hills 010B","E01032209","Total",1009,280,118,162,729,19,180,121,216,53,32,108
"2011","Malvern Hills 010C","E01032210","Total",1062,163,87,76,899,53,198,159,188,58,108,135
"2011","Malvern Hills 010D","E01032218","Total",1477,179,79,100,1298,47,250,274,274,72,120,261
"2011","Malvern Hills 010E","E01032219","Total",1619,245,112,133,1374,37,274,313,360,68,95,227
"2011","Malvern Hills 011A","E01032198","Total",1944,193,110,83,1751,30,346,334,352,93,221,375
"2011","Malvern Hills 011B","E01032200","Total",2009,196,108,88,1813,49,370,368,296,125,194,411
"2011","Malvern Hills 011C","E01032215","Total",1123,220,124,96,903,53,206,183,166,46,77,172
"2011","Malvern Hills 011D","E01032216","Total",1520,304,136,168,1216,89,242,288,290,35,81,191
"2011","Redditch 001A","E01032226","Total",1986,156,65,91,1830,101,252,435,432,140,153,317
"2011","Redditch 001B","E01032227","Total",1057,91,63,28,966,0,238,169,246,20,76,217
"2011","Redditch 001C","E01032243","Total",1403,116,59,57,1287,22,170,222,312,50,102,409
"2011","Redditch 001D","E01032244","Total",1240,149,65,84,1091,55,140,244,262,50,152,188
"2011","Redditch 002A","E01032240","Total",1341,161,34,127,1180,104,84,300,216,94,134,248
"2011","Redditch 002B","E01032241","Total",1385,103,27,76,1282,127,60,242,192,164,230,267
"2011","Redditch 002C","E01032242","Total",1378,160,38,122,1218,120,90,276,304,102,110,216
"2011","Redditch 002D","E01032245","Total",1369,286,83,203,1083,113,78,207,260,94,147,184
"2011","Redditch 003A","E01032232","Total",1668,326,106,220,1342,222,84,267,250,81,187,251
"2011","Redditch 003B","E01032233","Total",2978,216,26,190,2762,145,150,1035,698,197,280,257
"2011","Redditch 003C","E01032234","Total",1687,234,80,154,1453,202,144,285,292,121,208,201
"2011","Redditch 003D","E01032235","Total",1817,213,100,113,1604,219,204,375,198,116,218,274
"2011","Redditch 004A","E01032224","Total",1774,224,47,177,1550,107,76,261,256,152,395,303
"2011","Redditch 004B","E01032225","Total",1148,161,73,88,987,133,104,232,170,63,125,160
"2011","Redditch 004C","E01032239","Total",1812,217,81,136,1595,131,44,313,242,121,375,369
"2011","Redditch 004D","E01032262","Total",2133,262,87,175,1871,160,128,468,316,166,312,321
"2011","Redditch 005A","E01032273","Total",1392,116,55,61,1276,33,138,248,326,75,138,318
"2011","Redditch 005B","E01032275","Total",1356,169,56,113,1187,75,140,297,320,59,98,198
"2011","Redditch 005C","E01032277","Total",1304,129,31,98,1175,77,70,271,214,93,153,297
"2011","Redditch 005D","E01032278","Total",1603,261,48,213,1342,209,74,380,244,51,164,220
"2011","Redditch 006A","E01032236","Total",1774,322,99,223,1452,106,134,288,316,102,256,250
"2011","Redditch 006B","E01032237","Total",1490,181,54,127,1309,40,158,261,292,87,170,301
"2011","Redditch 006C","E01032238","Total",1356,113,41,72,1243,44,144,205,196,52,257,345
"2011","Redditch 006D","E01032264","Total",1765,118,46,72,1647,108,148,359,252,160,314,306
"2011","Redditch 007A","E01032255","Total",1416,125,83,42,1291,53,192,330,206,74,201,235
"2011","Redditch 007B","E01032263","Total",1784,166,89,77,1618,76,256,250,314,165,209,348
"2011","Redditch 007C","E01032266","Total",1589,161,51,110,1428,94,192,302,342,42,120,336
"2011","Redditch 007D","E01032274","Total",1294,102,40,62,1192,39,140,295,240,65,106,307
"2011","Redditch 008A","E01032259","Total",1412,196,122,74,1216,72,170,282,234,58,133,267
"2011","Redditch 008B","E01032269","Total",1633,262,129,133,1371,55,208,334,302,68,107,297
"2011","Redditch 008C","E01032270","Total",1298,115,44,71,1183,29,184,326,198,46,158,242
"2011","Redditch 008D","E01032271","Total",1313,98,34,64,1215,25,152,342,240,36,154,266
"2011","Redditch 008E","E01032272","Total",1242,158,76,82,1084,19,178,259,204,73,113,238
"2011","Redditch 009A","E01032253","Total",1271,70,29,41,1201,42,158,236,228,90,204,243
"2011","Redditch 009B","E01032265","Total",1596,202,84,118,1394,112,152,333,176,125,254,242
"2011","Redditch 009C","E01032267","Total",1675,131,53,78,1544,144,112,321,276,156,230,305
"2011","Redditch 009D","E01032268","Total",1225,76,35,41,1149,42,148,255,238,41,115,310
"2011","Redditch 009E","E01032276","Total",1475,122,40,82,1353,55,138,344,304,86,97,329
"2011","Redditch 010A","E01032250","Total",1389,111,29,82,1278,142,86,281,194,170,177,228
"2011","Redditch 010B","E01032251","Total",1762,154,33,121,1608,170,88,394,356,107,202,291
"2011","Redditch 010C","E01032252","Total",1434,185,60,125,1249,192,74,233,154,161,203,232
"2011","Redditch 010D","E01032254","Total",1603,129,79,50,1474,85,188,318,202,112,266,303
"2011","Redditch 011A","E01032256","Total",1506,181,81,100,1325,106,168,325,230,67,135,294
"2011","Redditch 011B","E01032257","Total",1463,98,38,60,1365,78,150,313,286,88,176,274
"2011","Redditch 011C","E01032258","Total",1472,245,112,133,1227,62,210,310,280,45,78,242
"2011","Redditch 011D","E01032260","Total",1369,290,118,172,1079,173,126,228,200,47,119,186
"2011","Redditch 012A","E01032246","Total",1404,116,52,64,1288,45,212,296,206,71,149,309
"2011","Redditch 012B","E01032247","Total",1414,198,99,99,1216,90,160,287,286,66,122,205
"2011","Redditch 012C","E01032248","Total",1477,79,32,47,1398,28,126,408,260,78,169,329
"2011","Redditch 012D","E01032249","Total",1579,214,48,166,1365,88,120,362,310,103,131,251
"2011","Redditch 012E","E01032261","Total",1410,130,87,43,1280,37,264,267,200,85,129,298
"2011","Redditch 013A","E01032228","Total",1359,140,52,88,1219,24,180,317,256,69,139,234
"2011","Redditch 013B","E01032229","Total",1483,178,56,122,1305,103,126,309,260,100,82,325
"2011","Redditch 013C","E01032230","Total",1464,137,77,60,1327,42,170,346,262,77,146,284
"2011","Redditch 013D","E01032231","Total",1718,229,108,121,1489,113,266,302,296,93,127,292
"2011","Worcester 001A","E01032296","Total",1576,258,91,167,1318,65,156,350,318,46,143,240
"2011","Worcester 001B","E01032297","Total",1605,157,97,60,1448,42,192,386,310,120,140,258
"2011","Worcester 001C","E01032298","Total",1768,201,147,54,1567,30,344,392,308,73,131,289
"2011","Worcester 001D","E01032299","Total",1539,199,72,127,1340,68,194,345,276,73,120,264
"2011","Worcester 001E","E01032300","Total",1568,151,96,55,1417,37,282,388,238,81,91,300
"2011","Worcester 002A","E01032303","Total",1175,123,57,66,1052,131,134,257,138,100,105,187
"2011","Worcester 002B","E01032304","Total",1447,211,101,110,1236,192,150,261,136,99,162,236
"2011","Worcester 002C","E01032331","Total",1381,250,74,176,1131,134,170,241,224,64,89,209
"2011","Worcester 002D","E01032332","Total",1154,302,75,227,852,166,60,218,168,27,72,141
"2011","Worcester 003A","E01032330","Total",1217,248,68,180,969,60,88,250,260,79,51,181
"2011","Worcester 003B","E01032334","Total",2350,281,54,227,2069,161,94,658,558,121,200,277
"2011","Worcester 003C","E01032335","Total",1602,72,17,55,1530,52,104,626,278,141,107,222
"2011","Worcester 003D","E01032336","Total",1565,143,31,112,1422,79,84,445,382,82,134,216
"2011","Worcester 004A","E01032279","Total",1294,140,48,92,1154,85,98,290,248,63,173,197
"2011","Worcester 004B","E01032312","Total",1465,228,58,170,1237,86,82,317,346,68,98,240
"2011","Worcester 004C","E01032327","Total",1547,301,114,187,1246,90,154,234,364,90,115,199
"2011","Worcester 004D","E01032328","Total",1487,169,97,72,1318,107,136,263,270,66,159,317
"2011","Worcester 004E","E01032329","Total",1988,240,110,130,1748,67,304,371,370,76,177,383
"2011","Worcester 005A","E01032301","Total",1428,175,71,104,1253,64,212,221,266,130,132,228
"2011","Worcester 005B","E01032302","Total",1241,211,72,139,1030,171,80,186,160,63,141,229
"2011","Worcester 005C","E01032310","Total",1462,156,55,101,1306,111,114,298,258,77,143,305
"2011","Worcester 005D","E01032311","Total",1525,170,71,99,1355,168,140,313,212,86,190,246
"2011","Worcester 005E","E01032313","Total",1348,143,52,91,1205,138,64,196,160,183,239,225
"2011","Worcester 005F","E01032333","Total",1957,198,46,152,1759,350,76,434,220,279,157,243
"2011","Worcester 006A","E01032314","Total",1117,106,54,52,1011,39,126,229,192,54,73,298
"2011","Worcester 006B","E01032315","Total",1264,153,72,81,1111,32,166,219,154,27,88,425
"2011","Worcester 006C","E01032316","Total",1129,132,96,36,997,19,248,235,150,25,77,243
"2011","Worcester 006D","E01032317","Total",1502,207,130,77,1295,35,224,250,212,66,130,378
"2011","Worcester 007A","E01032280","Total",1579,366,122,244,1213,72,86,296,338,72,122,227
"2011","Worcester 007B","E01032281","Total",1360,202,65,137,1158,73,88,289,352,46,78,232
"2011","Worcester 007C","E01032282","Total",1669,439,94,345,1230,100,78,187,450,45,128,242
"2011","Worcester 007E","E01033246","Total",1154,300,97,203,854,35,124,188,248,25,80,154
"2011","Worcester 007F","E01033247","Total",927,374,30,344,553,30,20,74,276,5,4,144
"2011","Worcester 008A","E01032337","Total",1898,135,38,97,1763,56,140,490,372,71,243,391
"2011","Worcester 008B","E01032338","Total",2078,169,33,136,1909,154,70,659,410,145,220,251
"2011","Worcester 008C","E01032339","Total",1663,89,26,63,1574,87,122,587,310,91,194,183
"2011","Worcester 009A","E01032318","Total",1584,195,54,141,1389,279,98,267,172,188,109,276
"2011","Worcester 009B","E01032319","Total",1710,173,106,67,1537,35,290,283,244,68,177,440
"2011","Worcester 009C","E01032320","Total",1797,141,65,76,1656,90,150,369,216,114,115,602
"2011","Worcester 009D","E01032321","Total",1492,169,82,87,1323,149,142,261,210,63,201,297
"2011","Worcester 009E","E01032322","Total",1817,490,263,227,1327,90,164,274,298,44,92,365
"2011","Worcester 010A","E01032305","Total",1655,178,57,121,1477,101,164,283,304,89,212,324
"2011","Worcester 010B","E01032306","Total",1534,177,60,117,1357,89,94,338,226,99,233,278
"2011","Worcester 010C","E01032307","Total",1753,149,61,88,1604,128,148,348,192,180,251,357
"2011","Worcester 010D","E01032309","Total",1580,179,105,74,1401,162,150,354,208,104,219,204
"2011","Worcester 011A","E01032285","Total",1682,277,84,193,1405,69,154,454,224,101,181,222
"2011","Worcester 011B","E01032292","Total",1565,202,28,174,1363,83,52,248,264,176,276,264
"2011","Worcester 011D","E01032294","Total",1414,186,76,110,1228,63,112,261,226,92,260,214
"2011","Worcester 011E","E01033248","Total",981,432,88,344,549,51,36,69,256,0,51,86
"2011","Worcester 011F","E01033249","Total",1208,328,78,250,880,96,78,122,330,39,94,121
"2011","Worcester 012A","E01032286","Total",1689,137,53,84,1552,90,152,384,266,105,168,387
"2011","Worcester 012B","E01032287","Total",1552,178,65,113,1374,96,176,351,272,86,115,278
"2011","Worcester 012C","E01032288","Total",1551,169,92,77,1382,53,186,349,276,112,141,265
"2011","Worcester 012D","E01032289","Total",1474,153,113,40,1321,41,308,208,210,71,122,361
"2011","Worcester 012E","E01032290","Total",1502,175,109,66,1327,81,290,327,218,30,111,270
"2011","Worcester 013A","E01032283","Total",1624,202,111,91,1422,115,200,274,296,127,163,247
"2011","Worcester 013B","E01032284","Total",1885,219,117,102,1666,42,328,396,342,80,191,287
"2011","Worcester 013C","E01032295","Total",2414,420,75,345,1994,120,184,458,646,115,177,294
"2011","Worcester 013D","E01032308","Total",1521,143,72,71,1378,82,188,324,280,50,196,258
"2011","Worcester 014A","E01032323","Total",1481,123,68,55,1358,66,200,377,268,48,184,215
"2011","Worcester 014B","E01032324","Total",1355,204,51,153,1151,46,90,375,306,61,133,140
"2011","Worcester 014C","E01032325","Total",1597,177,34,143,1420,97,78,517,302,78,149,199
"2011","Worcester 014D","E01032326","Total",1408,160,78,82,1248,90,196,312,224,30,168,228
"2011","Wychavon 001A","E01032354","Total",2349,233,123,110,2116,85,344,568,376,109,201,433
"2011","Wychavon 001B","E01032386","Total",1319,99,52,47,1220,29,224,227,242,51,202,245
"2011","Wychavon 001C","E01032387","Total",1384,158,76,82,1226,62,214,271,244,57,143,235
"2011","Wychavon 001D","E01032401","Total",1494,144,94,50,1350,25,336,262,278,80,149,220
"2011","Wychavon 002A","E01032368","Total",1221,154,61,93,1067,99,126,224,152,76,175,215
"2011","Wychavon 002B","E01032369","Total",1543,140,52,88,1403,168,98,388,226,129,179,215
"2011","Wychavon 002C","E01032370","Total",1265,98,39,59,1167,47,144,329,216,84,141,206
"2011","Wychavon 002D","E01032371","Total",1348,175,114,61,1173,62,124,279,266,62,165,215
"2011","Wychavon 003A","E01032359","Total",1727,581,332,249,1146,87,276,200,292,31,81,179
"2011","Wychavon 003B","E01032360","Total",1933,212,101,111,1721,149,292,393,266,123,193,305
"2011","Wychavon 003C","E01032361","Total",1694,188,71,117,1506,48,306,347,318,72,117,298
"2011","Wychavon 004A","E01032357","Total",1156,143,78,65,1013,64,166,233,220,31,110,189
"2011","Wychavon 004B","E01032358","Total",1450,225,87,138,1225,73,186,262,204,64,165,271
"2011","Wychavon 004C","E01032365","Total",1803,205,131,74,1598,138,240,404,244,99,153,320
"2011","Wychavon 004D","E01032367","Total",1424,201,131,70,1223,45,248,308,198,52,156,216
"2011","Wychavon 005A","E01032362","Total",1960,137,65,72,1823,68,228,597,310,143,218,259
"2011","Wychavon 005B","E01032363","Total",1521,108,52,56,1413,24,248,309,248,60,137,387
"2011","Wychavon 005C","E01032364","Total",1661,100,51,49,1561,42,202,442,306,76,157,336
"2011","Wychavon 005D","E01032366","Total",1583,232,114,118,1351,69,306,313,246,48,120,249
"2011","Wychavon 006A","E01032399","Total",1652,206,117,89,1446,37,224,356,276,92,150,311
"2011","Wychavon 006B","E01032400","Total",2251,151,80,71,2100,97,344,606,364,140,168,381
"2011","Wychavon 006C","E01032404","Total",2360,226,136,90,2134,35,426,455,430,112,211,465
"2011","Wychavon 007A","E01032345","Total",1447,125,46,79,1322,33,220,367,256,57,186,203
"2011","Wychavon 007B","E01032346","Total",1331,90,40,50,1241,47,224,349,250,60,119,192
"2011","Wychavon 007C","E01032395","Total",1206,111,55,56,1095,28,196,230,222,41,159,219
"2011","Wychavon 007D","E01032417","Total",1491,127,79,48,1364,19,288,319,246,79,144,269
"2011","Wychavon 008A","E01032392","Total",1518,151,88,63,1367,22,350,227,240,41,168,319
"2011","Wychavon 008B","E01032393","Total",1552,133,84,49,1419,35,314,340,226,67,132,305
"2011","Wychavon 008C","E01032394","Total",1182,97,46,51,1085,21,226,203,222,68,124,221
"2011","Wychavon 008D","E01032416","Total",1079,68,38,30,1011,18,216,219,186,46,120,206
"2011","Wychavon 009A","E01032355","Total",1242,99,47,52,1143,25,216,196,174,72,146,314
"2011","Wychavon 009B","E01032356","Total",1123,97,55,42,1026,43,152,292,198,60,85,196
"2011","Wychavon 009C","E01032402","Total",1506,72,18,54,1434,80,100,586,238,113,156,161
"2011","Wychavon 009D","E01032403","Total",1414,143,65,78,1271,54,184,333,270,60,128,242
"2011","Wychavon 010A","E01032375","Total",1165,126,84,42,1039,34,256,196,212,54,137,150
"2011","Wychavon 010B","E01032382","Total",1244,128,66,62,1116,40,214,230,220,72,105,235
"2011","Wychavon 010C","E01032383","Total",1372,131,67,64,1241,23,306,187,262,57,110,296
"2011","Wychavon 010D","E01032410","Total",1354,98,62,36,1256,18,298,276,260,41,127,236
"2011","Wychavon 010E","E01032411","Total",1542,171,113,58,1371,91,240,314,192,67,177,290
"2011","Wychavon 011A","E01032390","Total",1364,103,47,56,1261,52,210,304,228,65,167,235
"2011","Wychavon 011B","E01032391","Total",1097,98,45,53,999,57,136,192,184,85,149,196
"2011","Wychavon 011C","E01032414","Total",1524,167,103,64,1357,36,274,312,246,83,157,249
"2011","Wychavon 011D","E01032415","Total",1243,109,47,62,1134,39,150,311,240,44,109,241
"2011","Wychavon 012A","E01032405","Total",1330,156,91,65,1174,57,296,241,236,53,95,196
"2011","Wychavon 012B","E01032406","Total",1388,392,192,200,996,70,244,220,228,38,65,131
"2011","Wychavon 012C","E01032407","Total",1420,196,116,80,1224,28,214,213,210,76,160,323
"2011","Wychavon 012D","E01032408","Total",1357,159,113,46,1198,34,308,271,222,35,81,247
"2011","Wychavon 012E","E01032409","Total",1506,219,122,97,1287,64,200,265,256,95,148,259
"2011","Wychavon 013A","E01032340","Total",1399,131,82,49,1268,96,204,296,246,52,102,272
"2011","Wychavon 013B","E01032341","Total",1297,92,54,38,1205,28,220,223,242,56,143,293
"2011","Wychavon 013C","E01032349","Total",1500,142,74,68,1358,43,234,292,302,56,114,317
"2011","Wychavon 013D","E01032350","Total",1052,125,66,59,927,40,156,195,224,63,91,158
"2011","Wychavon 013E","E01032388","Total",1343,118,74,44,1225,25,244,299,226,87,97,247
"2011","Wychavon 013F","E01032389","Total",1266,138,72,66,1128,62,224,256,188,72,124,202
"2011","Wychavon 014A","E01032343","Total",2323,442,135,307,1881,162,184,467,502,60,174,332
"2011","Wychavon 014B","E01032377","Total",1758,411,165,246,1347,114,156,372,266,68,108,263
"2011","Wychavon 014C","E01032378","Total",1705,243,136,107,1462,104,154,363,292,92,182,275
"2011","Wychavon 015A","E01032376","Total",1489,168,77,91,1321,44,232,276,232,46,158,333
"2011","Wychavon 015B","E01032384","Total",1313,155,69,86,1158,59,136,241,208,100,152,262
"2011","Wychavon 015C","E01032385","Total",1225,205,137,68,1020,32,360,126,230,47,70,155
"2011","Wychavon 015D","E01032396","Total",1668,105,31,74,1563,69,146,569,258,76,188,257
"2011","Wychavon 016A","E01032342","Total",1547,128,56,72,1419,82,114,415,284,116,174,234
"2011","Wychavon 016B","E01032344","Total",1448,124,73,51,1324,38,278,292,268,57,188,203
"2011","Wychavon 016C","E01032379","Total",1879,150,67,83,1729,74,168,477,294,57,212,447
"2011","Wychavon 016D","E01032380","Total",1533,201,126,75,1332,28,266,323,216,41,125,333
"2011","Wychavon 017A","E01032381","Total",1898,220,93,127,1678,122,182,374,310,94,206,390
"2011","Wychavon 017B","E01032397","Total",1733,217,116,101,1516,91,224,326,298,89,175,313
"2011","Wychavon 017C","E01032398","Total",1761,131,31,100,1630,90,76,511,310,93,221,329
"2011","Wychavon 018A","E01032351","Total",1464,276,204,72,1188,16,398,194,250,32,81,217
"2011","Wychavon 018B","E01032352","Total",1485,157,92,65,1328,31,300,277,280,46,128,266
"2011","Wychavon 018C","E01032353","Total",1568,266,149,117,1302,81,316,276,278,68,99,184
"2011","Wychavon 018D","E01032374","Total",1291,117,66,51,1174,23,218,254,208,85,137,249
"2011","Wychavon 019A","E01032347","Total",1289,135,91,44,1154,32,216,322,212,72,93,207
"2011","Wychavon 019B","E01032348","Total",1215,107,69,38,1108,31,230,285,238,70,85,169
"2011","Wychavon 019C","E01032372","Total",1452,131,70,61,1321,46,262,321,264,81,115,232
"2011","Wychavon 019D","E01032373","Total",1253,113,59,54,1140,18,284,214,202,31,113,278
"2011","Wychavon 019E","E01032412","Total",1229,161,91,70,1068,33,234,244,232,61,99,165
"2011","Wychavon 019F","E01032413","Total",1067,95,53,42,972,36,238,190,180,54,112,162
"2011","Wyre Forest 001A","E01032431","Total",1426,194,92,102,1232,32,300,228,226,69,94,283
"2011","Wyre Forest 001B","E01032432","Total",1271,157,72,85,1114,37,234,236,208,45,110,244
"2011","Wyre Forest 001C","E01032433","Total",1290,126,65,61,1164,44,208,334,186,63,133,196
"2011","Wyre Forest 001D","E01032439","Total",1369,160,103,57,1209,35,240,270,252,71,131,210
"2011","Wyre Forest 001E","E01032440","Total",1163,180,111,69,983,81,174,214,168,43,158,145
"2011","Wyre Forest 001F","E01032479","Total",2065,266,171,95,1799,56,432,367,340,57,166,381
"2011","Wyre Forest 002A","E01032441","Total",1257,105,52,53,1152,33,238,241,228,31,147,234
"2011","Wyre Forest 002B","E01032442","Total",1471,122,45,77,1349,77,158,355,272,98,113,276
"2011","Wyre Forest 002C","E01032443","Total",1326,190,132,58,1136,21,314,231,202,25,109,234
"2011","Wyre Forest 002D","E01032444","Total",1184,132,54,78,1052,65,168,267,206,40,84,222
"2011","Wyre Forest 002E","E01032445","Total",1516,206,101,105,1310,103,228,293,170,87,132,297
"2011","Wyre Forest 003A","E01032436","Total",1522,186,94,92,1336,48,214,291,246,60,161,316
"2011","Wyre Forest 003B","E01032438","Total",1514,171,82,89,1343,56,208,261,306,41,153,318
"2011","Wyre Forest 003C","E01032446","Total",1407,182,94,88,1225,49,216,272,220,101,121,246
"2011","Wyre Forest 003D","E01032447","Total",1426,234,53,181,1192,76,72,305,258,51,185,245
"2011","Wyre Forest 003E","E01032448","Total",1227,90,49,41,1137,38,180,275,160,87,132,265
"2011","Wyre Forest 004A","E01032434","Total",1650,247,46,201,1403,244,90,344,218,109,171,227
"2011","Wyre Forest 004B","E01032435","Total",1440,241,89,152,1199,99,130,234,246,70,232,188
"2011","Wyre Forest 004C","E01032437","Total",1801,180,68,112,1621,190,160,342,326,130,213,260
"2011","Wyre Forest 004D","E01032450","Total",2197,502,191,311,1695,166,110,492,410,79,138,300
"2011","Wyre Forest 005A","E01032430","Total",1678,191,107,84,1487,44,282,328,322,63,164,284
"2011","Wyre Forest 005B","E01032480","Total",1782,203,104,99,1579,47,312,346,316,81,161,316
"2011","Wyre Forest 005C","E01032481","Total",1657,287,132,155,1370,76,282,231,288,51,180,262
"2011","Wyre Forest 005D","E01032482","Total",1398,171,92,79,1227,64,224,293,262,21,112,251
"2011","Wyre Forest 006A","E01032451","Total",1528,161,97,64,1367,21,286,262,264,63,149,322
"2011","Wyre Forest 006B","E01032452","Total",1529,130,88,42,1399,34,306,292,244,85,141,297
"2011","Wyre Forest 006C","E01032453","Total",1681,291,172,119,1390,114,154,343,218,121,165,275
"2011","Wyre Forest 006D","E01032454","Total",1578,287,130,157,1291,66,204,289,308,40,90,294
"2011","Wyre Forest 007A","E01032449","Total",1575,240,55,185,1335,120,92,383,332,26,151,231
"2011","Wyre Forest 007B","E01032464","Total",1495,318,165,153,1177,131,230,220,218,56,103,219
"2011","Wyre Forest 007C","E01032465","Total",1491,183,95,88,1308,175,132,315,168,152,136,230
"2011","Wyre Forest 007D","E01032466","Total",1320,254,124,130,1066,39,266,123,228,28,120,262
"2011","Wyre Forest 007E","E01032467","Total",1158,138,64,74,1020,28,248,154,234,55,102,199
"2011","Wyre Forest 007F","E01032468","Total",1143,119,63,56,1024,19,264,184,206,46,56,249
"2011","Wyre Forest 008A","E01032474","Total",1692,319,54,265,1373,197,108,372,374,56,92,174
"2011","Wyre Forest 008B","E01032475","Total",1645,197,55,142,1448,151,118,382,400,53,109,235
"2011","Wyre Forest 008C","E01032476","Total",1396,203,101,102,1193,76,192,295,206,90,103,231
"2011","Wyre Forest 008D","E01032477","Total",1193,124,87,37,1069,22,266,195,208,47,123,208
"2011","Wyre Forest 008E","E01032478","Total",1529,193,99,94,1336,140,156,296,206,74,214,250
"2011","Wyre Forest 009A","E01032469","Total",1729,182,100,82,1547,117,146,271,166,194,294,359
"2011","Wyre Forest 009B","E01032470","Total",1807,259,136,123,1548,102,214,315,256,149,212,300
"2011","Wyre Forest 009C","E01032471","Total",1608,198,45,153,1410,231,74,265,186,159,236,259
"2011","Wyre Forest 010A","E01032418","Total",1315,189,56,133,1126,56,160,241,268,30,101,270
"2011","Wyre Forest 010B","E01032419","Total",1280,148,91,57,1132,25,318,230,192,22,89,256
"2011","Wyre Forest 010C","E01032420","Total",1261,106,34,72,1155,54,120,267,258,52,145,259
"2011","Wyre Forest 010D","E01032421","Total",1243,78,34,44,1165,23,142,280,230,50,160,280
"2011","Wyre Forest 010E","E01032422","Total",1447,199,29,170,1248,233,22,400,286,41,99,167
"2011","Wyre Forest 011A","E01032427","Total",1540,186,117,69,1354,62,290,284,226,67,151,274
"2011","Wyre Forest 011B","E01032428","Total",1635,366,137,229,1269,61,316,175,374,56,114,173
"2011","Wyre Forest 011C","E01032429","Total",1499,175,105,70,1324,65,342,251,250,51,96,269
"2011","Wyre Forest 011D","E01032472","Total",1203,100,49,51,1103,22,264,171,190,45,123,288
"2011","Wyre Forest 011E","E01032473","Total",1222,122,75,47,1100,57,202,257,180,62,82,260
"2011","Wyre Forest 012A","E01032455","Total",1506,148,93,55,1358,57,290,223,226,106,179,277
"2011","Wyre Forest 012B","E01032456","Total",1196,140,61,79,1056,98,130,245,202,70,114,197
"2011","Wyre Forest 012C","E01032457","Total",1276,145,86,59,1131,70,166,333,166,75,114,207
"2011","Wyre Forest 012D","E01032458","Total",1367,179,119,60,1188,39,300,219,200,64,139,227
"2011","Wyre Forest 012E","E01032459","Total",1438,158,87,71,1280,78,234,265,204,80,145,274
"2011","Wyre Forest 013A","E01032460","Total",1785,352,161,191,1433,104,246,396,308,40,125,214
"2011","Wyre Forest 013B","E01032461","Total",1970,349,63,286,1621,111,174,419,368,61,161,327
"2011","Wyre Forest 013C","E01032462","Total",2224,238,102,136,1986,125,268,611,406,103,168,305
"2011","Wyre Forest 013D","E01032463","Total",1635,217,141,76,1418,41,338,303,268,48,123,297
"2011","Wyre Forest 014A","E01032423","Total",1499,186,91,95,1313,59,324,238,228,36,136,292
"2011","Wyre Forest 014B","E01032424","Total",1423,218,93,125,1205,157,146,230,188,119,122,243
"2011","Wyre Forest 014C","E01032425","Total",1424,176,117,59,1248,56,314,264,202,31,111,270
"2011","Wyre Forest 014D","E01032426","Total",1436,196,104,92,1240,49,284,272,254,35,106,240
"2011","Bedford 001A","E01017540","Total",1465,120,71,49,1345,42,228,267,244,81,183,300
"2011","Bedford 001B","E01017541","Total",1268,109,52,57,1159,51,202,246,238,105,137,180
"2011","Bedford 001C","E01017544","Total",1398,134,80,54,1264,66,232,279,208,89,156,234
"2011","Bedford 001D","E01017545","Total",1484,116,53,63,1368,82,182,339,250,99,210,206
"2011","Bedford 002A","E01017464","Total",1460,142,80,62,1318,36,292,311,236,93,129,221
"2011","Bedford 002B","E01017465","Total",1395,153,89,64,1242,45,288,302,230,76,64,237
"2011","Bedford 002C","E01017503","Total",1270,122,64,58,1148,68,158,305,176,79,139,223
"2011","Bedford 002D","E01017504","Total",1971,264,113,151,1707,95,250,513,236,160,202,251
"2011","Bedford 002E","E01017546","Total",1211,125,79,46,1086,62,142,230,224,84,134,210
"2011","Bedford 002F","E01017547","Total",1547,153,81,72,1394,43,204,243,268,61,236,339
"2011","Bedford 003A","E01017478","Total",1688,189,97,92,1499,87,234,358,240,73,145,362
"2011","Bedford 003B","E01017479","Total",1260,260,143,117,1000,31,228,205,180,85,106,165
"2011","Bedford 003C","E01017480","Total",1923,171,66,105,1752,151,142,586,270,129,222,252
"2011","Bedford 003D","E01017481","Total",1198,113,42,71,1085,79,162,301,154,73,127,189
"2011","Bedford 003E","E01017528","Total",2487,175,100,75,2312,98,298,673,330,241,208,464
"2011","Bedford 004B","E01017495","Total",2003,188,84,104,1815,104,246,537,360,113,169,286
"2011","Bedford 004C","E01017496","Total",1473,157,96,61,1316,53,248,301,288,41,111,274
"2011","Bedford 004D","E01017542","Total",1378,150,69,81,1228,49,196,278,254,26,172,253
"2011","Bedford 004E","E01017543","Total",1427,123,42,81,1304,48,200,272,290,98,136,260
"2011","Bedford 004F","E01033431","Total",1416,55,13,42,1361,200,52,439,212,171,154,133
"2011","Bedford 004G","E01033432","Total",2211,218,132,86,1993,145,342,420,366,148,220,352
"2011","Bedford 005A","E01017453","Total",1302,254,99,155,1048,86,158,261,188,52,103,200
"2011","Bedford 005B","E01017454","Total",1473,112,74,38,1361,81,216,252,232,87,170,323
"2011","Bedford 005C","E01017455","Total",1458,205,98,107,1253,49,234,291,198,37,134,310
"2011","Bedford 005D","E01017456","Total",1432,173,126,47,1259,28,316,245,182,50,128,310
"2011","Bedford 005E","E01017457","Total",1180,125,63,62,1055,64,144,307,174,55,114,197
"2011","Bedford 005F","E01017458","Total",1280,122,43,79,1158,90,138,269,194,77,164,226
"2011","Bedford 006A","E01017529","Total",1295,107,66,41,1188,57,172,270,190,66,126,307
"2011","Bedford 006B","E01017530","Total",1410,110,75,35,1300,30,274,263,222,72,103,336
"2011","Bedford 006C","E01017531","Total",1354,202,94,108,1152,114,148,217,186,105,150,232
"2011","Bedford 006D","E01017532","Total",1271,100,76,24,1171,28,252,259,160,78,126,268
"2011","Bedford 006E","E01017533","Total",1185,90,58,32,1095,17,244,179,188,46,110,311
"2011","Bedford 006F","E01017534","Total",1533,170,120,50,1363,51,274,322,194,52,173,297
"2011","Bedford 007A","E01017488","Total",1451,186,145,41,1265,44,310,214,170,80,149,298
"2011","Bedford 007B","E01017489","Total",1581,150,78,72,1431,253,104,345,174,109,199,247
"2011","Bedford 007C","E01017490","Total",1383,226,101,125,1157,202,98,265,186,91,114,201
"2011","Bedford 007D","E01017491","Total",1548,193,102,91,1355,61,198,331,182,104,157,322
"2011","Bedford 007E","E01017492","Total",1470,175,50,125,1295,219,102,290,202,122,136,224
"2011","Bedford 007F","E01017493","Total",1657,164,26,138,1493,204,82,472,236,107,190,202
"2011","Bedford 008A","E01017459","Total",1683,161,90,71,1522,85,208,381,286,170,133,259
"2011","Bedford 008B","E01017460","Total",1586,147,77,70,1439,59,200,337,284,76,197,286
"2011","Bedford 008C","E01017461","Total",1904,136,32,104,1768,82,192,512,322,155,209,296
"2011","Bedford 008D","E01017462","Total",1602,122,69,53,1480,40,198,452,216,127,172,275
"2011","Bedford 008E","E01017463","Total",1345,182,119,63,1163,32,292,234,192,78,127,208
"2011","Bedford 009A","E01017482","Total",1245,290,89,201,955,48,140,205,176,65,116,205
"2011","Bedford 009B","E01017483","Total",1366,190,109,81,1176,46,216,214,214,76,136,274
"2011","Bedford 009C","E01017484","Total",838,315,74,241,523,22,54,109,146,31,69,92
"2011","Bedford 009D","E01017485","Total",1359,252,36,216,1107,43,76,310,254,64,182,178
"2011","Bedford 010A","E01017497","Total",1399,175,31,144,1224,111,66,260,250,52,112,373
"2011","Bedford 010B","E01017498","Total",1277,123,51,72,1154,64,140,253,166,67,161,303
"2011","Bedford 010C","E01017499","Total",1212,271,53,218,941,41,82,205,232,53,108,220
"2011","Bedford 010D","E01017500","Total",1129,311,76,235,818,43,50,178,212,17,77,241
"2011","Bedford 010E","E01017501","Total",1066,356,157,199,710,45,70,152,218,50,56,119
"2011","Bedford 010F","E01017502","Total",1491,513,249,264,978,49,104,172,198,68,165,222
"2011","Bedford 011A","E01017524","Total",1560,173,82,91,1387,77,164,335,198,97,200,316
"2011","Bedford 011B","E01017525","Total",1206,139,56,83,1067,86,128,258,154,87,112,242
"2011","Bedford 011C","E01017526","Total",1455,165,38,127,1290,98,98,424,238,83,106,243
"2011","Bedford 011D","E01017527","Total",1167,163,54,109,1004,100,116,269,240,46,102,131
"2011","Bedford 012A","E01017466","Total",1865,316,42,274,1549,98,40,259,244,101,428,379
"2011","Bedford 012B","E01017467","Total",1280,240,105,135,1040,52,92,301,294,31,95,175
"2011","Bedford 012C","E01017468","Total",1311,195,61,134,1116,70,86,317,302,41,106,194
"2011","Bedford 012D","E01017469","Total",1649,408,111,297,1241,70,86,269,324,74,124,294
"2011","Bedford 012E","E01017470","Total",1275,112,56,56,1163,51,76,346,234,67,86,303
"2011","Bedford 012F","E01017471","Total",1442,423,89,334,1019,97,50,199,296,18,160,199
"2011","Bedford 013A","E01017535","Total",1443,95,51,44,1348,67,98,240,136,153,394,260
"2011","Bedford 013B","E01017536","Total",2391,176,29,147,2215,176,70,428,312,202,618,409
"2011","Bedford 013C","E01017537","Total",1369,136,60,76,1233,101,94,190,86,185,301,276
"2011","Bedford 013D","E01017538","Total",1815,93,47,46,1722,116,86,193,96,212,612,407
"2011","Bedford 013E","E01017539","Total",1508,140,55,85,1368,62,54,232,146,178,399,297
"2011","Bedford 014A","E01017518","Total",1496,174,63,111,1322,126,86,360,204,108,185,253
"2011","Bedford 014B","E01017519","Total",1578,194,94,100,1384,182,134,246,190,104,249,279
"2011","Bedford 014C","E01017520","Total",1459,198,42,156,1261,101,128,260,260,58,200,254
"2011","Bedford 014D","E01017521","Total",1519,179,65,114,1340,100,132,348,206,86,206,262
"2011","Bedford 014E","E01017522","Total",1810,367,161,206,1443,131,114,329,298,143,143,285
"2011","Bedford 014F","E01017523","Total",1556,158,62,96,1398,281,54,337,150,164,176,236
"2011","Bedford 015A","E01017472","Total",1462,130,39,91,1332,187,60,286,138,142,286,233
"2011","Bedford 015B","E01017473","Total",2251,320,20,300,1931,178,54,388,344,111,360,496
"2011","Bedford 015C","E01017474","Total",1728,193,28,165,1535,89,62,303,182,212,404,283
"2011","Bedford 015D","E01017475","Total",1521,131,58,73,1390,69,76,379,186,102,273,305
"2011","Bedford 015E","E01017476","Total",1457,120,65,55,1337,77,206,225,134,74,265,356
"2011","Bedford 015F","E01017477","Total",1261,178,100,78,1083,145,120,191,114,136,205,172
"2011","Bedford 016A","E01017509","Total",1221,175,59,116,1046,122,100,224,102,85,216,197
"2011","Bedford 016B","E01017510","Total",1507,193,74,119,1314,64,174,312,274,84,137,269
"2011","Bedford 016C","E01017511","Total",1258,96,24,72,1162,73,128,226,212,57,213,253
"2011","Bedford 016D","E01017512","Total",1424,125,33,92,1299,115,86,250,208,88,239,313
"2011","Bedford 017A","E01017505","Total",1517,186,70,116,1331,119,170,292,222,52,148,328
"2011","Bedford 017B","E01017506","Total",1552,212,80,132,1340,133,92,378,230,89,147,271
"2011","Bedford 017C","E01017507","Total",1349,135,49,86,1214,92,102,307,184,57,228,244
"2011","Bedford 017D","E01017508","Total",1610,193,70,123,1417,85,160,352,224,97,202,297
"2011","Bedford 018A","E01017513","Total",1483,107,42,65,1376,97,130,323,194,96,193,343
"2011","Bedford 018B","E01017514","Total",1635,195,72,123,1440,125,148,307,180,143,200,337
"2011","Bedford 018C","E01017515","Total",1570,183,101,82,1387,120,120,313,202,120,181,331
"2011","Bedford 018D","E01017516","Total",1481,132,68,64,1349,72,160,296,174,110,198,339
"2011","Bedford 018E","E01017517","Total",1592,126,51,75,1466,101,148,364,172,93,179,409
"2011","Bedford 019A","E01017486","Total",1719,157,69,88,1562,82,182,473,284,125,200,216
"2011","Bedford 019B","E01017487","Total",1808,139,24,115,1669,170,90,521,252,126,285,225
"2011","Bedford 019C","E01017548","Total",1833,140,68,72,1693,176,172,440,400,93,125,287
"2011","Bedford 019D","E01017549","Total",1408,205,137,68,1203,19,276,280,258,66,122,182
"2011","Bedford 019E","E01017550","Total",2692,197,60,137,2495,138,198,662,404,208,375,510
"2011","Bedford 020A","E01017551","Total",1447,86,41,45,1361,80,166,338,170,61,187,359
"2011","Bedford 020B","E01017552","Total",1189,168,76,92,1021,54,106,280,166,92,167,156
"2011","Bedford 020C","E01017553","Total",1258,82,33,49,1176,35,188,306,184,86,148,229
"2011","Bedford 020D","E01017554","Total",1451,203,130,73,1248,81,246,265,180,98,97,281
"2011","Central Bedfordshire 001A","E01017433","Total",1588,225,113,112,1363,126,84,284,190,197,203,279
"2011","Central Bedfordshire 001B","E01017434","Total",1683,164,69,95,1519,75,174,410,322,97,130,311
"2011","Central Bedfordshire 001C","E01017436","Total",2329,153,48,105,2176,85,186,718,492,177,261,257
"2011","Central Bedfordshire 002A","E01017430","Total",1392,180,78,102,1212,93,168,307,208,88,90,258
"2011","Central Bedfordshire 002B","E01017431","Total",1474,228,76,152,1246,67,136,330,294,58,110,251
"2011","Central Bedfordshire 002C","E01017432","Total",1428,97,46,51,1331,35,190,272,274,82,146,332
"2011","Central Bedfordshire 002D","E01017435","Total",1690,213,93,120,1477,109,150,394,296,128,163,237
"2011","Central Bedfordshire 003A","E01017425","Total",1062,84,49,35,978,29,128,212,228,40,104,237
"2011","Central Bedfordshire 003B","E01017426","Total",1370,132,62,70,1238,22,196,299,284,54,159,224
"2011","Central Bedfordshire 003C","E01017427","Total",1725,181,82,99,1544,69,188,401,322,93,153,318
"2011","Central Bedfordshire 003D","E01017428","Total",1631,190,102,88,1441,57,178,426,270,99,149,262
"2011","Central Bedfordshire 003E","E01017429","Total",1405,196,62,134,1209,44,140,345,306,55,139,180
"2011","Central Bedfordshire 004A","E01017412","Total",1481,161,62,99,1320,32,190,299,246,99,183,271
"2011","Central Bedfordshire 004B","E01017422","Total",1516,140,88,52,1376,39,250,317,256,97,147,270
"2011","Central Bedfordshire 004C","E01017423","Total",1536,144,83,61,1392,36,274,329,272,110,141,230
"2011","Central Bedfordshire 004D","E01017424","Total",1374,123,67,56,1251,51,228,225,258,56,159,274
"2011","Central Bedfordshire 005A","E01017383","Total",1862,300,59,241,1562,81,152,485,332,61,195,256
"2011","Central Bedfordshire 005B","E01017384","Total",1609,212,92,120,1397,99,128,437,234,117,185,197
"2011","Central Bedfordshire 005C","E01017385","Total",1608,383,136,247,1225,89,164,304,366,57,76,169
"2011","Central Bedfordshire 005D","E01017386","Total",1782,200,80,120,1582,98,150,483,348,71,147,285
"2011","Central Bedfordshire 005E","E01017387","Total",1350,92,45,47,1258,70,122,323,218,97,147,281
"2011","Central Bedfordshire 005F","E01017388","Total",1344,133,54,79,1211,75,142,280,238,77,122,277
"2011","Central Bedfordshire 006A","E01017381","Total",1473,136,75,61,1337,40,260,321,234,65,119,298
"2011","Central Bedfordshire 006B","E01017382","Total",1447,143,92,51,1304,84,200,305,164,88,195,268
"2011","Central Bedfordshire 006C","E01017389","Total",1944,145,44,101,1799,80,168,628,310,98,237,278
"2011","Central Bedfordshire 006D","E01017390","Total",2032,190,80,110,1842,158,176,444,308,170,217,369
"2011","Central Bedfordshire 007A","E01017379","Total",1191,157,91,66,1034,47,172,244,194,77,118,182
"2011","Central Bedfordshire 007B","E01017380","Total",1234,106,52,54,1128,30,196,285,244,50,119,204
"2011","Central Bedfordshire 007C","E01017394","Total",1538,123,57,66,1415,35,148,410,230,103,156,333
"2011","Central Bedfordshire 007F","E01017397","Total",1673,152,72,80,1521,42,192,369,296,95,212,315
"2011","Central Bedfordshire 007G","E01033194","Total",2114,163,73,90,1951,50,212,485,264,188,295,457
"2011","Central Bedfordshire 008A","E01017410","Total",1199,102,63,39,1097,25,174,216,226,76,136,244
"2011","Central Bedfordshire 008B","E01017411","Total",1514,144,68,76,1370,55,212,351,264,53,163,272
"2011","Central Bedfordshire 008C","E01017419","Total",1612,106,63,43,1506,22,244,389,210,111,262,268
"2011","Central Bedfordshire 008D","E01017420","Total",1520,182,102,80,1338,68,164,365,264,65,124,288
"2011","Central Bedfordshire 008E","E01017421","Total",1733,167,91,76,1566,56,238,400,272,117,217,266
"2011","Central Bedfordshire 009A","E01017416","Total",1981,165,71,94,1816,87,176,529,342,110,171,401
"2011","Central Bedfordshire 009B","E01017417","Total",2365,184,49,135,2181,147,140,695,406,173,220,400
"2011","Central Bedfordshire 009C","E01017418","Total",1495,186,101,85,1309,122,156,294,248,53,139,297
"2011","Central Bedfordshire 009D","E01017451","Total",1416,144,74,70,1272,32,154,350,244,117,117,258
"2011","Central Bedfordshire 009E","E01017452","Total",1166,230,138,92,936,22,198,209,204,51,81,171
"2011","Central Bedfordshire 010A","E01017376","Total",1840,238,55,183,1602,80,120,536,410,89,99,268
"2011","Central Bedfordshire 010B","E01017377","Total",1924,158,45,113,1766,86,160,468,348,104,219,381
"2011","Central Bedfordshire 010C","E01017378","Total",1758,255,122,133,1503,89,152,420,296,65,164,317
"2011","Central Bedfordshire 010D","E01017413","Total",1756,146,75,71,1610,45,290,391,326,96,144,318
"2011","Central Bedfordshire 010E","E01017414","Total",1728,180,97,83,1548,80,210,410,322,93,140,293
"2011","Central Bedfordshire 010F","E01017415","Total",1829,195,90,105,1634,131,224,457,332,72,174,244
"2011","Central Bedfordshire 011A","E01017437","Total",1526,192,75,117,1334,99,140,361,300,69,117,248
"2011","Central Bedfordshire 011B","E01017438","Total",1662,174,74,100,1488,42,174,464,238,108,182,280
"2011","Central Bedfordshire 011C","E01017439","Total",1676,122,55,67,1554,62,132,572,262,109,192,225
"2011","Central Bedfordshire 011D","E01017440","Total",1341,216,79,137,1125,82,140,352,252,59,100,140
"2011","Central Bedfordshire 011E","E01017441","Total",1736,102,52,50,1634,79,90,584,246,161,224,250
"2011","Central Bedfordshire 011F","E01017444","Total",1841,223,107,116,1618,63,238,398,334,100,212,273
"2011","Central Bedfordshire 012A","E01017371","Total",1300,147,104,43,1153,42,240,286,170,81,138,196
"2011","Central Bedfordshire 012B","E01017372","Total",1472,201,98,103,1271,73,186,387,202,57,115,251
"2011","Central Bedfordshire 012C","E01017373","Total",1488,118,49,69,1370,44,132,450,192,115,184,253
"2011","Central Bedfordshire 012D","E01017374","Total",1440,129,48,81,1311,51,166,421,238,68,152,215
"2011","Central Bedfordshire 012E","E01017375","Total",1443,223,119,104,1220,46,150,297,224,114,132,257
"2011","Central Bedfordshire 013A","E01017391","Total",1353,138,59,79,1215,74,128,328,166,112,122,285
"2011","Central Bedfordshire 013B","E01017392","Total",1476,141,71,70,1335,39,282,306,232,55,151,270
"2011","Central Bedfordshire 013C","E01017393","Total",1693,157,78,79,1536,38,158,453,298,89,167,333
"2011","Central Bedfordshire 013D","E01017442","Total",2052,157,59,98,1895,85,208,552,398,139,154,359
"2011","Central Bedfordshire 013E","E01017443","Total",1671,191,68,123,1480,65,90,560,348,153,107,157
"2011","Central Bedfordshire 014A","E01017446","Total",1731,194,92,102,1537,84,212,441,252,72,175,301
"2011","Central Bedfordshire 014B","E01017447","Total",2067,195,98,97,1872,74,230,571,360,82,204,351
"2011","Central Bedfordshire 014D","E01017449","Total",1486,151,83,68,1335,53,210,318,268,81,132,273
"2011","Central Bedfordshire 014E","E01033188","Total",1430,122,59,63,1308,58,188,366,242,103,102,249
"2011","Central Bedfordshire 014F","E01033189","Total",1542,131,32,99,1411,80,66,582,326,85,100,172
"2011","Central Bedfordshire 014G","E01033190","Total",1376,152,16,136,1224,96,44,483,370,68,64,99
"2011","Central Bedfordshire 015A","E01017399","Total",1495,117,24,93,1378,54,90,462,248,107,158,259
"2011","Central Bedfordshire 015B","E01017400","Total",1486,232,107,125,1254,113,132,320,164,103,164,258
"2011","Central Bedfordshire 015C","E01017401","Total",1271,138,50,88,1133,44,92,278,244,103,140,232
"2011","Central Bedfordshire 015D","E01017402","Total",1576,150,82,68,1426,44,306,352,204,72,148,300
"2011","Central Bedfordshire 016A","E01017403","Total",1414,166,65,101,1248,60,180,373,222,61,122,230
"2011","Central Bedfordshire 016B","E01017404","Total",1348,56,27,29,1292,11,136,292,254,75,156,368
"2011","Central Bedfordshire 016C","E01017405","Total",1449,164,45,119,1285,69,114,310,280,76,106,330
"2011","Central Bedfordshire 016D","E01017406","Total",1534,155,40,115,1379,87,104,389,310,85,174,230
"2011","Central Bedfordshire 016E","E01017407","Total",1602,179,55,124,1423,51,96,408,350,35,114,369
"2011","Central Bedfordshire 017A","E01017398","Total",2400,158,77,81,2242,44,318,608,442,143,259,428
"2011","Central Bedfordshire 017B","E01017408","Total",1072,84,45,39,988,42,120,236,174,63,126,227
"2011","Central Bedfordshire 017C","E01017409","Total",1225,125,83,42,1100,29,186,240,176,58,124,287
"2011","Central Bedfordshire 017D","E01017445","Total",1771,168,91,77,1603,56,254,383,300,62,181,367
"2011","Central Bedfordshire 017E","E01017450","Total",2284,154,73,81,2130,97,250,470,358,159,272,524
"2011","Central Bedfordshire 018A","E01017558","Total",1791,198,58,140,1593,98,136,538,294,98,180,249
"2011","Central Bedfordshire 018B","E01017559","Total",1698,137,93,44,1561,82,248,397,222,51,219,342
"2011","Central Bedfordshire 018C","E01017560","Total",1491,146,92,54,1345,44,256,375,200,33,132,305
"2011","Central Bedfordshire 018D","E01017616","Total",2316,242,68,174,2074,163,190,648,388,129,210,346
"2011","Central Bedfordshire 019A","E01017577","Total",2169,229,111,118,1940,73,288,478,450,129,141,381
"2011","Central Bedfordshire 019B","E01017615","Total",2057,218,121,97,1839,32,310,414,398,72,184,429
"2011","Central Bedfordshire 019C","E01017620","Total",1802,180,81,99,1622,74,204,396,308,102,197,341
"2011","Central Bedfordshire 019D","E01017621","Total",1640,140,82,58,1500,55,292,411,172,112,153,305
"2011","Central Bedfordshire 019E","E01017622","Total",1681,186,110,76,1495,110,144,366,234,100,210,331
"2011","Central Bedfordshire 020A","E01017603","Total",1501,171,70,101,1330,56,164,334,288,63,101,324
"2011","Central Bedfordshire 020B","E01017604","Total",1661,127,42,85,1534,56,130,425,292,72,186,373
"2011","Central Bedfordshire 020C","E01017605","Total",1416,91,29,62,1325,170,78,274,164,173,182,284
"2011","Central Bedfordshire 020D","E01017606","Total",1514,139,87,52,1375,24,306,242,286,61,147,309
"2011","Central Bedfordshire 020E","E01017607","Total",1307,71,41,30,1236,15,230,294,218,48,123,308
"2011","Central Bedfordshire 021A","E01017555","Total",1869,430,162,268,1439,134,136,375,334,58,119,283
"2011","Central Bedfordshire 021B","E01017556","Total",1568,189,48,141,1379,55,92,443,326,84,102,277
"2011","Central Bedfordshire 021C","E01017557","Total",1759,418,229,189,1341,121,186,306,344,66,87,231
"2011","Central Bedfordshire 021D","E01017608","Total",1685,230,91,139,1455,66,152,332,280,126,210,289
"2011","Central Bedfordshire 021E","E01017609","Total",1668,171,72,99,1497,277,140,371,188,72,150,299
"2011","Central Bedfordshire 022A","E01017589","Total",1641,310,85,225,1331,74,106,348,378,75,109,241
"2011","Central Bedfordshire 022B","E01017590","Total",1478,183,91,92,1295,45,246,280,262,73,96,293
"2011","Central Bedfordshire 022C","E01017591","Total",1696,185,73,112,1511,62,210,387,360,53,152,287
"2011","Central Bedfordshire 022D","E01017610","Total",1133,74,41,33,1059,23,168,258,196,37,120,257
"2011","Central Bedfordshire 023A","E01017611","Total",1267,111,28,83,1156,28,122,315,242,81,79,289
"2011","Central Bedfordshire 023B","E01017612","Total",1325,126,33,93,1199,40,116,348,230,105,125,235
"2011","Central Bedfordshire 023C","E01017613","Total",1387,170,78,92,1217,58,166,298,264,82,107,242
"2011","Central Bedfordshire 023D","E01017614","Total",1495,132,45,87,1363,43,146,398,234,80,163,299
"2011","Central Bedfordshire 025A","E01017600","Total",1939,250,32,218,1689,124,72,509,374,126,197,287
"2011","Central Bedfordshire 025B","E01017601","Total",1480,84,31,53,1396,193,76,271,172,169,296,219
"2011","Central Bedfordshire 025C","E01017602","Total",1554,189,76,113,1365,116,112,269,172,136,264,296
"2011","Central Bedfordshire 025D","E01017618","Total",1645,139,67,72,1506,212,104,338,170,189,199,294
"2011","Central Bedfordshire 025E","E01017619","Total",2171,166,78,88,2005,317,140,400,272,173,329,374
"2011","Central Bedfordshire 024A","E01017573","Total",1424,122,82,40,1302,34,260,256,216,71,140,325
"2011","Central Bedfordshire 024C","E01017575","Total",2478,309,86,223,2169,183,160,765,520,109,131,301
"2011","Central Bedfordshire 024D","E01017576","Total",1407,104,56,48,1303,63,160,330,236,91,121,302
"2011","Central Bedfordshire 024E","E01033191","Total",1417,132,13,119,1285,83,42,562,286,82,112,118
"2011","Central Bedfordshire 024F","E01033192","Total",1524,90,4,86,1434,111,22,653,324,85,104,135
"2011","Central Bedfordshire 024G","E01033193","Total",1589,118,29,89,1471,96,104,463,278,123,143,264
"2011","Central Bedfordshire 026A","E01017578","Total",1714,161,63,98,1553,97,152,358,316,64,246,320
"2011","Central Bedfordshire 026B","E01017579","Total",1467,158,59,99,1309,111,142,289,214,84,168,301
"2011","Central Bedfordshire 026C","E01017580","Total",2138,244,35,209,1894,325,46,585,374,121,196,247
"2011","Central Bedfordshire 026D","E01017581","Total",1764,286,129,157,1478,133,154,315,296,113,166,301
"2011","Central Bedfordshire 026E","E01017617","Total",1305,105,68,37,1200,88,178,244,174,70,166,280
"2011","Central Bedfordshire 027A","E01017582","Total",1518,141,69,72,1377,30,216,337,172,94,173,355
"2011","Central Bedfordshire 027B","E01017583","Total",1841,160,76,84,1681,73,188,430,264,104,259,363
"2011","Central Bedfordshire 027C","E01017584","Total",1899,204,112,92,1695,86,250,445,278,82,240,314
"2011","Central Bedfordshire 027D","E01017585","Total",1417,106,64,42,1311,13,218,249,174,66,241,350
"2011","Central Bedfordshire 028A","E01017566","Total",1498,134,102,32,1364,26,240,257,238,53,193,357
"2011","Central Bedfordshire 028B","E01017595","Total",1197,113,61,52,1084,104,128,193,134,92,168,265
"2011","Central Bedfordshire 028C","E01017596","Total",1539,168,80,88,1371,140,128,351,162,140,159,291
"2011","Central Bedfordshire 028D","E01017597","Total",1448,182,98,84,1266,117,140,259,212,117,137,284
"2011","Central Bedfordshire 028E","E01017598","Total",1058,74,34,40,984,35,130,259,166,56,108,230
"2011","Central Bedfordshire 028F","E01017599","Total",2090,255,73,182,1835,202,110,491,326,171,203,332
"2011","Central Bedfordshire 029A","E01017565","Total",1521,147,111,36,1374,28,286,294,194,78,175,319
"2011","Central Bedfordshire 029B","E01017567","Total",1650,205,63,142,1445,170,150,315,228,98,182,302
"2011","Central Bedfordshire 029C","E01017568","Total",1803,360,105,255,1443,185,114,437,298,68,88,253
"2011","Central Bedfordshire 029D","E01017569","Total",1581,301,107,194,1280,112,112,336,264,76,137,243
"2011","Central Bedfordshire 029E","E01017570","Total",1922,367,86,281,1555,119,128,421,398,79,135,275
"2011","Central Bedfordshire 030A","E01017592","Total",1531,263,129,134,1268,74,140,353,224,67,130,280
"2011","Central Bedfordshire 030B","E01017593","Total",1487,193,110,83,1294,80,220,283,194,52,150,315
"2011","Central Bedfordshire 030C","E01017594","Total",2166,218,84,134,1948,458,112,550,212,111,220,285
"2011","Central Bedfordshire 031A","E01017623","Total",1675,294,108,186,1381,103,118,348,224,78,169,341
"2011","Central Bedfordshire 031B","E01017624","Total",1858,143,52,91,1715,108,180,410,278,124,176,439
"2011","Central Bedfordshire 031C","E01017625","Total",1609,129,87,42,1480,18,320,299,218,82,161,382
"2011","Central Bedfordshire 031D","E01017626","Total",1709,121,46,75,1588,27,276,334,234,70,189,458
"2011","Central Bedfordshire 032A","E01017571","Total",1231,137,74,63,1094,75,210,181,196,62,104,266
"2011","Central Bedfordshire 032B","E01017572","Total",1345,143,49,94,1202,52,184,302,244,44,136,240
"2011","Central Bedfordshire 032C","E01017586","Total",1455,155,85,70,1300,59,204,270,264,73,159,271
"2011","Central Bedfordshire 032D","E01017587","Total",1527,145,89,56,1382,27,326,248,316,61,104,300
"2011","Central Bedfordshire 032E","E01017588","Total",1172,155,94,61,1017,17,244,176,222,58,88,212
"2011","Central Bedfordshire 033A","E01017561","Total",1497,110,58,52,1387,36,204,312,246,46,190,353
"2011","Central Bedfordshire 033B","E01017562","Total",1440,257,151,106,1183,63,264,222,230,67,104,233
"2011","Central Bedfordshire 033C","E01017563","Total",1583,173,108,65,1410,35,254,363,250,80,118,310
"2011","Central Bedfordshire 033D","E01017564","Total",1372,166,65,101,1206,66,178,292,270,77,78,245
"2011","Luton 001A","E01015706","Total",1406,197,105,92,1209,42,170,272,216,65,199,245
"2011","Luton 001B","E01015707","Total",1442,134,40,94,1308,33,192,342,248,60,154,279
"2011","Luton 001C","E01015708","Total",1399,104,44,60,1295,26,122,316,184,99,218,330
"2011","Luton 001D","E01015709","Total",1441,190,51,139,1251,55,160,298,280,50,133,275
"2011","Luton 001E","E01015710","Total",1494,200,61,139,1294,75,100,343,264,73,151,288
"2011","Luton 001F","E01015770","Total",1279,89,45,44,1190,20,202,170,192,106,204,296
"2011","Luton 002A","E01015801","Total",1761,216,51,165,1545,225,160,401,228,111,175,245
"2011","Luton 002B","E01015803","Total",1505,117,53,64,1388,38,216,272,238,109,169,346
"2011","Luton 002C","E01015804","Total",1827,178,65,113,1649,219,160,361,220,193,178,318
"2011","Luton 002D","E01015805","Total",1322,90,57,33,1232,24,186,239,148,77,212,346
"2011","Luton 003A","E01015769","Total",1195,158,52,106,1037,104,104,182,170,115,155,207
"2011","Luton 003B","E01015771","Total",1427,214,68,146,1213,183,66,234,132,116,272,210
"2011","Luton 003C","E01015772","Total",1475,158,41,117,1317,147,78,223,160,146,356,207
"2011","Luton 003D","E01015773","Total",1333,99,17,82,1234,219,44,203,122,118,295,233
"2011","Luton 003E","E01015774","Total",1444,152,25,127,1292,167,44,267,146,185,288,195
"2011","Luton 003F","E01015802","Total",1518,183,60,123,1335,177,140,301,142,122,223,230
"2011","Luton 004A","E01015744","Total",1438,261,89,172,1177,120,106,289,188,107,167,200
"2011","Luton 004B","E01015746","Total",1470,193,106,87,1277,49,242,231,178,123,203,251
"2011","Luton 004C","E01015747","Total",1410,67,41,26,1343,20,208,234,132,63,313,373
"2011","Luton 004D","E01015748","Total",1641,227,141,86,1414,79,302,231,202,116,168,316
"2011","Luton 005A","E01015749","Total",1894,202,51,151,1692,213,102,344,186,212,402,233
"2011","Luton 005B","E01015751","Total",1663,160,64,96,1503,147,132,287,194,168,286,289
"2011","Luton 005C","E01015752","Total",1339,90,42,48,1249,66,142,202,162,142,210,325
"2011","Luton 005D","E01015753","Total",1413,182,34,148,1231,136,110,317,250,43,165,210
"2011","Luton 005E","E01015754","Total",1773,288,129,159,1485,179,166,307,186,137,244,266
"2011","Luton 005F","E01015755","Total",1605,228,143,85,1377,53,232,319,190,91,221,271
"2011","Luton 006A","E01015764","Total",1485,141,84,57,1344,49,246,238,172,80,190,369
"2011","Luton 006B","E01015765","Total",1649,200,63,137,1449,155,128,318,162,97,290,299
"2011","Luton 006C","E01015766","Total",1675,101,41,60,1574,112,134,282,150,236,336,324
"2011","Luton 006D","E01015767","Total",1572,155,66,89,1417,76,146,270,166,91,317,351
"2011","Luton 006E","E01015768","Total",1453,137,80,57,1316,61,228,270,188,107,191,271
"2011","Luton 006F","E01015783","Total",1722,106,33,73,1616,106,74,265,108,213,513,337
"2011","Luton 006G","E01015785","Total",2041,274,88,186,1767,118,114,424,254,212,322,323
"2011","Luton 007A","E01015693","Total",1537,60,37,23,1477,46,168,263,190,125,358,327
"2011","Luton 007B","E01015694","Total",1443,94,56,38,1349,36,194,210,126,178,279,326
"2011","Luton 007C","E01015695","Total",1592,87,50,37,1505,51,84,292,144,188,414,332
"2011","Luton 007D","E01015696","Total",1333,97,17,80,1236,109,50,458,228,72,132,187
"2011","Luton 007E","E01015697","Total",1771,150,69,81,1621,76,118,531,224,133,259,280
"2011","Luton 007F","E01015745","Total",1590,98,67,31,1492,23,266,219,128,106,343,407
"2011","Luton 008A","E01015797","Total",1307,89,53,36,1218,31,206,270,180,53,160,318
"2011","Luton 008B","E01015798","Total",1342,141,72,69,1201,78,136,288,178,83,163,275
"2011","Luton 008C","E01015799","Total",1388,118,62,56,1270,53,242,313,218,25,125,294
"2011","Luton 008D","E01015800","Total",1523,157,68,89,1366,104,142,366,258,48,135,313
"2011","Luton 008E","E01015812","Total",1359,109,38,71,1250,78,86,319,244,70,135,318
"2011","Luton 008F","E01015813","Total",1314,339,148,191,975,69,152,186,184,31,107,246
"2011","Luton 009A","E01015756","Total",1593,174,50,124,1419,131,94,402,264,133,187,208
"2011","Luton 009B","E01015757","Total",1533,202,98,104,1331,152,138,236,154,102,279,270
"2011","Luton 009C","E01015758","Total",1494,115,10,105,1379,152,26,311,188,111,321,270
"2011","Luton 009D","E01015759","Total",1506,230,115,115,1276,143,124,203,128,148,274,256
"2011","Luton 009E","E01015760","Total",1480,243,102,141,1237,128,74,254,132,100,366,183
"2011","Luton 009F","E01015761","Total",1652,144,75,69,1508,154,140,309,160,188,278,279
"2011","Luton 010A","E01015700","Total",2427,201,89,112,2226,119,110,372,178,226,751,470
"2011","Luton 010B","E01015701","Total",2219,63,20,43,2156,69,54,187,76,383,970,417
"2011","Luton 010C","E01015704","Total",2116,87,28,59,2029,108,36,401,104,415,677,288
"2011","Luton 010D","E01015782","Total",2070,124,61,63,1946,66,146,288,138,336,534,438
"2011","Luton 010E","E01015784","Total",2200,65,25,40,2135,76,48,274,92,439,820,386
"2011","Luton 010F","E01015786","Total",2210,90,41,49,2120,57,66,250,118,358,796,475
"2011","Luton 011A","E01015711","Total",1703,108,54,54,1595,47,80,234,128,248,526,332
"2011","Luton 011B","E01015712","Total",1799,173,78,95,1626,51,200,215,140,267,402,351
"2011","Luton 011C","E01015715","Total",1822,60,19,41,1762,90,76,324,82,258,623,309
"2011","Luton 011D","E01015716","Total",1721,160,20,140,1561,166,46,404,178,155,338,274
"2011","Luton 011E","E01015717","Total",1537,115,38,77,1422,145,84,293,116,175,315,294
"2011","Luton 011F","E01015750","Total",2182,148,42,106,2034,122,108,425,214,239,534,392
"2011","Luton 012A","E01015740","Total",1544,140,44,96,1404,45,102,312,232,87,278,348
"2011","Luton 012B","E01015775","Total",1609,247,86,161,1362,66,164,350,230,95,179,278
"2011","Luton 012C","E01015776","Total",1892,199,110,89,1693,103,228,346,202,134,314,366
"2011","Luton 012D","E01015777","Total",1732,182,52,130,1550,101,140,375,228,94,257,355
"2011","Luton 012E","E01015778","Total",1726,194,50,144,1532,114,128,344,204,119,264,359
"2011","Luton 012F","E01015796","Total",1461,242,137,105,1219,27,242,205,198,62,160,325
"2011","Luton 013A","E01015713","Total",1408,128,71,57,1280,36,212,202,110,151,248,321
"2011","Luton 013B","E01015714","Total",1727,155,85,70,1572,60,210,296,146,160,309,391
"2011","Luton 013C","E01015718","Total",1606,235,71,164,1371,59,158,296,186,155,168,349
"2011","Luton 013D","E01015762","Total",1699,193,98,95,1506,82,190,307,198,117,302,310
"2011","Luton 013E","E01015763","Total",1552,198,122,76,1354,65,220,270,172,113,217,297
"2011","Luton 014A","E01015721","Total",1536,207,100,107,1329,61,174,349,228,72,177,268
"2011","Luton 014B","E01015722","Total",1275,147,50,97,1128,100,86,308,204,63,146,221
"2011","Luton 014C","E01015806","Total",1318,153,27,126,1165,103,66,314,272,35,158,217
"2011","Luton 014D","E01015808","Total",1414,208,58,150,1206,62,42,384,326,37,135,220
"2011","Luton 014E","E01015809","Total",1413,68,22,46,1345,16,102,371,238,40,190,388
"2011","Luton 014F","E01015810","Total",1391,92,12,80,1299,172,32,366,214,73,166,276
"2011","Luton 014G","E01015811","Total",1424,131,24,107,1293,42,86,364,328,79,132,262
"2011","Luton 015A","E01015703","Total",2132,61,16,45,2071,37,70,118,64,337,1000,445
"2011","Luton 015B","E01015726","Total",2328,88,28,60,2240,104,42,226,80,293,946,549
"2011","Luton 015C","E01015731","Total",1971,102,37,65,1869,80,52,300,120,314,628,375
"2011","Luton 015D","E01015787","Total",2012,113,30,83,1899,62,72,275,134,327,580,449
"2011","Luton 015E","E01015788","Total",2033,51,25,26,1982,36,56,165,50,283,1005,387
"2011","Luton 016A","E01015719","Total",1423,133,63,70,1290,56,158,255,194,88,195,344
"2011","Luton 016B","E01015720","Total",1506,170,35,135,1336,120,54,246,166,121,283,346
"2011","Luton 016C","E01015723","Total",1311,102,36,66,1209,90,74,256,206,143,161,279
"2011","Luton 016D","E01015779","Total",1474,95,49,46,1379,109,84,188,154,171,305,368
"2011","Luton 016E","E01015780","Total",1645,154,61,93,1491,70,98,339,258,151,190,385
"2011","Luton 016F","E01015781","Total",1545,114,41,73,1431,117,98,272,144,169,289,342
"2011","Luton 016G","E01015807","Total",1363,118,62,56,1245,118,134,266,198,94,142,293
"2011","Luton 017A","E01015698","Total",1783,129,26,103,1654,92,54,206,108,209,645,340
"2011","Luton 017B","E01015699","Total",1809,203,31,172,1606,99,38,273,128,151,556,361
"2011","Luton 017C","E01015702","Total",1754,96,29,67,1658,80,46,215,64,237,676,340
"2011","Luton 017D","E01015705","Total",1697,124,6,118,1573,144,16,313,196,117,405,382
"2011","Luton 017E","E01015725","Total",1751,107,52,55,1644,69,52,322,84,404,458,255
"2011","Luton 017F","E01015727","Total",1898,71,18,53,1827,50,38,170,70,268,804,427
"2011","Luton 018A","E01015739","Total",1904,455,104,351,1449,85,70,338,404,41,182,329
"2011","Luton 018B","E01015741","Total",2256,445,80,365,1811,160,52,346,358,110,305,480
"2011","Luton 018C","E01015742","Total",1769,235,43,192,1534,125,68,373,296,32,174,466
"2011","Luton 018D","E01015743","Total",1527,260,48,212,1267,138,56,247,272,52,141,361
"2011","Luton 018E","E01015789","Total",1746,416,181,235,1330,156,98,229,186,72,212,377
"2011","Luton 018F","E01015794","Total",2060,488,55,433,1572,64,38,278,512,22,60,598
"2011","Luton 019A","E01015724","Total",2339,129,35,94,2210,75,60,380,152,326,804,413
"2011","Luton 019B","E01015728","Total",1802,89,46,43,1713,79,100,309,84,314,528,299
"2011","Luton 019C","E01015729","Total",1900,184,32,152,1716,73,44,177,150,202,565,505
"2011","Luton 019D","E01015730","Total",2323,183,54,129,2140,100,44,438,200,338,437,583
"2011","Luton 020A","E01015732","Total",1523,100,48,52,1423,141,108,193,152,148,383,298
"2011","Luton 020B","E01015733","Total",1807,160,108,52,1647,151,156,235,100,217,462,326
"2011","Luton 020C","E01015734","Total",1855,194,80,114,1661,84,152,374,240,182,218,411
"2011","Luton 020D","E01015735","Total",1724,218,31,187,1506,111,34,351,272,124,198,416
"2011","Luton 020E","E01015736","Total",1704,274,129,145,1430,131,90,244,176,149,358,282
"2011","Luton 020F","E01015737","Total",1529,103,50,53,1426,114,86,204,124,145,403,350
"2011","Luton 021A","E01015738","Total",1798,295,63,232,1503,85,100,315,288,90,118,507
"2011","Luton 021B","E01015790","Total",1620,163,70,93,1457,58,114,343,206,100,232,404
"2011","Luton 021C","E01015791","Total",2462,432,119,313,2030,233,42,390,488,70,167,640
"2011","Luton 021D","E01015792","Total",1742,192,39,153,1550,113,68,367,304,55,154,489
"2011","Luton 021E","E01015793","Total",1665,179,40,139,1486,71,106,327,248,83,224,427
"2011","Luton 021F","E01015795","Total",2058,443,20,423,1615,140,20,352,416,76,148,463
"2011","Peterborough 001A","E01015629","Total",1719,136,77,59,1583,62,248,388,250,123,227,285
"2011","Peterborough 001B","E01015635","Total",1534,128,82,46,1406,45,292,261,260,95,142,311
"2011","Peterborough 001C","E01015636","Total",1150,98,54,44,1052,51,190,206,212,53,136,204
"2011","Peterborough 001D","E01015679","Total",1781,294,112,182,1487,83,178,359,332,81,154,300
"2011","Peterborough 002A","E01015678","Total",1422,139,30,109,1283,77,76,337,256,102,136,299
"2011","Peterborough 002B","E01015680","Total",1511,211,60,151,1300,198,76,296,224,91,174,241
"2011","Peterborough 002C","E01015681","Total",1552,128,53,75,1424,32,100,454,252,102,119,365
"2011","Peterborough 002D","E01015682","Total",1442,224,79,145,1218,102,96,342,296,36,101,245
"2011","Peterborough 003A","E01015630","Total",1539,132,52,80,1407,55,178,293,276,99,179,327
"2011","Peterborough 003B","E01015631","Total",1299,103,51,52,1196,24,168,348,238,94,92,232
"2011","Peterborough 003C","E01015659","Total",1951,233,49,184,1718,143,114,484,390,61,226,300
"2011","Peterborough 003D","E01015684","Total",1415,134,90,44,1281,16,282,230,256,50,170,277
"2011","Peterborough 003E","E01015685","Total",1611,158,93,65,1453,42,282,295,312,61,162,299
"2011","Peterborough 004A","E01015589","Total",1654,148,86,62,1506,39,264,354,276,126,227,220
"2011","Peterborough 004B","E01015590","Total",1222,152,88,64,1070,36,246,220,184,81,137,166
"2011","Peterborough 004C","E01015626","Total",1485,81,9,72,1404,66,26,615,284,164,86,163
"2011","Peterborough 004D","E01015628","Total",1788,166,35,131,1622,86,136,494,410,93,130,273
"2011","Peterborough 005A","E01015617","Total",1315,155,68,87,1160,50,146,268,252,105,103,236
"2011","Peterborough 005B","E01015618","Total",1084,109,56,53,975,52,160,209,180,78,131,165
"2011","Peterborough 005C","E01015619","Total",2020,260,128,132,1760,151,218,423,336,114,258,260
"2011","Peterborough 005D","E01015620","Total",1704,153,71,82,1551,67,238,408,246,118,148,326
"2011","Peterborough 006A","E01015674","Total",1495,237,127,110,1258,121,108,292,234,67,163,273
"2011","Peterborough 006B","E01015675","Total",1582,178,72,106,1404,96,206,303,242,106,166,285
"2011","Peterborough 006C","E01015676","Total",1507,229,85,144,1278,74,184,282,288,71,148,231
"2011","Peterborough 006D","E01015683","Total",1831,254,172,82,1577,60,402,292,280,56,144,343
"2011","Peterborough 006E","E01015686","Total",1505,217,134,83,1288,47,340,241,268,60,91,241
"2011","Peterborough 007A","E01015607","Total",1366,235,88,147,1131,179,118,265,200,62,133,174
"2011","Peterborough 007B","E01015609","Total",1735,188,23,165,1547,231,78,361,212,164,287,214
"2011","Peterborough 007C","E01015656","Total",1535,227,99,128,1308,133,126,274,232,117,177,249
"2011","Peterborough 007D","E01015657","Total",1975,201,48,153,1774,292,60,356,230,285,252,299
"2011","Peterborough 007E","E01015658","Total",1553,224,85,139,1329,198,74,269,184,168,229,207
"2011","Peterborough 007F","E01015660","Total",1530,280,109,171,1250,148,162,312,256,71,115,186
"2011","Peterborough 008A","E01015605","Total",1630,203,126,77,1427,93,168,277,142,137,350,260
"2011","Peterborough 008B","E01015608","Total",1559,191,82,109,1368,107,156,261,200,105,212,327
"2011","Peterborough 008C","E01015610","Total",1564,212,80,132,1352,159,148,285,190,133,182,255
"2011","Peterborough 008D","E01015633","Total",2197,326,178,148,1871,207,266,423,316,96,223,340
"2011","Peterborough 008E","E01015634","Total",1850,291,168,123,1559,125,150,280,186,208,256,354
"2011","Peterborough 009A","E01015593","Total",1430,175,61,114,1255,128,68,297,180,154,161,267
"2011","Peterborough 009B","E01015596","Total",1655,139,46,93,1516,176,104,285,192,174,321,264
"2011","Peterborough 009C","E01015662","Total",1450,80,26,54,1370,158,56,262,152,179,243,320
"2011","Peterborough 009D","E01015663","Total",1451,257,82,175,1194,144,102,283,204,59,212,190
"2011","Peterborough 009E","E01015664","Total",1672,191,41,150,1481,238,88,373,186,112,218,266
"2011","Peterborough 010A","E01015603","Total",2292,215,62,153,2077,112,92,324,234,239,690,386
"2011","Peterborough 010B","E01015604","Total",1956,66,16,50,1890,80,40,265,108,251,759,387
"2011","Peterborough 010C","E01015632","Total",2028,203,58,145,1825,125,118,305,208,288,352,429
"2011","Peterborough 010D","E01015661","Total",1522,166,56,110,1356,115,150,321,214,130,189,237
"2011","Peterborough 010E","E01015677","Total",1065,158,41,117,907,75,68,269,198,67,81,149
"2011","Peterborough 011A","E01015591","Total",1479,125,50,75,1354,94,182,204,248,108,189,329
"2011","Peterborough 011B","E01015592","Total",1529,189,74,115,1340,165,116,297,266,98,178,220
"2011","Peterborough 011C","E01015594","Total",1759,244,85,159,1515,139,140,366,276,84,237,273
"2011","Peterborough 011D","E01015595","Total",1459,272,92,180,1187,129,144,270,212,86,162,184
"2011","Peterborough 011E","E01015597","Total",1573,174,44,130,1399,185,64,343,190,109,250,258
"2011","Peterborough 012A","E01015601","Total",2055,92,27,65,1963,45,54,187,90,268,1004,315
"2011","Peterborough 012B","E01015651","Total",2060,131,66,65,1929,76,150,268,206,283,576,370
"2011","Peterborough 012C","E01015652","Total",2030,116,51,65,1914,81,68,228,160,262,662,453
"2011","Peterborough 012D","E01015653","Total",1769,159,67,92,1610,57,182,215,252,174,365,365
"2011","Peterborough 012E","E01015654","Total",2247,293,133,160,1954,119,102,401,282,270,477,303
"2011","Peterborough 013A","E01015606","Total",1725,195,79,116,1530,119,212,269,304,78,235,313
"2011","Peterborough 013B","E01015611","Total",2085,349,153,196,1736,136,174,343,308,147,346,282
"2011","Peterborough 013C","E01015613","Total",1537,208,52,156,1329,197,124,367,256,97,137,151
"2011","Peterborough 013D","E01015614","Total",1790,189,33,156,1601,164,94,487,350,93,186,227
"2011","Peterborough 013E","E01015615","Total",1613,226,108,118,1387,112,190,251,188,163,226,257
"2011","Peterborough 013F","E01015616","Total",1779,216,84,132,1563,142,78,313,148,199,418,265
"2011","Peterborough 014A","E01015599","Total",1879,285,101,184,1594,85,50,262,242,181,420,354
"2011","Peterborough 014B","E01015600","Total",1875,153,90,63,1722,45,48,180,94,235,657,463
"2011","Peterborough 014C","E01015602","Total",1928,402,89,313,1526,75,80,261,328,83,305,394
"2011","Peterborough 014D","E01015612","Total",2145,283,100,183,1862,134,142,341,298,134,447,366
"2011","Peterborough 014E","E01015655","Total",2097,246,69,177,1851,71,88,346,356,115,434,441
"2011","Peterborough 015A","E01015598","Total",1494,150,71,79,1344,35,224,264,302,60,147,312
"2011","Peterborough 015B","E01015687","Total",1590,154,88,66,1436,41,316,189,228,117,276,269
"2011","Peterborough 015C","E01015689","Total",1435,146,82,64,1289,17,290,221,266,58,204,233
"2011","Peterborough 015D","E01015690","Total",1196,92,53,39,1104,20,198,177,188,41,255,225
"2011","Peterborough 015E","E01015691","Total",1266,128,82,46,1138,38,222,154,156,26,289,253
"2011","Peterborough 016A","E01015622","Total",2353,388,116,272,1965,154,98,502,566,62,172,411
"2011","Peterborough 016C","E01015665","Total",1668,187,78,109,1481,42,102,198,146,165,551,277
"2011","Peterborough 016D","E01015688","Total",1374,243,81,162,1131,51,170,252,302,61,131,164
"2011","Peterborough 016E","E01015692","Total",1388,116,34,82,1272,50,82,223,156,176,343,242
"2011","Peterborough 016F","E01033173","Total",1906,176,17,159,1730,99,44,678,332,113,204,260
"2011","Peterborough 016G","E01033182","Total",1472,194,46,148,1278,198,92,283,258,65,136,246
"2011","Peterborough 017A","E01015621","Total",1974,338,84,254,1636,118,140,448,458,83,127,262
"2011","Peterborough 017B","E01015623","Total",1713,209,71,138,1504,84,188,396,304,88,136,308
"2011","Peterborough 017C","E01015624","Total",1621,233,51,182,1388,107,116,374,364,76,97,254
"2011","Peterborough 017D","E01015666","Total",1244,263,108,155,981,68,154,197,206,67,83,206
"2011","Peterborough 017E","E01015668","Total",1750,288,91,197,1462,150,136,411,326,68,131,240
"2011","Peterborough 018A","E01015627","Total",1740,187,102,85,1553,61,300,344,308,120,129,291
"2011","Peterborough 018B","E01015644","Total",1946,178,34,144,1768,111,114,499,416,128,185,315
"2011","Peterborough 018C","E01015645","Total",1634,205,77,128,1429,51,130,340,370,74,163,301
"2011","Peterborough 018D","E01015646","Total",1913,231,119,112,1682,30,452,308,366,47,118,361
"2011","Peterborough 018E","E01015648","Total",1413,141,85,56,1272,5,246,256,274,66,108,317
"2011","Peterborough 019A","E01015667","Total",1324,143,69,74,1181,59,98,319,248,63,143,251
"2011","Peterborough 019B","E01015669","Total",1394,162,85,77,1232,46,218,253,208,52,131,324
"2011","Peterborough 019C","E01015670","Total",1440,154,89,65,1286,48,240,262,202,84,145,305
"2011","Peterborough 019D","E01015671","Total",1573,223,110,113,1350,70,244,279,292,71,110,284
"2011","Peterborough 019E","E01015672","Total",1580,166,80,86,1414,53,202,432,246,77,184,220
"2011","Peterborough 019F","E01015673","Total",1496,194,88,106,1302,130,158,401,212,68,146,187
"2011","Peterborough 021A","E01015637","Total",1462,147,34,113,1315,159,68,308,212,145,180,243
"2011","Peterborough 021B","E01015639","Total",1512,286,70,216,1226,132,74,247,190,102,241,240
"2011","Peterborough 021C","E01015640","Total",1463,154,40,114,1309,81,106,291,278,153,167,233
"2011","Peterborough 021D","E01015641","Total",1259,133,49,84,1126,147,108,214,192,92,160,213
"2011","Peterborough 021E","E01015642","Total",1527,155,37,118,1372,201,64,323,200,167,203,214
"2011","Peterborough 021F","E01015647","Total",1399,276,131,145,1123,163,82,220,164,103,223,168
"2011","Peterborough 022A","E01015638","Total",1440,159,108,51,1281,57,232,213,248,106,164,261
"2011","Peterborough 022B","E01015650","Total",2023,253,75,178,1770,77,178,517,394,84,226,294
"2011","Peterborough 022C","E01033174","Total",1221,197,70,127,1024,186,48,285,202,84,113,106
"2011","Peterborough 022D","E01033179","Total",1526,124,45,79,1402,165,180,380,258,79,128,212
"2011","Peterborough 022E","E01033181","Total",1574,92,11,81,1482,128,34,510,286,150,172,202
"2011","Peterborough 023A","E01015643","Total",1375,182,46,136,1193,103,114,288,236,85,144,223
"2011","Peterborough 023B","E01033175","Total",1476,101,17,84,1375,92,38,542,216,148,198,141
"2011","Peterborough 023C","E01033176","Total",1531,127,11,116,1404,129,12,494,286,127,172,184
"2011","Peterborough 023D","E01033177","Total",1419,120,10,110,1299,116,24,517,280,107,144,111
"2011","Peterborough 023E","E01033178","Total",1545,117,9,108,1428,262,6,468,192,153,187,160
"2011","Peterborough 023F","E01033180","Total",1632,108,4,104,1524,211,8,484,268,205,189,159
"2011","Southend-on-Sea 001A","E01015833","Total",1524,145,95,50,1379,39,236,330,206,67,141,360
"2011","Southend-on-Sea 001B","E01015834","Total",1464,160,88,72,1304,55,240,310,204,33,137,325
"2011","Southend-on-Sea 001C","E01015835","Total",1624,231,126,105,1393,128,208,347,210,62,116,322
"2011","Southend-on-Sea 001D","E01015836","Total",1515,148,97,51,1367,44,276,315,226,60,168,278
"2011","Southend-on-Sea 001E","E01015837","Total",1683,233,125,108,1450,53,220,397,224,110,144,302
"2011","Southend-on-Sea 001F","E01015838","Total",1500,152,104,48,1348,20,358,272,202,83,134,279
"2011","Southend-on-Sea 002A","E01015863","Total",2371,296,152,144,2075,120,214,523,386,127,258,447
"2011","Southend-on-Sea 002B","E01015864","Total",1360,176,119,57,1184,57,232,240,208,36,159,252
"2011","Southend-on-Sea 002C","E01015865","Total",1425,215,118,97,1210,29,244,261,214,52,120,290
"2011","Southend-on-Sea 002D","E01015866","Total",1532,187,103,84,1345,50,260,313,236,73,108,305
"2011","Southend-on-Sea 002E","E01015867","Total",1423,205,105,100,1218,129,198,241,226,75,115,234
"2011","Southend-on-Sea 002F","E01015868","Total",1604,197,83,114,1407,92,148,300,228,165,206,268
"2011","Southend-on-Sea 003A","E01015814","Total",1412,204,151,53,1208,36,196,310,228,103,101,234
"2011","Southend-on-Sea 003B","E01015815","Total",1563,140,81,59,1423,46,216,372,216,82,188,303
"2011","Southend-on-Sea 003C","E01015816","Total",1485,310,182,128,1175,38,382,226,224,31,102,172
"2011","Southend-on-Sea 003D","E01015817","Total",1573,217,151,66,1356,47,386,229,260,76,128,230
"2011","Southend-on-Sea 003E","E01015818","Total",1712,270,148,122,1442,62,328,307,250,52,142,301
"2011","Southend-on-Sea 003F","E01015819","Total",1428,205,94,111,1223,102,170,307,196,79,134,235
"2011","Southend-on-Sea 004A","E01015857","Total",1543,168,105,63,1375,30,312,311,220,68,169,265
"2011","Southend-on-Sea 004B","E01015858","Total",1724,178,96,82,1546,45,292,382,252,83,202,290
"2011","Southend-on-Sea 004C","E01015859","Total",1880,263,142,121,1617,75,250,360,248,115,210,359
"2011","Southend-on-Sea 004D","E01015860","Total",1520,160,88,72,1360,36,226,356,208,86,159,289
"2011","Southend-on-Sea 004E","E01015861","Total",1638,317,121,196,1321,102,162,332,214,123,176,212
"2011","Southend-on-Sea 004F","E01015862","Total",1547,215,71,144,1332,118,106,316,226,120,218,228
"2011","Southend-on-Sea 005A","E01015820","Total",1485,210,86,124,1275,91,128,286,184,162,200,224
"2011","Southend-on-Sea 005B","E01015821","Total",1565,251,136,115,1314,69,224,291,262,52,156,260
"2011","Southend-on-Sea 005C","E01015822","Total",1223,116,62,54,1107,29,168,223,148,95,170,274
"2011","Southend-on-Sea 005D","E01015823","Total",1645,179,83,96,1466,47,180,365,250,133,190,301
"2011","Southend-on-Sea 005E","E01015824","Total",1545,161,78,83,1384,127,140,307,202,108,223,277
"2011","Southend-on-Sea 005F","E01015825","Total",1562,149,85,64,1413,26,176,311,200,132,247,321
"2011","Southend-on-Sea 005G","E01015826","Total",1398,153,89,64,1245,38,204,285,186,91,173,268
"2011","Southend-on-Sea 006A","E01015869","Total",1630,158,66,92,1472,141,138,337,220,136,219,281
"2011","Southend-on-Sea 006B","E01015870","Total",1636,194,71,123,1442,77,114,374,228,133,243,273
"2011","Southend-on-Sea 006C","E01015871","Total",1617,170,108,62,1447,59,222,298,246,93,195,334
"2011","Southend-on-Sea 006D","E01015872","Total",1688,201,68,133,1487,103,140,412,240,131,178,283
"2011","Southend-on-Sea 006E","E01015873","Total",1301,162,60,102,1139,98,90,325,194,62,153,217
"2011","Southend-on-Sea 006F","E01015874","Total",1669,208,81,127,1461,82,166,367,290,89,181,286
"2011","Southend-on-Sea 006G","E01015875","Total",1655,298,97,201,1357,175,132,329,216,128,121,256
"2011","Southend-on-Sea 007A","E01015901","Total",1441,175,44,131,1266,120,58,336,250,94,156,252
"2011","Southend-on-Sea 007B","E01015902","Total",1682,200,45,155,1482,94,74,304,240,216,325,229
"2011","Southend-on-Sea 007C","E01015903","Total",1598,204,58,146,1394,126,66,423,266,99,143,271
"2011","Southend-on-Sea 007D","E01015904","Total",1648,223,60,163,1425,105,118,391,252,106,200,253
"2011","Southend-on-Sea 007E","E01015905","Total",1410,177,55,122,1233,115,102,341,212,88,140,235
"2011","Southend-on-Sea 007F","E01015906","Total",1581,158,43,115,1423,100,86,326,246,184,169,312
"2011","Southend-on-Sea 007G","E01015907","Total",1442,202,56,146,1240,89,54,292,220,165,161,259
"2011","Southend-on-Sea 008A","E01015908","Total",1611,140,90,50,1471,22,222,508,272,127,97,223
"2011","Southend-on-Sea 008B","E01015909","Total",1506,197,74,123,1309,44,114,382,246,118,159,246
"2011","Southend-on-Sea 008C","E01015910","Total",1507,149,85,64,1358,36,246,404,224,76,121,251
"2011","Southend-on-Sea 008D","E01015911","Total",1306,111,73,38,1195,31,206,338,164,94,124,238
"2011","Southend-on-Sea 008E","E01015912","Total",1497,185,132,53,1312,31,218,361,220,95,153,234
"2011","Southend-on-Sea 008F","E01015913","Total",1675,280,122,158,1395,78,218,319,348,93,148,191
"2011","Southend-on-Sea 009A","E01015883","Total",1383,115,81,34,1268,31,300,307,182,93,130,225
"2011","Southend-on-Sea 009B","E01015884","Total",2084,309,137,172,1775,196,172,452,366,113,213,263
"2011","Southend-on-Sea 009C","E01015885","Total",1656,171,124,47,1485,40,390,370,222,72,161,230
"2011","Southend-on-Sea 009D","E01015886","Total",1495,233,94,139,1262,171,132,247,166,170,172,204
"2011","Southend-on-Sea 009E","E01015887","Total",1556,144,75,69,1412,129,148,288,150,117,291,289
"2011","Southend-on-Sea 009F","E01015888","Total",1457,179,118,61,1278,31,340,211,186,56,145,309
"2011","Southend-on-Sea 010A","E01015895","Total",1958,533,147,386,1425,215,102,288,392,90,123,215
"2011","Southend-on-Sea 010B","E01015896","Total",1870,386,113,273,1484,176,106,401,232,145,258,166
"2011","Southend-on-Sea 010C","E01015897","Total",2017,306,121,185,1711,172,152,327,384,142,226,308
"2011","Southend-on-Sea 010D","E01015898","Total",1686,300,133,167,1386,157,148,331,218,120,222,190
"2011","Southend-on-Sea 010E","E01015899","Total",1892,259,71,188,1633,109,116,444,306,65,254,339
"2011","Southend-on-Sea 010F","E01015900","Total",1454,205,47,158,1249,143,50,298,246,77,187,248
"2011","Southend-on-Sea 011A","E01015845","Total",1623,200,70,130,1423,54,80,531,306,73,105,274
"2011","Southend-on-Sea 011B","E01015846","Total",1717,325,120,205,1392,44,110,498,304,124,119,193
"2011","Southend-on-Sea 011C","E01015847","Total",1733,302,75,227,1431,150,92,448,334,83,134,190
"2011","Southend-on-Sea 011D","E01015848","Total",1628,439,184,255,1189,50,242,255,322,57,76,187
"2011","Southend-on-Sea 011E","E01015849","Total",1662,262,79,183,1400,98,116,445,322,55,157,207
"2011","Southend-on-Sea 011F","E01015850","Total",1651,191,58,133,1460,72,138,524,244,114,120,248
"2011","Southend-on-Sea 012A","E01015827","Total",1486,224,91,133,1262,25,202,274,292,86,158,225
"2011","Southend-on-Sea 012B","E01015828","Total",1475,440,70,370,1035,66,64,194,360,36,53,262
"2011","Southend-on-Sea 012C","E01015829","Total",1452,213,64,149,1239,51,104,426,292,60,143,163
"2011","Southend-on-Sea 012D","E01015830","Total",1552,145,84,61,1407,22,224,409,250,83,198,221
"2011","Southend-on-Sea 012E","E01015831","Total",1959,302,44,258,1657,100,68,262,390,53,404,380
"2011","Southend-on-Sea 012F","E01015832","Total",1454,385,202,183,1069,54,198,220,220,65,84,228
"2011","Southend-on-Sea 013A","E01015876","Total",2160,194,78,116,1966,75,252,538,428,127,197,349
"2011","Southend-on-Sea 013B","E01015877","Total",1777,309,118,191,1468,121,140,371,334,125,136,241
"2011","Southend-on-Sea 013C","E01015878","Total",1354,167,40,127,1187,84,94,309,260,46,160,234
"2011","Southend-on-Sea 013D","E01015879","Total",1401,181,72,109,1220,144,78,327,228,120,153,170
"2011","Southend-on-Sea 013E","E01015880","Total",1452,248,97,151,1204,153,138,266,200,76,143,228
"2011","Southend-on-Sea 013F","E01015881","Total",1391,148,96,52,1243,51,188,257,168,91,145,343
"2011","Southend-on-Sea 013G","E01015882","Total",1608,205,61,144,1403,155,132,328,272,127,186,203
"2011","Southend-on-Sea 014A","E01015839","Total",1667,307,93,214,1360,148,84,326,252,102,123,325
"2011","Southend-on-Sea 014B","E01015840","Total",1688,238,50,188,1450,118,70,317,308,199,173,265
"2011","Southend-on-Sea 014C","E01015841","Total",2325,437,62,375,1888,230,84,424,444,142,215,349
"2011","Southend-on-Sea 014D","E01015842","Total",1877,382,91,291,1495,294,98,366,272,99,150,216
"2011","Southend-on-Sea 014E","E01015843","Total",1676,245,78,167,1431,139,58,356,308,98,211,261
"2011","Southend-on-Sea 014F","E01015844","Total",1751,458,180,278,1293,82,96,312,350,69,132,252
"2011","Southend-on-Sea 015A","E01015851","Total",1614,591,245,346,1023,34,234,157,372,10,38,178
"2011","Southend-on-Sea 015B","E01015852","Total",1684,404,115,289,1280,114,58,227,394,74,144,269
"2011","Southend-on-Sea 015C","E01015853","Total",1679,419,160,259,1260,48,160,307,406,36,63,240
"2011","Southend-on-Sea 015D","E01015854","Total",1861,211,48,163,1650,145,74,365,328,71,203,464
"2011","Southend-on-Sea 015E","E01015855","Total",2016,330,77,253,1686,144,144,343,354,130,274,297
"2011","Southend-on-Sea 015F","E01015856","Total",1705,291,60,231,1414,90,98,310,368,122,134,292
"2011","Southend-on-Sea 016A","E01015889","Total",1439,166,120,46,1273,17,348,196,146,99,209,258
"2011","Southend-on-Sea 016B","E01015890","Total",1516,164,101,63,1352,28,278,242,190,85,241,288
"2011","Southend-on-Sea 016C","E01015891","Total",1402,246,103,143,1156,76,152,255,262,57,146,208
"2011","Southend-on-Sea 016D","E01015892","Total",1703,126,60,66,1577,48,146,474,254,129,220,306
"2011","Southend-on-Sea 016E","E01015893","Total",1579,279,238,41,1300,15,486,197,222,22,103,255
"2011","Southend-on-Sea 016F","E01015894","Total",1531,140,82,58,1391,32,236,323,190,62,265,283
"2011","Southend-on-Sea 017A","E01015914","Total",1365,55,34,21,1310,24,246,278,182,88,184,308
"2011","Southend-on-Sea 017B","E01015915","Total",1462,162,90,72,1300,65,258,252,198,64,152,311
"2011","Southend-on-Sea 017C","E01015916","Total",1501,134,47,87,1367,198,100,261,142,240,216,210
"2011","Southend-on-Sea 017D","E01015917","Total",1663,171,67,104,1492,164,96,273,194,169,326,270
"2011","Southend-on-Sea 017E","E01015918","Total",1370,134,56,78,1236,89,102,309,186,81,252,217
"2011","Southend-on-Sea 017F","E01015919","Total",1313,118,69,49,1195,46,168,324,156,78,235,188
"2011","Southend-on-Sea 017G","E01015920","Total",1486,155,109,46,1331,36,322,273,196,64,120,320
"2011","Thurrock 001A","E01015943","Total",1486,142,80,62,1344,64,208,262,202,58,157,393
"2011","Thurrock 001B","E01015944","Total",1240,129,99,30,1111,19,270,273,132,41,79,297
"2011","Thurrock 001C","E01015946","Total",1536,141,77,64,1395,55,182,314,282,117,114,331
"2011","Thurrock 001D","E01015997","Total",1389,59,28,31,1330,28,144,267,250,73,153,415
"2011","Thurrock 001E","E01015999","Total",1387,58,25,33,1329,37,128,341,216,115,171,321
"2011","Thurrock 002A","E01015945","Total",1211,113,82,31,1098,52,196,210,168,70,103,299
"2011","Thurrock 002B","E01015983","Total",1455,171,98,73,1284,44,268,255,158,58,136,365
"2011","Thurrock 002C","E01015987","Total",1482,123,77,46,1359,122,164,337,194,65,191,286
"2011","Thurrock 002D","E01015988","Total",1420,226,150,76,1194,135,112,278,148,86,150,285
"2011","Thurrock 002E","E01015998","Total",1598,105,51,54,1493,40,202,426,178,62,189,396
"2011","Thurrock 003A","E01015984","Total",1304,71,37,34,1233,44,178,253,196,99,149,314
"2011","Thurrock 003B","E01015985","Total",1390,190,137,53,1200,30,350,275,176,48,110,211
"2011","Thurrock 003C","E01015986","Total",1504,188,93,95,1316,98,132,287,220,123,220,236
"2011","Thurrock 003D","E01015990","Total",1490,158,89,69,1332,42,130,237,206,106,238,373
"2011","Thurrock 003E","E01016001","Total",1351,92,50,42,1259,49,140,352,212,87,114,305
"2011","Thurrock 004A","E01015977","Total",1813,156,80,76,1657,72,246,486,298,96,183,276
"2011","Thurrock 004B","E01015978","Total",1281,87,42,45,1194,21,200,214,190,72,178,319
"2011","Thurrock 004C","E01015979","Total",1373,99,23,76,1274,34,100,412,268,63,167,230
"2011","Thurrock 004D","E01015980","Total",1596,126,63,63,1470,37,234,301,238,109,223,328
"2011","Thurrock 005A","E01015989","Total",1563,228,68,160,1335,70,102,375,270,92,193,233
"2011","Thurrock 005B","E01015991","Total",1425,125,76,49,1300,56,206,297,256,63,123,299
"2011","Thurrock 005C","E01015992","Total",1885,212,87,125,1673,143,158,397,290,113,211,361
"2011","Thurrock 005D","E01016000","Total",1411,156,53,103,1255,67,154,354,228,40,113,299
"2011","Thurrock 005E","E01016002","Total",1368,72,33,39,1296,34,174,281,248,56,144,359
"2011","Thurrock 006A","E01015932","Total",1585,110,53,57,1475,105,128,326,190,132,267,327
"2011","Thurrock 006B","E01015971","Total",1459,267,105,162,1192,81,120,358,238,53,121,221
"2011","Thurrock 006C","E01015972","Total",1704,222,133,89,1482,67,148,308,204,121,298,336
"2011","Thurrock 006D","E01015973","Total",1758,212,87,125,1546,123,116,437,212,167,234,257
"2011","Thurrock 006E","E01015974","Total",1413,121,37,84,1292,36,118,387,272,93,155,231
"2011","Thurrock 006F","E01015975","Total",1551,167,53,114,1384,57,148,362,246,123,189,259
"2011","Thurrock 007A","E01015927","Total",1857,164,77,87,1693,154,94,415,168,193,367,302
"2011","Thurrock 007B","E01015928","Total",1739,163,77,86,1576,95,142,367,188,131,244,409
"2011","Thurrock 007C","E01015929","Total",1469,255,90,165,1214,119,80,250,222,137,221,185
"2011","Thurrock 007D","E01015930","Total",1764,160,59,101,1604,91,114,432,212,141,270,344
"2011","Thurrock 007E","E01015931","Total",1324,336,27,309,988,133,38,336,168,87,114,112
"2011","Thurrock 007F","E01015976","Total",1779,294,67,227,1485,188,98,414,234,91,142,318
"2011","Thurrock 008A","E01015922","Total",1518,170,100,70,1348,93,122,210,192,150,241,340
"2011","Thurrock 008B","E01015923","Total",1577,215,67,148,1362,90,88,343,250,102,206,283
"2011","Thurrock 008C","E01015924","Total",1551,165,67,98,1386,100,104,330,174,150,208,320
"2011","Thurrock 008D","E01015925","Total",1565,157,78,79,1408,54,184,295,226,102,237,310
"2011","Thurrock 008E","E01015926","Total",1524,234,122,112,1290,52,152,313,212,92,196,273
"2011","Thurrock 009A","E01015957","Total",1537,177,128,49,1360,58,112,314,172,169,216,319
"2011","Thurrock 009B","E01015958","Total",1315,98,48,50,1217,72,124,261,130,58,207,365
"2011","Thurrock 009C","E01015993","Total",1599,200,150,50,1399,77,186,291,154,93,221,377
"2011","Thurrock 009D","E01015994","Total",1554,200,146,54,1354,66,214,332,152,129,188,273
"2011","Thurrock 009E","E01015995","Total",1671,98,62,36,1573,20,242,282,208,97,253,471
"2011","Thurrock 009F","E01015996","Total",1631,170,110,60,1461,68,164,325,152,123,306,323
"2011","Thurrock 010A","E01015963","Total",1189,146,60,86,1043,129,96,352,134,74,107,151
"2011","Thurrock 010B","E01015964","Total",1549,137,91,46,1412,40,206,309,170,77,213,397
"2011","Thurrock 010C","E01015965","Total",1446,150,97,53,1296,15,234,272,210,73,134,358
"2011","Thurrock 010D","E01015966","Total",1576,126,93,33,1450,31,282,325,218,51,170,373
"2011","Thurrock 012A","E01015933","Total",1466,202,108,94,1264,43,150,333,216,75,161,286
"2011","Thurrock 012B","E01015934","Total",1496,107,43,64,1389,150,116,262,148,174,250,289
"2011","Thurrock 012C","E01015935","Total",1604,159,79,80,1445,101,150,233,160,151,288,362
"2011","Thurrock 012D","E01015936","Total",1662,209,139,70,1453,73,234,297,168,115,205,361
"2011","Thurrock 012E","E01015937","Total",1633,189,109,80,1444,46,298,230,216,69,167,418
"2011","Thurrock 012F","E01015938","Total",1884,224,110,114,1660,290,190,492,178,65,201,244
"2011","Thurrock 013A","E01015947","Total",1408,126,23,103,1282,111,74,361,246,88,161,241
"2011","Thurrock 013B","E01015948","Total",1538,162,49,113,1376,100,98,357,228,95,173,325
"2011","Thurrock 013C","E01015949","Total",1690,99,26,73,1591,89,90,457,250,125,206,374
"2011","Thurrock 013D","E01015950","Total",1703,140,47,93,1563,59,198,338,314,69,212,373
"2011","Thurrock 014A","E01015960","Total",1470,128,92,36,1342,17,174,267,138,96,222,428
"2011","Thurrock 014B","E01015967","Total",1518,123,55,68,1395,54,152,340,242,106,159,342
"2011","Thurrock 014C","E01015968","Total",1367,212,99,113,1155,50,118,291,222,42,136,296
"2011","Thurrock 014D","E01015969","Total",1736,258,128,130,1478,78,204,359,276,103,174,284
"2011","Thurrock 014E","E01015970","Total",1329,99,49,50,1230,44,118,372,172,88,137,299
"2011","Thurrock 015A","E01015921","Total",1164,213,38,175,951,88,56,330,236,55,84,102
"2011","Thurrock 015B","E01016011","Total",1513,225,27,198,1288,136,46,356,326,98,124,202
"2011","Thurrock 015C","E01016012","Total",2513,193,59,134,2320,204,102,585,394,242,347,446
"2011","Thurrock 015D","E01016013","Total",2202,381,28,353,1821,195,40,601,482,113,136,254
"2011","Thurrock 015E","E01016014","Total",2536,295,38,257,2241,343,34,663,436,249,299,217
"2011","Thurrock 015F","E01016015","Total",1713,101,32,69,1612,69,112,375,226,144,281,405
"2011","Thurrock 016A","E01015955","Total",1532,182,41,141,1350,66,82,437,306,77,157,225
"2011","Thurrock 016B","E01015956","Total",1977,230,51,179,1747,108,80,459,366,88,242,404
"2011","Thurrock 016C","E01015959","Total",1633,178,67,111,1455,83,102,230,246,152,265,377
"2011","Thurrock 016D","E01015961","Total",1502,192,69,123,1310,57,130,314,222,117,202,268
"2011","Thurrock 016E","E01015962","Total",1611,162,53,109,1449,132,62,403,234,138,209,271
"2011","Thurrock 017A","E01015951","Total",1681,139,20,119,1542,195,80,480,276,72,197,242
"2011","Thurrock 017B","E01015952","Total",2045,252,37,215,1793,163,42,522,320,171,317,258
"2011","Thurrock 017C","E01015953","Total",2082,384,33,351,1698,161,76,530,482,85,170,194
"2011","Thurrock 017D","E01015954","Total",2278,331,74,257,1947,308,72,520,370,164,241,272
"2011","Thurrock 018A","E01016003","Total",1902,238,57,181,1664,137,94,403,274,200,175,381
"2011","Thurrock 018B","E01016004","Total",1662,219,116,103,1443,237,118,289,180,147,170,302
"2011","Thurrock 018C","E01016005","Total",1556,106,36,70,1450,141,68,320,202,169,210,340
"2011","Thurrock 018D","E01016006","Total",1694,194,54,140,1500,357,50,400,116,208,161,208
"2011","Thurrock 018E","E01016007","Total",1489,102,55,47,1387,95,100,259,156,175,188,414
"2011","Thurrock 018F","E01016008","Total",1524,157,28,129,1367,120,76,333,226,142,180,290
"2011","Thurrock 018G","E01016009","Total",1705,163,57,106,1542,136,116,337,230,180,192,351
"2011","Thurrock 018H","E01016010","Total",1457,111,55,56,1346,155,80,246,142,159,307,257
"2011","Thurrock 019A","E01015982","Total",2566,137,8,129,2429,111,42,992,448,242,327,267
"2011","Thurrock 019B","E01033610","Total",1648,93,0,93,1555,94,18,642,270,173,217,141
"2011","Thurrock 019C","E01033611","Total",1625,135,5,130,1490,106,18,558,386,94,188,140
"2011","Thurrock 019D","E01033613","Total",1539,129,14,115,1410,75,34,570,282,99,185,165
"2011","Thurrock 020A","E01015939","Total",1564,119,21,98,1445,30,60,512,224,119,242,258
"2011","Thurrock 020B","E01015941","Total",1448,92,9,83,1356,56,54,528,216,140,188,174
"2011","Thurrock 020C","E01015942","Total",1593,111,23,88,1482,67,70,425,230,224,179,287
"2011","Thurrock 020D","E01033612","Total",1580,139,17,122,1441,71,28,476,290,102,260,214
"2011","Thurrock 020E","E01033614","Total",1872,87,19,68,1785,47,44,790,218,179,239,268
"2011","Cambridge 001A","E01017975","Total",1563,259,86,173,1304,112,142,303,194,98,197,258
"2011","Cambridge 001B","E01017976","Total",1651,137,43,94,1514,42,110,235,334,123,183,487
"2011","Cambridge 001C","E01017977","Total",1617,302,57,245,1315,128,98,328,314,60,131,256
"2011","Cambridge 001D","E01017978","Total",1551,227,81,146,1324,152,104,240,230,113,162,323
"2011","Cambridge 001E","E01017979","Total",1504,259,58,201,1245,126,58,254,246,67,178,316
"2011","Cambridge 001F","E01017980","Total",1106,155,38,117,951,51,116,238,226,21,85,214
"2011","Cambridge 002A","E01017949","Total",1536,228,46,182,1308,47,78,260,338,37,118,430
"2011","Cambridge 002B","E01017950","Total",1333,196,58,138,1137,31,78,234,246,87,82,379
"2011","Cambridge 002C","E01017951","Total",1465,233,67,166,1232,39,146,302,244,62,114,325
"2011","Cambridge 002D","E01017952","Total",1492,275,89,186,1217,113,140,290,198,80,138,258
"2011","Cambridge 002E","E01017953","Total",1620,254,99,155,1366,55,180,217,194,100,196,424
"2011","Cambridge 002F","E01017954","Total",1470,169,84,85,1301,76,192,335,172,58,176,292
"2011","Cambridge 003B","E01017971","Total",1632,204,58,146,1428,107,108,273,268,126,227,319
"2011","Cambridge 003C","E01017972","Total",1610,198,57,141,1412,46,182,280,286,116,197,305
"2011","Cambridge 003D","E01017973","Total",1647,241,83,158,1406,74,162,288,322,101,168,291
"2011","Cambridge 003E","E01017974","Total",1738,181,73,108,1557,61,128,308,288,131,177,464
"2011","Cambridge 003F","E01032792","Total",1306,225,42,183,1081,52,78,321,316,61,66,187
"2011","Cambridge 003G","E01032802","Total",1306,298,107,191,1008,39,78,180,300,73,66,272
"2011","Cambridge 004A","E01018006","Total",1631,286,117,169,1345,14,108,255,440,84,79,365
"2011","Cambridge 004B","E01018007","Total",1607,91,47,44,1516,16,186,370,226,131,162,425
"2011","Cambridge 004C","E01018008","Total",1605,192,70,122,1413,24,130,338,270,154,103,394
"2011","Cambridge 004D","E01018009","Total",1795,336,67,269,1459,51,86,286,368,67,146,455
"2011","Cambridge 004E","E01018010","Total",1693,423,68,355,1270,18,152,331,368,56,95,250
"2011","Cambridge 005A","E01017955","Total",1469,191,105,86,1278,17,194,292,296,56,105,318
"2011","Cambridge 005B","E01017956","Total",1240,176,58,118,1064,10,150,289,174,78,93,270
"2011","Cambridge 005C","E01017957","Total",1138,177,48,129,961,6,86,229,250,40,46,304
"2011","Cambridge 005D","E01017958","Total",682,223,81,142,459,24,34,122,144,32,27,76
"2011","Cambridge 006A","E01017943","Total",1724,239,35,204,1485,46,82,380,376,68,87,446
"2011","Cambridge 006B","E01017944","Total",1405,159,49,110,1246,90,88,320,236,69,136,307
"2011","Cambridge 006C","E01017945","Total",1720,262,58,204,1458,64,90,355,388,58,166,337
"2011","Cambridge 006D","E01017946","Total",1626,199,80,119,1427,125,100,242,234,164,215,347
"2011","Cambridge 006E","E01017947","Total",1670,186,76,110,1484,86,178,254,256,129,174,407
"2011","Cambridge 006F","E01017948","Total",1716,224,77,147,1492,178,62,404,276,93,210,269
"2011","Cambridge 007C","E01017983","Total",1877,333,136,197,1544,22,156,361,516,74,62,353
"2011","Cambridge 007D","E01017984","Total",1595,218,85,133,1377,10,194,349,306,85,141,292
"2011","Cambridge 007E","E01017985","Total",1655,219,128,91,1436,32,160,459,274,123,136,252
"2011","Cambridge 007F","E01017986","Total",613,123,52,71,490,27,102,97,102,27,52,83
"2011","Cambridge 007G","E01032797","Total",1495,361,99,262,1134,31,92,182,334,45,71,379
"2011","Cambridge 008A","E01017987","Total",1612,251,44,207,1361,32,90,252,264,120,94,509
"2011","Cambridge 008B","E01017988","Total",1507,146,31,115,1361,4,72,255,232,84,101,613
"2011","Cambridge 008C","E01017989","Total",2054,327,69,258,1727,66,46,385,532,87,119,492
"2011","Cambridge 008D","E01017990","Total",1247,210,35,175,1037,34,50,288,384,25,48,208
"2011","Cambridge 008E","E01017991","Total",1144,298,105,193,846,42,70,178,244,37,51,224
"2011","Cambridge 009A","E01017997","Total",2282,281,70,211,2001,53,136,359,492,118,233,610
"2011","Cambridge 009B","E01017998","Total",1718,206,60,146,1512,24,42,296,436,47,84,583
"2011","Cambridge 009C","E01017999","Total",1761,209,77,132,1552,36,94,295,274,116,195,542
"2011","Cambridge 009D","E01018000","Total",1748,227,36,191,1521,24,60,351,356,41,62,627
"2011","Cambridge 009E","E01018001","Total",1697,252,70,182,1445,17,64,325,434,30,67,508
"2011","Cambridge 010A","E01017965","Total",1625,301,132,169,1324,54,132,312,248,87,77,414
"2011","Cambridge 010B","E01017966","Total",2457,387,87,300,2070,60,120,380,622,123,214,551
"2011","Cambridge 010C","E01017967","Total",1762,172,68,104,1590,74,132,316,214,106,240,508
"2011","Cambridge 010D","E01017968","Total",1588,228,125,103,1360,7,154,330,206,57,162,444
"2011","Cambridge 010E","E01017969","Total",1545,199,75,124,1346,33,88,358,202,135,212,318
"2011","Cambridge 011A","E01017959","Total",1693,188,84,104,1505,47,150,348,242,68,179,471
"2011","Cambridge 011B","E01017960","Total",1334,161,81,80,1173,123,108,247,204,103,174,214
"2011","Cambridge 011C","E01017961","Total",1199,241,111,130,958,83,72,245,236,26,114,182
"2011","Cambridge 011D","E01017962","Total",1625,175,76,99,1450,67,172,397,256,82,171,305
"2011","Cambridge 011E","E01017963","Total",1593,212,90,122,1381,87,164,321,244,107,182,276
"2011","Cambridge 011F","E01017964","Total",1336,96,56,40,1240,15,194,317,180,56,187,291
"2011","Cambridge 012A","E01018002","Total",1579,302,114,188,1277,26,128,370,318,88,101,246
"2011","Cambridge 012B","E01018003","Total",1573,156,71,85,1417,48,168,346,220,116,196,323
"2011","Cambridge 012D","E01018005","Total",1508,361,80,281,1147,67,136,226,272,56,79,311
"2011","Cambridge 012E","E01032794","Total",1276,271,125,146,1005,21,210,200,250,67,111,146
"2011","Cambridge 012F","E01032795","Total",1479,258,40,218,1221,69,54,331,338,85,118,226
"2011","Cambridge 013A","E01017992","Total",1895,211,123,88,1684,51,156,350,240,186,299,402
"2011","Cambridge 013B","E01017993","Total",1978,460,71,389,1518,18,226,287,280,113,255,339
"2011","Cambridge 013C","E01017994","Total",1652,157,90,67,1495,88,184,337,166,102,214,404
"2011","Cambridge 013D","E01017995","Total",1466,109,76,33,1357,2,280,287,182,113,218,275
"2011","Cambridge 013E","E01017996","Total",1309,137,60,77,1172,5,124,309,228,108,105,293
"2011","East Cambridgeshire 001A","E01018042","Total",1446,193,124,69,1253,58,228,312,244,69,118,224
"2011","East Cambridgeshire 001B","E01018043","Total",2051,200,102,98,1851,102,260,503,334,117,214,321
"2011","East Cambridgeshire 001C","E01018044","Total",1706,217,89,128,1489,85,204,322,330,72,186,290
"2011","East Cambridgeshire 001D","E01018045","Total",1314,118,33,85,1196,58,104,302,264,81,136,251
"2011","East Cambridgeshire 001E","E01018046","Total",2100,220,108,112,1880,113,168,631,294,181,192,301
"2011","East Cambridgeshire 002A","E01018020","Total",1497,114,53,61,1383,19,136,289,322,108,181,328
"2011","East Cambridgeshire 002B","E01018021","Total",1492,131,73,58,1361,37,176,347,266,107,183,245
"2011","East Cambridgeshire 002C","E01018022","Total",1411,135,73,62,1276,49,218,297,256,86,96,274
"2011","East Cambridgeshire 002D","E01018055","Total",2042,184,84,100,1858,41,288,478,408,92,172,379
"2011","East Cambridgeshire 002E","E01018056","Total",1910,203,84,119,1707,87,206,545,344,110,149,266
"2011","East Cambridgeshire 003A","E01018027","Total",1719,206,110,96,1513,39,272,458,280,112,142,210
"2011","East Cambridgeshire 003C","E01018029","Total",2538,313,89,224,2225,70,184,750,592,162,140,327
"2011","East Cambridgeshire 003D","E01018032","Total",2473,265,130,135,2208,71,318,638,420,142,238,381
"2011","East Cambridgeshire 003E","E01018033","Total",1926,320,166,154,1606,60,330,364,320,102,109,321
"2011","East Cambridgeshire 003F","E01033426","Total",1488,63,27,36,1425,49,96,614,228,169,138,131
"2011","East Cambridgeshire 003G","E01033430","Total",1514,142,69,73,1372,130,156,381,204,130,174,197
"2011","East Cambridgeshire 004A","E01018024","Total",1094,177,96,81,917,13,188,200,222,56,107,131
"2011","East Cambridgeshire 004B","E01018025","Total",1329,333,152,181,996,42,142,243,356,36,47,130
"2011","East Cambridgeshire 004C","E01018026","Total",1379,208,93,115,1171,38,250,238,314,43,48,240
"2011","East Cambridgeshire 004D","E01018030","Total",1024,106,47,59,918,59,138,217,152,65,121,166
"2011","East Cambridgeshire 004F","E01033425","Total",1983,104,20,84,1879,94,94,800,328,225,168,170
"2011","East Cambridgeshire 004G","E01033428","Total",1434,184,52,132,1250,30,140,381,308,97,131,163
"2011","East Cambridgeshire 005A","E01018036","Total",1643,216,110,106,1427,48,208,411,274,92,161,233
"2011","East Cambridgeshire 005B","E01018037","Total",1393,88,45,43,1305,36,158,327,300,102,111,271
"2011","East Cambridgeshire 005C","E01018038","Total",1570,117,58,59,1453,39,220,446,270,93,193,192
"2011","East Cambridgeshire 005D","E01018039","Total",1323,122,75,47,1201,44,202,290,202,99,141,223
"2011","East Cambridgeshire 005E","E01018053","Total",1694,177,87,90,1517,28,202,358,294,119,171,345
"2011","East Cambridgeshire 005F","E01018054","Total",2263,207,83,124,2056,67,296,560,424,129,240,340
"2011","East Cambridgeshire 006A","E01018047","Total",1907,187,92,95,1720,91,188,452,318,100,220,351
"2011","East Cambridgeshire 006C","E01018049","Total",1642,167,85,82,1475,46,168,435,314,78,169,265
"2011","East Cambridgeshire 006D","E01018050","Total",1395,124,47,77,1271,43,114,349,242,99,149,275
"2011","East Cambridgeshire 006E","E01018051","Total",1683,158,80,78,1525,59,214,435,278,73,141,325
"2011","East Cambridgeshire 006F","E01018052","Total",1778,264,122,142,1514,49,190,372,378,90,113,322
"2011","East Cambridgeshire 006G","E01033427","Total",1332,87,8,79,1245,79,24,486,226,108,155,167
"2011","East Cambridgeshire 006H","E01033429","Total",1931,203,60,143,1728,63,176,491,392,91,167,348
"2011","East Cambridgeshire 007A","E01018034","Total",1564,133,66,67,1431,27,172,397,260,107,138,330
"2011","East Cambridgeshire 007B","E01018035","Total",2204,280,121,159,1924,82,282,490,410,134,167,359
"2011","East Cambridgeshire 007C","E01018040","Total",1264,103,46,57,1161,13,172,343,214,67,125,227
"2011","East Cambridgeshire 007D","E01018041","Total",1114,121,57,64,993,47,134,253,166,86,138,169
"2011","East Cambridgeshire 008A","E01018013","Total",1744,196,127,69,1548,50,312,423,232,78,165,288
"2011","East Cambridgeshire 008B","E01018014","Total",1798,203,79,124,1595,57,210,555,282,118,145,228
"2011","East Cambridgeshire 008C","E01018015","Total",1339,150,61,89,1189,45,154,320,226,77,143,224
"2011","East Cambridgeshire 008D","E01018016","Total",1415,177,95,82,1238,69,144,329,180,132,135,249
"2011","East Cambridgeshire 009A","E01018011","Total",2476,216,99,117,2260,46,376,590,396,155,249,448
"2011","East Cambridgeshire 009B","E01018012","Total",1355,139,77,62,1216,60,212,308,210,86,147,193
"2011","East Cambridgeshire 009C","E01018057","Total",2015,208,110,98,1807,52,274,492,326,122,165,376
"2011","East Cambridgeshire 011A","E01018017","Total",1263,210,124,86,1053,42,216,218,220,96,79,182
"2011","East Cambridgeshire 011B","E01018019","Total",1036,118,64,54,918,18,168,224,196,75,87,150
"2011","East Cambridgeshire 011C","E01018023","Total",2242,219,89,130,2023,83,252,583,408,111,225,361
"2011","East Cambridgeshire 011D","E01032611","Total",1803,167,76,91,1636,36,250,429,362,104,127,328
"2011","Fenland 001A","E01018094","Total",1758,225,131,94,1533,117,356,255,254,114,126,311
"2011","Fenland 001B","E01018095","Total",1548,135,79,56,1413,70,318,298,272,53,120,282
"2011","Fenland 001C","E01018096","Total",1576,221,119,102,1355,28,328,260,308,58,151,222
"2011","Fenland 001D","E01018097","Total",1402,149,81,68,1253,47,242,206,302,25,165,266
"2011","Fenland 002A","E01018063","Total",2262,290,108,182,1972,157,204,439,352,133,284,403
"2011","Fenland 002B","E01018073","Total",2240,248,133,115,1992,69,298,344,360,122,331,468
"2011","Fenland 002C","E01018107","Total",1680,160,80,80,1520,127,144,298,188,136,289,338
"2011","Fenland 002D","E01018108","Total",2000,196,78,118,1804,155,204,447,212,167,306,313
"2011","Fenland 002E","E01018109","Total",1815,215,87,128,1600,137,234,327,302,124,202,274
"2011","Fenland 003A","E01018069","Total",1763,177,106,71,1586,74,262,369,300,82,173,326
"2011","Fenland 003B","E01018070","Total",1701,259,82,177,1442,130,114,322,254,80,219,323
"2011","Fenland 003C","E01018071","Total",1703,286,159,127,1417,78,268,297,224,85,159,306
"2011","Fenland 003E","E01018093","Total",2359,309,153,156,2050,104,276,426,356,164,241,483
"2011","Fenland 003F","E01018103","Total",1182,156,65,91,1026,86,62,247,120,64,210,237
"2011","Fenland 003G","E01018104","Total",1222,141,77,64,1081,29,164,193,192,42,186,275
"2011","Fenland 003H","E01033111","Total",1411,217,120,97,1194,65,234,227,244,44,124,256
"2011","Fenland 003I","E01033112","Total",1128,304,146,158,824,42,82,132,192,15,110,251
"2011","Fenland 004A","E01018066","Total",1415,177,98,79,1238,62,274,231,248,83,126,214
"2011","Fenland 004B","E01018067","Total",1812,179,85,94,1633,109,286,345,344,91,202,256
"2011","Fenland 004C","E01018068","Total",1484,122,62,60,1362,50,186,289,284,84,179,290
"2011","Fenland 004D","E01018090","Total",1768,167,94,73,1601,102,288,266,348,153,159,285
"2011","Fenland 004E","E01018091","Total",1423,154,53,101,1269,38,172,237,278,101,191,252
"2011","Fenland 004F","E01018092","Total",1704,199,107,92,1505,99,248,309,278,75,195,301
"2011","Fenland 005A","E01018081","Total",1477,126,64,62,1351,66,208,286,194,138,169,290
"2011","Fenland 005B","E01018082","Total",1931,222,126,96,1709,88,286,376,296,90,204,369
"2011","Fenland 005C","E01018083","Total",1930,199,87,112,1731,133,166,476,280,180,236,260
"2011","Fenland 005D","E01018084","Total",2004,255,129,126,1749,98,394,322,354,122,175,284
"2011","Fenland 006A","E01018064","Total",2000,220,117,103,1780,124,236,391,328,89,199,413
"2011","Fenland 006B","E01018072","Total",1697,139,63,76,1558,163,208,300,252,118,185,332
"2011","Fenland 006C","E01018074","Total",1221,132,80,52,1089,55,182,208,212,82,98,252
"2011","Fenland 006D","E01018075","Total",1220,158,94,64,1062,106,182,215,136,64,134,225
"2011","Fenland 006E","E01018098","Total",1241,197,116,81,1044,32,236,249,220,51,71,185
"2011","Fenland 006F","E01018099","Total",1265,112,61,51,1153,45,190,259,218,43,115,283
"2011","Fenland 006G","E01018100","Total",1162,266,107,159,896,96,114,209,258,47,95,77
"2011","Fenland 006H","E01018101","Total",1291,192,69,123,1099,52,218,222,218,45,126,218
"2011","Fenland 007A","E01018077","Total",1739,352,141,211,1387,132,210,282,348,71,134,210
"2011","Fenland 007B","E01018078","Total",1640,313,208,105,1327,148,316,248,182,74,144,215
"2011","Fenland 007C","E01018079","Total",1712,243,170,73,1469,65,322,278,314,59,176,255
"2011","Fenland 007D","E01018080","Total",2319,234,99,135,2085,151,342,473,406,156,189,368
"2011","Fenland 008A","E01018058","Total",1548,198,100,98,1350,64,250,319,302,52,120,243
"2011","Fenland 008B","E01018059","Total",1332,112,48,64,1220,55,190,255,284,75,124,237
"2011","Fenland 008C","E01018060","Total",1846,165,59,106,1681,83,168,403,396,114,192,325
"2011","Fenland 008D","E01018061","Total",1272,113,52,61,1159,59,122,279,224,94,138,243
"2011","Fenland 009A","E01018085","Total",1592,203,114,89,1389,69,318,295,212,56,193,246
"2011","Fenland 009B","E01018086","Total",1707,198,113,85,1509,66,244,328,276,124,180,291
"2011","Fenland 009C","E01018087","Total",2009,331,187,144,1678,81,334,345,352,83,168,315
"2011","Fenland 009D","E01018088","Total",1542,217,139,78,1325,53,284,269,248,80,129,262
"2011","Fenland 010A","E01018065","Total",2168,239,139,100,1929,80,272,396,428,122,239,392
"2011","Fenland 010B","E01018076","Total",2088,193,99,94,1895,90,258,490,434,148,182,293
"2011","Fenland 010C","E01018111","Total",2211,217,125,92,1994,98,418,463,400,71,211,333
"2011","Fenland 011A","E01018062","Total",2481,279,142,137,2202,108,358,523,434,170,250,359
"2011","Fenland 011B","E01018102","Total",2577,374,133,241,2203,186,232,606,478,113,260,328
"2011","Fenland 011C","E01018105","Total",1155,201,109,92,954,64,152,210,192,63,110,163
"2011","Fenland 011D","E01018106","Total",1551,201,79,122,1350,81,214,283,320,80,135,237
"2011","Fenland 011E","E01018110","Total",2650,289,137,152,2361,115,374,547,396,163,300,466
"2011","Huntingdonshire 001A","E01018212","Total",1672,154,70,84,1518,82,212,387,272,115,168,282
"2011","Huntingdonshire 001B","E01018213","Total",1883,150,34,116,1733,132,152,445,380,105,229,290
"2011","Huntingdonshire 001C","E01018214","Total",1973,205,73,132,1768,124,154,465,306,124,234,361
"2011","Huntingdonshire 001D","E01018215","Total",1366,119,44,75,1247,63,162,357,264,73,92,236
"2011","Huntingdonshire 001E","E01018216","Total",2461,169,60,109,2292,78,208,756,424,181,219,426
"2011","Huntingdonshire 001F","E01018217","Total",1642,211,116,95,1431,56,254,351,330,57,122,261
"2011","Huntingdonshire 002A","E01018127","Total",1515,145,61,84,1370,44,214,230,320,133,173,256
"2011","Huntingdonshire 002B","E01018128","Total",1143,130,61,69,1013,49,214,239,218,41,78,174
"2011","Huntingdonshire 002C","E01018200","Total",1648,102,53,49,1546,53,224,353,278,83,206,349
"2011","Huntingdonshire 002D","E01018201","Total",1443,167,50,117,1276,65,114,416,242,104,110,225
"2011","Huntingdonshire 003A","E01018156","Total",1679,137,73,64,1542,45,274,295,280,79,233,336
"2011","Huntingdonshire 003B","E01018157","Total",2034,166,72,94,1868,75,208,451,370,150,257,357
"2011","Huntingdonshire 003C","E01018158","Total",1680,373,164,209,1307,77,176,296,282,78,99,299
"2011","Huntingdonshire 003D","E01018159","Total",1408,89,37,52,1319,44,148,320,326,57,189,235
"2011","Huntingdonshire 003E","E01018160","Total",1646,206,105,101,1440,93,190,342,222,88,196,309
"2011","Huntingdonshire 004A","E01018191","Total",1195,102,55,47,1093,85,156,248,168,89,132,215
"2011","Huntingdonshire 004B","E01018192","Total",1376,125,63,62,1251,34,186,263,242,56,183,287
"2011","Huntingdonshire 004C","E01018193","Total",1172,122,34,88,1050,35,152,228,212,56,105,262
"2011","Huntingdonshire 004D","E01018194","Total",1394,134,65,69,1260,62,174,327,272,48,113,264
"2011","Huntingdonshire 004E","E01018195","Total",1299,150,74,76,1149,65,118,328,206,105,124,203
"2011","Huntingdonshire 005A","E01018208","Total",1634,152,73,79,1482,68,218,366,310,98,147,275
"2011","Huntingdonshire 005B","E01018209","Total",1480,132,59,73,1348,24,188,361,262,104,127,282
"2011","Huntingdonshire 005C","E01018210","Total",1402,179,92,87,1223,58,126,322,228,68,154,267
"2011","Huntingdonshire 005D","E01018211","Total",1782,108,47,61,1674,55,292,428,278,108,199,314
"2011","Huntingdonshire 006A","E01018196","Total",1214,114,58,56,1100,25,194,272,232,40,114,223
"2011","Huntingdonshire 006B","E01018197","Total",1500,225,95,130,1275,76,124,384,240,61,152,238
"2011","Huntingdonshire 006C","E01018198","Total",1647,151,53,98,1496,36,198,387,366,149,137,223
"2011","Huntingdonshire 006D","E01018199","Total",1516,116,58,58,1400,36,188,340,308,47,217,264
"2011","Huntingdonshire 006E","E01018206","Total",1910,147,25,122,1763,96,70,621,358,191,221,206
"2011","Huntingdonshire 006F","E01018207","Total",1499,123,44,79,1376,65,198,315,318,84,145,251
"2011","Huntingdonshire 007A","E01018121","Total",1359,86,38,48,1273,26,186,308,212,87,153,301
"2011","Huntingdonshire 007B","E01018122","Total",1156,135,78,57,1021,19,196,282,174,59,114,177
"2011","Huntingdonshire 007C","E01018123","Total",1592,140,62,78,1452,36,164,342,320,74,187,329
"2011","Huntingdonshire 007D","E01018124","Total",2001,131,67,64,1870,59,254,480,366,164,191,356
"2011","Huntingdonshire 008A","E01018143","Total",1651,226,102,124,1425,83,190,319,182,133,194,324
"2011","Huntingdonshire 008B","E01018144","Total",1497,144,75,69,1353,151,84,336,192,163,222,205
"2011","Huntingdonshire 008C","E01018145","Total",1323,113,36,77,1210,110,72,228,170,127,243,260
"2011","Huntingdonshire 008D","E01018146","Total",2150,178,43,135,1972,172,76,462,256,158,427,421
"2011","Huntingdonshire 008E","E01018147","Total",1736,97,31,66,1639,116,72,409,216,202,264,360
"2011","Huntingdonshire 009A","E01018139","Total",1489,124,44,80,1365,58,110,295,260,105,221,316
"2011","Huntingdonshire 009B","E01018140","Total",1283,109,57,52,1174,35,186,238,192,56,178,289
"2011","Huntingdonshire 009C","E01018141","Total",1604,167,57,110,1437,32,232,375,316,83,117,282
"2011","Huntingdonshire 009D","E01018142","Total",1448,172,102,70,1276,84,286,194,200,113,175,224
"2011","Huntingdonshire 010B","E01018113","Total",1463,113,43,70,1350,39,218,371,260,115,135,212
"2011","Huntingdonshire 010D","E01018116","Total",1257,98,56,42,1159,18,168,384,210,86,121,172
"2011","Huntingdonshire 010E","E01018117","Total",1625,255,168,87,1370,38,328,302,262,78,121,241
"2011","Huntingdonshire 010F","E01018118","Total",1960,174,64,110,1786,86,176,534,352,148,156,334
"2011","Huntingdonshire 010G","E01033433","Total",1872,206,107,99,1666,43,330,399,346,110,140,298
"2011","Huntingdonshire 011A","E01018161","Total",1381,142,52,90,1239,57,122,350,268,52,92,298
"2011","Huntingdonshire 011B","E01018162","Total",1616,96,25,71,1520,79,140,401,338,89,154,319
"2011","Huntingdonshire 011C","E01018163","Total",1434,172,19,153,1262,129,46,356,314,112,144,161
"2011","Huntingdonshire 011D","E01018164","Total",1281,141,42,99,1140,39,112,288,242,78,148,233
"2011","Huntingdonshire 011E","E01018165","Total",1287,153,32,121,1134,65,130,247,308,92,117,175
"2011","Huntingdonshire 011F","E01018170","Total",1399,176,95,81,1223,32,228,245,224,91,181,222
"2011","Huntingdonshire 011G","E01018171","Total",1465,114,46,68,1351,43,212,299,256,68,148,325
"2011","Huntingdonshire 012A","E01018138","Total",1918,351,84,267,1567,64,176,374,436,96,143,278
"2011","Huntingdonshire 012B","E01018148","Total",2504,134,19,115,2370,153,114,886,402,171,315,329
"2011","Huntingdonshire 012C","E01018149","Total",1479,78,17,61,1401,40,78,540,278,80,148,237
"2011","Huntingdonshire 012D","E01018150","Total",1658,176,17,159,1482,71,68,466,300,134,192,251
"2011","Huntingdonshire 012E","E01018151","Total",1741,399,113,286,1342,67,110,318,476,73,125,173
"2011","Huntingdonshire 013A","E01018166","Total",1556,186,109,77,1370,37,244,356,220,120,143,250
"2011","Huntingdonshire 013B","E01018167","Total",1465,116,64,52,1349,36,238,319,238,76,162,280
"2011","Huntingdonshire 013C","E01018168","Total",1891,573,277,296,1318,63,186,269,422,26,109,243
"2011","Huntingdonshire 013D","E01018169","Total",1569,146,67,79,1423,67,196,275,220,158,186,321
"2011","Huntingdonshire 014A","E01018131","Total",1553,182,95,87,1371,74,168,340,218,112,176,283
"2011","Huntingdonshire 014B","E01018132","Total",1632,344,159,185,1288,31,226,284,282,89,92,284
"2011","Huntingdonshire 014C","E01018133","Total",1676,166,74,92,1510,47,136,458,256,148,173,292
"2011","Huntingdonshire 014D","E01018134","Total",1850,214,41,173,1636,81,132,499,380,146,195,203
"2011","Huntingdonshire 015A","E01018125","Total",1542,120,60,60,1422,33,206,332,260,133,207,251
"2011","Huntingdonshire 015B","E01018126","Total",1609,109,48,61,1500,47,194,402,338,84,183,252
"2011","Huntingdonshire 015C","E01018152","Total",1506,113,49,64,1393,32,220,406,272,89,149,225
"2011","Huntingdonshire 015D","E01018153","Total",1802,197,100,97,1605,65,276,414,282,94,212,262
"2011","Huntingdonshire 016A","E01018129","Total",1541,165,75,90,1376,45,178,322,304,102,139,286
"2011","Huntingdonshire 016B","E01018130","Total",1701,165,82,83,1536,49,188,487,312,60,126,314
"2011","Huntingdonshire 016C","E01018202","Total",1442,170,125,45,1272,28,334,284,204,112,71,239
"2011","Huntingdonshire 016D","E01018203","Total",1384,187,90,97,1197,23,244,284,262,105,78,201
"2011","Huntingdonshire 016E","E01018204","Total",1388,90,46,44,1298,41,244,326,220,126,155,186
"2011","Huntingdonshire 016F","E01018205","Total",1817,214,84,130,1603,51,400,309,364,57,115,307
"2011","Huntingdonshire 017A","E01018115","Total",1294,154,62,92,1140,17,216,290,236,59,93,229
"2011","Huntingdonshire 017B","E01018119","Total",1504,137,61,76,1367,42,246,321,314,68,127,249
"2011","Huntingdonshire 017C","E01018120","Total",1745,235,147,88,1510,84,286,391,224,123,147,255
"2011","Huntingdonshire 017D","E01018137","Total",1714,139,68,71,1575,56,236,463,314,132,112,262
"2011","Huntingdonshire 018A","E01018135","Total",2917,227,55,172,2690,219,178,820,640,243,272,318
"2011","Huntingdonshire 018B","E01018136","Total",1743,112,58,54,1631,38,294,434,322,142,144,257
"2011","Huntingdonshire 018C","E01018154","Total",1756,151,73,78,1605,77,254,398,322,68,176,310
"2011","Huntingdonshire 018D","E01018155","Total",1456,172,69,103,1284,35,236,284,298,57,138,236
"2011","Huntingdonshire 019A","E01018187","Total",1886,521,219,302,1365,102,188,304,362,80,127,202
"2011","Huntingdonshire 019B","E01018188","Total",1461,189,99,90,1272,53,184,348,244,85,125,233
"2011","Huntingdonshire 019C","E01018189","Total",1322,76,40,36,1246,16,218,409,202,66,115,220
"2011","Huntingdonshire 019D","E01018190","Total",1556,168,91,77,1388,43,198,310,216,145,199,277
"2011","Huntingdonshire 020A","E01018172","Total",1362,200,131,69,1162,48,246,236,230,78,113,211
"2011","Huntingdonshire 020B","E01018173","Total",1183,131,20,111,1052,62,74,304,290,52,112,158
"2011","Huntingdonshire 020C","E01018174","Total",1572,198,59,139,1374,57,206,376,294,54,141,246
"2011","Huntingdonshire 020D","E01018175","Total",1382,108,37,71,1274,29,188,327,238,86,131,275
"2011","Huntingdonshire 020E","E01018176","Total",1273,62,36,26,1211,24,230,270,192,92,128,275
"2011","Huntingdonshire 021A","E01018181","Total",2762,323,90,233,2439,83,156,784,636,172,280,328
"2011","Huntingdonshire 021B","E01018182","Total",1489,122,31,91,1367,46,104,353,310,107,181,266
"2011","Huntingdonshire 021C","E01018183","Total",1466,154,45,109,1312,107,146,290,260,53,159,297
"2011","Huntingdonshire 021D","E01018184","Total",1345,129,47,82,1216,97,108,261,164,142,229,215
"2011","Huntingdonshire 021E","E01018185","Total",1601,215,100,115,1386,65,260,298,296,63,132,272
"2011","Huntingdonshire 021F","E01018186","Total",1755,201,65,136,1554,71,200,431,280,81,167,324
"2011","Huntingdonshire 022A","E01018177","Total",1500,156,64,92,1344,27,300,298,260,77,114,268
"2011","Huntingdonshire 022B","E01018178","Total",1415,186,93,93,1229,39,212,318,238,31,147,244
"2011","Huntingdonshire 022C","E01018179","Total",1407,180,67,113,1227,96,120,298,252,99,138,224
"2011","Huntingdonshire 022D","E01018180","Total",1320,185,58,127,1135,131,66,281,218,59,132,248
"2011","South Cambridgeshire 001A","E01018304","Total",1848,216,103,113,1632,80,154,486,368,120,160,264
"2011","South Cambridgeshire 001B","E01018305","Total",1332,131,77,54,1201,18,188,323,206,82,140,244
"2011","South Cambridgeshire 001C","E01018306","Total",1530,107,43,64,1423,31,188,475,230,116,142,241
"2011","South Cambridgeshire 001D","E01018307","Total",2165,174,76,98,1991,34,230,547,376,136,186,482
"2011","South Cambridgeshire 002A","E01018233","Total",1568,165,82,83,1403,27,206,372,296,79,135,288
"2011","South Cambridgeshire 002B","E01018234","Total",1637,145,62,83,1492,54,214,381,282,66,182,313
"2011","South Cambridgeshire 002C","E01018235","Total",1679,206,115,91,1473,42,186,452,240,172,130,251
"2011","South Cambridgeshire 002D","E01018236","Total",1573,173,97,76,1400,77,178,365,240,119,189,232
"2011","South Cambridgeshire 003A","E01018237","Total",1526,150,61,89,1376,51,188,365,262,118,107,285
"2011","South Cambridgeshire 003B","E01018266","Total",2657,247,77,170,2410,100,286,796,534,154,214,326
"2011","South Cambridgeshire 003C","E01018284","Total",1264,133,54,79,1131,31,162,299,222,105,119,193
"2011","South Cambridgeshire 003D","E01018285","Total",1199,101,49,52,1098,51,82,296,254,82,117,216
"2011","South Cambridgeshire 004A","E01018298","Total",1396,70,15,55,1326,42,60,575,252,134,117,146
"2011","South Cambridgeshire 004B","E01018299","Total",1650,224,85,139,1426,54,224,412,286,96,108,246
"2011","South Cambridgeshire 004C","E01018300","Total",1128,144,74,70,984,21,176,224,208,41,101,213
"2011","South Cambridgeshire 004D","E01018301","Total",1341,145,61,84,1196,25,164,378,232,45,107,245
"2011","South Cambridgeshire 005A","E01018221","Total",1659,235,74,161,1424,43,120,364,402,82,169,244
"2011","South Cambridgeshire 005B","E01018222","Total",1503,97,50,47,1406,29,234,259,262,47,196,379
"2011","South Cambridgeshire 005C","E01018223","Total",1878,205,95,110,1673,74,220,473,366,86,167,287
"2011","South Cambridgeshire 006A","E01018257","Total",1363,192,114,78,1171,52,156,313,204,55,175,216
"2011","South Cambridgeshire 006B","E01018258","Total",1626,185,118,67,1441,34,230,452,258,115,111,241
"2011","South Cambridgeshire 006C","E01018259","Total",1324,127,54,73,1197,43,142,304,228,73,131,276
"2011","South Cambridgeshire 006D","E01018260","Total",1701,269,147,122,1432,27,224,340,296,128,104,313
"2011","South Cambridgeshire 006F","E01018262","Total",1387,111,61,50,1276,35,194,327,210,71,160,279
"2011","South Cambridgeshire 006G","E01033120","Total",1455,114,30,84,1341,81,54,217,244,116,251,378
"2011","South Cambridgeshire 006H","E01033121","Total",1588,108,6,102,1480,119,4,412,278,137,205,325
"2011","South Cambridgeshire 007A","E01018272","Total",1332,92,37,55,1240,20,156,408,212,90,160,194
"2011","South Cambridgeshire 007B","E01018273","Total",1587,213,91,122,1374,44,198,310,270,87,189,276
"2011","South Cambridgeshire 007C","E01018274","Total",1720,166,24,142,1554,35,82,537,414,81,131,274
"2011","South Cambridgeshire 007D","E01018297","Total",1682,211,80,131,1471,51,218,373,338,87,131,273
"2011","South Cambridgeshire 009A","E01018224","Total",1428,165,84,81,1263,35,196,363,204,121,134,210
"2011","South Cambridgeshire 009B","E01018225","Total",1078,167,114,53,911,23,190,194,168,57,89,190
"2011","South Cambridgeshire 009C","E01018248","Total",1844,139,52,87,1705,45,230,501,314,103,199,313
"2011","South Cambridgeshire 009D","E01018249","Total",1007,144,104,40,863,10,170,240,148,37,61,197
"2011","South Cambridgeshire 009E","E01018250","Total",1214,163,97,66,1051,19,184,259,180,82,160,167
"2011","South Cambridgeshire 010A","E01018231","Total",2476,209,79,130,2267,51,324,695,370,175,269,383
"2011","South Cambridgeshire 010B","E01018232","Total",2346,235,121,114,2111,71,364,560,318,179,258,361
"2011","South Cambridgeshire 010C","E01018251","Total",1220,110,38,72,1110,48,70,318,258,52,132,232
"2011","South Cambridgeshire 010D","E01018252","Total",1450,86,35,51,1364,43,124,319,248,132,216,282
"2011","South Cambridgeshire 010E","E01018255","Total",1149,93,45,48,1056,57,206,237,160,82,146,168
"2011","South Cambridgeshire 011A","E01018242","Total",1280,177,111,66,1103,34,188,262,196,62,135,226
"2011","South Cambridgeshire 011B","E01018243","Total",1718,146,36,110,1572,60,138,427,276,100,280,291
"2011","South Cambridgeshire 011C","E01018244","Total",1560,174,107,67,1386,22,290,313,240,88,186,247
"2011","South Cambridgeshire 011D","E01018286","Total",1604,192,69,123,1412,78,124,395,302,114,192,207
"2011","South Cambridgeshire 011E","E01018287","Total",1331,198,34,164,1133,31,50,396,300,41,139,176
"2011","South Cambridgeshire 011F","E01018296","Total",1079,118,60,58,961,21,192,216,192,75,90,175
"2011","South Cambridgeshire 012A","E01018292","Total",1393,127,74,53,1266,32,196,345,222,118,116,237
"2011","South Cambridgeshire 012B","E01018293","Total",1481,169,116,53,1312,40,276,333,204,101,164,194
"2011","South Cambridgeshire 012C","E01018294","Total",1646,360,151,209,1286,62,232,339,304,78,61,210
"2011","South Cambridgeshire 012D","E01018295","Total",1569,144,97,47,1425,43,280,353,248,95,160,246
"2011","South Cambridgeshire 013A","E01018245","Total",1700,150,87,63,1550,29,276,361,302,146,141,295
"2011","South Cambridgeshire 013B","E01018246","Total",1628,193,99,94,1435,63,268,296,316,77,185,230
"2011","South Cambridgeshire 013C","E01018247","Total",1571,135,70,65,1436,34,176,341,330,70,166,319
"2011","South Cambridgeshire 013D","E01018275","Total",2329,231,139,92,2098,57,400,537,398,145,201,360
"2011","South Cambridgeshire 014A","E01018240","Total",1232,91,57,34,1141,29,212,312,148,78,120,242
"2011","South Cambridgeshire 014B","E01018253","Total",1080,83,50,33,997,34,160,231,186,83,112,191
"2011","South Cambridgeshire 014C","E01018254","Total",1322,156,83,73,1166,36,194,296,222,95,104,219
"2011","South Cambridgeshire 014D","E01018256","Total",1507,156,89,67,1351,37,254,334,224,129,118,255
"2011","South Cambridgeshire 014E","E01018291","Total",1218,114,64,50,1104,23,204,325,168,76,128,180
"2011","South Cambridgeshire 015A","E01018279","Total",1463,231,144,87,1232,50,214,240,252,54,168,254
"2011","South Cambridgeshire 015B","E01018280","Total",1496,130,74,56,1366,46,202,277,264,71,104,402
"2011","South Cambridgeshire 015C","E01018281","Total",1564,205,94,111,1359,53,236,333,288,83,118,248
"2011","South Cambridgeshire 015D","E01018282","Total",1309,105,47,58,1204,33,144,355,248,63,125,236
"2011","South Cambridgeshire 015E","E01018283","Total",1274,88,43,45,1186,38,148,321,210,61,108,300
"2011","South Cambridgeshire 016A","E01018218","Total",1756,145,84,61,1611,34,300,412,340,111,168,246
"2011","South Cambridgeshire 016B","E01018219","Total",1405,122,72,50,1283,37,212,391,210,108,100,225
"2011","South Cambridgeshire 016C","E01018220","Total",1493,114,64,50,1379,33,212,313,288,90,154,289
"2011","South Cambridgeshire 016D","E01018263","Total",1476,153,81,72,1323,22,182,364,222,110,137,286
"2011","South Cambridgeshire 016E","E01018264","Total",1536,196,105,91,1340,68,204,308,206,142,110,302
"2011","South Cambridgeshire 016F","E01018265","Total",1760,147,73,74,1613,32,250,449,300,162,140,280
"2011","South Cambridgeshire 017A","E01018238","Total",1455,136,72,64,1319,41,194,361,222,121,121,259
"2011","South Cambridgeshire 017B","E01018239","Total",1353,123,60,63,1230,35,184,336,228,119,115,213
"2011","South Cambridgeshire 017C","E01018288","Total",1155,136,80,56,1019,31,188,233,176,66,131,194
"2011","South Cambridgeshire 017D","E01018289","Total",1151,119,42,77,1032,17,148,257,202,68,139,201
"2011","South Cambridgeshire 017E","E01018302","Total",1499,150,43,107,1349,19,138,399,284,112,132,265
"2011","South Cambridgeshire 017F","E01018303","Total",1200,146,91,55,1054,28,174,256,194,120,87,195
"2011","South Cambridgeshire 018A","E01018241","Total",1206,120,63,57,1086,22,134,294,200,119,100,217
"2011","South Cambridgeshire 018B","E01018267","Total",2328,284,170,114,2044,45,364,560,366,140,184,385
"2011","South Cambridgeshire 018C","E01018268","Total",1904,125,54,71,1779,52,228,519,338,131,197,314
"2011","South Cambridgeshire 018D","E01018269","Total",1342,180,103,77,1162,65,176,242,258,94,106,221
"2011","South Cambridgeshire 018E","E01018270","Total",1116,97,45,52,1019,30,156,191,180,86,142,234
"2011","South Cambridgeshire 018F","E01018271","Total",1326,178,83,95,1148,44,174,282,188,101,139,220
"2011","South Cambridgeshire 019A","E01018226","Total",1293,87,25,62,1206,47,78,472,210,109,133,157
"2011","South Cambridgeshire 019B","E01018227","Total",1887,171,80,91,1716,88,192,498,272,130,171,365
"2011","South Cambridgeshire 019C","E01018228","Total",1667,147,79,68,1520,32,212,426,276,81,189,304
"2011","South Cambridgeshire 019D","E01018290","Total",2403,203,99,104,2200,69,374,596,430,142,200,389
"2011","South Cambridgeshire 020A","E01033113","Total",1120,127,47,80,993,97,58,378,188,125,77,70
"2011","South Cambridgeshire 020B","E01033114","Total",1539,119,12,107,1420,66,50,526,248,216,201,113
"2011","South Cambridgeshire 020C","E01033115","Total",1407,60,6,54,1347,65,32,587,204,181,174,104
"2011","South Cambridgeshire 020D","E01033117","Total",1314,100,15,85,1214,69,20,506,210,162,149,98
"2011","South Cambridgeshire 020E","E01033119","Total",1805,121,13,108,1684,98,30,745,332,165,154,160
"2011","South Cambridgeshire 021A","E01018276","Total",1431,156,66,90,1275,51,118,396,244,122,116,228
"2011","South Cambridgeshire 021B","E01018277","Total",1719,160,62,98,1559,26,254,386,350,124,164,255
"2011","South Cambridgeshire 021C","E01018278","Total",1722,152,36,116,1570,46,134,535,314,160,188,193
"2011","South Cambridgeshire 021D","E01033116","Total",1686,136,66,70,1550,38,178,473,258,191,193,219
"2011","South Cambridgeshire 021E","E01033118","Total",1461,122,32,90,1339,41,120,469,300,96,146,167
"2011","Basildon 001A","E01021237","Total",1384,96,54,42,1288,14,198,368,160,109,139,300
"2011","Basildon 001B","E01021238","Total",1387,67,38,29,1320,52,210,370,184,52,157,295
"2011","Basildon 001C","E01021242","Total",1227,92,41,51,1135,33,132,285,220,58,120,287
"2011","Basildon 001D","E01021250","Total",1537,166,84,82,1371,20,192,419,230,86,115,309
"2011","Basildon 001E","E01021251","Total",1587,114,50,64,1473,33,196,427,226,103,150,338
"2011","Basildon 002A","E01021245","Total",1411,238,101,137,1173,99,122,290,234,100,113,215
"2011","Basildon 002B","E01021246","Total",1457,208,129,79,1249,16,214,335,236,92,92,264
"2011","Basildon 002C","E01021248","Total",1433,186,66,120,1247,84,134,389,246,61,92,241
"2011","Basildon 002D","E01021249","Total",1559,135,57,78,1424,34,208,411,258,124,135,254
"2011","Basildon 002E","E01021252","Total",1428,209,86,123,1219,52,120,346,292,62,124,223
"2011","Basildon 003A","E01021239","Total",1443,61,44,17,1382,24,234,367,188,116,167,286
"2011","Basildon 003B","E01021240","Total",1628,324,131,193,1304,38,166,420,280,70,119,211
"2011","Basildon 003C","E01021241","Total",1573,182,98,84,1391,107,170,312,228,118,220,236
"2011","Basildon 003D","E01021243","Total",1689,149,80,69,1540,51,188,444,272,62,174,349
"2011","Basildon 003E","E01021247","Total",1482,210,127,83,1272,25,264,361,190,68,102,262
"2011","Basildon 004A","E01021244","Total",1442,168,104,64,1274,37,278,384,234,63,99,179
"2011","Basildon 004B","E01021253","Total",1699,129,76,53,1570,42,322,440,214,93,159,300
"2011","Basildon 004C","E01021255","Total",1363,219,152,67,1144,36,254,252,184,40,137,241
"2011","Basildon 004D","E01021256","Total",1465,155,116,39,1310,13,222,400,212,46,104,313
"2011","Basildon 004E","E01021258","Total",1589,346,185,161,1243,68,168,354,232,42,108,271
"2011","Basildon 005A","E01021334","Total",1618,189,109,80,1429,67,274,323,238,63,185,279
"2011","Basildon 005B","E01021336","Total",1628,252,154,98,1376,52,246,345,250,60,113,310
"2011","Basildon 005C","E01021338","Total",1455,159,85,74,1296,102,204,342,208,67,116,257
"2011","Basildon 005D","E01021339","Total",1348,252,83,169,1096,103,164,245,248,74,95,167
"2011","Basildon 006A","E01021264","Total",1448,70,42,28,1378,24,220,222,192,124,228,368
"2011","Basildon 006B","E01021329","Total",1447,272,164,108,1175,40,216,244,212,59,133,271
"2011","Basildon 006C","E01021330","Total",1589,166,98,68,1423,55,246,305,220,75,133,389
"2011","Basildon 006D","E01021332","Total",1429,159,97,62,1270,28,264,257,224,67,143,287
"2011","Basildon 006E","E01021333","Total",1550,132,96,36,1418,19,290,287,246,49,144,383
"2011","Basildon 007A","E01021335","Total",1424,86,26,60,1338,69,106,358,200,62,193,350
"2011","Basildon 007B","E01021337","Total",1410,181,118,63,1229,21,256,255,198,66,136,297
"2011","Basildon 007C","E01021340","Total",1607,164,74,90,1443,63,196,344,268,85,158,329
"2011","Basildon 007D","E01021341","Total",1605,159,84,75,1446,60,230,360,234,97,171,294
"2011","Basildon 007E","E01021345","Total",2003,147,28,119,1856,82,88,895,376,105,147,163
"2011","Basildon 008A","E01021331","Total",1534,180,81,99,1354,54,180,298,240,83,174,325
"2011","Basildon 008B","E01021342","Total",1602,286,140,146,1316,77,136,378,178,99,152,296
"2011","Basildon 008C","E01021343","Total",1760,220,32,188,1540,147,48,624,346,114,86,175
"2011","Basildon 008D","E01021344","Total",2213,179,40,139,2034,120,136,677,428,153,256,264
"2011","Basildon 008E","E01021346","Total",1959,245,74,171,1714,68,152,644,416,71,108,255
"2011","Basildon 009A","E01021254","Total",1457,111,73,38,1346,10,218,298,172,85,224,339
"2011","Basildon 009B","E01021257","Total",1517,152,92,60,1365,42,242,299,194,91,183,314
"2011","Basildon 009C","E01021259","Total",1525,160,60,100,1365,52,202,354,278,66,145,268
"2011","Basildon 009D","E01021260","Total",2388,191,79,112,2197,34,220,405,304,257,600,377
"2011","Basildon 010A","E01021261","Total",1705,179,61,118,1526,81,180,362,280,119,234,270
"2011","Basildon 010B","E01021262","Total",1546,282,115,167,1264,95,136,311,350,57,116,199
"2011","Basildon 010C","E01021263","Total",1831,229,41,188,1602,153,128,509,360,56,181,215
"2011","Basildon 010D","E01021274","Total",1791,286,116,170,1505,106,200,318,298,113,183,287
"2011","Basildon 010E","E01021279","Total",1612,194,52,142,1418,158,100,370,240,104,215,231
"2011","Basildon 011A","E01021301","Total",1518,200,71,129,1318,190,74,291,190,117,188,268
"2011","Basildon 011B","E01021303","Total",1328,209,88,121,1119,104,94,251,226,78,110,256
"2011","Basildon 011C","E01021307","Total",1331,188,38,150,1143,137,64,289,268,53,120,212
"2011","Basildon 011D","E01021308","Total",1286,121,19,102,1165,35,46,315,206,54,200,309
"2011","Basildon 011E","E01021309","Total",1321,218,54,164,1103,130,78,270,268,43,114,200
"2011","Basildon 011F","E01021312","Total",1481,101,45,56,1380,56,192,193,228,69,253,389
"2011","Basildon 012A","E01021265","Total",1550,166,73,93,1384,113,202,269,180,83,212,325
"2011","Basildon 012B","E01021267","Total",1716,280,153,127,1436,112,180,299,272,122,164,287
"2011","Basildon 012C","E01021269","Total",1665,162,75,87,1503,109,152,294,258,175,239,276
"2011","Basildon 012D","E01021270","Total",1502,204,66,138,1298,95,124,292,198,161,185,243
"2011","Basildon 012E","E01021272","Total",1602,172,91,81,1430,163,158,329,220,129,191,240
"2011","Basildon 013A","E01021271","Total",1765,203,41,162,1562,240,84,342,188,187,225,296
"2011","Basildon 013B","E01021302","Total",1527,221,62,159,1306,226,60,251,188,228,175,178
"2011","Basildon 013C","E01021304","Total",1413,202,90,112,1211,135,102,241,232,103,126,272
"2011","Basildon 013D","E01021305","Total",1465,185,82,103,1280,107,144,233,218,112,185,281
"2011","Basildon 013E","E01021306","Total",1470,176,69,107,1294,134,112,244,228,89,177,310
"2011","Basildon 014A","E01021273","Total",1683,276,120,156,1407,125,192,280,250,105,147,308
"2011","Basildon 014B","E01021275","Total",1635,160,94,66,1475,60,192,247,306,48,231,391
"2011","Basildon 014C","E01021276","Total",1446,280,99,181,1166,72,144,253,262,52,171,212
"2011","Basildon 014D","E01021277","Total",1416,254,98,156,1162,86,166,307,232,44,100,227
"2011","Basildon 014E","E01021278","Total",1669,340,148,192,1329,150,112,353,234,102,133,245
"2011","Basildon 015A","E01021266","Total",1658,248,131,117,1410,123,216,342,222,102,150,255
"2011","Basildon 015B","E01021268","Total",1347,291,137,154,1056,127,108,269,166,92,79,215
"2011","Basildon 015C","E01021318","Total",2043,315,106,209,1728,197,194,431,322,67,217,300
"2011","Basildon 015D","E01021320","Total",1616,193,55,138,1423,130,134,276,218,154,212,299
"2011","Basildon 015E","E01021321","Total",1609,246,94,152,1363,147,166,306,192,119,207,226
"2011","Basildon 016A","E01021286","Total",1734,209,55,154,1525,197,84,376,250,115,170,333
"2011","Basildon 016B","E01021288","Total",1811,118,29,89,1693,382,52,419,130,325,207,178
"2011","Basildon 016C","E01021289","Total",1792,174,63,111,1618,186,124,422,250,92,222,322
"2011","Basildon 016D","E01021290","Total",1775,163,40,123,1612,358,88,297,170,151,250,298
"2011","Basildon 016E","E01021291","Total",1667,320,113,207,1347,132,172,331,236,88,167,221
"2011","Basildon 017A","E01021287","Total",1506,161,66,95,1345,103,154,368,204,62,188,266
"2011","Basildon 017B","E01021292","Total",1518,180,78,102,1338,127,206,264,188,98,171,284
"2011","Basildon 017C","E01021293","Total",1685,248,97,151,1437,91,210,393,234,89,194,226
"2011","Basildon 017D","E01021298","Total",1588,182,105,77,1406,145,168,269,220,83,193,328
"2011","Basildon 017E","E01021319","Total",1583,257,114,143,1326,125,130,345,242,62,136,286
"2011","Basildon 018A","E01021313","Total",1461,129,61,68,1332,43,210,192,234,60,162,431
"2011","Basildon 018B","E01021314","Total",1373,184,68,116,1189,131,94,279,186,129,125,245
"2011","Basildon 018C","E01021315","Total",1490,267,102,165,1223,108,160,206,198,140,172,239
"2011","Basildon 018D","E01021316","Total",1491,281,137,144,1210,144,148,216,228,75,175,224
"2011","Basildon 018E","E01021317","Total",1625,202,85,117,1423,138,144,270,248,173,195,255
"2011","Basildon 019A","E01021322","Total",1521,199,62,137,1322,133,110,261,222,137,200,259
"2011","Basildon 019B","E01021323","Total",1760,185,76,109,1575,246,96,319,202,201,247,264
"2011","Basildon 019C","E01021324","Total",1651,205,67,138,1446,209,86,301,202,168,215,265
"2011","Basildon 019D","E01021325","Total",1565,216,68,148,1349,235,98,279,182,167,194,194
"2011","Basildon 019E","E01021327","Total",1688,273,125,148,1415,148,160,275,212,102,222,296
"2011","Basildon 020A","E01021294","Total",1616,151,82,69,1465,76,216,291,202,68,236,376
"2011","Basildon 020B","E01021295","Total",1685,215,102,113,1470,121,198,348,206,120,198,279
"2011","Basildon 020C","E01021296","Total",1720,264,105,159,1456,118,220,334,222,90,173,299
"2011","Basildon 020D","E01021297","Total",1612,218,72,146,1394,108,138,372,252,67,142,315
"2011","Basildon 020E","E01021299","Total",1512,115,74,41,1397,12,270,243,214,36,225,397
"2011","Basildon 021A","E01021280","Total",1527,162,30,132,1365,64,64,516,318,75,134,194
"2011","Basildon 021B","E01021281","Total",1435,137,43,94,1298,25,196,283,290,65,112,327
"2011","Basildon 021C","E01021282","Total",1527,122,49,73,1405,35,252,288,278,70,160,322
"2011","Basildon 021D","E01021283","Total",1581,174,47,127,1407,108,118,307,260,120,157,337
"2011","Basildon 021E","E01021284","Total",1547,119,21,98,1428,42,68,530,274,93,182,239
"2011","Basildon 021F","E01021285","Total",1355,131,39,92,1224,40,78,409,244,71,177,205
"2011","Basildon 022A","E01021300","Total",2072,256,88,168,1816,175,154,422,306,153,189,417
"2011","Basildon 022B","E01021310","Total",1334,315,82,233,1019,43,134,235,286,27,69,225
"2011","Basildon 022C","E01021311","Total",1339,241,69,172,1098,81,148,132,214,82,201,240
"2011","Basildon 022D","E01021326","Total",1814,188,62,126,1626,165,134,378,304,90,241,314
"2011","Basildon 022E","E01021328","Total",1566,172,73,99,1394,130,130,326,224,109,153,322
"2011","Braintree 001A","E01021375","Total",1152,103,45,58,1049,46,150,240,236,89,117,171
"2011","Braintree 001B","E01021376","Total",1406,111,65,46,1295,21,186,312,260,78,166,272
"2011","Braintree 001C","E01021414","Total",2145,190,87,103,1955,78,340,371,402,91,232,441
"2011","Braintree 001D","E01021430","Total",2172,171,87,84,2001,82,272,522,330,157,298,340
"2011","Braintree 002A","E01021398","Total",1493,143,73,70,1350,47,270,285,246,50,138,314
"2011","Braintree 002B","E01021406","Total",2166,233,112,121,1933,68,406,437,436,74,164,348
"2011","Braintree 002C","E01021407","Total",2176,215,116,99,1961,78,396,487,404,139,186,271
"2011","Braintree 003A","E01021382","Total",1242,119,69,50,1123,37,246,223,184,56,135,242
"2011","Braintree 003B","E01021397","Total",1731,209,85,124,1522,106,184,326,318,80,186,322
"2011","Braintree 003C","E01021399","Total",1606,166,94,72,1440,73,250,342,242,68,169,296
"2011","Braintree 003D","E01021400","Total",1687,217,106,111,1470,92,262,302,318,87,167,242
"2011","Braintree 004A","E01021387","Total",1956,461,171,290,1495,97,170,415,404,87,108,214
"2011","Braintree 004B","E01021388","Total",1623,235,114,121,1388,82,172,312,296,114,181,231
"2011","Braintree 004C","E01021391","Total",1712,183,80,103,1529,236,170,397,176,165,153,232
"2011","Braintree 004D","E01021392","Total",1587,265,103,162,1322,99,196,308,310,66,126,217
"2011","Braintree 004E","E01021393","Total",1505,197,70,127,1308,73,170,339,276,118,132,200
"2011","Braintree 005A","E01021404","Total",2063,226,116,110,1837,64,354,365,366,87,165,436
"2011","Braintree 005B","E01021411","Total",1227,148,90,58,1079,50,192,244,202,62,97,232
"2011","Braintree 005C","E01021412","Total",1440,148,66,82,1292,35,184,368,232,69,163,241
"2011","Braintree 005D","E01021413","Total",1263,112,56,56,1151,33,190,240,248,66,113,261
"2011","Braintree 006A","E01021389","Total",1823,186,89,97,1637,58,234,543,210,170,166,256
"2011","Braintree 006B","E01021390","Total",1525,166,94,72,1359,68,254,369,292,66,92,218
"2011","Braintree 006C","E01021408","Total",1682,150,90,60,1532,40,278,287,326,129,171,301
"2011","Braintree 006D","E01021409","Total",1806,169,85,84,1637,61,198,463,300,124,217,274
"2011","Braintree 006E","E01021410","Total",1612,243,118,125,1369,154,192,312,260,104,130,217
"2011","Braintree 007A","E01021349","Total",1424,71,16,55,1353,51,56,369,220,81,185,391
"2011","Braintree 007B","E01021351","Total",1584,69,19,50,1515,72,88,467,268,132,193,295
"2011","Braintree 007C","E01021352","Total",1598,117,61,56,1481,80,116,430,206,102,180,367
"2011","Braintree 007D","E01021355","Total",1813,258,94,164,1555,83,228,373,348,79,164,280
"2011","Braintree 007E","E01021356","Total",1351,119,63,56,1232,20,218,334,204,57,138,261
"2011","Braintree 007F","E01021381","Total",1143,142,95,47,1001,25,232,193,192,61,64,234
"2011","Braintree 008A","E01021354","Total",1295,149,45,104,1146,126,142,275,210,83,130,180
"2011","Braintree 008B","E01021357","Total",1496,183,69,114,1313,62,162,306,242,96,155,290
"2011","Braintree 008C","E01021358","Total",2230,284,140,144,1946,284,204,461,274,195,234,294
"2011","Braintree 008D","E01021359","Total",2016,265,120,145,1751,197,202,429,282,71,232,338
"2011","Braintree 009A","E01021350","Total",1681,187,72,115,1494,48,260,387,256,99,143,301
"2011","Braintree 009B","E01021353","Total",1779,270,102,168,1509,80,196,395,320,79,150,289
"2011","Braintree 009D","E01021365","Total",2233,482,157,325,1751,165,168,376,506,92,138,306
"2011","Braintree 009E","E01033458","Total",1313,297,73,224,1016,107,42,298,356,21,36,156
"2011","Braintree 009F","E01033459","Total",1819,342,144,198,1477,133,132,368,364,71,130,279
"2011","Braintree 010A","E01021364","Total",1642,162,57,105,1480,81,192,452,294,58,139,264
"2011","Braintree 010B","E01021366","Total",1551,102,60,42,1449,52,228,321,230,99,183,336
"2011","Braintree 010C","E01021383","Total",2136,81,30,51,2055,105,212,698,212,208,299,321
"2011","Braintree 010D","E01021405","Total",2294,177,79,98,2117,104,294,535,360,112,239,473
"2011","Braintree 011A","E01021368","Total",1517,241,82,159,1276,92,140,308,254,88,122,272
"2011","Braintree 011B","E01021370","Total",1610,275,119,156,1335,180,100,338,220,152,128,217
"2011","Braintree 011C","E01021372","Total",1825,209,54,155,1616,92,170,439,330,130,154,301
"2011","Braintree 011D","E01021373","Total",2391,285,80,205,2106,161,226,586,486,108,187,352
"2011","Braintree 011E","E01021374","Total",1535,157,70,87,1378,128,142,283,194,126,196,309
"2011","Braintree 012A","E01021360","Total",1951,206,107,99,1745,160,170,472,258,143,158,384
"2011","Braintree 012B","E01021361","Total",1624,131,47,84,1493,86,144,394,330,121,133,285
"2011","Braintree 012C","E01021367","Total",1508,134,58,76,1374,104,102,323,210,98,294,243
"2011","Braintree 012D","E01021369","Total",2887,224,72,152,2663,234,156,962,428,231,299,353
"2011","Braintree 012E","E01021380","Total",2261,236,124,112,2025,101,358,448,400,130,182,406
"2011","Braintree 013A","E01021347","Total",2435,188,93,95,2247,102,252,668,344,209,269,403
"2011","Braintree 013B","E01021371","Total",1681,154,64,90,1527,67,224,504,296,68,94,274
"2011","Braintree 013C","E01021384","Total",2334,155,64,91,2179,121,174,757,296,181,271,379
"2011","Braintree 013D","E01021385","Total",1331,118,32,86,1213,124,66,437,190,99,114,183
"2011","Braintree 013E","E01021386","Total",1644,63,31,32,1581,77,132,435,242,193,217,285
"2011","Braintree 014A","E01021377","Total",1711,202,102,100,1509,67,238,387,266,129,152,270
"2011","Braintree 014B","E01021378","Total",1610,319,195,124,1291,65,226,393,266,66,70,205
"2011","Braintree 014C","E01021379","Total",1835,139,74,65,1696,64,210,474,276,147,141,384
"2011","Braintree 014D","E01021401","Total",1478,214,118,96,1264,85,198,290,216,78,145,252
"2011","Braintree 014E","E01021402","Total",2053,197,85,112,1856,101,176,565,370,149,158,337
"2011","Braintree 014F","E01021403","Total",1561,133,63,70,1428,38,200,402,302,82,169,235
"2011","Braintree 015A","E01021362","Total",1463,128,57,71,1335,59,174,314,210,53,192,333
"2011","Braintree 015B","E01021417","Total",1506,196,81,115,1310,72,172,301,264,84,182,235
"2011","Braintree 015C","E01021418","Total",1491,124,49,75,1367,177,66,309,198,104,242,271
"2011","Braintree 015D","E01021419","Total",1655,207,106,101,1448,72,194,331,290,112,160,289
"2011","Braintree 015E","E01021426","Total",1307,179,46,133,1128,121,110,283,286,60,91,177
"2011","Braintree 015F","E01021428","Total",1403,162,109,53,1241,19,270,240,256,36,113,307
"2011","Braintree 016A","E01021423","Total",1570,139,41,98,1431,155,110,378,216,131,250,191
"2011","Braintree 016B","E01021425","Total",1537,127,47,80,1410,146,90,423,250,101,183,217
"2011","Braintree 016C","E01021427","Total",1369,147,51,96,1222,85,98,265,194,130,150,300
"2011","Braintree 016D","E01021429","Total",1344,130,53,77,1214,78,110,239,214,149,154,270
"2011","Braintree 017A","E01021415","Total",1381,374,215,159,1007,73,168,232,190,37,77,230
"2011","Braintree 017B","E01021416","Total",1531,320,132,188,1211,51,156,282,310,40,103,269
"2011","Braintree 017C","E01021420","Total",1657,227,59,168,1430,92,166,331,294,70,184,293
"2011","Braintree 017E","E01021422","Total",1634,297,154,143,1337,102,246,305,256,62,101,265
"2011","Braintree 017F","E01033460","Total",1215,202,71,131,1013,53,124,234,248,51,94,209
"2011","Braintree 017G","E01033461","Total",1502,123,8,115,1379,76,34,502,340,113,130,184
"2011","Braintree 017H","E01033462","Total",1041,168,35,133,873,73,60,277,248,56,87,72
"2011","Braintree 018A","E01021348","Total",1576,117,62,55,1459,49,268,334,286,88,159,275
"2011","Braintree 018B","E01021394","Total",1437,222,118,104,1215,69,186,277,266,64,90,263
"2011","Braintree 018C","E01021395","Total",1470,158,100,58,1312,50,242,287,204,110,148,271
"2011","Braintree 018D","E01021396","Total",1364,99,50,49,1265,31,198,221,238,76,166,335
"2011","Braintree 018E","E01021424","Total",2030,188,69,119,1842,108,162,563,366,125,174,344
"2011","Brentwood 001A","E01021441","Total",1499,109,68,41,1390,81,204,278,176,45,236,370
"2011","Brentwood 001B","E01021442","Total",1348,105,75,30,1243,6,180,294,172,73,190,328
"2011","Brentwood 001C","E01021443","Total",1411,111,54,57,1300,49,188,241,204,74,234,310
"2011","Brentwood 001D","E01021444","Total",1609,143,81,62,1466,33,240,287,214,102,252,338
"2011","Brentwood 001E","E01021469","Total",1155,112,61,51,1043,22,202,188,144,85,182,220
"2011","Brentwood 001F","E01021470","Total",1079,72,44,28,1007,53,150,187,152,57,154,254
"2011","Brentwood 001G","E01021471","Total",1573,108,77,31,1465,28,316,299,174,40,295,313
"2011","Brentwood 002A","E01021457","Total",1399,186,98,88,1213,26,216,218,228,91,155,279
"2011","Brentwood 002B","E01021458","Total",1617,299,160,139,1318,41,292,312,220,87,128,238
"2011","Brentwood 002C","E01021459","Total",1315,108,78,30,1207,18,276,292,138,46,132,305
"2011","Brentwood 002D","E01021460","Total",1619,186,92,94,1433,51,252,297,200,125,150,358
"2011","Brentwood 003A","E01021448","Total",1405,249,136,113,1156,76,160,287,140,52,170,271
"2011","Brentwood 003B","E01021449","Total",1556,187,97,90,1369,66,178,336,184,94,197,314
"2011","Brentwood 003C","E01021450","Total",2065,167,101,66,1898,78,270,491,204,98,231,526
"2011","Brentwood 003D","E01021451","Total",1551,176,78,98,1375,171,90,372,208,120,161,253
"2011","Brentwood 003E","E01021452","Total",1467,154,103,51,1313,50,264,293,200,81,105,320
"2011","Brentwood 004A","E01021431","Total",1546,184,83,101,1362,53,144,403,232,122,131,277
"2011","Brentwood 004B","E01021432","Total",1681,196,79,117,1485,190,134,360,254,122,110,315
"2011","Brentwood 004C","E01021434","Total",1230,158,71,87,1072,93,80,283,186,85,136,209
"2011","Brentwood 004D","E01021461","Total",1442,183,82,101,1259,151,140,260,202,58,155,293
"2011","Brentwood 004E","E01021464","Total",1460,146,82,64,1314,40,206,306,206,52,148,356
"2011","Brentwood 005A","E01021447","Total",2450,204,128,76,2246,45,428,510,292,198,258,515
"2011","Brentwood 005B","E01021453","Total",1177,171,84,87,1006,21,168,270,152,57,100,238
"2011","Brentwood 005C","E01021455","Total",1352,80,55,25,1272,19,292,239,152,119,141,310
"2011","Brentwood 005D","E01021465","Total",1855,261,127,134,1594,34,254,477,280,91,163,295
"2011","Brentwood 005E","E01021466","Total",1812,93,59,34,1719,12,316,427,178,147,227,412
"2011","Brentwood 005F","E01021467","Total",1748,147,100,47,1601,25,232,483,186,100,225,350
"2011","Brentwood 006A","E01021438","Total",2025,167,84,83,1858,40,238,536,320,117,216,391
"2011","Brentwood 006B","E01021462","Total",1393,129,75,54,1264,45,194,281,228,67,147,302
"2011","Brentwood 006C","E01021463","Total",1553,154,102,52,1399,47,268,277,188,87,194,338
"2011","Brentwood 006D","E01021468","Total",1891,212,105,107,1679,50,218,442,264,87,239,379
"2011","Brentwood 007A","E01021433","Total",1923,373,169,204,1550,77,130,397,372,107,154,313
"2011","Brentwood 007B","E01021436","Total",2095,574,209,365,1521,83,156,400,458,64,59,301
"2011","Brentwood 007C","E01021439","Total",2312,454,88,366,1858,163,104,544,590,70,79,308
"2011","Brentwood 007E","E01021475","Total",1508,235,59,176,1273,70,106,458,272,47,143,177
"2011","Brentwood 007F","E01033063","Total",1340,168,20,148,1172,102,50,356,290,118,103,153
"2011","Brentwood 007G","E01033064","Total",1370,324,108,216,1046,102,76,287,238,62,122,159
"2011","Brentwood 008A","E01021435","Total",1858,255,119,136,1603,101,184,372,192,132,247,375
"2011","Brentwood 008B","E01021437","Total",1726,227,112,115,1499,191,168,386,192,101,141,320
"2011","Brentwood 008C","E01021472","Total",1430,322,96,226,1108,100,108,274,302,46,92,186
"2011","Brentwood 008D","E01021473","Total",1223,142,54,88,1081,31,172,241,184,53,136,264
"2011","Brentwood 008E","E01021474","Total",1573,136,104,32,1437,15,200,424,202,105,145,346
"2011","Brentwood 009A","E01021445","Total",2143,195,101,94,1948,62,268,493,280,141,202,502
"2011","Brentwood 009B","E01021446","Total",1531,194,119,75,1337,32,258,295,258,40,158,296
"2011","Brentwood 009C","E01021454","Total",1245,149,62,87,1096,59,126,319,214,45,92,241
"2011","Brentwood 009D","E01021456","Total",1229,148,40,108,1081,13,126,226,208,108,127,273
"2011","Castle Point 001A","E01021513","Total",1624,128,88,40,1496,29,260,355,224,58,156,414
"2011","Castle Point 001B","E01021514","Total",1518,143,81,62,1375,73,190,334,224,79,143,332
"2011","Castle Point 001C","E01021515","Total",1352,74,38,36,1278,56,190,317,168,78,187,282
"2011","Castle Point 001D","E01021525","Total",1508,190,63,127,1318,117,198,302,240,41,127,293
"2011","Castle Point 001E","E01021527","Total",1672,139,97,42,1533,63,300,333,218,52,198,369
"2011","Castle Point 002A","E01021509","Total",1366,218,123,95,1148,45,286,237,212,47,107,214
"2011","Castle Point 002B","E01021510","Total",1450,225,149,76,1225,48,296,221,172,78,111,299
"2011","Castle Point 002C","E01021511","Total",1304,132,74,58,1172,53,208,229,160,51,182,289
"2011","Castle Point 002D","E01021528","Total",1487,111,68,43,1376,40,228,248,246,85,191,338
"2011","Castle Point 002E","E01021531","Total",1373,124,66,58,1249,53,192,244,216,71,168,305
"2011","Castle Point 003A","E01021476","Total",1905,195,115,80,1710,54,258,370,250,84,285,409
"2011","Castle Point 003B","E01021477","Total",1540,130,83,47,1410,32,284,296,250,76,158,314
"2011","Castle Point 003C","E01021478","Total",1724,143,88,55,1581,61,240,273,196,114,255,442
"2011","Castle Point 003D","E01021516","Total",1364,103,55,48,1261,56,230,258,196,62,153,306
"2011","Castle Point 004A","E01021479","Total",1525,116,68,48,1409,54,254,346,180,70,172,333
"2011","Castle Point 004B","E01021481","Total",1514,85,52,33,1429,33,216,339,224,71,209,337
"2011","Castle Point 004C","E01021483","Total",1747,139,88,51,1608,43,288,307,258,119,213,380
"2011","Castle Point 004D","E01021512","Total",1564,161,104,57,1403,50,244,299,220,88,145,357
"2011","Castle Point 004E","E01021526","Total",1617,135,81,54,1482,67,250,303,250,50,211,351
"2011","Castle Point 005A","E01021517","Total",1599,194,126,68,1405,42,330,296,264,32,153,288
"2011","Castle Point 005B","E01021519","Total",1471,152,110,42,1319,26,356,201,216,50,180,290
"2011","Castle Point 005C","E01021530","Total",1426,169,101,68,1257,33,288,276,170,55,174,261
"2011","Castle Point 005D","E01021532","Total",1450,157,104,53,1293,32,354,237,246,68,94,262
"2011","Castle Point 006A","E01021482","Total",1531,140,95,45,1391,45,260,316,174,51,196,349
"2011","Castle Point 006B","E01021518","Total",1917,378,196,182,1539,122,218,322,336,87,144,310
"2011","Castle Point 006C","E01021520","Total",1549,210,131,79,1339,70,218,281,216,53,241,260
"2011","Castle Point 006D","E01021529","Total",1498,209,111,98,1289,72,176,333,166,63,150,329
"2011","Castle Point 007A","E01021480","Total",1829,147,72,75,1682,62,218,391,282,118,213,398
"2011","Castle Point 007B","E01021521","Total",1422,152,94,58,1270,57,206,280,244,56,150,277
"2011","Castle Point 007C","E01021522","Total",1666,196,83,113,1470,104,186,329,294,115,157,285
"2011","Castle Point 007D","E01021523","Total",1367,169,125,44,1198,18,262,246,200,40,123,309
"2011","Castle Point 007E","E01021524","Total",1544,172,96,76,1372,38,250,276,202,72,187,347
"2011","Castle Point 008A","E01021487","Total",1363,169,95,74,1194,42,226,274,204,40,145,263
"2011","Castle Point 008B","E01021494","Total",1490,138,75,63,1352,58,170,319,224,55,166,360
"2011","Castle Point 008C","E01021504","Total",1514,79,24,55,1435,54,74,312,188,72,317,418
"2011","Castle Point 008D","E01021505","Total",1413,54,26,28,1359,54,120,256,234,82,214,399
"2011","Castle Point 008E","E01021506","Total",1320,128,40,88,1192,101,86,301,210,72,160,262
"2011","Castle Point 009A","E01021492","Total",1743,212,115,97,1531,86,266,327,308,96,182,266
"2011","Castle Point 009B","E01021493","Total",1547,231,125,106,1316,54,240,280,244,39,149,310
"2011","Castle Point 009C","E01021495","Total",2011,502,379,123,1509,29,716,173,264,57,95,175
"2011","Castle Point 009D","E01021496","Total",1432,161,68,93,1271,82,224,263,162,76,189,275
"2011","Castle Point 010A","E01021485","Total",1256,147,82,65,1109,70,130,149,134,121,220,285
"2011","Castle Point 010B","E01021486","Total",1252,117,64,53,1135,170,90,194,122,119,217,223
"2011","Castle Point 010C","E01021488","Total",1406,181,95,86,1225,77,212,213,198,90,169,266
"2011","Castle Point 010D","E01021503","Total",1414,82,42,40,1332,117,158,258,188,84,207,320
"2011","Castle Point 010E","E01021507","Total",1600,156,79,77,1444,206,84,211,182,155,219,387
"2011","Castle Point 010F","E01021508","Total",1382,50,11,39,1332,110,46,357,140,148,198,333
"2011","Castle Point 011A","E01021484","Total",1366,189,113,76,1177,52,222,163,148,77,149,366
"2011","Castle Point 011B","E01021498","Total",1441,151,79,72,1290,27,238,168,212,63,168,414
"2011","Castle Point 011C","E01021499","Total",1638,129,85,44,1509,28,294,262,236,52,168,469
"2011","Castle Point 011D","E01021501","Total",1414,193,119,74,1221,31,254,243,194,67,116,316
"2011","Castle Point 011E","E01021502","Total",2225,310,90,220,1915,113,254,496,398,116,193,345
"2011","Castle Point 012A","E01021489","Total",1412,186,89,97,1226,42,234,221,234,72,149,274
"2011","Castle Point 012B","E01021490","Total",1493,214,102,112,1279,85,190,247,228,41,192,296
"2011","Castle Point 012C","E01021491","Total",1639,154,80,74,1485,74,228,273,238,77,235,360
"2011","Castle Point 012D","E01021497","Total",1495,211,115,96,1284,62,228,213,238,88,184,271
"2011","Castle Point 012E","E01021500","Total",1696,244,132,112,1452,91,226,311,292,76,191,265
"2011","Chelmsford 001A","E01021538","Total",2709,172,63,109,2537,101,248,788,408,227,314,451
"2011","Chelmsford 001B","E01021539","Total",1298,117,70,47,1181,29,202,291,242,90,162,165
"2011","Chelmsford 001C","E01021540","Total",1534,139,68,71,1395,29,234,299,300,104,148,281
"2011","Chelmsford 001D","E01021541","Total",1446,199,120,79,1247,45,254,269,198,116,91,274
"2011","Chelmsford 002A","E01021542","Total",1974,243,96,147,1731,66,250,475,322,122,176,320
"2011","Chelmsford 002B","E01021543","Total",1607,139,74,65,1468,34,254,406,262,103,127,282
"2011","Chelmsford 002C","E01021587","Total",1460,143,99,44,1317,42,290,276,214,92,99,304
"2011","Chelmsford 002D","E01021590","Total",1472,118,44,74,1354,33,190,318,284,114,135,280
"2011","Chelmsford 002E","E01021591","Total",1499,181,76,105,1318,39,182,314,284,92,100,307
"2011","Chelmsford 003A","E01021550","Total",1404,119,46,73,1285,38,190,257,296,110,136,258
"2011","Chelmsford 003B","E01021597","Total",1466,158,79,79,1308,99,146,290,218,115,156,284
"2011","Chelmsford 003C","E01021598","Total",1473,210,114,96,1263,158,176,311,206,66,88,258
"2011","Chelmsford 003D","E01021600","Total",1173,71,33,38,1102,22,160,222,178,41,163,316
"2011","Chelmsford 003E","E01021601","Total",1532,252,136,116,1280,133,152,282,228,91,156,238
"2011","Chelmsford 004A","E01021616","Total",1441,92,32,60,1349,47,124,314,276,100,124,364
"2011","Chelmsford 004B","E01021617","Total",1368,198,89,109,1170,67,108,287,228,86,111,283
"2011","Chelmsford 004C","E01021619","Total",1513,183,77,106,1330,73,112,424,232,65,93,331
"2011","Chelmsford 004D","E01021620","Total",1383,229,39,190,1154,78,104,305,298,72,93,204
"2011","Chelmsford 004E","E01021623","Total",1250,115,50,65,1135,46,152,292,232,56,130,227
"2011","Chelmsford 004F","E01021624","Total",1232,104,78,26,1128,4,274,238,164,73,128,247
"2011","Chelmsford 005A","E01021536","Total",1576,211,94,117,1365,87,196,320,294,67,121,280
"2011","Chelmsford 005B","E01021537","Total",1850,219,75,144,1631,68,252,412,290,65,185,359
"2011","Chelmsford 005D","E01021568","Total",1586,107,71,36,1479,50,330,281,240,101,185,292
"2011","Chelmsford 005E","E01033142","Total",2174,116,23,93,2058,86,82,822,314,191,294,269
"2011","Chelmsford 005F","E01033144","Total",1852,92,9,83,1760,99,48,598,258,217,288,252
"2011","Chelmsford 006A","E01021576","Total",1637,137,52,85,1500,279,86,382,180,142,167,264
"2011","Chelmsford 006B","E01021588","Total",1412,225,125,100,1187,99,190,204,154,143,144,253
"2011","Chelmsford 006C","E01021589","Total",1504,225,75,150,1279,121,124,313,238,80,172,231
"2011","Chelmsford 006D","E01021592","Total",1548,253,114,139,1295,164,134,275,180,124,129,289
"2011","Chelmsford 006E","E01021596","Total",1571,292,132,160,1279,139,110,310,172,132,199,217
"2011","Chelmsford 007A","E01021618","Total",1484,133,20,113,1351,50,92,375,250,92,207,285
"2011","Chelmsford 007B","E01021621","Total",1551,151,23,128,1400,66,52,463,314,115,160,230
"2011","Chelmsford 007C","E01021622","Total",1466,161,103,58,1305,20,304,272,220,34,173,282
"2011","Chelmsford 007D","E01021625","Total",1453,160,95,65,1293,68,250,313,202,60,101,299
"2011","Chelmsford 007E","E01021626","Total",1415,112,52,60,1303,48,196,294,226,85,149,305
"2011","Chelmsford 008A","E01021544","Total",1311,226,32,194,1085,63,92,400,282,40,59,149
"2011","Chelmsford 008B","E01021545","Total",1618,157,63,94,1461,48,110,605,284,112,111,191
"2011","Chelmsford 008C","E01021546","Total",1458,199,71,128,1259,52,70,367,234,106,126,304
"2011","Chelmsford 008D","E01021547","Total",1558,240,30,210,1318,53,50,373,388,60,122,272
"2011","Chelmsford 008E","E01021628","Total",1686,155,49,106,1531,93,120,443,298,99,156,322
"2011","Chelmsford 008F","E01021629","Total",1659,192,83,109,1467,90,116,392,290,100,181,298
"2011","Chelmsford 009A","E01021573","Total",1716,205,65,140,1511,37,150,383,266,134,196,345
"2011","Chelmsford 009B","E01021575","Total",1567,247,63,184,1320,84,90,323,382,80,100,261
"2011","Chelmsford 009C","E01021599","Total",1837,153,67,86,1684,52,208,433,350,138,183,320
"2011","Chelmsford 009E","E01021631","Total",1887,239,118,121,1648,169,172,362,264,174,204,303
"2011","Chelmsford 009F","E01033138","Total",1515,181,70,111,1334,81,128,345,290,79,136,275
"2011","Chelmsford 009G","E01033139","Total",1461,200,20,180,1261,111,40,304,348,85,110,263
"2011","Chelmsford 010A","E01021574","Total",1996,424,50,374,1572,90,48,270,600,58,67,439
"2011","Chelmsford 010B","E01021578","Total",1682,373,56,317,1309,62,94,412,412,40,76,213
"2011","Chelmsford 010D","E01021582","Total",1848,421,80,341,1427,75,114,347,552,45,77,217
"2011","Chelmsford 010E","E01021627","Total",1261,227,116,111,1034,12,148,264,228,51,63,268
"2011","Chelmsford 010F","E01033140","Total",1106,316,96,220,790,60,32,188,318,15,44,133
"2011","Chelmsford 010G","E01033141","Total",1011,323,120,203,688,40,64,125,300,21,36,102
"2011","Chelmsford 011A","E01021551","Total",1360,135,76,59,1225,54,212,271,208,62,173,245
"2011","Chelmsford 011B","E01021632","Total",1443,112,83,29,1331,28,336,303,206,62,76,320
"2011","Chelmsford 011C","E01021633","Total",1082,170,83,87,912,18,236,182,186,46,86,158
"2011","Chelmsford 011D","E01021634","Total",1521,136,68,68,1385,41,238,318,220,61,175,332
"2011","Chelmsford 011E","E01021635","Total",1383,189,117,72,1194,27,284,233,216,66,105,263
"2011","Chelmsford 011F","E01021636","Total",1090,189,118,71,901,66,152,190,152,41,80,220
"2011","Chelmsford 012A","E01021556","Total",1646,184,72,112,1462,30,206,425,250,128,157,266
"2011","Chelmsford 012B","E01021577","Total",1450,168,79,89,1282,47,162,428,244,52,122,227
"2011","Chelmsford 012C","E01021579","Total",1499,159,51,108,1340,42,112,456,266,98,131,235
"2011","Chelmsford 012D","E01021580","Total",1423,78,45,33,1345,17,140,455,168,115,195,255
"2011","Chelmsford 012E","E01021584","Total",1227,73,55,18,1154,22,268,226,130,91,148,269
"2011","Chelmsford 013A","E01021548","Total",1306,149,72,77,1157,5,104,313,254,65,114,302
"2011","Chelmsford 013B","E01021560","Total",1650,278,155,123,1372,42,300,315,278,79,124,234
"2011","Chelmsford 013C","E01021561","Total",1771,189,94,95,1582,57,346,422,244,58,151,304
"2011","Chelmsford 013D","E01021564","Total",1479,169,92,77,1310,26,320,239,192,102,114,317
"2011","Chelmsford 013E","E01021571","Total",1573,108,70,38,1465,32,268,327,192,127,196,323
"2011","Chelmsford 014A","E01021562","Total",1762,284,129,155,1478,102,222,383,260,83,129,299
"2011","Chelmsford 014B","E01021563","Total",1685,337,111,226,1348,130,146,291,306,130,114,231
"2011","Chelmsford 014C","E01021565","Total",1591,220,92,128,1371,161,126,353,218,114,138,261
"2011","Chelmsford 014D","E01021566","Total",1720,155,66,89,1565,57,248,415,252,117,164,312
"2011","Chelmsford 014F","E01033137","Total",1577,169,42,127,1408,120,126,433,278,109,127,215
"2011","Chelmsford 014G","E01033145","Total",1385,141,79,62,1244,68,226,297,186,50,147,270
"2011","Chelmsford 015A","E01021557","Total",1264,101,32,69,1163,37,116,310,202,72,137,289
"2011","Chelmsford 015B","E01021558","Total",1266,104,48,56,1162,14,170,262,222,79,135,280
"2011","Chelmsford 015C","E01021583","Total",1575,131,52,79,1444,84,146,403,216,138,153,304
"2011","Chelmsford 015D","E01021585","Total",1272,106,57,49,1166,44,154,295,172,58,137,306
"2011","Chelmsford 015E","E01021586","Total",1550,137,68,69,1413,43,250,346,176,94,182,322
"2011","Chelmsford 016A","E01021533","Total",2270,225,79,146,2045,64,290,617,354,101,188,431
"2011","Chelmsford 016B","E01021535","Total",1772,138,67,71,1634,78,222,382,244,125,208,375
"2011","Chelmsford 016C","E01021569","Total",1611,104,60,44,1507,29,330,356,246,120,135,291
"2011","Chelmsford 016D","E01021570","Total",1907,149,88,61,1758,31,366,388,278,137,178,380
"2011","Chelmsford 016E","E01021572","Total",1534,167,93,74,1367,93,190,305,228,133,152,266
"2011","Chelmsford 017A","E01021552","Total",1538,190,127,63,1348,79,304,244,182,62,134,343
"2011","Chelmsford 017B","E01021553","Total",1382,153,61,92,1229,59,158,306,208,71,147,280
"2011","Chelmsford 017C","E01021554","Total",1440,208,59,149,1232,130,172,275,240,85,121,209
"2011","Chelmsford 017D","E01021555","Total",1378,107,64,43,1271,35,182,270,210,126,136,312
"2011","Chelmsford 017E","E01021559","Total",1505,112,74,38,1393,34,212,266,216,105,209,351
"2011","Chelmsford 018B","E01021602","Total",1676,242,132,110,1434,45,302,303,246,75,151,312
"2011","Chelmsford 018D","E01021604","Total",2277,159,79,80,2118,99,234,589,358,153,251,434
"2011","Chelmsford 018E","E01033143","Total",2589,373,201,172,2216,15,590,419,340,139,244,469
"2011","Chelmsford 019A","E01021611","Total",1501,70,30,40,1431,43,128,449,184,94,144,389
"2011","Chelmsford 019B","E01021612","Total",1527,131,71,60,1396,50,220,357,240,68,185,276
"2011","Chelmsford 019C","E01021613","Total",1818,325,108,217,1493,95,136,359,366,100,158,279
"2011","Chelmsford 019D","E01021614","Total",1767,109,55,54,1658,49,212,368,214,116,233,466
"2011","Chelmsford 019E","E01021615","Total",1474,153,72,81,1321,79,174,324,290,96,116,242
"2011","Chelmsford 020A","E01021605","Total",1250,73,29,44,1177,52,110,270,208,51,126,360
"2011","Chelmsford 020B","E01021606","Total",1643,109,19,90,1534,86,82,341,226,109,230,460
"2011","Chelmsford 020C","E01021607","Total",1517,201,59,142,1316,88,54,422,306,70,131,245
"2011","Chelmsford 020D","E01021608","Total",1145,219,75,144,926,69,64,275,216,48,76,178
"2011","Chelmsford 020E","E01021609","Total",1424,92,35,57,1332,32,114,303,210,98,225,350
"2011","Chelmsford 020F","E01021610","Total",1315,186,51,135,1129,69,74,271,252,68,139,256
"2011","Chelmsford 021A","E01021593","Total",1575,179,125,54,1396,33,296,301,208,94,162,302
"2011","Chelmsford 021B","E01021594","Total",1614,166,67,99,1448,29,276,272,260,69,186,356
"2011","Chelmsford 021C","E01021595","Total",1693,173,110,63,1520,30,312,341,254,46,153,384
"2011","Colchester 001A","E01021655","Total",1341,96,46,50,1245,27,200,257,226,91,128,316
"2011","Colchester 001B","E01021656","Total",1548,204,118,86,1344,44,280,281,230,72,168,269
"2011","Colchester 001C","E01021659","Total",2079,173,84,89,1906,48,302,478,342,177,189,370
"2011","Colchester 001D","E01021661","Total",1718,112,59,53,1606,62,214,435,284,113,168,330
"2011","Colchester 002A","E01021668","Total",1651,340,39,301,1311,116,78,378,344,100,118,177
"2011","Colchester 002B","E01021669","Total",1525,286,60,226,1239,152,82,382,278,82,146,117
"2011","Colchester 002C","E01021670","Total",1550,162,44,118,1388,157,130,384,212,120,162,223
"2011","Colchester 002D","E01021671","Total",1399,164,79,85,1235,48,150,320,248,70,102,297
"2011","Colchester 002F","E01033720","Total",1999,173,15,158,1826,154,38,637,408,162,217,210
"2011","Colchester 002G","E01033721","Total",1792,124,14,110,1668,107,30,842,284,131,140,134
"2011","Colchester 003A","E01021660","Total",1460,107,59,48,1353,23,222,346,246,125,146,245
"2011","Colchester 003B","E01021728","Total",1636,121,91,30,1515,20,292,410,258,80,142,313
"2011","Colchester 003C","E01021729","Total",1708,179,79,100,1529,87,214,422,274,68,212,252
"2011","Colchester 003D","E01021730","Total",1676,163,78,85,1513,90,250,310,224,96,169,374
"2011","Colchester 004A","E01021679","Total",2348,272,53,219,2076,136,90,750,536,94,169,301
"2011","Colchester 004B","E01021680","Total",2740,263,96,167,2477,154,164,855,490,145,271,398
"2011","Colchester 004C","E01021681","Total",2690,312,71,241,2378,138,216,725,696,137,197,269
"2011","Colchester 004D","E01021682","Total",2620,347,79,268,2273,141,198,690,546,127,216,355
"2011","Colchester 007A","E01021646","Total",1954,441,148,293,1513,90,170,324,472,65,115,277
"2011","Colchester 007B","E01021647","Total",1783,282,100,182,1501,94,186,358,326,81,120,336
"2011","Colchester 007C","E01021648","Total",2303,434,157,277,1869,150,176,408,530,68,143,394
"2011","Colchester 007D","E01021649","Total",1822,562,134,428,1260,111,90,291,436,26,92,214
"2011","Colchester 007E","E01021650","Total",1947,381,48,333,1566,125,90,375,518,56,164,238
"2011","Colchester 008A","E01021696","Total",1559,320,128,192,1239,196,126,289,174,76,85,293
"2011","Colchester 008B","E01021697","Total",1660,227,105,122,1433,153,182,287,214,71,173,353
"2011","Colchester 008C","E01021698","Total",1300,81,23,58,1219,113,82,191,156,84,160,433
"2011","Colchester 008D","E01021699","Total",1458,228,87,141,1230,148,144,194,198,55,110,381
"2011","Colchester 008E","E01021700","Total",1511,153,33,120,1358,216,60,267,178,145,105,387
"2011","Colchester 008G","E01033719","Total",1139,200,3,197,939,39,8,182,332,25,29,324
"2011","Colchester 008H","E01033722","Total",1589,149,34,115,1440,121,86,199,180,83,105,666
"2011","Colchester 009A","E01021673","Total",1366,200,132,68,1166,20,312,243,170,40,160,221
"2011","Colchester 009B","E01021674","Total",1358,121,40,81,1237,87,90,351,178,94,184,253
"2011","Colchester 009C","E01021675","Total",1311,126,59,67,1185,46,180,306,202,96,136,219
"2011","Colchester 009D","E01021676","Total",1409,208,99,109,1201,46,266,293,202,63,126,205
"2011","Colchester 010A","E01021654","Total",1844,166,77,89,1678,52,210,496,294,126,145,355
"2011","Colchester 010B","E01021662","Total",1578,133,68,65,1445,32,248,297,274,147,176,271
"2011","Colchester 010C","E01021663","Total",1098,110,55,55,988,27,194,157,194,95,138,183
"2011","Colchester 010D","E01021677","Total",1212,109,55,54,1103,18,178,250,224,52,123,258
"2011","Colchester 010E","E01021678","Total",1326,143,37,106,1183,62,146,298,254,80,116,227
"2011","Colchester 011A","E01021683","Total",1044,237,63,174,807,117,40,220,286,25,26,93
"2011","Colchester 011B","E01021684","Total",1506,248,97,151,1258,98,144,359,310,77,93,177
"2011","Colchester 011C","E01021685","Total",1917,282,44,238,1635,197,36,368,384,92,223,335
"2011","Colchester 011D","E01021686","Total",1830,482,89,393,1348,184,40,324,418,76,114,192
"2011","Colchester 011E","E01021687","Total",1630,266,47,219,1364,146,72,390,364,57,87,248
"2011","Colchester 011F","E01021688","Total",1404,176,45,131,1228,120,94,314,270,88,99,243
"2011","Colchester 012A","E01021718","Total",1515,193,42,151,1322,78,138,344,318,93,127,224
"2011","Colchester 012B","E01021719","Total",1541,184,103,81,1357,59,286,313,208,72,140,279
"2011","Colchester 012C","E01021720","Total",1477,299,152,147,1178,89,148,270,200,99,105,267
"2011","Colchester 012D","E01021721","Total",1960,156,82,74,1804,93,290,449,262,79,227,404
"2011","Colchester 012E","E01021722","Total",1664,199,102,97,1465,75,232,358,246,78,200,276
"2011","Colchester 013A","E01021651","Total",1624,276,85,191,1348,130,46,451,294,107,85,235
"2011","Colchester 013B","E01021652","Total",1489,202,72,130,1287,47,200,295,230,146,132,237
"2011","Colchester 013C","E01021653","Total",1332,93,29,64,1239,18,118,410,160,60,217,256
"2011","Colchester 013D","E01021717","Total",1726,179,70,109,1547,79,154,478,352,82,161,241
"2011","Colchester 014A","E01021689","Total",1444,183,123,60,1261,53,238,277,170,59,200,264
"2011","Colchester 014B","E01021690","Total",1320,87,35,52,1233,65,112,302,226,99,137,292
"2011","Colchester 014C","E01021691","Total",1450,182,125,57,1268,42,280,232,226,59,127,302
"2011","Colchester 014D","E01021692","Total",1473,141,86,55,1332,25,264,257,196,65,199,326
"2011","Colchester 014E","E01021693","Total",1660,202,145,57,1458,56,378,268,178,88,206,284
"2011","Colchester 015A","E01021711","Total",1295,209,99,110,1086,126,142,205,174,139,126,174
"2011","Colchester 015C","E01021713","Total",1191,155,89,66,1036,52,130,152,100,73,236,293
"2011","Colchester 015D","E01021714","Total",1777,122,24,98,1655,178,76,559,298,116,223,205
"2011","Colchester 015E","E01021715","Total",1462,138,61,77,1324,118,114,312,226,86,200,268
"2011","Colchester 015G","E01033723","Total",2630,124,13,111,2506,170,20,1245,282,422,241,126
"2011","Colchester 016A","E01021657","Total",1582,238,89,149,1344,124,156,374,278,53,108,251
"2011","Colchester 016B","E01021658","Total",1051,130,62,68,921,68,104,204,144,76,101,224
"2011","Colchester 016C","E01021664","Total",1997,276,96,180,1721,131,170,436,422,80,165,317
"2011","Colchester 016D","E01021665","Total",1364,226,71,155,1138,108,118,248,200,90,184,190
"2011","Colchester 016E","E01021666","Total",1295,241,74,167,1054,53,124,272,268,15,98,224
"2011","Colchester 016F","E01021667","Total",1423,193,72,121,1230,117,152,312,216,91,122,220
"2011","Colchester 017A","E01021736","Total",1261,152,41,111,1109,41,96,229,226,78,124,315
"2011","Colchester 017B","E01021737","Total",1229,205,91,114,1024,83,176,249,204,55,40,217
"2011","Colchester 017C","E01021738","Total",2104,332,107,225,1772,61,274,415,418,151,165,288
"2011","Colchester 017D","E01021739","Total",1563,153,87,66,1410,40,228,323,290,96,92,341
"2011","Colchester 017E","E01021740","Total",1735,217,114,103,1518,88,256,339,244,97,99,395
"2011","Colchester 018A","E01021637","Total",1177,103,39,64,1074,72,140,225,180,43,156,258
"2011","Colchester 018B","E01021638","Total",1229,133,62,71,1096,115,114,244,180,52,133,258
"2011","Colchester 018C","E01021639","Total",1740,234,54,180,1506,129,98,417,352,98,209,203
"2011","Colchester 018D","E01021640","Total",1205,99,33,66,1106,94,98,249,238,72,112,243
"2011","Colchester 018E","E01021641","Total",1403,158,71,87,1245,95,164,263,248,76,156,243
"2011","Colchester 018F","E01021642","Total",2003,273,110,163,1730,139,130,408,300,94,344,315
"2011","Colchester 019A","E01021643","Total",2448,154,70,84,2294,62,286,613,410,207,270,446
"2011","Colchester 019B","E01021644","Total",1660,148,77,71,1512,35,236,347,296,139,166,293
"2011","Colchester 019C","E01021645","Total",1493,102,60,42,1391,34,226,339,250,88,123,331
"2011","Colchester 019D","E01021694","Total",1423,126,61,65,1297,24,242,239,288,104,186,214
"2011","Colchester 019E","E01021695","Total",1103,89,51,38,1014,20,214,271,194,51,65,199
"2011","Colchester 020A","E01021723","Total",1626,205,120,85,1421,67,302,289,248,44,116,355
"2011","Colchester 020B","E01021724","Total",1667,229,141,88,1438,39,312,301,238,93,173,282
"2011","Colchester 020C","E01021725","Total",1290,105,58,47,1185,24,254,191,198,66,130,322
"2011","Colchester 020D","E01021726","Total",1520,221,104,117,1299,105,216,294,232,83,115,254
"2011","Colchester 020E","E01021727","Total",1455,152,95,57,1303,33,256,307,272,30,138,267
"2011","Colchester 021A","E01021731","Total",1434,173,116,57,1261,32,314,256,240,95,94,230
"2011","Colchester 021B","E01021732","Total",1523,267,143,124,1256,91,216,295,194,89,154,217
"2011","Colchester 021C","E01021733","Total",1501,141,84,57,1360,85,356,271,282,67,97,202
"2011","Colchester 021D","E01021734","Total",1357,189,133,56,1168,25,328,192,222,36,114,251
"2011","Colchester 021E","E01021735","Total",1357,244,179,65,1113,37,350,176,184,76,88,202
"2011","Colchester 022D","E01021702","Total",1331,181,96,85,1150,69,142,237,268,90,103,241
"2011","Colchester 022E","E01021703","Total",1275,133,58,75,1142,172,68,214,140,172,143,233
"2011","Colchester 022F","E01021704","Total",1478,236,81,155,1242,136,134,286,218,67,177,224
"2011","Colchester 022G","E01021705","Total",2034,121,53,68,1913,75,248,343,360,109,260,518
"2011","Colchester 022H","E01021706","Total",1256,236,52,184,1020,58,68,222,284,65,97,226
"2011","Colchester 022I","E01021707","Total",1358,180,97,83,1178,61,220,284,174,41,127,271
"2011","Colchester 022A","E01021708","Total",1391,162,85,77,1229,48,258,199,268,38,136,282
"2011","Colchester 022B","E01021709","Total",1434,158,99,59,1276,52,356,230,188,71,87,292
"2011","Colchester 022C","E01021710","Total",1937,147,81,66,1790,41,356,370,268,88,218,449
"2011","Epping Forest 001A","E01021768","Total",2138,210,114,96,1928,75,282,440,330,145,233,423
"2011","Epping Forest 001B","E01021795","Total",2014,330,65,265,1684,53,190,460,454,90,158,279
"2011","Epping Forest 001C","E01021797","Total",1314,121,62,59,1193,34,154,286,192,62,131,334
"2011","Epping Forest 001D","E01021798","Total",1536,155,105,50,1381,60,252,268,228,100,176,297
"2011","Epping Forest 001E","E01021799","Total",1584,247,127,120,1337,105,158,301,256,92,168,257
"2011","Epping Forest 002A","E01021741","Total",1970,172,88,84,1798,49,264,406,306,84,233,456
"2011","Epping Forest 002B","E01021792","Total",1205,107,61,46,1098,23,222,148,154,78,180,293
"2011","Epping Forest 002C","E01021793","Total",1523,120,77,43,1403,22,312,266,220,63,132,388
"2011","Epping Forest 002D","E01021794","Total",1146,144,88,56,1002,46,154,220,152,32,157,241
"2011","Epping Forest 002E","E01021801","Total",2187,216,126,90,1971,42,292,412,324,93,306,502
"2011","Epping Forest 003A","E01021769","Total",2237,159,87,72,2078,53,308,452,328,150,286,501
"2011","Epping Forest 003B","E01021796","Total",2122,208,117,91,1914,74,362,384,308,127,274,385
"2011","Epping Forest 003C","E01021800","Total",2239,201,82,119,2038,57,260,397,292,152,318,562
"2011","Epping Forest 004A","E01021753","Total",1407,223,107,116,1184,53,150,292,224,60,145,260
"2011","Epping Forest 004B","E01021754","Total",1538,125,84,41,1413,35,320,303,180,101,183,291
"2011","Epping Forest 004C","E01021755","Total",1101,133,81,52,968,27,198,232,150,38,75,248
"2011","Epping Forest 004D","E01021802","Total",2205,238,135,103,1967,179,240,528,294,111,191,424
"2011","Epping Forest 005A","E01021760","Total",1512,194,101,93,1318,48,204,315,222,65,149,315
"2011","Epping Forest 005B","E01021761","Total",1782,183,85,98,1599,143,206,405,294,97,115,339
"2011","Epping Forest 005C","E01021762","Total",1380,191,125,66,1189,51,224,307,194,63,137,213
"2011","Epping Forest 005D","E01021763","Total",1495,194,120,74,1301,52,174,405,264,83,85,238
"2011","Epping Forest 006A","E01021756","Total",1527,144,63,81,1383,68,154,366,250,93,164,288
"2011","Epping Forest 006B","E01021757","Total",1589,286,141,145,1303,42,286,275,362,31,89,218
"2011","Epping Forest 006C","E01021758","Total",1521,288,133,155,1233,42,224,275,312,36,131,213
"2011","Epping Forest 006D","E01021759","Total",1491,158,67,91,1333,69,148,377,230,92,182,235
"2011","Epping Forest 007A","E01021811","Total",1364,188,90,98,1176,147,126,238,214,66,122,263
"2011","Epping Forest 007B","E01021813","Total",1386,156,92,64,1230,50,210,205,188,62,163,352
"2011","Epping Forest 007C","E01021814","Total",1450,179,84,95,1271,78,170,314,176,57,160,316
"2011","Epping Forest 007D","E01021815","Total",1547,182,56,126,1365,87,102,319,182,117,219,339
"2011","Epping Forest 007E","E01021816","Total",1262,282,132,150,980,59,112,259,152,53,132,213
"2011","Epping Forest 008A","E01021807","Total",1514,137,58,79,1377,93,156,378,202,113,153,282
"2011","Epping Forest 008B","E01021808","Total",1486,171,72,99,1315,129,154,331,190,68,160,283
"2011","Epping Forest 008C","E01021809","Total",1400,216,98,118,1184,52,160,231,208,92,182,259
"2011","Epping Forest 008D","E01021810","Total",1787,257,51,206,1530,153,76,541,342,45,140,233
"2011","Epping Forest 008E","E01021817","Total",2491,330,91,239,2161,208,214,612,380,150,251,346
"2011","Epping Forest 009A","E01021806","Total",2150,379,185,194,1771,64,332,304,358,152,238,323
"2011","Epping Forest 009B","E01021812","Total",1241,220,105,115,1021,34,162,187,218,56,120,244
"2011","Epping Forest 009C","E01021818","Total",1758,445,145,300,1313,110,132,350,304,72,127,218
"2011","Epping Forest 010A","E01021770","Total",2013,315,143,172,1698,111,298,380,264,101,190,354
"2011","Epping Forest 010B","E01021803","Total",1327,144,96,48,1183,33,158,258,182,92,148,312
"2011","Epping Forest 010C","E01021804","Total",1357,186,77,109,1171,24,172,301,210,45,181,238
"2011","Epping Forest 010D","E01021805","Total",1294,98,73,25,1196,28,194,304,166,105,170,229
"2011","Epping Forest 011A","E01021774","Total",1409,229,72,157,1180,123,74,330,194,60,144,255
"2011","Epping Forest 011B","E01021775","Total",1457,243,84,159,1214,115,110,301,164,120,171,233
"2011","Epping Forest 011C","E01021776","Total",1367,350,210,140,1017,55,134,257,232,53,95,191
"2011","Epping Forest 011D","E01021777","Total",1372,175,82,93,1197,62,132,326,162,69,129,317
"2011","Epping Forest 011E","E01021778","Total",1454,143,49,94,1311,79,106,318,186,99,148,375
"2011","Epping Forest 011F","E01021779","Total",1491,276,97,179,1215,113,112,354,254,35,97,250
"2011","Epping Forest 012A","E01021786","Total",1238,164,45,119,1074,36,136,339,174,61,94,234
"2011","Epping Forest 012B","E01021787","Total",1548,174,74,100,1374,29,170,366,198,66,147,398
"2011","Epping Forest 012C","E01021788","Total",1558,140,65,75,1418,65,232,341,202,50,154,374
"2011","Epping Forest 012D","E01021789","Total",1541,70,52,18,1471,38,192,310,148,131,204,448
"2011","Epping Forest 012E","E01021790","Total",1466,126,63,63,1340,127,96,343,210,126,180,258
"2011","Epping Forest 012F","E01021791","Total",1538,192,86,106,1346,65,144,384,272,61,109,311
"2011","Epping Forest 013A","E01021771","Total",1523,289,93,196,1234,159,118,411,188,67,114,177
"2011","Epping Forest 013B","E01021772","Total",1490,159,90,69,1331,77,182,266,168,85,169,384
"2011","Epping Forest 013C","E01021773","Total",1513,149,75,74,1364,109,116,338,194,77,179,351
"2011","Epping Forest 013D","E01021783","Total",1554,165,78,87,1389,78,176,375,214,76,122,348
"2011","Epping Forest 013E","E01021784","Total",1532,176,80,96,1356,75,168,398,234,76,132,273
"2011","Epping Forest 014A","E01021780","Total",1452,79,37,42,1373,40,186,348,172,93,237,297
"2011","Epping Forest 014B","E01021781","Total",1466,182,74,108,1284,49,184,348,250,55,118,280
"2011","Epping Forest 014C","E01021782","Total",1410,230,127,103,1180,35,162,282,224,71,142,264
"2011","Epping Forest 014D","E01021785","Total",1620,188,68,120,1432,149,108,394,230,99,169,283
"2011","Epping Forest 015A","E01021742","Total",1375,118,52,66,1257,53,100,403,162,83,218,238
"2011","Epping Forest 015B","E01021743","Total",1623,368,190,178,1255,96,166,340,292,46,120,195
"2011","Epping Forest 015C","E01021744","Total",1548,168,64,104,1380,69,160,422,242,51,140,296
"2011","Epping Forest 015D","E01021745","Total",1525,206,73,133,1319,42,158,375,236,86,158,264
"2011","Epping Forest 015E","E01021746","Total",1783,346,143,203,1437,89,194,434,302,79,139,200
"2011","Epping Forest 015F","E01021747","Total",1618,151,68,83,1467,65,216,354,216,56,194,366
"2011","Epping Forest 015G","E01021748","Total",1729,225,84,141,1504,96,160,443,312,78,128,287
"2011","Epping Forest 016A","E01021749","Total",2188,232,107,125,1956,55,336,381,328,77,243,536
"2011","Epping Forest 016B","E01021750","Total",1256,136,65,71,1120,15,162,149,118,62,293,321
"2011","Epping Forest 016C","E01021751","Total",1341,56,39,17,1285,11,150,225,118,60,270,451
"2011","Epping Forest 016D","E01021752","Total",1538,114,47,67,1424,102,114,284,216,87,260,361
"2011","Epping Forest 017A","E01021764","Total",1770,199,60,139,1571,315,48,483,208,104,201,212
"2011","Epping Forest 017B","E01021765","Total",1620,184,64,120,1436,76,164,295,202,76,279,344
"2011","Epping Forest 017C","E01021766","Total",1460,94,47,47,1366,47,172,208,124,92,313,410
"2011","Epping Forest 017D","E01021767","Total",1660,157,96,61,1503,38,216,260,182,61,319,427
"2011","Harlow 001A","E01021854","Total",1636,221,99,122,1415,70,230,293,306,66,163,287
"2011","Harlow 001B","E01021855","Total",1394,200,108,92,1194,85,166,251,190,141,106,255
"2011","Harlow 001C","E01021856","Total",1419,179,101,78,1240,58,148,295,248,57,155,279
"2011","Harlow 001D","E01021857","Total",2500,317,154,163,2183,129,244,512,464,166,269,399
"2011","Harlow 002A","E01021844","Total",1365,121,55,66,1244,92,126,263,182,53,211,317
"2011","Harlow 002B","E01021845","Total",1434,202,93,109,1232,154,132,254,206,63,195,228
"2011","Harlow 002C","E01021846","Total",1351,185,66,119,1166,137,98,229,184,92,200,226
"2011","Harlow 002D","E01021847","Total",1408,213,122,91,1195,66,164,305,202,102,157,199
"2011","Harlow 002E","E01021848","Total",1575,224,97,127,1351,109,162,322,252,81,152,273
"2011","Harlow 003A","E01021849","Total",1603,215,115,100,1388,76,154,322,210,95,185,346
"2011","Harlow 003B","E01021850","Total",1430,206,86,120,1224,137,130,273,182,86,154,262
"2011","Harlow 003C","E01021851","Total",1485,291,79,212,1194,164,118,272,248,85,100,207
"2011","Harlow 003D","E01021852","Total",1546,232,120,112,1314,119,160,407,178,74,142,234
"2011","Harlow 003E","E01021853","Total",1332,199,103,96,1133,77,158,230,202,56,120,290
"2011","Harlow 004A","E01021839","Total",1513,194,79,115,1319,102,168,246,204,103,148,348
"2011","Harlow 004B","E01021840","Total",1441,199,71,128,1242,122,124,304,216,58,133,285
"2011","Harlow 004C","E01021841","Total",1379,124,63,61,1255,117,124,338,174,68,126,308
"2011","Harlow 004D","E01021842","Total",1529,195,69,126,1334,136,118,366,186,101,144,283
"2011","Harlow 004E","E01021843","Total",2023,337,75,262,1686,122,144,460,410,98,164,288
"2011","Harlow 005A","E01021824","Total",1732,117,35,82,1615,102,114,676,246,146,139,192
"2011","Harlow 005B","E01021825","Total",1618,151,27,124,1467,113,98,564,294,115,163,120
"2011","Harlow 005C","E01021826","Total",1602,149,30,119,1453,81,144,525,268,101,106,228
"2011","Harlow 005D","E01021827","Total",1616,218,52,166,1398,115,104,463,312,87,123,194
"2011","Harlow 005E","E01021828","Total",2315,173,39,134,2142,160,94,860,384,158,269,217
"2011","Harlow 006A","E01021819","Total",1546,189,82,107,1357,109,162,284,208,100,168,326
"2011","Harlow 006B","E01021820","Total",1495,187,112,75,1308,131,162,267,254,89,176,229
"2011","Harlow 006C","E01021822","Total",1561,165,81,84,1396,140,160,345,208,113,175,255
"2011","Harlow 006D","E01021823","Total",1712,264,89,175,1448,182,166,374,214,154,110,248
"2011","Harlow 006E","E01021870","Total",1308,197,87,110,1111,84,168,218,178,95,142,226
"2011","Harlow 007A","E01021831","Total",1426,228,121,107,1198,100,194,257,184,87,143,233
"2011","Harlow 007B","E01021868","Total",1595,207,117,90,1388,112,162,354,202,83,127,348
"2011","Harlow 007C","E01021869","Total",1351,140,72,68,1211,83,178,224,216,97,167,246
"2011","Harlow 007D","E01021871","Total",1390,236,93,143,1154,122,142,294,166,71,130,229
"2011","Harlow 007E","E01021872","Total",1815,340,86,254,1475,167,68,435,272,113,145,275
"2011","Harlow 008A","E01021821","Total",1337,253,119,134,1084,114,142,311,196,41,78,202
"2011","Harlow 008B","E01021834","Total",1497,192,86,106,1305,135,188,302,244,85,140,211
"2011","Harlow 008C","E01021835","Total",1492,170,89,81,1322,126,158,299,202,71,220,246
"2011","Harlow 008D","E01021836","Total",1423,243,105,138,1180,124,108,297,228,89,126,208
"2011","Harlow 008E","E01021837","Total",1439,199,101,98,1240,90,174,284,248,92,83,269
"2011","Harlow 009A","E01021829","Total",1468,245,84,161,1223,94,118,283,228,87,133,280
"2011","Harlow 009B","E01021830","Total",1183,108,53,55,1075,46,200,202,188,52,122,265
"2011","Harlow 009C","E01021832","Total",1237,137,39,98,1100,59,102,267,228,36,162,246
"2011","Harlow 009D","E01021833","Total",1219,149,83,66,1070,45,152,258,184,74,91,266
"2011","Harlow 009E","E01021865","Total",1332,201,56,145,1131,73,74,269,222,101,141,251
"2011","Harlow 010A","E01021838","Total",1491,142,71,71,1349,121,214,246,190,62,127,389
"2011","Harlow 010B","E01021858","Total",1492,195,68,127,1297,142,130,330,214,85,105,291
"2011","Harlow 010C","E01021859","Total",1459,188,64,124,1271,154,104,338,208,83,145,239
"2011","Harlow 010D","E01021860","Total",1526,160,53,107,1366,146,144,241,222,177,173,263
"2011","Harlow 010E","E01021861","Total",1296,105,45,60,1191,107,128,240,162,108,186,260
"2011","Harlow 011A","E01021862","Total",1448,220,69,151,1228,121,130,307,200,91,185,194
"2011","Harlow 011B","E01021863","Total",1586,179,43,136,1407,119,120,295,198,120,241,314
"2011","Harlow 011C","E01021864","Total",1437,137,31,106,1300,133,94,260,194,75,257,287
"2011","Harlow 011D","E01021866","Total",1328,223,77,146,1105,77,70,310,260,73,102,213
"2011","Harlow 011E","E01021867","Total",1416,138,67,71,1278,46,174,224,258,61,167,348
"2011","Maldon 001A","E01021908","Total",1977,231,102,129,1746,44,272,413,418,84,234,281
"2011","Maldon 001B","E01021909","Total",1301,128,66,62,1173,26,182,261,232,56,160,256
"2011","Maldon 001C","E01021910","Total",1469,188,93,95,1281,26,220,281,246,106,150,252
"2011","Maldon 001D","E01021911","Total",1197,92,54,38,1105,17,206,193,196,61,206,226
"2011","Maldon 002A","E01021882","Total",2000,182,112,70,1818,24,404,382,348,120,166,374
"2011","Maldon 002B","E01021883","Total",1636,130,57,73,1506,53,220,413,274,123,124,299
"2011","Maldon 002C","E01021912","Total",1989,174,104,70,1815,32,448,397,282,117,161,378
"2011","Maldon 002D","E01021913","Total",1500,107,65,42,1393,22,258,309,240,101,157,306
"2011","Maldon 003A","E01021884","Total",1413,167,39,128,1246,56,124,319,310,87,98,252
"2011","Maldon 003B","E01021885","Total",1130,116,49,67,1014,30,170,243,178,69,84,240
"2011","Maldon 003C","E01021886","Total",1479,146,55,91,1333,55,158,324,256,93,124,323
"2011","Maldon 003D","E01021887","Total",2191,213,83,130,1978,70,168,710,374,198,153,305
"2011","Maldon 003E","E01021888","Total",1854,278,134,144,1576,130,164,387,298,141,157,299
"2011","Maldon 004A","E01021889","Total",2162,284,152,132,1878,142,222,471,336,146,201,360
"2011","Maldon 004B","E01021890","Total",1740,397,189,208,1343,100,200,326,344,51,100,222
"2011","Maldon 004C","E01021891","Total",1396,329,203,126,1067,28,310,219,214,22,81,193
"2011","Maldon 004D","E01021892","Total",1030,185,108,77,845,80,164,160,112,49,123,157
"2011","Maldon 005A","E01021893","Total",1544,110,54,56,1434,57,202,464,228,92,153,238
"2011","Maldon 005B","E01021894","Total",1212,132,65,67,1080,68,132,316,182,46,137,199
"2011","Maldon 005C","E01021895","Total",1226,116,47,69,1110,54,138,290,180,83,92,273
"2011","Maldon 005D","E01021896","Total",1350,72,51,21,1278,31,178,313,200,73,188,295
"2011","Maldon 005E","E01021897","Total",1156,122,39,83,1034,55,154,267,164,15,88,291
"2011","Maldon 005F","E01021898","Total",1271,192,135,57,1079,25,252,239,192,73,71,227
"2011","Maldon 006A","E01021901","Total",1877,194,90,104,1683,51,340,418,314,85,166,309
"2011","Maldon 006B","E01021904","Total",1478,126,57,69,1352,66,146,337,210,160,175,258
"2011","Maldon 006C","E01021905","Total",1256,119,68,51,1137,65,160,259,180,66,167,240
"2011","Maldon 006D","E01021906","Total",1478,209,68,141,1269,65,132,341,228,82,160,261
"2011","Maldon 006E","E01021907","Total",2136,204,99,105,1932,46,308,396,412,100,228,442
"2011","Maldon 007A","E01021873","Total",1373,78,42,36,1295,34,170,262,242,90,162,335
"2011","Maldon 007B","E01021874","Total",1347,124,55,69,1223,72,138,271,196,73,155,318
"2011","Maldon 007C","E01021875","Total",1374,201,119,82,1173,19,300,191,242,61,125,235
"2011","Maldon 007D","E01021899","Total",1385,87,40,47,1298,39,126,298,260,95,202,278
"2011","Maldon 007E","E01021900","Total",1097,117,56,61,980,34,108,280,156,56,139,207
"2011","Maldon 007F","E01021902","Total",1806,97,50,47,1709,32,260,391,284,80,229,433
"2011","Maldon 007G","E01021903","Total",1608,109,67,42,1499,30,282,304,230,109,186,358
"2011","Maldon 008C","E01021878","Total",1401,185,128,57,1216,44,298,285,202,35,74,278
"2011","Maldon 008D","E01021879","Total",1366,223,96,127,1143,49,174,307,232,75,128,178
"2011","Maldon 008E","E01021880","Total",1427,363,174,189,1064,70,242,214,280,36,68,154
"2011","Maldon 008F","E01021881","Total",1164,168,70,98,996,32,182,299,170,34,84,195
"2011","Maldon 008G","E01033057","Total",2301,228,116,112,2073,85,352,491,376,103,248,418
"2011","Rochford 001A","E01021942","Total",1575,332,209,123,1243,39,424,171,260,32,109,208
"2011","Rochford 001B","E01021943","Total",1754,139,96,43,1615,44,290,273,302,67,222,417
"2011","Rochford 001C","E01021944","Total",1632,109,69,40,1523,39,252,320,240,64,202,406
"2011","Rochford 001D","E01021945","Total",1562,121,77,44,1441,25,282,226,232,62,223,391
"2011","Rochford 002A","E01021914","Total",2085,155,89,66,1930,38,324,450,268,115,325,410
"2011","Rochford 002B","E01021927","Total",1353,71,37,34,1282,19,184,270,178,95,163,373
"2011","Rochford 002C","E01021928","Total",1535,202,132,70,1333,20,206,302,254,36,193,322
"2011","Rochford 002D","E01021929","Total",1640,87,48,39,1553,50,166,358,202,125,298,354
"2011","Rochford 002E","E01021931","Total",1332,154,105,49,1178,31,292,213,190,61,131,260
"2011","Rochford 003A","E01021933","Total",1365,94,55,39,1271,34,196,287,160,97,164,333
"2011","Rochford 003B","E01021934","Total",1416,86,53,33,1330,33,224,303,168,92,184,326
"2011","Rochford 003C","E01021935","Total",1353,97,62,35,1256,28,240,279,196,67,169,277
"2011","Rochford 003D","E01021936","Total",1697,283,198,85,1414,33,310,307,216,76,158,314
"2011","Rochford 003E","E01021937","Total",1648,197,87,110,1451,89,210,362,250,98,171,271
"2011","Rochford 003F","E01021938","Total",1495,176,114,62,1319,33,310,272,162,67,153,322
"2011","Rochford 003G","E01021939","Total",1686,150,100,50,1536,16,274,399,216,63,160,408
"2011","Rochford 003H","E01021940","Total",2120,120,75,45,2000,41,318,533,280,133,203,492
"2011","Rochford 003I","E01021941","Total",2096,126,66,60,1970,39,300,429,278,130,284,510
"2011","Rochford 004A","E01021915","Total",1272,106,43,63,1166,46,160,242,252,107,135,224
"2011","Rochford 004B","E01021916","Total",1072,103,62,41,969,48,134,225,124,103,151,184
"2011","Rochford 004C","E01021953","Total",1483,129,48,81,1354,190,102,320,142,94,246,260
"2011","Rochford 004D","E01021955","Total",1822,363,192,171,1459,163,166,368,310,94,183,175
"2011","Rochford 005A","E01021918","Total",1521,91,40,51,1430,24,174,481,232,92,111,316
"2011","Rochford 005B","E01021919","Total",1296,116,72,44,1180,27,214,231,174,86,123,325
"2011","Rochford 005C","E01021925","Total",1637,157,100,57,1480,34,216,368,252,84,191,335
"2011","Rochford 005D","E01021960","Total",1961,138,87,51,1823,17,360,419,248,123,254,402
"2011","Rochford 005E","E01021961","Total",1494,149,99,50,1345,60,322,262,218,71,139,273
"2011","Rochford 006A","E01021920","Total",2003,132,48,84,1871,60,154,564,308,129,216,440
"2011","Rochford 006B","E01021926","Total",2102,220,108,112,1882,71,208,702,364,143,144,250
"2011","Rochford 006C","E01021957","Total",1457,184,87,97,1273,92,140,278,250,112,104,297
"2011","Rochford 006D","E01021958","Total",1243,127,37,90,1116,43,92,408,268,56,66,183
"2011","Rochford 006E","E01021959","Total",1701,126,55,71,1575,62,132,475,280,145,227,254
"2011","Rochford 007A","E01021930","Total",1375,277,72,205,1098,46,138,270,264,64,113,203
"2011","Rochford 007B","E01021932","Total",1535,158,88,70,1377,63,236,283,232,105,183,275
"2011","Rochford 007C","E01021952","Total",1394,162,93,69,1232,64,200,324,240,56,80,268
"2011","Rochford 007D","E01021954","Total",1506,167,95,72,1339,60,138,348,216,95,181,301
"2011","Rochford 007E","E01021956","Total",1441,180,94,86,1261,77,172,284,244,40,146,298
"2011","Rochford 008A","E01021950","Total",1465,146,92,54,1319,39,198,293,212,72,174,331
"2011","Rochford 008B","E01021951","Total",1272,121,89,32,1151,38,190,281,172,75,143,252
"2011","Rochford 008C","E01021962","Total",1214,135,96,39,1079,99,166,245,176,38,90,265
"2011","Rochford 008D","E01021963","Total",1343,100,64,36,1243,35,204,281,204,91,163,265
"2011","Rochford 008E","E01021964","Total",1572,188,120,68,1384,29,224,380,228,65,133,325
"2011","Rochford 008F","E01021966","Total",1755,300,203,97,1455,65,230,316,214,86,202,342
"2011","Rochford 009A","E01021946","Total",1547,62,43,19,1485,22,232,310,202,77,197,445
"2011","Rochford 009B","E01021947","Total",1197,111,73,38,1086,22,228,265,168,37,111,255
"2011","Rochford 009C","E01021948","Total",1335,109,56,53,1226,50,164,302,210,90,155,255
"2011","Rochford 009D","E01021949","Total",1518,140,95,45,1378,26,254,295,176,82,172,373
"2011","Rochford 009E","E01021965","Total",2293,235,154,81,2058,66,422,504,322,77,236,431
"2011","Rochford 010A","E01021917","Total",1828,156,80,76,1672,64,212,362,254,126,303,351
"2011","Rochford 010B","E01021921","Total",1501,114,39,75,1387,63,164,351,272,67,154,316
"2011","Rochford 010C","E01021922","Total",1591,221,146,75,1370,92,204,233,174,138,255,274
"2011","Rochford 010D","E01021923","Total",1364,89,49,40,1275,51,174,295,216,72,176,291
"2011","Rochford 010E","E01021924","Total",1282,101,53,48,1181,42,148,249,204,56,193,289
"2011","Tendring 001A","E01021997","Total",1323,317,107,210,1006,96,118,185,176,87,162,182
"2011","Tendring 001B","E01021998","Total",1353,248,84,164,1105,106,154,213,196,100,116,220
"2011","Tendring 001C","E01021999","Total",1662,269,144,125,1393,123,196,299,246,103,170,256
"2011","Tendring 001D","E01022001","Total",1642,373,127,246,1269,160,146,304,258,67,139,195
"2011","Tendring 002A","E01022000","Total",1631,147,79,68,1484,90,250,377,206,154,156,251
"2011","Tendring 002C","E01022006","Total",1618,259,153,106,1359,135,210,272,236,118,180,208
"2011","Tendring 002D","E01022007","Total",1690,150,66,84,1540,116,142,283,272,201,204,322
"2011","Tendring 002F","E01033051","Total",2373,383,211,172,1990,187,364,385,332,161,185,376
"2011","Tendring 003A","E01021978","Total",2212,196,124,72,2016,58,346,434,398,134,196,450
"2011","Tendring 003B","E01022013","Total",1554,152,75,77,1402,49,266,262,260,62,198,305
"2011","Tendring 003C","E01022014","Total",1359,165,94,71,1194,67,226,226,182,62,144,287
"2011","Tendring 003D","E01022015","Total",1389,197,79,118,1192,80,126,353,248,15,115,255
"2011","Tendring 003E","E01022019","Total",1360,141,64,77,1219,37,218,257,206,55,147,299
"2011","Tendring 003F","E01022020","Total",1740,390,182,208,1350,73,210,324,400,101,68,174
"2011","Tendring 003G","E01022021","Total",1371,198,75,123,1173,74,168,258,222,108,109,234
"2011","Tendring 004A","E01021991","Total",1011,90,47,43,921,30,196,171,146,58,86,234
"2011","Tendring 004B","E01021992","Total",1158,111,56,55,1047,45,154,271,180,54,111,232
"2011","Tendring 004C","E01022002","Total",1908,172,108,64,1736,98,356,423,280,111,199,269
"2011","Tendring 004D","E01022004","Total",1625,217,131,86,1408,88,344,288,256,55,133,244
"2011","Tendring 004E","E01022005","Total",1705,211,135,76,1494,90,322,295,260,94,136,297
"2011","Tendring 004F","E01022028","Total",1347,121,62,59,1226,73,200,207,232,104,173,237
"2011","Tendring 005A","E01021971","Total",1034,88,40,48,946,27,152,167,170,48,137,245
"2011","Tendring 005B","E01021972","Total",1253,111,52,59,1142,27,140,266,200,87,159,263
"2011","Tendring 005C","E01022051","Total",1390,123,72,51,1267,51,228,234,254,89,136,275
"2011","Tendring 005D","E01022052","Total",1426,157,87,70,1269,54,236,274,212,90,152,251
"2011","Tendring 006A","E01021985","Total",1314,240,169,71,1074,35,352,179,214,54,101,139
"2011","Tendring 006B","E01021986","Total",1382,319,228,91,1063,55,346,151,166,30,130,185
"2011","Tendring 006C","E01022054","Total",1380,192,119,73,1188,99,312,170,192,54,170,191
"2011","Tendring 006D","E01022055","Total",1253,247,180,67,1006,52,342,154,196,64,77,121
"2011","Tendring 006E","E01022056","Total",1583,319,155,164,1264,120,212,227,234,49,205,217
"2011","Tendring 007A","E01021973","Total",1139,101,66,35,1038,41,212,213,180,73,119,200
"2011","Tendring 007B","E01021974","Total",1145,113,47,66,1032,39,162,205,228,53,142,203
"2011","Tendring 007C","E01022016","Total",1726,308,178,130,1418,53,438,196,228,73,183,247
"2011","Tendring 007D","E01022017","Total",1398,137,62,75,1261,61,244,246,184,73,148,305
"2011","Tendring 007E","E01022018","Total",1402,193,119,74,1209,71,268,201,204,94,147,224
"2011","Tendring 008A","E01021987","Total",1225,202,149,53,1023,56,340,129,156,47,127,168
"2011","Tendring 008B","E01021994","Total",1130,253,205,48,877,27,342,113,150,33,44,168
"2011","Tendring 008C","E01021995","Total",1369,195,157,38,1174,50,374,210,156,55,85,244
"2011","Tendring 008D","E01021996","Total",1298,211,153,58,1087,72,298,242,170,30,145,130
"2011","Tendring 008E","E01022009","Total",1359,203,121,82,1156,38,332,173,228,55,116,214
"2011","Tendring 008F","E01022010","Total",1543,195,117,78,1348,69,392,225,224,79,108,251
"2011","Tendring 008G","E01022011","Total",1791,201,122,79,1590,75,290,269,258,129,248,321
"2011","Tendring 008H","E01022012","Total",1859,394,314,80,1465,101,648,173,214,26,90,213
"2011","Tendring 009A","E01021967","Total",1993,193,117,76,1800,60,360,383,302,113,196,386
"2011","Tendring 009B","E01021983","Total",1335,160,88,72,1175,47,296,195,260,36,118,223
"2011","Tendring 009C","E01021993","Total",2223,246,144,102,1977,103,374,416,362,120,247,355
"2011","Tendring 009D","E01022053","Total",1708,154,85,69,1554,26,284,338,334,102,186,284
"2011","Tendring 010A","E01021984","Total",2027,327,239,88,1700,65,574,236,332,74,133,286
"2011","Tendring 010B","E01022039","Total",1478,216,119,97,1262,115,226,272,184,66,138,261
"2011","Tendring 010C","E01022040","Total",1727,251,181,70,1476,79,452,236,240,69,122,278
"2011","Tendring 010D","E01022041","Total",1451,243,163,80,1208,75,364,170,210,26,128,235
"2011","Tendring 011A","E01021979","Total",1484,170,106,64,1314,71,256,321,172,59,184,251
"2011","Tendring 011B","E01021980","Total",1707,237,150,87,1470,54,318,267,276,112,133,310
"2011","Tendring 011C","E01021981","Total",1679,307,160,147,1372,74,258,303,238,81,177,241
"2011","Tendring 011D","E01021982","Total",1784,296,96,200,1488,196,162,315,318,132,110,255
"2011","Tendring 011E","E01022046","Total",1550,210,124,86,1340,79,336,143,180,46,261,295
"2011","Tendring 012A","E01022008","Total",2023,329,256,73,1694,56,652,256,270,82,96,282
"2011","Tendring 012B","E01022033","Total",1413,248,188,60,1165,22,478,111,230,32,90,202
"2011","Tendring 012C","E01022034","Total",1488,280,204,76,1208,78,428,140,234,11,106,211
"2011","Tendring 012D","E01022035","Total",1461,214,156,58,1247,77,412,112,214,36,148,248
"2011","Tendring 013A","E01021975","Total",1484,193,109,84,1291,111,258,262,180,74,201,205
"2011","Tendring 013B","E01021976","Total",1386,188,115,73,1198,50,224,264,198,58,150,254
"2011","Tendring 013C","E01021977","Total",1657,203,131,72,1454,111,296,251,206,102,177,311
"2011","Tendring 013D","E01022022","Total",1479,175,74,101,1304,75,156,299,192,174,152,256
"2011","Tendring 013E","E01022044","Total",1624,234,137,97,1390,52,354,215,218,97,187,267
"2011","Tendring 014A","E01022042","Total",1486,260,142,118,1226,144,220,263,196,66,197,140
"2011","Tendring 014B","E01022043","Total",1898,224,72,152,1674,238,142,329,224,124,296,321
"2011","Tendring 014C","E01022048","Total",1420,268,155,113,1152,47,334,204,208,58,100,201
"2011","Tendring 014D","E01022049","Total",1434,177,100,77,1257,88,244,223,190,70,191,251
"2011","Tendring 014E","E01022050","Total",1655,345,228,117,1310,128,410,182,236,48,81,225
"2011","Tendring 015A","E01022023","Total",1459,211,93,118,1248,140,178,183,220,104,211,212
"2011","Tendring 015B","E01022024","Total",1498,208,130,78,1290,156,174,252,202,85,167,254
"2011","Tendring 015C","E01022030","Total",1630,277,162,115,1353,128,344,201,174,72,205,229
"2011","Tendring 015D","E01022031","Total",1364,185,58,127,1179,233,90,297,154,110,109,186
"2011","Tendring 015E","E01022032","Total",1793,196,114,82,1597,177,288,298,158,177,239,260
"2011","Tendring 016A","E01021970","Total",1626,401,188,213,1225,141,174,274,178,114,145,199
"2011","Tendring 016B","E01022025","Total",1341,466,201,265,875,81,164,141,162,50,117,160
"2011","Tendring 016C","E01022026","Total",1493,244,79,165,1249,142,88,251,164,131,240,233
"2011","Tendring 016D","E01022027","Total",1531,371,154,217,1160,92,178,209,236,84,148,213
"2011","Tendring 017A","E01021968","Total",1776,225,93,132,1551,191,144,367,172,81,288,308
"2011","Tendring 017B","E01021969","Total",1426,165,88,77,1261,152,118,233,232,125,167,234
"2011","Tendring 017C","E01022036","Total",1237,176,87,89,1061,54,262,158,198,64,125,200
"2011","Tendring 017D","E01022037","Total",1293,242,165,77,1051,43,306,130,136,34,155,247
"2011","Tendring 017E","E01022038","Total",1467,177,113,64,1290,92,304,181,164,91,177,281
"2011","Tendring 018A","E01021988","Total",1739,589,187,402,1150,163,190,155,294,96,92,160
"2011","Tendring 018B","E01021989","Total",1451,262,188,74,1189,26,526,106,226,41,92,172
"2011","Tendring 018C","E01021990","Total",1563,344,216,128,1219,68,414,148,278,38,68,205
"2011","Tendring 018D","E01022045","Total",1426,262,155,107,1164,89,288,180,184,106,137,180
"2011","Tendring 018E","E01022047","Total",1270,187,115,72,1083,62,232,195,186,65,106,237
"2011","Uttlesford 001A","E01022057","Total",1734,136,70,66,1598,43,238,401,254,147,212,303
"2011","Uttlesford 001B","E01022075","Total",1792,184,88,96,1608,31,262,428,226,155,240,266
"2011","Uttlesford 001C","E01022077","Total",1563,147,73,74,1416,63,186,344,268,84,179,292
"2011","Uttlesford 001D","E01022094","Total",1708,172,89,83,1536,12,208,461,250,187,168,250
"2011","Uttlesford 002A","E01022074","Total",1509,129,64,65,1380,48,202,315,180,168,205,262
"2011","Uttlesford 002B","E01022076","Total",1682,474,294,180,1208,43,274,272,316,78,63,162
"2011","Uttlesford 002C","E01022078","Total",1526,166,83,83,1360,98,146,321,240,123,166,266
"2011","Uttlesford 002D","E01022079","Total",1679,246,114,132,1433,67,188,379,290,87,152,270
"2011","Uttlesford 002E","E01022080","Total",1584,163,35,128,1421,79,68,355,288,76,150,405
"2011","Uttlesford 002F","E01022081","Total",2245,290,182,108,1955,108,260,574,362,155,192,304
"2011","Uttlesford 002G","E01022082","Total",1705,126,54,72,1579,52,162,439,328,66,167,365
"2011","Uttlesford 003A","E01022061","Total",1461,96,61,35,1365,29,262,317,216,100,183,258
"2011","Uttlesford 003B","E01022071","Total",1707,131,63,68,1576,24,224,390,252,196,201,289
"2011","Uttlesford 003C","E01022072","Total",1883,146,69,77,1737,32,268,461,292,164,237,283
"2011","Uttlesford 003D","E01022073","Total",1557,142,88,54,1415,45,184,367,238,68,194,319
"2011","Uttlesford 003E","E01022098","Total",1520,123,63,60,1397,8,224,356,274,114,162,259
"2011","Uttlesford 004A","E01022092","Total",1749,186,77,109,1563,30,274,375,260,137,199,288
"2011","Uttlesford 004B","E01022093","Total",1716,196,137,59,1520,88,224,348,266,144,178,272
"2011","Uttlesford 004C","E01022097","Total",1900,131,75,56,1769,33,300,382,216,227,226,385
"2011","Uttlesford 004D","E01022099","Total",2163,115,58,57,2048,36,228,672,362,249,224,277
"2011","Uttlesford 005A","E01022062","Total",2089,135,61,74,1954,50,258,469,330,188,239,420
"2011","Uttlesford 005B","E01022063","Total",1586,123,68,55,1463,63,178,307,294,112,173,336
"2011","Uttlesford 005C","E01022083","Total",1629,163,75,88,1466,23,250,335,298,87,183,290
"2011","Uttlesford 005D","E01022084","Total",1608,102,66,36,1506,31,226,352,228,140,167,362
"2011","Uttlesford 005E","E01022085","Total",1570,208,67,141,1362,45,116,382,358,76,126,259
"2011","Uttlesford 005F","E01022087","Total",1777,147,52,95,1630,63,146,535,364,76,141,305
"2011","Uttlesford 005G","E01022089","Total",1552,107,49,58,1445,40,206,369,276,156,141,257
"2011","Uttlesford 006A","E01022086","Total",1346,134,55,79,1212,81,104,257,200,141,127,302
"2011","Uttlesford 006B","E01022090","Total",2362,215,84,131,2147,84,182,642,392,198,236,413
"2011","Uttlesford 006C","E01022091","Total",2349,165,61,104,2184,124,312,556,382,130,277,403
"2011","Uttlesford 006D","E01022095","Total",1560,101,48,53,1459,36,224,389,274,75,194,267
"2011","Uttlesford 007B","E01022067","Total",1755,442,188,254,1313,64,142,371,370,46,108,212
"2011","Uttlesford 007C","E01022068","Total",1588,132,66,66,1456,55,192,442,216,94,206,251
"2011","Uttlesford 007D","E01033054","Total",1087,144,50,94,943,103,88,279,172,94,78,129
"2011","Uttlesford 007E","E01033055","Total",1462,96,33,63,1366,46,144,491,206,82,186,211
"2011","Uttlesford 007F","E01033056","Total",1327,124,68,56,1203,46,194,283,140,100,172,268
"2011","Uttlesford 008A","E01022058","Total",1701,98,54,44,1603,24,220,402,270,113,246,328
"2011","Uttlesford 008B","E01022064","Total",1742,130,82,48,1612,39,292,364,240,125,202,350
"2011","Uttlesford 008D","E01022069","Total",1493,192,115,77,1301,27,286,310,246,67,164,201
"2011","Uttlesford 008E","E01022088","Total",1560,113,70,43,1447,31,230,296,266,105,174,345
"2011","Uttlesford 008F","E01033052","Total",1585,143,80,63,1442,50,226,401,196,117,200,252
"2011","Uttlesford 008G","E01033053","Total",1882,81,12,69,1801,82,42,828,238,242,176,193
"2011","Uttlesford 009A","E01022059","Total",1614,149,78,71,1465,34,208,336,196,159,186,346
"2011","Uttlesford 009B","E01022060","Total",1946,110,73,37,1836,23,260,400,252,160,299,442
"2011","Uttlesford 009C","E01022070","Total",1907,163,98,65,1744,46,248,459,184,192,254,361
"2011","Uttlesford 009D","E01022096","Total",1835,156,83,73,1679,45,220,457,332,120,201,304
"2011","Broxbourne 001A","E01023316","Total",1446,76,43,33,1370,30,192,342,132,96,161,417
"2011","Broxbourne 001B","E01023317","Total",2473,157,59,98,2316,163,220,639,298,238,269,489
"2011","Broxbourne 001C","E01023318","Total",1612,85,40,45,1527,67,226,366,190,82,168,428
"2011","Broxbourne 001D","E01023319","Total",1576,133,92,41,1443,20,300,273,208,91,163,388
"2011","Broxbourne 002A","E01023327","Total",1440,129,48,81,1311,107,160,326,158,120,196,244
"2011","Broxbourne 002B","E01023328","Total",1379,127,54,73,1252,76,102,336,142,62,224,310
"2011","Broxbourne 002C","E01023329","Total",1311,110,63,47,1201,58,154,290,150,101,140,308
"2011","Broxbourne 002D","E01023330","Total",1507,161,45,116,1346,145,102,405,226,84,154,230
"2011","Broxbourne 002E","E01023331","Total",1549,136,64,72,1413,80,166,380,216,72,239,260
"2011","Broxbourne 003A","E01023320","Total",1921,434,177,257,1487,123,220,367,340,82,114,241
"2011","Broxbourne 003B","E01023321","Total",1950,242,160,82,1708,51,300,417,282,107,144,407
"2011","Broxbourne 003C","E01023322","Total",1763,228,73,155,1535,115,138,442,262,83,190,305
"2011","Broxbourne 003D","E01023323","Total",1583,375,128,247,1208,90,140,291,232,86,123,246
"2011","Broxbourne 004A","E01023289","Total",1531,66,49,17,1465,9,172,418,166,136,187,377
"2011","Broxbourne 004B","E01023290","Total",1658,128,76,52,1530,22,294,396,172,122,177,347
"2011","Broxbourne 004C","E01023291","Total",1517,146,86,60,1371,24,242,274,200,86,173,372
"2011","Broxbourne 004D","E01023292","Total",1497,185,98,87,1312,55,178,317,218,47,147,350
"2011","Broxbourne 005A","E01023340","Total",1736,219,61,158,1517,135,142,369,238,101,193,339
"2011","Broxbourne 005B","E01023341","Total",1780,186,96,90,1594,43,220,366,250,113,204,398
"2011","Broxbourne 005C","E01023342","Total",2594,297,72,225,2297,336,166,685,446,94,251,319
"2011","Broxbourne 005D","E01023343","Total",1839,196,40,156,1643,294,82,451,218,109,195,294
"2011","Broxbourne 005E","E01023344","Total",1725,240,107,133,1485,95,174,435,294,61,121,305
"2011","Broxbourne 006A","E01023307","Total",1575,73,40,33,1502,48,166,353,184,113,254,384
"2011","Broxbourne 006B","E01023308","Total",1703,111,62,49,1592,35,210,370,220,73,256,428
"2011","Broxbourne 006C","E01023309","Total",1713,95,58,37,1618,25,220,360,216,69,246,482
"2011","Broxbourne 006D","E01023310","Total",2201,258,110,148,1943,333,120,492,244,111,316,327
"2011","Broxbourne 007A","E01023311","Total",1655,138,74,64,1517,59,256,295,192,67,174,474
"2011","Broxbourne 007B","E01023312","Total",1680,97,29,68,1583,35,104,367,202,106,291,478
"2011","Broxbourne 007C","E01023313","Total",1640,128,102,26,1512,20,316,318,162,67,221,408
"2011","Broxbourne 007D","E01023315","Total",1861,84,20,64,1777,75,58,621,248,150,271,354
"2011","Broxbourne 008A","E01023302","Total",1488,268,174,94,1220,90,174,233,170,87,137,329
"2011","Broxbourne 008B","E01023303","Total",1560,161,52,109,1399,110,122,318,230,84,239,296
"2011","Broxbourne 008C","E01023304","Total",1549,167,97,70,1382,89,204,357,198,42,174,318
"2011","Broxbourne 008D","E01023305","Total",1382,103,43,60,1279,71,114,328,160,103,230,273
"2011","Broxbourne 008E","E01023306","Total",1467,173,68,105,1294,60,176,281,222,56,150,349
"2011","Broxbourne 009A","E01023314","Total",1336,113,46,67,1223,56,132,262,178,53,185,357
"2011","Broxbourne 009B","E01023324","Total",1365,112,52,60,1253,34,138,279,184,131,164,323
"2011","Broxbourne 009C","E01023325","Total",1421,209,88,121,1212,66,124,370,222,61,97,272
"2011","Broxbourne 009D","E01023326","Total",1627,199,70,129,1428,120,184,334,164,102,221,303
"2011","Broxbourne 010A","E01023297","Total",1364,103,63,40,1261,49,146,278,178,120,170,320
"2011","Broxbourne 010B","E01023298","Total",1546,168,113,55,1378,72,272,327,160,67,145,335
"2011","Broxbourne 010C","E01023299","Total",1688,158,66,92,1530,54,244,371,200,161,153,347
"2011","Broxbourne 010D","E01023300","Total",1408,248,126,122,1160,106,130,251,198,102,179,194
"2011","Broxbourne 010E","E01023301","Total",1606,219,69,150,1387,129,118,395,200,80,158,307
"2011","Broxbourne 011A","E01023293","Total",1728,142,75,67,1586,80,248,422,180,125,189,342
"2011","Broxbourne 011B","E01023294","Total",1498,289,165,124,1209,135,158,280,188,70,115,263
"2011","Broxbourne 011C","E01023295","Total",1419,145,82,63,1274,67,158,266,172,49,214,348
"2011","Broxbourne 011D","E01023296","Total",1660,149,86,63,1511,79,176,352,184,110,205,405
"2011","Broxbourne 012A","E01023332","Total",2067,267,167,100,1800,139,298,439,256,103,202,363
"2011","Broxbourne 012B","E01023333","Total",1844,238,88,150,1606,154,160,401,286,73,223,309
"2011","Broxbourne 012C","E01023334","Total",1699,172,103,69,1527,42,284,308,218,83,232,360
"2011","Broxbourne 012D","E01023335","Total",1723,139,92,47,1584,35,234,359,174,58,284,440
"2011","Broxbourne 013A","E01023336","Total",2022,241,66,175,1781,160,120,363,314,123,337,364
"2011","Broxbourne 013B","E01023337","Total",1675,165,60,105,1510,134,154,268,198,84,272,400
"2011","Broxbourne 013C","E01023338","Total",2201,514,167,347,1687,301,124,446,318,105,197,196
"2011","Broxbourne 013D","E01023339","Total",1509,168,80,88,1341,156,92,295,168,59,221,350
"2011","Dacorum 001A","E01023430","Total",1177,127,60,67,1050,34,160,269,202,96,111,178
"2011","Dacorum 001B","E01023431","Total",1234,112,49,63,1122,31,156,259,238,101,101,236
"2011","Dacorum 001C","E01023432","Total",1448,136,53,83,1312,56,160,418,240,80,104,254
"2011","Dacorum 001D","E01023433","Total",1464,240,83,157,1224,87,98,382,310,47,100,200
"2011","Dacorum 002A","E01023423","Total",1342,136,86,50,1206,39,178,342,218,87,128,214
"2011","Dacorum 002B","E01023424","Total",1390,153,55,98,1237,30,142,393,224,77,181,190
"2011","Dacorum 002C","E01023425","Total",1337,119,57,62,1218,35,170,362,176,101,110,264
"2011","Dacorum 002D","E01023426","Total",1364,324,103,221,1040,83,108,287,308,27,83,144
"2011","Dacorum 003A","E01023418","Total",1409,231,132,99,1178,73,130,300,220,94,130,231
"2011","Dacorum 003B","E01023419","Total",2112,222,62,160,1890,66,130,552,352,215,224,351
"2011","Dacorum 003C","E01023420","Total",1551,140,72,68,1411,50,238,323,202,141,177,280
"2011","Dacorum 004A","E01023352","Total",2439,257,111,146,2182,46,364,572,414,224,199,363
"2011","Dacorum 004B","E01023421","Total",1478,194,75,119,1284,49,190,374,236,71,141,223
"2011","Dacorum 004C","E01023422","Total",1270,84,51,33,1186,12,218,317,158,89,112,280
"2011","Dacorum 005A","E01023434","Total",1533,198,33,165,1335,81,106,353,324,82,163,226
"2011","Dacorum 005B","E01023435","Total",1493,242,20,222,1251,96,42,349,380,52,118,214
"2011","Dacorum 005C","E01023436","Total",1208,103,26,77,1105,36,112,247,244,84,114,268
"2011","Dacorum 005D","E01023437","Total",1531,240,25,215,1291,207,46,357,268,83,138,192
"2011","Dacorum 006A","E01023355","Total",1537,134,74,60,1403,20,254,335,256,118,168,252
"2011","Dacorum 006B","E01023356","Total",1107,116,59,57,991,24,216,217,140,93,124,177
"2011","Dacorum 006C","E01023416","Total",1454,200,116,84,1254,23,264,330,240,97,77,223
"2011","Dacorum 006D","E01023417","Total",1359,273,169,104,1086,56,190,353,198,88,67,134
"2011","Dacorum 007A","E01023393","Total",1669,444,151,293,1225,97,138,295,284,86,92,233
"2011","Dacorum 007B","E01023394","Total",1376,88,21,67,1288,110,108,232,218,90,196,334
"2011","Dacorum 007C","E01023395","Total",1616,162,40,122,1454,150,90,274,254,175,213,298
"2011","Dacorum 007D","E01023396","Total",1559,106,33,73,1453,86,122,288,300,131,155,371
"2011","Dacorum 007E","E01023397","Total",1338,134,45,89,1204,145,58,262,176,96,152,315
"2011","Dacorum 008A","E01023401","Total",1742,205,51,154,1537,168,88,421,288,93,191,288
"2011","Dacorum 008B","E01023402","Total",1618,192,79,113,1426,81,168,352,198,98,237,292
"2011","Dacorum 008C","E01023403","Total",1446,252,129,123,1194,103,162,285,198,68,107,271
"2011","Dacorum 008D","E01023404","Total",1315,160,62,98,1155,191,48,233,176,105,155,247
"2011","Dacorum 008E","E01023405","Total",1504,204,86,118,1300,148,132,308,166,136,186,224
"2011","Dacorum 009A","E01023361","Total",1662,435,135,300,1227,76,126,345,490,55,32,103
"2011","Dacorum 009B","E01023362","Total",1734,257,146,111,1477,33,278,425,306,66,128,241
"2011","Dacorum 009C","E01023363","Total",1553,153,45,108,1400,48,154,523,240,116,97,222
"2011","Dacorum 009D","E01023364","Total",1294,97,56,41,1197,9,218,397,184,69,107,213
"2011","Dacorum 010A","E01023390","Total",2026,276,106,170,1750,127,202,495,298,116,184,328
"2011","Dacorum 010B","E01023391","Total",1702,180,82,98,1522,87,144,508,262,80,200,241
"2011","Dacorum 010C","E01023399","Total",1595,402,145,257,1193,75,172,312,324,45,108,157
"2011","Dacorum 011A","E01023392","Total",1562,145,76,69,1417,124,158,333,256,118,143,285
"2011","Dacorum 011B","E01023427","Total",1673,161,77,84,1512,141,138,414,200,65,228,326
"2011","Dacorum 011C","E01023428","Total",1477,171,41,130,1306,40,140,364,288,42,207,225
"2011","Dacorum 011D","E01023429","Total",1801,287,177,110,1514,104,216,346,226,109,179,334
"2011","Dacorum 012A","E01023369","Total",1462,196,123,73,1266,116,178,381,160,94,116,221
"2011","Dacorum 012B","E01023370","Total",1645,245,76,169,1400,97,92,537,284,73,110,207
"2011","Dacorum 012C","E01023371","Total",1509,65,31,34,1444,43,158,473,156,131,184,299
"2011","Dacorum 012D","E01023372","Total",1426,84,57,27,1342,8,238,404,198,103,162,229
"2011","Dacorum 013A","E01023345","Total",1557,174,61,113,1383,91,148,326,266,60,183,309
"2011","Dacorum 013B","E01023346","Total",1309,147,69,78,1162,109,150,279,162,119,98,245
"2011","Dacorum 013C","E01023347","Total",1271,130,77,53,1141,35,200,194,178,106,140,288
"2011","Dacorum 013D","E01023348","Total",1542,265,135,130,1277,142,124,294,184,136,162,235
"2011","Dacorum 014A","E01023365","Total",1247,188,66,122,1059,38,108,294,274,64,95,186
"2011","Dacorum 014B","E01023366","Total",1499,194,58,136,1305,99,120,395,258,81,104,248
"2011","Dacorum 014C","E01023367","Total",1117,45,29,16,1072,24,202,370,114,86,95,181
"2011","Dacorum 014D","E01023368","Total",1716,157,82,75,1559,80,144,516,294,170,151,204
"2011","Dacorum 015A","E01023349","Total",1939,236,113,123,1703,149,172,413,228,153,266,322
"2011","Dacorum 015B","E01023350","Total",1629,180,113,67,1449,115,156,350,250,103,154,321
"2011","Dacorum 015C","E01023351","Total",1589,177,83,94,1412,86,180,378,240,114,151,263
"2011","Dacorum 015D","E01023398","Total",2400,367,66,301,2033,123,144,552,504,143,195,372
"2011","Dacorum 015E","E01023400","Total",1681,408,153,255,1273,88,166,245,342,82,143,207
"2011","Dacorum 016A","E01023383","Total",1497,156,58,98,1341,68,150,328,204,96,199,296
"2011","Dacorum 016B","E01023384","Total",1910,217,100,117,1693,132,168,452,268,119,187,367
"2011","Dacorum 016C","E01023385","Total",1661,209,131,78,1452,31,198,253,210,83,278,399
"2011","Dacorum 017A","E01023409","Total",1496,212,101,111,1284,50,182,312,178,77,211,274
"2011","Dacorum 017B","E01023410","Total",1352,94,81,13,1258,17,318,249,160,41,143,330
"2011","Dacorum 017C","E01023411","Total",1493,136,70,66,1357,118,170,346,200,113,136,274
"2011","Dacorum 017D","E01023412","Total",1270,78,62,16,1192,16,272,185,174,68,140,337
"2011","Dacorum 017E","E01023413","Total",1344,121,30,91,1223,125,104,325,234,80,117,238
"2011","Dacorum 018B","E01023354","Total",1683,152,49,103,1531,77,188,412,342,76,143,293
"2011","Dacorum 018C","E01023379","Total",1601,183,92,91,1418,39,192,434,268,58,163,264
"2011","Dacorum 018D","E01023380","Total",1148,121,36,85,1027,58,114,289,222,46,88,210
"2011","Dacorum 018E","E01023381","Total",1325,96,70,26,1229,18,204,287,180,79,145,316
"2011","Dacorum 018F","E01023382","Total",1488,260,118,142,1228,83,122,386,228,76,142,191
"2011","Dacorum 018G","E01033022","Total",1310,253,19,234,1057,65,36,272,456,33,85,110
"2011","Dacorum 018H","E01033023","Total",1469,304,90,214,1165,78,98,311,360,62,79,177
"2011","Dacorum 019A","E01023386","Total",1522,160,65,95,1362,96,120,298,248,90,179,331
"2011","Dacorum 019B","E01023387","Total",1330,93,28,65,1237,141,92,329,206,99,128,242
"2011","Dacorum 019C","E01023388","Total",1592,178,59,119,1414,70,150,345,262,101,202,284
"2011","Dacorum 019D","E01023389","Total",1683,145,53,92,1538,68,188,393,256,101,141,391
"2011","Dacorum 020A","E01023357","Total",1651,210,123,87,1441,160,126,292,218,113,239,293
"2011","Dacorum 020B","E01023358","Total",1477,131,60,71,1346,125,86,288,130,129,302,286
"2011","Dacorum 020C","E01023359","Total",1823,152,68,84,1671,124,138,484,186,128,280,331
"2011","Dacorum 020D","E01023360","Total",1473,113,38,75,1360,70,108,379,208,124,211,260
"2011","Dacorum 020E","E01023414","Total",1432,184,63,121,1248,64,88,377,224,57,175,263
"2011","Dacorum 020F","E01023415","Total",1381,105,65,40,1276,80,214,280,166,91,152,293
"2011","Dacorum 021A","E01023373","Total",1153,171,82,89,982,35,110,304,176,74,134,149
"2011","Dacorum 021B","E01023374","Total",1418,172,83,89,1246,51,182,383,240,72,92,226
"2011","Dacorum 021C","E01023375","Total",1537,183,98,85,1354,40,224,339,186,101,217,247
"2011","Dacorum 021D","E01023376","Total",1268,160,54,106,1108,51,134,309,196,125,87,206
"2011","Dacorum 021E","E01023377","Total",1212,118,66,52,1094,31,220,281,166,77,105,214
"2011","Dacorum 021F","E01023378","Total",1628,83,40,43,1545,14,254,356,212,101,271,337
"2011","Dacorum 022A","E01023406","Total",1882,317,163,154,1565,98,194,462,306,66,135,304
"2011","Dacorum 022B","E01023407","Total",1664,140,72,68,1524,51,200,412,238,115,174,334
"2011","Dacorum 022C","E01023408","Total",1635,118,74,44,1517,56,238,399,196,108,191,329
"2011","East Hertfordshire 001A","E01023462","Total",1337,113,56,57,1224,57,148,269,234,114,167,235
"2011","East Hertfordshire 001B","E01023464","Total",2164,142,61,81,2022,47,294,556,274,164,251,436
"2011","East Hertfordshire 001C","E01023465","Total",1444,113,55,58,1331,45,194,284,212,117,196,283
"2011","East Hertfordshire 001D","E01023466","Total",1717,270,153,117,1447,74,222,365,204,83,171,328
"2011","East Hertfordshire 002A","E01023467","Total",2392,219,109,110,2173,47,392,496,366,155,255,462
"2011","East Hertfordshire 002B","E01023494","Total",1206,102,60,42,1104,23,194,250,180,89,147,221
"2011","East Hertfordshire 002C","E01023495","Total",1252,118,40,78,1134,42,146,275,190,128,120,233
"2011","East Hertfordshire 002D","E01023508","Total",1472,119,43,76,1353,45,192,322,230,130,141,293
"2011","East Hertfordshire 002E","E01023509","Total",1356,133,60,73,1223,82,138,339,220,66,165,213
"2011","East Hertfordshire 003A","E01023452","Total",1388,72,22,50,1316,60,64,473,190,87,195,247
"2011","East Hertfordshire 003B","E01023453","Total",1390,121,47,74,1269,27,172,416,186,118,142,208
"2011","East Hertfordshire 003C","E01023454","Total",1311,104,33,71,1207,33,122,379,208,96,140,229
"2011","East Hertfordshire 003D","E01023455","Total",1292,157,76,81,1135,49,116,341,206,51,157,215
"2011","East Hertfordshire 003E","E01023463","Total",1203,129,73,56,1074,27,184,233,184,106,139,201
"2011","East Hertfordshire 003F","E01023493","Total",2468,181,78,103,2287,71,260,634,372,244,269,437
"2011","East Hertfordshire 004A","E01023449","Total",1611,188,92,96,1423,34,194,438,254,112,146,245
"2011","East Hertfordshire 004B","E01023450","Total",1908,440,145,295,1468,66,156,379,444,86,99,238
"2011","East Hertfordshire 004C","E01023451","Total",2141,260,129,131,1881,39,302,510,374,111,175,370
"2011","East Hertfordshire 005A","E01023438","Total",1449,150,62,88,1299,80,128,357,216,117,131,270
"2011","East Hertfordshire 005B","E01023439","Total",1358,77,50,27,1281,94,166,289,190,45,179,318
"2011","East Hertfordshire 005C","E01023440","Total",1641,131,84,47,1510,27,278,381,210,85,147,382
"2011","East Hertfordshire 005D","E01023441","Total",1187,145,35,110,1042,48,74,270,206,109,123,212
"2011","East Hertfordshire 005E","E01023442","Total",2095,186,51,135,1909,91,138,634,296,118,188,444
"2011","East Hertfordshire 006A","E01023498","Total",2653,305,143,162,2348,81,298,735,400,162,217,455
"2011","East Hertfordshire 006B","E01023506","Total",1398,158,79,79,1240,42,198,325,188,106,118,263
"2011","East Hertfordshire 006C","E01023507","Total",1577,146,51,95,1431,43,192,444,242,108,168,234
"2011","East Hertfordshire 007A","E01023443","Total",1557,187,93,94,1370,72,128,354,250,96,164,306
"2011","East Hertfordshire 007B","E01023444","Total",1619,188,83,105,1431,57,132,494,298,89,120,241
"2011","East Hertfordshire 007C","E01023445","Total",1733,199,118,81,1534,87,172,368,210,113,217,367
"2011","East Hertfordshire 007D","E01023446","Total",2118,499,151,348,1619,107,122,474,602,47,65,202
"2011","East Hertfordshire 007E","E01023447","Total",1248,127,50,77,1121,130,100,241,130,122,149,249
"2011","East Hertfordshire 007F","E01023448","Total",1519,143,40,103,1376,83,68,445,226,120,134,300
"2011","East Hertfordshire 008A","E01023456","Total",1435,103,33,70,1332,38,70,433,168,84,215,324
"2011","East Hertfordshire 008B","E01023457","Total",1507,145,56,89,1362,59,124,445,260,70,148,256
"2011","East Hertfordshire 008C","E01023458","Total",1331,124,49,75,1207,34,126,298,216,102,169,262
"2011","East Hertfordshire 008D","E01023459","Total",1342,119,47,72,1223,31,126,314,182,71,167,332
"2011","East Hertfordshire 008E","E01023460","Total",1519,109,58,51,1410,27,148,440,172,154,205,264
"2011","East Hertfordshire 008F","E01023461","Total",1623,58,17,41,1565,40,84,557,182,209,296,197
"2011","East Hertfordshire 009A","E01023491","Total",1272,128,47,81,1144,50,166,282,226,103,119,198
"2011","East Hertfordshire 009B","E01023492","Total",1468,117,54,63,1351,53,188,345,248,64,137,316
"2011","East Hertfordshire 009C","E01023496","Total",1117,98,50,48,1019,58,136,258,166,66,127,208
"2011","East Hertfordshire 009D","E01023497","Total",1571,179,110,69,1392,48,232,337,200,116,209,250
"2011","East Hertfordshire 010A","E01023485","Total",2277,240,114,126,2037,41,364,502,384,138,239,369
"2011","East Hertfordshire 010B","E01023486","Total",2514,206,105,101,2308,66,322,555,408,195,244,518
"2011","East Hertfordshire 010E","E01033609","Total",2328,266,110,156,2062,99,250,666,380,122,183,362
"2011","East Hertfordshire 011A","E01023499","Total",1750,237,114,123,1513,101,222,325,244,116,199,306
"2011","East Hertfordshire 011B","E01023500","Total",1603,100,65,35,1503,26,242,367,274,106,156,332
"2011","East Hertfordshire 011C","E01023501","Total",1513,219,97,122,1294,55,198,339,256,84,108,254
"2011","East Hertfordshire 011D","E01023502","Total",1735,285,97,188,1450,95,178,424,316,106,85,246
"2011","East Hertfordshire 011E","E01023503","Total",1723,202,87,115,1521,37,278,384,258,56,194,314
"2011","East Hertfordshire 012A","E01023512","Total",1860,281,85,196,1579,66,150,424,390,111,160,278
"2011","East Hertfordshire 012B","E01023513","Total",1488,147,87,60,1341,38,188,376,168,114,132,325
"2011","East Hertfordshire 012C","E01023514","Total",1691,439,152,287,1252,79,152,333,374,42,110,162
"2011","East Hertfordshire 012D","E01023518","Total",1951,141,63,78,1810,107,178,420,198,224,257,426
"2011","East Hertfordshire 012E","E01023519","Total",1735,156,67,89,1579,91,138,450,262,130,224,284
"2011","East Hertfordshire 012F","E01023520","Total",1608,182,83,99,1426,39,248,443,174,80,182,260
"2011","East Hertfordshire 013A","E01023510","Total",1469,149,59,90,1320,8,206,389,230,75,138,274
"2011","East Hertfordshire 013B","E01023511","Total",1517,378,115,263,1139,60,96,307,394,45,51,186
"2011","East Hertfordshire 013C","E01023515","Total",1554,198,44,154,1356,42,90,411,344,102,108,259
"2011","East Hertfordshire 013D","E01023516","Total",2085,232,65,167,1853,61,184,559,400,82,184,383
"2011","East Hertfordshire 013E","E01023517","Total",1595,195,66,129,1400,103,186,330,260,100,157,264
"2011","East Hertfordshire 014A","E01023470","Total",1729,393,125,268,1336,47,118,449,484,30,78,130
"2011","East Hertfordshire 014B","E01023471","Total",1319,127,69,58,1192,22,172,338,220,72,146,222
"2011","East Hertfordshire 014C","E01023472","Total",1343,215,110,105,1128,82,142,299,214,123,87,181
"2011","East Hertfordshire 014D","E01023473","Total",1455,146,98,48,1309,15,288,312,170,118,136,270
"2011","East Hertfordshire 014E","E01023474","Total",1557,140,56,84,1417,40,178,513,270,97,126,193
"2011","East Hertfordshire 015A","E01023487","Total",1374,234,105,129,1140,126,144,247,192,87,143,201
"2011","East Hertfordshire 015B","E01023488","Total",1592,258,82,176,1334,251,92,341,222,121,133,174
"2011","East Hertfordshire 015C","E01023489","Total",1309,253,85,168,1056,31,160,306,278,72,75,134
"2011","East Hertfordshire 015D","E01023490","Total",1272,86,37,49,1186,66,110,387,182,110,103,228
"2011","East Hertfordshire 016A","E01023482","Total",1953,172,35,137,1781,88,68,758,360,146,223,138
"2011","East Hertfordshire 016B","E01023483","Total",1969,154,63,91,1815,79,162,519,294,173,240,348
"2011","East Hertfordshire 016C","E01023484","Total",1531,193,63,130,1338,85,88,459,250,103,119,234
"2011","East Hertfordshire 017A","E01023475","Total",1461,196,75,121,1265,106,108,335,226,63,166,261
"2011","East Hertfordshire 017B","E01023476","Total",1473,125,69,56,1348,40,268,349,208,132,101,250
"2011","East Hertfordshire 017C","E01023477","Total",2090,283,64,219,1807,81,134,597,450,81,149,315
"2011","East Hertfordshire 017D","E01023478","Total",1708,484,144,340,1224,77,86,310,480,81,56,134
"2011","East Hertfordshire 017E","E01023479","Total",1565,236,69,167,1329,30,116,385,342,88,103,265
"2011","East Hertfordshire 018A","E01023468","Total",1368,124,35,89,1244,15,124,312,216,127,165,285
"2011","East Hertfordshire 018B","E01023469","Total",1510,144,71,73,1366,64,170,360,236,102,168,266
"2011","East Hertfordshire 018C","E01023480","Total",1576,192,103,89,1384,45,242,353,248,81,150,265
"2011","East Hertfordshire 018D","E01023481","Total",1213,115,43,72,1098,35,126,316,178,63,127,253
"2011","East Hertfordshire 018E","E01023504","Total",1353,178,89,89,1175,52,142,334,218,107,109,213
"2011","East Hertfordshire 018F","E01023505","Total",1657,219,71,148,1438,54,114,442,412,82,104,230
"2011","Hertsmere 001A","E01023576","Total",1404,151,99,52,1253,22,314,193,182,48,155,339
"2011","Hertsmere 001B","E01023577","Total",1707,192,129,63,1515,34,356,285,188,66,176,410
"2011","Hertsmere 001C","E01023578","Total",1569,165,121,44,1404,18,292,261,200,40,191,402
"2011","Hertsmere 001D","E01023579","Total",1382,207,102,105,1175,89,78,231,206,55,158,358
"2011","Hertsmere 001E","E01023580","Total",1663,222,134,88,1441,66,202,370,214,70,180,339
"2011","Hertsmere 002A","E01023567","Total",2056,142,88,54,1914,61,176,494,242,182,260,499
"2011","Hertsmere 002B","E01023568","Total",1511,174,133,41,1337,26,254,284,194,88,157,334
"2011","Hertsmere 002C","E01023569","Total",1615,130,73,57,1485,84,164,354,196,135,206,346
"2011","Hertsmere 002D","E01023570","Total",1472,203,97,106,1269,56,108,292,216,56,210,331
"2011","Hertsmere 003A","E01023571","Total",1433,161,101,60,1272,42,262,255,176,76,163,298
"2011","Hertsmere 003B","E01023572","Total",1447,166,81,85,1281,61,188,273,252,46,140,321
"2011","Hertsmere 003C","E01023573","Total",1210,179,90,89,1031,102,106,209,142,41,100,331
"2011","Hertsmere 003D","E01023574","Total",1601,177,80,97,1424,176,150,309,220,98,177,294
"2011","Hertsmere 003E","E01023575","Total",1524,206,87,119,1318,44,180,275,220,88,156,355
"2011","Hertsmere 004A","E01023581","Total",1336,77,20,57,1259,30,92,516,236,117,109,159
"2011","Hertsmere 004B","E01023582","Total",1601,143,36,107,1458,123,88,496,218,124,163,246
"2011","Hertsmere 004C","E01023583","Total",1377,163,70,93,1214,73,122,310,194,110,162,243
"2011","Hertsmere 004D","E01023584","Total",1031,123,57,66,908,54,116,219,172,30,139,178
"2011","Hertsmere 005A","E01023523","Total",1712,94,50,44,1618,12,228,385,222,156,305,310
"2011","Hertsmere 005B","E01023524","Total",1537,64,43,21,1473,35,246,321,98,164,278,331
"2011","Hertsmere 005C","E01023525","Total",1676,261,109,152,1415,64,192,393,264,96,118,288
"2011","Hertsmere 005D","E01023526","Total",1779,115,53,62,1664,19,306,432,190,125,242,350
"2011","Hertsmere 005E","E01023527","Total",1444,188,85,103,1256,73,172,331,162,125,141,252
"2011","Hertsmere 006A","E01023534","Total",1695,146,55,91,1549,100,116,339,156,128,287,423
"2011","Hertsmere 006B","E01023535","Total",1629,211,76,135,1418,150,100,353,194,67,200,354
"2011","Hertsmere 006C","E01023536","Total",1594,382,128,254,1212,217,112,317,180,98,142,146
"2011","Hertsmere 006D","E01023537","Total",1769,141,73,68,1628,84,166,295,188,144,309,442
"2011","Hertsmere 006E","E01023538","Total",1667,313,155,158,1354,114,158,345,214,56,189,278
"2011","Hertsmere 007A","E01023529","Total",1494,137,61,76,1357,102,94,386,168,96,174,337
"2011","Hertsmere 007B","E01023530","Total",1223,192,68,124,1031,154,90,248,208,36,127,168
"2011","Hertsmere 007C","E01023531","Total",1964,217,93,124,1747,120,160,477,252,131,259,348
"2011","Hertsmere 007D","E01023532","Total",1637,194,76,118,1443,63,144,440,202,111,167,316
"2011","Hertsmere 007E","E01023533","Total",1598,180,87,93,1418,154,116,309,166,121,245,307
"2011","Hertsmere 008A","E01023552","Total",1660,111,56,55,1549,69,170,379,178,145,158,450
"2011","Hertsmere 008B","E01023553","Total",1502,158,54,104,1344,28,96,398,198,71,203,350
"2011","Hertsmere 008C","E01023554","Total",1670,200,61,139,1470,107,100,385,296,78,199,305
"2011","Hertsmere 008D","E01023555","Total",1650,254,95,159,1396,150,162,311,200,86,175,312
"2011","Hertsmere 009A","E01023544","Total",1187,148,47,101,1039,81,92,309,162,58,128,209
"2011","Hertsmere 009B","E01023545","Total",1202,235,28,207,967,72,70,320,216,16,90,183
"2011","Hertsmere 009C","E01023546","Total",1800,212,70,142,1588,140,108,465,224,122,178,351
"2011","Hertsmere 009D","E01023547","Total",1679,225,64,161,1454,124,116,375,210,87,229,313
"2011","Hertsmere 010A","E01023528","Total",1511,166,41,125,1345,61,176,270,274,92,207,265
"2011","Hertsmere 010B","E01023564","Total",1656,188,64,124,1468,96,114,390,200,119,237,312
"2011","Hertsmere 010C","E01023565","Total",1707,121,69,52,1586,52,190,381,196,180,248,339
"2011","Hertsmere 010D","E01023566","Total",1579,54,34,20,1525,21,214,335,104,153,327,371
"2011","Hertsmere 011A","E01023539","Total",2806,326,78,248,2480,225,136,806,516,92,285,420
"2011","Hertsmere 011B","E01023540","Total",1675,165,105,60,1510,108,148,366,178,153,172,385
"2011","Hertsmere 011C","E01023541","Total",1918,159,60,99,1759,112,124,516,224,134,217,432
"2011","Hertsmere 011D","E01023542","Total",1776,145,55,90,1631,93,126,333,206,128,306,439
"2011","Hertsmere 011E","E01023543","Total",1366,196,81,115,1170,66,82,251,212,79,171,309
"2011","Hertsmere 012A","E01023558","Total",1632,291,123,168,1341,65,156,425,238,114,98,245
"2011","Hertsmere 012B","E01023559","Total",1478,153,62,91,1325,44,152,338,172,90,177,352
"2011","Hertsmere 012C","E01023560","Total",1482,218,123,95,1264,137,108,300,130,137,188,264
"2011","Hertsmere 012D","E01023561","Total",1620,172,91,81,1448,93,176,435,160,97,173,314
"2011","Hertsmere 012E","E01023562","Total",1469,121,60,61,1348,40,194,332,146,99,195,342
"2011","Hertsmere 012F","E01023563","Total",1459,216,100,116,1243,73,146,334,200,87,134,269
"2011","Hertsmere 013A","E01023548","Total",1762,249,151,98,1513,42,356,288,244,105,200,278
"2011","Hertsmere 013B","E01023549","Total",1614,305,181,124,1309,79,282,320,218,66,141,203
"2011","Hertsmere 013C","E01023550","Total",1691,125,76,49,1566,18,248,469,232,134,174,291
"2011","Hertsmere 013D","E01023551","Total",1510,77,55,22,1433,33,240,353,140,136,152,379
"2011","Hertsmere 013E","E01023556","Total",1538,166,72,94,1372,55,194,386,172,77,164,324
"2011","Hertsmere 013F","E01023557","Total",1522,176,74,102,1346,56,180,377,154,109,233,237
"2011","North Hertfordshire 001A","E01023660","Total",2167,396,186,210,1771,78,254,466,436,70,135,332
"2011","North Hertfordshire 001B","E01023661","Total",1355,111,56,55,1244,63,148,297,180,130,165,261
"2011","North Hertfordshire 001C","E01023662","Total",1548,144,28,116,1404,60,84,483,260,76,184,257
"2011","North Hertfordshire 002A","E01023654","Total",1551,125,52,73,1426,29,178,395,384,96,80,264
"2011","North Hertfordshire 002B","E01023655","Total",1511,136,72,64,1375,53,232,249,282,104,131,324
"2011","North Hertfordshire 002C","E01023656","Total",2148,352,127,225,1796,78,160,422,500,89,181,366
"2011","North Hertfordshire 002D","E01023657","Total",2506,215,113,102,2291,23,352,749,454,155,197,361
"2011","North Hertfordshire 002E","E01023658","Total",1598,152,91,61,1446,90,210,401,216,73,197,259
"2011","North Hertfordshire 002F","E01023659","Total",1328,80,30,50,1248,23,166,313,220,88,113,325
"2011","North Hertfordshire 003A","E01023635","Total",1476,160,104,56,1316,95,256,340,168,83,131,243
"2011","North Hertfordshire 003B","E01023636","Total",1805,236,142,94,1569,113,226,368,282,84,191,305
"2011","North Hertfordshire 003C","E01023637","Total",1700,393,186,207,1307,128,220,354,254,118,67,166
"2011","North Hertfordshire 003D","E01023638","Total",1557,198,76,122,1359,94,192,314,238,107,127,287
"2011","North Hertfordshire 004A","E01023587","Total",1097,188,41,147,909,40,58,262,220,56,103,170
"2011","North Hertfordshire 004B","E01023588","Total",1342,136,72,64,1206,27,118,390,230,59,127,255
"2011","North Hertfordshire 004C","E01023589","Total",1616,344,159,185,1272,32,186,364,284,72,113,221
"2011","North Hertfordshire 004D","E01023590","Total",1666,255,99,156,1411,58,138,476,280,78,137,244
"2011","North Hertfordshire 004E","E01023591","Total",1457,194,88,106,1263,38,198,354,202,59,164,248
"2011","North Hertfordshire 004F","E01023592","Total",1510,131,79,52,1379,106,108,374,146,177,210,258
"2011","North Hertfordshire 004G","E01023593","Total",1402,199,91,108,1203,108,156,332,188,75,125,219
"2011","North Hertfordshire 005A","E01023585","Total",1167,119,79,40,1048,18,172,189,172,153,144,200
"2011","North Hertfordshire 005B","E01023586","Total",1528,167,95,72,1361,61,238,338,256,132,117,219
"2011","North Hertfordshire 005C","E01023597","Total",1201,103,45,58,1098,35,194,262,216,85,117,189
"2011","North Hertfordshire 005D","E01023598","Total",1381,120,57,63,1261,83,192,330,210,119,114,213
"2011","North Hertfordshire 005F","E01023600","Total",1330,162,75,87,1168,69,174,284,224,87,94,236
"2011","North Hertfordshire 005G","E01023663","Total",2091,184,90,94,1907,78,264,423,346,178,191,427
"2011","North Hertfordshire 005H","E01033024","Total",1619,62,7,55,1557,43,36,643,246,124,232,233
"2011","North Hertfordshire 005I","E01033025","Total",1286,114,18,96,1172,74,52,565,276,54,52,99
"2011","North Hertfordshire 005J","E01033026","Total",1526,114,20,94,1412,67,76,480,300,143,173,173
"2011","North Hertfordshire 005K","E01033027","Total",1471,142,9,133,1329,117,30,427,392,109,106,148
"2011","North Hertfordshire 006A","E01023630","Total",1591,169,91,78,1422,101,120,340,224,130,220,287
"2011","North Hertfordshire 006B","E01023631","Total",1663,237,87,150,1426,127,106,416,246,105,139,287
"2011","North Hertfordshire 006C","E01023632","Total",1323,168,54,114,1155,57,88,335,240,51,134,250
"2011","North Hertfordshire 006D","E01023633","Total",1376,227,74,153,1149,139,102,315,200,84,111,198
"2011","North Hertfordshire 006E","E01023634","Total",1308,179,81,98,1129,26,256,280,268,55,69,175
"2011","North Hertfordshire 007A","E01023649","Total",1253,272,66,206,981,68,128,260,278,41,73,133
"2011","North Hertfordshire 007B","E01023650","Total",1477,189,59,130,1288,113,84,313,214,125,202,237
"2011","North Hertfordshire 007C","E01023651","Total",1230,110,60,50,1120,62,150,325,172,52,137,222
"2011","North Hertfordshire 007D","E01023652","Total",1451,189,113,76,1262,116,150,340,176,110,160,210
"2011","North Hertfordshire 008A","E01023644","Total",1615,229,143,86,1386,54,266,268,238,99,193,268
"2011","North Hertfordshire 008B","E01023645","Total",1510,196,112,84,1314,81,186,292,220,81,181,273
"2011","North Hertfordshire 008C","E01023646","Total",1389,84,40,44,1305,161,114,327,164,117,193,229
"2011","North Hertfordshire 008D","E01023647","Total",1526,128,86,42,1398,14,240,338,184,71,209,342
"2011","North Hertfordshire 008E","E01023648","Total",1143,99,49,50,1044,11,226,208,166,41,152,240
"2011","North Hertfordshire 009A","E01023639","Total",1314,133,60,73,1181,41,182,270,220,93,177,198
"2011","North Hertfordshire 009B","E01023640","Total",1212,207,116,91,1005,94,160,202,178,41,175,155
"2011","North Hertfordshire 009C","E01023641","Total",1327,183,73,110,1144,139,158,259,166,100,95,227
"2011","North Hertfordshire 009D","E01023642","Total",1326,83,59,24,1243,11,202,233,188,79,203,327
"2011","North Hertfordshire 009E","E01023643","Total",1325,102,42,60,1223,97,146,299,146,59,170,306
"2011","North Hertfordshire 010A","E01023601","Total",2108,515,118,397,1593,121,94,373,534,55,133,283
"2011","North Hertfordshire 010B","E01023602","Total",1580,167,43,124,1413,65,78,480,332,82,162,214
"2011","North Hertfordshire 010C","E01023603","Total",1572,133,51,82,1439,55,142,461,228,107,120,326
"2011","North Hertfordshire 010D","E01023604","Total",1369,133,57,76,1236,37,122,351,212,62,192,260
"2011","North Hertfordshire 010E","E01023605","Total",1444,309,44,265,1135,103,76,261,362,57,144,132
"2011","North Hertfordshire 011A","E01023617","Total",1488,146,96,50,1342,40,252,349,246,48,151,256
"2011","North Hertfordshire 011B","E01023618","Total",1511,154,72,82,1357,87,134,322,232,120,163,299
"2011","North Hertfordshire 011C","E01023619","Total",1619,250,48,202,1369,48,92,339,364,71,125,330
"2011","North Hertfordshire 011D","E01023620","Total",1324,143,68,75,1181,98,136,281,158,64,183,261
"2011","North Hertfordshire 011E","E01023621","Total",1346,184,56,128,1162,75,106,327,256,47,119,232
"2011","North Hertfordshire 012A","E01023611","Total",1638,182,98,84,1456,161,182,287,200,98,241,287
"2011","North Hertfordshire 012B","E01023612","Total",1768,207,70,137,1561,95,166,455,286,116,142,301
"2011","North Hertfordshire 012C","E01023613","Total",1653,310,117,193,1343,171,118,301,200,119,161,273
"2011","North Hertfordshire 012D","E01023614","Total",1950,187,80,107,1763,40,286,450,328,122,186,351
"2011","North Hertfordshire 012E","E01023615","Total",1525,172,96,76,1353,44,274,331,248,93,137,226
"2011","North Hertfordshire 012F","E01023616","Total",1932,506,221,285,1426,64,180,379,406,56,106,235
"2011","North Hertfordshire 013A","E01023606","Total",1631,305,122,183,1326,111,144,377,306,79,121,188
"2011","North Hertfordshire 013B","E01023607","Total",1473,137,73,64,1336,62,224,408,166,97,114,265
"2011","North Hertfordshire 013C","E01023608","Total",1509,157,107,50,1352,40,304,367,198,82,115,246
"2011","North Hertfordshire 013D","E01023609","Total",1549,258,102,156,1291,50,166,328,310,112,118,207
"2011","North Hertfordshire 013E","E01023610","Total",1337,110,22,88,1227,26,82,450,194,97,172,206
"2011","North Hertfordshire 014A","E01023594","Total",2194,292,155,137,1902,100,322,450,342,61,235,392
"2011","North Hertfordshire 014B","E01023622","Total",1109,107,64,43,1002,58,142,210,196,62,166,168
"2011","North Hertfordshire 014C","E01023623","Total",1425,150,87,63,1275,41,198,319,270,111,135,201
"2011","North Hertfordshire 014D","E01023624","Total",1330,112,53,59,1218,70,142,274,242,120,138,232
"2011","North Hertfordshire 014E","E01023625","Total",1079,87,36,51,992,31,150,206,182,73,143,207
"2011","North Hertfordshire 014F","E01023653","Total",2159,233,137,96,1926,71,270,598,316,155,203,313
"2011","North Hertfordshire 015A","E01023595","Total",1494,244,113,131,1250,38,174,366,248,77,146,201
"2011","North Hertfordshire 015B","E01023596","Total",1099,164,97,67,935,31,188,240,120,40,114,202
"2011","North Hertfordshire 015C","E01023626","Total",2167,184,98,86,1983,90,332,465,302,196,182,416
"2011","North Hertfordshire 015D","E01023627","Total",1643,171,71,100,1472,49,190,345,288,65,205,330
"2011","North Hertfordshire 015E","E01023628","Total",1723,206,88,118,1517,83,164,459,386,73,130,222
"2011","North Hertfordshire 015F","E01023629","Total",1770,263,116,147,1507,62,192,371,280,127,161,314
"2011","St Albans 001A","E01023690","Total",1584,151,97,54,1433,57,160,532,178,157,142,207
"2011","St Albans 001B","E01023691","Total",1458,68,42,26,1390,19,178,481,130,140,177,265
"2011","St Albans 001C","E01023692","Total",1245,135,60,75,1110,106,102,354,178,82,122,166
"2011","St Albans 001D","E01023693","Total",1288,147,63,84,1141,29,146,305,166,114,130,251
"2011","St Albans 001E","E01023694","Total",1474,74,49,25,1400,42,162,491,134,160,162,249
"2011","St Albans 002A","E01023685","Total",1690,147,54,93,1543,43,150,560,238,204,130,218
"2011","St Albans 002B","E01023686","Total",1530,80,45,35,1450,10,152,509,134,210,143,292
"2011","St Albans 002C","E01023687","Total",1521,165,71,94,1356,138,140,299,194,107,233,245
"2011","St Albans 002D","E01023688","Total",1428,194,81,113,1234,66,142,407,260,79,105,175
"2011","St Albans 002E","E01023689","Total",1320,143,73,70,1177,22,114,436,154,151,140,160
"2011","St Albans 003A","E01023699","Total",1472,163,118,45,1309,12,198,384,210,165,138,202
"2011","St Albans 003B","E01023700","Total",1322,71,54,17,1251,15,210,325,136,153,182,230
"2011","St Albans 003C","E01023701","Total",1755,341,178,163,1414,80,214,368,308,117,160,167
"2011","St Albans 003D","E01023702","Total",1609,233,89,144,1376,27,94,560,280,152,113,150
"2011","St Albans 003E","E01023703","Total",1457,91,51,40,1366,31,120,573,170,166,116,190
"2011","St Albans 004A","E01023746","Total",1545,152,75,77,1393,165,120,409,228,104,101,266
"2011","St Albans 004B","E01023747","Total",1787,212,116,96,1575,53,214,546,244,129,148,241
"2011","St Albans 004C","E01023748","Total",1383,110,70,40,1273,20,304,264,212,97,170,206
"2011","St Albans 004D","E01023749","Total",1682,155,100,55,1527,55,232,376,226,144,201,293
"2011","St Albans 005A","E01023695","Total",1578,129,85,44,1449,13,232,435,200,123,188,258
"2011","St Albans 005B","E01023696","Total",1736,79,52,27,1657,23,376,384,152,192,227,303
"2011","St Albans 005C","E01023697","Total",1855,258,115,143,1597,71,162,549,282,133,144,256
"2011","St Albans 005D","E01023698","Total",1606,103,51,52,1503,10,220,460,208,97,207,301
"2011","St Albans 006A","E01023722","Total",1414,147,63,84,1267,22,236,301,212,128,136,232
"2011","St Albans 006B","E01023723","Total",1692,185,81,104,1507,111,192,386,200,94,229,295
"2011","St Albans 006C","E01023724","Total",1538,220,117,103,1318,44,264,395,286,103,74,152
"2011","St Albans 006D","E01023725","Total",1512,103,49,54,1409,34,214,405,196,157,133,270
"2011","St Albans 007A","E01023713","Total",1872,146,75,71,1726,66,134,450,264,232,245,335
"2011","St Albans 007B","E01023734","Total",1648,162,64,98,1486,46,148,460,232,99,109,392
"2011","St Albans 007C","E01023735","Total",1746,289,113,176,1457,64,140,420,320,38,156,319
"2011","St Albans 007D","E01023736","Total",1492,212,83,129,1280,55,158,329,250,95,137,256
"2011","St Albans 008A","E01023709","Total",1658,245,113,132,1413,71,184,388,250,102,105,313
"2011","St Albans 008B","E01023710","Total",1564,63,49,14,1501,10,230,381,166,120,187,407
"2011","St Albans 008C","E01023711","Total",1588,140,91,49,1448,41,226,377,150,117,217,320
"2011","St Albans 008D","E01023712","Total",1687,245,73,172,1442,61,136,425,314,70,192,244
"2011","St Albans 009A","E01023669","Total",1681,186,53,133,1495,151,80,426,264,117,215,242
"2011","St Albans 009B","E01023670","Total",2046,202,76,126,1844,53,94,798,374,169,109,247
"2011","St Albans 009C","E01023671","Total",1887,201,114,87,1686,58,210,404,202,171,301,340
"2011","St Albans 009D","E01023672","Total",1909,130,41,89,1779,64,150,484,204,265,191,421
"2011","St Albans 010A","E01023673","Total",1441,71,37,34,1370,20,154,365,170,143,220,298
"2011","St Albans 010B","E01023714","Total",1822,100,65,35,1722,31,244,482,174,193,242,356
"2011","St Albans 010C","E01023715","Total",1585,64,42,22,1521,22,176,411,164,237,216,295
"2011","St Albans 010D","E01023716","Total",2039,223,75,148,1816,37,138,705,438,150,150,198
"2011","St Albans 011A","E01023666","Total",1714,275,42,233,1439,77,84,265,452,97,213,251
"2011","St Albans 011B","E01023674","Total",1862,174,56,118,1688,46,50,588,398,176,139,291
"2011","St Albans 011C","E01023675","Total",1394,82,54,28,1312,14,188,363,178,125,229,215
"2011","St Albans 011D","E01023676","Total",2156,343,85,258,1813,119,150,484,572,150,149,189
"2011","St Albans 012A","E01023726","Total",1671,284,57,227,1387,41,60,458,584,25,51,168
"2011","St Albans 012B","E01023727","Total",1859,489,166,323,1370,74,80,336,582,86,41,171
"2011","St Albans 012C","E01023728","Total",2153,304,79,225,1849,43,150,599,524,117,136,280
"2011","St Albans 012D","E01023729","Total",1806,320,61,259,1486,119,78,433,444,98,94,220
"2011","St Albans 013A","E01023664","Total",1751,138,39,99,1613,80,112,492,262,156,236,275
"2011","St Albans 013B","E01023665","Total",1571,138,45,93,1433,49,106,467,248,117,211,235
"2011","St Albans 013C","E01023667","Total",1431,137,41,96,1294,32,84,385,300,116,170,207
"2011","St Albans 013D","E01023668","Total",1406,71,44,27,1335,26,124,464,148,113,195,265
"2011","St Albans 014A","E01023742","Total",1425,93,70,23,1332,9,274,335,208,116,110,280
"2011","St Albans 014B","E01023743","Total",1723,256,110,146,1467,22,218,409,350,123,132,213
"2011","St Albans 014C","E01023744","Total",1470,149,117,32,1321,15,316,297,168,77,130,318
"2011","St Albans 014D","E01023745","Total",1721,224,93,131,1497,32,188,553,328,86,94,216
"2011","St Albans 015A","E01023677","Total",1213,118,12,106,1095,88,16,493,152,101,121,124
"2011","St Albans 015B","E01023678","Total",1869,170,55,115,1699,77,152,644,268,118,142,298
"2011","St Albans 015C","E01023679","Total",1478,152,67,85,1326,65,158,345,210,96,129,323
"2011","St Albans 015D","E01023680","Total",1313,123,55,68,1190,73,154,326,142,116,127,252
"2011","St Albans 016A","E01023681","Total",1601,274,103,171,1327,95,90,253,234,79,184,392
"2011","St Albans 016B","E01023682","Total",1693,160,72,88,1533,30,170,392,226,135,215,365
"2011","St Albans 016C","E01023683","Total",1660,189,106,83,1471,99,192,394,186,127,178,295
"2011","St Albans 016D","E01023684","Total",1615,167,91,76,1448,19,230,358,278,62,178,323
"2011","St Albans 017A","E01023737","Total",1338,153,50,103,1185,81,76,194,182,102,256,294
"2011","St Albans 017B","E01023738","Total",1586,215,83,132,1371,70,122,316,194,144,264,261
"2011","St Albans 017C","E01023739","Total",1407,159,86,73,1248,58,116,338,182,135,242,177
"2011","St Albans 017D","E01023740","Total",1338,268,66,202,1070,54,72,341,322,61,77,143
"2011","St Albans 017E","E01023741","Total",1583,145,54,91,1438,45,102,558,332,107,86,208
"2011","St Albans 018A","E01023704","Total",1584,302,45,257,1282,92,98,382,276,71,97,266
"2011","St Albans 018B","E01023705","Total",1699,155,65,90,1544,111,124,289,162,146,367,345
"2011","St Albans 018C","E01023706","Total",1576,178,82,96,1398,69,162,332,210,83,198,344
"2011","St Albans 018E","E01023708","Total",1502,210,109,101,1292,65,158,317,224,72,208,248
"2011","St Albans 018F","E01033028","Total",1480,95,33,62,1385,63,98,331,172,146,258,317
"2011","St Albans 018G","E01033029","Total",1599,124,19,105,1475,60,80,518,256,166,213,182
"2011","St Albans 019A","E01023718","Total",1746,155,107,48,1591,50,302,407,196,108,193,335
"2011","St Albans 019B","E01023719","Total",1119,139,68,71,980,45,146,240,146,87,116,200
"2011","St Albans 019C","E01023720","Total",1763,281,85,196,1482,116,132,497,320,40,144,233
"2011","St Albans 019D","E01023721","Total",1406,115,59,56,1291,30,208,330,148,123,153,299
"2011","St Albans 020A","E01023717","Total",1227,110,59,51,1117,39,150,319,194,67,115,233
"2011","St Albans 020B","E01023730","Total",1740,137,86,51,1603,25,312,476,176,128,171,315
"2011","St Albans 020C","E01023731","Total",1469,170,76,94,1299,44,212,320,206,126,151,240
"2011","St Albans 020D","E01023732","Total",1599,176,92,84,1423,33,246,294,232,60,222,336
"2011","St Albans 020E","E01023733","Total",1596,136,83,53,1460,44,290,276,220,76,226,328
"2011","Stevenage 001A","E01023787","Total",1425,119,35,84,1306,75,108,312,260,120,200,231
"2011","Stevenage 001B","E01023788","Total",1582,192,85,107,1390,106,116,333,194,155,225,261
"2011","Stevenage 001C","E01023789","Total",1986,179,53,126,1807,162,100,477,294,168,321,285
"2011","Stevenage 001D","E01023790","Total",1732,161,38,123,1571,146,92,399,172,160,293,309
"2011","Stevenage 002A","E01023776","Total",2495,342,111,231,2153,161,248,512,542,141,154,395
"2011","Stevenage 002B","E01023777","Total",1791,221,86,135,1570,65,214,394,282,133,176,306
"2011","Stevenage 002C","E01023778","Total",1694,178,94,84,1516,169,134,303,212,136,238,324
"2011","Stevenage 002D","E01023799","Total",1378,80,38,42,1298,62,120,218,218,104,216,360
"2011","Stevenage 002E","E01023800","Total",1839,221,94,127,1618,74,252,356,306,101,161,368
"2011","Stevenage 002F","E01023801","Total",2417,185,36,149,2232,276,94,670,412,163,263,354
"2011","Stevenage 003A","E01023771","Total",1601,179,52,127,1422,89,168,358,294,71,144,298
"2011","Stevenage 003B","E01023772","Total",1681,292,75,217,1389,64,142,348,248,79,153,355
"2011","Stevenage 003C","E01023773","Total",1371,119,27,92,1252,147,78,315,194,90,185,243
"2011","Stevenage 003D","E01023774","Total",1585,239,72,167,1346,109,130,380,168,99,203,257
"2011","Stevenage 004A","E01023767","Total",1454,178,26,152,1276,27,100,359,282,47,168,293
"2011","Stevenage 004B","E01023768","Total",1665,173,47,126,1492,38,102,492,324,47,185,304
"2011","Stevenage 004C","E01023769","Total",1659,207,93,114,1452,112,192,365,228,77,132,346
"2011","Stevenage 004D","E01023770","Total",1512,160,41,119,1352,45,164,338,310,41,135,319
"2011","Stevenage 005A","E01023795","Total",1520,213,100,113,1307,91,170,254,256,51,153,332
"2011","Stevenage 005B","E01023796","Total",1459,306,125,181,1153,99,148,282,258,70,98,198
"2011","Stevenage 005C","E01023797","Total",1317,174,83,91,1143,81,102,275,230,82,110,263
"2011","Stevenage 005D","E01023798","Total",1484,177,34,143,1307,107,144,339,298,72,86,261
"2011","Stevenage 006A","E01023775","Total",1880,401,197,204,1479,117,174,349,362,31,162,284
"2011","Stevenage 006B","E01023779","Total",1605,225,92,133,1380,142,100,288,228,92,205,325
"2011","Stevenage 006C","E01023780","Total",1411,256,98,158,1155,58,178,256,168,35,174,286
"2011","Stevenage 006D","E01023781","Total",1681,320,104,216,1361,91,164,358,240,75,207,226
"2011","Stevenage 006E","E01023782","Total",1391,227,103,124,1164,86,192,240,194,20,165,267
"2011","Stevenage 007A","E01023759","Total",1510,159,70,89,1351,108,144,316,190,132,235,226
"2011","Stevenage 007B","E01023760","Total",1543,139,67,72,1404,94,198,287,210,96,176,343
"2011","Stevenage 007C","E01023761","Total",2163,221,73,148,1942,181,160,538,326,158,194,385
"2011","Stevenage 007D","E01023762","Total",1558,163,85,78,1395,95,198,372,210,107,154,259
"2011","Stevenage 008A","E01023755","Total",1610,162,68,94,1448,111,170,310,184,87,265,321
"2011","Stevenage 008B","E01023756","Total",1662,148,60,88,1514,186,102,327,170,166,285,278
"2011","Stevenage 008C","E01023757","Total",1889,217,108,109,1672,152,158,429,190,140,188,415
"2011","Stevenage 008D","E01023758","Total",1848,584,213,371,1264,202,160,293,270,65,85,189
"2011","Stevenage 009A","E01023750","Total",1190,294,106,188,896,74,108,193,184,57,80,200
"2011","Stevenage 009B","E01023751","Total",1202,116,47,69,1086,74,130,277,144,110,129,222
"2011","Stevenage 009C","E01023752","Total",1329,116,57,59,1213,104,118,314,158,101,153,265
"2011","Stevenage 009D","E01023753","Total",1475,200,56,144,1275,46,82,361,282,48,183,273
"2011","Stevenage 009E","E01023754","Total",1368,70,26,44,1298,92,108,359,154,108,240,237
"2011","Stevenage 010A","E01023791","Total",1564,158,94,64,1406,81,170,293,208,93,202,359
"2011","Stevenage 010B","E01023792","Total",1638,137,76,61,1501,159,112,342,190,182,232,284
"2011","Stevenage 010C","E01023793","Total",1441,194,83,111,1247,154,124,309,210,99,130,221
"2011","Stevenage 010D","E01023794","Total",1567,189,74,115,1378,97,120,306,190,155,217,293
"2011","Stevenage 011A","E01023783","Total",1625,228,72,156,1397,81,110,381,262,92,144,327
"2011","Stevenage 011B","E01023784","Total",1619,176,106,70,1443,77,220,363,250,80,160,293
"2011","Stevenage 011C","E01023785","Total",1574,210,76,134,1364,171,118,348,242,71,151,263
"2011","Stevenage 011D","E01023786","Total",1526,182,100,82,1344,117,118,331,220,76,183,299
"2011","Stevenage 012A","E01023763","Total",1483,126,47,79,1357,73,138,317,300,108,101,320
"2011","Stevenage 012B","E01023764","Total",1411,216,101,115,1195,70,134,263,242,31,121,334
"2011","Stevenage 012C","E01023765","Total",1465,169,110,59,1296,74,200,311,152,100,159,300
"2011","Stevenage 012D","E01023766","Total",1530,157,69,88,1373,155,152,323,176,103,158,306
"2011","Three Rivers 001A","E01023802","Total",1723,234,111,123,1489,58,176,480,254,88,154,279
"2011","Three Rivers 001B","E01023803","Total",1526,169,114,55,1357,5,180,367,186,122,194,303
"2011","Three Rivers 001C","E01023804","Total",1475,197,117,80,1278,98,168,265,198,109,156,284
"2011","Three Rivers 001D","E01023807","Total",1510,183,84,99,1327,60,194,281,172,105,241,274
"2011","Three Rivers 001E","E01023808","Total",2527,395,100,295,2132,138,226,557,534,156,201,320
"2011","Three Rivers 002A","E01023829","Total",1708,136,71,65,1572,143,126,325,200,122,324,332
"2011","Three Rivers 002B","E01023830","Total",1411,375,129,246,1036,68,120,285,250,46,97,170
"2011","Three Rivers 002C","E01023832","Total",1682,212,46,166,1470,102,78,421,256,106,229,278
"2011","Three Rivers 002D","E01023833","Total",2318,211,56,155,2107,118,136,729,428,137,225,334
"2011","Three Rivers 002E","E01023834","Total",1561,114,48,66,1447,40,170,348,186,135,224,344
"2011","Three Rivers 003A","E01023823","Total",1355,192,107,85,1163,44,150,285,198,68,161,257
"2011","Three Rivers 003B","E01023824","Total",1936,134,101,33,1802,43,280,459,274,122,277,347
"2011","Three Rivers 003C","E01023831","Total",2009,158,60,98,1851,99,160,508,274,176,247,387
"2011","Three Rivers 003D","E01023854","Total",1849,201,114,87,1648,41,306,383,308,104,147,359
"2011","Three Rivers 004A","E01023812","Total",1459,62,35,27,1397,17,202,248,124,147,260,399
"2011","Three Rivers 004B","E01023813","Total",1474,64,39,25,1410,29,158,278,134,140,308,363
"2011","Three Rivers 004C","E01023814","Total",1092,206,160,46,886,14,156,236,112,46,105,217
"2011","Three Rivers 004D","E01023851","Total",1508,314,112,202,1194,44,140,301,362,57,81,209
"2011","Three Rivers 005A","E01023815","Total",1537,114,53,61,1423,34,242,464,176,142,97,268
"2011","Three Rivers 005B","E01023816","Total",1293,117,67,50,1176,36,196,317,136,155,145,191
"2011","Three Rivers 005C","E01023817","Total",1355,196,90,106,1159,32,154,356,210,66,128,213
"2011","Three Rivers 005D","E01023818","Total",1375,95,69,26,1280,8,208,332,126,127,196,283
"2011","Three Rivers 006A","E01023819","Total",1580,216,93,123,1364,99,116,413,260,75,141,260
"2011","Three Rivers 006B","E01023820","Total",1282,154,103,51,1128,29,194,264,150,74,156,261
"2011","Three Rivers 006C","E01023821","Total",1292,105,68,37,1187,24,148,325,168,89,139,294
"2011","Three Rivers 006D","E01023822","Total",1361,117,75,42,1244,29,160,481,148,36,110,280
"2011","Three Rivers 006E","E01023825","Total",2265,202,69,133,2063,75,204,663,380,102,221,418
"2011","Three Rivers 006F","E01023826","Total",1461,128,68,60,1333,38,142,430,160,114,124,325
"2011","Three Rivers 007A","E01023847","Total",1878,224,58,166,1654,105,110,592,326,119,137,265
"2011","Three Rivers 007B","E01023848","Total",1659,150,65,85,1509,69,146,438,166,168,206,316
"2011","Three Rivers 007C","E01023850","Total",1363,387,137,250,976,46,136,286,332,30,37,109
"2011","Three Rivers 007D","E01023852","Total",1410,168,98,70,1242,50,174,360,218,90,144,206
"2011","Three Rivers 007E","E01023853","Total",2059,110,71,39,1949,25,330,484,226,165,284,435
"2011","Three Rivers 008A","E01023827","Total",2186,251,98,153,1935,221,124,544,242,148,239,417
"2011","Three Rivers 008B","E01023828","Total",1507,191,98,93,1316,123,96,408,168,81,159,281
"2011","Three Rivers 008C","E01023845","Total",1790,144,53,91,1646,159,172,424,260,115,179,337
"2011","Three Rivers 008D","E01023846","Total",1508,105,50,55,1403,43,204,293,190,96,188,389
"2011","Three Rivers 009A","E01023835","Total",1387,118,60,58,1269,52,178,296,182,112,126,323
"2011","Three Rivers 009B","E01023836","Total",1394,217,102,115,1177,74,96,330,282,67,118,210
"2011","Three Rivers 009C","E01023837","Total",1550,177,59,118,1373,67,138,406,280,95,152,235
"2011","Three Rivers 009D","E01023838","Total",1251,114,50,64,1137,122,126,299,180,90,99,221
"2011","Three Rivers 010A","E01023805","Total",1665,184,83,101,1481,152,102,326,170,156,250,325
"2011","Three Rivers 010B","E01023809","Total",1651,267,165,102,1384,69,288,274,232,50,174,297
"2011","Three Rivers 010C","E01023810","Total",1736,198,126,72,1538,31,304,303,192,34,208,466
"2011","Three Rivers 010D","E01023811","Total",1452,162,87,75,1290,25,280,277,210,38,136,324
"2011","Three Rivers 011A","E01023839","Total",2249,94,70,24,2155,21,322,453,194,88,395,682
"2011","Three Rivers 011B","E01023840","Total",1416,132,51,81,1284,23,198,302,194,93,209,265
"2011","Three Rivers 011C","E01023841","Total",1612,76,38,38,1536,15,214,233,152,104,298,520
"2011","Three Rivers 011D","E01023849","Total",1435,158,93,65,1277,25,242,273,230,99,129,279
"2011","Three Rivers 012A","E01023806","Total",2190,260,85,175,1930,141,134,451,264,174,348,418
"2011","Three Rivers 012B","E01023842","Total",1521,196,64,132,1325,150,98,323,154,94,242,264
"2011","Three Rivers 012C","E01023843","Total",1921,302,134,168,1619,172,100,456,242,87,242,320
"2011","Three Rivers 012D","E01023844","Total",1610,352,79,273,1258,200,48,394,230,81,151,154
"2011","Watford 001A","E01023904","Total",1985,198,79,119,1787,132,176,382,260,146,260,431
"2011","Watford 001B","E01023905","Total",1882,314,115,199,1568,114,126,473,316,83,228,228
"2011","Watford 001C","E01023906","Total",1485,206,103,103,1279,120,124,300,198,68,172,297
"2011","Watford 001D","E01023907","Total",1689,270,86,184,1419,64,200,380,254,79,192,250
"2011","Watford 002A","E01023890","Total",1246,157,47,110,1089,30,94,288,188,102,115,272
"2011","Watford 002B","E01023891","Total",1440,105,39,66,1335,151,104,252,144,149,260,275
"2011","Watford 002C","E01023892","Total",1312,132,48,84,1180,89,102,311,160,66,170,282
"2011","Watford 002D","E01023893","Total",1704,229,114,115,1475,64,226,312,220,97,206,350
"2011","Watford 002E","E01023894","Total",1454,95,40,55,1359,55,140,398,192,77,204,293
"2011","Watford 003A","E01023873","Total",1286,178,67,111,1108,114,100,248,150,133,141,222
"2011","Watford 003B","E01023874","Total",1306,124,83,41,1182,72,156,263,100,121,206,264
"2011","Watford 003C","E01023875","Total",1840,259,126,133,1581,56,216,401,308,74,133,393
"2011","Watford 003D","E01023876","Total",1738,214,62,152,1524,299,108,362,180,106,204,265
"2011","Watford 003E","E01023877","Total",1647,200,88,112,1447,85,148,345,204,109,258,298
"2011","Watford 004A","E01023868","Total",1728,201,118,83,1527,91,166,305,188,229,274,274
"2011","Watford 004B","E01023869","Total",1367,129,50,79,1238,69,58,219,180,108,305,299
"2011","Watford 004C","E01023870","Total",1483,107,40,67,1376,114,58,204,108,183,343,366
"2011","Watford 004D","E01023871","Total",1133,178,35,143,955,73,72,264,222,41,117,166
"2011","Watford 004E","E01023872","Total",1706,151,49,102,1555,65,120,398,194,127,252,399
"2011","Watford 005A","E01023895","Total",1604,262,40,222,1342,42,82,408,440,56,104,210
"2011","Watford 005B","E01023896","Total",1341,91,38,53,1250,57,110,310,124,75,243,331
"2011","Watford 005C","E01023897","Total",1586,220,131,89,1366,64,242,257,162,87,206,348
"2011","Watford 005D","E01023898","Total",1569,102,54,48,1467,25,132,443,152,65,209,441
"2011","Watford 006A","E01023855","Total",1813,261,51,210,1552,107,36,470,442,56,100,341
"2011","Watford 006B","E01023856","Total",2279,326,58,268,1953,165,72,558,480,108,234,336
"2011","Watford 006C","E01023857","Total",1656,134,44,90,1522,118,86,243,204,123,423,325
"2011","Watford 006D","E01023858","Total",1696,299,28,271,1397,103,66,439,328,65,124,272
"2011","Watford 007A","E01023878","Total",1944,185,111,74,1759,49,288,381,216,92,260,473
"2011","Watford 007B","E01023879","Total",2116,341,107,234,1775,123,154,554,430,81,178,255
"2011","Watford 007C","E01023880","Total",1748,342,122,220,1406,76,102,333,454,68,122,251
"2011","Watford 007D","E01023881","Total",1550,128,52,76,1422,35,162,361,218,131,160,355
"2011","Watford 008A","E01023886","Total",2709,316,53,263,2393,179,116,673,506,131,385,403
"2011","Watford 008B","E01023887","Total",1698,100,77,23,1598,34,296,390,174,127,184,393
"2011","Watford 008C","E01023888","Total",1580,143,59,84,1437,75,130,295,200,144,275,318
"2011","Watford 008D","E01023889","Total",1774,116,82,34,1658,23,240,450,144,152,283,366
"2011","Watford 009A","E01023859","Total",2072,367,47,320,1705,91,64,596,538,60,126,230
"2011","Watford 009B","E01023860","Total",1827,406,40,366,1421,127,50,323,356,71,158,336
"2011","Watford 009C","E01023861","Total",2191,576,116,460,1615,83,80,286,440,53,289,384
"2011","Watford 009D","E01023862","Total",1963,398,145,253,1565,89,88,459,426,83,120,300
"2011","Watford 010A","E01023899","Total",1501,154,24,130,1347,55,52,312,168,142,338,280
"2011","Watford 010B","E01023900","Total",1728,128,35,93,1600,46,62,279,196,155,430,432
"2011","Watford 010C","E01023901","Total",1909,190,32,158,1719,129,68,477,280,186,295,284
"2011","Watford 010D","E01023902","Total",1510,184,28,156,1326,63,68,328,276,76,211,304
"2011","Watford 010E","E01023903","Total",1554,161,54,107,1393,63,58,354,138,108,431,241
"2011","Watford 011A","E01023863","Total",1720,217,36,181,1503,98,92,355,244,118,250,346
"2011","Watford 011B","E01023864","Total",1455,260,64,196,1195,94,72,282,252,141,173,181
"2011","Watford 011C","E01023865","Total",1661,183,71,112,1478,163,94,325,160,165,329,242
"2011","Watford 011D","E01023866","Total",1553,189,73,116,1364,236,106,333,138,167,212,172
"2011","Watford 011E","E01023867","Total",2105,289,33,256,1816,146,82,486,350,146,231,375
"2011","Watford 012A","E01023882","Total",1556,189,79,110,1367,31,152,379,252,87,138,328
"2011","Watford 012B","E01023883","Total",1656,237,141,96,1419,91,126,295,176,161,277,293
"2011","Watford 012C","E01023884","Total",1709,288,84,204,1421,103,84,487,350,48,122,227
"2011","Watford 012D","E01023885","Total",1801,163,57,106,1638,50,164,414,210,110,262,428
"2011","Welwyn Hatfield 001A","E01023965","Total",1416,84,48,36,1332,19,236,365,186,78,180,268
"2011","Welwyn Hatfield 001B","E01023966","Total",1573,158,90,68,1415,30,284,331,248,67,163,292
"2011","Welwyn Hatfield 001C","E01023967","Total",1314,174,71,103,1140,44,144,331,252,63,91,215
"2011","Welwyn Hatfield 001D","E01023971","Total",1629,105,59,46,1524,19,296,428,202,102,172,305
"2011","Welwyn Hatfield 002B","E01023968","Total",1265,103,68,35,1162,19,254,270,166,45,146,262
"2011","Welwyn Hatfield 002C","E01023969","Total",1363,204,118,86,1159,21,232,258,218,65,146,219
"2011","Welwyn Hatfield 002D","E01023970","Total",1379,202,104,98,1177,103,152,302,150,85,152,233
"2011","Welwyn Hatfield 002E","E01033310","Total",1665,142,26,116,1523,93,80,518,258,119,185,270
"2011","Welwyn Hatfield 002F","E01033313","Total",1469,99,22,77,1370,78,108,352,230,107,223,272
"2011","Welwyn Hatfield 003A","E01023959","Total",1432,112,64,48,1320,24,244,387,190,86,145,244
"2011","Welwyn Hatfield 003B","E01023960","Total",1566,164,91,73,1402,81,212,382,238,83,145,261
"2011","Welwyn Hatfield 003C","E01023961","Total",1427,178,89,89,1249,96,166,348,224,81,97,237
"2011","Welwyn Hatfield 003D","E01023962","Total",1492,126,83,43,1366,49,202,385,160,121,190,259
"2011","Welwyn Hatfield 004A","E01023912","Total",1441,185,80,105,1256,49,158,372,196,52,129,300
"2011","Welwyn Hatfield 004B","E01023913","Total",1348,147,50,97,1201,58,138,319,258,68,134,226
"2011","Welwyn Hatfield 004C","E01023914","Total",1654,259,144,115,1395,74,252,316,232,93,193,235
"2011","Welwyn Hatfield 004D","E01023915","Total",1521,205,69,136,1316,92,106,427,256,104,156,175
"2011","Welwyn Hatfield 005A","E01023950","Total",1580,143,28,115,1437,43,92,369,314,103,168,348
"2011","Welwyn Hatfield 005B","E01023951","Total",1577,356,79,277,1221,113,152,277,234,69,130,246
"2011","Welwyn Hatfield 005C","E01023952","Total",1676,396,158,238,1280,71,98,395,344,41,89,242
"2011","Welwyn Hatfield 005D","E01023953","Total",1428,168,52,116,1260,43,124,383,300,66,97,247
"2011","Welwyn Hatfield 006A","E01023916","Total",1704,201,111,90,1503,89,152,526,224,88,139,285
"2011","Welwyn Hatfield 006B","E01023917","Total",1720,244,122,122,1476,39,246,414,280,88,155,254
"2011","Welwyn Hatfield 006C","E01023918","Total",1728,511,301,210,1217,29,290,265,246,100,123,164
"2011","Welwyn Hatfield 006D","E01023919","Total",1593,74,59,15,1519,42,250,396,176,153,187,315
"2011","Welwyn Hatfield 007A","E01023954","Total",1670,243,83,160,1427,176,94,391,224,139,164,239
"2011","Welwyn Hatfield 007B","E01023955","Total",1382,126,63,63,1256,119,118,366,128,106,189,230
"2011","Welwyn Hatfield 007C","E01023956","Total",1355,121,34,87,1234,114,64,333,194,86,189,254
"2011","Welwyn Hatfield 007D","E01023957","Total",1485,222,35,187,1263,111,50,420,234,83,191,174
"2011","Welwyn Hatfield 007E","E01023958","Total",1439,162,65,97,1277,170,66,310,174,202,153,202
"2011","Welwyn Hatfield 008A","E01023943","Total",1521,157,60,97,1364,104,126,389,184,120,194,247
"2011","Welwyn Hatfield 008B","E01023944","Total",2068,216,99,117,1852,132,190,525,304,176,186,339
"2011","Welwyn Hatfield 008C","E01023945","Total",1594,150,69,81,1444,91,188,420,218,97,122,308
"2011","Welwyn Hatfield 008D","E01023946","Total",1551,232,67,165,1319,43,142,407,214,71,209,233
"2011","Welwyn Hatfield 009A","E01023939","Total",1179,190,114,76,989,56,130,245,156,103,85,214
"2011","Welwyn Hatfield 009B","E01023940","Total",1741,227,104,123,1514,108,178,371,212,129,232,284
"2011","Welwyn Hatfield 009C","E01023941","Total",2794,331,90,241,2463,170,124,857,532,140,262,378
"2011","Welwyn Hatfield 009D","E01023942","Total",1670,135,72,63,1535,104,122,424,194,130,282,279
"2011","Welwyn Hatfield 010A","E01023929","Total",1613,173,90,83,1440,123,138,275,222,114,139,429
"2011","Welwyn Hatfield 010B","E01023930","Total",1628,220,95,125,1408,117,96,364,230,77,186,338
"2011","Welwyn Hatfield 010D","E01023938","Total",1534,116,52,64,1418,40,202,295,262,53,178,388
"2011","Welwyn Hatfield 010E","E01033308","Total",1483,204,3,201,1279,92,18,214,348,21,49,537
"2011","Welwyn Hatfield 010F","E01033311","Total",1523,189,87,102,1334,76,96,338,198,85,146,395
"2011","Welwyn Hatfield 010G","E01033314","Total",2102,112,5,107,1990,117,16,437,162,137,156,965
"2011","Welwyn Hatfield 011A","E01023924","Total",1597,246,112,134,1351,89,70,184,172,38,154,644
"2011","Welwyn Hatfield 011B","E01023925","Total",1215,159,62,97,1056,49,188,234,226,35,88,236
"2011","Welwyn Hatfield 011C","E01023926","Total",1739,201,104,97,1538,46,238,309,280,42,198,425
"2011","Welwyn Hatfield 011D","E01023927","Total",1725,191,75,116,1534,155,110,460,226,91,158,334
"2011","Welwyn Hatfield 012A","E01023920","Total",1559,359,98,261,1200,132,66,243,226,68,141,324
"2011","Welwyn Hatfield 012B","E01023921","Total",2070,320,87,233,1750,137,114,342,300,32,151,674
"2011","Welwyn Hatfield 012C","E01023922","Total",1768,156,64,92,1612,123,120,333,160,75,213,588
"2011","Welwyn Hatfield 012D","E01023923","Total",1847,171,78,93,1676,88,180,212,224,63,201,708
"2011","Welwyn Hatfield 013A","E01023932","Total",1708,131,55,76,1577,103,102,153,156,77,197,789
"2011","Welwyn Hatfield 013B","E01023934","Total",1469,99,26,73,1370,61,50,217,146,88,97,711
"2011","Welwyn Hatfield 013C","E01023935","Total",1334,105,65,40,1229,39,114,146,80,46,127,677
"2011","Welwyn Hatfield 013D","E01023936","Total",2173,192,82,110,1981,153,164,315,200,99,264,786
"2011","Welwyn Hatfield 013E","E01023937","Total",1333,169,91,78,1164,38,82,117,118,64,114,631
"2011","Welwyn Hatfield 014A","E01023933","Total",1510,221,104,117,1289,99,106,214,210,85,103,472
"2011","Welwyn Hatfield 014B","E01023963","Total",2236,390,184,206,1846,102,262,395,328,116,210,433
"2011","Welwyn Hatfield 014C","E01023964","Total",1411,188,93,95,1223,40,250,244,182,47,142,318
"2011","Welwyn Hatfield 015A","E01023908","Total",1542,133,71,62,1409,34,248,323,162,82,178,382
"2011","Welwyn Hatfield 015B","E01023909","Total",1179,62,34,28,1117,18,188,252,108,108,176,267
"2011","Welwyn Hatfield 015C","E01023910","Total",1371,102,64,38,1269,19,192,271,180,66,194,347
"2011","Welwyn Hatfield 015D","E01023911","Total",1572,193,121,72,1379,75,270,359,208,81,91,295
"2011","Welwyn Hatfield 016A","E01023947","Total",1606,229,115,114,1377,61,214,278,254,115,190,265
"2011","Welwyn Hatfield 016B","E01023948","Total",1610,137,88,49,1473,17,320,295,176,92,172,401
"2011","Welwyn Hatfield 016C","E01023949","Total",1964,113,81,32,1851,18,424,419,226,156,227,381
"2011","Breckland 001A","E01026436","Total",2235,242,138,104,1993,77,372,396,420,122,188,418
"2011","Breckland 001C","E01026461","Total",1281,137,93,44,1144,31,280,210,250,62,78,233
"2011","Breckland 001E","E01026483","Total",1113,134,76,58,979,29,188,218,208,53,93,190
"2011","Breckland 001F","E01033042","Total",2095,183,96,87,1912,75,288,517,432,132,201,267
"2011","Breckland 002A","E01026442","Total",2128,230,150,80,1898,69,440,432,352,83,202,320
"2011","Breckland 002B","E01026443","Total",2095,192,106,86,1903,61,320,380,310,157,296,379
"2011","Breckland 002C","E01026445","Total",2220,257,147,110,1963,92,510,380,394,80,197,310
"2011","Breckland 002D","E01026462","Total",2200,198,113,85,2002,86,444,411,412,110,167,372
"2011","Breckland 003A","E01026428","Total",2711,236,104,132,2475,184,308,661,400,155,277,490
"2011","Breckland 003B","E01026429","Total",1495,252,141,111,1243,58,204,301,274,57,128,221
"2011","Breckland 003C","E01026430","Total",1678,150,103,47,1528,51,330,334,270,98,240,205
"2011","Breckland 003D","E01026431","Total",1087,145,106,39,942,35,216,197,184,57,88,165
"2011","Breckland 004A","E01026446","Total",1911,246,177,69,1665,39,524,280,268,98,142,314
"2011","Breckland 004B","E01026452","Total",1648,177,99,78,1471,35,322,311,290,107,177,229
"2011","Breckland 004C","E01026453","Total",1531,142,86,56,1389,41,230,266,282,85,186,299
"2011","Breckland 004D","E01026454","Total",1668,107,30,77,1561,80,112,438,322,119,235,255
"2011","Breckland 005A","E01026425","Total",1916,272,168,104,1644,157,312,300,264,160,202,249
"2011","Breckland 005B","E01026426","Total",2356,488,183,305,1868,169,232,458,470,79,232,228
"2011","Breckland 005C","E01026427","Total",2173,237,138,99,1936,118,436,413,340,161,168,300
"2011","Breckland 005D","E01026432","Total",1464,160,96,64,1304,50,286,321,236,57,109,245
"2011","Breckland 005E","E01026433","Total",1470,167,47,120,1303,102,88,399,312,109,144,149
"2011","Breckland 005F","E01026434","Total",1970,255,140,115,1715,93,370,369,424,80,117,262
"2011","Breckland 006A","E01026479","Total",1489,177,99,78,1312,24,254,233,236,82,183,300
"2011","Breckland 006B","E01026480","Total",1451,185,100,85,1266,47,286,279,256,58,93,247
"2011","Breckland 006C","E01026481","Total",1188,104,45,59,1084,61,162,220,224,84,135,198
"2011","Breckland 006D","E01026484","Total",1370,157,84,73,1213,18,226,302,220,91,136,220
"2011","Breckland 006E","E01026485","Total",1089,96,44,52,993,35,204,223,196,42,115,178
"2011","Breckland 007A","E01026455","Total",1786,274,169,105,1512,127,308,338,242,89,132,276
"2011","Breckland 007B","E01026456","Total",1090,134,88,46,956,31,234,180,194,30,103,184
"2011","Breckland 007C","E01026457","Total",1237,171,137,34,1066,13,392,135,214,28,65,219
"2011","Breckland 007D","E01026458","Total",1498,211,121,90,1287,118,212,315,246,65,135,196
"2011","Breckland 007E","E01026459","Total",1390,223,145,78,1167,72,304,208,218,70,112,183
"2011","Breckland 008A","E01026437","Total",1178,138,88,50,1040,11,322,190,216,64,99,138
"2011","Breckland 008B","E01026438","Total",1027,93,51,42,934,52,194,151,190,64,106,177
"2011","Breckland 008C","E01026451","Total",2027,231,137,94,1796,65,416,323,348,114,234,296
"2011","Breckland 008D","E01026495","Total",1287,155,102,53,1132,39,258,227,238,76,124,170
"2011","Breckland 008E","E01026496","Total",1068,150,101,49,918,18,282,154,154,69,72,169
"2011","Breckland 009A","E01026486","Total",1520,197,119,78,1323,87,416,211,206,63,121,219
"2011","Breckland 009B","E01026487","Total",1573,116,54,62,1457,99,160,411,292,83,159,253
"2011","Breckland 009C","E01026488","Total",1068,257,125,132,811,63,136,162,156,21,95,178
"2011","Breckland 009D","E01026489","Total",1340,191,137,54,1149,35,374,193,158,49,95,245
"2011","Breckland 009E","E01026490","Total",1568,213,150,63,1355,36,398,286,226,25,130,254
"2011","Breckland 010A","E01026419","Total",1211,102,63,39,1109,20,164,214,216,60,183,252
"2011","Breckland 010B","E01026420","Total",1132,95,47,48,1037,26,190,244,212,57,105,203
"2011","Breckland 010D","E01026464","Total",1266,84,37,47,1182,47,218,252,230,64,166,205
"2011","Breckland 010E","E01026491","Total",2148,217,103,114,1931,35,344,381,432,97,239,403
"2011","Breckland 010F","E01033040","Total",1116,72,9,63,1044,134,32,337,168,155,114,104
"2011","Breckland 010G","E01033041","Total",1021,105,20,85,916,50,48,237,184,92,121,184
"2011","Breckland 011A","E01026422","Total",1946,266,168,98,1680,42,478,354,314,54,132,306
"2011","Breckland 011B","E01026423","Total",1784,205,82,123,1579,107,180,376,326,127,204,259
"2011","Breckland 011C","E01026447","Total",1511,271,136,135,1240,112,152,315,286,61,161,153
"2011","Breckland 011D","E01026449","Total",1888,200,101,99,1688,93,194,403,368,107,196,327
"2011","Breckland 011E","E01026450","Total",1731,187,89,98,1544,51,240,459,264,79,153,298
"2011","Breckland 012A","E01026424","Total",2050,220,134,86,1830,59,366,383,378,130,236,278
"2011","Breckland 012B","E01026444","Total",2013,236,110,126,1777,68,354,373,392,88,177,325
"2011","Breckland 012C","E01026492","Total",1291,148,68,80,1143,32,208,314,236,118,52,183
"2011","Breckland 012D","E01026493","Total",1108,125,58,67,983,56,248,170,198,39,88,184
"2011","Breckland 013A","E01026421","Total",1704,204,116,88,1500,60,292,299,270,108,171,300
"2011","Breckland 013B","E01026435","Total",2160,193,82,111,1967,45,286,436,378,192,243,387
"2011","Breckland 013C","E01026448","Total",2240,157,80,77,2083,95,270,625,352,140,219,382
"2011","Breckland 014A","E01026439","Total",1533,178,89,89,1355,42,310,274,302,45,141,241
"2011","Breckland 014B","E01026440","Total",1186,101,37,64,1085,42,128,240,204,105,168,198
"2011","Breckland 014C","E01026441","Total",1532,165,99,66,1367,59,316,263,216,69,177,267
"2011","Breckland 014D","E01026494","Total",2208,218,104,114,1990,71,396,394,412,115,242,360
"2011","Breckland 015A","E01026465","Total",1796,245,110,135,1551,162,214,312,242,97,205,319
"2011","Breckland 015B","E01026466","Total",1914,179,70,109,1735,123,124,366,232,122,347,421
"2011","Breckland 015C","E01026467","Total",2189,155,41,114,2034,379,86,392,220,305,354,298
"2011","Breckland 016A","E01026468","Total",2232,335,158,177,1897,91,310,357,454,100,153,432
"2011","Breckland 016B","E01026469","Total",1584,178,96,82,1406,43,204,339,260,59,209,292
"2011","Breckland 016C","E01026470","Total",2758,182,47,135,2576,89,158,823,602,140,320,444
"2011","Breckland 016D","E01026471","Total",1240,127,28,99,1113,50,118,266,228,74,157,220
"2011","Breckland 016E","E01026472","Total",1206,84,32,52,1122,47,166,277,254,51,80,247
"2011","Breckland 016F","E01026473","Total",1474,96,37,59,1378,69,162,420,244,94,161,228
"2011","Breckland 017A","E01026474","Total",1690,150,75,75,1540,110,204,351,262,139,186,288
"2011","Breckland 017B","E01026475","Total",1471,163,83,80,1308,83,206,265,260,57,192,245
"2011","Breckland 017C","E01026476","Total",1475,122,50,72,1353,130,134,241,200,126,217,305
"2011","Breckland 017D","E01026477","Total",1447,146,86,60,1301,156,134,296,182,77,200,256
"2011","Breckland 017E","E01026478","Total",1688,159,87,72,1529,191,134,240,218,206,268,272
"2011","Broadland 001A","E01026499","Total",1498,329,198,131,1169,84,240,222,238,79,75,231
"2011","Broadland 001B","E01026500","Total",1701,188,114,74,1513,54,330,412,270,72,134,241
"2011","Broadland 001C","E01026501","Total",1523,181,95,86,1342,43,300,200,292,85,141,281
"2011","Broadland 001D","E01026502","Total",1143,143,68,75,1000,41,210,194,240,95,65,155
"2011","Broadland 001E","E01026503","Total",1389,191,123,68,1198,37,318,232,234,42,87,248
"2011","Broadland 002A","E01026522","Total",1424,161,91,70,1263,75,184,303,230,93,167,211
"2011","Broadland 002B","E01026523","Total",1862,194,94,100,1668,111,238,400,274,111,170,364
"2011","Broadland 002C","E01026524","Total",1440,142,73,69,1298,41,234,270,314,72,144,223
"2011","Broadland 002D","E01026525","Total",1068,83,30,53,985,30,196,162,244,68,107,178
"2011","Broadland 002E","E01026547","Total",1419,214,105,109,1205,58,206,289,228,85,130,209
"2011","Broadland 002F","E01026548","Total",1290,128,75,53,1162,101,176,270,194,83,121,217
"2011","Broadland 003A","E01026514","Total",1497,139,62,77,1358,73,226,331,306,72,161,189
"2011","Broadland 003B","E01026515","Total",1079,105,65,40,974,28,172,231,196,56,88,203
"2011","Broadland 003C","E01026516","Total",1242,182,101,81,1060,39,186,183,218,82,129,223
"2011","Broadland 003D","E01026517","Total",1366,168,101,67,1198,46,224,263,254,94,114,203
"2011","Broadland 004A","E01026533","Total",1190,134,62,72,1056,19,234,181,208,69,99,246
"2011","Broadland 004B","E01026534","Total",1623,119,49,70,1504,79,206,353,262,154,174,276
"2011","Broadland 004C","E01026535","Total",1656,131,56,75,1525,83,218,337,292,106,139,350
"2011","Broadland 004D","E01026536","Total",1668,133,72,61,1535,54,204,400,286,125,159,307
"2011","Broadland 004E","E01026537","Total",1475,109,26,83,1366,71,80,514,310,82,127,182
"2011","Broadland 005A","E01026549","Total",1720,257,128,129,1463,65,288,301,316,86,144,263
"2011","Broadland 005B","E01026550","Total",1131,96,33,63,1035,47,104,249,186,66,155,228
"2011","Broadland 005C","E01026551","Total",1128,131,59,72,997,26,170,263,228,35,101,174
"2011","Broadland 005D","E01026552","Total",1395,144,96,48,1251,11,290,268,242,47,116,277
"2011","Broadland 006A","E01026562","Total",1184,73,29,44,1111,35,162,374,184,57,125,174
"2011","Broadland 006B","E01026563","Total",1407,136,21,115,1271,102,60,395,240,89,147,238
"2011","Broadland 006C","E01026564","Total",1488,105,40,65,1383,65,172,467,196,50,193,240
"2011","Broadland 006D","E01026565","Total",1165,164,20,144,1001,88,40,320,252,59,115,127
"2011","Broadland 006E","E01026566","Total",1440,173,74,99,1267,95,208,301,278,51,134,200
"2011","Broadland 006F","E01026567","Total",1634,207,152,55,1427,43,440,250,258,52,117,267
"2011","Broadland 006G","E01026568","Total",1580,122,71,51,1458,44,194,391,276,62,174,317
"2011","Broadland 007A","E01026518","Total",1395,118,40,78,1277,103,80,478,214,98,143,161
"2011","Broadland 007B","E01026519","Total",1707,210,61,149,1497,101,124,458,352,92,160,210
"2011","Broadland 007C","E01026520","Total",1077,140,104,36,937,40,266,161,180,5,84,201
"2011","Broadland 007D","E01026521","Total",1175,101,68,33,1074,33,302,225,176,21,109,208
"2011","Broadland 008A","E01026545","Total",1592,143,57,86,1449,84,198,483,274,111,134,165
"2011","Broadland 008B","E01026546","Total",1502,86,46,40,1416,37,248,329,248,88,124,342
"2011","Broadland 008C","E01026578","Total",1931,143,65,78,1788,111,250,534,310,167,134,282
"2011","Broadland 008D","E01026579","Total",1474,116,60,56,1358,55,312,240,312,36,90,313
"2011","Broadland 008E","E01026580","Total",1535,204,144,60,1331,65,410,198,228,76,131,223
"2011","Broadland 009A","E01026540","Total",1444,169,117,52,1275,15,280,240,288,86,123,243
"2011","Broadland 009B","E01026541","Total",2402,270,119,151,2132,165,258,623,448,182,151,305
"2011","Broadland 009C","E01026542","Total",1475,172,105,67,1303,50,280,261,238,69,112,293
"2011","Broadland 009D","E01026543","Total",1422,166,97,69,1256,37,264,248,266,52,130,259
"2011","Broadland 009E","E01026544","Total",1675,178,57,121,1497,66,194,419,372,51,97,298
"2011","Broadland 010A","E01026526","Total",1421,185,117,68,1236,29,288,229,244,83,86,277
"2011","Broadland 010B","E01026527","Total",1454,183,136,47,1271,24,386,204,220,62,84,291
"2011","Broadland 010C","E01026528","Total",1311,174,123,51,1137,53,296,182,192,36,86,292
"2011","Broadland 010D","E01026529","Total",1543,244,135,109,1299,65,230,223,282,65,135,299
"2011","Broadland 011A","E01026530","Total",1705,196,108,88,1509,46,314,266,298,82,140,363
"2011","Broadland 011B","E01026531","Total",1690,206,143,63,1484,23,334,299,280,76,170,302
"2011","Broadland 011C","E01026532","Total",1689,215,107,108,1474,45,266,319,254,70,161,359
"2011","Broadland 012A","E01026553","Total",1348,207,95,112,1141,62,176,286,224,68,120,205
"2011","Broadland 012B","E01026554","Total",1165,127,61,66,1038,41,146,240,252,16,107,236
"2011","Broadland 012C","E01026555","Total",1510,141,80,61,1369,42,252,255,214,130,158,318
"2011","Broadland 012D","E01026556","Total",1421,177,65,112,1244,86,186,275,306,38,138,215
"2011","Broadland 013A","E01026557","Total",1368,207,116,91,1161,9,262,219,252,52,95,272
"2011","Broadland 013B","E01026558","Total",1276,184,114,70,1092,39,276,201,268,31,68,209
"2011","Broadland 013C","E01026559","Total",1479,154,93,61,1325,43,268,261,230,41,159,323
"2011","Broadland 013D","E01026560","Total",1340,189,137,52,1151,27,344,245,200,43,84,208
"2011","Broadland 013E","E01026561","Total",1366,184,121,63,1182,22,350,188,250,20,87,265
"2011","Broadland 014A","E01026504","Total",1501,127,67,60,1374,35,278,323,292,69,153,224
"2011","Broadland 014B","E01026505","Total",1356,171,103,68,1185,40,248,304,242,76,98,177
"2011","Broadland 014C","E01026506","Total",1365,136,83,53,1229,36,308,274,216,52,98,245
"2011","Broadland 014D","E01026507","Total",1323,148,88,60,1175,48,214,290,210,82,66,265
"2011","Broadland 014E","E01026512","Total",1280,146,83,63,1134,45,184,254,260,70,143,178
"2011","Broadland 014F","E01026513","Total",1344,148,76,72,1196,73,216,329,216,70,101,191
"2011","Broadland 015A","E01026569","Total",1427,298,199,99,1129,39,244,275,220,52,92,207
"2011","Broadland 015B","E01026570","Total",1574,214,151,63,1360,40,328,349,258,57,94,234
"2011","Broadland 015C","E01026571","Total",1469,210,133,77,1259,36,196,315,264,77,146,225
"2011","Broadland 015D","E01026572","Total",1456,175,101,74,1281,44,240,332,244,43,118,260
"2011","Broadland 015E","E01026573","Total",1370,201,129,72,1169,68,254,223,210,102,110,202
"2011","Broadland 016A","E01026574","Total",1734,146,47,99,1588,115,124,503,308,107,173,258
"2011","Broadland 016B","E01026575","Total",1638,218,104,114,1420,80,278,335,258,112,116,241
"2011","Broadland 016C","E01026576","Total",2057,175,30,145,1882,124,78,718,410,126,175,251
"2011","Broadland 016D","E01026577","Total",1658,253,88,165,1405,71,250,364,332,52,81,255
"2011","Broadland 017A","E01026508","Total",1408,183,112,71,1225,68,254,263,252,65,117,206
"2011","Broadland 017B","E01026509","Total",1580,169,91,78,1411,23,270,314,304,56,141,303
"2011","Broadland 017C","E01026510","Total",1542,193,106,87,1349,44,296,290,294,50,111,264
"2011","Broadland 017D","E01026511","Total",1141,89,48,41,1052,66,144,156,270,64,141,211
"2011","Broadland 018A","E01026497","Total",1467,211,117,94,1256,47,280,329,250,31,96,223
"2011","Broadland 018B","E01026498","Total",1323,216,153,63,1107,75,210,215,180,92,104,231
"2011","Broadland 018C","E01026538","Total",1526,160,83,77,1366,75,250,255,292,131,145,218
"2011","Broadland 018D","E01026539","Total",1675,129,61,68,1546,72,260,348,330,121,160,255
"2011","Great Yarmouth 001A","E01026605","Total",1570,160,102,58,1410,38,366,258,278,69,82,319
"2011","Great Yarmouth 001B","E01026606","Total",1548,204,126,78,1344,59,328,153,280,59,185,280
"2011","Great Yarmouth 001C","E01026607","Total",1595,200,110,90,1395,68,288,308,248,74,139,270
"2011","Great Yarmouth 001D","E01026627","Total",1388,158,112,46,1230,45,298,245,232,51,84,275
"2011","Great Yarmouth 001E","E01026628","Total",1381,145,88,57,1236,49,244,205,248,53,140,297
"2011","Great Yarmouth 001F","E01026629","Total",1473,175,98,77,1298,65,218,303,214,43,182,273
"2011","Great Yarmouth 002A","E01026608","Total",1257,119,69,50,1138,34,206,234,198,58,128,280
"2011","Great Yarmouth 002B","E01026609","Total",1169,111,47,64,1058,36,144,210,262,61,114,231
"2011","Great Yarmouth 002C","E01026636","Total",1525,180,116,64,1345,35,312,242,272,60,149,275
"2011","Great Yarmouth 002D","E01026637","Total",1965,174,104,70,1791,51,416,284,340,114,210,376
"2011","Great Yarmouth 002E","E01026638","Total",1562,169,93,76,1393,108,202,312,196,92,227,256
"2011","Great Yarmouth 003A","E01026589","Total",1412,175,86,89,1237,78,204,283,204,51,135,282
"2011","Great Yarmouth 003B","E01026590","Total",1382,201,112,89,1181,59,326,193,272,26,98,207
"2011","Great Yarmouth 003C","E01026591","Total",1745,233,154,79,1512,60,356,292,302,56,125,321
"2011","Great Yarmouth 003D","E01026592","Total",1449,228,160,68,1221,50,390,128,202,15,134,302
"2011","Great Yarmouth 003E","E01026593","Total",1314,157,102,55,1157,30,314,201,190,36,122,264
"2011","Great Yarmouth 003F","E01026594","Total",1720,248,136,112,1472,121,256,314,224,74,238,245
"2011","Great Yarmouth 004A","E01026599","Total",1408,176,55,121,1232,79,138,204,196,136,222,257
"2011","Great Yarmouth 004B","E01026639","Total",1536,132,59,73,1404,50,212,216,224,90,239,373
"2011","Great Yarmouth 004C","E01026640","Total",1577,276,212,64,1301,72,368,179,190,90,147,255
"2011","Great Yarmouth 004D","E01026641","Total",1507,191,124,67,1316,164,160,281,160,103,193,255
"2011","Great Yarmouth 005A","E01026595","Total",1638,292,116,176,1346,166,188,344,274,62,106,206
"2011","Great Yarmouth 005B","E01026596","Total",1654,192,103,89,1462,75,194,328,238,145,195,287
"2011","Great Yarmouth 005C","E01026597","Total",1845,382,101,281,1463,170,120,343,284,125,227,194
"2011","Great Yarmouth 005D","E01026598","Total",1546,275,65,210,1271,147,94,227,268,33,224,278
"2011","Great Yarmouth 006A","E01026622","Total",1642,171,96,75,1471,211,122,304,182,277,172,203
"2011","Great Yarmouth 006B","E01026623","Total",1470,255,73,182,1215,94,102,199,230,82,144,364
"2011","Great Yarmouth 006C","E01026624","Total",1748,366,129,237,1382,190,116,270,280,92,215,219
"2011","Great Yarmouth 006D","E01026625","Total",1795,291,101,190,1504,246,118,321,192,220,221,186
"2011","Great Yarmouth 006E","E01026626","Total",1863,327,88,239,1536,192,160,317,340,110,168,249
"2011","Great Yarmouth 007A","E01026600","Total",1477,202,101,101,1275,126,126,274,210,125,178,236
"2011","Great Yarmouth 007B","E01026633","Total",1848,194,50,144,1654,147,124,407,260,162,213,341
"2011","Great Yarmouth 007C","E01026634","Total",1543,167,54,113,1376,150,104,315,214,176,189,228
"2011","Great Yarmouth 007D","E01026635","Total",2237,283,86,197,1954,239,142,548,382,125,236,282
"2011","Great Yarmouth 008A","E01026581","Total",1686,132,52,80,1554,69,188,428,256,90,228,295
"2011","Great Yarmouth 008B","E01026582","Total",1926,224,114,110,1702,63,332,449,328,76,158,296
"2011","Great Yarmouth 008C","E01026583","Total",1286,162,80,82,1124,68,188,218,198,52,131,269
"2011","Great Yarmouth 008D","E01026584","Total",1496,164,122,42,1332,62,386,238,210,66,95,275
"2011","Great Yarmouth 009A","E01026601","Total",1490,185,78,107,1305,130,148,310,298,78,111,230
"2011","Great Yarmouth 009B","E01026602","Total",1481,240,157,83,1241,94,262,220,236,46,127,256
"2011","Great Yarmouth 009C","E01026603","Total",1657,224,86,138,1433,265,146,350,220,78,128,246
"2011","Great Yarmouth 009D","E01026604","Total",1575,266,107,159,1309,172,192,261,188,74,205,217
"2011","Great Yarmouth 009E","E01026632","Total",1655,287,147,140,1368,158,194,244,306,81,159,226
"2011","Great Yarmouth 010A","E01026610","Total",1528,227,63,164,1301,124,132,325,206,89,151,274
"2011","Great Yarmouth 010B","E01026611","Total",1383,220,134,86,1163,23,272,182,224,55,133,274
"2011","Great Yarmouth 010C","E01026612","Total",2495,306,203,103,2189,127,410,487,320,136,298,411
"2011","Great Yarmouth 010D","E01026630","Total",1737,159,74,85,1578,187,124,332,230,168,217,320
"2011","Great Yarmouth 010E","E01026631","Total",1716,247,76,171,1469,179,200,373,274,98,118,227
"2011","Great Yarmouth 011A","E01026617","Total",1273,176,124,52,1097,71,254,205,180,62,111,214
"2011","Great Yarmouth 011B","E01026618","Total",1574,201,95,106,1373,58,242,323,208,76,152,314
"2011","Great Yarmouth 011C","E01026619","Total",1493,149,86,63,1344,149,172,291,174,163,182,213
"2011","Great Yarmouth 011D","E01026620","Total",1400,259,186,73,1141,101,172,186,158,138,170,216
"2011","Great Yarmouth 011E","E01026621","Total",1453,124,83,41,1329,86,172,244,154,106,226,341
"2011","Great Yarmouth 012A","E01026613","Total",1296,142,72,70,1154,19,204,218,264,74,116,259
"2011","Great Yarmouth 012B","E01026614","Total",1579,215,89,126,1364,27,282,197,298,43,176,341
"2011","Great Yarmouth 012C","E01026615","Total",1348,106,60,46,1242,46,232,193,272,88,142,269
"2011","Great Yarmouth 012D","E01026616","Total",1226,112,46,66,1114,58,118,298,216,63,139,222
"2011","Great Yarmouth 013A","E01026585","Total",1284,179,120,59,1105,44,268,239,190,35,112,217
"2011","Great Yarmouth 013B","E01026586","Total",1048,171,119,52,877,75,214,159,142,38,81,168
"2011","Great Yarmouth 013C","E01026587","Total",1748,164,88,76,1584,52,280,454,262,66,150,320
"2011","Great Yarmouth 013D","E01026588","Total",2608,321,155,166,2287,101,456,538,412,171,198,411
"2011","King's Lynn and West Norfolk 001A","E01026680","Total",1424,307,217,90,1117,27,494,121,202,37,106,130
"2011","King's Lynn and West Norfolk 001B","E01026681","Total",1401,213,129,84,1188,32,422,177,228,59,90,180
"2011","King's Lynn and West Norfolk 001C","E01026682","Total",1127,198,142,56,929,36,272,135,184,27,111,164
"2011","King's Lynn and West Norfolk 001D","E01026683","Total",1279,257,117,140,1022,56,236,149,260,56,77,188
"2011","King's Lynn and West Norfolk 002A","E01026645","Total",1289,221,137,84,1068,22,392,127,266,26,59,176
"2011","King's Lynn and West Norfolk 002B","E01026646","Total",1714,298,180,118,1416,51,454,237,246,111,92,225
"2011","King's Lynn and West Norfolk 002C","E01026656","Total",1884,224,126,98,1660,68,384,327,330,100,145,306
"2011","King's Lynn and West Norfolk 002D","E01026695","Total",2128,275,157,118,1853,57,478,389,390,80,144,315
"2011","King's Lynn and West Norfolk 003A","E01026676","Total",1644,249,159,90,1395,61,516,167,278,62,79,232
"2011","King's Lynn and West Norfolk 003B","E01026677","Total",1478,290,184,106,1188,66,272,239,222,41,158,190
"2011","King's Lynn and West Norfolk 003C","E01026678","Total",1519,258,176,82,1261,40,444,168,238,70,109,192
"2011","King's Lynn and West Norfolk 003D","E01026701","Total",1574,231,159,72,1343,56,478,171,310,38,100,190
"2011","King's Lynn and West Norfolk 003E","E01026702","Total",1245,236,137,99,1009,58,258,177,218,31,120,147
"2011","King's Lynn and West Norfolk 003F","E01026703","Total",1165,142,79,63,1023,46,234,203,236,66,87,151
"2011","King's Lynn and West Norfolk 004A","E01026653","Total",1740,240,162,78,1500,51,498,284,300,49,73,245
"2011","King's Lynn and West Norfolk 004B","E01026654","Total",1535,257,150,107,1278,68,354,252,226,78,153,147
"2011","King's Lynn and West Norfolk 004C","E01026655","Total",1343,220,130,90,1123,39,364,174,218,71,89,168
"2011","King's Lynn and West Norfolk 004D","E01026718","Total",2256,263,148,115,1993,65,482,325,436,149,171,365
"2011","King's Lynn and West Norfolk 005A","E01026691","Total",1158,79,46,33,1079,43,182,287,184,67,94,222
"2011","King's Lynn and West Norfolk 005B","E01026692","Total",1271,115,43,72,1156,59,160,295,226,66,149,201
"2011","King's Lynn and West Norfolk 005C","E01026708","Total",1355,103,72,31,1252,53,294,266,206,50,149,234
"2011","King's Lynn and West Norfolk 005D","E01026709","Total",1879,149,100,49,1730,87,324,461,322,108,134,294
"2011","King's Lynn and West Norfolk 005E","E01026710","Total",1151,90,52,38,1061,26,230,213,212,48,82,250
"2011","King's Lynn and West Norfolk 006A","E01026669","Total",1623,206,129,77,1417,53,360,255,288,30,125,306
"2011","King's Lynn and West Norfolk 006B","E01026670","Total",1525,133,39,94,1392,100,128,404,206,100,178,276
"2011","King's Lynn and West Norfolk 006C","E01026671","Total",1407,86,46,40,1321,52,182,295,226,98,123,345
"2011","King's Lynn and West Norfolk 006D","E01026672","Total",1493,163,95,68,1330,38,224,230,226,82,178,352
"2011","King's Lynn and West Norfolk 006E","E01026673","Total",1533,144,52,92,1389,75,148,405,308,93,97,263
"2011","King's Lynn and West Norfolk 007A","E01026687","Total",1543,219,125,94,1324,145,132,361,180,53,197,256
"2011","King's Lynn and West Norfolk 007B","E01026688","Total",1485,89,45,44,1396,162,70,337,174,148,224,281
"2011","King's Lynn and West Norfolk 007C","E01026689","Total",1525,188,68,120,1337,108,84,230,314,72,193,336
"2011","King's Lynn and West Norfolk 007D","E01026690","Total",1478,163,57,106,1315,127,124,291,148,175,178,272
"2011","King's Lynn and West Norfolk 008A","E01026647","Total",2171,210,123,87,1961,62,486,299,352,93,282,387
"2011","King's Lynn and West Norfolk 008B","E01026711","Total",1522,139,60,79,1383,89,174,306,234,131,170,279
"2011","King's Lynn and West Norfolk 008C","E01026712","Total",1639,159,92,67,1480,60,280,318,288,73,161,300
"2011","King's Lynn and West Norfolk 008D","E01026713","Total",1500,129,70,59,1371,26,270,222,318,81,167,287
"2011","King's Lynn and West Norfolk 009A","E01026666","Total",1891,216,102,114,1675,87,168,361,188,157,366,348
"2011","King's Lynn and West Norfolk 009B","E01026667","Total",1533,200,78,122,1333,64,180,299,262,37,141,350
"2011","King's Lynn and West Norfolk 009C","E01026668","Total",1558,176,64,112,1382,53,180,271,236,109,213,320
"2011","King's Lynn and West Norfolk 009D","E01026693","Total",1890,244,122,122,1646,76,266,360,302,95,216,331
"2011","King's Lynn and West Norfolk 010A","E01026662","Total",2483,192,37,155,2291,281,148,636,366,213,335,312
"2011","King's Lynn and West Norfolk 010B","E01026663","Total",1787,223,130,93,1564,133,140,378,196,194,245,278
"2011","King's Lynn and West Norfolk 010C","E01026664","Total",2202,249,63,186,1953,117,160,573,480,82,208,333
"2011","King's Lynn and West Norfolk 010D","E01026714","Total",1946,184,85,99,1762,73,254,447,318,78,207,385
"2011","King's Lynn and West Norfolk 011A","E01026698","Total",1895,491,216,275,1404,66,238,215,404,61,135,285
"2011","King's Lynn and West Norfolk 011B","E01026699","Total",1505,477,167,310,1028,56,96,265,260,56,98,197
"2011","King's Lynn and West Norfolk 011C","E01026700","Total",1400,309,89,220,1091,61,80,192,274,69,105,310
"2011","King's Lynn and West Norfolk 011D","E01026704","Total",1828,159,51,108,1669,128,146,326,248,265,200,356
"2011","King's Lynn and West Norfolk 011E","E01026705","Total",1575,154,67,87,1421,63,208,393,236,161,120,240
"2011","King's Lynn and West Norfolk 011F","E01026706","Total",1568,142,49,93,1426,65,196,309,256,99,161,340
"2011","King's Lynn and West Norfolk 012A","E01026665","Total",2218,275,147,128,1943,52,394,507,392,88,174,336
"2011","King's Lynn and West Norfolk 012B","E01026674","Total",1117,105,63,42,1012,31,242,155,200,48,96,240
"2011","King's Lynn and West Norfolk 012C","E01026675","Total",1216,107,62,45,1109,34,202,293,218,36,95,231
"2011","King's Lynn and West Norfolk 012D","E01026694","Total",2427,303,170,133,2124,65,448,466,430,101,201,413
"2011","King's Lynn and West Norfolk 013A","E01026684","Total",1160,92,39,53,1068,28,160,166,230,92,174,218
"2011","King's Lynn and West Norfolk 013B","E01026685","Total",1276,147,88,59,1129,56,246,217,198,31,123,258
"2011","King's Lynn and West Norfolk 013C","E01026719","Total",2318,175,86,89,2143,72,344,406,398,219,266,438
"2011","King's Lynn and West Norfolk 013D","E01026720","Total",1324,112,65,47,1212,32,196,233,196,65,175,315
"2011","King's Lynn and West Norfolk 013E","E01026721","Total",1299,116,71,45,1183,50,216,215,168,94,182,258
"2011","King's Lynn and West Norfolk 014A","E01026642","Total",1287,130,76,54,1157,36,294,229,228,68,114,188
"2011","King's Lynn and West Norfolk 014B","E01026643","Total",1400,132,68,64,1268,34,260,232,260,56,124,302
"2011","King's Lynn and West Norfolk 014C","E01026644","Total",2011,14,3,11,1997,28,24,1068,398,246,107,126
"2011","King's Lynn and West Norfolk 014D","E01026723","Total",1619,115,66,49,1504,29,342,342,268,72,119,332
"2011","King's Lynn and West Norfolk 014E","E01026724","Total",1625,193,122,71,1432,70,370,289,230,80,99,294
"2011","King's Lynn and West Norfolk 014F","E01026725","Total",1450,130,71,59,1320,65,282,212,256,42,166,297
"2011","King's Lynn and West Norfolk 015A","E01026696","Total",1164,94,55,39,1070,48,124,214,180,84,192,228
"2011","King's Lynn and West Norfolk 015B","E01026697","Total",1264,140,79,61,1124,31,220,228,234,27,154,230
"2011","King's Lynn and West Norfolk 015C","E01026722","Total",2455,251,107,144,2204,116,316,549,434,162,222,405
"2011","King's Lynn and West Norfolk 015D","E01026726","Total",2099,196,105,91,1903,71,338,320,368,123,308,375
"2011","King's Lynn and West Norfolk 016A","E01026659","Total",1572,199,94,105,1373,56,204,329,262,117,177,228
"2011","King's Lynn and West Norfolk 016B","E01026660","Total",1648,156,108,48,1492,48,334,275,260,104,181,290
"2011","King's Lynn and West Norfolk 016C","E01026661","Total",1474,135,87,48,1339,34,266,243,244,89,209,254
"2011","King's Lynn and West Norfolk 016D","E01026715","Total",1421,130,67,63,1291,36,244,255,268,68,162,258
"2011","King's Lynn and West Norfolk 016E","E01026716","Total",1853,194,123,71,1659,68,316,304,374,122,186,289
"2011","King's Lynn and West Norfolk 016F","E01026717","Total",1535,120,45,75,1415,40,224,292,272,97,213,277
"2011","King's Lynn and West Norfolk 017C","E01026686","Total",1995,379,248,131,1616,78,484,359,314,70,77,234
"2011","King's Lynn and West Norfolk 017D","E01026707","Total",2079,428,352,76,1651,28,874,154,282,0,58,255
"2011","King's Lynn and West Norfolk 017E","E01033036","Total",1615,125,56,69,1490,84,218,422,214,134,177,241
"2011","King's Lynn and West Norfolk 017F","E01033037","Total",1514,160,30,130,1354,135,100,406,242,95,169,207
"2011","King's Lynn and West Norfolk 017G","E01033038","Total",1681,270,128,142,1411,98,204,326,346,162,90,185
"2011","King's Lynn and West Norfolk 017H","E01033039","Total",987,165,104,61,822,26,196,137,170,66,95,132
"2011","King's Lynn and West Norfolk 018A","E01026679","Total",2409,236,134,102,2173,48,392,401,414,157,261,500
"2011","King's Lynn and West Norfolk 018B","E01026727","Total",2503,273,146,127,2230,71,474,434,488,162,188,413
"2011","King's Lynn and West Norfolk 018C","E01026728","Total",2276,215,115,100,2061,49,440,386,438,135,222,391
"2011","King's Lynn and West Norfolk 019A","E01026648","Total",1506,168,77,91,1338,66,254,323,282,62,155,196
"2011","King's Lynn and West Norfolk 019B","E01026649","Total",1545,185,83,102,1360,62,228,296,266,120,169,219
"2011","King's Lynn and West Norfolk 019C","E01026650","Total",1203,62,29,33,1141,28,88,348,238,119,152,168
"2011","King's Lynn and West Norfolk 019D","E01026651","Total",2320,220,117,103,2100,70,384,467,446,161,219,353
"2011","King's Lynn and West Norfolk 019E","E01026652","Total",1324,110,50,60,1214,53,212,265,214,81,185,204
"2011","North Norfolk 001A","E01026770","Total",1830,497,297,200,1333,48,324,202,336,86,146,191
"2011","North Norfolk 001B","E01026771","Total",1565,254,177,77,1311,88,336,260,252,56,99,220
"2011","North Norfolk 001C","E01026772","Total",1717,202,150,52,1515,48,552,233,222,99,189,172
"2011","North Norfolk 001D","E01026773","Total",2046,259,176,83,1787,59,584,355,306,84,134,265
"2011","North Norfolk 002A","E01026739","Total",2001,330,194,136,1671,45,490,262,318,128,138,290
"2011","North Norfolk 002B","E01026763","Total",1355,206,124,82,1149,92,266,244,188,45,145,169
"2011","North Norfolk 002C","E01026764","Total",1181,293,181,112,888,26,284,96,196,16,66,204
"2011","North Norfolk 002D","E01026765","Total",1330,177,99,78,1153,36,332,171,214,75,79,246
"2011","North Norfolk 003A","E01026734","Total",1093,305,90,215,788,37,134,164,274,15,39,125
"2011","North Norfolk 003B","E01026735","Total",1146,358,150,208,788,50,238,121,178,10,73,118
"2011","North Norfolk 003C","E01026736","Total",1279,194,142,52,1085,50,286,210,188,76,64,211
"2011","North Norfolk 003D","E01026777","Total",1123,155,103,52,968,38,304,119,182,30,83,212
"2011","North Norfolk 003E","E01026778","Total",1338,308,215,93,1030,33,398,114,188,54,53,190
"2011","North Norfolk 003F","E01026779","Total",1444,145,65,80,1299,94,158,293,178,140,178,258
"2011","North Norfolk 004A","E01026741","Total",1856,305,207,98,1551,58,548,236,350,76,98,185
"2011","North Norfolk 004B","E01026742","Total",1256,272,206,66,984,35,480,149,166,36,25,93
"2011","North Norfolk 004C","E01026743","Total",2229,424,286,138,1805,83,526,337,322,138,136,263
"2011","North Norfolk 005A","E01026762","Total",2298,280,173,107,2018,52,582,319,400,100,184,381
"2011","North Norfolk 005B","E01026766","Total",2231,231,123,108,2000,52,442,337,468,105,201,395
"2011","North Norfolk 005C","E01026781","Total",2104,293,180,113,1811,29,536,279,346,67,166,388
"2011","North Norfolk 006A","E01026731","Total",955,175,136,39,780,17,320,113,144,25,61,100
"2011","North Norfolk 006B","E01026732","Total",1253,153,80,73,1100,50,254,183,228,64,109,212
"2011","North Norfolk 006C","E01026733","Total",2320,305,175,130,2015,89,408,408,400,143,221,346
"2011","North Norfolk 006D","E01026737","Total",2344,245,126,119,2099,59,420,377,422,130,256,435
"2011","North Norfolk 007A","E01026738","Total",2454,274,175,99,2180,85,536,366,436,102,263,392
"2011","North Norfolk 007B","E01026750","Total",1322,217,120,97,1105,65,328,167,210,58,123,154
"2011","North Norfolk 007C","E01026751","Total",1371,242,159,83,1129,50,338,207,202,78,119,135
"2011","North Norfolk 007D","E01026752","Total",1413,170,81,89,1243,37,300,216,234,59,148,249
"2011","North Norfolk 008A","E01026729","Total",2184,241,102,139,1943,86,372,401,368,155,175,386
"2011","North Norfolk 008B","E01026730","Total",2439,295,153,142,2144,79,424,497,398,117,234,395
"2011","North Norfolk 008C","E01026788","Total",1265,141,77,64,1124,49,292,199,238,93,61,192
"2011","North Norfolk 009A","E01026780","Total",2521,321,146,175,2200,101,370,471,522,182,176,378
"2011","North Norfolk 009B","E01026782","Total",2154,326,181,145,1828,76,424,336,386,76,219,311
"2011","North Norfolk 009C","E01026787","Total",1040,116,61,55,924,64,158,211,150,52,105,184
"2011","North Norfolk 010A","E01026753","Total",1575,272,144,128,1303,99,268,253,174,151,117,241
"2011","North Norfolk 010B","E01026754","Total",1413,173,84,89,1240,101,168,334,230,63,122,222
"2011","North Norfolk 010C","E01026755","Total",1175,151,111,40,1024,12,394,172,152,30,88,176
"2011","North Norfolk 010D","E01026756","Total",1223,166,80,86,1057,135,164,236,148,76,103,195
"2011","North Norfolk 010E","E01026757","Total",1537,180,84,96,1357,61,240,369,286,58,109,234
"2011","North Norfolk 010F","E01026758","Total",1374,211,94,117,1163,43,232,283,256,85,42,222
"2011","North Norfolk 010G","E01026759","Total",1279,166,107,59,1113,84,234,214,146,77,149,209
"2011","North Norfolk 010H","E01026760","Total",1251,210,114,96,1041,40,206,210,192,47,124,222
"2011","North Norfolk 010I","E01026761","Total",1553,213,127,86,1340,71,308,275,236,107,95,248
"2011","North Norfolk 011A","E01026745","Total",1647,243,147,96,1404,47,286,276,286,78,159,272
"2011","North Norfolk 011B","E01026746","Total",1638,221,125,96,1417,29,256,328,328,42,150,284
"2011","North Norfolk 011C","E01026747","Total",1306,232,112,120,1074,77,218,228,188,50,107,206
"2011","North Norfolk 011D","E01026748","Total",1430,189,123,66,1241,39,382,237,232,58,78,215
"2011","North Norfolk 011E","E01026749","Total",1491,262,141,121,1229,111,204,295,174,108,161,176
"2011","North Norfolk 012A","E01026740","Total",2345,286,158,128,2059,75,494,355,538,122,155,320
"2011","North Norfolk 012B","E01026767","Total",1215,119,68,51,1096,23,234,235,254,68,85,197
"2011","North Norfolk 012C","E01026768","Total",1186,101,26,75,1085,78,92,305,340,60,68,142
"2011","North Norfolk 012D","E01026789","Total",1200,102,45,57,1098,36,174,212,232,58,143,243
"2011","North Norfolk 012E","E01026790","Total",1143,105,56,49,1038,41,186,217,214,64,122,194
"2011","North Norfolk 013A","E01026774","Total",1451,159,81,78,1292,54,268,273,282,52,119,244
"2011","North Norfolk 013B","E01026775","Total",1265,198,121,77,1067,75,192,263,164,89,102,182
"2011","North Norfolk 013C","E01026776","Total",1542,305,138,167,1237,63,320,249,242,47,118,198
"2011","North Norfolk 013D","E01026786","Total",2164,241,120,121,1923,87,434,346,420,107,185,344
"2011","North Norfolk 014A","E01026744","Total",1947,301,204,97,1646,27,586,230,306,92,123,282
"2011","North Norfolk 014B","E01026769","Total",2105,268,181,87,1837,38,512,318,412,73,154,330
"2011","North Norfolk 014C","E01026783","Total",1753,242,145,97,1511,26,474,234,326,60,81,310
"2011","North Norfolk 014D","E01026784","Total",1045,138,90,48,907,57,198,210,136,39,93,174
"2011","North Norfolk 014E","E01026785","Total",1313,157,90,67,1156,40,360,173,256,48,104,175
"2011","Norwich 001A","E01026797","Total",2400,341,73,268,2059,138,128,586,554,145,145,363
"2011","Norwich 001B","E01026798","Total",1533,250,68,182,1283,141,128,271,204,134,200,205
"2011","Norwich 001C","E01026799","Total",1459,181,42,139,1278,137,110,320,256,89,122,244
"2011","Norwich 001D","E01026800","Total",1991,364,93,271,1627,200,100,353,318,166,219,271
"2011","Norwich 001E","E01026801","Total",1560,180,94,86,1380,33,268,299,278,58,117,327
"2011","Norwich 001F","E01026802","Total",1536,329,88,241,1207,104,168,307,286,74,65,203
"2011","Norwich 002A","E01026828","Total",1744,162,59,103,1582,195,134,363,210,209,161,310
"2011","Norwich 002B","E01026829","Total",2063,266,63,203,1797,199,94,423,350,188,159,384
"2011","Norwich 002C","E01026830","Total",1252,312,112,200,940,117,160,208,246,26,40,143
"2011","Norwich 002D","E01026831","Total",1242,257,33,224,985,53,56,225,380,56,16,199
"2011","Norwich 002E","E01026832","Total",1415,99,51,48,1316,166,132,254,138,150,243,233
"2011","Norwich 002F","E01026833","Total",1382,321,95,226,1061,146,108,326,200,84,88,109
"2011","Norwich 002G","E01026834","Total",1503,206,98,108,1297,175,140,319,200,90,145,228
"2011","Norwich 003A","E01026841","Total",1428,272,39,233,1156,78,68,290,470,32,43,175
"2011","Norwich 003B","E01026842","Total",1628,324,61,263,1304,58,110,334,454,46,56,246
"2011","Norwich 003C","E01026843","Total",1871,338,113,225,1533,143,160,354,436,53,165,222
"2011","Norwich 003D","E01026844","Total",1741,314,65,249,1427,200,136,314,358,125,102,192
"2011","Norwich 003E","E01026845","Total",1561,286,36,250,1275,87,68,326,514,42,58,180
"2011","Norwich 003F","E01026846","Total",1609,320,64,256,1289,105,66,308,468,39,56,247
"2011","Norwich 004A","E01026803","Total",1388,212,113,99,1176,130,236,242,184,85,90,209
"2011","Norwich 004B","E01026804","Total",1429,187,111,76,1242,90,262,228,228,71,157,206
"2011","Norwich 004C","E01026805","Total",1421,207,120,87,1214,134,256,228,162,107,112,215
"2011","Norwich 004D","E01026806","Total",1127,131,67,64,996,29,222,203,226,48,65,203
"2011","Norwich 004E","E01026807","Total",1252,152,69,83,1100,77,80,222,246,180,93,202
"2011","Norwich 004F","E01026808","Total",1320,154,68,86,1166,176,76,206,164,165,172,207
"2011","Norwich 004G","E01026809","Total",1483,335,120,215,1148,117,224,238,212,95,85,177
"2011","Norwich 005A","E01026791","Total",1475,262,71,191,1213,174,70,250,214,90,111,304
"2011","Norwich 005B","E01026792","Total",1445,180,80,100,1265,78,166,319,268,106,89,239
"2011","Norwich 005C","E01026793","Total",1817,102,46,56,1715,202,152,341,186,273,221,340
"2011","Norwich 005D","E01026794","Total",2021,210,56,154,1811,111,154,434,444,129,186,353
"2011","Norwich 005F","E01026796","Total",1636,196,88,108,1440,141,162,178,160,134,155,510
"2011","Norwich 005G","E01033435","Total",1845,144,21,123,1701,129,50,507,396,118,143,358
"2011","Norwich 005H","E01033436","Total",1383,187,89,98,1196,102,130,228,236,122,137,241
"2011","Norwich 006A","E01026863","Total",1814,215,80,135,1599,88,146,317,372,42,105,529
"2011","Norwich 006B","E01026864","Total",1547,169,75,94,1378,160,160,304,296,63,147,248
"2011","Norwich 006C","E01026865","Total",1949,236,79,157,1713,220,104,383,316,164,165,361
"2011","Norwich 006D","E01026866","Total",1574,293,68,225,1281,107,146,198,362,66,69,333
"2011","Norwich 006E","E01026867","Total",1592,136,51,85,1456,138,104,251,152,171,337,303
"2011","Norwich 006F","E01026868","Total",1623,119,41,78,1504,195,70,289,188,185,218,359
"2011","Norwich 006G","E01026869","Total",1400,264,63,201,1136,152,132,326,178,101,87,160
"2011","Norwich 007A","E01026822","Total",1958,694,219,475,1264,105,176,180,550,5,31,217
"2011","Norwich 007B","E01026823","Total",1800,597,116,481,1203,65,122,139,574,16,19,268
"2011","Norwich 007C","E01026824","Total",1471,476,146,330,995,87,116,187,352,46,30,177
"2011","Norwich 007D","E01026825","Total",1276,359,78,281,917,56,70,206,352,15,29,189
"2011","Norwich 007E","E01026826","Total",1406,515,174,341,891,109,70,164,320,54,44,130
"2011","Norwich 007F","E01026827","Total",1501,547,225,322,954,150,150,188,276,44,29,117
"2011","Norwich 009A","E01026835","Total",1453,236,51,185,1217,85,78,200,252,57,71,474
"2011","Norwich 009B","E01026836","Total",1566,181,40,141,1385,77,92,303,280,87,95,451
"2011","Norwich 009C","E01026837","Total",1448,338,89,249,1110,40,96,220,328,91,60,275
"2011","Norwich 009D","E01026838","Total",1551,171,53,118,1380,64,122,377,300,74,67,376
"2011","Norwich 009E","E01026839","Total",1592,204,31,173,1388,59,48,273,308,33,37,630
"2011","Norwich 009F","E01026840","Total",1604,233,42,191,1371,92,88,264,516,20,52,339
"2011","Norwich 010A","E01026858","Total",1508,323,161,162,1185,116,198,225,188,72,78,308
"2011","Norwich 010B","E01026859","Total",1659,154,76,78,1505,189,132,385,194,147,120,338
"2011","Norwich 010C","E01026860","Total",1098,152,85,67,946,26,174,123,136,73,64,350
"2011","Norwich 010D","E01026861","Total",1493,105,59,46,1388,110,138,238,144,56,132,570
"2011","Norwich 010E","E01026862","Total",1302,122,86,36,1180,58,136,202,138,80,167,399
"2011","Norwich 011A","E01026852","Total",1234,228,100,128,1006,24,140,278,272,42,91,159
"2011","Norwich 011B","E01026853","Total",1746,534,208,326,1212,128,160,231,390,36,45,222
"2011","Norwich 011D","E01026855","Total",1564,332,102,230,1232,49,118,227,334,51,55,398
"2011","Norwich 011E","E01026856","Total",1821,306,59,247,1515,102,72,226,460,41,38,576
"2011","Norwich 011F","E01026857","Total",1515,327,192,135,1188,48,190,207,246,46,100,351
"2011","Norwich 011G","E01033434","Total",1076,311,62,249,765,36,48,157,330,10,40,144
"2011","Norwich 011H","E01033437","Total",1334,460,136,324,874,100,100,167,226,48,83,150
"2011","Norwich 012A","E01026810","Total",1374,205,127,78,1169,50,276,228,208,61,97,249
"2011","Norwich 012B","E01026811","Total",1525,243,170,73,1282,12,342,294,224,42,126,242
"2011","Norwich 012C","E01026812","Total",1425,178,81,97,1247,31,234,297,284,58,140,203
"2011","Norwich 012D","E01026813","Total",1426,172,125,47,1254,10,352,273,192,47,115,265
"2011","Norwich 012E","E01026814","Total",1502,203,116,87,1299,74,210,243,218,104,100,350
"2011","Norwich 012F","E01026815","Total",1450,206,92,114,1244,46,170,350,258,46,104,270
"2011","Norwich 013A","E01026816","Total",1699,446,134,312,1253,119,114,272,464,47,73,164
"2011","Norwich 013B","E01026817","Total",1415,297,180,117,1118,103,174,250,254,73,68,196
"2011","Norwich 013C","E01026818","Total",1462,173,69,104,1289,168,142,281,254,69,167,208
"2011","Norwich 013D","E01026819","Total",1439,214,54,160,1225,172,96,264,228,119,133,213
"2011","Norwich 013E","E01026820","Total",1727,272,167,105,1455,149,178,293,220,154,218,243
"2011","Norwich 013F","E01026821","Total",1542,254,134,120,1288,106,218,291,220,112,78,263
"2011","Norwich 014A","E01033438","Total",1350,557,276,281,793,25,156,124,274,25,45,144
"2011","Norwich 014B","E01033439","Total",1357,366,42,324,991,42,52,161,470,31,42,193
"2011","Norwich 014C","E01033440","Total",1070,377,30,347,693,39,32,142,340,30,21,89
"2011","Norwich 014D","E01033441","Total",1229,428,31,397,801,56,64,125,430,0,17,109
"2011","Norwich 015A","E01026848","Total",1823,512,182,330,1311,218,138,322,304,40,63,226
"2011","Norwich 015B","E01026849","Total",1677,409,66,343,1268,37,134,298,516,30,62,191
"2011","Norwich 015C","E01026850","Total",1827,390,80,310,1437,109,134,348,536,66,70,174
"2011","South Norfolk 001A","E01026916","Total",2028,226,146,80,1802,37,410,386,370,94,141,364
"2011","South Norfolk 001B","E01026917","Total",1481,188,144,44,1293,49,328,189,234,63,129,301
"2011","South Norfolk 001C","E01026918","Total",1686,218,103,115,1468,46,318,310,340,69,101,284
"2011","South Norfolk 001E","E01026924","Total",1514,174,76,98,1340,54,324,285,252,70,117,238
"2011","South Norfolk 001F","E01026925","Total",2091,297,89,208,1794,181,148,483,366,122,183,311
"2011","South Norfolk 001G","E01033538","Total",2164,157,7,150,2007,175,38,700,596,193,124,181
"2011","South Norfolk 001H","E01033540","Total",1484,165,80,85,1319,52,270,313,322,75,72,215
"2011","South Norfolk 002A","E01026881","Total",1335,238,65,173,1097,58,158,325,206,72,79,199
"2011","South Norfolk 002B","E01026882","Total",2053,162,99,63,1891,77,406,497,374,141,119,277
"2011","South Norfolk 002C","E01026883","Total",1602,163,85,78,1439,32,284,375,282,62,176,228
"2011","South Norfolk 002D","E01026895","Total",1438,128,42,86,1310,61,202,377,280,76,96,218
"2011","South Norfolk 002E","E01026896","Total",1201,80,40,40,1121,36,224,263,226,72,107,193
"2011","South Norfolk 003A","E01026905","Total",1025,213,166,47,812,29,232,157,130,25,76,163
"2011","South Norfolk 003B","E01026906","Total",1348,134,89,45,1214,26,294,243,262,33,108,248
"2011","South Norfolk 003C","E01026907","Total",1832,209,116,93,1623,84,274,468,350,121,97,229
"2011","South Norfolk 003D","E01026908","Total",1402,171,43,128,1231,86,74,479,274,45,105,168
"2011","South Norfolk 004A","E01026909","Total",1387,216,125,91,1171,72,260,247,240,63,118,171
"2011","South Norfolk 004B","E01026910","Total",1488,165,91,74,1323,33,286,326,262,92,122,202
"2011","South Norfolk 004C","E01026947","Total",1287,109,54,55,1178,30,162,330,220,110,127,199
"2011","South Norfolk 004D","E01026948","Total",1299,80,41,39,1219,50,188,348,188,134,111,200
"2011","South Norfolk 005A","E01026870","Total",1543,454,231,223,1089,81,188,298,298,37,82,105
"2011","South Norfolk 005B","E01026871","Total",1296,140,81,59,1156,30,244,249,242,56,105,230
"2011","South Norfolk 005C","E01026921","Total",1366,199,100,99,1167,55,248,210,248,73,93,240
"2011","South Norfolk 005D","E01026922","Total",1469,229,135,94,1240,100,260,280,244,79,98,179
"2011","South Norfolk 006A","E01026875","Total",1142,84,47,37,1058,21,188,243,182,80,137,207
"2011","South Norfolk 006B","E01026876","Total",1489,169,97,72,1320,47,318,292,224,67,150,222
"2011","South Norfolk 006C","E01026926","Total",1555,152,95,57,1403,61,330,279,240,79,155,259
"2011","South Norfolk 006D","E01026927","Total",1837,195,97,98,1642,42,310,495,306,61,124,304
"2011","South Norfolk 006E","E01026928","Total",1409,186,119,67,1223,64,266,275,196,55,111,256
"2011","South Norfolk 006F","E01026936","Total",1392,163,86,77,1229,59,294,284,244,41,96,211
"2011","South Norfolk 006G","E01026937","Total",1472,162,79,83,1310,87,176,361,274,84,124,204
"2011","South Norfolk 007A","E01026884","Total",1157,127,49,78,1030,78,154,208,218,103,130,139
"2011","South Norfolk 007B","E01026885","Total",1434,107,46,61,1327,69,178,348,232,107,166,227
"2011","South Norfolk 007C","E01026933","Total",2739,271,106,165,2468,174,284,707,464,229,228,382
"2011","South Norfolk 007D","E01026945","Total",2234,190,60,130,2044,142,176,736,348,170,202,270
"2011","South Norfolk 007E","E01026946","Total",1076,157,118,39,919,26,234,169,158,41,86,205
"2011","South Norfolk 008A","E01026879","Total",1167,138,74,64,1029,55,200,243,150,79,107,195
"2011","South Norfolk 008B","E01026880","Total",1436,140,94,46,1296,42,292,265,222,82,136,257
"2011","South Norfolk 008C","E01026911","Total",1098,208,122,86,890,64,162,218,164,52,86,144
"2011","South Norfolk 008D","E01026912","Total",1535,165,91,74,1370,79,232,306,244,70,173,266
"2011","South Norfolk 008E","E01026929","Total",1287,135,63,72,1152,39,250,231,222,82,98,230
"2011","South Norfolk 008F","E01026930","Total",1520,123,71,52,1397,36,254,327,260,143,126,251
"2011","South Norfolk 009A","E01026913","Total",1636,191,102,89,1445,66,186,403,370,55,146,219
"2011","South Norfolk 009B","E01026914","Total",1468,121,61,60,1347,48,304,272,250,83,141,249
"2011","South Norfolk 009C","E01026915","Total",1964,166,78,88,1798,81,254,473,376,190,131,293
"2011","South Norfolk 009D","E01026919","Total",1489,135,59,76,1354,92,216,433,292,81,103,137
"2011","South Norfolk 009E","E01026920","Total",1134,98,46,52,1036,23,208,232,190,72,102,209
"2011","South Norfolk 009F","E01026941","Total",1217,108,55,53,1109,30,226,221,220,66,136,210
"2011","South Norfolk 009G","E01026942","Total",1149,76,42,34,1073,44,168,208,204,103,131,215
"2011","South Norfolk 010A","E01026898","Total",1392,166,90,76,1226,39,250,265,204,74,133,261
"2011","South Norfolk 010B","E01026899","Total",1464,140,80,60,1324,41,226,296,252,108,167,234
"2011","South Norfolk 010C","E01026943","Total",1537,139,66,73,1398,37,286,222,330,108,142,273
"2011","South Norfolk 010D","E01026944","Total",1186,86,53,33,1100,31,162,268,196,94,143,206
"2011","South Norfolk 011A","E01026877","Total",1537,131,76,55,1406,37,286,335,284,85,176,203
"2011","South Norfolk 011B","E01026878","Total",1200,96,44,52,1104,63,132,256,212,100,106,235
"2011","South Norfolk 011C","E01026897","Total",2680,206,102,104,2474,44,484,602,480,134,220,510
"2011","South Norfolk 011D","E01026938","Total",1975,229,104,125,1746,104,228,443,402,113,142,314
"2011","South Norfolk 011E","E01026939","Total",1714,163,64,99,1551,63,220,397,304,103,187,277
"2011","South Norfolk 011F","E01026940","Total",1798,177,89,88,1621,112,172,451,286,144,216,240
"2011","South Norfolk 012A","E01026892","Total",1288,163,83,80,1125,59,186,249,210,91,158,172
"2011","South Norfolk 012B","E01026893","Total",996,130,93,37,866,15,212,155,182,12,72,218
"2011","South Norfolk 012C","E01026894","Total",2410,247,135,112,2163,76,450,436,436,144,202,419
"2011","South Norfolk 012D","E01026903","Total",1198,101,55,46,1097,10,152,223,250,93,143,226
"2011","South Norfolk 012E","E01026904","Total",1362,122,70,52,1240,44,232,295,226,82,101,260
"2011","South Norfolk 013A","E01026872","Total",2194,267,128,139,1927,113,408,406,412,102,191,295
"2011","South Norfolk 013B","E01026900","Total",1446,235,147,88,1211,61,300,247,248,84,78,193
"2011","South Norfolk 013C","E01026901","Total",1333,180,97,83,1153,57,240,299,214,57,73,213
"2011","South Norfolk 013D","E01026902","Total",1832,315,132,183,1517,73,302,315,336,111,113,267
"2011","South Norfolk 014A","E01026873","Total",1255,100,39,61,1155,37,232,262,230,49,129,216
"2011","South Norfolk 014B","E01026874","Total",1521,127,61,66,1394,40,224,269,290,74,192,305
"2011","South Norfolk 014C","E01026886","Total",1335,116,61,55,1219,22,232,257,290,42,123,253
"2011","South Norfolk 014D","E01026887","Total",1453,140,67,73,1313,39,200,300,312,153,119,190
"2011","South Norfolk 014E","E01026934","Total",1027,130,63,67,897,39,212,171,190,55,75,155
"2011","South Norfolk 014F","E01026935","Total",1306,135,71,64,1171,25,268,239,262,92,116,169
"2011","South Norfolk 015A","E01026888","Total",1581,324,225,99,1257,74,286,211,224,120,148,194
"2011","South Norfolk 015B","E01026889","Total",1522,223,130,93,1299,35,324,255,308,46,113,218
"2011","South Norfolk 015D","E01026891","Total",1613,348,177,171,1265,99,228,276,238,64,126,234
"2011","South Norfolk 015E","E01026931","Total",1186,88,47,41,1098,26,216,263,186,99,116,192
"2011","South Norfolk 015F","E01026932","Total",1236,146,75,71,1090,56,180,214,216,93,136,195
"2011","South Norfolk 015G","E01033539","Total",1391,193,65,128,1198,100,162,345,238,73,89,191
"2011","South Norfolk 015H","E01033541","Total",1396,225,113,112,1171,71,162,260,300,80,106,192
"2011","Babergh 001A","E01029876","Total",2079,244,127,117,1835,78,342,397,358,152,170,338
"2011","Babergh 001B","E01029898","Total",1713,346,221,125,1367,65,384,238,328,50,103,199
"2011","Babergh 001C","E01029907","Total",2133,249,135,114,1884,58,418,381,434,104,164,325
"2011","Babergh 002A","E01029881","Total",2032,196,107,89,1836,84,306,414,348,154,211,319
"2011","Babergh 002B","E01029884","Total",1555,204,72,132,1351,91,144,325,268,109,191,223
"2011","Babergh 002C","E01029885","Total",2131,243,123,120,1888,76,382,394,416,113,154,353
"2011","Babergh 003A","E01029900","Total",1622,234,149,85,1388,23,318,314,234,75,148,276
"2011","Babergh 003B","E01029901","Total",2098,377,180,197,1721,77,326,296,452,127,123,320
"2011","Babergh 003C","E01029917","Total",1893,194,108,86,1699,95,348,460,318,74,161,243
"2011","Babergh 004A","E01029892","Total",1811,328,151,177,1483,153,204,353,290,89,173,221
"2011","Babergh 004B","E01029893","Total",2642,193,102,91,2449,88,374,724,398,283,287,295
"2011","Babergh 004C","E01029894","Total",1163,151,66,85,1012,56,184,256,198,36,102,180
"2011","Babergh 004D","E01029895","Total",1189,99,64,35,1090,38,184,294,168,61,89,256
"2011","Babergh 004E","E01029896","Total",1378,205,157,48,1173,58,246,250,144,92,141,242
"2011","Babergh 004F","E01029911","Total",2189,231,122,109,1958,34,382,468,352,176,176,370
"2011","Babergh 005A","E01029877","Total",1247,120,58,62,1127,26,196,251,206,67,156,225
"2011","Babergh 005B","E01029878","Total",1141,149,67,82,992,27,236,212,192,41,107,177
"2011","Babergh 005C","E01029879","Total",1475,152,73,79,1323,35,240,306,254,112,100,276
"2011","Babergh 005D","E01029908","Total",1629,179,40,139,1450,57,78,541,390,85,95,204
"2011","Babergh 005E","E01029909","Total",1556,256,49,207,1300,93,96,342,374,71,98,226
"2011","Babergh 005F","E01029910","Total",1157,157,44,113,1000,116,86,192,216,88,123,179
"2011","Babergh 006A","E01029880","Total",1699,189,110,79,1510,61,346,263,304,123,135,278
"2011","Babergh 006B","E01029921","Total",1270,110,75,35,1160,41,258,214,234,65,115,233
"2011","Babergh 006C","E01029922","Total",1282,126,64,62,1156,48,252,209,206,86,110,245
"2011","Babergh 006D","E01029923","Total",1399,139,54,85,1260,62,168,334,262,55,128,251
"2011","Babergh 007A","E01029912","Total",1580,267,132,135,1313,119,156,335,250,79,130,244
"2011","Babergh 007B","E01029913","Total",1083,192,149,43,891,23,344,126,150,46,64,138
"2011","Babergh 007C","E01029914","Total",1620,170,45,125,1450,149,120,403,284,142,152,200
"2011","Babergh 007D","E01029915","Total",1163,168,72,96,995,26,140,258,196,76,102,197
"2011","Babergh 007E","E01029916","Total",1313,122,48,74,1191,123,102,234,168,108,219,237
"2011","Babergh 007F","E01029918","Total",1077,244,88,156,833,74,110,164,210,68,59,148
"2011","Babergh 007G","E01029919","Total",1418,233,97,136,1185,38,244,276,242,94,84,207
"2011","Babergh 007H","E01029920","Total",1687,542,290,252,1145,110,240,256,310,35,75,119
"2011","Babergh 008A","E01029886","Total",1164,156,86,70,1008,43,190,239,162,115,93,166
"2011","Babergh 008B","E01029887","Total",1795,212,89,123,1583,103,296,354,302,84,122,322
"2011","Babergh 008C","E01029888","Total",1203,115,53,62,1088,77,152,256,206,65,148,184
"2011","Babergh 008D","E01029889","Total",1349,108,55,53,1241,101,132,261,184,183,169,211
"2011","Babergh 008E","E01029890","Total",1337,73,26,47,1264,46,90,370,208,97,160,293
"2011","Babergh 008F","E01029891","Total",1925,197,74,123,1728,77,186,580,320,72,174,319
"2011","Babergh 009A","E01029875","Total",2170,215,113,102,1955,38,380,471,346,168,231,321
"2011","Babergh 009B","E01029899","Total",1765,175,96,79,1590,45,338,403,354,87,126,237
"2011","Babergh 009C","E01029902","Total",2133,214,118,96,1919,47,354,409,398,119,223,369
"2011","Babergh 009D","E01029906","Total",1787,259,146,113,1528,69,328,385,300,116,105,225
"2011","Babergh 010A","E01029870","Total",1165,119,56,63,1046,88,138,251,202,100,105,162
"2011","Babergh 010B","E01029872","Total",1401,136,82,54,1265,19,234,266,250,113,133,250
"2011","Babergh 010C","E01029882","Total",1499,167,110,57,1332,36,248,291,196,157,137,267
"2011","Babergh 010D","E01029883","Total",1980,191,104,87,1789,82,440,347,338,113,170,299
"2011","Babergh 010E","E01029903","Total",1403,87,59,28,1316,26,266,346,274,58,122,224
"2011","Babergh 010F","E01029904","Total",1444,144,83,61,1300,51,296,273,194,67,143,276
"2011","Babergh 010G","E01029905","Total",1087,111,68,43,976,27,222,229,176,52,96,174
"2011","Babergh 011A","E01029871","Total",1352,202,124,78,1150,20,248,230,238,90,106,218
"2011","Babergh 011B","E01029873","Total",2128,299,151,148,1829,81,402,406,338,114,194,294
"2011","Babergh 011C","E01029874","Total",1750,168,66,102,1582,90,214,408,326,73,192,279
"2011","Babergh 011D","E01029897","Total",1909,213,108,105,1696,69,286,441,294,102,160,344
"2011","Forest Heath 001A","E01029926","Total",1664,221,150,71,1443,30,458,243,326,81,89,216
"2011","Forest Heath 001B","E01029927","Total",2339,317,145,172,2022,198,262,405,334,144,289,390
"2011","Forest Heath 001C","E01029928","Total",1824,230,84,146,1594,112,222,385,352,114,169,240
"2011","Forest Heath 001D","E01029929","Total",2238,312,154,158,1926,124,338,417,408,91,216,332
"2011","Forest Heath 001E","E01029930","Total",1506,165,84,81,1341,49,222,354,276,77,143,220
"2011","Forest Heath 002C","E01029942","Total",1455,181,62,119,1274,53,274,254,276,80,135,202
"2011","Forest Heath 002E","E01029944","Total",1671,198,109,89,1473,88,338,322,290,76,111,248
"2011","Forest Heath 002F","E01033453","Total",2374,234,77,157,2140,118,130,785,424,270,170,243
"2011","Forest Heath 003E","E01029945","Total",1906,197,92,105,1709,56,270,419,338,116,168,342
"2011","Forest Heath 003F","E01032523","Total",1164,82,9,73,1082,17,34,452,212,111,129,127
"2011","Forest Heath 003G","E01032524","Total",983,104,32,72,879,40,124,230,186,73,86,140
"2011","Forest Heath 003H","E01032525","Total",2829,174,46,128,2655,86,200,900,404,395,352,318
"2011","Forest Heath 003I","E01032526","Total",1627,180,58,122,1447,41,226,373,310,80,108,309
"2011","Forest Heath 004A","E01029938","Total",1401,114,37,77,1287,145,64,299,202,131,160,286
"2011","Forest Heath 004B","E01029939","Total",1532,153,64,89,1379,42,170,404,294,71,128,270
"2011","Forest Heath 004C","E01029940","Total",1433,165,82,83,1268,106,188,320,222,103,86,243
"2011","Forest Heath 004D","E01029946","Total",2112,263,108,155,1849,184,216,439,350,147,253,260
"2011","Forest Heath 004E","E01029947","Total",2140,403,183,220,1737,60,382,372,394,64,143,322
"2011","Forest Heath 005A","E01029941","Total",1824,202,87,115,1622,52,262,449,340,126,155,238
"2011","Forest Heath 005C","E01029957","Total",1650,191,101,90,1459,42,280,362,348,88,101,238
"2011","Forest Heath 005D","E01033451","Total",1475,156,7,149,1319,118,12,513,404,138,62,72
"2011","Forest Heath 005E","E01033452","Total",1394,158,34,124,1236,86,112,416,270,93,98,161
"2011","Forest Heath 005F","E01033454","Total",1255,152,24,128,1103,79,76,343,304,66,81,154
"2011","Forest Heath 006A","E01029937","Total",1921,271,132,139,1650,64,272,397,358,103,94,362
"2011","Forest Heath 006B","E01029953","Total",1424,182,86,96,1242,89,92,311,272,82,128,268
"2011","Forest Heath 006C","E01029954","Total",2413,409,151,258,2004,234,208,512,436,113,202,299
"2011","Forest Heath 006D","E01029955","Total",1816,309,86,223,1507,87,200,329,394,95,112,290
"2011","Forest Heath 006E","E01029956","Total",1356,119,40,79,1237,63,46,335,334,97,132,230
"2011","Forest Heath 008A","E01029925","Total",1698,347,145,202,1351,64,210,272,416,45,91,253
"2011","Forest Heath 008B","E01029949","Total",1385,206,91,115,1179,66,182,222,278,78,131,222
"2011","Forest Heath 008C","E01029950","Total",1784,243,107,136,1541,155,140,390,298,61,124,373
"2011","Forest Heath 008D","E01029951","Total",1384,157,99,58,1227,66,230,224,264,36,95,312
"2011","Forest Heath 008E","E01029952","Total",1177,149,72,77,1028,52,164,238,232,51,73,218
"2011","Forest Heath 008F","E01032612","Total",2021,294,71,223,1727,102,152,418,534,42,119,360
"2011","Ipswich 001A","E01030032","Total",1506,98,48,50,1408,133,106,265,146,215,288,255
"2011","Ipswich 001B","E01030033","Total",1534,172,100,72,1362,34,308,270,190,49,150,361
"2011","Ipswich 001C","E01030034","Total",1414,151,93,58,1263,22,330,250,230,57,66,308
"2011","Ipswich 001D","E01030035","Total",1840,126,70,56,1714,150,164,354,202,184,355,305
"2011","Ipswich 001E","E01030036","Total",1743,304,190,114,1439,93,250,253,142,99,233,369
"2011","Ipswich 002A","E01029973","Total",1515,151,114,37,1364,11,310,239,210,111,128,355
"2011","Ipswich 002B","E01029974","Total",1524,142,68,74,1382,52,144,347,282,92,161,304
"2011","Ipswich 002C","E01029975","Total",1294,128,88,40,1166,31,184,285,178,75,191,222
"2011","Ipswich 002D","E01029976","Total",1549,149,90,59,1400,55,208,262,280,135,144,316
"2011","Ipswich 002E","E01029977","Total",1537,154,93,61,1383,51,238,348,234,94,126,292
"2011","Ipswich 003A","E01030027","Total",2059,272,46,226,1787,138,100,481,462,104,161,341
"2011","Ipswich 003B","E01030028","Total",1631,168,62,106,1463,99,168,333,274,101,178,310
"2011","Ipswich 003C","E01030029","Total",1637,178,74,104,1459,161,194,250,208,126,203,317
"2011","Ipswich 003D","E01030030","Total",2001,278,70,208,1723,183,138,486,432,116,139,229
"2011","Ipswich 003E","E01030031","Total",1551,208,93,115,1343,130,162,352,192,102,178,227
"2011","Ipswich 004A","E01029997","Total",1589,170,96,74,1419,78,174,428,178,172,172,217
"2011","Ipswich 004B","E01029998","Total",1898,220,117,103,1678,156,218,333,224,239,252,256
"2011","Ipswich 004C","E01029999","Total",1705,127,55,72,1578,43,182,455,182,181,230,305
"2011","Ipswich 004D","E01030000","Total",1569,161,50,111,1408,56,136,469,270,106,174,197
"2011","Ipswich 004E","E01030001","Total",1511,189,121,68,1322,42,238,234,246,105,185,272
"2011","Ipswich 005A","E01030007","Total",1605,194,53,141,1411,75,116,469,258,141,148,204
"2011","Ipswich 005B","E01030008","Total",1249,151,74,77,1098,15,188,278,168,71,164,214
"2011","Ipswich 005C","E01030009","Total",1320,208,123,85,1112,39,162,260,214,77,154,206
"2011","Ipswich 005D","E01030010","Total",1846,447,155,292,1399,139,132,388,342,94,130,174
"2011","Ipswich 005E","E01030011","Total",1588,163,122,41,1425,38,278,324,270,105,126,284
"2011","Ipswich 006A","E01030022","Total",2199,287,55,232,1912,120,86,547,428,162,221,348
"2011","Ipswich 006B","E01030023","Total",1883,289,44,245,1594,170,64,457,362,107,194,240
"2011","Ipswich 006C","E01030024","Total",1947,582,134,448,1365,104,82,405,294,54,132,294
"2011","Ipswich 006D","E01030025","Total",1686,361,77,284,1325,93,110,288,380,79,165,210
"2011","Ipswich 006E","E01030026","Total",1713,190,48,142,1523,183,80,452,322,102,153,231
"2011","Ipswich 007A","E01029958","Total",1404,237,61,176,1167,90,108,338,262,92,110,167
"2011","Ipswich 007C","E01029960","Total",1784,319,90,229,1465,107,100,447,372,62,145,232
"2011","Ipswich 007D","E01029961","Total",1504,153,48,105,1351,169,84,395,242,83,180,198
"2011","Ipswich 007E","E01029962","Total",1594,241,49,192,1353,115,48,353,316,48,194,279
"2011","Ipswich 007F","E01033124","Total",633,279,49,230,354,18,18,48,240,0,0,30
"2011","Ipswich 007G","E01033125","Total",1017,379,72,307,638,51,24,133,284,15,33,98
"2011","Ipswich 007H","E01033129","Total",1172,362,32,330,810,50,44,209,230,47,96,134
"2011","Ipswich 008A","E01030002","Total",1875,416,177,239,1459,100,164,405,352,106,123,209
"2011","Ipswich 008B","E01030003","Total",1681,203,82,121,1478,82,142,467,290,97,140,260
"2011","Ipswich 008C","E01030004","Total",1299,104,50,54,1195,52,144,300,174,68,178,279
"2011","Ipswich 008D","E01030005","Total",2281,249,61,188,2032,248,94,634,386,194,181,295
"2011","Ipswich 008E","E01030006","Total",1828,324,146,178,1504,135,174,411,264,142,168,210
"2011","Ipswich 009A","E01029963","Total",1531,136,103,33,1395,43,314,293,246,98,129,272
"2011","Ipswich 009B","E01029964","Total",1326,123,44,79,1203,71,112,328,216,95,101,280
"2011","Ipswich 009C","E01029965","Total",1460,161,107,54,1299,53,250,310,210,72,146,258
"2011","Ipswich 009D","E01029966","Total",1389,211,104,107,1178,32,218,266,206,51,178,227
"2011","Ipswich 009E","E01029967","Total",1297,189,146,43,1108,28,374,200,176,35,88,207
"2011","Ipswich 010A","E01029984","Total",1498,163,51,112,1335,145,104,324,248,100,208,206
"2011","Ipswich 010B","E01029985","Total",2297,399,44,355,1898,134,144,341,578,122,248,331
"2011","Ipswich 010C","E01029986","Total",1573,238,89,149,1335,187,126,248,196,217,138,223
"2011","Ipswich 010D","E01029987","Total",1562,184,87,97,1378,57,192,280,198,169,260,222
"2011","Ipswich 010E","E01029988","Total",1799,439,111,328,1360,158,58,354,354,41,133,262
"2011","Ipswich 011B","E01029990","Total",1617,226,45,181,1391,174,86,320,330,90,187,204
"2011","Ipswich 011C","E01029991","Total",1633,141,73,68,1492,22,242,355,294,66,145,368
"2011","Ipswich 011D","E01029992","Total",1328,211,92,119,1117,61,124,294,272,80,73,213
"2011","Ipswich 011E","E01033123","Total",1787,262,61,201,1525,142,84,396,444,57,156,246
"2011","Ipswich 011F","E01033126","Total",1422,310,17,293,1112,66,22,358,552,0,21,93
"2011","Ipswich 012A","E01029968","Total",1471,242,54,188,1229,130,72,261,314,80,146,226
"2011","Ipswich 012B","E01029969","Total",1320,172,57,115,1148,87,108,249,220,74,179,231
"2011","Ipswich 012C","E01029970","Total",1735,234,90,144,1501,69,170,341,338,50,222,311
"2011","Ipswich 012D","E01029971","Total",1419,222,90,132,1197,137,158,249,208,56,165,224
"2011","Ipswich 012F","E01033122","Total",1427,254,42,212,1173,243,20,297,308,89,84,132
"2011","Ipswich 012G","E01033130","Total",1034,387,62,325,647,73,38,156,214,16,68,82
"2011","Ipswich 013A","E01030012","Total",1120,330,141,189,790,45,192,146,148,42,98,119
"2011","Ipswich 013B","E01030013","Total",1382,176,113,63,1206,62,222,251,216,84,125,246
"2011","Ipswich 013C","E01030014","Total",1400,184,139,45,1216,75,226,241,148,90,131,305
"2011","Ipswich 013D","E01030015","Total",1310,101,56,45,1209,30,218,230,224,80,147,280
"2011","Ipswich 013E","E01030016","Total",1433,180,70,110,1253,72,186,240,278,45,79,353
"2011","Ipswich 014B","E01029994","Total",1616,209,98,111,1407,135,124,262,154,227,244,261
"2011","Ipswich 014C","E01029995","Total",1580,157,69,88,1423,44,156,366,336,66,156,299
"2011","Ipswich 014D","E01029996","Total",1701,143,72,71,1558,103,170,240,222,191,275,357
"2011","Ipswich 014E","E01033127","Total",1526,157,13,144,1369,179,34,368,306,89,242,151
"2011","Ipswich 014F","E01033128","Total",1102,143,38,105,959,62,64,266,246,52,70,199
"2011","Ipswich 014G","E01033131","Total",1429,140,40,100,1289,144,86,295,216,113,191,244
"2011","Ipswich 015A","E01030017","Total",1365,219,87,132,1146,95,178,277,236,52,88,220
"2011","Ipswich 015B","E01030018","Total",1464,236,53,183,1228,185,92,330,230,66,104,221
"2011","Ipswich 015C","E01030019","Total",1517,177,94,83,1340,74,188,319,256,80,172,251
"2011","Ipswich 015D","E01030020","Total",1500,122,65,57,1378,50,212,261,282,80,148,345
"2011","Ipswich 015E","E01030021","Total",1392,267,70,197,1125,169,98,309,240,81,81,147
"2011","Ipswich 016A","E01029978","Total",1321,131,58,73,1190,69,168,293,196,74,83,307
"2011","Ipswich 016B","E01029979","Total",1643,189,110,79,1454,198,158,283,160,198,201,256
"2011","Ipswich 016C","E01029980","Total",1625,226,77,149,1399,236,96,430,210,114,103,210
"2011","Ipswich 016D","E01029981","Total",1166,141,59,82,1025,49,156,219,240,79,87,195
"2011","Ipswich 016E","E01029982","Total",1461,106,55,51,1355,156,102,285,178,180,187,267
"2011","Ipswich 016F","E01029983","Total",1569,185,77,108,1384,39,154,348,274,104,212,253
"2011","Mid Suffolk 001A","E01030052","Total",2133,310,172,138,1823,88,386,410,328,112,232,267
"2011","Mid Suffolk 001B","E01030058","Total",2033,210,115,95,1823,87,392,307,350,154,205,328
"2011","Mid Suffolk 001C","E01030064","Total",2231,205,105,100,2026,40,370,501,406,162,206,341
"2011","Mid Suffolk 001D","E01030088","Total",1167,90,42,48,1077,23,196,236,226,51,163,182
"2011","Mid Suffolk 002A","E01030039","Total",1446,92,52,40,1354,50,226,267,220,97,192,302
"2011","Mid Suffolk 002B","E01030054","Total",1253,90,33,57,1163,29,264,224,230,111,129,176
"2011","Mid Suffolk 002C","E01030055","Total",1368,143,52,91,1225,41,166,311,292,92,110,213
"2011","Mid Suffolk 002D","E01030066","Total",1585,184,119,65,1401,41,288,299,262,74,192,245
"2011","Mid Suffolk 002E","E01030067","Total",1271,159,80,79,1112,61,210,273,250,61,83,174
"2011","Mid Suffolk 002F","E01030068","Total",1687,193,96,97,1494,62,242,321,278,99,187,305
"2011","Mid Suffolk 003A","E01030053","Total",2292,230,129,101,2062,79,460,442,406,130,226,319
"2011","Mid Suffolk 003B","E01030082","Total",2557,313,191,122,2244,98,530,433,426,155,270,332
"2011","Mid Suffolk 003C","E01030090","Total",2429,185,97,88,2244,86,394,463,448,202,237,414
"2011","Mid Suffolk 004A","E01030040","Total",1176,110,49,61,1066,43,180,213,212,67,123,228
"2011","Mid Suffolk 004B","E01030049","Total",1689,138,74,64,1551,39,294,372,234,118,181,313
"2011","Mid Suffolk 004C","E01030050","Total",2038,201,80,121,1837,62,210,580,386,111,222,266
"2011","Mid Suffolk 004D","E01030084","Total",1611,119,80,39,1492,36,288,307,286,88,181,306
"2011","Mid Suffolk 004E","E01030085","Total",1621,177,90,87,1444,54,196,437,288,110,129,230
"2011","Mid Suffolk 005A","E01030037","Total",1211,121,62,59,1090,54,180,300,226,51,82,197
"2011","Mid Suffolk 005B","E01030038","Total",1214,110,68,42,1104,31,220,247,182,38,166,220
"2011","Mid Suffolk 005C","E01030059","Total",2254,254,123,131,2000,66,322,446,422,137,222,385
"2011","Mid Suffolk 005D","E01030081","Total",2263,272,152,120,1991,88,446,370,402,139,170,376
"2011","Mid Suffolk 006A","E01030051","Total",1696,189,116,73,1507,74,282,309,284,130,161,267
"2011","Mid Suffolk 006B","E01030056","Total",2181,277,163,114,1904,69,392,370,332,145,220,376
"2011","Mid Suffolk 006C","E01030065","Total",2080,192,106,86,1888,58,348,379,420,207,177,299
"2011","Mid Suffolk 006D","E01030086","Total",1177,84,43,41,1093,66,188,288,208,73,93,177
"2011","Mid Suffolk 006E","E01030089","Total",1993,196,130,66,1797,56,366,341,330,106,208,390
"2011","Mid Suffolk 007A","E01030048","Total",2366,305,183,122,2061,129,350,517,356,174,207,328
"2011","Mid Suffolk 007B","E01030057","Total",2323,178,92,86,2145,76,276,498,450,172,287,386
"2011","Mid Suffolk 007C","E01030083","Total",2321,173,89,84,2148,46,340,450,426,177,260,449
"2011","Mid Suffolk 007D","E01030087","Total",1363,112,61,51,1251,20,176,249,210,185,180,231
"2011","Mid Suffolk 008A","E01030073","Total",1502,280,210,70,1222,125,298,212,214,67,108,198
"2011","Mid Suffolk 008B","E01030077","Total",1432,275,158,117,1157,105,200,262,188,65,182,155
"2011","Mid Suffolk 008C","E01030079","Total",1599,194,89,105,1405,160,128,304,212,180,206,215
"2011","Mid Suffolk 008D","E01030080","Total",1641,159,99,60,1482,95,260,329,214,98,178,308
"2011","Mid Suffolk 009A","E01030063","Total",2200,189,98,91,2011,82,336,520,406,131,219,317
"2011","Mid Suffolk 009B","E01030069","Total",1310,111,50,61,1199,24,206,232,272,62,154,249
"2011","Mid Suffolk 009C","E01030072","Total",1565,253,121,132,1312,79,250,320,306,66,76,215
"2011","Mid Suffolk 009D","E01030075","Total",1668,112,35,77,1556,92,96,494,270,109,204,291
"2011","Mid Suffolk 010A","E01030060","Total",1636,257,122,135,1379,46,172,428,268,103,129,233
"2011","Mid Suffolk 010B","E01030071","Total",1438,222,86,136,1216,57,216,277,338,59,93,176
"2011","Mid Suffolk 010D","E01030076","Total",1486,187,63,124,1299,123,138,288,276,106,92,276
"2011","Mid Suffolk 010E","E01030078","Total",1717,182,56,126,1535,71,170,413,348,103,138,292
"2011","Mid Suffolk 010F","E01033316","Total",1572,142,16,126,1430,86,52,554,352,106,152,128
"2011","Mid Suffolk 010G","E01033317","Total",1573,173,41,132,1400,122,86,466,322,100,127,177
"2011","Mid Suffolk 010H","E01033319","Total",1912,123,23,100,1789,78,128,704,398,126,158,197
"2011","Mid Suffolk 011A","E01030041","Total",2122,210,97,113,1912,40,398,406,438,72,192,366
"2011","Mid Suffolk 011B","E01030043","Total",1227,137,42,95,1090,50,150,350,264,50,56,170
"2011","Mid Suffolk 011C","E01030061","Total",1527,318,205,113,1209,58,250,284,232,88,96,201
"2011","Mid Suffolk 011D","E01030062","Total",1336,215,106,109,1121,38,216,208,228,75,101,255
"2011","Mid Suffolk 011E","E01030070","Total",1459,60,31,29,1399,43,106,540,322,131,117,140
"2011","Mid Suffolk 012A","E01030042","Total",1567,150,70,80,1417,60,318,250,270,83,153,283
"2011","Mid Suffolk 012B","E01030044","Total",1148,210,129,81,938,33,222,157,208,68,60,190
"2011","Mid Suffolk 012C","E01030045","Total",1740,156,86,70,1584,69,270,371,292,133,202,247
"2011","Mid Suffolk 012D","E01030046","Total",1590,126,67,59,1464,54,268,341,300,61,212,228
"2011","Mid Suffolk 012E","E01030047","Total",1258,166,75,91,1092,64,142,251,244,42,147,202
"2011","St Edmundsbury 001A","E01030095","Total",1179,106,51,55,1073,45,182,197,226,107,113,203
"2011","St Edmundsbury 001B","E01030096","Total",1443,137,75,62,1306,29,244,250,282,75,184,242
"2011","St Edmundsbury 001C","E01030097","Total",1201,132,79,53,1069,39,206,155,190,119,156,204
"2011","St Edmundsbury 001D","E01030145","Total",1393,156,81,75,1237,65,218,294,222,73,124,241
"2011","St Edmundsbury 001E","E01030146","Total",1095,139,113,26,956,31,302,250,150,22,64,137
"2011","St Edmundsbury 002A","E01030094","Total",1412,150,88,62,1262,70,190,266,258,83,153,242
"2011","St Edmundsbury 002B","E01030121","Total",2278,178,113,65,2100,83,320,518,338,183,278,380
"2011","St Edmundsbury 002C","E01030132","Total",1247,45,20,25,1202,44,84,543,216,127,83,105
"2011","St Edmundsbury 002D","E01030133","Total",1464,136,68,68,1328,29,216,368,252,100,109,254
"2011","St Edmundsbury 003A","E01030130","Total",1293,135,79,56,1158,110,194,231,194,85,77,267
"2011","St Edmundsbury 003B","E01030131","Total",1299,133,75,58,1166,168,132,177,126,156,164,243
"2011","St Edmundsbury 003C","E01030139","Total",1725,261,136,125,1464,174,178,317,232,116,169,278
"2011","St Edmundsbury 003D","E01030140","Total",1277,98,44,54,1179,99,160,228,190,74,162,266
"2011","St Edmundsbury 003E","E01030141","Total",1601,168,66,102,1433,131,162,320,206,120,225,269
"2011","St Edmundsbury 004A","E01030103","Total",1929,205,129,76,1724,37,420,356,368,83,110,350
"2011","St Edmundsbury 004B","E01030104","Total",2172,179,123,56,1993,26,490,425,310,111,221,410
"2011","St Edmundsbury 004C","E01030138","Total",2341,225,120,105,2116,119,398,410,360,183,202,444
"2011","St Edmundsbury 005B","E01030127","Total",1237,126,30,96,1111,20,88,352,280,56,120,195
"2011","St Edmundsbury 005C","E01030128","Total",1472,145,28,117,1327,76,76,393,350,73,125,234
"2011","St Edmundsbury 005D","E01030129","Total",1427,128,62,66,1299,46,154,300,272,87,108,332
"2011","St Edmundsbury 005E","E01033044","Total",1458,86,4,82,1372,130,20,486,266,174,147,149
"2011","St Edmundsbury 005F","E01033045","Total",1072,80,12,68,992,74,52,378,174,90,97,127
"2011","St Edmundsbury 005G","E01033050","Total",1293,123,26,97,1170,54,92,442,252,75,88,167
"2011","St Edmundsbury 006A","E01030091","Total",1724,429,152,277,1295,65,270,180,414,36,56,274
"2011","St Edmundsbury 006B","E01030093","Total",1504,312,128,184,1192,70,212,212,360,63,106,169
"2011","St Edmundsbury 006D","E01030137","Total",1579,231,73,158,1348,83,154,297,396,66,118,234
"2011","St Edmundsbury 006E","E01033043","Total",1215,265,116,149,950,65,112,219,248,74,65,167
"2011","St Edmundsbury 006F","E01033046","Total",1104,305,109,196,799,56,54,145,270,47,60,167
"2011","St Edmundsbury 006G","E01033047","Total",1132,157,63,94,975,48,104,253,228,78,92,172
"2011","St Edmundsbury 007A","E01030092","Total",1679,290,126,164,1389,104,210,316,364,67,98,230
"2011","St Edmundsbury 007B","E01030123","Total",1596,170,80,90,1426,113,190,326,184,114,178,321
"2011","St Edmundsbury 007C","E01030124","Total",1530,238,142,96,1292,35,342,267,282,61,86,219
"2011","St Edmundsbury 007D","E01030125","Total",1511,169,108,61,1342,71,222,239,222,89,177,322
"2011","St Edmundsbury 007E","E01030148","Total",1228,112,62,50,1116,50,228,281,196,37,86,238
"2011","St Edmundsbury 007F","E01030149","Total",1477,147,90,57,1330,52,266,337,258,86,106,225
"2011","St Edmundsbury 008A","E01030098","Total",2317,219,127,92,2098,98,466,521,332,168,182,331
"2011","St Edmundsbury 008B","E01030100","Total",2055,174,91,83,1881,64,406,362,388,119,198,344
"2011","St Edmundsbury 008C","E01030119","Total",2245,209,129,80,2036,65,374,517,384,130,152,414
"2011","St Edmundsbury 008D","E01030134","Total",1099,120,61,59,979,40,178,232,184,89,94,162
"2011","St Edmundsbury 008E","E01030135","Total",1292,109,62,47,1183,17,254,281,234,83,126,188
"2011","St Edmundsbury 009B","E01030142","Total",1660,177,111,66,1483,29,388,303,258,51,115,339
"2011","St Edmundsbury 009C","E01030143","Total",1592,192,84,108,1400,83,150,409,214,85,136,323
"2011","St Edmundsbury 009D","E01030144","Total",1235,141,88,53,1094,42,240,256,186,50,138,182
"2011","St Edmundsbury 009E","E01030147","Total",1437,213,131,82,1224,20,410,222,208,88,72,204
"2011","St Edmundsbury 009F","E01033048","Total",1210,298,138,160,912,84,126,199,274,35,58,136
"2011","St Edmundsbury 009G","E01033049","Total",1114,355,179,176,759,24,158,153,216,15,56,137
"2011","St Edmundsbury 010A","E01030099","Total",1966,223,135,88,1743,48,408,293,346,145,185,318
"2011","St Edmundsbury 010B","E01030101","Total",2015,324,196,128,1691,60,418,365,300,111,158,279
"2011","St Edmundsbury 010C","E01030150","Total",2192,170,94,76,2022,60,404,377,464,168,196,353
"2011","St Edmundsbury 011A","E01030120","Total",2118,243,135,108,1875,54,338,429,408,141,158,347
"2011","St Edmundsbury 011B","E01030122","Total",1950,163,85,78,1787,45,364,476,298,127,160,317
"2011","St Edmundsbury 011C","E01030151","Total",1955,182,96,86,1773,57,338,379,370,101,208,320
"2011","St Edmundsbury 012A","E01030109","Total",1843,196,103,93,1647,157,228,428,220,184,194,236
"2011","St Edmundsbury 012B","E01030110","Total",2839,303,124,179,2536,191,266,766,444,219,263,387
"2011","St Edmundsbury 012C","E01030111","Total",1392,97,62,35,1295,30,166,282,238,104,178,297
"2011","St Edmundsbury 012D","E01030112","Total",1679,201,58,143,1478,58,212,312,350,57,138,351
"2011","St Edmundsbury 013A","E01030115","Total",2364,173,65,108,2191,191,172,585,356,240,330,317
"2011","St Edmundsbury 013B","E01030116","Total",2251,148,52,96,2103,116,188,677,344,173,296,309
"2011","St Edmundsbury 013C","E01030117","Total",1625,133,41,92,1492,78,114,495,330,88,132,255
"2011","St Edmundsbury 013D","E01030118","Total",1676,161,60,101,1515,112,124,405,246,133,219,276
"2011","St Edmundsbury 014A","E01030105","Total",1789,173,54,119,1616,82,146,387,286,94,221,400
"2011","St Edmundsbury 014B","E01030106","Total",2454,281,106,175,2173,183,168,550,444,162,303,363
"2011","St Edmundsbury 014C","E01030107","Total",1616,121,62,59,1495,33,222,294,294,107,175,370
"2011","St Edmundsbury 014D","E01030108","Total",1885,145,71,74,1740,108,162,357,280,138,234,461
"2011","St Edmundsbury 014E","E01030113","Total",1890,252,131,121,1638,85,238,391,328,122,181,293
"2011","St Edmundsbury 014F","E01030114","Total",1600,97,39,58,1503,90,106,385,148,159,317,298
"2011","Suffolk Coastal 001A","E01030201","Total",2076,223,113,110,1853,63,376,296,412,110,219,377
"2011","Suffolk Coastal 001B","E01030219","Total",1919,278,174,104,1641,66,450,247,342,119,140,277
"2011","Suffolk Coastal 001C","E01030222","Total",1843,287,157,130,1556,44,474,251,372,57,140,218
"2011","Suffolk Coastal 002A","E01030154","Total",2118,183,94,89,1935,76,368,347,410,190,223,321
"2011","Suffolk Coastal 002B","E01030172","Total",1657,210,119,91,1447,56,270,338,238,170,145,230
"2011","Suffolk Coastal 002C","E01030173","Total",1445,263,172,91,1182,44,260,255,198,102,107,216
"2011","Suffolk Coastal 002D","E01030174","Total",1338,125,53,72,1213,54,196,257,216,91,155,244
"2011","Suffolk Coastal 002E","E01030176","Total",1977,213,111,102,1764,57,350,333,390,147,171,316
"2011","Suffolk Coastal 003A","E01030186","Total",1412,141,80,61,1271,44,304,202,226,78,161,256
"2011","Suffolk Coastal 003B","E01030208","Total",1269,179,108,71,1090,64,300,163,202,53,138,170
"2011","Suffolk Coastal 003C","E01030209","Total",1491,308,154,154,1183,81,318,267,212,58,70,177
"2011","Suffolk Coastal 003D","E01030210","Total",2113,221,108,113,1892,108,294,493,276,216,237,268
"2011","Suffolk Coastal 003E","E01030212","Total",1911,233,128,105,1678,49,420,286,356,95,192,280
"2011","Suffolk Coastal 004A","E01030152","Total",1935,426,300,126,1509,26,644,213,278,91,80,177
"2011","Suffolk Coastal 004B","E01030153","Total",1219,314,195,119,905,37,240,123,234,62,71,138
"2011","Suffolk Coastal 004C","E01030187","Total",1563,169,98,71,1394,100,260,257,210,94,207,266
"2011","Suffolk Coastal 004D","E01030188","Total",1623,319,121,198,1304,97,166,312,294,93,117,225
"2011","Suffolk Coastal 004E","E01030189","Total",1625,212,96,116,1413,127,226,278,264,109,148,261
"2011","Suffolk Coastal 005A","E01030193","Total",1638,159,82,77,1479,43,276,299,258,133,179,291
"2011","Suffolk Coastal 005B","E01030194","Total",1612,365,185,180,1247,69,228,291,246,97,125,191
"2011","Suffolk Coastal 005C","E01030195","Total",1618,149,69,80,1469,25,278,327,286,80,191,282
"2011","Suffolk Coastal 005D","E01030220","Total",2120,310,199,111,1810,70,418,328,318,123,246,307
"2011","Suffolk Coastal 006A","E01030175","Total",2301,240,150,90,2061,72,412,465,360,177,231,344
"2011","Suffolk Coastal 006B","E01030200","Total",2272,163,94,69,2109,49,388,469,334,148,259,462
"2011","Suffolk Coastal 006C","E01030221","Total",1932,191,96,95,1741,30,354,331,388,114,164,360
"2011","Suffolk Coastal 007C","E01030199","Total",1828,260,146,114,1568,37,346,282,326,127,177,273
"2011","Suffolk Coastal 007F","E01033443","Total",1384,87,26,61,1297,54,156,434,256,147,112,138
"2011","Suffolk Coastal 007G","E01033445","Total",1656,131,35,96,1525,119,152,444,296,123,177,214
"2011","Suffolk Coastal 007H","E01033446","Total",2012,214,109,105,1798,33,366,347,382,78,192,400
"2011","Suffolk Coastal 007I","E01033448","Total",1253,157,77,80,1096,52,234,199,186,128,127,170
"2011","Suffolk Coastal 007J","E01033449","Total",1650,145,48,97,1505,112,146,440,326,102,161,218
"2011","Suffolk Coastal 008A","E01030155","Total",2024,227,98,129,1797,129,298,402,314,128,213,313
"2011","Suffolk Coastal 008B","E01030185","Total",2073,238,148,90,1835,186,362,409,242,120,190,326
"2011","Suffolk Coastal 008C","E01030203","Total",1909,383,285,98,1526,31,464,275,256,132,205,163
"2011","Suffolk Coastal 008D","E01030211","Total",1914,560,312,248,1354,119,374,280,320,47,89,125
"2011","Suffolk Coastal 009A","E01030179","Total",2656,245,83,162,2411,127,170,926,394,252,305,237
"2011","Suffolk Coastal 009B","E01030180","Total",1398,127,61,66,1271,48,164,356,204,108,160,231
"2011","Suffolk Coastal 009C","E01030183","Total",1965,227,150,77,1738,55,526,310,264,75,119,389
"2011","Suffolk Coastal 009D","E01030184","Total",1771,258,187,71,1513,71,392,255,218,93,172,312
"2011","Suffolk Coastal 009E","E01030207","Total",1470,181,111,70,1289,39,368,264,238,43,104,233
"2011","Suffolk Coastal 010A","E01030181","Total",1920,151,32,119,1769,66,112,635,320,118,261,257
"2011","Suffolk Coastal 010C","E01030190","Total",1790,207,128,79,1583,48,482,286,280,84,153,250
"2011","Suffolk Coastal 010D","E01030191","Total",1621,316,129,187,1305,85,206,338,258,47,140,231
"2011","Suffolk Coastal 010E","E01030192","Total",1481,134,55,79,1347,29,212,279,274,77,151,325
"2011","Suffolk Coastal 010F","E01030198","Total",1294,143,78,65,1151,24,258,212,244,76,80,257
"2011","Suffolk Coastal 010G","E01033442","Total",1622,69,11,58,1553,106,22,654,246,195,176,154
"2011","Suffolk Coastal 010H","E01033444","Total",1509,81,12,69,1428,99,18,589,220,168,191,143
"2011","Suffolk Coastal 010I","E01033447","Total",1458,146,85,61,1312,47,216,458,176,86,126,203
"2011","Suffolk Coastal 011A","E01030196","Total",1690,160,43,117,1530,33,162,430,306,112,204,283
"2011","Suffolk Coastal 011B","E01030197","Total",1565,162,91,71,1403,15,402,225,284,84,138,255
"2011","Suffolk Coastal 011C","E01030204","Total",1850,134,71,63,1716,50,326,451,264,130,183,312
"2011","Suffolk Coastal 011D","E01030205","Total",1314,64,25,39,1250,24,106,421,196,125,144,234
"2011","Suffolk Coastal 011E","E01030206","Total",1546,142,112,30,1404,19,340,275,200,82,181,307
"2011","Suffolk Coastal 012A","E01030171","Total",1907,179,71,108,1728,79,240,409,340,116,202,342
"2011","Suffolk Coastal 012B","E01030214","Total",1327,129,45,84,1198,62,106,298,204,60,171,297
"2011","Suffolk Coastal 012C","E01030215","Total",1312,233,76,157,1079,60,184,258,274,51,104,148
"2011","Suffolk Coastal 012D","E01030216","Total",1462,154,94,60,1308,35,254,286,268,63,143,259
"2011","Suffolk Coastal 012E","E01030217","Total",1316,131,74,57,1185,48,200,251,274,59,109,244
"2011","Suffolk Coastal 012F","E01030218","Total",1475,160,66,94,1315,87,178,297,294,71,166,222
"2011","Suffolk Coastal 013C","E01030158","Total",1431,162,116,46,1269,18,506,144,254,15,113,219
"2011","Suffolk Coastal 013D","E01030159","Total",1499,168,95,73,1331,97,280,292,220,66,175,201
"2011","Suffolk Coastal 013E","E01030164","Total",1461,188,131,57,1273,45,290,175,248,81,172,262
"2011","Suffolk Coastal 013F","E01030166","Total",1464,193,139,54,1271,23,390,208,214,93,117,226
"2011","Suffolk Coastal 013G","E01033450","Total",2379,335,235,100,2044,39,634,372,374,101,170,354
"2011","Suffolk Coastal 014A","E01030160","Total",1406,304,167,137,1102,62,210,257,190,78,132,173
"2011","Suffolk Coastal 014B","E01030161","Total",1393,188,83,105,1205,165,146,327,200,60,115,192
"2011","Suffolk Coastal 014C","E01030168","Total",1459,270,133,137,1189,126,134,225,192,114,158,240
"2011","Suffolk Coastal 014D","E01030169","Total",1546,294,65,229,1252,174,86,376,292,63,70,191
"2011","Suffolk Coastal 014E","E01030170","Total",1703,255,161,94,1448,123,268,243,222,136,200,256
"2011","Suffolk Coastal 015A","E01030162","Total",1245,286,125,161,959,57,154,189,232,63,119,145
"2011","Suffolk Coastal 015B","E01030163","Total",1480,214,94,120,1266,150,142,272,244,67,111,280
"2011","Suffolk Coastal 015C","E01030165","Total",1539,354,149,205,1185,69,162,266,226,48,191,223
"2011","Suffolk Coastal 015D","E01030167","Total",1337,218,138,80,1119,53,232,260,178,79,118,199
"2011","Waveney 001A","E01030240","Total",1548,245,134,111,1303,9,408,215,238,37,166,230
"2011","Waveney 001B","E01030241","Total",1434,180,113,67,1254,33,362,216,228,54,109,252
"2011","Waveney 001C","E01030242","Total",1388,119,82,37,1269,22,350,195,224,42,167,269
"2011","Waveney 001D","E01030259","Total",1096,124,66,58,972,21,166,224,186,51,123,201
"2011","Waveney 001E","E01030260","Total",988,102,46,56,886,30,134,189,236,51,108,138
"2011","Waveney 002A","E01030261","Total",1416,213,75,138,1203,128,140,223,182,141,169,220
"2011","Waveney 002B","E01030262","Total",1241,196,108,88,1045,77,188,226,196,93,107,158
"2011","Waveney 002C","E01030277","Total",1192,144,92,52,1048,91,136,156,122,91,220,232
"2011","Waveney 002D","E01030279","Total",1384,199,77,122,1185,141,156,219,160,133,165,211
"2011","Waveney 002E","E01030281","Total",2365,204,84,120,2161,147,302,575,362,162,243,370
"2011","Waveney 003A","E01030266","Total",1615,217,141,76,1398,80,234,370,268,86,149,211
"2011","Waveney 003B","E01030267","Total",1358,166,95,71,1192,76,170,282,190,80,144,250
"2011","Waveney 003C","E01030271","Total",1456,180,128,52,1276,28,456,197,230,58,100,207
"2011","Waveney 003D","E01030278","Total",1578,186,132,54,1392,61,462,197,200,68,165,239
"2011","Waveney 003E","E01030280","Total",1400,158,105,53,1242,33,330,268,212,45,131,223
"2011","Waveney 004A","E01030246","Total",1412,199,59,140,1213,138,106,305,212,117,147,188
"2011","Waveney 004B","E01030248","Total",1471,194,78,116,1277,113,100,245,238,147,181,253
"2011","Waveney 004C","E01030249","Total",1646,291,98,193,1355,146,90,354,242,88,195,240
"2011","Waveney 004D","E01030250","Total",1806,415,103,312,1391,227,94,288,256,127,201,198
"2011","Waveney 004E","E01030264","Total",1427,196,70,126,1231,134,132,352,230,132,92,159
"2011","Waveney 004F","E01030265","Total",1438,184,56,128,1254,150,128,260,238,110,130,238
"2011","Waveney 005A","E01030255","Total",1357,89,37,52,1268,74,128,272,212,149,179,254
"2011","Waveney 005B","E01030263","Total",1365,223,132,91,1142,48,334,155,232,62,90,221
"2011","Waveney 005C","E01030270","Total",1499,223,129,94,1276,132,222,257,218,90,130,227
"2011","Waveney 005D","E01030289","Total",1445,259,120,139,1186,72,190,246,216,127,119,216
"2011","Waveney 005E","E01030290","Total",1508,204,130,74,1304,53,340,256,192,96,123,244
"2011","Waveney 006A","E01030233","Total",1512,128,85,43,1384,26,306,278,302,76,145,251
"2011","Waveney 006B","E01030235","Total",1444,156,106,50,1288,19,326,255,260,101,151,176
"2011","Waveney 006C","E01030268","Total",1353,101,62,39,1252,32,198,260,224,114,204,220
"2011","Waveney 006D","E01030269","Total",1552,250,150,100,1302,37,330,262,292,38,106,237
"2011","Waveney 006E","E01030288","Total",1414,140,104,36,1274,30,406,197,188,37,166,250
"2011","Waveney 007A","E01030247","Total",1422,512,180,332,910,95,126,183,258,73,76,99
"2011","Waveney 007B","E01030254","Total",1463,158,53,105,1305,151,118,340,242,93,117,244
"2011","Waveney 007C","E01030256","Total",1344,265,101,164,1079,70,140,197,192,79,188,213
"2011","Waveney 007D","E01030258","Total",1485,461,147,314,1024,98,96,175,240,95,145,175
"2011","Waveney 007E","E01030276","Total",1223,218,89,129,1005,113,176,187,202,52,83,192
"2011","Waveney 008A","E01030257","Total",1490,189,117,72,1301,78,214,289,206,83,147,284
"2011","Waveney 008B","E01030274","Total",1168,298,192,106,870,57,232,143,130,54,101,153
"2011","Waveney 008C","E01030275","Total",1131,120,66,54,1011,22,198,162,234,68,159,168
"2011","Waveney 008D","E01030287","Total",1425,210,139,71,1215,71,352,153,166,81,182,210
"2011","Waveney 008E","E01030291","Total",1477,148,85,63,1329,185,180,197,222,120,230,195
"2011","Waveney 009A","E01030234","Total",1592,176,49,127,1416,227,82,423,282,95,144,163
"2011","Waveney 009B","E01030236","Total",1737,232,129,103,1505,93,312,331,300,102,119,248
"2011","Waveney 009C","E01030237","Total",2830,220,93,127,2610,124,380,769,448,195,285,409
"2011","Waveney 009D","E01030238","Total",1848,138,73,65,1710,85,190,444,292,107,258,334
"2011","Waveney 010A","E01030223","Total",1715,297,159,138,1418,84,320,297,248,118,134,217
"2011","Waveney 010B","E01030224","Total",1585,268,182,86,1317,55,356,266,258,42,143,197
"2011","Waveney 010C","E01030225","Total",1604,364,157,207,1240,127,246,228,312,55,94,178
"2011","Waveney 010D","E01030227","Total",1441,195,116,79,1246,106,206,252,190,141,152,199
"2011","Waveney 010E","E01030228","Total",1746,187,131,56,1559,54,418,305,300,102,130,250
"2011","Waveney 011A","E01030226","Total",1904,192,101,91,1712,157,218,434,256,106,199,342
"2011","Waveney 011B","E01030286","Total",2181,193,88,105,1988,64,374,330,388,125,267,440
"2011","Waveney 011C","E01030292","Total",1485,155,100,55,1330,50,334,325,224,35,132,230
"2011","Waveney 011D","E01030293","Total",1700,132,83,49,1568,32,332,398,280,80,189,257
"2011","Waveney 011E","E01030294","Total",1488,173,109,64,1315,81,234,361,238,71,126,204
"2011","Waveney 012A","E01030239","Total",2018,126,37,89,1892,115,116,523,330,211,278,319
"2011","Waveney 012B","E01030251","Total",1572,190,84,106,1382,100,314,242,252,97,124,253
"2011","Waveney 012C","E01030252","Total",1723,237,137,100,1486,64,452,221,298,101,88,262
"2011","Waveney 012D","E01030253","Total",1788,234,131,103,1554,113,262,332,308,70,202,267
"2011","Waveney 012E","E01030272","Total",1494,264,173,91,1230,71,378,228,256,36,72,189
"2011","Waveney 012F","E01030273","Total",1515,212,151,61,1303,34,496,190,226,25,96,236
"2011","Waveney 013A","E01030230","Total",1733,429,214,215,1304,75,248,260,336,76,139,170
"2011","Waveney 013B","E01030231","Total",1568,181,99,82,1387,104,212,331,230,115,159,236
"2011","Waveney 013C","E01030232","Total",1689,162,103,59,1527,105,264,326,248,135,199,250
"2011","Waveney 013D","E01030285","Total",2239,220,123,97,2019,50,374,354,390,165,277,409
"2011","Waveney 014A","E01030282","Total",1082,332,231,101,750,20,332,88,184,10,33,83
"2011","Waveney 014B","E01030283","Total",1266,195,129,66,1071,65,206,244,174,57,131,194
"2011","Waveney 014C","E01030284","Total",1222,195,143,52,1027,22,396,191,192,31,85,110
"2011","Waveney 014D","E01030295","Total",2218,260,121,139,1958,114,374,362,436,82,213,377
"2011","Waveney 015A","E01030229","Total",2148,245,149,96,1903,108,466,305,346,93,203,382
"2011","Waveney 015B","E01030243","Total",1461,192,114,78,1269,85,282,241,222,89,125,225
"2011","Waveney 015C","E01030244","Total",1603,410,225,185,1193,31,340,167,304,31,154,166
"2011","Waveney 015D","E01030245","Total",1588,275,200,75,1313,36,368,219,224,98,129,239
"2011","Camden 001A","E01000907","Total",1430,207,57,150,1223,182,88,242,246,61,129,275
"2011","Camden 001B","E01000908","Total",1581,420,103,317,1161,159,110,275,228,72,88,229
"2011","Camden 001C","E01000909","Total",1614,199,82,117,1415,37,156,244,226,76,205,471
"2011","Camden 001D","E01000912","Total",1589,270,111,159,1319,105,84,243,212,44,217,414
"2011","Camden 001E","E01000913","Total",1702,210,85,125,1492,22,236,361,292,112,152,317
"2011","Camden 002A","E01000893","Total",1566,281,82,199,1285,45,138,330,240,78,175,279
"2011","Camden 002B","E01000894","Total",1376,209,74,135,1167,20,140,340,276,98,91,202
"2011","Camden 002C","E01000895","Total",1629,403,172,231,1226,44,106,366,336,51,100,223
"2011","Camden 002D","E01000896","Total",1692,258,89,169,1434,15,190,397,306,129,131,266
"2011","Camden 002E","E01000899","Total",1606,229,65,164,1377,33,206,387,232,138,168,213
"2011","Camden 003A","E01000910","Total",1472,173,53,120,1299,16,124,247,216,108,195,393
"2011","Camden 003B","E01000911","Total",1549,220,75,145,1329,107,114,294,264,81,189,280
"2011","Camden 003C","E01000921","Total",1963,381,50,331,1582,104,48,306,506,40,192,386
"2011","Camden 003D","E01000923","Total",1436,266,53,213,1170,63,60,254,244,76,128,345
"2011","Camden 003E","E01000928","Total",1620,234,59,175,1386,135,104,289,240,53,189,376
"2011","Camden 004A","E01000878","Total",1246,188,72,116,1058,19,150,265,202,52,115,255
"2011","Camden 004B","E01000879","Total",1305,237,64,173,1068,31,124,307,218,97,60,231
"2011","Camden 004C","E01000880","Total",1558,191,57,134,1367,47,76,386,252,201,190,215
"2011","Camden 004D","E01000884","Total",1462,181,61,120,1281,33,102,347,188,155,199,257
"2011","Camden 004E","E01000885","Total",1410,172,78,94,1238,39,224,340,182,126,98,229
"2011","Camden 005A","E01000871","Total",1653,183,51,132,1470,41,96,237,232,101,333,430
"2011","Camden 005B","E01000872","Total",1896,382,51,331,1514,73,54,261,464,44,167,451
"2011","Camden 005C","E01000873","Total",1639,235,61,174,1404,67,76,322,294,50,130,465
"2011","Camden 005D","E01000874","Total",1559,227,61,166,1332,25,134,358,342,51,85,337
"2011","Camden 005E","E01000877","Total",1546,274,45,229,1272,31,86,318,352,60,75,350
"2011","Camden 006A","E01000886","Total",1445,187,41,146,1258,89,96,286,224,99,114,350
"2011","Camden 006B","E01000887","Total",1478,262,60,202,1216,60,70,270,348,70,106,292
"2011","Camden 006C","E01000888","Total",1605,252,56,196,1353,80,90,320,286,100,194,283
"2011","Camden 006D","E01000892","Total",1843,308,95,213,1535,104,130,347,326,114,176,338
"2011","Camden 006E","E01000903","Total",1418,301,117,184,1117,32,68,271,302,31,133,280
"2011","Camden 007A","E01000889","Total",1670,224,69,155,1446,166,86,250,158,104,290,392
"2011","Camden 007B","E01000890","Total",1625,357,118,239,1268,144,138,168,164,132,245,277
"2011","Camden 007C","E01000891","Total",1534,279,77,202,1255,184,60,179,200,111,232,289
"2011","Camden 007D","E01000901","Total",1821,228,51,177,1593,240,54,284,166,188,329,332
"2011","Camden 007E","E01000922","Total",1537,266,57,209,1271,82,54,160,254,57,191,473
"2011","Camden 007F","E01000927","Total",1732,205,63,142,1527,69,104,299,354,63,109,529
"2011","Camden 008A","E01000881","Total",1451,247,57,190,1204,32,78,239,290,171,132,262
"2011","Camden 008B","E01000882","Total",1512,281,67,214,1231,32,118,320,384,104,79,194
"2011","Camden 008C","E01000883","Total",1319,258,69,189,1061,28,86,247,320,50,92,238
"2011","Camden 008D","E01000897","Total",1595,243,82,161,1352,8,176,451,340,119,102,156
"2011","Camden 008E","E01000898","Total",1688,418,88,330,1270,63,88,281,326,93,111,308
"2011","Camden 009A","E01000866","Total",2030,364,97,267,1666,103,134,289,370,119,174,477
"2011","Camden 009B","E01000870","Total",1693,316,86,230,1377,87,64,261,326,71,189,379
"2011","Camden 009C","E01000924","Total",1637,307,55,252,1330,54,90,223,462,32,169,300
"2011","Camden 009D","E01000925","Total",1552,246,107,139,1306,177,60,198,154,131,262,324
"2011","Camden 009E","E01000926","Total",1791,204,49,155,1587,117,54,183,268,82,147,736
"2011","Camden 010A","E01000969","Total",2032,341,79,262,1691,62,76,336,532,56,97,532
"2011","Camden 010B","E01000970","Total",1444,406,39,367,1038,27,60,127,500,10,30,284
"2011","Camden 010C","E01000971","Total",1478,222,50,172,1256,26,72,373,310,64,72,339
"2011","Camden 010D","E01000972","Total",2009,414,88,326,1595,156,90,272,352,88,237,400
"2011","Camden 010E","E01000973","Total",1883,341,53,288,1542,99,48,205,518,82,115,475
"2011","Camden 011A","E01000842","Total",1368,340,106,234,1028,28,92,271,350,46,78,163
"2011","Camden 011B","E01000844","Total",1772,362,81,281,1410,30,78,433,440,68,137,224
"2011","Camden 011C","E01000848","Total",1580,348,90,258,1232,15,132,314,424,78,132,137
"2011","Camden 011D","E01000849","Total",1569,466,118,348,1103,52,66,243,336,41,120,245
"2011","Camden 012A","E01000900","Total",1795,256,72,184,1539,120,100,259,312,77,267,404
"2011","Camden 012B","E01000902","Total",1451,216,83,133,1235,155,54,237,184,105,226,274
"2011","Camden 012C","E01000904","Total",2120,309,80,229,1811,180,124,258,396,142,194,517
"2011","Camden 012D","E01000905","Total",1965,300,125,175,1665,273,102,225,226,181,263,395
"2011","Camden 012E","E01000906","Total",1532,319,95,224,1213,25,134,192,458,61,72,271
"2011","Camden 013A","E01000875","Total",1646,369,75,294,1277,109,64,187,440,44,88,345
"2011","Camden 013B","E01000876","Total",1748,342,78,264,1406,130,78,200,304,116,223,355
"2011","Camden 013C","E01000931","Total",1902,357,83,274,1545,154,88,253,340,89,216,405
"2011","Camden 013D","E01000932","Total",1825,402,85,317,1423,101,56,177,552,30,72,435
"2011","Camden 013E","E01000974","Total",1702,358,72,286,1344,83,60,172,368,56,183,422
"2011","Camden 014A","E01000843","Total",1678,354,90,264,1324,146,98,390,376,53,96,165
"2011","Camden 014B","E01000845","Total",1444,340,75,265,1104,46,78,237,328,69,119,227
"2011","Camden 014C","E01000846","Total",1499,220,86,134,1279,182,120,251,128,122,218,258
"2011","Camden 014D","E01000847","Total",1684,233,72,161,1451,140,110,329,194,171,243,264
"2011","Camden 015A","E01000864","Total",1537,265,42,223,1272,85,76,206,376,33,153,343
"2011","Camden 015B","E01000865","Total",977,182,31,151,795,25,66,117,188,62,120,217
"2011","Camden 015C","E01000867","Total",1608,239,74,165,1369,148,64,140,328,106,183,400
"2011","Camden 015D","E01000868","Total",1442,219,39,180,1223,152,38,271,184,129,263,186
"2011","Camden 015E","E01000869","Total",2098,364,104,260,1734,106,64,302,514,90,137,521
"2011","Camden 016A","E01000962","Total",1592,236,37,199,1356,47,58,383,504,10,68,286
"2011","Camden 016B","E01000964","Total",1577,260,70,190,1317,76,94,320,306,51,143,327
"2011","Camden 016C","E01000965","Total",1522,313,69,244,1209,70,78,232,428,51,103,247
"2011","Camden 016D","E01000966","Total",1508,222,55,167,1286,21,86,355,370,31,106,317
"2011","Camden 016E","E01000968","Total",1504,314,88,226,1190,49,50,247,444,20,65,315
"2011","Camden 017A","E01000960","Total",1774,321,72,249,1453,82,114,315,434,98,160,250
"2011","Camden 017B","E01000961","Total",1591,197,59,138,1394,137,136,269,220,154,202,276
"2011","Camden 017C","E01000963","Total",1864,311,117,194,1553,63,138,414,358,70,133,377
"2011","Camden 017D","E01000967","Total",1409,225,84,141,1184,31,132,260,208,128,158,267
"2011","Camden 018A","E01000857","Total",1443,301,101,200,1142,40,90,223,260,130,123,276
"2011","Camden 018B","E01000858","Total",1861,287,55,232,1574,137,60,240,264,94,339,440
"2011","Camden 018C","E01000859","Total",1586,380,80,300,1206,16,92,327,344,82,109,236
"2011","Camden 018D","E01000860","Total",1307,515,195,320,792,38,110,195,198,49,75,127
"2011","Camden 018E","E01000862","Total",1712,293,76,217,1419,41,166,308,436,80,127,261
"2011","Camden 019A","E01000856","Total",1645,205,38,167,1440,84,46,185,228,219,254,424
"2011","Camden 019B","E01000861","Total",1574,315,41,274,1259,86,56,140,310,37,175,455
"2011","Camden 019C","E01000957","Total",1729,263,58,205,1466,136,58,211,410,76,211,364
"2011","Camden 019D","E01000958","Total",2108,237,34,203,1871,192,66,221,332,117,365,578
"2011","Camden 019E","E01000959","Total",1670,264,83,181,1406,129,98,157,176,129,223,494
"2011","Camden 020A","E01000929","Total",1675,245,69,176,1430,168,90,277,210,155,243,287
"2011","Camden 020B","E01000930","Total",1910,628,235,393,1282,169,78,269,330,101,105,230
"2011","Camden 020C","E01000933","Total",1671,340,95,245,1331,51,74,195,426,61,112,412
"2011","Camden 020D","E01000934","Total",1542,338,106,232,1204,116,58,256,252,117,154,251
"2011","Camden 020E","E01000935","Total",1415,241,50,191,1174,184,42,288,214,134,135,177
"2011","Camden 021A","E01000863","Total",1383,255,30,225,1128,64,58,141,394,38,80,353
"2011","Camden 021B","E01000946","Total",1475,312,84,228,1163,85,98,176,262,58,145,339
"2011","Camden 021C","E01000947","Total",1925,344,44,300,1581,43,52,144,424,55,204,659
"2011","Camden 021D","E01000948","Total",1708,362,103,259,1346,104,130,273,350,42,127,320
"2011","Camden 022A","E01000952","Total",1728,206,56,150,1522,155,92,177,216,117,258,507
"2011","Camden 022B","E01000953","Total",1643,299,132,167,1344,103,90,195,216,73,298,369
"2011","Camden 022C","E01000954","Total",1656,202,61,141,1454,236,80,203,152,217,259,307
"2011","Camden 022D","E01000955","Total",1505,293,83,210,1212,122,62,300,126,94,198,310
"2011","Camden 022E","E01000956","Total",1532,221,28,193,1311,120,34,182,226,124,289,336
"2011","Camden 023A","E01000944","Total",1899,188,54,134,1711,108,70,141,182,92,257,861
"2011","Camden 023B","E01000945","Total",1493,223,36,187,1270,132,54,130,236,91,175,452
"2011","Camden 023C","E01000949","Total",1578,331,103,228,1247,134,98,256,210,117,152,280
"2011","Camden 023D","E01000950","Total",1431,192,48,144,1239,103,52,218,136,165,211,354
"2011","Camden 023E","E01000951","Total",1538,230,97,133,1308,90,68,186,118,137,279,430
"2011","Camden 024A","E01000936","Total",1360,194,50,144,1166,162,42,136,182,50,301,293
"2011","Camden 024B","E01000938","Total",1726,305,38,267,1421,339,40,94,256,56,146,490
"2011","Camden 024C","E01000939","Total",1197,156,49,107,1041,95,50,109,102,126,239,320
"2011","Camden 024D","E01000940","Total",1124,253,61,192,871,52,62,169,178,73,131,206
"2011","Camden 025A","E01000853","Total",1596,469,197,272,1127,171,116,112,214,78,104,332
"2011","Camden 025B","E01000937","Total",943,296,40,256,647,74,26,58,154,27,92,216
"2011","Camden 025C","E01000941","Total",1203,242,56,186,961,132,70,157,146,54,143,259
"2011","Camden 025D","E01000942","Total",1181,381,73,308,800,50,38,83,300,30,51,248
"2011","Camden 025E","E01000943","Total",991,359,54,305,632,53,22,98,246,15,50,148
"2011","Camden 026A","E01000850","Total",1281,324,77,247,957,20,66,97,310,27,53,384
"2011","Camden 026B","E01000851","Total",1645,423,55,368,1222,61,48,84,438,35,95,461
"2011","Camden 026C","E01000852","Total",976,388,79,309,588,16,84,63,218,0,22,185
"2011","Camden 026D","E01000854","Total",1643,310,64,246,1333,135,54,87,242,60,162,593
"2011","Camden 027A","E01000915","Total",1527,247,69,178,1280,107,84,171,214,110,221,373
"2011","Camden 027B","E01000916","Total",1718,392,64,328,1326,115,88,153,472,85,144,269
"2011","Camden 027C","E01000917","Total",1855,458,99,359,1397,180,48,319,284,131,189,246
"2011","Camden 027D","E01000920","Total",1921,409,87,322,1512,85,86,236,458,68,146,433
"2011","Camden 028A","E01000855","Total",1714,750,134,616,964,3,82,86,338,5,38,412
"2011","Camden 028B","E01000914","Total",1753,483,109,374,1270,45,90,126,514,24,116,355
"2011","Camden 028C","E01000918","Total",1885,482,122,360,1403,54,94,134,332,74,219,496
"2011","Camden 028D","E01000919","Total",1658,434,73,361,1224,40,68,85,326,26,316,363
"2011","City of London 001A","E01000001","Total",1465,453,120,333,1012,20,172,201,436,21,27,135
"2011","City of London 001B","E01000002","Total",1436,418,122,296,1018,24,156,261,396,16,32,133
"2011","City of London 001C","E01000003","Total",1250,507,164,343,743,62,90,161,300,11,8,111
"2011","City of London 001E","E01000005","Total",985,228,61,167,757,53,42,120,134,31,186,191
"2011","City of London 001F","E01032739","Total",1002,409,17,392,593,12,26,54,412,10,12,67
"2011","City of London 001G","E01032740","Total",1049,457,42,415,592,0,44,62,382,6,4,94
"2011","Hackney 001A","E01001808","Total",1838,150,29,121,1688,32,48,327,178,483,402,218
"2011","Hackney 001B","E01001809","Total",1969,185,72,113,1784,73,72,184,188,399,590,278
"2011","Hackney 001C","E01001814","Total",1658,152,28,124,1506,75,46,299,198,271,351,266
"2011","Hackney 001D","E01001823","Total",1765,147,38,109,1618,99,50,217,108,488,418,238
"2011","Hackney 001E","E01001825","Total",1598,94,28,66,1504,22,60,206,132,456,535,93
"2011","Hackney 002A","E01001714","Total",1468,227,57,170,1241,164,56,177,218,71,189,366
"2011","Hackney 002D","E01001811","Total",1494,252,92,160,1242,137,70,259,182,100,221,273
"2011","Hackney 002E","E01001813","Total",1241,188,33,155,1053,167,60,156,164,75,145,286
"2011","Hackney 002F","E01033701","Total",1818,278,73,205,1540,160,76,211,222,82,355,434
"2011","Hackney 003A","E01001799","Total",1582,119,32,87,1463,26,56,260,198,391,366,166
"2011","Hackney 003B","E01001802","Total",1240,164,47,117,1076,83,44,162,160,221,196,210
"2011","Hackney 003C","E01001804","Total",1512,102,35,67,1410,44,72,230,150,343,334,237
"2011","Hackney 003D","E01001807","Total",1804,248,55,193,1556,100,38,240,288,272,303,315
"2011","Hackney 003E","E01001812","Total",1746,205,59,146,1541,103,58,302,180,317,332,249
"2011","Hackney 004A","E01001725","Total",1909,154,34,120,1755,77,48,188,172,472,523,275
"2011","Hackney 004B","E01001726","Total",1357,110,26,84,1247,147,18,216,138,138,315,275
"2011","Hackney 004C","E01001800","Total",1596,267,65,202,1329,134,48,304,164,321,197,161
"2011","Hackney 004D","E01001824","Total",1517,167,42,125,1350,139,70,260,140,262,323,156
"2011","Hackney 004E","E01001826","Total",1728,183,46,137,1545,133,66,226,154,381,350,235
"2011","Hackney 006A","E01001723","Total",1944,182,39,143,1762,66,46,254,298,133,516,449
"2011","Hackney 006B","E01001724","Total",2219,386,41,345,1833,131,36,336,482,91,284,473
"2011","Hackney 006C","E01001727","Total",1911,140,29,111,1771,60,58,242,198,376,528,309
"2011","Hackney 006D","E01001768","Total",1819,193,34,159,1626,113,36,228,382,64,256,547
"2011","Hackney 006E","E01001769","Total",1581,228,35,193,1353,78,48,234,314,62,210,407
"2011","Hackney 007A","E01001715","Total",1316,274,25,249,1042,55,4,166,442,10,41,324
"2011","Hackney 007B","E01001716","Total",1260,290,42,248,970,116,32,143,294,32,103,250
"2011","Hackney 007C","E01001717","Total",1222,98,15,83,1124,58,24,145,204,126,233,334
"2011","Hackney 007D","E01001718","Total",1787,284,17,267,1503,26,44,175,556,35,165,502
"2011","Hackney 007E","E01001719","Total",1136,166,60,106,970,55,86,148,168,67,124,322
"2011","Hackney 007F","E01001720","Total",1720,256,35,221,1464,51,44,227,496,26,137,483
"2011","Hackney 008A","E01001742","Total",1810,275,69,206,1535,165,46,322,326,50,208,418
"2011","Hackney 008B","E01001801","Total",1614,223,100,123,1391,90,50,218,164,218,430,221
"2011","Hackney 008C","E01001803","Total",1863,217,61,156,1646,113,64,327,320,243,218,361
"2011","Hackney 008D","E01001806","Total",1546,265,65,200,1281,136,74,255,314,78,101,323
"2011","Hackney 009A","E01001741","Total",1490,171,32,139,1319,57,52,417,280,74,131,308
"2011","Hackney 009B","E01001805","Total",1206,160,23,137,1046,59,28,201,262,46,126,324
"2011","Hackney 009C","E01001829","Total",1794,187,36,151,1607,46,48,466,326,134,154,433
"2011","Hackney 009D","E01001831","Total",1677,246,62,184,1431,69,76,222,388,63,143,470
"2011","Hackney 009E","E01001832","Total",1607,204,39,165,1403,70,36,218,256,50,203,570
"2011","Hackney 010A","E01001764","Total",1688,253,53,200,1435,94,54,214,278,130,257,408
"2011","Hackney 010B","E01001765","Total",1717,325,97,228,1392,164,62,207,156,195,350,258
"2011","Hackney 010D","E01001767","Total",1593,177,39,138,1416,152,22,237,262,98,209,436
"2011","Hackney 010E","E01001770","Total",1732,332,73,259,1400,177,44,287,232,86,213,361
"2011","Hackney 010F","E01033703","Total",1395,259,56,203,1136,119,46,137,232,61,202,339
"2011","Hackney 010G","E01033713","Total",1324,237,26,211,1087,136,28,194,254,69,132,274
"2011","Hackney 011A","E01001792","Total",1735,180,43,137,1555,103,82,246,168,76,357,523
"2011","Hackney 011B","E01001793","Total",1685,200,33,167,1485,115,66,270,242,74,204,514
"2011","Hackney 011C","E01001794","Total",1794,182,38,144,1612,64,74,198,282,103,381,510
"2011","Hackney 011D","E01001795","Total",1464,181,23,158,1283,91,48,201,234,89,188,432
"2011","Hackney 011E","E01001796","Total",1647,312,35,277,1335,131,26,203,264,78,197,436
"2011","Hackney 012A","E01001736","Total",1656,231,25,206,1425,88,58,348,332,77,182,340
"2011","Hackney 012B","E01001737","Total",1838,212,33,179,1626,93,50,422,368,72,155,466
"2011","Hackney 012C","E01001738","Total",1755,280,48,232,1475,96,42,345,412,93,142,345
"2011","Hackney 012D","E01001739","Total",2039,299,67,232,1740,103,64,423,456,110,123,461
"2011","Hackney 013A","E01001786","Total",1825,251,66,185,1574,284,36,335,154,150,321,294
"2011","Hackney 013B","E01001787","Total",1589,228,120,108,1361,228,98,176,138,165,299,257
"2011","Hackney 013C","E01001788","Total",1582,282,107,175,1300,216,64,225,166,148,315,166
"2011","Hackney 013D","E01001790","Total",1343,148,35,113,1195,202,46,210,98,150,289,200
"2011","Hackney 014A","E01001740","Total",1566,198,61,137,1368,212,56,207,182,127,194,390
"2011","Hackney 014B","E01001747","Total",2137,308,85,223,1829,123,70,240,498,57,173,668
"2011","Hackney 014C","E01001830","Total",1904,415,93,322,1489,125,96,226,370,62,152,458
"2011","Hackney 014D","E01001833","Total",2132,323,42,281,1809,200,44,354,422,68,270,451
"2011","Hackney 014E","E01001834","Total",2059,258,34,224,1801,147,32,282,452,121,190,577
"2011","Hackney 014F","E01001835","Total",1249,123,16,107,1126,23,46,228,250,59,160,360
"2011","Hackney 015A","E01001733","Total",1815,221,41,180,1594,105,64,325,240,108,246,506
"2011","Hackney 015B","E01001785","Total",1486,157,55,102,1329,105,96,206,200,94,213,415
"2011","Hackney 015C","E01001789","Total",1739,188,40,148,1551,139,58,299,208,101,250,496
"2011","Hackney 015D","E01001791","Total",1529,112,37,75,1417,149,42,187,144,145,364,386
"2011","Hackney 016A","E01001745","Total",2249,346,45,301,1903,260,50,269,364,111,407,442
"2011","Hackney 016B","E01001746","Total",1656,176,40,136,1480,289,24,334,170,169,255,239
"2011","Hackney 016C","E01001757","Total",1717,175,36,139,1542,205,52,286,210,111,332,346
"2011","Hackney 016D","E01001758","Total",2087,321,72,249,1766,221,60,325,314,171,287,388
"2011","Hackney 016E","E01001759","Total",1804,268,70,198,1536,105,56,172,288,100,306,509
"2011","Hackney 016F","E01001761","Total",1779,403,107,296,1376,143,50,219,330,43,148,443
"2011","Hackney 017A","E01001731","Total",2299,437,47,390,1862,250,52,319,364,144,263,470
"2011","Hackney 017B","E01001734","Total",1814,340,57,283,1474,162,58,196,378,87,154,439
"2011","Hackney 017C","E01001760","Total",1754,248,55,193,1506,143,72,192,366,61,191,481
"2011","Hackney 017D","E01001762","Total",1765,303,48,255,1462,109,36,232,422,20,131,512
"2011","Hackney 018A","E01001846","Total",1216,213,78,135,1003,135,80,120,158,68,209,233
"2011","Hackney 018B","E01001847","Total",1110,160,45,115,950,120,38,155,166,93,144,234
"2011","Hackney 018C","E01001848","Total",1605,251,95,156,1354,157,58,187,200,111,295,346
"2011","Hackney 018D","E01001849","Total",2335,327,35,292,2008,334,32,306,432,158,213,533
"2011","Hackney 019A","E01001729","Total",2021,335,49,286,1686,290,40,415,220,119,256,346
"2011","Hackney 019B","E01001730","Total",1921,304,52,252,1617,275,92,313,208,165,278,286
"2011","Hackney 019C","E01001732","Total",1715,231,53,178,1484,280,58,249,198,135,262,302
"2011","Hackney 019D","E01001735","Total",1632,209,74,135,1423,127,98,233,250,120,217,378
"2011","Hackney 019E","E01001838","Total",1746,248,74,174,1498,290,64,271,162,147,288,276
"2011","Hackney 019F","E01001850","Total",1810,204,56,148,1606,338,46,235,176,209,299,303
"2011","Hackney 020A","E01001748","Total",2287,445,46,399,1842,167,64,205,562,60,191,593
"2011","Hackney 020B","E01001749","Total",1717,244,45,199,1473,93,48,324,378,37,155,438
"2011","Hackney 020C","E01001763","Total",1642,281,69,212,1361,131,72,205,316,80,205,352
"2011","Hackney 020D","E01001816","Total",1625,182,48,134,1443,121,70,256,250,118,220,408
"2011","Hackney 020E","E01001819","Total",1577,231,77,154,1346,86,90,233,286,80,153,418
"2011","Hackney 021B","E01001744","Total",1879,263,78,185,1616,126,96,230,306,77,279,502
"2011","Hackney 021C","E01001750","Total",1838,238,50,188,1600,108,84,246,396,63,208,495
"2011","Hackney 021D","E01001751","Total",1547,196,42,154,1351,36,92,234,402,65,51,471
"2011","Hackney 021E","E01001756","Total",2155,341,69,272,1814,91,80,224,578,48,125,668
"2011","Hackney 021F","E01033698","Total",1259,293,132,161,966,126,42,141,228,43,171,215
"2011","Hackney 021G","E01033699","Total",1217,229,21,208,988,38,8,143,384,10,118,287
"2011","Hackney 021H","E01033700","Total",1510,244,41,203,1266,74,28,124,448,80,82,430
"2011","Hackney 021I","E01033707","Total",1303,252,27,225,1051,47,38,126,324,20,156,340
"2011","Hackney 022A","E01001836","Total",1866,336,81,255,1530,185,62,343,382,118,181,259
"2011","Hackney 022B","E01001840","Total",1676,287,96,191,1389,197,46,230,190,161,236,329
"2011","Hackney 022C","E01001841","Total",1411,256,72,184,1155,62,62,268,206,92,171,294
"2011","Hackney 022D","E01001844","Total",1888,321,50,271,1567,111,40,278,344,166,194,434
"2011","Hackney 022E","E01001845","Total",1555,276,67,209,1279,182,62,179,182,131,260,283
"2011","Hackney 023B","E01001837","Total",1478,219,45,174,1259,79,66,271,396,56,126,265
"2011","Hackney 023C","E01001839","Total",2102,290,33,257,1812,213,32,258,566,63,144,536
"2011","Hackney 023D","E01001842","Total",1589,193,29,164,1396,193,40,246,246,104,260,307
"2011","Hackney 023E","E01001843","Total",1244,153,41,112,1091,117,46,214,192,66,192,264
"2011","Hackney 023F","E01033704","Total",1631,256,9,247,1375,97,10,255,528,45,125,315
"2011","Hackney 023G","E01033712","Total",1578,204,23,181,1374,179,26,203,314,81,159,412
"2011","Hackney 024A","E01001772","Total",1046,192,34,158,854,134,36,128,122,58,175,201
"2011","Hackney 024B","E01001774","Total",2082,248,43,205,1834,201,34,280,504,123,261,431
"2011","Hackney 024C","E01001775","Total",1776,300,86,214,1476,181,48,195,250,142,243,417
"2011","Hackney 024D","E01001815","Total",1774,260,81,179,1514,144,56,214,188,103,343,466
"2011","Hackney 024E","E01001820","Total",1463,206,61,145,1257,109,66,167,194,107,210,404
"2011","Hackney 024F","E01001821","Total",1460,263,71,192,1197,136,74,213,178,89,184,323
"2011","Hackney 025A","E01001752","Total",2307,345,48,297,1962,143,70,270,666,89,205,519
"2011","Hackney 025B","E01001753","Total",1629,240,45,195,1389,215,44,310,222,133,179,286
"2011","Hackney 025C","E01001754","Total",2379,464,72,392,1915,204,78,295,538,126,265,409
"2011","Hackney 025D","E01001755","Total",1754,242,45,197,1512,191,58,321,240,101,271,330
"2011","Hackney 025E","E01001773","Total",2052,278,60,218,1774,146,96,239,440,111,332,410
"2011","Hackney 025F","E01001776","Total",1439,259,73,186,1180,98,68,176,182,71,156,429
"2011","Hackney 026A","E01001779","Total",2428,476,66,410,1952,248,70,283,494,153,306,398
"2011","Hackney 026B","E01001781","Total",1667,277,79,198,1390,196,64,216,222,36,198,458
"2011","Hackney 026C","E01001782","Total",2300,379,57,322,1921,144,64,312,584,63,235,519
"2011","Hackney 026D","E01001783","Total",1897,329,78,251,1568,279,48,247,270,80,189,455
"2011","Hackney 027B","E01001777","Total",2358,366,35,331,1992,229,82,288,482,156,175,580
"2011","Hackney 027D","E01001780","Total",1825,413,92,321,1412,200,52,215,374,74,110,387
"2011","Hackney 027E","E01001784","Total",1869,265,65,200,1604,179,62,226,340,100,197,500
"2011","Hackney 027F","E01033706","Total",1539,288,9,279,1251,94,16,119,494,20,34,474
"2011","Hackney 027G","E01033708","Total",1509,415,11,404,1094,12,6,103,608,12,46,307
"2011","Hackney 027H","E01033709","Total",1599,349,30,319,1250,144,42,152,346,80,113,373
"2011","Hackney 027I","E01033711","Total",943,221,21,200,722,49,14,48,302,16,35,258
"2011","Hackney 028A","E01001798","Total",1785,251,68,183,1534,233,66,233,164,98,427,313
"2011","Hackney 028B","E01001828","Total",2057,298,55,243,1759,339,44,345,206,155,316,354
"2011","Hackney 028C","E01033702","Total",1193,162,12,150,1031,142,18,180,220,179,156,136
"2011","Hackney 028D","E01033705","Total",1417,195,20,175,1222,208,28,161,234,165,222,204
"2011","Hackney 028E","E01033710","Total",1159,197,14,183,962,191,14,246,228,83,76,124
"2011","Hackney 029A","E01001722","Total",2028,345,62,283,1683,213,68,314,262,236,209,381
"2011","Hackney 029B","E01001728","Total",2015,117,42,75,1898,166,50,493,188,503,317,181
"2011","Hackney 029C","E01001822","Total",1780,272,67,205,1508,203,52,284,160,232,262,315
"2011","Hackney 029D","E01001827","Total",1916,285,69,216,1631,214,76,219,146,263,473,240
"2011","Hammersmith and Fulham 001A","E01001874","Total",2052,457,109,348,1595,131,64,254,350,48,173,575
"2011","Hammersmith and Fulham 001B","E01001875","Total",1854,172,62,110,1682,226,116,199,170,150,299,522
"2011","Hammersmith and Fulham 001C","E01001876","Total",1898,357,42,315,1541,220,74,285,224,196,265,277
"2011","Hammersmith and Fulham 001D","E01001877","Total",1338,263,40,223,1075,129,48,195,194,62,130,317
"2011","Hammersmith and Fulham 001E","E01001878","Total",1689,122,54,68,1567,225,102,275,202,158,196,409
"2011","Hammersmith and Fulham 002A","E01001955","Total",1807,175,55,120,1632,230,112,233,184,151,291,431
"2011","Hammersmith and Fulham 002B","E01001957","Total",1616,162,48,114,1454,238,40,214,172,99,299,392
"2011","Hammersmith and Fulham 002C","E01001958","Total",1671,178,49,129,1493,290,40,238,146,127,273,379
"2011","Hammersmith and Fulham 002D","E01001961","Total",1564,130,41,89,1434,211,48,226,136,191,295,327
"2011","Hammersmith and Fulham 003A","E01001954","Total",1525,224,93,131,1301,130,62,264,250,75,143,377
"2011","Hammersmith and Fulham 003B","E01001956","Total",1585,162,65,97,1423,138,86,214,220,90,242,433
"2011","Hammersmith and Fulham 003C","E01001959","Total",1727,144,56,88,1583,156,106,171,130,97,422,501
"2011","Hammersmith and Fulham 003D","E01001960","Total",1875,209,37,172,1666,129,56,256,346,89,128,662
"2011","Hammersmith and Fulham 004A","E01001943","Total",1926,384,45,339,1542,131,66,226,384,53,123,559
"2011","Hammersmith and Fulham 004B","E01001944","Total",1689,462,104,358,1227,213,76,185,228,102,179,244
"2011","Hammersmith and Fulham 004C","E01001945","Total",1750,268,60,208,1482,127,86,276,312,69,163,449
"2011","Hammersmith and Fulham 004D","E01001946","Total",1633,247,54,193,1386,108,54,203,314,102,143,462
"2011","Hammersmith and Fulham 005A","E01001862","Total",1763,346,62,284,1417,148,60,271,350,64,158,366
"2011","Hammersmith and Fulham 005B","E01001940","Total",1590,295,64,231,1295,127,60,237,366,49,125,331
"2011","Hammersmith and Fulham 005C","E01001941","Total",1671,240,24,216,1431,55,26,171,408,48,106,617
"2011","Hammersmith and Fulham 005D","E01001942","Total",1866,355,50,305,1511,96,52,253,384,54,165,507
"2011","Hammersmith and Fulham 006A","E01001858","Total",1603,304,76,228,1299,115,50,209,292,52,186,395
"2011","Hammersmith and Fulham 006B","E01001860","Total",1749,333,56,277,1416,160,44,255,306,77,147,427
"2011","Hammersmith and Fulham 006C","E01001861","Total",1486,245,48,197,1241,127,64,256,256,55,169,314
"2011","Hammersmith and Fulham 006D","E01001863","Total",1517,233,46,187,1284,86,56,269,362,113,94,304
"2011","Hammersmith and Fulham 006E","E01001864","Total",1578,333,90,243,1245,74,60,307,330,44,111,319
"2011","Hammersmith and Fulham 007A","E01001852","Total",1792,425,61,364,1367,68,52,188,600,15,78,366
"2011","Hammersmith and Fulham 007B","E01001853","Total",1533,257,43,214,1276,46,36,259,392,117,109,317
"2011","Hammersmith and Fulham 007C","E01001854","Total",1716,398,73,325,1318,72,56,210,478,68,111,323
"2011","Hammersmith and Fulham 007D","E01001857","Total",1473,327,75,252,1146,126,82,191,294,48,105,300
"2011","Hammersmith and Fulham 008A","E01001859","Total",2541,403,67,336,2138,282,42,533,580,131,175,395
"2011","Hammersmith and Fulham 008B","E01001865","Total",1648,204,47,157,1444,80,76,341,264,47,159,477
"2011","Hammersmith and Fulham 008C","E01001927","Total",1503,159,52,107,1344,30,130,296,158,191,128,411
"2011","Hammersmith and Fulham 008D","E01001930","Total",1719,401,152,249,1318,91,78,232,298,92,186,341
"2011","Hammersmith and Fulham 009A","E01001895","Total",1587,219,53,166,1368,84,68,313,326,51,162,364
"2011","Hammersmith and Fulham 009B","E01001896","Total",1503,264,79,185,1239,73,62,198,312,71,80,443
"2011","Hammersmith and Fulham 009C","E01001897","Total",1461,204,51,153,1257,71,66,362,266,151,83,258
"2011","Hammersmith and Fulham 009D","E01001929","Total",1260,241,69,172,1019,42,50,370,270,40,62,185
"2011","Hammersmith and Fulham 010A","E01001851","Total",1618,236,46,190,1382,45,64,353,352,122,186,260
"2011","Hammersmith and Fulham 010B","E01001855","Total",1654,397,50,347,1257,72,44,254,562,25,109,191
"2011","Hammersmith and Fulham 010C","E01001856","Total",1659,267,48,219,1392,95,38,328,340,130,141,320
"2011","Hammersmith and Fulham 010D","E01001869","Total",1301,211,69,142,1090,28,90,260,258,118,147,189
"2011","Hammersmith and Fulham 010E","E01001873","Total",1450,263,58,205,1187,116,58,254,334,46,114,265
"2011","Hammersmith and Fulham 011A","E01001928","Total",1712,247,80,167,1465,76,84,404,286,128,181,306
"2011","Hammersmith and Fulham 011B","E01001931","Total",1498,298,45,253,1200,155,44,228,314,96,138,225
"2011","Hammersmith and Fulham 011C","E01001932","Total",1612,291,49,242,1321,75,66,233,380,51,128,388
"2011","Hammersmith and Fulham 011D","E01001933","Total",1324,265,71,194,1059,49,126,251,244,42,114,233
"2011","Hammersmith and Fulham 012A","E01001866","Total",1575,265,60,205,1310,39,92,209,302,46,141,481
"2011","Hammersmith and Fulham 012B","E01001867","Total",1285,265,91,174,1020,28,92,112,250,70,48,420
"2011","Hammersmith and Fulham 012C","E01001868","Total",1341,239,49,190,1102,133,58,175,200,68,147,321
"2011","Hammersmith and Fulham 012D","E01001870","Total",1923,454,54,400,1469,94,40,183,552,25,65,510
"2011","Hammersmith and Fulham 012E","E01001871","Total",1591,319,96,223,1272,33,108,165,368,43,87,468
"2011","Hammersmith and Fulham 012F","E01001872","Total",1585,325,47,278,1260,48,56,147,406,42,152,409
"2011","Hammersmith and Fulham 013A","E01001893","Total",1244,157,48,109,1087,129,64,142,182,72,173,325
"2011","Hammersmith and Fulham 013B","E01001894","Total",1244,275,67,208,969,93,64,146,210,40,106,310
"2011","Hammersmith and Fulham 013C","E01001898","Total",1554,285,47,238,1269,60,72,223,394,65,125,330
"2011","Hammersmith and Fulham 013D","E01001899","Total",1380,308,91,217,1072,154,104,142,250,58,61,303
"2011","Hammersmith and Fulham 013E","E01001900","Total",1698,264,61,203,1434,103,88,229,262,78,169,505
"2011","Hammersmith and Fulham 014A","E01001889","Total",1390,197,48,149,1193,35,60,216,276,36,70,500
"2011","Hammersmith and Fulham 014B","E01001910","Total",1504,418,54,364,1086,47,46,144,486,0,63,300
"2011","Hammersmith and Fulham 014C","E01001913","Total",1545,304,53,251,1241,28,38,160,470,15,37,493
"2011","Hammersmith and Fulham 014D","E01001914","Total",1703,391,29,362,1312,49,42,178,514,20,69,440
"2011","Hammersmith and Fulham 015A","E01001885","Total",1319,182,51,131,1137,174,84,210,130,102,153,284
"2011","Hammersmith and Fulham 015B","E01001908","Total",1625,395,35,360,1230,61,32,177,550,21,47,342
"2011","Hammersmith and Fulham 015C","E01001909","Total",1814,295,83,212,1519,91,76,247,424,75,143,463
"2011","Hammersmith and Fulham 015D","E01001911","Total",1761,274,57,217,1487,224,86,242,214,128,190,403
"2011","Hammersmith and Fulham 015E","E01001912","Total",1598,194,31,163,1404,164,72,154,164,121,243,486
"2011","Hammersmith and Fulham 016A","E01001886","Total",1572,200,46,154,1372,109,58,229,216,53,202,505
"2011","Hammersmith and Fulham 016B","E01001887","Total",1519,252,100,152,1267,70,76,209,212,32,125,543
"2011","Hammersmith and Fulham 016C","E01001890","Total",1783,536,29,507,1247,65,36,283,284,29,48,502
"2011","Hammersmith and Fulham 016D","E01001892","Total",1366,227,56,171,1139,153,64,174,218,43,125,362
"2011","Hammersmith and Fulham 017A","E01001880","Total",1491,333,97,236,1158,84,74,202,386,57,82,273
"2011","Hammersmith and Fulham 017B","E01001881","Total",1588,200,44,156,1388,42,68,274,398,43,93,470
"2011","Hammersmith and Fulham 017C","E01001882","Total",1752,206,34,172,1546,34,50,247,364,42,141,668
"2011","Hammersmith and Fulham 017D","E01001883","Total",1477,316,105,211,1161,70,78,147,366,36,82,382
"2011","Hammersmith and Fulham 017E","E01001884","Total",1843,450,164,286,1393,105,68,169,370,91,141,449
"2011","Hammersmith and Fulham 018A","E01001888","Total",1614,184,53,131,1430,30,110,292,280,64,97,557
"2011","Hammersmith and Fulham 018B","E01001891","Total",2023,297,54,243,1726,33,76,237,394,52,101,833
"2011","Hammersmith and Fulham 018C","E01001917","Total",1462,274,120,154,1188,44,124,231,260,76,109,344
"2011","Hammersmith and Fulham 018D","E01001918","Total",1519,176,55,121,1343,45,80,416,278,53,128,343
"2011","Hammersmith and Fulham 018E","E01001919","Total",1630,203,97,106,1427,29,102,407,212,147,242,288
"2011","Hammersmith and Fulham 019A","E01001879","Total",1473,245,61,184,1228,54,66,168,222,66,148,504
"2011","Hammersmith and Fulham 019B","E01001901","Total",1621,238,35,203,1383,53,68,377,312,121,106,346
"2011","Hammersmith and Fulham 019C","E01001902","Total",1699,294,90,204,1405,54,46,238,498,20,72,477
"2011","Hammersmith and Fulham 019D","E01001903","Total",1649,224,72,152,1425,108,70,210,264,90,214,469
"2011","Hammersmith and Fulham 020A","E01001920","Total",1509,455,145,310,1054,72,90,140,280,55,92,325
"2011","Hammersmith and Fulham 020B","E01001921","Total",1523,240,45,195,1283,42,82,289,280,66,181,343
"2011","Hammersmith and Fulham 020C","E01001922","Total",1605,221,64,157,1384,42,86,338,284,126,169,339
"2011","Hammersmith and Fulham 020D","E01001923","Total",1479,224,69,155,1255,46,84,264,318,55,148,340
"2011","Hammersmith and Fulham 020E","E01001924","Total",1596,171,56,115,1425,25,58,294,270,219,181,378
"2011","Hammersmith and Fulham 021A","E01001947","Total",1448,190,39,151,1258,228,56,256,158,75,162,323
"2011","Hammersmith and Fulham 021B","E01001948","Total",1986,349,58,291,1637,114,70,367,494,136,135,321
"2011","Hammersmith and Fulham 021C","E01001949","Total",1547,193,30,163,1354,43,56,296,364,120,125,350
"2011","Hammersmith and Fulham 021D","E01001950","Total",1596,167,34,133,1429,27,62,377,358,143,138,324
"2011","Hammersmith and Fulham 021E","E01001951","Total",1609,259,62,197,1350,46,56,284,312,78,116,458
"2011","Hammersmith and Fulham 021F","E01001953","Total",1351,216,73,143,1135,82,56,131,314,85,86,381
"2011","Hammersmith and Fulham 022A","E01001904","Total",1587,207,41,166,1380,32,64,338,374,65,97,410
"2011","Hammersmith and Fulham 022B","E01001905","Total",1702,238,80,158,1464,39,88,382,410,79,65,401
"2011","Hammersmith and Fulham 022C","E01001906","Total",1439,204,47,157,1235,31,52,252,428,16,66,390
"2011","Hammersmith and Fulham 022D","E01001907","Total",1297,188,39,149,1109,31,68,303,282,113,80,232
"2011","Hammersmith and Fulham 023A","E01001935","Total",2059,293,67,226,1766,104,86,324,502,79,176,495
"2011","Hammersmith and Fulham 023C","E01001939","Total",2021,406,107,299,1615,215,140,299,420,91,131,319
"2011","Hammersmith and Fulham 023D","E01032788","Total",1099,158,27,131,941,143,36,170,250,30,89,223
"2011","Hammersmith and Fulham 023E","E01032789","Total",1151,259,9,250,892,124,28,192,286,43,67,152
"2011","Hammersmith and Fulham 023F","E01032790","Total",1118,238,55,183,880,151,44,257,252,31,62,83
"2011","Hammersmith and Fulham 024A","E01001915","Total",1482,208,95,113,1274,41,98,308,198,187,149,293
"2011","Hammersmith and Fulham 024B","E01001916","Total",1390,294,144,150,1096,21,184,185,246,99,94,267
"2011","Hammersmith and Fulham 024C","E01001926","Total",1456,189,55,134,1267,12,60,326,330,112,99,328
"2011","Hammersmith and Fulham 024D","E01001952","Total",1623,316,66,250,1307,44,52,187,512,48,49,415
"2011","Hammersmith and Fulham 025A","E01001925","Total",1628,182,40,142,1446,27,98,377,222,152,290,280
"2011","Hammersmith and Fulham 025B","E01001934","Total",1622,241,82,159,1381,145,70,291,280,37,201,357
"2011","Hammersmith and Fulham 025C","E01001937","Total",1823,228,53,175,1595,43,100,345,372,137,123,475
"2011","Hammersmith and Fulham 025D","E01001938","Total",1560,176,44,132,1384,172,74,310,230,89,185,324
"2011","Haringey 001A","E01001969","Total",1888,321,94,227,1567,157,86,328,326,73,152,445
"2011","Haringey 001B","E01001971","Total",2002,252,89,163,1750,245,78,288,218,178,245,498
"2011","Haringey 001C","E01001974","Total",2198,335,66,269,1863,76,108,438,406,68,215,552
"2011","Haringey 001D","E01001975","Total",1710,283,43,240,1427,98,40,379,382,40,119,369
"2011","Haringey 002A","E01002036","Total",1618,219,56,163,1399,225,76,236,138,120,332,272
"2011","Haringey 002B","E01002037","Total",1728,275,49,226,1453,235,58,194,180,129,348,309
"2011","Haringey 002C","E01002039","Total",1610,198,46,152,1412,311,50,303,150,104,287,207
"2011","Haringey 002D","E01002040","Total",2043,199,51,148,1844,252,96,347,198,152,396,403
"2011","Haringey 004A","E01001962","Total",1758,147,48,99,1611,84,102,505,196,193,192,339
"2011","Haringey 004B","E01001970","Total",1972,185,44,141,1787,244,58,292,294,129,256,514
"2011","Haringey 004C","E01001972","Total",1672,288,78,210,1384,134,94,277,264,95,172,348
"2011","Haringey 004D","E01001973","Total",2246,284,108,176,1962,176,144,489,390,82,249,432
"2011","Haringey 005A","E01002090","Total",1601,102,35,67,1499,121,84,226,144,109,438,377
"2011","Haringey 005B","E01002093","Total",1795,169,65,104,1626,182,78,265,156,204,372,369
"2011","Haringey 005C","E01002096","Total",1645,162,88,74,1483,168,78,289,132,145,367,304
"2011","Haringey 005D","E01002097","Total",1693,113,32,81,1580,303,50,333,186,175,280,253
"2011","Haringey 006A","E01002091","Total",1802,181,106,75,1621,213,108,224,100,156,395,425
"2011","Haringey 006B","E01002092","Total",1697,230,31,199,1467,274,38,269,208,125,259,294
"2011","Haringey 006C","E01002094","Total",1554,103,32,71,1451,273,58,217,164,120,275,344
"2011","Haringey 006D","E01002095","Total",1644,150,30,120,1494,274,52,274,148,158,262,326
"2011","Haringey 007A","E01002098","Total",1349,219,57,162,1130,80,40,257,290,22,107,334
"2011","Haringey 007B","E01002101","Total",1916,186,35,151,1730,97,82,330,240,113,236,632
"2011","Haringey 007C","E01002102","Total",1877,227,44,183,1650,160,68,236,310,41,299,536
"2011","Haringey 007D","E01002105","Total",2052,277,59,218,1775,186,90,252,420,94,198,535
"2011","Haringey 008A","E01002099","Total",2108,269,89,180,1839,252,64,298,218,206,325,476
"2011","Haringey 008B","E01002100","Total",1909,162,38,124,1747,164,94,341,196,126,331,495
"2011","Haringey 008C","E01002103","Total",1856,159,50,109,1697,108,92,239,200,156,309,593
"2011","Haringey 008D","E01002104","Total",1431,107,34,73,1324,109,88,154,168,129,240,436
"2011","Haringey 009A","E01001963","Total",1820,169,54,115,1651,60,120,462,268,218,217,306
"2011","Haringey 009B","E01001964","Total",1588,192,35,157,1396,76,56,345,366,62,187,304
"2011","Haringey 009C","E01001965","Total",1627,167,29,138,1460,43,80,572,316,116,97,236
"2011","Haringey 009D","E01001966","Total",1506,114,34,80,1392,39,128,285,148,160,238,394
"2011","Haringey 010A","E01002027","Total",1537,134,48,86,1403,102,94,193,178,69,250,517
"2011","Haringey 010B","E01002028","Total",1767,146,38,108,1621,127,76,225,234,102,240,617
"2011","Haringey 010C","E01002032","Total",1813,272,62,210,1541,253,40,273,212,97,235,431
"2011","Haringey 010D","E01002033","Total",1908,178,55,123,1730,254,66,273,230,99,314,494
"2011","Haringey 011A","E01001976","Total",1614,196,50,146,1418,194,70,296,152,130,252,324
"2011","Haringey 011B","E01001977","Total",1576,183,45,138,1393,186,64,236,180,166,262,299
"2011","Haringey 011C","E01001978","Total",1862,326,105,221,1536,260,84,320,206,34,327,305
"2011","Haringey 011D","E01001979","Total",2187,258,39,219,1929,251,44,361,276,175,374,448
"2011","Haringey 012A","E01002074","Total",2099,276,84,192,1823,389,98,328,182,183,286,357
"2011","Haringey 012B","E01002077","Total",2079,162,41,121,1917,364,62,351,176,120,280,564
"2011","Haringey 012C","E01002079","Total",1630,91,35,56,1539,133,66,262,202,184,287,405
"2011","Haringey 012D","E01002081","Total",1769,224,71,153,1545,159,84,190,96,89,385,542
"2011","Haringey 013A","E01002082","Total",1508,163,42,121,1345,215,54,223,140,115,317,281
"2011","Haringey 013B","E01002086","Total",1589,194,38,156,1395,134,64,199,166,115,264,453
"2011","Haringey 013C","E01002088","Total",1853,198,64,134,1655,133,118,293,170,72,249,620
"2011","Haringey 013D","E01002089","Total",1520,265,63,202,1255,253,34,239,130,141,265,193
"2011","Haringey 014A","E01001967","Total",1607,173,49,124,1434,44,92,365,280,142,200,311
"2011","Haringey 014B","E01001968","Total",1834,264,66,198,1570,64,102,401,350,103,168,382
"2011","Haringey 014C","E01001996","Total",1625,232,70,162,1393,66,72,319,342,194,143,257
"2011","Haringey 014D","E01001997","Total",1570,284,41,243,1286,52,42,304,378,76,101,333
"2011","Haringey 015A","E01002075","Total",1775,161,46,115,1614,285,62,263,142,136,215,511
"2011","Haringey 015B","E01002076","Total",1888,150,48,102,1738,223,94,295,152,131,350,493
"2011","Haringey 015C","E01002078","Total",2194,364,68,296,1830,235,62,367,332,122,337,375
"2011","Haringey 015D","E01002080","Total",1593,117,38,79,1476,103,78,113,146,113,286,637
"2011","Haringey 016A","E01002026","Total",1619,301,62,239,1318,198,68,230,154,123,221,324
"2011","Haringey 016B","E01002029","Total",1590,300,61,239,1290,188,46,276,250,69,151,310
"2011","Haringey 016C","E01002030","Total",1640,204,38,166,1436,116,66,244,260,62,227,461
"2011","Haringey 016D","E01002031","Total",1911,243,43,200,1668,121,90,259,282,68,217,631
"2011","Haringey 017A","E01001991","Total",1609,321,50,271,1288,121,40,439,328,75,83,202
"2011","Haringey 017B","E01001992","Total",1701,197,78,119,1504,19,154,372,204,196,171,388
"2011","Haringey 017C","E01001993","Total",1686,157,84,73,1529,26,128,477,136,240,206,316
"2011","Haringey 017D","E01001995","Total",2412,206,67,139,2206,235,96,585,340,228,316,406
"2011","Haringey 018A","E01001980","Total",1983,195,49,146,1788,167,64,280,178,140,530,429
"2011","Haringey 018B","E01001981","Total",1758,159,45,114,1599,145,66,199,168,104,383,534
"2011","Haringey 018C","E01001982","Total",1763,214,48,166,1549,157,72,245,216,92,300,467
"2011","Haringey 018D","E01001983","Total",1652,153,37,116,1499,121,60,331,232,83,282,390
"2011","Haringey 019A","E01002083","Total",1440,152,56,96,1288,46,90,141,170,64,204,573
"2011","Haringey 019B","E01002084","Total",1617,198,49,149,1419,86,62,202,222,87,269,491
"2011","Haringey 019C","E01002085","Total",2168,211,50,161,1957,165,74,337,394,129,307,551
"2011","Haringey 019D","E01002087","Total",1586,293,70,223,1293,122,66,189,256,72,224,364
"2011","Haringey 020B","E01002014","Total",1711,303,55,248,1408,117,62,262,422,84,139,322
"2011","Haringey 020C","E01002015","Total",1480,236,74,162,1244,106,104,221,280,71,121,341
"2011","Haringey 020D","E01002018","Total",1420,184,78,106,1236,127,76,384,242,46,147,214
"2011","Haringey 020E","E01033085","Total",1780,402,33,369,1378,155,28,215,522,43,200,215
"2011","Haringey 020F","E01033086","Total",1091,177,46,131,914,175,56,187,158,60,99,179
"2011","Haringey 021A","E01002020","Total",1564,250,60,190,1314,92,80,363,308,35,134,302
"2011","Haringey 021B","E01002022","Total",1829,324,39,285,1505,45,72,295,514,70,95,414
"2011","Haringey 021C","E01002023","Total",1474,196,83,113,1278,56,104,316,190,113,175,324
"2011","Haringey 021D","E01002025","Total",1717,164,47,117,1553,59,116,422,292,150,205,309
"2011","Haringey 022A","E01002013","Total",1401,165,48,117,1236,70,64,421,298,45,104,234
"2011","Haringey 022B","E01002019","Total",1309,103,57,46,1206,29,100,300,234,71,108,364
"2011","Haringey 022C","E01002021","Total",1479,189,79,110,1290,42,92,311,228,95,155,367
"2011","Haringey 022D","E01002024","Total",1320,162,61,101,1158,56,84,304,184,63,182,285
"2011","Haringey 023A","E01001998","Total",2058,266,56,210,1792,67,90,313,450,38,205,629
"2011","Haringey 023B","E01001999","Total",2001,246,40,206,1755,101,92,301,372,54,180,655
"2011","Haringey 023C","E01002003","Total",2160,351,44,307,1809,236,50,356,346,120,188,513
"2011","Haringey 023D","E01002004","Total",1881,190,41,149,1691,80,90,306,286,63,177,689
"2011","Haringey 024A","E01002067","Total",1694,263,73,190,1431,144,64,261,174,113,250,425
"2011","Haringey 024B","E01002069","Total",1937,388,98,290,1549,133,86,240,274,65,268,483
"2011","Haringey 024C","E01002070","Total",2032,229,52,177,1803,214,68,268,332,136,325,460
"2011","Haringey 024D","E01002073","Total",1762,224,53,171,1538,140,52,274,202,210,245,415
"2011","Haringey 025A","E01002066","Total",1843,297,47,250,1546,282,50,308,196,142,265,303
"2011","Haringey 025B","E01002068","Total",1822,236,50,186,1586,107,76,242,282,88,223,568
"2011","Haringey 025C","E01002071","Total",1615,245,66,179,1370,288,64,269,166,80,204,299
"2011","Haringey 025D","E01002072","Total",1678,226,58,168,1452,140,60,241,226,124,225,436
"2011","Haringey 026A","E01002043","Total",2017,202,35,167,1815,141,70,340,258,165,304,537
"2011","Haringey 026B","E01002045","Total",2199,243,45,198,1956,182,70,365,232,159,336,612
"2011","Haringey 026C","E01002046","Total",1686,248,85,163,1438,155,58,230,164,118,316,397
"2011","Haringey 026D","E01002049","Total",1881,219,54,165,1662,156,72,253,188,111,390,492
"2011","Haringey 027A","E01002042","Total",1416,152,51,101,1264,34,68,223,192,56,206,485
"2011","Haringey 027B","E01002044","Total",1722,207,39,168,1515,66,88,188,328,59,227,559
"2011","Haringey 027C","E01002047","Total",1651,145,40,105,1506,79,82,140,232,77,151,745
"2011","Haringey 027D","E01002048","Total",1920,181,41,140,1739,107,76,305,230,93,267,661
"2011","Haringey 028A","E01002016","Total",1959,273,68,205,1686,142,50,384,472,97,188,353
"2011","Haringey 028B","E01002017","Total",1667,277,46,231,1390,107,44,309,400,57,185,288
"2011","Haringey 028C","E01002059","Total",1671,237,73,164,1434,93,68,398,280,119,145,331
"2011","Haringey 028D","E01002060","Total",1759,233,41,192,1526,70,56,423,440,85,157,295
"2011","Haringey 029A","E01002050","Total",1895,80,27,53,1815,50,62,128,74,670,497,334
"2011","Haringey 029B","E01002051","Total",1678,235,52,183,1443,129,54,269,198,145,230,418
"2011","Haringey 029C","E01002052","Total",2020,100,35,65,1920,63,76,185,134,750,478,234
"2011","Haringey 029D","E01002055","Total",1658,99,28,71,1559,44,50,148,118,566,334,299
"2011","Haringey 030A","E01001994","Total",1779,231,81,150,1548,54,146,270,378,134,172,394
"2011","Haringey 030B","E01002008","Total",1534,217,79,138,1317,38,164,372,190,84,185,284
"2011","Haringey 030C","E01002010","Total",1619,219,88,131,1400,109,140,345,344,73,134,255
"2011","Haringey 030D","E01002011","Total",1718,263,61,202,1455,53,94,346,382,89,98,393
"2011","Haringey 031A","E01002000","Total",1692,221,35,186,1471,106,54,293,310,55,211,442
"2011","Haringey 031B","E01002001","Total",1661,224,25,199,1437,41,70,224,318,42,194,548
"2011","Haringey 031C","E01002002","Total",1785,274,34,240,1511,104,62,233,390,66,178,478
"2011","Haringey 031D","E01002058","Total",1690,200,42,158,1490,91,62,259,308,62,151,557
"2011","Haringey 032A","E01002053","Total",1737,220,67,153,1517,137,84,245,168,137,316,430
"2011","Haringey 032B","E01002054","Total",1732,239,51,188,1493,233,46,366,146,116,220,366
"2011","Haringey 032C","E01002056","Total",1964,342,76,266,1622,173,64,261,258,132,228,506
"2011","Haringey 032D","E01002057","Total",1581,124,26,98,1457,120,76,181,222,75,304,479
"2011","Haringey 033A","E01001984","Total",1590,413,95,318,1177,60,84,329,444,53,42,165
"2011","Haringey 033B","E01001985","Total",1667,311,67,244,1356,45,68,352,358,143,135,255
"2011","Haringey 033C","E01001987","Total",1821,233,60,173,1588,28,110,493,482,74,109,292
"2011","Haringey 033D","E01001989","Total",1725,262,83,179,1463,53,78,442,380,67,151,292
"2011","Haringey 034A","E01001986","Total",1635,275,61,214,1360,40,70,391,360,117,86,296
"2011","Haringey 034B","E01001988","Total",1762,378,76,302,1384,58,64,348,478,112,108,216
"2011","Haringey 034C","E01001990","Total",2137,350,41,309,1787,81,58,284,572,65,124,603
"2011","Haringey 034D","E01002062","Total",1874,288,40,248,1586,75,44,335,586,60,165,321
"2011","Haringey 035A","E01002005","Total",1686,289,27,262,1397,54,34,341,554,41,66,307
"2011","Haringey 035B","E01002006","Total",1602,310,57,253,1292,65,40,300,536,32,56,263
"2011","Haringey 035C","E01002007","Total",1676,298,103,195,1378,48,160,298,408,100,95,269
"2011","Haringey 035D","E01002009","Total",1567,249,56,193,1318,49,142,356,282,62,113,314
"2011","Haringey 036A","E01002061","Total",1687,182,29,153,1505,71,62,297,448,85,116,426
"2011","Haringey 036B","E01002063","Total",1587,255,31,224,1332,100,50,297,342,94,95,354
"2011","Haringey 036C","E01002064","Total",1514,214,39,175,1300,163,58,167,310,78,147,377
"2011","Haringey 036D","E01002065","Total",1633,323,40,283,1310,56,44,179,550,41,102,338
"2011","Haringey 037A","E01002034","Total",1858,321,74,247,1537,321,52,384,190,148,170,272
"2011","Haringey 037B","E01002038","Total",1653,258,73,185,1395,270,50,299,152,90,247,287
"2011","Haringey 037C","E01002041","Total",1877,242,82,160,1635,239,96,294,186,158,288,374
"2011","Haringey 037D","E01032575","Total",1889,193,35,158,1696,299,54,232,176,190,426,319
"2011","Islington 001A","E01002755","Total",1326,289,76,213,1037,140,36,224,206,65,129,237
"2011","Islington 001B","E01002756","Total",1326,231,38,193,1095,55,44,251,290,59,96,300
"2011","Islington 001C","E01002758","Total",1561,278,45,233,1283,230,46,250,266,100,172,219
"2011","Islington 001D","E01002804","Total",1642,297,41,256,1345,224,54,203,288,99,175,302
"2011","Islington 001E","E01002807","Total",1732,325,68,257,1407,213,60,245,340,68,134,347
"2011","Islington 001F","E01002811","Total",1545,272,76,196,1273,173,52,293,252,121,135,247
"2011","Islington 002A","E01002753","Total",1429,255,50,205,1174,101,52,134,234,100,152,401
"2011","Islington 002B","E01002754","Total",1508,169,48,121,1339,52,74,324,298,88,171,332
"2011","Islington 002C","E01002757","Total",1427,160,47,113,1267,177,50,315,254,66,137,268
"2011","Islington 002D","E01002759","Total",1600,194,54,140,1406,88,78,265,320,52,183,420
"2011","Islington 002E","E01002760","Total",1543,214,64,150,1329,221,60,213,162,83,199,391
"2011","Islington 002F","E01002772","Total",1848,356,85,271,1492,148,58,257,380,68,124,457
"2011","Islington 003A","E01002735","Total",1645,315,50,265,1330,148,58,230,340,38,133,383
"2011","Islington 003B","E01002805","Total",1569,269,36,233,1300,143,64,158,462,31,47,395
"2011","Islington 003C","E01002806","Total",1595,260,65,195,1335,94,68,280,336,52,149,356
"2011","Islington 003D","E01002808","Total",1891,294,59,235,1597,152,82,253,434,58,188,430
"2011","Islington 003E","E01002809","Total",1640,258,41,217,1382,131,42,277,290,85,179,378
"2011","Islington 003F","E01002810","Total",1650,296,59,237,1354,162,64,262,302,102,163,299
"2011","Islington 004A","E01002768","Total",1604,415,112,303,1189,149,102,195,338,41,124,240
"2011","Islington 004B","E01002770","Total",1483,270,75,195,1213,110,84,198,382,60,83,296
"2011","Islington 004C","E01002771","Total",1483,235,49,186,1248,122,52,260,292,58,178,286
"2011","Islington 004D","E01002773","Total",1386,342,125,217,1044,137,92,169,186,68,116,276
"2011","Islington 004E","E01002774","Total",2110,393,87,306,1717,185,86,324,466,65,110,481
"2011","Islington 005A","E01002732","Total",1813,342,55,287,1471,179,62,212,286,91,247,394
"2011","Islington 005B","E01002734","Total",1692,245,37,208,1447,317,46,264,182,148,192,298
"2011","Islington 005C","E01002736","Total",1435,240,64,176,1195,157,66,238,142,175,177,240
"2011","Islington 005D","E01002737","Total",1957,263,66,197,1694,317,72,253,228,207,240,377
"2011","Islington 005E","E01002751","Total",1796,393,59,334,1403,225,66,233,328,97,159,295
"2011","Islington 006A","E01002742","Total",1561,186,41,145,1375,43,90,312,396,100,73,361
"2011","Islington 006B","E01002747","Total",1635,200,40,160,1435,60,76,302,322,78,117,480
"2011","Islington 006C","E01002748","Total",1467,271,32,239,1196,139,56,240,262,63,155,281
"2011","Islington 006D","E01002749","Total",1316,145,33,112,1171,180,54,231,232,66,160,248
"2011","Islington 006F","E01033493","Total",1301,223,5,218,1078,20,12,106,756,10,24,150
"2011","Islington 006G","E01033494","Total",1498,189,45,144,1309,36,72,226,344,77,131,423
"2011","Islington 007A","E01002730","Total",1781,312,68,244,1469,118,58,151,388,44,129,581
"2011","Islington 007B","E01002731","Total",2466,443,55,388,2023,140,76,239,676,74,223,595
"2011","Islington 007C","E01002733","Total",1392,161,21,140,1231,72,64,175,370,47,80,423
"2011","Islington 007D","E01002763","Total",1249,261,49,212,988,42,76,134,264,70,88,314
"2011","Islington 008A","E01002769","Total",1955,336,84,252,1619,76,74,321,326,81,140,601
"2011","Islington 008B","E01002785","Total",1968,289,69,220,1679,131,100,348,344,137,213,406
"2011","Islington 008C","E01002788","Total",1836,374,62,312,1462,110,62,257,508,45,133,347
"2011","Islington 008D","E01002789","Total",1873,243,52,191,1630,47,112,387,406,72,174,432
"2011","Islington 009A","E01002738","Total",1733,348,97,251,1385,128,92,290,378,77,137,283
"2011","Islington 009B","E01002741","Total",1513,257,78,179,1256,171,60,222,178,104,162,359
"2011","Islington 009C","E01002743","Total",1604,246,53,193,1358,132,76,280,396,116,151,207
"2011","Islington 009D","E01002744","Total",1442,311,45,266,1131,51,54,259,364,62,51,290
"2011","Islington 009E","E01002752","Total",1522,206,50,156,1316,133,78,169,350,134,186,266
"2011","Islington 010A","E01002764","Total",1779,285,94,191,1494,141,102,234,352,96,200,369
"2011","Islington 010B","E01002783","Total",1413,340,73,267,1073,173,54,131,276,33,91,315
"2011","Islington 010C","E01002784","Total",1735,257,50,207,1478,155,78,248,276,95,237,389
"2011","Islington 010D","E01002786","Total",1805,320,79,241,1485,198,62,226,396,96,157,350
"2011","Islington 010E","E01002787","Total",1296,203,39,164,1093,116,52,90,286,55,144,350
"2011","Islington 011C","E01002762","Total",1940,304,61,243,1636,97,68,232,510,30,132,567
"2011","Islington 011D","E01002767","Total",2044,395,85,310,1649,262,108,234,336,46,145,518
"2011","Islington 011E","E01033486","Total",1022,137,28,109,885,85,32,93,226,48,160,241
"2011","Islington 011F","E01033487","Total",1226,180,8,172,1046,86,2,148,532,50,38,190
"2011","Islington 011G","E01033488","Total",1205,197,58,139,1008,108,54,113,296,40,114,283
"2011","Islington 011H","E01033491","Total",1680,387,54,333,1293,101,50,194,480,42,84,342
"2011","Islington 011I","E01033492","Total",1348,251,13,238,1097,83,24,126,510,32,25,297
"2011","Islington 012A","E01002777","Total",1626,359,80,279,1267,75,70,204,442,31,104,341
"2011","Islington 012B","E01002778","Total",1787,267,83,184,1520,333,54,201,246,130,271,285
"2011","Islington 012C","E01002779","Total",1687,319,45,274,1368,130,68,268,462,65,137,238
"2011","Islington 012D","E01002781","Total",1341,234,55,179,1107,89,46,203,248,76,176,269
"2011","Islington 012E","E01002782","Total",1533,199,54,145,1334,260,66,192,192,121,257,246
"2011","Islington 013A","E01002739","Total",1835,290,82,208,1545,72,86,359,374,116,99,439
"2011","Islington 013B","E01002740","Total",1826,279,57,222,1547,60,60,363,442,93,171,358
"2011","Islington 013C","E01002745","Total",1467,259,62,197,1208,51,68,213,360,76,129,311
"2011","Islington 013D","E01002795","Total",1997,253,35,218,1744,121,50,260,528,92,209,484
"2011","Islington 013E","E01002796","Total",1039,199,40,159,840,25,60,120,242,21,113,259
"2011","Islington 014A","E01002716","Total",2300,399,114,285,1901,324,102,283,502,84,228,378
"2011","Islington 014B","E01002718","Total",1661,306,43,263,1355,53,72,198,466,45,118,403
"2011","Islington 014C","E01002721","Total",1667,324,72,252,1343,174,70,192,508,51,92,256
"2011","Islington 014D","E01002775","Total",1429,251,44,207,1178,57,34,184,440,32,113,318
"2011","Islington 014E","E01002776","Total",1661,288,84,204,1373,226,56,247,342,70,112,320
"2011","Islington 014F","E01002780","Total",1640,297,53,244,1343,128,40,233,390,84,141,327
"2011","Islington 015A","E01002708","Total",1859,373,63,310,1486,189,102,203,428,64,122,378
"2011","Islington 015B","E01002712","Total",1192,208,32,176,984,88,48,180,216,32,92,328
"2011","Islington 015C","E01002713","Total",1559,424,175,249,1135,153,122,176,210,85,123,266
"2011","Islington 015D","E01002765","Total",2257,375,67,308,1882,281,98,271,346,110,345,431
"2011","Islington 015E","E01002766","Total",1794,363,91,272,1431,162,70,199,242,77,266,415
"2011","Islington 016A","E01002717","Total",1315,202,52,150,1113,82,84,242,256,68,87,294
"2011","Islington 016B","E01002719","Total",1490,290,92,198,1200,88,110,236,392,61,76,237
"2011","Islington 016C","E01002720","Total",2334,338,66,272,1996,430,72,335,338,112,319,390
"2011","Islington 016D","E01002790","Total",1435,316,76,240,1119,140,96,174,238,34,124,313
"2011","Islington 016E","E01002791","Total",1543,299,82,217,1244,98,96,206,398,35,86,325
"2011","Islington 016F","E01002793","Total",1898,407,88,319,1491,178,84,227,462,43,135,362
"2011","Islington 017A","E01002698","Total",2063,433,52,381,1630,147,68,267,660,80,82,326
"2011","Islington 017B","E01002699","Total",1507,332,64,268,1175,74,64,213,426,31,77,290
"2011","Islington 017C","E01002700","Total",1459,193,41,152,1266,30,132,269,338,61,157,279
"2011","Islington 017D","E01002714","Total",1698,243,32,211,1455,69,70,228,518,97,130,343
"2011","Islington 017E","E01002792","Total",1868,295,56,239,1573,84,86,272,576,93,147,315
"2011","Islington 018A","E01002722","Total",1305,299,61,238,1006,139,76,158,290,30,109,204
"2011","Islington 018B","E01002797","Total",1873,322,69,253,1551,149,106,199,422,42,179,454
"2011","Islington 018C","E01002798","Total",1932,323,90,233,1609,49,134,365,526,53,106,376
"2011","Islington 018D","E01002799","Total",1839,346,84,262,1493,267,112,233,352,76,159,294
"2011","Islington 018E","E01002800","Total",1049,160,36,124,889,155,64,130,118,53,212,157
"2011","Islington 019A","E01002694","Total",1532,252,71,181,1280,252,58,146,200,90,226,308
"2011","Islington 019B","E01002697","Total",1635,285,102,183,1350,211,92,143,198,105,244,357
"2011","Islington 019C","E01002709","Total",1754,237,96,141,1517,155,86,140,380,44,227,485
"2011","Islington 019D","E01002710","Total",1676,212,45,167,1464,172,94,233,242,101,208,414
"2011","Islington 019E","E01002715","Total",1511,298,86,212,1213,191,46,219,194,102,178,283
"2011","Islington 020A","E01002696","Total",1813,325,67,258,1488,98,98,225,566,61,95,345
"2011","Islington 020B","E01002794","Total",1765,357,78,279,1408,105,68,179,462,58,101,435
"2011","Islington 020C","E01002801","Total",1553,335,76,259,1218,69,80,201,468,47,80,273
"2011","Islington 020D","E01002802","Total",1480,263,64,199,1217,79,82,231,404,42,94,285
"2011","Islington 020E","E01002803","Total",1896,386,70,316,1510,90,100,267,460,65,138,390
"2011","Islington 021A","E01002695","Total",1639,308,67,241,1331,165,56,175,512,21,105,297
"2011","Islington 021B","E01002711","Total",1934,387,37,350,1547,117,46,199,574,41,105,465
"2011","Islington 021C","E01002727","Total",1624,389,60,329,1235,139,88,181,444,21,68,294
"2011","Islington 021D","E01002728","Total",1015,236,49,187,779,83,46,132,216,15,86,201
"2011","Islington 021E","E01002729","Total",1496,265,58,207,1231,72,118,208,334,63,114,322
"2011","Islington 022B","E01002707","Total",1717,429,50,379,1288,103,102,128,406,35,109,405
"2011","Islington 022C","E01002723","Total",1529,386,77,309,1143,95,76,220,262,82,153,255
"2011","Islington 022D","E01002724","Total",1748,518,55,463,1230,48,52,173,674,10,73,200
"2011","Islington 022E","E01002725","Total",1235,237,61,176,998,135,78,147,172,52,123,291
"2011","Islington 022F","E01002726","Total",1669,348,60,288,1321,153,40,224,432,71,103,298
"2011","Islington 022G","E01033489","Total",1288,385,11,374,903,40,34,117,546,15,17,134
"2011","Islington 022H","E01033490","Total",1232,381,26,355,851,132,26,117,310,26,63,177
"2011","Islington 023A","E01002701","Total",1471,305,100,205,1166,133,88,170,294,65,122,294
"2011","Islington 023B","E01002702","Total",1822,349,52,297,1473,240,70,213,366,74,179,331
"2011","Islington 023C","E01002703","Total",1635,286,61,225,1349,186,62,192,412,63,116,318
"2011","Islington 023D","E01002704","Total",1898,538,123,415,1360,187,98,282,400,94,117,182
"2011","Islington 023E","E01002706","Total",1961,352,71,281,1609,283,112,256,394,94,100,370
"2011","Kensington and Chelsea 001A","E01002852","Total",1908,342,77,265,1566,206,78,275,324,156,231,296
"2011","Kensington and Chelsea 001B","E01002853","Total",1093,174,43,131,919,105,64,131,156,48,175,240
"2011","Kensington and Chelsea 001C","E01002854","Total",1121,181,60,121,940,121,98,172,150,86,130,183
"2011","Kensington and Chelsea 001D","E01002855","Total",1724,298,79,219,1426,161,52,167,314,54,294,384
"2011","Kensington and Chelsea 001E","E01002857","Total",1349,216,51,165,1133,144,68,221,174,108,144,274
"2011","Kensington and Chelsea 002A","E01002904","Total",1173,226,60,166,947,149,42,186,124,40,178,228
"2011","Kensington and Chelsea 002B","E01002905","Total",1545,270,63,207,1275,114,72,228,224,125,233,279
"2011","Kensington and Chelsea 002C","E01002906","Total",1612,274,100,174,1338,120,82,225,228,71,263,349
"2011","Kensington and Chelsea 002D","E01002907","Total",1376,171,65,106,1205,237,78,246,130,107,190,217
"2011","Kensington and Chelsea 003A","E01002876","Total",1721,279,97,182,1442,84,124,329,234,125,156,390
"2011","Kensington and Chelsea 003B","E01002877","Total",1703,174,56,118,1529,248,92,255,156,111,267,400
"2011","Kensington and Chelsea 003C","E01002878","Total",1615,430,98,332,1185,99,82,262,360,41,93,248
"2011","Kensington and Chelsea 003D","E01002908","Total",1379,226,83,143,1153,84,78,258,226,61,160,286
"2011","Kensington and Chelsea 003E","E01002909","Total",2152,578,106,472,1574,115,110,294,498,62,181,314
"2011","Kensington and Chelsea 004A","E01002829","Total",1455,400,70,330,1055,95,50,141,364,37,122,246
"2011","Kensington and Chelsea 004B","E01002830","Total",1773,449,136,313,1324,133,58,199,390,41,205,298
"2011","Kensington and Chelsea 004C","E01002831","Total",1958,445,90,355,1513,89,74,286,404,67,245,348
"2011","Kensington and Chelsea 004D","E01002832","Total",1701,456,75,381,1245,205,82,187,354,27,125,265
"2011","Kensington and Chelsea 004E","E01002856","Total",1732,477,72,405,1255,117,50,182,446,47,164,249
"2011","Kensington and Chelsea 005A","E01002870","Total",1386,362,117,245,1024,152,72,166,154,33,138,309
"2011","Kensington and Chelsea 005B","E01002872","Total",1440,357,195,162,1083,95,148,217,162,90,166,205
"2011","Kensington and Chelsea 005C","E01002879","Total",1528,296,90,206,1232,159,46,191,232,68,239,297
"2011","Kensington and Chelsea 005D","E01002880","Total",1540,249,51,198,1291,172,70,258,148,103,192,348
"2011","Kensington and Chelsea 005E","E01002881","Total",1398,169,46,123,1229,142,72,173,178,102,236,326
"2011","Kensington and Chelsea 006A","E01002882","Total",1334,375,107,268,959,80,58,196,246,56,153,170
"2011","Kensington and Chelsea 006B","E01002883","Total",1696,306,96,210,1390,52,156,302,362,127,104,287
"2011","Kensington and Chelsea 006C","E01002884","Total",1203,417,59,358,786,7,38,187,306,57,64,127
"2011","Kensington and Chelsea 006D","E01002885","Total",1538,547,66,481,991,66,46,154,504,57,15,149
"2011","Kensington and Chelsea 006E","E01002886","Total",1546,369,85,284,1177,17,106,295,330,118,106,205
"2011","Kensington and Chelsea 007A","E01002833","Total",1460,386,55,331,1074,61,66,263,422,41,84,137
"2011","Kensington and Chelsea 007B","E01002871","Total",1680,265,71,194,1415,41,122,350,332,116,182,272
"2011","Kensington and Chelsea 007C","E01002873","Total",1331,260,62,198,1071,50,110,244,270,92,105,200
"2011","Kensington and Chelsea 007D","E01002874","Total",1431,245,46,199,1186,66,64,249,314,99,170,224
"2011","Kensington and Chelsea 007E","E01002875","Total",1388,318,112,206,1070,29,108,190,242,71,195,235
"2011","Kensington and Chelsea 008A","E01002824","Total",1515,289,69,220,1226,9,72,271,334,111,207,222
"2011","Kensington and Chelsea 008B","E01002825","Total",1817,310,87,223,1507,52,170,401,334,143,162,245
"2011","Kensington and Chelsea 008C","E01002826","Total",1474,380,89,291,1094,35,124,284,382,35,69,165
"2011","Kensington and Chelsea 008D","E01002827","Total",1814,400,86,314,1414,18,112,453,418,78,101,234
"2011","Kensington and Chelsea 008E","E01002828","Total",1332,352,98,254,980,23,112,225,308,58,101,153
"2011","Kensington and Chelsea 009A","E01002864","Total",1496,163,60,103,1333,35,180,298,152,156,246,266
"2011","Kensington and Chelsea 009B","E01002866","Total",1744,358,44,314,1386,140,70,290,394,55,163,274
"2011","Kensington and Chelsea 009C","E01002867","Total",1981,452,74,378,1529,113,70,305,486,102,235,218
"2011","Kensington and Chelsea 009D","E01002868","Total",1633,267,81,186,1366,16,162,357,284,101,152,294
"2011","Kensington and Chelsea 009E","E01002869","Total",1507,340,70,270,1167,90,86,243,388,54,102,204
"2011","Kensington and Chelsea 010A","E01002887","Total",1400,448,69,379,952,12,70,195,376,51,95,153
"2011","Kensington and Chelsea 010B","E01002889","Total",1118,273,72,201,845,4,66,236,264,63,74,138
"2011","Kensington and Chelsea 010C","E01002890","Total",1812,193,77,116,1619,13,156,457,290,182,268,253
"2011","Kensington and Chelsea 010D","E01002891","Total",1436,320,48,272,1116,41,68,272,348,84,97,206
"2011","Kensington and Chelsea 010E","E01002892","Total",1800,436,43,393,1364,31,62,375,440,66,128,262
"2011","Kensington and Chelsea 011A","E01002813","Total",1767,344,89,255,1423,11,134,320,394,136,178,250
"2011","Kensington and Chelsea 011B","E01002815","Total",1423,368,96,272,1055,50,54,237,346,62,66,240
"2011","Kensington and Chelsea 011C","E01002816","Total",1322,327,54,273,995,12,112,248,308,61,59,195
"2011","Kensington and Chelsea 011D","E01002817","Total",1593,248,68,180,1345,55,158,300,282,84,146,320
"2011","Kensington and Chelsea 011E","E01002865","Total",1383,159,48,111,1224,28,84,328,222,137,183,242
"2011","Kensington and Chelsea 012A","E01002818","Total",2002,671,132,539,1331,33,116,266,496,90,90,240
"2011","Kensington and Chelsea 012B","E01002819","Total",1585,449,87,362,1136,17,106,208,356,47,179,223
"2011","Kensington and Chelsea 012C","E01002859","Total",1628,412,65,347,1216,36,124,269,418,82,133,154
"2011","Kensington and Chelsea 012D","E01002860","Total",1502,346,79,267,1156,22,130,240,408,99,91,166
"2011","Kensington and Chelsea 012E","E01002863","Total",1441,401,91,310,1040,12,148,259,312,66,68,175
"2011","Kensington and Chelsea 013A","E01002812","Total",1763,403,63,340,1360,66,108,364,414,91,125,192
"2011","Kensington and Chelsea 013B","E01002834","Total",1410,356,57,299,1054,18,60,278,304,107,100,187
"2011","Kensington and Chelsea 013C","E01002839","Total",1566,618,81,537,948,45,60,183,368,45,60,187
"2011","Kensington and Chelsea 013D","E01002850","Total",1377,308,46,262,1069,65,32,189,344,37,109,293
"2011","Kensington and Chelsea 013E","E01002888","Total",2022,605,80,525,1417,19,72,295,606,63,42,320
"2011","Kensington and Chelsea 014A","E01002821","Total",1420,279,65,214,1141,23,106,235,358,90,96,233
"2011","Kensington and Chelsea 014B","E01002823","Total",1369,350,100,250,1019,48,130,193,224,114,146,164
"2011","Kensington and Chelsea 014C","E01002858","Total",1254,488,105,383,766,57,66,96,170,32,122,223
"2011","Kensington and Chelsea 014D","E01002861","Total",1424,376,105,271,1048,32,170,244,296,51,89,166
"2011","Kensington and Chelsea 014E","E01002862","Total",1543,630,137,493,913,129,98,167,254,23,61,181
"2011","Kensington and Chelsea 015A","E01002814","Total",1953,358,71,287,1595,128,104,295,380,111,182,395
"2011","Kensington and Chelsea 015B","E01002847","Total",1552,431,49,382,1121,47,70,212,508,58,52,174
"2011","Kensington and Chelsea 015C","E01002848","Total",1567,476,78,398,1091,58,48,159,484,100,72,170
"2011","Kensington and Chelsea 015D","E01002851","Total",1576,514,118,396,1062,66,66,139,404,66,75,246
"2011","Kensington and Chelsea 016A","E01002820","Total",1250,340,57,283,910,15,58,221,306,87,64,159
"2011","Kensington and Chelsea 016B","E01002822","Total",1205,321,74,247,884,16,106,207,214,100,132,109
"2011","Kensington and Chelsea 016C","E01002835","Total",1550,342,71,271,1208,22,90,305,414,91,82,204
"2011","Kensington and Chelsea 016D","E01002836","Total",1390,428,71,357,962,21,50,245,398,52,53,143
"2011","Kensington and Chelsea 016E","E01002837","Total",1329,365,39,326,964,17,82,220,338,67,115,125
"2011","Kensington and Chelsea 017A","E01002846","Total",1313,432,50,382,881,65,42,146,372,25,51,180
"2011","Kensington and Chelsea 017B","E01002849","Total",1523,350,68,282,1173,62,80,211,434,92,93,201
"2011","Kensington and Chelsea 017C","E01002893","Total",1767,494,100,394,1273,72,90,256,492,51,67,245
"2011","Kensington and Chelsea 017D","E01002894","Total",1389,381,61,320,1008,62,44,176,434,68,51,173
"2011","Kensington and Chelsea 017E","E01002898","Total",1609,303,105,198,1306,41,114,308,310,148,187,198
"2011","Kensington and Chelsea 018A","E01002899","Total",1355,414,143,271,941,39,120,219,284,41,59,179
"2011","Kensington and Chelsea 018B","E01002900","Total",1430,286,67,219,1144,21,128,227,310,75,169,214
"2011","Kensington and Chelsea 018C","E01002901","Total",956,342,152,190,614,23,76,120,156,59,70,110
"2011","Kensington and Chelsea 018D","E01002902","Total",1704,550,114,436,1154,48,142,212,472,56,81,143
"2011","Kensington and Chelsea 018E","E01002903","Total",1513,251,68,183,1262,21,160,312,296,99,126,248
"2011","Kensington and Chelsea 019A","E01002844","Total",1369,377,101,276,992,26,136,199,294,45,119,173
"2011","Kensington and Chelsea 019B","E01002845","Total",1326,405,108,297,921,36,104,199,240,40,107,195
"2011","Kensington and Chelsea 019C","E01002910","Total",1329,428,145,283,901,42,124,225,216,51,81,162
"2011","Kensington and Chelsea 019D","E01002911","Total",1651,312,54,258,1339,37,86,297,350,119,194,256
"2011","Kensington and Chelsea 019E","E01002914","Total",1432,344,106,238,1088,44,168,267,264,62,103,180
"2011","Kensington and Chelsea 020A","E01002838","Total",1057,290,40,250,767,22,102,228,228,45,32,110
"2011","Kensington and Chelsea 020B","E01002895","Total",1395,225,40,185,1170,31,104,265,254,162,162,192
"2011","Kensington and Chelsea 020C","E01002896","Total",1752,387,64,323,1365,23,78,335,466,84,155,224
"2011","Kensington and Chelsea 020D","E01002897","Total",1314,358,64,294,956,64,60,196,378,32,42,184
"2011","Kensington and Chelsea 020E","E01002912","Total",1601,367,86,281,1234,59,144,251,298,72,69,341
"2011","Kensington and Chelsea 021A","E01002840","Total",1383,308,141,167,1075,113,160,190,206,62,121,223
"2011","Kensington and Chelsea 021B","E01002841","Total",1363,353,68,285,1010,63,52,231,294,46,82,242
"2011","Kensington and Chelsea 021C","E01002842","Total",1248,187,67,120,1061,93,86,205,126,117,173,261
"2011","Kensington and Chelsea 021D","E01002843","Total",1232,279,74,205,953,104,92,162,198,98,100,199
"2011","Kensington and Chelsea 021E","E01002913","Total",1894,420,72,348,1474,84,86,313,428,100,146,317
"2011","Lambeth 002A","E01003015","Total",1594,289,64,225,1305,147,72,194,292,78,217,305
"2011","Lambeth 002B","E01003108","Total",1536,347,97,250,1189,183,44,231,288,84,148,211
"2011","Lambeth 002C","E01003110","Total",1825,325,86,239,1500,125,72,203,426,71,171,432
"2011","Lambeth 002D","E01003111","Total",1530,242,84,158,1288,177,72,193,146,64,262,374
"2011","Lambeth 002E","E01003112","Total",1502,390,91,299,1112,138,46,156,278,49,160,285
"2011","Lambeth 003A","E01003101","Total",1568,219,36,183,1349,178,32,205,332,80,151,371
"2011","Lambeth 003B","E01003105","Total",1673,328,80,248,1345,200,84,226,258,52,178,347
"2011","Lambeth 003C","E01003106","Total",1942,324,76,248,1618,238,110,265,400,77,166,362
"2011","Lambeth 003D","E01003107","Total",1912,358,71,287,1554,163,76,186,496,40,130,463
"2011","Lambeth 003E","E01003109","Total",2255,459,69,390,1796,259,88,241,486,121,183,418
"2011","Lambeth 004A","E01003102","Total",1655,383,59,324,1272,103,30,145,416,27,71,480
"2011","Lambeth 004C","E01003104","Total",1608,307,41,266,1301,108,50,138,432,37,161,375
"2011","Lambeth 004D","E01003122","Total",1811,352,64,288,1459,166,38,168,468,87,115,417
"2011","Lambeth 004E","E01003129","Total",1839,260,33,227,1579,130,60,184,468,74,139,524
"2011","Lambeth 004F","E01033207","Total",1635,332,107,225,1303,128,84,203,262,83,158,385
"2011","Lambeth 004G","E01033208","Total",1723,553,3,550,1170,132,20,168,584,78,78,110
"2011","Lambeth 005A","E01003098","Total",1544,219,66,153,1325,109,58,224,280,77,213,364
"2011","Lambeth 005B","E01003099","Total",1590,203,33,170,1387,164,44,172,350,99,133,425
"2011","Lambeth 005C","E01003100","Total",1928,248,31,217,1680,71,28,149,676,20,81,655
"2011","Lambeth 005D","E01003180","Total",1471,261,46,215,1210,128,52,194,252,68,112,404
"2011","Lambeth 005E","E01003183","Total",1498,237,53,184,1261,130,68,159,192,48,223,441
"2011","Lambeth 006A","E01003097","Total",1671,256,96,160,1415,134,94,213,258,61,179,476
"2011","Lambeth 006B","E01003121","Total",1624,241,48,193,1383,242,64,265,222,106,189,295
"2011","Lambeth 006C","E01003123","Total",1484,215,28,187,1269,82,68,228,420,53,88,330
"2011","Lambeth 006D","E01003124","Total",1438,211,43,168,1227,122,60,157,266,66,174,382
"2011","Lambeth 006E","E01003125","Total",1762,200,52,148,1562,305,62,294,212,128,239,322
"2011","Lambeth 007A","E01003181","Total",1449,218,54,164,1231,158,66,129,298,67,139,374
"2011","Lambeth 007B","E01003184","Total",1414,211,38,173,1203,263,24,265,158,103,176,214
"2011","Lambeth 007C","E01003185","Total",1645,273,62,211,1372,155,46,209,390,62,93,417
"2011","Lambeth 007D","E01003186","Total",1939,282,28,254,1657,154,64,265,530,78,153,413
"2011","Lambeth 007E","E01003187","Total",1486,251,56,195,1235,81,36,164,178,36,294,446
"2011","Lambeth 008A","E01003089","Total",1874,196,16,180,1678,204,52,193,226,134,382,487
"2011","Lambeth 008B","E01003091","Total",1667,182,31,151,1485,202,42,224,326,98,198,395
"2011","Lambeth 008C","E01003092","Total",1738,228,53,175,1510,231,56,206,260,97,253,407
"2011","Lambeth 008D","E01003126","Total",1532,201,42,159,1331,181,56,234,260,69,226,305
"2011","Lambeth 008E","E01003128","Total",1499,259,46,213,1240,199,48,181,238,82,167,325
"2011","Lambeth 009A","E01003046","Total",1738,279,31,248,1459,298,54,301,212,117,240,237
"2011","Lambeth 009B","E01003048","Total",1764,286,52,234,1478,312,50,223,152,171,282,288
"2011","Lambeth 009C","E01003075","Total",1614,258,53,205,1356,252,62,230,162,115,257,278
"2011","Lambeth 009D","E01003182","Total",1804,239,44,195,1565,158,58,182,274,106,324,463
"2011","Lambeth 009E","E01003188","Total",1336,192,27,165,1144,176,46,168,166,35,230,323
"2011","Lambeth 010A","E01003088","Total",1817,208,37,171,1609,166,50,218,332,80,204,559
"2011","Lambeth 010B","E01003093","Total",2305,269,64,205,2036,453,80,366,330,167,218,422
"2011","Lambeth 010C","E01003094","Total",1539,230,50,180,1309,86,90,170,288,33,132,510
"2011","Lambeth 010D","E01003096","Total",2062,298,50,248,1764,49,48,125,616,43,97,786
"2011","Lambeth 010E","E01003127","Total",1773,262,44,218,1511,114,68,271,344,76,197,441
"2011","Lambeth 011A","E01003045","Total",1971,246,63,183,1725,247,52,261,164,148,403,450
"2011","Lambeth 011B","E01003047","Total",1627,266,54,212,1361,172,56,188,388,85,108,364
"2011","Lambeth 011C","E01003049","Total",1686,218,50,168,1468,234,48,227,226,120,297,316
"2011","Lambeth 011D","E01003059","Total",1592,207,61,146,1385,173,34,206,216,101,259,396
"2011","Lambeth 011E","E01003060","Total",1558,239,66,173,1319,138,44,226,158,112,268,373
"2011","Lambeth 011F","E01003061","Total",1242,215,25,190,1027,70,30,176,302,57,119,273
"2011","Lambeth 012A","E01003034","Total",1731,223,45,178,1508,120,48,289,356,124,150,421
"2011","Lambeth 012B","E01003035","Total",1557,230,40,190,1327,69,38,132,444,31,72,541
"2011","Lambeth 012C","E01003036","Total",1603,271,57,214,1332,125,40,253,382,41,125,366
"2011","Lambeth 012D","E01003090","Total",2279,343,41,302,1936,67,38,175,724,57,200,675
"2011","Lambeth 012E","E01003095","Total",1834,220,37,183,1614,97,58,221,420,131,190,497
"2011","Lambeth 013A","E01003037","Total",1387,210,59,151,1177,122,52,183,266,73,112,369
"2011","Lambeth 013B","E01003038","Total",1506,242,52,190,1264,29,36,238,422,70,89,380
"2011","Lambeth 013C","E01003039","Total",2042,303,40,263,1739,78,50,278,666,109,130,428
"2011","Lambeth 013D","E01003040","Total",1288,210,37,173,1078,84,60,180,334,51,125,244
"2011","Lambeth 013E","E01003042","Total",1042,212,61,151,830,86,34,94,188,20,67,341
"2011","Lambeth 014A","E01003072","Total",1846,246,103,143,1600,106,122,351,308,175,183,355
"2011","Lambeth 014B","E01003073","Total",1697,236,52,184,1461,157,44,293,296,115,240,316
"2011","Lambeth 014C","E01003076","Total",1887,272,30,242,1615,151,38,293,456,39,220,418
"2011","Lambeth 014D","E01003077","Total",1792,262,32,230,1530,83,62,290,416,80,180,419
"2011","Lambeth 014E","E01003078","Total",1576,164,60,104,1412,49,100,317,314,106,136,390
"2011","Lambeth 015A","E01003019","Total",2084,282,57,225,1802,89,72,236,572,71,127,635
"2011","Lambeth 015B","E01003053","Total",1724,221,30,191,1503,56,44,168,524,36,61,614
"2011","Lambeth 015C","E01003054","Total",1825,242,20,222,1583,77,24,97,582,18,64,721
"2011","Lambeth 015D","E01003056","Total",1929,256,44,212,1673,134,20,134,488,43,102,752
"2011","Lambeth 015E","E01003058","Total",1922,245,38,207,1677,109,50,145,446,47,64,816
"2011","Lambeth 016A","E01003020","Total",1772,263,40,223,1509,120,54,258,370,45,182,480
"2011","Lambeth 016B","E01003050","Total",1618,307,57,250,1311,100,36,181,392,54,72,476
"2011","Lambeth 016C","E01003052","Total",1821,299,44,255,1522,249,36,251,212,127,292,355
"2011","Lambeth 016D","E01003055","Total",1464,381,83,298,1083,58,44,130,404,0,80,367
"2011","Lambeth 016E","E01003176","Total",1906,257,75,182,1649,354,62,292,230,155,202,354
"2011","Lambeth 017A","E01003029","Total",1781,319,50,269,1462,89,74,200,522,88,73,416
"2011","Lambeth 017B","E01003032","Total",1747,263,75,188,1484,119,86,177,342,83,164,513
"2011","Lambeth 017C","E01003041","Total",1536,231,51,180,1305,168,64,143,304,100,164,362
"2011","Lambeth 017D","E01003057","Total",1676,262,39,223,1414,215,46,147,262,49,157,538
"2011","Lambeth 018A","E01003043","Total",1634,221,60,161,1413,124,80,159,316,22,160,552
"2011","Lambeth 018B","E01003044","Total",1238,303,31,272,935,157,20,182,158,58,152,208
"2011","Lambeth 018C","E01003051","Total",1641,209,21,188,1432,200,22,208,336,83,251,332
"2011","Lambeth 018D","E01003071","Total",2278,289,25,264,1989,140,66,384,668,47,171,513
"2011","Lambeth 018E","E01003074","Total",2347,417,52,365,1930,178,64,425,544,118,210,391
"2011","Lambeth 019A","E01003026","Total",1471,213,41,172,1258,31,26,221,442,76,65,397
"2011","Lambeth 019B","E01003027","Total",1373,92,21,71,1281,21,46,312,220,135,138,409
"2011","Lambeth 019C","E01003028","Total",1469,123,27,96,1346,96,54,363,250,76,84,423
"2011","Lambeth 019D","E01003030","Total",1782,210,40,170,1572,59,42,285,568,81,104,433
"2011","Lambeth 019E","E01003033","Total",1518,152,37,115,1366,55,46,304,316,129,176,340
"2011","Lambeth 020A","E01003018","Total",2063,352,45,307,1711,95,48,309,670,25,107,457
"2011","Lambeth 020B","E01003171","Total",1740,351,54,297,1389,179,52,201,364,89,73,431
"2011","Lambeth 020C","E01003173","Total",1610,233,52,181,1377,51,68,277,332,65,173,411
"2011","Lambeth 020D","E01003177","Total",1648,207,36,171,1441,147,44,260,386,55,149,400
"2011","Lambeth 020E","E01003178","Total",1576,252,48,204,1324,67,50,229,382,35,70,491
"2011","Lambeth 021A","E01003021","Total",1514,252,62,190,1262,152,84,232,200,41,170,383
"2011","Lambeth 021B","E01003022","Total",1746,262,53,209,1484,112,60,240,376,56,179,461
"2011","Lambeth 021C","E01003023","Total",2380,370,70,300,2010,197,58,291,504,90,167,703
"2011","Lambeth 021D","E01003024","Total",1798,274,53,221,1524,302,36,294,220,96,162,414
"2011","Lambeth 021E","E01003025","Total",2071,264,60,204,1807,207,82,330,304,121,295,468
"2011","Lambeth 022A","E01003136","Total",1583,298,40,258,1285,128,42,263,326,103,119,304
"2011","Lambeth 022B","E01003137","Total",1446,262,45,217,1184,229,66,206,266,68,132,217
"2011","Lambeth 022C","E01003159","Total",1473,204,39,165,1269,138,50,225,214,89,202,351
"2011","Lambeth 022D","E01003160","Total",1462,159,29,130,1303,209,42,217,162,99,240,334
"2011","Lambeth 022E","E01003162","Total",2126,245,70,175,1881,389,54,330,224,109,355,420
"2011","Lambeth 023A","E01003031","Total",1658,239,40,199,1419,133,36,179,346,55,133,537
"2011","Lambeth 023B","E01003156","Total",1555,204,59,145,1351,80,78,329,322,55,143,344
"2011","Lambeth 023C","E01003157","Total",1549,124,24,100,1425,65,52,449,268,82,117,392
"2011","Lambeth 023D","E01003158","Total",1596,232,56,176,1364,34,56,332,482,68,44,348
"2011","Lambeth 023E","E01003161","Total",1237,135,56,79,1102,117,52,230,214,63,111,315
"2011","Lambeth 023F","E01003163","Total",1515,146,54,92,1369,101,118,298,194,64,119,475
"2011","Lambeth 024A","E01003132","Total",1413,141,51,90,1272,160,72,210,194,75,266,295
"2011","Lambeth 024B","E01003172","Total",1922,286,54,232,1636,227,68,300,294,132,220,395
"2011","Lambeth 024C","E01003174","Total",2045,271,37,234,1774,431,38,288,226,132,252,407
"2011","Lambeth 024D","E01003175","Total",1610,187,38,149,1423,251,46,207,138,145,251,385
"2011","Lambeth 024E","E01003179","Total",1648,206,40,166,1442,269,28,287,178,77,293,310
"2011","Lambeth 025A","E01003164","Total",2118,305,40,265,1813,245,70,407,422,82,222,365
"2011","Lambeth 025B","E01003165","Total",1610,246,85,161,1364,163,110,335,268,81,161,246
"2011","Lambeth 025C","E01003168","Total",1584,210,62,148,1374,167,80,254,216,98,243,316
"2011","Lambeth 025D","E01003169","Total",2446,380,63,317,2066,225,70,504,476,101,216,474
"2011","Lambeth 025E","E01003170","Total",1859,263,124,139,1596,59,156,506,296,143,145,291
"2011","Lambeth 026A","E01003130","Total",1735,240,57,183,1495,90,70,320,358,49,187,421
"2011","Lambeth 026B","E01003131","Total",1447,200,44,156,1247,77,46,251,282,94,145,352
"2011","Lambeth 026C","E01003135","Total",1684,268,45,223,1416,107,76,290,272,68,188,415
"2011","Lambeth 026D","E01003138","Total",1531,212,45,167,1319,58,48,345,436,31,78,323
"2011","Lambeth 026E","E01003151","Total",1950,309,102,207,1641,386,54,333,234,122,224,288
"2011","Lambeth 027A","E01003079","Total",1709,285,50,235,1424,275,54,293,248,117,148,289
"2011","Lambeth 027B","E01003080","Total",1599,208,37,171,1391,105,58,394,264,62,175,333
"2011","Lambeth 027C","E01003133","Total",1719,290,43,247,1429,144,36,303,306,101,169,370
"2011","Lambeth 027D","E01003134","Total",1552,173,46,127,1379,98,80,317,256,72,169,387
"2011","Lambeth 027E","E01003152","Total",1945,208,43,165,1737,144,96,353,294,63,295,492
"2011","Lambeth 028A","E01003064","Total",1536,193,27,166,1343,99,64,379,362,72,161,206
"2011","Lambeth 028B","E01003066","Total",1688,266,86,180,1422,184,62,275,278,96,261,266
"2011","Lambeth 028C","E01003081","Total",1766,299,39,260,1467,172,44,299,256,124,221,351
"2011","Lambeth 028D","E01003166","Total",2279,344,50,294,1935,267,74,481,466,72,230,345
"2011","Lambeth 028E","E01003167","Total",1723,170,68,102,1553,74,112,480,294,122,193,278
"2011","Lambeth 029A","E01003116","Total",1583,192,50,142,1391,98,122,246,216,90,228,391
"2011","Lambeth 029B","E01003117","Total",1914,302,67,235,1612,150,100,238,390,51,200,483
"2011","Lambeth 029C","E01003118","Total",1677,218,90,128,1459,61,74,263,312,57,307,385
"2011","Lambeth 029D","E01003153","Total",2066,291,62,229,1775,97,56,243,592,20,148,619
"2011","Lambeth 029E","E01003155","Total",1743,252,50,202,1491,49,80,362,346,82,177,395
"2011","Lambeth 030A","E01003083","Total",1459,185,56,129,1274,59,100,308,220,118,170,299
"2011","Lambeth 030B","E01003084","Total",1603,219,39,180,1384,101,54,431,288,90,170,250
"2011","Lambeth 030C","E01003085","Total",1734,218,91,127,1516,131,102,321,242,114,244,362
"2011","Lambeth 030D","E01003149","Total",1693,204,50,154,1489,111,86,331,272,130,139,420
"2011","Lambeth 030E","E01003154","Total",1836,282,73,209,1554,163,68,354,258,82,255,374
"2011","Lambeth 031A","E01003065","Total",1472,269,70,199,1203,262,66,267,192,49,186,181
"2011","Lambeth 031B","E01003068","Total",1592,191,58,133,1401,262,68,350,226,85,237,173
"2011","Lambeth 031C","E01003082","Total",1446,247,81,166,1199,154,94,287,216,91,154,203
"2011","Lambeth 031D","E01003086","Total",1611,211,39,172,1400,268,70,249,184,111,313,205
"2011","Lambeth 031E","E01003087","Total",1562,196,57,139,1366,316,50,357,120,174,173,176
"2011","Lambeth 032A","E01003113","Total",1922,260,30,230,1662,168,52,268,450,66,286,372
"2011","Lambeth 032B","E01003114","Total",1812,238,40,198,1574,143,48,264,402,70,241,406
"2011","Lambeth 032C","E01003119","Total",1833,304,38,266,1529,121,44,304,396,56,247,361
"2011","Lambeth 032D","E01003120","Total",1939,424,61,363,1515,149,32,356,424,46,196,312
"2011","Lambeth 032E","E01003148","Total",1777,279,45,234,1498,110,40,427,332,77,240,272
"2011","Lambeth 032F","E01003150","Total",1690,306,94,212,1384,242,40,291,294,59,189,269
"2011","Lambeth 033A","E01003062","Total",1668,291,51,240,1377,138,56,308,466,63,111,235
"2011","Lambeth 033B","E01003063","Total",1432,277,48,229,1155,189,64,243,218,84,154,203
"2011","Lambeth 033C","E01003067","Total",1471,166,47,119,1305,101,78,338,236,69,186,297
"2011","Lambeth 033D","E01003069","Total",1361,122,26,96,1239,197,76,289,190,68,172,247
"2011","Lambeth 033E","E01003070","Total",1492,234,38,196,1258,239,44,243,234,64,173,261
"2011","Lambeth 034A","E01003115","Total",1601,195,23,172,1406,144,54,371,332,51,161,293
"2011","Lambeth 034B","E01003141","Total",1707,242,72,170,1465,150,116,368,236,93,191,311
"2011","Lambeth 034C","E01003144","Total",1499,115,37,78,1384,45,104,318,146,106,247,418
"2011","Lambeth 034D","E01003145","Total",1675,323,54,269,1352,116,60,243,368,42,207,316
"2011","Lambeth 034E","E01003147","Total",1974,253,53,200,1721,135,94,403,292,74,356,367
"2011","Lambeth 035A","E01003139","Total",1564,136,45,91,1428,124,86,236,136,117,288,441
"2011","Lambeth 035B","E01003140","Total",1489,89,45,44,1400,119,102,210,142,141,256,430
"2011","Lambeth 035C","E01003142","Total",1359,91,45,46,1268,91,122,177,96,89,367,326
"2011","Lambeth 035D","E01003143","Total",1395,144,72,72,1251,76,78,237,166,81,297,316
"2011","Lambeth 035E","E01003146","Total",1517,116,32,84,1401,158,60,208,158,100,296,421
"2011","Lambeth 036A","E01003013","Total",1562,414,25,389,1148,33,56,147,448,47,79,338
"2011","Lambeth 036B","E01003014","Total",1415,272,76,196,1143,80,102,145,286,26,137,367
"2011","Lambeth 036C","E01003016","Total",1026,244,26,218,782,30,46,77,242,5,100,282
"2011","Lambeth 036D","E01003017","Total",1661,407,94,313,1254,103,92,217,354,24,131,333
"2011","Lambeth 036E","E01032582","Total",1893,374,79,295,1519,125,80,150,482,89,110,483
"2011","Lewisham 001A","E01003244","Total",1629,208,34,174,1421,281,22,329,124,175,287,203
"2011","Lewisham 001B","E01003245","Total",1559,157,23,134,1402,284,26,237,204,175,293,183
"2011","Lewisham 001C","E01003247","Total",1673,237,18,219,1436,32,42,150,352,51,187,622
"2011","Lewisham 001D","E01003249","Total",1909,368,56,312,1541,181,50,254,422,56,245,333
"2011","Lewisham 001E","E01003250","Total",1755,245,56,189,1510,184,56,188,410,88,233,351
"2011","Lewisham 002A","E01003246","Total",1438,179,30,149,1259,152,48,201,182,32,296,348
"2011","Lewisham 002B","E01003248","Total",1619,287,42,245,1332,237,38,242,256,108,213,238
"2011","Lewisham 002C","E01003251","Total",2003,220,44,176,1783,334,56,366,206,141,298,382
"2011","Lewisham 002D","E01003252","Total",1557,200,52,148,1357,332,46,231,140,96,298,214
"2011","Lewisham 002E","E01003253","Total",1438,269,69,200,1169,154,66,190,246,89,156,268
"2011","Lewisham 003A","E01003297","Total",1538,337,10,327,1201,282,8,291,360,31,96,133
"2011","Lewisham 003B","E01003299","Total",1623,150,34,116,1473,242,58,194,250,53,235,441
"2011","Lewisham 003C","E01003301","Total",1936,203,18,185,1733,115,30,335,456,97,317,383
"2011","Lewisham 003D","E01003302","Total",1509,316,70,246,1193,189,42,231,218,82,204,227
"2011","Lewisham 003E","E01003305","Total",1281,178,35,143,1103,152,58,189,146,52,202,304
"2011","Lewisham 005A","E01003207","Total",1399,258,47,211,1141,136,62,187,146,70,199,341
"2011","Lewisham 005B","E01003209","Total",1868,276,62,214,1592,198,44,244,320,100,147,539
"2011","Lewisham 005C","E01003210","Total",1727,363,30,333,1364,125,48,237,416,61,132,345
"2011","Lewisham 005D","E01003212","Total",1976,297,88,209,1679,133,110,243,360,62,150,621
"2011","Lewisham 005E","E01003215","Total",1596,216,37,179,1380,97,32,291,354,46,125,435
"2011","Lewisham 006A","E01003338","Total",1772,320,76,244,1452,198,90,231,202,117,249,365
"2011","Lewisham 006B","E01003339","Total",1753,267,70,197,1486,118,76,251,366,100,303,272
"2011","Lewisham 006C","E01003340","Total",1906,249,28,221,1657,87,50,248,410,48,141,673
"2011","Lewisham 006D","E01003341","Total",1508,135,25,110,1373,109,66,281,284,73,162,398
"2011","Lewisham 006E","E01003343","Total",1356,239,43,196,1117,110,58,311,266,27,91,254
"2011","Lewisham 007A","E01003199","Total",1715,275,66,209,1440,92,78,414,464,80,90,222
"2011","Lewisham 007B","E01003201","Total",1626,232,55,177,1394,180,58,311,236,52,222,335
"2011","Lewisham 007C","E01003204","Total",1370,191,50,141,1179,103,56,288,356,79,128,169
"2011","Lewisham 007D","E01003205","Total",1332,157,63,94,1175,176,56,160,106,79,383,215
"2011","Lewisham 007E","E01003206","Total",1568,217,43,174,1351,71,98,422,380,67,113,200
"2011","Lewisham 008B","E01003211","Total",1554,306,46,260,1248,91,42,254,382,65,146,268
"2011","Lewisham 008C","E01003213","Total",1834,276,34,242,1558,105,52,392,434,46,145,384
"2011","Lewisham 008D","E01003214","Total",1755,249,42,207,1506,189,52,301,292,76,211,385
"2011","Lewisham 008E","E01033324","Total",1597,193,68,125,1404,78,112,251,246,71,240,406
"2011","Lewisham 008F","E01033325","Total",1205,297,5,292,908,8,2,162,652,0,13,71
"2011","Lewisham 009A","E01003198","Total",1406,211,76,135,1195,101,92,323,320,66,113,180
"2011","Lewisham 009B","E01003200","Total",1553,292,74,218,1261,29,104,327,406,78,87,230
"2011","Lewisham 009C","E01003202","Total",1559,288,108,180,1271,22,164,335,394,64,68,224
"2011","Lewisham 009D","E01003203","Total",1757,529,105,424,1228,129,60,317,362,52,98,210
"2011","Lewisham 010A","E01003336","Total",1378,204,67,137,1174,223,58,209,154,118,200,212
"2011","Lewisham 010B","E01003337","Total",1636,173,22,151,1463,261,56,451,112,115,259,209
"2011","Lewisham 010C","E01003342","Total",1634,188,32,156,1446,135,40,347,442,56,140,286
"2011","Lewisham 010D","E01003344","Total",1731,220,35,185,1511,90,72,289,344,84,152,480
"2011","Lewisham 010E","E01003345","Total",1714,210,29,181,1504,78,36,280,414,78,197,421
"2011","Lewisham 011A","E01003273","Total",2000,153,53,100,1847,98,68,320,220,61,213,867
"2011","Lewisham 011B","E01003277","Total",1706,277,32,245,1429,159,62,315,382,47,146,318
"2011","Lewisham 011C","E01003278","Total",1887,284,56,228,1603,106,90,270,336,76,193,532
"2011","Lewisham 011D","E01003279","Total",1593,179,59,120,1414,82,72,262,332,81,165,420
"2011","Lewisham 012A","E01003288","Total",1767,340,131,209,1427,200,92,225,220,62,254,374
"2011","Lewisham 012C","E01003290","Total",1701,277,80,197,1424,134,38,232,284,41,238,457
"2011","Lewisham 012D","E01003291","Total",1478,262,83,179,1216,267,54,259,214,87,93,242
"2011","Lewisham 012E","E01003296","Total",2046,460,54,406,1586,176,70,341,424,77,152,346
"2011","Lewisham 012F","E01033327","Total",1507,255,52,203,1252,86,62,262,312,38,113,379
"2011","Lewisham 012G","E01033341","Total",1298,173,24,149,1125,206,38,233,218,61,166,203
"2011","Lewisham 013A","E01003282","Total",2418,374,62,312,2044,141,92,362,468,115,230,636
"2011","Lewisham 013B","E01003283","Total",2108,335,74,261,1773,52,108,598,388,169,179,279
"2011","Lewisham 013C","E01003284","Total",1748,221,61,160,1527,90,106,432,370,49,182,298
"2011","Lewisham 013D","E01003286","Total",1633,343,138,205,1290,193,110,283,210,83,189,222
"2011","Lewisham 014A","E01003272","Total",1959,245,46,199,1714,106,82,358,340,77,189,562
"2011","Lewisham 014B","E01003274","Total",1717,232,46,186,1485,118,68,415,300,58,202,324
"2011","Lewisham 014C","E01003275","Total",1640,211,64,147,1429,122,78,286,188,119,353,283
"2011","Lewisham 014D","E01003276","Total",1898,160,39,121,1738,135,106,495,222,76,334,370
"2011","Lewisham 015A","E01003225","Total",1507,115,36,79,1392,58,100,411,294,35,166,328
"2011","Lewisham 015B","E01003231","Total",1603,238,49,189,1365,91,70,388,280,64,181,291
"2011","Lewisham 015C","E01003232","Total",1714,153,40,113,1561,57,100,509,238,67,215,375
"2011","Lewisham 015D","E01003233","Total",1702,171,44,127,1531,79,104,380,308,77,222,361
"2011","Lewisham 016A","E01003280","Total",1596,181,63,118,1415,203,110,267,208,96,234,297
"2011","Lewisham 016B","E01003281","Total",1534,177,62,115,1357,54,114,368,182,102,223,314
"2011","Lewisham 016C","E01003285","Total",1608,307,84,223,1301,86,102,331,332,47,159,244
"2011","Lewisham 016D","E01003287","Total",1909,231,61,170,1678,62,120,514,354,93,174,361
"2011","Lewisham 017A","E01003292","Total",1565,234,52,182,1331,113,82,284,356,42,173,281
"2011","Lewisham 017B","E01003293","Total",1515,241,40,201,1274,166,66,285,274,53,179,251
"2011","Lewisham 017D","E01003295","Total",1622,211,30,181,1411,149,64,291,216,75,265,351
"2011","Lewisham 017E","E01033320","Total",1463,244,49,195,1219,97,58,257,252,111,170,274
"2011","Lewisham 017F","E01033322","Total",1238,216,14,202,1022,102,18,174,366,54,81,227
"2011","Lewisham 018A","E01003319","Total",1831,283,88,195,1548,184,84,330,172,103,352,323
"2011","Lewisham 018B","E01003320","Total",1494,241,42,199,1253,172,62,274,200,111,186,248
"2011","Lewisham 018C","E01003323","Total",1478,222,51,171,1256,124,56,225,212,82,250,307
"2011","Lewisham 018D","E01003325","Total",1719,238,45,193,1481,247,78,314,206,132,250,254
"2011","Lewisham 019A","E01003226","Total",1742,191,47,144,1551,64,68,433,382,65,153,386
"2011","Lewisham 019B","E01003227","Total",1658,206,60,146,1452,46,92,402,254,77,199,382
"2011","Lewisham 019C","E01003228","Total",1487,204,52,152,1283,75,92,437,364,50,71,194
"2011","Lewisham 019D","E01003229","Total",1555,323,77,246,1232,159,100,259,230,75,177,232
"2011","Lewisham 019E","E01003230","Total",1933,312,61,251,1621,209,58,371,364,96,219,304
"2011","Lewisham 020A","E01003317","Total",1882,181,51,130,1701,94,98,283,192,354,210,470
"2011","Lewisham 020B","E01003318","Total",1513,308,33,275,1205,171,40,223,230,41,264,236
"2011","Lewisham 020C","E01003321","Total",1915,307,55,252,1608,152,86,502,244,63,262,299
"2011","Lewisham 020D","E01003322","Total",1429,215,48,167,1214,99,72,282,170,72,175,344
"2011","Lewisham 020E","E01003324","Total",1467,341,65,276,1126,159,58,319,182,70,100,238
"2011","Lewisham 021A","E01003254","Total",1418,180,62,118,1238,46,132,347,264,59,133,257
"2011","Lewisham 021B","E01003255","Total",1886,423,40,383,1463,100,54,338,540,84,100,247
"2011","Lewisham 021C","E01003260","Total",1824,154,40,114,1670,316,112,370,256,96,176,344
"2011","Lewisham 021D","E01003261","Total",1495,181,39,142,1314,117,80,366,266,67,169,249
"2011","Lewisham 021E","E01003262","Total",1365,220,38,182,1145,137,62,313,286,87,109,151
"2011","Lewisham 022A","E01003217","Total",1667,158,60,98,1509,138,116,304,202,113,340,296
"2011","Lewisham 022B","E01003218","Total",1498,128,43,85,1370,61,98,300,158,161,234,358
"2011","Lewisham 022C","E01003220","Total",1499,197,31,166,1302,95,96,243,178,112,234,344
"2011","Lewisham 022D","E01003222","Total",1632,194,48,146,1438,137,120,302,144,77,331,327
"2011","Lewisham 022E","E01003224","Total",1648,164,46,118,1484,114,96,268,202,126,301,377
"2011","Lewisham 023A","E01003263","Total",1642,282,112,170,1360,233,98,312,222,106,171,218
"2011","Lewisham 023B","E01003268","Total",1664,253,78,175,1411,97,94,322,270,66,210,352
"2011","Lewisham 023C","E01003269","Total",1554,192,55,137,1362,163,106,281,242,69,174,327
"2011","Lewisham 023D","E01003270","Total",1638,214,46,168,1424,67,110,365,228,77,180,397
"2011","Lewisham 023E","E01003271","Total",1667,117,50,67,1550,55,200,328,248,89,223,407
"2011","Lewisham 024A","E01003307","Total",1521,180,59,121,1341,106,84,362,246,61,176,306
"2011","Lewisham 024B","E01003308","Total",1808,235,54,181,1573,136,60,377,268,92,342,298
"2011","Lewisham 024C","E01003314","Total",1596,203,34,169,1393,129,68,303,344,90,186,273
"2011","Lewisham 024D","E01003315","Total",1287,222,46,176,1065,97,42,260,308,58,106,194
"2011","Lewisham 024E","E01003316","Total",1482,172,49,123,1310,92,72,323,274,72,200,277
"2011","Lewisham 025A","E01003216","Total",1824,231,37,194,1593,79,80,261,190,185,404,394
"2011","Lewisham 025B","E01003219","Total",1647,196,71,125,1451,73,116,258,162,107,362,373
"2011","Lewisham 025C","E01003221","Total",1917,251,60,191,1666,170,106,271,238,206,279,396
"2011","Lewisham 025D","E01003223","Total",1715,142,58,84,1573,60,156,222,154,150,375,456
"2011","Lewisham 026A","E01003346","Total",1537,180,81,99,1357,199,92,313,148,69,243,293
"2011","Lewisham 026B","E01003349","Total",1412,156,55,101,1256,192,64,329,112,105,258,196
"2011","Lewisham 026C","E01003351","Total",1463,187,98,89,1276,222,106,278,122,89,254,205
"2011","Lewisham 026D","E01003354","Total",1675,264,50,214,1411,138,78,358,198,94,299,246
"2011","Lewisham 027A","E01003309","Total",1483,259,92,167,1224,225,78,240,128,67,215,271
"2011","Lewisham 027B","E01003310","Total",1551,312,48,264,1239,170,40,238,366,58,165,202
"2011","Lewisham 027C","E01003311","Total",1543,149,55,94,1394,53,130,347,232,64,210,358
"2011","Lewisham 027D","E01003312","Total",1760,290,55,235,1470,158,100,373,262,89,107,381
"2011","Lewisham 027E","E01003313","Total",1530,228,49,179,1302,283,48,310,224,88,137,212
"2011","Lewisham 028A","E01003256","Total",2055,337,81,256,1718,248,122,348,362,75,170,393
"2011","Lewisham 028B","E01003257","Total",1607,286,111,175,1321,162,128,359,226,113,87,246
"2011","Lewisham 028C","E01003258","Total",1477,195,36,159,1282,239,50,295,152,113,262,171
"2011","Lewisham 028D","E01003259","Total",1611,270,67,203,1341,131,100,354,374,33,151,198
"2011","Lewisham 029A","E01003193","Total",1568,240,78,162,1328,132,114,305,186,90,200,301
"2011","Lewisham 029B","E01003194","Total",1678,269,97,172,1409,185,100,241,156,111,279,337
"2011","Lewisham 029C","E01003195","Total",1547,206,62,144,1341,133,100,290,204,155,182,277
"2011","Lewisham 029D","E01003196","Total",1673,182,86,96,1491,206,76,288,140,177,260,344
"2011","Lewisham 029E","E01003197","Total",1628,191,80,111,1437,178,66,300,172,108,283,330
"2011","Lewisham 030A","E01003347","Total",1735,148,39,109,1587,414,56,336,116,122,327,216
"2011","Lewisham 030B","E01003348","Total",1459,171,72,99,1288,104,130,260,146,104,257,287
"2011","Lewisham 030C","E01003350","Total",1412,122,52,70,1290,191,94,281,138,115,256,215
"2011","Lewisham 030D","E01003352","Total",1801,246,97,149,1555,161,138,264,184,155,310,343
"2011","Lewisham 030E","E01003353","Total",1740,161,71,90,1579,54,126,350,158,154,293,444
"2011","Lewisham 031A","E01003264","Total",1610,284,136,148,1326,132,120,318,246,75,173,262
"2011","Lewisham 031B","E01003265","Total",1531,233,51,182,1298,254,64,278,254,51,235,162
"2011","Lewisham 031C","E01003266","Total",1734,302,120,182,1432,156,138,268,182,124,298,266
"2011","Lewisham 031D","E01003267","Total",1568,166,74,92,1402,163,98,241,144,139,287,330
"2011","Lewisham 033A","E01003329","Total",1590,201,54,147,1389,162,78,342,268,89,163,287
"2011","Lewisham 033B","E01003330","Total",1550,212,98,114,1338,299,110,274,190,78,202,185
"2011","Lewisham 033C","E01003331","Total",1373,198,91,107,1175,126,104,192,154,107,192,300
"2011","Lewisham 033D","E01003332","Total",1467,261,75,186,1206,97,82,316,280,74,155,202
"2011","Lewisham 033E","E01003334","Total",1604,335,75,260,1269,152,64,287,296,62,138,270
"2011","Lewisham 034A","E01003189","Total",1662,185,70,115,1477,216,88,315,124,159,310,265
"2011","Lewisham 034B","E01003190","Total",1877,265,53,212,1612,357,46,491,262,96,170,190
"2011","Lewisham 034C","E01003191","Total",1494,250,67,183,1244,323,56,216,204,62,175,208
"2011","Lewisham 034D","E01003192","Total",1639,321,77,244,1318,247,88,236,156,115,258,218
"2011","Lewisham 035A","E01003326","Total",1397,248,86,162,1149,115,90,301,224,66,164,189
"2011","Lewisham 035B","E01003327","Total",1796,222,68,154,1574,125,106,310,254,79,170,530
"2011","Lewisham 035C","E01003328","Total",1700,356,102,254,1344,139,98,329,318,65,141,254
"2011","Lewisham 035D","E01003333","Total",1542,253,63,190,1289,122,62,310,196,97,160,342
"2011","Lewisham 035E","E01003335","Total",1393,211,58,153,1182,183,64,239,174,85,183,254
"2011","Lewisham 037A","E01003236","Total",1590,188,72,116,1402,255,112,288,180,138,224,205
"2011","Lewisham 037B","E01003237","Total",1471,179,70,109,1292,236,112,253,174,71,226,220
"2011","Lewisham 037C","E01003238","Total",1407,160,56,104,1247,209,86,352,152,76,181,191
"2011","Lewisham 037D","E01003239","Total",1428,172,70,102,1256,185,90,258,138,96,269,220
"2011","Lewisham 037E","E01032564","Total",1312,147,63,84,1165,179,66,245,128,153,212,182
"2011","Lewisham 038A","E01003235","Total",1279,189,71,118,1090,86,84,247,120,52,225,276
"2011","Lewisham 038B","E01003240","Total",1788,199,74,125,1589,240,138,366,206,127,189,323
"2011","Lewisham 038C","E01003241","Total",1541,305,131,174,1236,99,136,244,144,98,202,313
"2011","Lewisham 038D","E01003243","Total",1358,214,88,126,1144,143,124,240,128,85,188,236
"2011","Lewisham 038E","E01032565","Total",1392,292,130,162,1100,149,98,219,166,96,256,116
"2011","Lewisham 039A","E01003298","Total",1292,136,40,96,1156,118,30,257,158,74,229,290
"2011","Lewisham 039B","E01003300","Total",1356,188,43,145,1168,186,44,198,176,39,230,295
"2011","Lewisham 039C","E01003303","Total",1377,195,47,148,1182,144,48,135,180,89,268,318
"2011","Lewisham 039D","E01003304","Total",1890,394,45,349,1496,143,46,258,412,79,232,326
"2011","Lewisham 039E","E01032579","Total",1460,327,38,289,1133,180,24,190,258,73,177,231
"2011","Newham 001A","E01003543","Total",2475,228,41,187,2247,123,74,490,222,151,540,647
"2011","Newham 001B","E01003544","Total",1938,169,46,123,1769,165,78,298,178,89,419,542
"2011","Newham 001C","E01003546","Total",1940,129,35,94,1811,131,38,285,108,217,559,473
"2011","Newham 001D","E01003550","Total",1778,173,59,114,1605,107,60,283,186,144,332,493
"2011","Newham 002A","E01003576","Total",1940,263,84,179,1677,198,46,319,134,258,378,344
"2011","Newham 002B","E01003581","Total",1845,64,21,43,1781,108,46,198,104,129,693,503
"2011","Newham 002C","E01003582","Total",1613,105,32,73,1508,148,68,185,110,201,418,378
"2011","Newham 002D","E01003583","Total",1913,102,39,63,1811,101,50,258,84,239,559,520
"2011","Newham 003A","E01003578","Total",1943,140,20,120,1803,156,20,319,128,206,492,482
"2011","Newham 003B","E01003584","Total",2057,154,40,114,1903,126,72,300,158,109,594,544
"2011","Newham 003C","E01003586","Total",1751,98,24,74,1653,91,48,136,106,119,537,616
"2011","Newham 003D","E01003590","Total",1488,223,56,167,1265,131,36,215,140,151,318,274
"2011","Newham 004A","E01003579","Total",1850,95,34,61,1755,58,54,203,84,195,716,445
"2011","Newham 004B","E01003585","Total",1649,54,23,31,1595,48,56,128,78,141,725,419
"2011","Newham 004C","E01003587","Total",2436,190,57,133,2246,159,66,463,248,185,481,644
"2011","Newham 004D","E01003591","Total",2166,156,47,109,2010,181,56,262,168,179,603,561
"2011","Newham 005A","E01003528","Total",1386,112,44,68,1274,90,42,215,64,188,369,306
"2011","Newham 005B","E01003575","Total",1698,98,26,72,1600,111,40,244,104,193,531,377
"2011","Newham 005C","E01003577","Total",1920,210,80,130,1710,214,66,349,120,307,381,273
"2011","Newham 005D","E01003580","Total",1836,165,49,116,1671,148,68,357,124,272,393,309
"2011","Newham 006A","E01003545","Total",1727,221,46,175,1506,194,46,188,172,150,341,415
"2011","Newham 006B","E01003548","Total",2351,249,105,144,2102,145,82,317,256,89,457,756
"2011","Newham 006C","E01003549","Total",2105,231,57,174,1874,126,78,280,300,93,365,632
"2011","Newham 006D","E01003557","Total",1958,213,28,185,1745,81,44,229,172,115,621,483
"2011","Newham 007A","E01003547","Total",1925,197,47,150,1728,92,78,306,238,154,345,515
"2011","Newham 007B","E01003555","Total",1842,114,28,86,1728,27,78,119,122,106,744,532
"2011","Newham 007C","E01003561","Total",1880,76,24,52,1804,61,48,170,62,196,573,694
"2011","Newham 007D","E01003567","Total",1822,117,32,85,1705,102,48,244,102,123,503,583
"2011","Newham 008A","E01003556","Total",1741,218,51,167,1523,122,34,194,182,124,381,486
"2011","Newham 008B","E01003558","Total",1572,134,18,116,1438,53,48,148,106,161,496,426
"2011","Newham 008C","E01003570","Total",2050,143,29,114,1907,56,66,217,90,146,723,609
"2011","Newham 008D","E01003571","Total",2270,90,27,63,2180,46,68,216,94,180,857,719
"2011","Newham 008E","E01003572","Total",1765,63,23,40,1702,85,42,210,84,104,648,529
"2011","Newham 009A","E01003551","Total",1713,138,20,118,1575,116,50,288,212,68,386,455
"2011","Newham 009B","E01003553","Total",1926,233,40,193,1693,197,54,230,222,151,317,522
"2011","Newham 009C","E01003554","Total",1861,163,41,122,1698,75,56,190,182,73,366,756
"2011","Newham 009D","E01003559","Total",2585,271,41,230,2314,147,62,389,468,119,374,755
"2011","Newham 010A","E01003529","Total",2376,71,25,46,2305,59,68,158,74,198,762,986
"2011","Newham 010B","E01003530","Total",1827,63,19,44,1764,39,66,169,64,104,668,654
"2011","Newham 010C","E01003531","Total",1991,80,33,47,1911,32,60,190,98,96,793,642
"2011","Newham 010D","E01003532","Total",2002,79,41,38,1923,43,72,153,72,101,791,691
"2011","Newham 010E","E01003534","Total",2395,106,29,77,2289,73,78,261,124,305,782,666
"2011","Newham 011A","E01003533","Total",1845,101,40,61,1744,51,50,132,50,173,679,609
"2011","Newham 011B","E01003560","Total",1818,54,19,35,1764,48,64,124,68,219,637,604
"2011","Newham 011C","E01003563","Total",2030,80,13,67,1950,44,50,232,130,219,689,586
"2011","Newham 011D","E01003588","Total",1785,74,24,50,1711,77,60,133,74,173,717,477
"2011","Newham 011E","E01003589","Total",1871,98,21,77,1773,45,44,218,102,194,648,522
"2011","Newham 012A","E01003616","Total",1650,219,42,177,1431,108,42,187,262,25,290,517
"2011","Newham 012B","E01003617","Total",2769,351,97,254,2418,119,88,291,494,161,377,888
"2011","Newham 012C","E01003618","Total",2159,222,54,168,1937,95,40,250,408,69,362,713
"2011","Newham 012D","E01003619","Total",2195,500,88,412,1695,134,36,289,478,92,207,459
"2011","Newham 013C","E01003615","Total",1835,193,65,128,1642,78,66,210,188,130,406,564
"2011","Newham 013E","E01033578","Total",1273,197,17,180,1076,123,0,190,424,28,67,244
"2011","Newham 013F","E01033579","Total",1293,210,13,197,1083,58,4,152,462,37,81,289
"2011","Newham 013G","E01033583","Total",3063,366,45,321,2697,174,104,312,532,160,472,943
"2011","Newham 013H","E01033586","Total",1410,212,24,188,1198,106,42,239,266,78,206,261
"2011","Newham 014A","E01003562","Total",2200,86,25,61,2114,29,66,168,128,184,650,889
"2011","Newham 014B","E01003564","Total",2460,120,31,89,2340,78,32,270,148,257,748,807
"2011","Newham 014C","E01003565","Total",1849,88,25,63,1761,36,38,278,102,172,523,612
"2011","Newham 014D","E01003566","Total",1792,116,36,80,1676,82,60,178,80,188,524,564
"2011","Newham 015A","E01003625","Total",1697,94,22,72,1603,100,30,236,102,133,539,463
"2011","Newham 015B","E01003626","Total",1590,57,15,42,1533,36,44,136,98,110,641,468
"2011","Newham 015C","E01003627","Total",1603,73,20,53,1530,30,52,167,76,62,634,509
"2011","Newham 015D","E01003628","Total",1665,36,15,21,1629,47,50,180,88,172,546,546
"2011","Newham 015E","E01003629","Total",1672,93,37,56,1579,41,48,273,78,187,514,438
"2011","Newham 016A","E01003552","Total",1708,129,27,102,1579,118,56,166,174,144,504,417
"2011","Newham 016B","E01003596","Total",1770,156,59,97,1614,111,52,268,136,105,459,483
"2011","Newham 016C","E01003597","Total",1639,124,30,94,1515,34,34,176,82,139,612,438
"2011","Newham 016D","E01003635","Total",1945,128,23,105,1817,76,68,201,164,105,429,774
"2011","Newham 017A","E01003568","Total",2302,92,18,74,2210,51,68,148,126,181,839,797
"2011","Newham 017B","E01003569","Total",1899,78,24,54,1821,46,80,145,102,97,626,725
"2011","Newham 017C","E01003573","Total",2142,87,33,54,2055,56,50,177,84,173,840,675
"2011","Newham 017D","E01003574","Total",2613,204,76,128,2409,100,86,236,146,197,757,887
"2011","Newham 018A","E01003520","Total",2001,133,65,68,1868,67,56,194,94,163,525,769
"2011","Newham 018B","E01003521","Total",2259,100,31,69,2159,52,42,273,136,157,576,923
"2011","Newham 018C","E01003522","Total",1908,96,34,62,1812,71,64,332,100,237,482,526
"2011","Newham 018D","E01003525","Total",1978,86,23,63,1892,33,50,160,92,186,694,677
"2011","Newham 018E","E01003526","Total",1927,135,51,84,1792,69,46,209,100,122,753,493
"2011","Newham 019A","E01003488","Total",1874,237,83,154,1637,141,70,301,106,157,486,376
"2011","Newham 019B","E01003489","Total",1806,98,32,66,1708,135,76,233,58,251,500,455
"2011","Newham 019C","E01003490","Total",1857,117,23,94,1740,99,44,257,88,220,534,498
"2011","Newham 019D","E01003524","Total",2023,142,49,93,1881,48,52,227,102,168,671,613
"2011","Newham 020A","E01003631","Total",1832,227,34,193,1605,120,58,335,300,81,299,412
"2011","Newham 020B","E01003632","Total",2268,175,49,126,2093,135,66,292,216,204,481,699
"2011","Newham 020C","E01003633","Total",1871,248,52,196,1623,171,62,250,132,182,420,406
"2011","Newham 020D","E01003634","Total",1805,152,49,103,1653,159,60,137,174,154,393,576
"2011","Newham 020E","E01003636","Total",1976,207,48,159,1769,169,82,230,214,205,421,448
"2011","Newham 021A","E01003598","Total",1897,208,37,171,1689,213,42,294,172,200,413,355
"2011","Newham 021B","E01003600","Total",1893,241,69,172,1652,150,52,318,146,205,422,359
"2011","Newham 021C","E01003630","Total",2011,238,61,177,1773,129,80,218,228,191,491,436
"2011","Newham 021D","E01003637","Total",1839,146,53,93,1693,75,58,233,162,81,494,590
"2011","Newham 022A","E01003491","Total",1977,196,104,92,1781,51,86,185,100,75,577,707
"2011","Newham 022B","E01003592","Total",1829,133,42,91,1696,95,58,276,112,106,582,467
"2011","Newham 022C","E01003599","Total",1611,125,55,70,1486,70,40,168,94,154,468,492
"2011","Newham 022D","E01003606","Total",2130,158,53,105,1972,131,74,349,164,191,526,537
"2011","Newham 023A","E01003535","Total",1654,150,45,105,1504,123,50,201,100,177,473,380
"2011","Newham 023B","E01003536","Total",1843,130,46,84,1713,192,58,321,144,175,490,333
"2011","Newham 023C","E01003621","Total",1664,56,17,39,1608,49,54,260,66,166,652,361
"2011","Newham 023D","E01003622","Total",1613,123,38,85,1490,86,60,246,88,177,459,374
"2011","Newham 023E","E01003623","Total",1757,78,38,40,1679,109,58,265,98,235,527,387
"2011","Newham 024A","E01003523","Total",2043,193,78,115,1850,73,88,282,132,190,588,497
"2011","Newham 024B","E01003527","Total",1773,129,48,81,1644,76,88,312,142,224,413,389
"2011","Newham 024C","E01003537","Total",2062,156,56,100,1906,122,74,387,148,179,509,487
"2011","Newham 024D","E01003542","Total",1974,173,75,98,1801,203,70,349,182,250,460,287
"2011","Newham 024E","E01003624","Total",1582,99,35,64,1483,120,54,198,124,171,471,345
"2011","Newham 025A","E01003492","Total",2010,97,33,64,1913,51,60,186,92,215,768,541
"2011","Newham 025B","E01003493","Total",2298,198,64,134,2100,56,58,297,182,213,630,664
"2011","Newham 025C","E01003494","Total",2048,122,37,85,1926,125,76,470,158,228,453,416
"2011","Newham 025D","E01003495","Total",2110,126,45,81,1984,106,68,355,178,253,504,520
"2011","Newham 026A","E01003594","Total",1721,112,21,91,1609,120,36,234,144,118,445,512
"2011","Newham 026B","E01003595","Total",1526,229,89,140,1297,102,56,188,120,100,354,377
"2011","Newham 026C","E01003602","Total",1985,122,48,74,1863,129,62,253,142,112,535,630
"2011","Newham 026D","E01003607","Total",1648,115,23,92,1533,146,34,283,184,100,387,399
"2011","Newham 027A","E01003496","Total",1445,224,28,196,1221,137,26,173,196,37,303,349
"2011","Newham 027B","E01003498","Total",1741,218,41,177,1523,147,66,246,202,173,289,400
"2011","Newham 027C","E01003500","Total",2043,194,49,145,1849,229,48,328,214,149,352,529
"2011","Newham 027D","E01003593","Total",1539,183,36,147,1356,117,32,244,116,109,337,401
"2011","Newham 028A","E01003601","Total",2118,178,46,132,1940,216,80,308,158,186,513,479
"2011","Newham 028B","E01003603","Total",1921,114,38,76,1807,190,48,373,160,189,411,436
"2011","Newham 028C","E01003605","Total",2112,227,72,155,1885,113,68,281,126,248,503,546
"2011","Newham 028D","E01003608","Total",2072,164,38,126,1908,148,70,364,234,171,460,461
"2011","Newham 029A","E01003538","Total",2035,171,55,116,1864,145,70,311,106,247,534,451
"2011","Newham 029B","E01003539","Total",2217,133,42,91,2084,143,88,417,122,188,650,476
"2011","Newham 029C","E01003540","Total",1833,131,48,83,1702,150,80,322,140,202,471,337
"2011","Newham 029D","E01003541","Total",1867,105,40,65,1762,138,70,287,110,250,560,347
"2011","Newham 030A","E01003499","Total",2280,308,146,162,1972,262,106,333,146,214,446,465
"2011","Newham 030B","E01003501","Total",2031,183,40,143,1848,170,80,322,178,156,401,541
"2011","Newham 030C","E01003502","Total",1836,217,59,158,1619,132,68,235,162,89,448,485
"2011","Newham 030D","E01003503","Total",1683,242,80,162,1441,151,52,234,154,138,378,334
"2011","Newham 031A","E01003507","Total",2113,294,101,193,1819,176,62,236,202,163,475,505
"2011","Newham 031B","E01003508","Total",1605,151,50,101,1454,168,74,234,126,146,371,335
"2011","Newham 031C","E01003509","Total",1953,268,84,184,1685,277,70,310,202,101,301,424
"2011","Newham 031D","E01003604","Total",2354,169,35,134,2185,218,56,504,204,273,434,496
"2011","Newham 032A","E01003483","Total",1486,122,44,78,1364,126,24,241,138,115,315,405
"2011","Newham 032B","E01003484","Total",1615,122,8,114,1493,115,24,324,232,107,369,322
"2011","Newham 032C","E01003516","Total",1859,194,43,151,1665,202,66,218,142,150,525,362
"2011","Newham 032D","E01003518","Total",1595,163,28,135,1432,73,58,316,174,95,387,329
"2011","Newham 032E","E01003519","Total",1580,109,26,83,1471,92,28,163,130,89,484,485
"2011","Newham 033A","E01003480","Total",1768,221,42,179,1547,120,38,318,196,70,398,407
"2011","Newham 033B","E01003482","Total",2629,301,22,279,2328,217,22,539,492,82,464,512
"2011","Newham 033C","E01003486","Total",1195,162,83,79,1033,127,28,143,102,56,275,302
"2011","Newham 033D","E01003487","Total",1316,125,10,115,1191,83,14,173,96,147,424,254
"2011","Newham 034A","E01003497","Total",1715,173,76,97,1542,140,84,212,162,116,401,427
"2011","Newham 034D","E01003506","Total",1464,125,39,86,1339,93,70,133,116,164,374,389
"2011","Newham 034F","E01033574","Total",1095,241,3,238,854,2,8,110,434,35,52,213
"2011","Newham 034G","E01033575","Total",1021,213,0,213,808,10,4,88,444,15,15,232
"2011","Newham 034H","E01033576","Total",1295,236,25,211,1059,73,36,129,384,60,104,273
"2011","Newham 034I","E01033584","Total",1595,149,51,98,1446,177,52,281,188,136,312,300
"2011","Newham 034J","E01033585","Total",2445,324,103,221,2121,175,88,270,322,139,527,600
"2011","Newham 035A","E01003479","Total",1505,181,23,158,1324,135,46,432,232,67,220,192
"2011","Newham 035B","E01003481","Total",1288,159,48,111,1129,127,58,208,158,72,261,245
"2011","Newham 035C","E01003485","Total",1573,139,37,102,1434,132,48,310,164,110,333,337
"2011","Newham 035D","E01003513","Total",1588,126,15,111,1462,92,36,385,208,89,397,255
"2011","Newham 036A","E01003511","Total",1394,83,26,57,1311,252,62,173,116,148,320,240
"2011","Newham 036B","E01003512","Total",1805,204,86,118,1601,209,74,261,162,125,280,490
"2011","Newham 036C","E01003514","Total",1512,141,36,105,1371,140,48,265,146,114,319,339
"2011","Newham 036D","E01003515","Total",1798,307,99,208,1491,229,64,285,214,138,283,278
"2011","Newham 036E","E01003517","Total",1674,161,36,125,1513,165,42,277,186,130,391,322
"2011","Newham 037A","E01003609","Total",2693,289,62,227,2404,317,66,469,456,209,307,580
"2011","Newham 037C","E01003611","Total",1803,247,61,186,1556,318,32,299,168,179,293,267
"2011","Newham 037E","E01033577","Total",1489,167,9,158,1322,115,34,206,352,86,191,338
"2011","Newham 037F","E01033580","Total",1522,174,3,171,1348,28,12,310,474,33,55,436
"2011","Newham 037G","E01033581","Total",1782,247,51,196,1535,193,52,302,222,94,331,341
"2011","Newham 037H","E01033582","Total",1381,215,6,209,1166,78,10,295,362,37,115,269
"2011","Southwark 001A","E01004029","Total",1835,249,20,229,1586,112,30,298,504,40,48,554
"2011","Southwark 001B","E01004032","Total",1694,173,16,157,1521,22,26,327,492,20,83,551
"2011","Southwark 001C","E01004053","Total",1830,307,35,272,1523,51,48,325,554,20,80,445
"2011","Southwark 001D","E01004054","Total",1655,242,22,220,1413,40,50,287,588,38,73,337
"2011","Southwark 001E","E01004055","Total",1291,146,61,85,1145,122,68,168,182,78,186,341
"2011","Southwark 002A","E01003927","Total",1985,384,93,291,1601,151,76,171,630,17,101,455
"2011","Southwark 002B","E01003929","Total",2111,424,72,352,1687,98,54,212,714,25,93,491
"2011","Southwark 002C","E01003934","Total",1422,420,114,306,1002,80,96,140,382,37,55,212
"2011","Southwark 002D","E01003935","Total",946,194,39,155,752,61,34,91,212,25,123,206
"2011","Southwark 002E","E01003939","Total",1848,299,31,268,1549,89,28,188,466,80,110,588
"2011","Southwark 003A","E01003976","Total",1955,327,74,253,1628,192,42,284,522,59,148,381
"2011","Southwark 003E","E01004027","Total",2072,358,31,327,1714,154,56,230,612,78,134,450
"2011","Southwark 003F","E01032637","Total",1080,278,5,273,802,15,16,98,576,5,11,81
"2011","Southwark 003G","E01032638","Total",1159,272,14,258,887,2,38,142,518,10,4,173
"2011","Southwark 003H","E01032640","Total",1248,253,7,246,995,0,24,158,560,5,12,236
"2011","Southwark 003I","E01032646","Total",1569,227,18,209,1342,26,28,168,570,56,91,403
"2011","Southwark 003J","E01032803","Total",1331,194,8,186,1137,64,10,144,580,30,18,291
"2011","Southwark 003K","E01032834","Total",1122,313,11,302,809,4,32,121,514,0,9,129
"2011","Southwark 004A","E01003975","Total",1630,216,40,176,1414,229,44,235,240,128,236,302
"2011","Southwark 004B","E01003978","Total",1840,352,49,303,1488,158,32,256,552,65,137,288
"2011","Southwark 004C","E01004022","Total",2479,405,92,313,2074,231,120,354,526,59,145,639
"2011","Southwark 004D","E01004023","Total",1540,286,98,188,1254,137,82,244,200,56,148,387
"2011","Southwark 004E","E01004028","Total",1642,268,52,216,1374,144,50,238,270,91,180,401
"2011","Southwark 006A","E01003938","Total",1814,274,35,239,1540,147,34,284,378,57,249,391
"2011","Southwark 006B","E01003940","Total",1483,228,52,176,1255,166,30,216,182,116,205,340
"2011","Southwark 006C","E01003941","Total",1897,303,54,249,1594,89,54,222,642,37,109,441
"2011","Southwark 006D","E01003942","Total",1399,176,55,121,1223,143,60,218,164,88,186,364
"2011","Southwark 006E","E01003979","Total",1664,326,39,287,1338,134,42,202,410,48,140,362
"2011","Southwark 006F","E01003981","Total",1440,283,61,222,1157,79,58,119,340,48,135,378
"2011","Southwark 007A","E01004030","Total",1457,311,60,251,1146,79,52,156,336,21,122,380
"2011","Southwark 007B","E01004031","Total",2036,280,49,231,1756,148,86,275,470,112,244,421
"2011","Southwark 007C","E01004033","Total",1513,283,89,194,1230,175,54,175,276,32,197,321
"2011","Southwark 007D","E01004034","Total",1541,198,55,143,1343,221,66,245,202,60,179,370
"2011","Southwark 007E","E01004036","Total",2014,240,61,179,1774,279,78,332,256,171,276,382
"2011","Southwark 008A","E01004056","Total",2061,286,62,224,1775,101,60,332,502,29,150,601
"2011","Southwark 008B","E01004057","Total",1488,214,35,179,1274,118,42,249,358,22,138,347
"2011","Southwark 008C","E01004058","Total",1699,298,12,286,1401,24,34,228,678,15,32,390
"2011","Southwark 008D","E01004059","Total",1487,192,13,179,1295,22,20,129,484,10,40,590
"2011","Southwark 008E","E01004060","Total",1828,247,55,192,1581,194,54,229,388,104,194,418
"2011","Southwark 009A","E01003936","Total",1198,155,16,139,1043,15,26,127,452,35,55,333
"2011","Southwark 009B","E01003937","Total",1553,251,19,232,1302,63,26,95,530,60,125,403
"2011","Southwark 009C","E01003943","Total",1367,180,50,130,1187,159,22,179,168,91,229,339
"2011","Southwark 009F","E01032720","Total",1656,219,32,187,1437,126,30,210,288,91,299,393
"2011","Southwark 010A","E01003977","Total",1672,348,72,276,1324,156,86,189,284,57,191,361
"2011","Southwark 010B","E01004037","Total",1953,309,39,270,1644,175,34,347,442,115,207,324
"2011","Southwark 010C","E01004038","Total",2340,242,19,223,2098,314,28,495,370,127,306,458
"2011","Southwark 010D","E01004042","Total",1710,289,92,197,1421,145,130,193,218,80,168,487
"2011","Southwark 010E","E01004043","Total",1355,212,58,154,1143,74,112,140,220,65,154,378
"2011","Southwark 011A","E01003986","Total",1230,222,85,137,1008,184,82,174,118,82,142,226
"2011","Southwark 011B","E01003987","Total",1777,262,104,158,1515,171,112,314,230,79,226,383
"2011","Southwark 011C","E01004024","Total",1825,358,83,275,1467,195,62,245,210,92,204,459
"2011","Southwark 011D","E01004035","Total",1593,243,90,153,1350,215,100,281,158,84,127,385
"2011","Southwark 012A","E01003960","Total",1863,230,50,180,1633,161,82,247,342,72,166,563
"2011","Southwark 012B","E01003961","Total",2045,370,127,243,1675,183,108,299,244,135,221,485
"2011","Southwark 012E","E01003994","Total",1468,220,58,162,1248,77,58,170,244,57,212,430
"2011","Southwark 012F","E01032722","Total",2131,319,90,229,1812,159,110,264,364,59,226,630
"2011","Southwark 013A","E01003980","Total",1899,381,97,284,1518,125,56,154,258,40,229,656
"2011","Southwark 013B","E01004039","Total",1568,192,22,170,1376,111,30,223,330,72,260,350
"2011","Southwark 013C","E01004040","Total",1780,230,71,159,1550,192,44,289,150,156,346,373
"2011","Southwark 013D","E01004041","Total",1660,252,49,203,1408,143,58,288,236,126,257,300
"2011","Southwark 013E","E01004044","Total",1394,185,47,138,1209,165,52,190,178,101,238,285
"2011","Southwark 014A","E01003992","Total",1492,176,65,111,1316,189,54,259,170,98,215,331
"2011","Southwark 014B","E01003995","Total",1384,368,76,292,1016,165,46,172,274,72,60,227
"2011","Southwark 014D","E01003998","Total",1331,250,63,187,1081,47,60,149,338,32,141,314
"2011","Southwark 014E","E01003999","Total",1442,186,40,146,1256,137,44,190,266,114,140,365
"2011","Southwark 014F","E01032639","Total",1509,194,28,166,1315,101,38,163,474,21,109,409
"2011","Southwark 014G","E01032719","Total",1211,291,62,229,920,72,40,204,272,42,87,203
"2011","Southwark 015A","E01003964","Total",1909,218,33,185,1691,123,50,275,234,109,346,554
"2011","Southwark 015B","E01003966","Total",1941,201,60,141,1740,181,96,298,232,71,279,583
"2011","Southwark 015C","E01003968","Total",1441,172,34,138,1269,129,40,204,114,149,322,311
"2011","Southwark 015D","E01003971","Total",1809,130,26,104,1679,258,66,353,134,166,409,293
"2011","Southwark 015E","E01003974","Total",1268,172,44,128,1096,126,50,183,106,90,268,273
"2011","Southwark 016A","E01003963","Total",1648,217,34,183,1431,206,54,268,188,108,247,360
"2011","Southwark 016B","E01003967","Total",1658,140,38,102,1518,173,64,280,166,106,275,454
"2011","Southwark 016C","E01003970","Total",1486,202,52,150,1284,144,70,216,132,118,292,312
"2011","Southwark 016D","E01003972","Total",1654,257,37,220,1397,177,46,247,278,132,189,328
"2011","Southwark 016E","E01003973","Total",1650,273,77,196,1377,210,46,272,262,92,155,340
"2011","Southwark 017A","E01003923","Total",1735,240,46,194,1495,108,46,304,318,85,177,457
"2011","Southwark 017B","E01003969","Total",1851,234,39,195,1617,146,50,223,360,42,286,510
"2011","Southwark 017C","E01003991","Total",1208,238,113,125,970,112,88,122,142,53,122,331
"2011","Southwark 017D","E01003993","Total",1713,178,54,124,1535,190,34,277,164,176,266,428
"2011","Southwark 017E","E01003997","Total",1219,138,30,108,1081,58,42,194,182,84,167,354
"2011","Southwark 018A","E01003983","Total",2021,194,46,148,1827,239,94,288,202,218,365,421
"2011","Southwark 018B","E01003988","Total",2187,342,108,234,1845,203,100,304,242,189,325,482
"2011","Southwark 018C","E01003989","Total",1960,214,27,187,1746,315,28,292,148,186,417,360
"2011","Southwark 018D","E01003990","Total",2130,208,68,140,1922,225,64,358,214,174,436,451
"2011","Southwark 018E","E01004007","Total",1261,112,34,78,1149,140,38,156,106,104,325,280
"2011","Southwark 019A","E01003912","Total",1571,148,36,112,1423,220,38,296,134,134,317,284
"2011","Southwark 019B","E01004011","Total",2112,156,27,129,1956,271,50,423,194,150,494,374
"2011","Southwark 019C","E01004012","Total",2502,257,31,226,2245,284,54,389,356,216,447,499
"2011","Southwark 019D","E01004013","Total",1656,148,29,119,1508,188,50,285,174,105,347,359
"2011","Southwark 019E","E01004014","Total",1739,240,62,178,1499,212,46,328,210,77,310,316
"2011","Southwark 020A","E01003911","Total",1985,188,30,158,1797,198,36,356,314,177,357,359
"2011","Southwark 020B","E01003916","Total",2080,253,33,220,1827,156,52,301,314,87,314,603
"2011","Southwark 020C","E01003917","Total",1761,336,99,237,1425,83,68,320,256,65,229,404
"2011","Southwark 020D","E01003918","Total",1602,244,79,165,1358,169,62,240,174,125,239,349
"2011","Southwark 020E","E01003925","Total",1286,178,43,135,1108,103,58,238,192,110,198,209
"2011","Southwark 021A","E01003919","Total",1692,235,49,186,1457,136,40,225,294,123,206,433
"2011","Southwark 021B","E01003920","Total",1854,283,45,238,1571,233,52,359,216,169,225,317
"2011","Southwark 021C","E01003921","Total",1371,318,41,277,1053,116,38,231,222,57,132,257
"2011","Southwark 021D","E01003922","Total",1914,289,60,229,1625,239,54,267,308,106,286,365
"2011","Southwark 021E","E01003924","Total",1916,274,55,219,1642,208,80,376,234,142,188,414
"2011","Southwark 021F","E01003926","Total",1423,161,51,110,1262,136,62,189,148,103,235,389
"2011","Southwark 022B","E01004008","Total",2134,240,48,192,1894,262,78,313,222,133,354,532
"2011","Southwark 022D","E01004010","Total",1526,179,35,144,1347,152,36,269,192,100,278,320
"2011","Southwark 022E","E01004067","Total",2147,263,63,200,1884,170,56,347,276,124,415,496
"2011","Southwark 022F","E01032805","Total",2538,288,58,230,2250,236,82,328,262,212,542,588
"2011","Southwark 023A","E01003984","Total",1993,329,99,230,1664,115,72,267,302,92,279,537
"2011","Southwark 023B","E01004003","Total",1700,302,62,240,1398,162,76,303,212,55,223,367
"2011","Southwark 023C","E01004004","Total",2492,387,89,298,2105,239,86,304,460,110,289,617
"2011","Southwark 023D","E01004005","Total",2079,330,67,263,1749,302,48,342,288,126,298,345
"2011","Southwark 023E","E01004006","Total",1968,235,59,176,1733,176,82,307,294,45,214,615
"2011","Southwark 024A","E01003913","Total",1817,285,55,230,1532,84,88,344,342,68,159,447
"2011","Southwark 024B","E01003914","Total",1831,211,51,160,1620,83,74,274,316,115,223,535
"2011","Southwark 024C","E01003915","Total",1940,288,50,238,1652,147,86,288,278,96,305,452
"2011","Southwark 024D","E01004050","Total",1472,219,31,188,1253,62,66,234,382,49,152,308
"2011","Southwark 024E","E01004052","Total",1759,281,75,206,1478,70,76,286,440,106,141,359
"2011","Southwark 025A","E01004061","Total",1748,284,47,237,1464,62,64,327,346,62,158,445
"2011","Southwark 025B","E01004062","Total",1932,289,79,210,1643,175,58,390,324,112,267,317
"2011","Southwark 025C","E01004063","Total",1927,294,103,191,1633,103,72,344,370,76,142,526
"2011","Southwark 025D","E01004065","Total",1515,168,30,138,1347,62,70,342,316,67,190,300
"2011","Southwark 025E","E01004066","Total",2159,249,31,218,1910,224,70,451,282,114,243,526
"2011","Southwark 026A","E01004000","Total",1874,320,72,248,1554,132,72,358,326,95,168,403
"2011","Southwark 026B","E01004001","Total",1738,277,98,179,1461,193,78,251,196,153,262,328
"2011","Southwark 026C","E01004019","Total",2292,265,32,233,2027,205,64,432,374,130,394,428
"2011","Southwark 026D","E01004064","Total",1973,269,85,184,1704,202,82,402,256,100,304,358
"2011","Southwark 026E","E01004068","Total",1974,328,130,198,1646,181,86,290,230,135,363,361
"2011","Southwark 027A","E01004045","Total",1518,175,27,148,1343,220,30,321,180,117,241,234
"2011","Southwark 027B","E01004047","Total",1595,172,49,123,1423,181,56,312,196,125,254,299
"2011","Southwark 027C","E01004048","Total",1587,178,47,131,1409,102,44,374,318,53,204,314
"2011","Southwark 027D","E01004049","Total",1332,119,29,90,1213,205,44,290,168,59,193,254
"2011","Southwark 027E","E01004051","Total",1302,212,52,160,1090,51,78,241,334,63,64,259
"2011","Southwark 028A","E01003953","Total",2073,377,54,323,1696,87,66,350,526,88,107,472
"2011","Southwark 028B","E01003955","Total",1813,298,83,215,1515,57,86,356,398,56,155,407
"2011","Southwark 028C","E01004015","Total",1548,250,73,177,1298,85,54,355,322,92,144,246
"2011","Southwark 028D","E01004021","Total",2102,382,62,320,1720,81,80,392,654,42,152,319
"2011","Southwark 028E","E01004046","Total",1625,191,44,147,1434,71,70,374,364,63,197,295
"2011","Southwark 029A","E01004002","Total",1602,174,49,125,1428,69,64,401,284,65,146,399
"2011","Southwark 029B","E01004016","Total",2347,244,69,175,2103,183,106,598,394,146,270,406
"2011","Southwark 029C","E01004017","Total",1515,161,49,112,1354,103,112,332,286,71,150,300
"2011","Southwark 029D","E01004020","Total",1730,241,61,180,1489,256,62,352,240,108,209,262
"2011","Southwark 030A","E01003952","Total",1640,184,40,144,1456,61,74,403,394,71,93,360
"2011","Southwark 030B","E01003954","Total",1596,191,47,144,1405,46,84,390,378,102,157,248
"2011","Southwark 030C","E01003956","Total",1685,198,44,154,1487,69,70,470,404,76,114,284
"2011","Southwark 030D","E01004071","Total",1572,202,69,133,1370,73,82,401,290,89,137,298
"2011","Southwark 030E","E01004072","Total",1726,119,41,78,1607,31,78,503,264,136,249,346
"2011","Southwark 031A","E01004069","Total",1387,89,46,43,1298,31,132,379,166,101,237,252
"2011","Southwark 031B","E01004070","Total",1985,209,76,133,1776,88,136,479,312,153,210,398
"2011","Southwark 031C","E01004073","Total",1931,166,53,113,1765,77,106,569,332,128,243,310
"2011","Southwark 031D","E01004074","Total",1868,117,65,52,1751,37,124,423,210,232,335,390
"2011","Southwark 031E","E01004075","Total",1849,135,69,66,1714,42,146,543,202,233,265,283
"2011","Southwark 032A","E01003949","Total",1860,310,59,251,1550,109,82,380,468,83,191,237
"2011","Southwark 032B","E01003950","Total",1896,260,69,191,1636,253,114,247,292,84,305,341
"2011","Southwark 032C","E01003957","Total",1760,186,44,142,1574,90,84,417,360,110,153,360
"2011","Southwark 032D","E01003958","Total",1710,208,58,150,1502,58,90,431,300,122,176,325
"2011","Southwark 032E","E01004018","Total",1894,188,62,126,1706,70,100,577,414,96,110,339
"2011","Southwark 033A","E01003945","Total",1663,216,82,134,1447,89,148,376,348,75,125,286
"2011","Southwark 033B","E01003946","Total",1757,212,93,119,1545,120,184,370,278,118,218,257
"2011","Southwark 033C","E01003947","Total",1517,178,63,115,1339,255,80,266,174,102,258,204
"2011","Southwark 033D","E01003948","Total",1529,284,69,215,1245,104,62,392,404,31,90,162
"2011","Southwark 033E","E01003951","Total",1403,160,66,94,1243,104,132,286,196,76,152,297
"2011","Southwark 034A","E01003930","Total",963,185,45,140,778,40,40,133,230,68,61,206
"2011","Southwark 034B","E01003932","Total",1434,270,49,221,1164,109,50,159,248,51,168,379
"2011","Southwark 034C","E01003933","Total",1376,164,41,123,1212,37,56,161,262,31,255,410
"2011","Southwark 034D","E01032583","Total",1343,265,51,214,1078,64,56,174,302,37,138,307
"2011","Southwark 034E","E01032584","Total",1275,209,47,162,1066,112,48,137,278,48,112,331
"2011","Tower Hamlets 001A","E01004222","Total",2479,402,143,259,2077,193,106,303,408,236,431,400
"2011","Tower Hamlets 001B","E01004223","Total",2079,355,125,230,1724,244,106,263,346,113,239,413
"2011","Tower Hamlets 001C","E01004224","Total",2000,250,67,183,1750,120,86,196,412,174,281,481
"2011","Tower Hamlets 001D","E01004226","Total",1738,203,44,159,1535,174,54,228,278,186,239,376
"2011","Tower Hamlets 002A","E01004197","Total",2285,338,31,307,1947,122,62,302,490,197,321,453
"2011","Tower Hamlets 002B","E01004198","Total",1522,243,84,159,1279,66,58,147,206,135,324,343
"2011","Tower Hamlets 002C","E01004199","Total",1637,187,47,140,1450,163,46,175,138,246,399,283
"2011","Tower Hamlets 002D","E01004201","Total",1533,216,51,165,1317,93,42,199,246,141,242,354
"2011","Tower Hamlets 003A","E01004228","Total",1849,246,56,190,1603,91,74,304,358,89,147,540
"2011","Tower Hamlets 003B","E01004230","Total",2091,230,78,152,1861,146,82,262,314,215,226,616
"2011","Tower Hamlets 003C","E01004232","Total",1631,159,26,133,1472,47,60,179,290,98,170,628
"2011","Tower Hamlets 003D","E01004233","Total",1821,306,102,204,1515,131,88,181,250,260,303,302
"2011","Tower Hamlets 003E","E01004234","Total",2218,251,47,204,1967,143,92,373,484,107,151,617
"2011","Tower Hamlets 004A","E01004225","Total",2178,436,23,413,1742,108,50,236,918,50,63,317
"2011","Tower Hamlets 004C","E01004229","Total",1484,163,41,122,1321,97,46,173,228,133,274,370
"2011","Tower Hamlets 004D","E01004231","Total",1793,172,56,116,1621,195,64,226,180,254,305,397
"2011","Tower Hamlets 004E","E01032764","Total",1302,243,36,207,1059,92,30,139,436,20,107,235
"2011","Tower Hamlets 004F","E01032765","Total",1488,215,27,188,1273,138,36,121,376,66,232,304
"2011","Tower Hamlets 004G","E01032784","Total",1516,214,44,170,1302,124,28,123,550,48,187,242
"2011","Tower Hamlets 005A","E01004200","Total",1394,177,13,164,1217,23,26,89,394,102,157,426
"2011","Tower Hamlets 005B","E01004202","Total",1705,230,17,213,1475,76,38,157,460,117,286,341
"2011","Tower Hamlets 005C","E01004203","Total",1779,194,39,155,1585,75,50,149,364,195,231,521
"2011","Tower Hamlets 005D","E01004204","Total",1538,249,85,164,1289,61,74,150,198,154,280,372
"2011","Tower Hamlets 006A","E01004311","Total",1518,244,63,181,1274,78,72,203,246,145,206,324
"2011","Tower Hamlets 006B","E01004314","Total",1100,165,61,104,935,46,50,160,294,64,70,251
"2011","Tower Hamlets 006C","E01004315","Total",1628,281,64,217,1347,37,60,111,356,67,246,470
"2011","Tower Hamlets 006D","E01004318","Total",1433,254,34,220,1179,152,38,184,218,154,146,287
"2011","Tower Hamlets 007A","E01004259","Total",1694,334,48,286,1360,119,26,142,446,105,146,376
"2011","Tower Hamlets 007B","E01004260","Total",1790,168,52,116,1622,110,64,258,232,225,303,430
"2011","Tower Hamlets 007C","E01004263","Total",1401,165,64,101,1236,111,54,147,194,136,289,305
"2011","Tower Hamlets 007D","E01004266","Total",1545,176,54,122,1369,83,58,191,202,106,258,471
"2011","Tower Hamlets 008A","E01004235","Total",1372,172,38,134,1200,128,34,225,152,207,281,173
"2011","Tower Hamlets 008B","E01004236","Total",1679,116,35,81,1563,104,36,183,126,212,577,325
"2011","Tower Hamlets 008C","E01004237","Total",1158,200,38,162,958,112,34,180,216,82,148,186
"2011","Tower Hamlets 008D","E01004238","Total",2733,345,26,319,2388,230,46,418,510,210,603,371
"2011","Tower Hamlets 008E","E01004239","Total",1649,139,35,104,1510,109,78,174,140,205,437,367
"2011","Tower Hamlets 009A","E01004312","Total",1614,236,75,161,1378,81,80,148,210,160,318,381
"2011","Tower Hamlets 009B","E01004313","Total",2043,247,55,192,1796,175,62,190,378,258,279,454
"2011","Tower Hamlets 009C","E01004316","Total",1134,159,10,149,975,92,24,117,166,68,174,334
"2011","Tower Hamlets 009D","E01004317","Total",2689,407,18,389,2282,94,38,193,844,100,386,627
"2011","Tower Hamlets 010A","E01004261","Total",1655,175,35,140,1480,63,52,148,118,167,350,582
"2011","Tower Hamlets 010B","E01004262","Total",1366,170,46,124,1196,53,54,140,132,69,276,472
"2011","Tower Hamlets 010C","E01004264","Total",1537,96,42,54,1441,81,46,192,110,211,395,406
"2011","Tower Hamlets 010E","E01032785","Total",1348,181,17,164,1167,82,14,202,496,83,102,188
"2011","Tower Hamlets 010F","E01032786","Total",1561,269,60,209,1292,112,56,214,256,240,164,250
"2011","Tower Hamlets 011A","E01004207","Total",1342,189,49,140,1153,80,36,141,186,70,301,339
"2011","Tower Hamlets 011B","E01004209","Total",1366,154,24,130,1212,91,26,155,88,220,335,297
"2011","Tower Hamlets 011D","E01004212","Total",1604,318,41,277,1286,82,36,173,312,152,221,310
"2011","Tower Hamlets 011F","E01032787","Total",2567,208,48,160,2359,79,42,328,192,299,781,638
"2011","Tower Hamlets 012A","E01004240","Total",1815,136,29,107,1679,153,72,209,134,261,507,343
"2011","Tower Hamlets 012B","E01004241","Total",1621,185,45,140,1436,105,60,240,146,224,399,262
"2011","Tower Hamlets 012C","E01004242","Total",2433,264,18,246,2169,194,32,396,434,239,525,349
"2011","Tower Hamlets 012D","E01004267","Total",1754,246,21,225,1508,91,26,190,388,118,292,403
"2011","Tower Hamlets 012E","E01004268","Total",1756,248,52,196,1508,116,42,251,276,223,352,248
"2011","Tower Hamlets 013A","E01004205","Total",2106,201,30,171,1905,136,40,277,182,208,579,483
"2011","Tower Hamlets 013B","E01004206","Total",1491,222,47,175,1269,99,52,156,114,87,383,378
"2011","Tower Hamlets 013C","E01004208","Total",1842,280,23,257,1562,21,18,150,506,71,334,462
"2011","Tower Hamlets 013D","E01004211","Total",1461,315,34,281,1146,26,10,108,452,15,193,342
"2011","Tower Hamlets 014A","E01004269","Total",1920,249,80,169,1671,93,62,235,228,224,298,531
"2011","Tower Hamlets 014B","E01004270","Total",2236,155,26,129,2081,73,32,226,352,153,341,904
"2011","Tower Hamlets 014C","E01004271","Total",1589,158,35,123,1431,109,46,322,140,305,257,252
"2011","Tower Hamlets 014D","E01004272","Total",2099,166,33,133,1933,140,46,240,140,376,654,337
"2011","Tower Hamlets 014E","E01004273","Total",1904,150,30,120,1754,117,38,240,156,297,548,358
"2011","Tower Hamlets 015A","E01004306","Total",1799,205,34,171,1594,26,42,154,408,78,399,487
"2011","Tower Hamlets 015B","E01004307","Total",1857,471,19,452,1386,30,36,162,676,43,105,334
"2011","Tower Hamlets 015C","E01004308","Total",1469,148,31,117,1321,37,42,128,172,138,326,478
"2011","Tower Hamlets 015D","E01004309","Total",2433,323,48,275,2110,80,52,213,374,189,608,594
"2011","Tower Hamlets 015E","E01004310","Total",1893,320,60,260,1573,27,44,125,410,95,437,435
"2011","Tower Hamlets 016A","E01004283","Total",2143,258,61,197,1885,83,56,212,244,207,677,406
"2011","Tower Hamlets 016B","E01004287","Total",2171,306,107,199,1865,131,108,337,286,242,377,384
"2011","Tower Hamlets 016C","E01004289","Total",1844,236,74,162,1608,61,76,176,188,187,376,544
"2011","Tower Hamlets 016D","E01004290","Total",1259,230,67,163,1029,44,54,100,270,104,87,370
"2011","Tower Hamlets 017A","E01004322","Total",1160,207,56,151,953,57,50,165,180,119,177,205
"2011","Tower Hamlets 017B","E01004323","Total",1466,142,36,106,1324,35,24,167,176,72,398,452
"2011","Tower Hamlets 017C","E01004324","Total",1570,133,30,103,1437,62,50,159,106,187,471,402
"2011","Tower Hamlets 017D","E01004326","Total",1438,240,51,189,1198,80,46,191,292,107,202,280
"2011","Tower Hamlets 018A","E01004245","Total",1539,92,13,79,1447,130,16,229,78,214,591,189
"2011","Tower Hamlets 018B","E01004246","Total",1977,236,49,187,1741,144,72,237,302,130,424,432
"2011","Tower Hamlets 018C","E01004248","Total",1344,134,58,76,1210,143,24,155,90,279,306,213
"2011","Tower Hamlets 018D","E01004249","Total",2049,261,52,209,1788,208,50,253,230,288,406,353
"2011","Tower Hamlets 019A","E01004284","Total",2302,316,68,248,1986,86,40,416,400,166,575,303
"2011","Tower Hamlets 019B","E01004285","Total",2318,162,43,119,2156,106,44,257,132,403,797,417
"2011","Tower Hamlets 019C","E01004286","Total",2353,259,61,198,2094,171,82,244,292,292,673,340
"2011","Tower Hamlets 019D","E01004288","Total",1590,149,48,101,1441,116,46,222,138,249,409,261
"2011","Tower Hamlets 020A","E01004243","Total",1789,168,36,132,1621,168,68,193,170,292,367,363
"2011","Tower Hamlets 020B","E01004244","Total",1788,257,74,183,1531,138,80,248,188,194,428,255
"2011","Tower Hamlets 020C","E01004247","Total",1934,230,62,168,1704,153,62,295,220,183,407,384
"2011","Tower Hamlets 020D","E01004250","Total",2342,269,72,197,2073,204,72,364,278,347,454,354
"2011","Tower Hamlets 021A","E01004319","Total",1886,160,30,130,1726,69,42,161,176,166,602,510
"2011","Tower Hamlets 021C","E01004321","Total",1769,315,49,266,1454,63,40,186,234,104,432,395
"2011","Tower Hamlets 021D","E01004325","Total",2475,284,17,267,2191,79,32,178,756,103,313,730
"2011","Tower Hamlets 021E","E01032766","Total",1307,222,7,215,1085,54,8,107,440,74,148,254
"2011","Tower Hamlets 021F","E01032767","Total",1584,292,4,288,1292,15,6,82,552,15,70,552
"2011","Tower Hamlets 022A","E01004298","Total",1629,239,57,182,1390,119,50,176,238,89,395,323
"2011","Tower Hamlets 022B","E01004300","Total",1349,205,54,151,1144,76,56,120,174,150,346,222
"2011","Tower Hamlets 022C","E01004304","Total",1955,196,53,143,1759,105,52,207,224,215,573,383
"2011","Tower Hamlets 022D","E01004305","Total",1940,218,70,148,1722,164,78,154,238,226,479,383
"2011","Tower Hamlets 023A","E01004251","Total",2082,262,86,176,1820,136,76,287,230,244,419,428
"2011","Tower Hamlets 023B","E01004254","Total",2120,357,13,344,1763,54,26,277,902,51,163,290
"2011","Tower Hamlets 023C","E01004255","Total",1618,250,19,231,1368,83,28,225,240,179,322,291
"2011","Tower Hamlets 023D","E01004258","Total",1506,273,44,229,1233,40,64,257,414,60,168,230
"2011","Tower Hamlets 024A","E01004252","Total",2707,389,48,341,2318,208,62,399,520,309,392,428
"2011","Tower Hamlets 024B","E01004253","Total",2266,244,77,167,2022,258,90,355,218,200,481,420
"2011","Tower Hamlets 024C","E01004256","Total",1729,170,49,121,1559,142,64,241,152,181,378,401
"2011","Tower Hamlets 024D","E01004257","Total",1883,145,35,110,1738,202,52,268,152,296,395,373
"2011","Tower Hamlets 025B","E01004301","Total",1324,114,27,87,1210,50,24,146,124,138,417,311
"2011","Tower Hamlets 025C","E01004302","Total",1987,174,29,145,1813,110,18,320,216,247,601,301
"2011","Tower Hamlets 025D","E01004303","Total",2362,358,65,293,2004,170,74,356,384,253,319,448
"2011","Tower Hamlets 025E","E01032768","Total",1307,276,7,269,1031,33,16,193,566,29,48,146
"2011","Tower Hamlets 025F","E01032769","Total",1230,218,11,207,1012,52,26,172,420,89,78,175
"2011","Tower Hamlets 026A","E01004292","Total",1738,309,24,285,1429,28,48,233,484,34,132,470
"2011","Tower Hamlets 026B","E01004294","Total",1690,401,42,359,1289,35,42,185,534,68,163,262
"2011","Tower Hamlets 026C","E01004295","Total",1516,134,31,103,1382,83,46,294,146,233,334,246
"2011","Tower Hamlets 026D","E01004296","Total",1605,268,52,216,1337,71,36,202,308,138,268,314
"2011","Tower Hamlets 027A","E01004291","Total",1844,533,55,478,1311,59,68,179,640,70,67,228
"2011","Tower Hamlets 027B","E01004293","Total",2125,522,82,440,1603,19,62,289,714,27,167,325
"2011","Tower Hamlets 027C","E01004297","Total",1826,364,45,319,1462,39,66,299,578,40,97,343
"2011","Tower Hamlets 028A","E01004215","Total",2756,408,62,346,2348,245,80,284,572,212,394,561
"2011","Tower Hamlets 028B","E01004219","Total",2294,258,24,234,2036,159,28,282,414,256,478,419
"2011","Tower Hamlets 028D","E01004221","Total",1881,250,22,228,1631,97,42,265,538,100,238,351
"2011","Tower Hamlets 028E","E01032776","Total",1076,317,2,315,759,34,12,134,426,21,44,88
"2011","Tower Hamlets 028F","E01032777","Total",1141,178,7,171,963,72,4,151,344,64,169,159
"2011","Tower Hamlets 028G","E01032778","Total",1108,205,5,200,903,82,4,188,414,10,27,178
"2011","Tower Hamlets 028H","E01032779","Total",1089,220,2,218,869,130,8,176,408,57,10,80
"2011","Tower Hamlets 028I","E01032780","Total",1333,194,2,192,1139,10,26,237,554,15,25,272
"2011","Tower Hamlets 030A","E01004214","Total",1669,252,56,196,1417,193,48,303,174,144,303,252
"2011","Tower Hamlets 030B","E01004216","Total",1619,235,52,183,1384,79,46,307,464,75,116,297
"2011","Tower Hamlets 030C","E01004217","Total",1745,303,77,226,1442,111,76,304,302,108,161,380
"2011","Tower Hamlets 030D","E01004218","Total",1750,215,40,175,1535,91,62,325,412,70,170,405
"2011","Tower Hamlets 031A","E01004274","Total",1973,159,16,143,1814,123,34,288,262,165,522,420
"2011","Tower Hamlets 031B","E01004275","Total",1879,218,33,185,1661,106,64,345,432,107,252,355
"2011","Tower Hamlets 031C","E01004276","Total",2024,342,12,330,1682,29,26,338,792,12,48,437
"2011","Tower Hamlets 031D","E01004281","Total",1770,307,9,298,1463,52,14,352,530,37,114,364
"2011","Tower Hamlets 031F","E01032775","Total",1108,245,6,239,863,36,20,195,462,21,32,97
"2011","Tower Hamlets 031G","E01032783","Total",1383,275,42,233,1108,63,30,179,370,27,107,332
"2011","Tower Hamlets 032A","E01004280","Total",1879,252,36,216,1627,109,56,365,398,135,297,267
"2011","Tower Hamlets 032B","E01032770","Total",1191,212,43,169,979,54,32,157,388,56,86,206
"2011","Tower Hamlets 032C","E01032772","Total",1135,281,26,255,854,22,26,81,238,57,237,193
"2011","Tower Hamlets 032D","E01032773","Total",1561,407,3,404,1154,156,4,187,544,114,84,65
"2011","Tower Hamlets 032E","E01032774","Total",1297,211,13,198,1086,161,16,201,320,59,177,152
"2011","Tower Hamlets 033A","E01004277","Total",1630,363,14,349,1267,14,34,341,718,5,28,127
"2011","Tower Hamlets 033B","E01032771","Total",1104,239,5,234,865,49,12,91,368,120,134,91
"2011","Tower Hamlets 033C","E01032781","Total",1535,271,11,260,1264,29,22,209,654,43,103,204
"2011","Tower Hamlets 033D","E01032782","Total",1614,364,9,355,1250,130,6,137,448,163,238,128
"2011","Wandsworth 001A","E01004560","Total",1954,365,58,307,1589,78,86,300,566,65,86,408
"2011","Wandsworth 001B","E01004566","Total",1567,376,105,271,1191,35,82,300,412,32,54,276
"2011","Wandsworth 001C","E01004582","Total",2147,331,77,254,1816,101,144,357,492,84,182,456
"2011","Wandsworth 001D","E01004583","Total",1669,376,118,258,1293,84,146,233,432,41,51,306
"2011","Wandsworth 002B","E01004562","Total",1764,284,100,184,1480,127,112,190,236,44,274,497
"2011","Wandsworth 002C","E01004563","Total",1961,343,48,295,1618,204,68,244,332,114,208,448
"2011","Wandsworth 002D","E01004564","Total",1768,260,57,203,1508,54,82,194,518,18,139,503
"2011","Wandsworth 002E","E01004567","Total",2343,319,38,281,2024,363,78,259,398,152,358,416
"2011","Wandsworth 002F","E01033098","Total",1009,352,16,336,657,23,22,146,386,0,4,76
"2011","Wandsworth 002G","E01033100","Total",1243,265,90,175,978,76,38,101,284,71,26,382
"2011","Wandsworth 002H","E01033132","Total",1040,344,20,324,696,92,14,129,284,10,46,121
"2011","Wandsworth 003A","E01004539","Total",2098,246,49,197,1852,329,74,311,182,148,370,438
"2011","Wandsworth 003B","E01004540","Total",2083,416,97,319,1667,155,78,286,478,118,183,369
"2011","Wandsworth 003C","E01004577","Total",1928,343,116,227,1585,72,100,294,484,86,148,401
"2011","Wandsworth 003D","E01004584","Total",1702,227,45,182,1475,314,84,243,184,122,172,356
"2011","Wandsworth 004B","E01004579","Total",1615,275,67,208,1340,76,96,293,320,97,134,324
"2011","Wandsworth 004C","E01004580","Total",2032,287,44,243,1745,109,86,252,480,79,188,551
"2011","Wandsworth 004D","E01004581","Total",1817,355,83,272,1462,48,114,201,458,55,156,430
"2011","Wandsworth 004E","E01033099","Total",1028,163,28,135,865,75,32,102,218,39,82,317
"2011","Wandsworth 004F","E01033101","Total",1191,275,26,249,916,6,44,127,542,7,28,162
"2011","Wandsworth 004G","E01033133","Total",1193,251,20,231,942,61,28,157,486,31,43,136
"2011","Wandsworth 005A","E01004565","Total",1679,258,59,199,1421,107,54,222,586,32,83,337
"2011","Wandsworth 005B","E01004590","Total",1749,298,89,209,1451,142,128,257,322,69,130,403
"2011","Wandsworth 005C","E01004591","Total",1734,283,49,234,1451,64,52,181,522,41,123,468
"2011","Wandsworth 005D","E01004592","Total",1628,299,91,208,1329,106,112,271,416,31,111,282
"2011","Wandsworth 006A","E01004604","Total",1686,97,32,65,1589,18,112,491,268,237,156,307
"2011","Wandsworth 006B","E01004605","Total",1726,268,103,165,1458,62,110,392,382,108,92,312
"2011","Wandsworth 006C","E01004606","Total",1625,224,50,174,1401,28,68,344,550,55,22,334
"2011","Wandsworth 006D","E01004607","Total",1729,203,51,152,1526,13,114,436,372,139,137,315
"2011","Wandsworth 006E","E01004608","Total",1682,269,91,178,1413,53,86,284,472,26,99,393
"2011","Wandsworth 007A","E01004535","Total",1758,243,41,202,1515,351,62,302,190,131,189,290
"2011","Wandsworth 007B","E01004537","Total",1881,276,82,194,1605,222,70,211,294,87,228,493
"2011","Wandsworth 007C","E01004538","Total",2001,352,97,255,1649,228,72,242,380,97,201,429
"2011","Wandsworth 007D","E01004541","Total",1637,321,121,200,1316,155,94,161,254,72,182,398
"2011","Wandsworth 008A","E01004534","Total",1850,251,52,199,1599,51,88,313,448,37,85,577
"2011","Wandsworth 008B","E01004536","Total",2029,324,49,275,1705,178,52,248,468,88,137,534
"2011","Wandsworth 008C","E01004552","Total",1982,252,28,224,1730,19,24,239,766,30,83,569
"2011","Wandsworth 008D","E01004585","Total",1835,261,52,209,1574,46,96,294,556,25,78,479
"2011","Wandsworth 008E","E01004588","Total",1953,243,37,206,1710,45,40,363,610,86,57,509
"2011","Wandsworth 009A","E01004554","Total",1607,171,37,134,1436,32,60,436,372,111,94,331
"2011","Wandsworth 009B","E01004556","Total",1612,123,26,97,1489,17,72,637,260,151,147,205
"2011","Wandsworth 009C","E01004586","Total",1812,289,35,254,1523,26,46,251,556,40,78,526
"2011","Wandsworth 009D","E01004587","Total",1743,223,46,177,1520,26,66,382,374,92,64,516
"2011","Wandsworth 009E","E01004589","Total",1700,164,30,134,1536,17,62,306,512,122,98,419
"2011","Wandsworth 010A","E01004509","Total",2190,403,63,340,1787,68,52,223,916,41,32,455
"2011","Wandsworth 010B","E01004511","Total",1722,171,31,140,1551,31,58,352,472,62,74,502
"2011","Wandsworth 010C","E01004602","Total",1640,212,49,163,1428,12,56,286,470,83,120,401
"2011","Wandsworth 010E","E01004609","Total",2147,335,73,262,1812,20,78,326,660,65,98,565
"2011","Wandsworth 010F","E01033093","Total",1526,282,35,247,1244,25,72,310,536,37,65,199
"2011","Wandsworth 010G","E01033135","Total",1071,131,29,102,940,11,48,247,328,59,47,200
"2011","Wandsworth 011A","E01004506","Total",1922,355,99,256,1567,24,100,278,658,76,82,349
"2011","Wandsworth 011B","E01004638","Total",1438,102,45,57,1336,11,122,331,178,205,123,366
"2011","Wandsworth 011C","E01004639","Total",1715,274,89,185,1441,38,90,324,398,83,111,397
"2011","Wandsworth 011D","E01004640","Total",1775,257,72,185,1518,28,90,360,476,89,163,312
"2011","Wandsworth 011E","E01004641","Total",1910,279,137,142,1631,71,162,322,282,101,178,515
"2011","Wandsworth 012A","E01004508","Total",2019,343,58,285,1676,57,76,252,718,50,101,422
"2011","Wandsworth 012B","E01004510","Total",1934,316,37,279,1618,54,86,281,602,66,86,443
"2011","Wandsworth 012C","E01004514","Total",1672,250,39,211,1422,43,98,349,548,31,54,299
"2011","Wandsworth 012D","E01004515","Total",1651,227,27,200,1424,61,50,215,490,55,126,427
"2011","Wandsworth 012E","E01004551","Total",1764,325,51,274,1439,109,52,212,570,10,106,380
"2011","Wandsworth 013A","E01004568","Total",1064,171,44,127,893,191,30,161,134,84,108,185
"2011","Wandsworth 013B","E01004574","Total",1811,228,69,159,1583,358,44,309,204,137,202,329
"2011","Wandsworth 013C","E01004575","Total",1528,290,165,125,1238,164,142,96,156,76,153,451
"2011","Wandsworth 013D","E01004576","Total",1543,170,50,120,1373,121,106,307,144,95,203,397
"2011","Wandsworth 014A","E01004500","Total",1591,322,123,199,1269,33,82,159,496,27,76,396
"2011","Wandsworth 014B","E01004501","Total",1582,251,87,164,1331,87,76,254,366,53,158,337
"2011","Wandsworth 014C","E01004503","Total",1625,252,52,200,1373,41,72,209,466,86,169,330
"2011","Wandsworth 014D","E01004505","Total",1616,346,136,210,1270,37,116,209,474,57,46,331
"2011","Wandsworth 014E","E01004507","Total",1838,379,113,266,1459,48,88,194,696,47,62,324
"2011","Wandsworth 015A","E01004553","Total",1640,259,45,214,1381,48,44,311,506,65,52,355
"2011","Wandsworth 015B","E01004557","Total",1530,199,54,145,1331,28,66,413,348,142,89,245
"2011","Wandsworth 015C","E01004558","Total",1707,175,34,141,1532,40,62,552,330,152,126,270
"2011","Wandsworth 015D","E01004559","Total",1397,103,24,79,1294,43,54,398,242,180,180,197
"2011","Wandsworth 015E","E01004619","Total",1437,136,29,107,1301,43,42,305,278,204,209,220
"2011","Wandsworth 016A","E01004572","Total",1649,234,83,151,1415,137,112,265,240,116,124,421
"2011","Wandsworth 016B","E01004642","Total",1734,273,99,174,1461,118,118,367,284,74,176,324
"2011","Wandsworth 016C","E01004643","Total",1981,290,106,184,1691,183,124,309,330,93,216,436
"2011","Wandsworth 016D","E01004644","Total",1924,326,119,207,1598,83,160,313,328,97,257,360
"2011","Wandsworth 016E","E01004645","Total",1983,308,118,190,1675,252,112,281,230,121,235,444
"2011","Wandsworth 017A","E01004477","Total",1668,127,47,80,1541,41,108,442,264,202,152,332
"2011","Wandsworth 017B","E01004478","Total",1526,108,34,74,1418,13,72,544,204,132,162,291
"2011","Wandsworth 017C","E01004479","Total",1540,177,42,135,1363,35,76,346,262,164,191,289
"2011","Wandsworth 017D","E01004550","Total",1363,157,41,116,1206,153,68,282,266,92,126,219
"2011","Wandsworth 017E","E01004555","Total",1663,102,33,69,1561,28,76,572,264,188,173,260
"2011","Wandsworth 018A","E01004494","Total",1645,250,50,200,1395,86,58,315,484,53,112,287
"2011","Wandsworth 018B","E01004513","Total",1866,263,89,174,1603,151,78,225,516,82,196,355
"2011","Wandsworth 018C","E01004600","Total",2062,296,41,255,1766,252,46,305,432,141,275,315
"2011","Wandsworth 018D","E01004601","Total",2241,350,91,259,1891,97,102,385,542,119,244,402
"2011","Wandsworth 019A","E01004493","Total",1734,274,44,230,1460,59,40,304,536,79,105,337
"2011","Wandsworth 019B","E01004512","Total",1483,184,36,148,1299,41,62,334,352,132,160,218
"2011","Wandsworth 019C","E01004620","Total",1642,206,48,158,1436,54,72,419,412,107,109,263
"2011","Wandsworth 019D","E01004621","Total",1635,184,38,146,1451,26,66,263,402,125,264,305
"2011","Wandsworth 019E","E01004623","Total",1733,189,52,137,1544,42,68,483,416,132,122,281
"2011","Wandsworth 019F","E01004627","Total",1614,159,39,120,1455,32,110,410,260,162,148,333
"2011","Wandsworth 020A","E01004499","Total",1591,222,41,181,1369,70,60,222,472,84,105,356
"2011","Wandsworth 020B","E01004502","Total",1655,184,40,144,1471,11,106,353,354,157,172,318
"2011","Wandsworth 020C","E01004504","Total",1523,121,46,75,1402,10,114,377,264,123,228,286
"2011","Wandsworth 020D","E01004594","Total",1657,133,42,91,1524,18,66,432,220,195,177,416
"2011","Wandsworth 020E","E01004596","Total",1621,169,55,114,1452,32,80,469,324,86,157,304
"2011","Wandsworth 020F","E01004629","Total",1586,148,55,93,1438,58,132,305,250,103,224,366
"2011","Wandsworth 021A","E01004472","Total",1746,213,60,153,1533,34,82,328,438,90,120,441
"2011","Wandsworth 021B","E01004474","Total",1856,329,40,289,1527,48,40,191,702,59,95,392
"2011","Wandsworth 021C","E01004476","Total",1636,333,58,275,1303,36,68,149,508,71,79,392
"2011","Wandsworth 021D","E01004542","Total",1621,147,38,109,1474,39,66,418,310,132,136,373
"2011","Wandsworth 021E","E01004544","Total",1529,171,35,136,1358,34,52,362,286,159,137,328
"2011","Wandsworth 022A","E01004628","Total",2102,289,49,240,1813,111,62,346,532,106,248,408
"2011","Wandsworth 022B","E01004630","Total",1751,187,63,124,1564,214,80,299,206,144,242,379
"2011","Wandsworth 022C","E01004631","Total",1452,245,64,181,1207,115,42,244,266,105,156,279
"2011","Wandsworth 022D","E01004633","Total",1618,166,55,111,1452,189,42,234,228,123,222,414
"2011","Wandsworth 023A","E01004569","Total",1969,210,65,145,1759,144,100,299,228,152,261,575
"2011","Wandsworth 023B","E01004570","Total",1873,267,121,146,1606,183,78,198,180,193,168,606
"2011","Wandsworth 023C","E01004571","Total",1681,217,106,111,1464,129,86,207,178,65,211,588
"2011","Wandsworth 023D","E01004573","Total",1521,213,67,146,1308,87,94,262,220,39,176,430
"2011","Wandsworth 024A","E01004495","Total",1536,120,29,91,1416,74,46,131,250,132,375,408
"2011","Wandsworth 024B","E01004496","Total",1956,305,42,263,1651,30,40,284,792,20,78,407
"2011","Wandsworth 024C","E01004497","Total",1445,123,47,76,1322,55,78,348,212,63,226,340
"2011","Wandsworth 024D","E01004622","Total",1092,206,47,159,886,62,42,140,340,83,74,145
"2011","Wandsworth 024E","E01004624","Total",1592,140,44,96,1452,40,86,339,316,69,163,439
"2011","Wandsworth 025A","E01004593","Total",1830,301,57,244,1529,58,76,391,500,50,115,339
"2011","Wandsworth 025B","E01004595","Total",1757,252,57,195,1505,65,70,420,484,31,127,308
"2011","Wandsworth 025C","E01004597","Total",1813,245,65,180,1568,58,94,548,348,92,130,298
"2011","Wandsworth 025D","E01004598","Total",1760,249,31,218,1511,30,38,389,628,15,76,335
"2011","Wandsworth 025E","E01004599","Total",1515,127,46,81,1388,20,70,558,252,127,109,252
"2011","Wandsworth 026A","E01004473","Total",1688,218,53,165,1470,37,68,328,470,47,93,427
"2011","Wandsworth 026B","E01004475","Total",1400,181,34,147,1219,50,62,194,444,56,114,299
"2011","Wandsworth 026C","E01004480","Total",1653,165,36,129,1488,30,44,246,474,55,87,552
"2011","Wandsworth 026D","E01004483","Total",2099,333,49,284,1766,113,44,389,766,45,130,279
"2011","Wandsworth 026E","E01004484","Total",1513,191,40,151,1322,67,50,191,428,36,108,442
"2011","Wandsworth 026F","E01004486","Total",1465,331,79,252,1134,59,48,159,556,48,66,198
"2011","Wandsworth 027A","E01004543","Total",1781,186,33,153,1595,58,64,431,394,143,192,313
"2011","Wandsworth 027B","E01004545","Total",1578,386,73,313,1192,30,40,150,550,20,32,370
"2011","Wandsworth 027C","E01004546","Total",1502,167,33,134,1335,31,56,319,396,76,67,390
"2011","Wandsworth 027D","E01004549","Total",1593,232,61,171,1361,25,66,281,308,132,186,363
"2011","Wandsworth 027E","E01004625","Total",1397,85,48,37,1312,5,102,349,148,246,149,313
"2011","Wandsworth 027F","E01004626","Total",1674,227,56,171,1447,41,60,435,442,115,147,207
"2011","Wandsworth 028A","E01004632","Total",1527,150,62,88,1377,56,82,377,232,106,150,374
"2011","Wandsworth 028B","E01004634","Total",1465,265,66,199,1200,61,110,235,342,80,88,284
"2011","Wandsworth 028C","E01004635","Total",1616,220,59,161,1396,68,62,280,354,114,178,340
"2011","Wandsworth 028D","E01004636","Total",1462,207,34,173,1255,112,76,273,332,99,99,264
"2011","Wandsworth 028E","E01004637","Total",1471,179,65,114,1292,67,96,262,244,80,146,397
"2011","Wandsworth 029A","E01004481","Total",1671,169,31,138,1502,76,54,220,520,49,61,522
"2011","Wandsworth 029B","E01004488","Total",1486,208,31,177,1278,52,52,282,314,102,201,275
"2011","Wandsworth 029C","E01004547","Total",1331,189,51,138,1142,34,52,254,242,79,168,313
"2011","Wandsworth 029D","E01004548","Total",2034,454,99,355,1580,78,72,167,662,65,144,392
"2011","Wandsworth 030A","E01004482","Total",1588,171,42,129,1417,68,64,171,284,113,230,487
"2011","Wandsworth 030B","E01004485","Total",1668,199,67,132,1469,40,74,262,370,68,203,452
"2011","Wandsworth 030C","E01004487","Total",1519,268,27,241,1251,61,48,222,420,134,117,249
"2011","Wandsworth 030D","E01004489","Total",1430,231,25,206,1199,63,48,198,282,139,231,238
"2011","Wandsworth 031A","E01004490","Total",1510,144,42,102,1366,13,58,418,370,51,140,316
"2011","Wandsworth 031B","E01004491","Total",1824,537,45,492,1287,124,48,261,334,104,199,217
"2011","Wandsworth 031C","E01004492","Total",1719,233,46,187,1486,79,52,290,410,72,138,445
"2011","Wandsworth 031D","E01004498","Total",1705,237,43,194,1468,15,48,390,586,50,59,320
"2011","Wandsworth 032A","E01004532","Total",1487,193,36,157,1294,88,60,296,356,78,129,287
"2011","Wandsworth 032B","E01004611","Total",1602,130,40,90,1472,88,96,215,198,87,247,541
"2011","Wandsworth 032C","E01004612","Total",1785,101,31,70,1684,72,80,226,174,186,375,571
"2011","Wandsworth 032D","E01004618","Total",1552,109,37,72,1443,31,82,243,164,91,275,557
"2011","Wandsworth 033A","E01004531","Total",1724,152,63,89,1572,135,80,303,256,123,278,397
"2011","Wandsworth 033B","E01004533","Total",1398,142,41,101,1256,174,56,249,268,62,126,321
"2011","Wandsworth 033C","E01004610","Total",1976,108,44,64,1868,58,104,253,216,93,479,665
"2011","Wandsworth 033D","E01004613","Total",1614,251,103,148,1363,130,82,207,204,86,243,411
"2011","Wandsworth 034A","E01004614","Total",2065,269,74,195,1796,121,58,291,412,75,170,669
"2011","Wandsworth 034B","E01004615","Total",1795,257,80,177,1538,278,94,258,256,113,221,318
"2011","Wandsworth 034C","E01004616","Total",2159,207,34,173,1952,95,68,258,442,100,287,702
"2011","Wandsworth 034D","E01004617","Total",1645,199,44,155,1446,71,46,177,248,116,220,568
"2011","Wandsworth 035A","E01004525","Total",1848,134,32,102,1714,72,66,240,326,94,295,621
"2011","Wandsworth 035B","E01004526","Total",1558,208,52,156,1350,64,56,222,342,54,185,427
"2011","Wandsworth 035C","E01004527","Total",1643,131,41,90,1512,64,94,257,200,129,263,505
"2011","Wandsworth 035D","E01004528","Total",1488,214,58,156,1274,159,72,271,272,66,174,260
"2011","Wandsworth 035E","E01004529","Total",2079,265,66,199,1814,118,50,392,560,82,229,383
"2011","Wandsworth 035F","E01004530","Total",1880,241,60,181,1639,67,72,325,426,98,167,484
"2011","Wandsworth 036A","E01004516","Total",1608,91,42,49,1517,64,70,382,136,135,359,371
"2011","Wandsworth 036B","E01004518","Total",1743,175,46,129,1568,107,86,386,212,113,285,379
"2011","Wandsworth 036C","E01004519","Total",1767,159,70,89,1608,140,86,320,220,127,266,449
"2011","Wandsworth 036D","E01004520","Total",1366,96,41,55,1270,77,84,278,140,108,276,307
"2011","Wandsworth 036E","E01004523","Total",1581,326,137,189,1255,91,80,253,218,73,224,316
"2011","Wandsworth 037A","E01004517","Total",1943,268,54,214,1675,143,46,365,414,95,289,323
"2011","Wandsworth 037B","E01004521","Total",1946,215,47,168,1731,129,72,439,314,168,260,349
"2011","Wandsworth 037C","E01004522","Total",1629,170,41,129,1459,143,58,376,242,124,194,322
"2011","Wandsworth 037D","E01004524","Total",1633,355,117,238,1278,196,64,239,238,93,197,251
"2011","Westminster 001A","E01004647","Total",1480,277,130,147,1203,49,140,280,256,78,147,253
"2011","Westminster 001B","E01004649","Total",1593,261,83,178,1332,47,158,361,248,50,221,247
"2011","Westminster 001C","E01004724","Total",1761,384,101,283,1377,63,104,287,332,94,172,325
"2011","Westminster 001D","E01004730","Total",1665,324,125,199,1341,54,202,347,288,93,116,241
"2011","Westminster 002A","E01004646","Total",1653,164,72,92,1489,69,114,356,208,204,270,268
"2011","Westminster 002B","E01004648","Total",2398,450,128,322,1948,97,164,368,512,202,233,372
"2011","Westminster 002C","E01004650","Total",1992,365,93,272,1627,36,122,455,432,82,190,310
"2011","Westminster 002D","E01004710","Total",1603,195,63,132,1408,179,98,219,212,195,222,283
"2011","Westminster 002E","E01004711","Total",1734,265,82,183,1469,211,80,262,272,136,179,329
"2011","Westminster 003A","E01004651","Total",2015,618,131,487,1397,43,112,357,482,67,116,220
"2011","Westminster 003B","E01004725","Total",1611,429,200,229,1182,116,98,262,198,76,199,233
"2011","Westminster 003C","E01004726","Total",1792,337,100,237,1455,55,146,307,312,79,221,335
"2011","Westminster 003D","E01004728","Total",1558,379,157,222,1179,73,136,241,320,64,93,252
"2011","Westminster 003E","E01004729","Total",1638,467,206,261,1171,88,114,210,220,100,170,269
"2011","Westminster 004A","E01004718","Total",1962,309,57,252,1653,191,82,267,326,85,252,450
"2011","Westminster 004B","E01004719","Total",1896,243,64,179,1653,209,88,377,320,161,183,315
"2011","Westminster 004C","E01004720","Total",1991,231,90,141,1760,161,122,309,252,190,284,442
"2011","Westminster 004D","E01004721","Total",1998,353,123,230,1645,159,132,312,252,120,309,361
"2011","Westminster 004E","E01004722","Total",2456,245,61,184,2211,224,92,302,216,291,627,459
"2011","Westminster 005A","E01004674","Total",2093,307,106,201,1786,164,98,209,276,187,363,489
"2011","Westminster 005B","E01004675","Total",2279,490,142,348,1789,183,76,367,448,128,197,390
"2011","Westminster 005C","E01004677","Total",1795,352,71,281,1443,119,52,270,474,31,159,338
"2011","Westminster 005D","E01004678","Total",1997,341,51,290,1656,152,80,336,378,146,203,361
"2011","Westminster 005E","E01004679","Total",2118,328,63,265,1790,289,74,306,422,159,209,331
"2011","Westminster 005F","E01004723","Total",2176,403,61,342,1773,225,64,239,452,101,254,438
"2011","Westminster 006A","E01004676","Total",1685,318,37,281,1367,141,32,248,410,80,181,275
"2011","Westminster 006B","E01004706","Total",1600,219,62,157,1381,76,60,311,470,44,47,373
"2011","Westminster 006C","E01004707","Total",1954,199,52,147,1755,54,92,476,418,135,140,440
"2011","Westminster 006D","E01004708","Total",1569,324,54,270,1245,72,72,248,412,37,94,310
"2011","Westminster 006E","E01004756","Total",1796,366,33,333,1430,119,34,272,438,115,131,321
"2011","Westminster 007A","E01004701","Total",1618,399,91,308,1219,16,96,390,400,57,84,176
"2011","Westminster 007B","E01004703","Total",2308,368,103,265,1940,59,174,491,432,180,213,391
"2011","Westminster 007D","E01004705","Total",1469,264,48,216,1205,33,76,343,386,89,85,193
"2011","Westminster 007E","E01004709","Total",1673,284,65,219,1389,102,92,259,364,92,184,296
"2011","Westminster 007F","E01033600","Total",1224,282,55,227,942,30,70,192,362,51,77,160
"2011","Westminster 007G","E01033608","Total",1369,349,32,317,1020,42,48,177,408,69,58,218
"2011","Westminster 008A","E01004659","Total",1769,466,78,388,1303,31,96,162,500,53,80,381
"2011","Westminster 008B","E01004660","Total",1781,352,87,265,1429,34,130,299,420,73,115,358
"2011","Westminster 008C","E01004712","Total",1545,394,84,310,1151,34,134,188,446,5,90,254
"2011","Westminster 008D","E01004727","Total",1998,377,67,310,1621,46,150,319,526,38,104,438
"2011","Westminster 009A","E01004670","Total",2709,325,154,171,2384,307,126,257,182,279,791,442
"2011","Westminster 009E","E01004702","Total",2597,330,114,216,2267,228,130,382,256,245,419,607
"2011","Westminster 009F","E01033598","Total",1242,190,74,116,1052,122,80,117,138,153,202,240
"2011","Westminster 009G","E01033601","Total",1569,198,102,96,1371,123,70,200,182,143,331,322
"2011","Westminster 009H","E01033602","Total",1625,226,72,154,1399,225,74,248,160,141,255,296
"2011","Westminster 009I","E01033603","Total",1217,267,46,221,950,98,38,146,252,52,114,250
"2011","Westminster 009J","E01033604","Total",1236,314,33,281,922,89,22,186,212,53,120,240
"2011","Westminster 009K","E01033605","Total",2004,301,106,195,1703,193,122,269,198,189,321,411
"2011","Westminster 010A","E01004754","Total",1528,219,95,124,1309,172,84,200,98,153,237,365
"2011","Westminster 010B","E01004755","Total",2147,387,34,353,1760,169,58,331,388,155,252,407
"2011","Westminster 010C","E01004757","Total",1594,172,53,119,1422,157,54,234,172,178,227,400
"2011","Westminster 010F","E01032512","Total",2480,307,66,241,2173,347,108,467,340,305,265,341
"2011","Westminster 010G","E01032513","Total",1311,234,84,150,1077,135,66,154,152,146,188,236
"2011","Westminster 011A","E01004713","Total",1779,415,89,326,1364,19,128,292,494,35,64,332
"2011","Westminster 011B","E01004714","Total",2141,575,83,492,1566,53,106,310,644,16,115,322
"2011","Westminster 011C","E01004716","Total",1419,295,80,215,1124,10,146,208,388,35,82,255
"2011","Westminster 011D","E01004717","Total",1511,473,94,379,1038,25,86,164,494,36,21,212
"2011","Westminster 011E","E01004762","Total",2066,603,141,462,1463,50,170,226,444,64,196,313
"2011","Westminster 012A","E01004657","Total",1471,431,72,359,1040,17,96,215,388,49,51,224
"2011","Westminster 012B","E01004658","Total",1391,390,60,330,1001,85,56,174,288,33,88,277
"2011","Westminster 012C","E01004661","Total",1817,424,71,353,1393,67,94,158,344,80,130,520
"2011","Westminster 012D","E01004662","Total",1876,541,81,460,1335,31,68,269,510,32,90,335
"2011","Westminster 012E","E01004663","Total",1636,381,114,267,1255,50,156,225,406,70,112,236
"2011","Westminster 013A","E01004715","Total",1514,424,107,317,1090,36,82,110,362,51,90,359
"2011","Westminster 013B","E01004763","Total",1731,612,66,546,1119,15,30,86,634,15,35,304
"2011","Westminster 013D","E01004765","Total",1967,549,90,459,1418,53,106,213,588,65,74,319
"2011","Westminster 013E","E01033595","Total",1174,474,88,386,700,24,44,78,344,11,46,153
"2011","Westminster 013F","E01033596","Total",1231,443,103,340,788,55,62,107,324,82,54,104
"2011","Westminster 014A","E01004653","Total",1812,450,97,353,1362,45,94,317,402,117,96,291
"2011","Westminster 014B","E01004654","Total",2225,570,91,479,1655,62,104,326,682,80,118,283
"2011","Westminster 014D","E01004656","Total",2107,613,106,507,1494,67,114,266,570,109,92,276
"2011","Westminster 014E","E01004760","Total",1630,321,62,259,1309,151,70,178,356,66,169,319
"2011","Westminster 014F","E01033606","Total",1064,321,30,291,743,45,28,111,366,7,49,137
"2011","Westminster 014G","E01033607","Total",1193,295,69,226,898,32,58,198,260,51,76,223
"2011","Westminster 015A","E01004680","Total",1451,306,84,222,1145,40,120,256,272,68,118,271
"2011","Westminster 015B","E01004683","Total",1657,300,72,228,1357,24,150,272,324,48,146,393
"2011","Westminster 015C","E01004684","Total",1401,354,75,279,1047,100,98,203,202,108,112,224
"2011","Westminster 015E","E01004686","Total",1529,508,61,447,1021,91,66,194,228,89,118,235
"2011","Westminster 015F","E01033593","Total",1130,372,18,354,758,147,24,118,222,74,68,105
"2011","Westminster 015G","E01033594","Total",1280,381,85,296,899,68,80,115,254,53,51,278
"2011","Westminster 016A","E01004681","Total",2126,544,72,472,1582,69,66,261,656,58,71,401
"2011","Westminster 016B","E01004682","Total",1336,407,50,357,929,27,54,160,390,25,24,249
"2011","Westminster 016C","E01004694","Total",1717,469,61,408,1248,34,44,244,542,60,97,227
"2011","Westminster 016D","E01004697","Total",1504,384,72,312,1120,47,60,198,460,42,62,251
"2011","Westminster 016E","E01004700","Total",1708,484,62,422,1224,48,50,310,460,63,63,230
"2011","Westminster 017A","E01004652","Total",1840,451,81,370,1389,53,60,193,504,81,75,423
"2011","Westminster 017B","E01004693","Total",1398,359,64,295,1039,11,86,218,350,98,77,199
"2011","Westminster 017C","E01004695","Total",1274,305,53,252,969,36,30,99,394,57,44,309
"2011","Westminster 017D","E01004696","Total",1585,346,121,225,1239,121,88,277,228,84,130,311
"2011","Westminster 017E","E01004698","Total",1428,377,53,324,1051,70,30,154,362,41,67,327
"2011","Westminster 017F","E01004699","Total",2241,540,66,474,1701,67,70,249,616,79,84,536
"2011","Westminster 018A","E01004734","Total",1931,611,155,456,1320,56,92,101,472,20,109,470
"2011","Westminster 018B","E01004735","Total",1601,581,120,461,1020,32,80,106,426,24,61,291
"2011","Westminster 018C","E01004736","Total",1265,379,65,314,886,6,112,99,386,37,47,199
"2011","Westminster 018D","E01004761","Total",1922,594,111,483,1328,43,132,205,430,30,112,376
"2011","Westminster 019A","E01004687","Total",1665,353,94,259,1312,31,160,278,294,80,171,298
"2011","Westminster 019B","E01004688","Total",878,240,62,178,638,20,96,121,214,23,48,116
"2011","Westminster 019C","E01004689","Total",1015,239,33,206,776,24,88,157,206,78,54,169
"2011","Westminster 019D","E01004690","Total",1400,235,54,181,1165,46,122,202,256,83,198,258
"2011","Westminster 019E","E01004691","Total",1508,427,106,321,1081,33,144,169,314,40,118,263
"2011","Westminster 019F","E01004692","Total",1396,255,77,178,1141,26,154,220,250,71,89,331
"2011","Westminster 020A","E01004731","Total",1658,437,68,369,1221,32,82,199,520,50,71,267
"2011","Westminster 020B","E01004732","Total",1314,372,119,253,942,92,90,165,194,61,106,234
"2011","Westminster 020C","E01004733","Total",1796,394,56,338,1402,58,122,260,524,57,110,271
"2011","Westminster 020D","E01004744","Total",1311,413,139,274,898,45,54,262,296,75,36,130
"2011","Westminster 020E","E01004748","Total",1238,253,76,177,985,24,142,159,294,69,53,244
"2011","Westminster 021A","E01004740","Total",1494,393,172,221,1101,72,106,187,290,49,138,259
"2011","Westminster 021B","E01004743","Total",1396,335,44,291,1061,123,54,181,320,120,105,158
"2011","Westminster 021C","E01004745","Total",2114,508,125,383,1606,106,164,309,552,76,108,291
"2011","Westminster 021D","E01004746","Total",1440,377,130,247,1063,108,100,233,266,68,91,197
"2011","Westminster 021E","E01004747","Total",2182,509,109,400,1673,127,122,278,546,83,171,346
"2011","Westminster 022A","E01004742","Total",1381,369,62,307,1012,28,48,158,510,51,25,192
"2011","Westminster 022B","E01004749","Total",2337,518,96,422,1819,129,90,348,616,106,80,450
"2011","Westminster 022C","E01004751","Total",1768,436,98,338,1332,40,106,203,538,72,140,233
"2011","Westminster 022D","E01004752","Total",1567,463,86,377,1104,53,86,111,484,48,42,280
"2011","Westminster 022E","E01004753","Total",1813,543,94,449,1270,42,96,174,554,57,94,253
"2011","Westminster 023B","E01004666","Total",1103,255,96,159,848,52,100,146,208,84,73,185
"2011","Westminster 023C","E01004667","Total",1348,397,98,299,951,98,92,168,264,41,89,199
"2011","Westminster 023D","E01004668","Total",1443,228,99,129,1215,114,118,287,252,102,104,238
"2011","Westminster 023E","E01004750","Total",1741,526,179,347,1215,69,114,164,338,79,167,284
"2011","Westminster 023F","E01033597","Total",990,386,58,328,604,51,42,128,232,56,15,80
"2011","Westminster 023G","E01033599","Total",1573,206,24,182,1367,272,46,291,170,170,188,230
"2011","Westminster 024A","E01004665","Total",1478,226,98,128,1252,160,102,196,170,164,228,232
"2011","Westminster 024B","E01004669","Total",1683,328,119,209,1355,141,104,214,212,121,212,351
"2011","Westminster 024C","E01004737","Total",1301,313,112,201,988,81,158,180,246,59,82,182
"2011","Westminster 024D","E01004738","Total",1306,363,69,294,943,41,70,150,376,63,42,201
"2011","Westminster 024E","E01004739","Total",1348,629,164,465,719,13,96,76,424,10,19,81
"2011","Westminster 024F","E01004741","Total",1273,367,83,284,906,86,80,149,264,42,109,176
"2011","Barking and Dagenham 001A","E01000027","Total",1688,175,96,79,1513,239,104,338,138,164,186,344
"2011","Barking and Dagenham 001B","E01000028","Total",1519,197,86,111,1322,235,88,250,148,125,249,227
"2011","Barking and Dagenham 001C","E01000029","Total",1602,224,152,72,1378,71,290,236,152,113,224,292
"2011","Barking and Dagenham 001D","E01000030","Total",1915,218,75,143,1697,403,118,405,168,148,190,265
"2011","Barking and Dagenham 002A","E01000031","Total",1617,159,97,62,1458,110,116,268,156,132,283,393
"2011","Barking and Dagenham 002B","E01000032","Total",1629,181,78,103,1448,132,126,268,162,105,274,381
"2011","Barking and Dagenham 002C","E01000110","Total",1404,92,44,48,1312,74,128,260,162,88,260,340
"2011","Barking and Dagenham 002D","E01000111","Total",1833,225,110,115,1608,174,124,364,212,108,314,312
"2011","Barking and Dagenham 002E","E01000112","Total",1871,213,79,134,1658,178,120,314,248,128,290,380
"2011","Barking and Dagenham 002F","E01000113","Total",1679,169,58,111,1510,138,92,342,204,122,287,325
"2011","Barking and Dagenham 003A","E01000034","Total",1348,142,77,65,1206,118,104,225,158,86,256,259
"2011","Barking and Dagenham 003B","E01000037","Total",1547,129,61,68,1418,51,144,285,190,55,255,438
"2011","Barking and Dagenham 003C","E01000038","Total",1447,153,95,58,1294,83,168,260,132,73,234,344
"2011","Barking and Dagenham 003D","E01000039","Total",1595,185,90,95,1410,122,156,363,232,78,131,328
"2011","Barking and Dagenham 004A","E01000063","Total",1620,185,81,104,1435,211,108,310,144,129,258,275
"2011","Barking and Dagenham 004B","E01000100","Total",1653,155,72,83,1498,188,110,346,168,149,287,250
"2011","Barking and Dagenham 004C","E01000101","Total",1513,144,73,71,1369,148,94,323,144,57,301,302
"2011","Barking and Dagenham 004D","E01000109","Total",1686,149,70,79,1537,151,94,291,164,152,297,388
"2011","Barking and Dagenham 004E","E01000114","Total",2090,175,75,100,1915,238,152,354,230,170,380,391
"2011","Barking and Dagenham 006A","E01000033","Total",1361,158,61,97,1203,170,90,264,126,120,187,246
"2011","Barking and Dagenham 006B","E01000060","Total",1809,286,105,181,1523,251,140,350,180,158,256,188
"2011","Barking and Dagenham 006C","E01000061","Total",1719,192,37,155,1527,388,22,348,194,181,238,156
"2011","Barking and Dagenham 006D","E01000062","Total",1952,230,122,108,1722,218,132,339,196,169,301,367
"2011","Barking and Dagenham 006E","E01000064","Total",1831,198,104,94,1633,223,104,277,214,164,283,368
"2011","Barking and Dagenham 007A","E01000065","Total",1736,321,177,144,1415,194,120,297,178,90,291,245
"2011","Barking and Dagenham 007B","E01000078","Total",1666,186,75,111,1480,233,102,273,162,138,328,244
"2011","Barking and Dagenham 007C","E01000080","Total",1556,171,74,97,1385,180,92,282,150,120,285,276
"2011","Barking and Dagenham 007D","E01000081","Total",1688,170,62,108,1518,169,124,332,172,147,273,301
"2011","Barking and Dagenham 007E","E01000082","Total",1678,223,73,150,1455,180,80,367,184,142,270,232
"2011","Barking and Dagenham 007F","E01000083","Total",1700,143,71,72,1557,217,110,353,192,136,258,291
"2011","Barking and Dagenham 007G","E01000102","Total",1540,184,83,101,1356,185,106,377,150,77,218,243
"2011","Barking and Dagenham 008A","E01000021","Total",1579,189,54,135,1390,163,52,256,150,91,337,341
"2011","Barking and Dagenham 008B","E01000022","Total",1314,103,45,58,1211,162,60,276,138,85,236,254
"2011","Barking and Dagenham 008C","E01000023","Total",1112,199,56,143,913,116,50,186,168,67,114,212
"2011","Barking and Dagenham 008D","E01000024","Total",1325,98,48,50,1227,171,52,203,138,84,323,256
"2011","Barking and Dagenham 008E","E01000025","Total",1609,159,63,96,1450,201,92,342,188,98,211,318
"2011","Barking and Dagenham 008F","E01000077","Total",1437,149,59,90,1288,168,88,285,172,85,222,268
"2011","Barking and Dagenham 009A","E01000015","Total",2241,195,58,137,2046,367,70,479,232,222,348,328
"2011","Barking and Dagenham 009B","E01000016","Total",1637,176,67,109,1461,180,116,324,156,126,265,294
"2011","Barking and Dagenham 009C","E01000017","Total",1594,178,68,110,1416,160,102,220,196,164,294,280
"2011","Barking and Dagenham 009D","E01000018","Total",1597,158,68,90,1439,196,102,364,150,123,222,282
"2011","Barking and Dagenham 009E","E01000079","Total",1546,194,100,94,1352,150,104,319,154,146,264,215
"2011","Barking and Dagenham 010A","E01000035","Total",1543,151,59,92,1392,129,116,253,140,142,286,326
"2011","Barking and Dagenham 010B","E01000036","Total",1353,98,41,57,1255,70,96,201,164,71,360,293
"2011","Barking and Dagenham 010C","E01000107","Total",1632,131,63,68,1501,151,172,272,160,110,335,301
"2011","Barking and Dagenham 010D","E01000108","Total",1558,195,48,147,1363,185,134,235,206,91,204,308
"2011","Barking and Dagenham 011A","E01000066","Total",1928,208,90,118,1720,114,102,264,164,201,537,338
"2011","Barking and Dagenham 011B","E01000067","Total",1969,172,86,86,1797,111,134,276,170,142,544,420
"2011","Barking and Dagenham 011C","E01000069","Total",1756,82,46,36,1674,33,96,193,126,178,601,447
"2011","Barking and Dagenham 011D","E01000070","Total",1975,107,59,48,1868,36,160,245,124,113,643,547
"2011","Barking and Dagenham 011E","E01000071","Total",2251,222,122,100,2029,139,130,384,190,136,603,447
"2011","Barking and Dagenham 012A","E01000057","Total",1496,121,53,68,1375,211,76,279,140,162,248,259
"2011","Barking and Dagenham 012B","E01000073","Total",1619,175,70,105,1444,185,98,348,174,167,225,247
"2011","Barking and Dagenham 012C","E01000074","Total",1567,200,80,120,1367,217,72,348,152,156,181,241
"2011","Barking and Dagenham 012D","E01000075","Total",1732,159,68,91,1573,134,150,267,154,180,313,375
"2011","Barking and Dagenham 012E","E01000076","Total",1982,203,81,122,1779,191,92,372,186,319,290,329
"2011","Barking and Dagenham 013A","E01000013","Total",1660,164,73,91,1496,218,144,317,200,107,236,274
"2011","Barking and Dagenham 013B","E01000014","Total",1622,180,68,112,1442,181,110,340,164,143,206,298
"2011","Barking and Dagenham 013C","E01000059","Total",1540,153,69,84,1387,198,68,288,158,126,244,305
"2011","Barking and Dagenham 013D","E01000084","Total",1355,138,47,91,1217,144,76,247,176,134,235,205
"2011","Barking and Dagenham 013E","E01000085","Total",1711,171,56,115,1540,186,108,304,178,215,276,273
"2011","Barking and Dagenham 013F","E01000086","Total",1431,121,55,66,1310,131,86,294,110,101,308,280
"2011","Barking and Dagenham 014A","E01000103","Total",1685,137,42,95,1548,186,78,308,182,123,370,301
"2011","Barking and Dagenham 014B","E01000104","Total",1781,281,67,214,1500,252,68,287,168,201,300,224
"2011","Barking and Dagenham 014C","E01000105","Total",2115,329,130,199,1786,309,118,403,256,167,275,258
"2011","Barking and Dagenham 014D","E01000106","Total",1968,393,118,275,1575,305,102,368,228,119,266,187
"2011","Barking and Dagenham 015A","E01000007","Total",1391,253,40,213,1138,132,16,323,220,88,231,128
"2011","Barking and Dagenham 015B","E01000008","Total",1544,129,12,117,1415,216,10,209,184,237,322,237
"2011","Barking and Dagenham 015C","E01000010","Total",2840,258,32,226,2582,224,40,655,594,225,370,474
"2011","Barking and Dagenham 015D","E01000012","Total",1895,165,18,147,1730,278,24,473,212,156,295,292
"2011","Barking and Dagenham 016A","E01000006","Total",1699,97,24,73,1602,87,78,287,168,121,448,413
"2011","Barking and Dagenham 016B","E01000009","Total",1773,191,64,127,1582,84,72,274,188,26,403,535
"2011","Barking and Dagenham 016C","E01000011","Total",1628,70,19,51,1558,77,40,210,118,114,507,492
"2011","Barking and Dagenham 016D","E01000044","Total",1793,152,50,102,1641,159,92,317,178,148,392,355
"2011","Barking and Dagenham 016E","E01000068","Total",1575,84,38,46,1491,36,78,156,116,94,546,465
"2011","Barking and Dagenham 017A","E01000041","Total",1682,149,56,93,1533,179,86,356,168,160,277,307
"2011","Barking and Dagenham 017B","E01000042","Total",1786,214,71,143,1572,260,82,280,168,219,312,251
"2011","Barking and Dagenham 017C","E01000045","Total",1646,135,50,85,1511,214,76,349,180,114,307,271
"2011","Barking and Dagenham 017D","E01000046","Total",1779,145,58,87,1634,218,100,390,210,135,299,282
"2011","Barking and Dagenham 017E","E01000072","Total",1991,242,115,127,1749,297,100,402,188,154,313,295
"2011","Barking and Dagenham 018A","E01000054","Total",1718,149,56,93,1569,185,122,336,186,142,294,304
"2011","Barking and Dagenham 018B","E01000055","Total",1553,129,50,79,1424,131,76,279,172,136,352,278
"2011","Barking and Dagenham 018C","E01000056","Total",1542,133,39,94,1409,204,84,369,164,153,212,223
"2011","Barking and Dagenham 018D","E01000058","Total",1849,188,71,117,1661,252,84,311,176,128,364,346
"2011","Barking and Dagenham 018E","E01000095","Total",1572,123,37,86,1449,178,72,375,144,138,328,214
"2011","Barking and Dagenham 019A","E01000040","Total",1569,188,70,118,1381,201,98,276,216,103,221,266
"2011","Barking and Dagenham 019B","E01000043","Total",1356,117,59,58,1239,91,96,205,94,146,306,301
"2011","Barking and Dagenham 019C","E01000050","Total",1661,192,90,102,1469,207,92,282,160,121,299,308
"2011","Barking and Dagenham 019D","E01000052","Total",2014,228,89,139,1786,259,110,369,210,154,338,346
"2011","Barking and Dagenham 019E","E01000092","Total",2674,256,116,140,2418,289,114,585,230,252,524,424
"2011","Barking and Dagenham 020A","E01000053","Total",1484,241,89,152,1243,181,70,306,204,96,193,193
"2011","Barking and Dagenham 020B","E01000087","Total",1341,132,52,80,1209,151,64,254,130,65,278,267
"2011","Barking and Dagenham 020C","E01000088","Total",1723,168,57,111,1555,182,100,360,170,184,252,307
"2011","Barking and Dagenham 020D","E01000089","Total",1666,132,40,92,1534,234,100,354,174,128,215,329
"2011","Barking and Dagenham 020E","E01000090","Total",1584,110,39,71,1474,177,104,266,150,210,281,286
"2011","Barking and Dagenham 021B","E01000048","Total",1783,192,43,149,1591,342,30,325,130,299,313,152
"2011","Barking and Dagenham 021C","E01000049","Total",1820,167,51,116,1653,334,64,367,128,287,241,232
"2011","Barking and Dagenham 021D","E01000051","Total",1927,235,19,216,1692,371,32,320,164,273,330,202
"2011","Barking and Dagenham 021E","E01033587","Total",1573,170,20,150,1403,261,30,379,238,122,191,182
"2011","Barking and Dagenham 021F","E01033588","Total",1581,155,35,120,1426,325,44,410,184,138,191,134
"2011","Barking and Dagenham 022A","E01000091","Total",1714,195,55,140,1519,301,80,254,136,201,321,226
"2011","Barking and Dagenham 022B","E01000093","Total",1547,246,46,200,1301,210,60,292,150,140,264,185
"2011","Barking and Dagenham 022C","E01000094","Total",1326,144,10,134,1182,212,14,376,136,78,189,177
"2011","Barking and Dagenham 022D","E01000096","Total",1895,146,31,115,1749,341,64,341,108,281,337,277
"2011","Barking and Dagenham 023A","E01000019","Total",1407,113,48,65,1294,202,74,226,164,116,221,291
"2011","Barking and Dagenham 023B","E01000020","Total",1773,191,78,113,1582,178,64,357,142,125,414,302
"2011","Barking and Dagenham 023C","E01000097","Total",1683,255,166,89,1428,176,132,409,128,106,188,289
"2011","Barking and Dagenham 023D","E01000098","Total",1746,147,45,102,1599,202,106,278,168,183,348,314
"2011","Barking and Dagenham 023E","E01000099","Total",1732,164,75,89,1568,189,112,425,210,155,163,314
"2011","Barking and Dagenham 023F","E01032580","Total",1354,104,34,70,1250,182,46,240,108,122,246,306
"2011","Barnet 001A","E01000248","Total",1613,209,84,125,1404,47,118,457,218,81,218,265
"2011","Barnet 001B","E01000249","Total",1510,123,60,63,1387,42,170,329,180,97,206,363
"2011","Barnet 001C","E01000250","Total",2219,373,140,233,1846,125,148,466,342,129,251,385
"2011","Barnet 001D","E01000254","Total",1497,182,93,89,1315,46,168,414,214,99,116,258
"2011","Barnet 001E","E01000292","Total",1460,195,118,77,1265,70,194,272,194,57,162,316
"2011","Barnet 001F","E01000293","Total",1670,143,67,76,1527,31,190,410,212,73,199,412
"2011","Barnet 002A","E01000167","Total",1307,137,52,85,1170,106,92,250,174,60,173,315
"2011","Barnet 002B","E01000246","Total",1498,217,109,108,1281,50,188,370,206,46,121,300
"2011","Barnet 002C","E01000247","Total",1691,269,63,206,1422,91,78,432,296,57,165,303
"2011","Barnet 002D","E01000251","Total",1824,425,134,291,1399,128,142,295,400,57,152,225
"2011","Barnet 002E","E01000252","Total",1609,299,131,168,1310,100,118,303,268,63,175,283
"2011","Barnet 003A","E01000166","Total",1582,209,94,115,1373,85,138,380,182,86,184,318
"2011","Barnet 003B","E01000168","Total",1559,103,55,48,1456,14,238,351,140,88,211,414
"2011","Barnet 003C","E01000169","Total",1485,235,65,170,1250,83,122,345,262,82,117,239
"2011","Barnet 003D","E01000172","Total",1650,139,83,56,1511,32,154,450,148,138,177,412
"2011","Barnet 004A","E01000285","Total",1443,194,74,120,1249,79,128,324,200,40,150,328
"2011","Barnet 004B","E01000287","Total",1580,154,71,83,1426,130,136,340,204,72,250,294
"2011","Barnet 004C","E01000288","Total",1565,138,75,63,1427,70,124,352,148,77,296,360
"2011","Barnet 004D","E01000289","Total",1817,134,51,83,1683,227,102,257,152,212,334,399
"2011","Barnet 004E","E01000291","Total",1574,157,54,103,1417,235,118,275,170,131,188,300
"2011","Barnet 004F","E01000294","Total",1520,235,122,113,1285,77,162,341,222,52,183,248
"2011","Barnet 005A","E01000267","Total",1520,129,51,78,1391,37,148,291,168,102,218,427
"2011","Barnet 005B","E01000268","Total",1680,219,67,152,1461,194,108,316,352,113,121,257
"2011","Barnet 005C","E01000269","Total",1425,101,53,48,1324,51,172,277,182,77,214,351
"2011","Barnet 005D","E01000270","Total",1482,182,77,105,1300,64,186,349,214,52,142,293
"2011","Barnet 006A","E01000170","Total",1626,201,82,119,1425,108,128,348,186,86,244,325
"2011","Barnet 006B","E01000171","Total",1849,301,55,246,1548,252,62,446,370,90,113,215
"2011","Barnet 006C","E01000173","Total",1719,117,55,62,1602,66,146,411,190,112,282,395
"2011","Barnet 006D","E01000174","Total",1728,283,107,176,1445,122,106,447,266,51,181,272
"2011","Barnet 006E","E01000175","Total",1585,152,64,88,1433,53,162,385,196,117,182,338
"2011","Barnet 007A","E01000228","Total",1481,66,30,36,1415,84,112,362,112,122,284,339
"2011","Barnet 007B","E01000253","Total",1610,118,73,45,1492,24,260,304,150,122,261,371
"2011","Barnet 007C","E01000279","Total",1446,80,42,38,1366,25,228,274,132,95,236,376
"2011","Barnet 007D","E01000280","Total",1381,83,51,32,1298,14,192,271,142,92,189,398
"2011","Barnet 007E","E01000286","Total",1538,213,104,109,1325,140,124,306,208,78,169,300
"2011","Barnet 007F","E01000290","Total",1557,230,143,87,1327,61,204,269,174,87,202,330
"2011","Barnet 008A","E01000271","Total",1461,159,98,61,1302,22,200,287,162,94,189,348
"2011","Barnet 008B","E01000272","Total",1266,83,41,42,1183,11,184,191,154,98,201,344
"2011","Barnet 008C","E01000273","Total",1497,225,102,123,1272,57,178,268,184,72,178,335
"2011","Barnet 008D","E01000281","Total",1221,142,63,79,1079,99,52,353,154,74,150,197
"2011","Barnet 008E","E01000282","Total",1705,151,68,83,1554,31,184,437,186,93,254,369
"2011","Barnet 009A","E01000115","Total",1460,70,40,30,1390,32,172,324,88,72,242,460
"2011","Barnet 009B","E01000116","Total",1718,130,69,61,1588,54,152,490,170,131,160,431
"2011","Barnet 009C","E01000119","Total",1680,123,63,60,1557,52,192,408,154,65,213,473
"2011","Barnet 009D","E01000120","Total",1504,87,56,31,1417,38,142,296,94,110,277,460
"2011","Barnet 009E","E01000122","Total",1463,123,63,60,1340,31,118,335,144,83,242,387
"2011","Barnet 010A","E01000117","Total",1819,215,95,120,1604,64,242,409,246,66,211,366
"2011","Barnet 010B","E01000118","Total",1936,165,83,82,1771,87,150,403,188,145,331,467
"2011","Barnet 010C","E01000121","Total",1398,123,31,92,1275,144,64,263,120,116,299,269
"2011","Barnet 010D","E01000123","Total",1664,215,54,161,1449,97,102,341,244,70,227,368
"2011","Barnet 010E","E01000124","Total",1621,216,62,154,1405,127,88,319,228,94,230,319
"2011","Barnet 011A","E01000265","Total",1927,229,80,149,1698,170,114,482,288,108,185,351
"2011","Barnet 011B","E01000266","Total",1511,80,46,34,1431,34,176,310,110,92,230,479
"2011","Barnet 011C","E01000274","Total",1862,177,65,112,1685,134,124,412,204,122,262,427
"2011","Barnet 011D","E01000320","Total",1475,204,101,103,1271,50,172,322,174,69,185,299
"2011","Barnet 011E","E01000322","Total",1675,269,92,177,1406,135,126,327,328,38,127,325
"2011","Barnet 012A","E01000275","Total",1544,193,69,124,1351,43,142,329,228,62,183,364
"2011","Barnet 012B","E01000277","Total",1561,343,135,208,1218,64,118,394,306,47,115,174
"2011","Barnet 012C","E01000283","Total",1430,73,54,19,1357,14,166,320,98,121,276,362
"2011","Barnet 012D","E01000284","Total",1671,292,107,185,1379,141,118,323,328,47,166,256
"2011","Barnet 012E","E01000321","Total",1577,251,72,179,1326,61,74,345,296,31,120,399
"2011","Barnet 013A","E01000195","Total",1788,223,56,167,1565,194,84,334,202,119,332,300
"2011","Barnet 013B","E01000229","Total",1667,136,54,82,1531,117,98,338,180,143,270,385
"2011","Barnet 013C","E01000230","Total",1757,149,101,48,1608,46,222,285,184,204,255,412
"2011","Barnet 013D","E01000231","Total",1849,140,49,91,1709,135,120,413,176,146,338,381
"2011","Barnet 013E","E01000232","Total",1811,196,82,114,1615,43,198,386,198,150,270,370
"2011","Barnet 013F","E01000233","Total",1817,122,40,82,1695,79,134,425,192,133,307,425
"2011","Barnet 014A","E01000186","Total",1612,60,36,24,1552,27,172,327,104,285,234,403
"2011","Barnet 014B","E01000187","Total",1657,135,94,41,1522,93,154,291,140,239,262,343
"2011","Barnet 014C","E01000188","Total",1554,70,48,22,1484,27,164,239,148,172,237,497
"2011","Barnet 014D","E01000189","Total",1814,197,35,162,1617,355,54,380,178,109,247,294
"2011","Barnet 014E","E01000190","Total",1579,117,76,41,1462,60,156,191,168,201,358,328
"2011","Barnet 014F","E01000191","Total",1525,110,74,36,1415,21,176,245,126,180,265,402
"2011","Barnet 015A","E01000158","Total",1455,168,47,121,1287,131,72,284,140,57,220,383
"2011","Barnet 015B","E01000159","Total",1777,131,62,69,1646,102,162,391,180,102,275,434
"2011","Barnet 015C","E01000160","Total",2037,319,51,268,1718,121,94,456,446,84,149,368
"2011","Barnet 015D","E01000161","Total",1752,210,53,157,1542,84,96,327,264,50,165,556
"2011","Barnet 015E","E01000162","Total",1502,142,53,89,1360,68,92,291,146,120,208,435
"2011","Barnet 015F","E01000324","Total",1762,182,70,112,1580,67,136,374,162,118,296,427
"2011","Barnet 016A","E01000256","Total",1788,137,51,86,1651,82,178,423,202,79,292,395
"2011","Barnet 016B","E01000258","Total",1658,224,90,134,1434,82,162,364,222,94,203,307
"2011","Barnet 016C","E01000263","Total",1581,61,39,22,1520,19,160,378,108,168,340,347
"2011","Barnet 016D","E01000264","Total",1648,169,53,116,1479,103,104,341,214,106,254,357
"2011","Barnet 017A","E01000255","Total",1481,123,66,57,1358,55,140,230,146,110,276,401
"2011","Barnet 017B","E01000257","Total",1855,192,93,99,1663,223,98,365,240,167,196,374
"2011","Barnet 017C","E01000261","Total",1513,232,164,68,1281,33,178,335,178,143,172,242
"2011","Barnet 017D","E01000262","Total",2245,146,55,91,2099,140,152,385,238,311,381,492
"2011","Barnet 018A","E01000192","Total",1850,184,85,99,1666,56,188,267,180,190,358,427
"2011","Barnet 018B","E01000193","Total",1709,148,76,72,1561,69,148,219,142,153,349,481
"2011","Barnet 018C","E01000194","Total",1640,148,58,90,1492,102,136,250,180,129,240,455
"2011","Barnet 018D","E01000226","Total",1758,184,93,91,1574,182,88,276,122,158,339,409
"2011","Barnet 018E","E01000227","Total",1805,103,56,47,1702,72,156,312,164,221,293,484
"2011","Barnet 019A","E01000299","Total",1782,255,101,154,1527,94,84,350,394,79,148,378
"2011","Barnet 019B","E01000300","Total",1632,215,79,136,1417,34,110,381,230,82,221,359
"2011","Barnet 019C","E01000302","Total",1728,359,86,273,1369,88,100,386,348,53,124,270
"2011","Barnet 019D","E01000317","Total",1580,212,75,137,1368,54,118,368,216,61,184,367
"2011","Barnet 019E","E01000318","Total",1820,109,52,57,1711,81,158,300,140,121,344,567
"2011","Barnet 019F","E01000323","Total",1916,331,105,226,1585,80,118,344,378,87,221,357
"2011","Barnet 020A","E01000276","Total",1520,79,58,21,1441,14,134,507,98,82,195,411
"2011","Barnet 020B","E01000278","Total",1514,67,49,18,1447,12,144,491,102,145,218,335
"2011","Barnet 020C","E01000301","Total",1508,102,42,60,1406,24,124,459,144,108,210,337
"2011","Barnet 020D","E01000303","Total",1542,102,40,62,1440,28,116,434,166,155,189,352
"2011","Barnet 020E","E01000304","Total",1532,155,42,113,1377,76,80,298,310,46,150,417
"2011","Barnet 021A","E01000130","Total",1603,124,32,92,1479,190,54,252,192,89,322,380
"2011","Barnet 021B","E01000132","Total",1478,94,36,58,1384,182,72,270,120,112,325,303
"2011","Barnet 021C","E01000133","Total",1601,133,57,76,1468,159,98,232,142,135,291,411
"2011","Barnet 021D","E01000234","Total",1701,153,59,94,1548,85,136,453,210,89,181,394
"2011","Barnet 021E","E01000235","Total",1688,115,45,70,1573,162,88,309,158,113,344,399
"2011","Barnet 022A","E01000156","Total",1875,203,67,136,1672,107,128,528,242,52,173,442
"2011","Barnet 022B","E01000157","Total",1541,254,48,206,1287,142,86,321,262,77,128,271
"2011","Barnet 022C","E01000163","Total",1547,318,47,271,1229,198,70,328,240,65,73,255
"2011","Barnet 022D","E01000164","Total",1686,180,52,128,1506,161,68,373,182,100,215,407
"2011","Barnet 022E","E01000165","Total",1862,194,44,150,1668,89,80,478,214,86,240,481
"2011","Barnet 022F","E01000315","Total",1715,144,58,86,1571,198,78,304,128,73,372,418
"2011","Barnet 023A","E01000197","Total",1827,203,48,155,1624,77,100,288,266,143,231,519
"2011","Barnet 023B","E01000295","Total",1703,205,72,133,1498,40,132,380,240,59,196,451
"2011","Barnet 023C","E01000296","Total",1707,210,47,163,1497,99,104,349,360,65,99,421
"2011","Barnet 023D","E01000298","Total",1763,208,71,137,1555,63,110,366,328,36,189,463
"2011","Barnet 024A","E01000125","Total",2690,310,100,210,2380,279,82,457,316,250,465,531
"2011","Barnet 024B","E01000127","Total",1505,102,45,57,1403,157,72,232,132,122,288,400
"2011","Barnet 024C","E01000128","Total",1869,120,58,62,1749,198,120,294,158,170,417,392
"2011","Barnet 024D","E01000129","Total",1715,178,84,94,1537,187,66,286,152,105,317,424
"2011","Barnet 024E","E01000131","Total",1796,154,54,100,1642,82,116,303,178,97,408,458
"2011","Barnet 024F","E01000134","Total",1632,184,66,118,1448,142,74,321,192,121,268,330
"2011","Barnet 025A","E01000198","Total",1893,186,75,111,1707,46,146,408,180,266,261,400
"2011","Barnet 025B","E01000199","Total",1617,225,121,104,1392,25,242,297,160,148,246,274
"2011","Barnet 025C","E01000204","Total",1728,201,76,125,1527,31,148,298,248,120,243,439
"2011","Barnet 025D","E01000259","Total",2597,249,86,163,2348,132,170,627,336,155,412,516
"2011","Barnet 025E","E01000260","Total",1982,193,50,143,1789,159,124,474,272,107,269,384
"2011","Barnet 026A","E01000126","Total",2162,173,42,131,1989,217,60,395,202,211,501,403
"2011","Barnet 026B","E01000151","Total",1711,199,34,165,1512,258,52,314,96,222,325,245
"2011","Barnet 026C","E01000152","Total",1729,89,16,73,1640,338,54,308,148,207,347,238
"2011","Barnet 026D","E01000153","Total",1541,205,56,149,1336,183,92,240,174,135,252,260
"2011","Barnet 026E","E01000154","Total",1360,152,41,111,1208,146,64,200,114,107,260,317
"2011","Barnet 027A","E01000176","Total",1605,271,135,136,1334,114,102,248,228,88,243,311
"2011","Barnet 027B","E01000178","Total",1791,198,86,112,1593,63,158,381,204,137,289,361
"2011","Barnet 027C","E01000184","Total",1414,138,36,102,1276,141,98,196,122,92,294,333
"2011","Barnet 027D","E01000297","Total",1430,166,46,120,1264,40,66,268,230,54,225,381
"2011","Barnet 027E","E01000316","Total",2312,194,49,145,2118,167,112,483,344,76,405,531
"2011","Barnet 027F","E01000319","Total",1500,96,45,51,1404,34,128,391,178,98,208,367
"2011","Barnet 028A","E01000196","Total",1802,346,126,220,1456,93,170,277,434,11,100,371
"2011","Barnet 028B","E01000200","Total",1839,341,180,161,1498,43,244,245,292,144,169,361
"2011","Barnet 028C","E01000201","Total",1531,105,66,39,1426,8,176,179,120,164,336,443
"2011","Barnet 028D","E01000202","Total",1751,160,56,104,1591,47,156,316,216,166,290,400
"2011","Barnet 028E","E01000203","Total",1646,170,75,95,1476,105,138,292,138,146,261,396
"2011","Barnet 029A","E01000177","Total",1628,183,66,117,1445,46,128,412,342,67,95,355
"2011","Barnet 029B","E01000179","Total",1614,286,57,229,1328,45,64,462,370,61,77,249
"2011","Barnet 029C","E01000180","Total",1607,239,153,86,1368,72,102,298,250,95,117,434
"2011","Barnet 029D","E01000181","Total",1711,162,58,104,1549,30,110,432,286,98,136,457
"2011","Barnet 029E","E01000182","Total",1691,253,104,149,1438,36,114,343,334,95,81,435
"2011","Barnet 029F","E01000185","Total",1447,212,67,145,1235,128,68,198,186,108,188,359
"2011","Barnet 030A","E01000147","Total",1732,108,47,61,1624,14,152,201,116,102,424,615
"2011","Barnet 030B","E01000148","Total",1858,247,92,155,1611,118,78,228,224,169,305,489
"2011","Barnet 030D","E01000155","Total",1880,286,39,247,1594,137,40,404,314,134,199,366
"2011","Barnet 030E","E01033572","Total",1588,123,38,85,1465,73,108,270,200,73,272,469
"2011","Barnet 030F","E01033573","Total",1192,260,4,256,932,122,18,203,338,67,46,138
"2011","Barnet 031A","E01000239","Total",1970,325,44,281,1645,98,54,381,390,124,172,426
"2011","Barnet 031B","E01000240","Total",1670,130,52,78,1540,49,140,283,138,92,355,483
"2011","Barnet 031C","E01000241","Total",1744,225,65,160,1519,55,106,294,222,115,239,488
"2011","Barnet 031D","E01000309","Total",1791,141,53,88,1650,45,118,289,172,119,340,567
"2011","Barnet 032A","E01000237","Total",2038,181,75,106,1857,36,94,267,330,194,306,630
"2011","Barnet 032B","E01000242","Total",1592,161,77,84,1431,46,212,261,134,192,245,341
"2011","Barnet 032C","E01000243","Total",1884,278,115,163,1606,60,140,319,288,100,174,525
"2011","Barnet 032D","E01000244","Total",1532,173,53,120,1359,56,96,204,188,103,209,503
"2011","Barnet 032E","E01000245","Total",1982,271,92,179,1711,150,120,295,292,172,258,424
"2011","Barnet 032F","E01000314","Total",1865,137,51,86,1728,35,130,282,244,130,315,592
"2011","Barnet 033A","E01000183","Total",1392,187,92,95,1205,24,100,347,232,125,108,269
"2011","Barnet 033B","E01000206","Total",1490,99,44,55,1391,21,170,192,160,127,395,326
"2011","Barnet 033C","E01000207","Total",1583,149,68,81,1434,51,200,253,192,164,259,315
"2011","Barnet 033D","E01000208","Total",1591,159,62,97,1432,19,196,317,188,164,171,377
"2011","Barnet 033E","E01000210","Total",1548,157,68,89,1391,67,128,455,174,136,165,266
"2011","Barnet 033F","E01000213","Total",1438,82,42,40,1356,33,154,253,76,203,333,304
"2011","Barnet 034A","E01000236","Total",1860,187,72,115,1673,49,144,387,208,350,257,278
"2011","Barnet 034B","E01000238","Total",1961,127,47,80,1834,81,102,335,148,422,265,481
"2011","Barnet 034C","E01000310","Total",1984,131,60,71,1853,43,128,238,330,136,297,681
"2011","Barnet 034D","E01000311","Total",1632,73,43,30,1559,11,154,192,90,433,356,323
"2011","Barnet 035A","E01000205","Total",1522,178,77,101,1344,58,170,509,166,111,124,206
"2011","Barnet 035B","E01000209","Total",1550,309,179,130,1241,43,246,372,184,108,63,225
"2011","Barnet 035C","E01000211","Total",2014,311,120,191,1703,113,106,385,304,59,119,617
"2011","Barnet 035D","E01000212","Total",1428,118,69,49,1310,31,172,225,170,192,152,368
"2011","Barnet 035E","E01000216","Total",1947,182,85,97,1765,31,124,360,222,323,340,365
"2011","Barnet 035F","E01000217","Total",1716,101,27,74,1615,21,122,171,142,399,387,373
"2011","Barnet 036A","E01000150","Total",2056,178,60,118,1878,92,152,346,242,138,332,576
"2011","Barnet 036B","E01000305","Total",1651,222,66,156,1429,96,98,193,146,116,330,450
"2011","Barnet 036C","E01000306","Total",1696,109,25,84,1587,50,98,194,182,96,395,572
"2011","Barnet 036D","E01000308","Total",1516,257,80,177,1259,200,92,242,174,83,164,304
"2011","Barnet 036E","E01000312","Total",1672,258,53,205,1414,125,46,363,244,116,225,295
"2011","Barnet 036F","E01000313","Total",1851,198,55,143,1653,63,86,252,240,118,396,498
"2011","Barnet 037A","E01000145","Total",1473,91,44,47,1382,45,96,186,78,268,264,445
"2011","Barnet 037B","E01000215","Total",2033,206,122,84,1827,48,138,215,162,492,344,428
"2011","Barnet 037C","E01000218","Total",1798,147,59,88,1651,26,114,174,168,406,347,416
"2011","Barnet 037D","E01000219","Total",1897,128,43,85,1769,57,90,244,190,393,361,434
"2011","Barnet 037E","E01000220","Total",1731,193,75,118,1538,13,76,238,150,316,281,464
"2011","Barnet 037F","E01000225","Total",1761,132,88,44,1629,63,142,156,58,527,387,296
"2011","Barnet 038A","E01000135","Total",1493,128,47,81,1365,25,156,203,166,87,325,403
"2011","Barnet 038B","E01000136","Total",1466,142,52,90,1324,37,184,273,164,107,245,314
"2011","Barnet 038C","E01000144","Total",1538,198,57,141,1340,30,76,206,248,115,207,458
"2011","Barnet 038D","E01000146","Total",1715,269,74,195,1446,73,96,185,328,113,178,473
"2011","Barnet 038E","E01000214","Total",1663,226,61,165,1437,46,124,348,316,98,132,373
"2011","Barnet 039A","E01000141","Total",2081,290,42,248,1791,194,54,338,340,99,267,499
"2011","Barnet 039B","E01000221","Total",1279,159,56,103,1120,161,60,168,106,145,225,255
"2011","Barnet 039C","E01000223","Total",1287,144,51,93,1143,101,74,206,116,129,195,322
"2011","Barnet 039D","E01000307","Total",1655,116,66,50,1539,61,96,207,100,100,449,526
"2011","Barnet 040A","E01000138","Total",1449,149,62,87,1300,69,98,211,122,91,330,379
"2011","Barnet 040B","E01000142","Total",2296,313,43,270,1983,177,72,442,368,151,294,479
"2011","Barnet 040C","E01000222","Total",1582,107,45,62,1475,105,86,221,112,166,318,467
"2011","Barnet 040D","E01000224","Total",1559,117,49,68,1442,53,100,206,138,160,359,426
"2011","Barnet 041A","E01000137","Total",1644,216,77,139,1428,202,88,368,190,91,217,272
"2011","Barnet 041B","E01000139","Total",1427,151,55,96,1276,44,120,244,204,88,164,412
"2011","Barnet 041C","E01000140","Total",1606,237,68,169,1369,54,96,248,236,77,156,502
"2011","Barnet 041D","E01000143","Total",1339,175,41,134,1164,118,92,243,150,149,159,253
"2011","Bexley 001A","E01000466","Total",1641,188,39,149,1453,182,72,279,150,143,367,260
"2011","Bexley 001B","E01000467","Total",1634,154,29,125,1480,159,46,353,196,139,338,249
"2011","Bexley 001C","E01000468","Total",2723,173,20,153,2550,322,46,618,254,302,654,354
"2011","Bexley 001D","E01000469","Total",1654,188,36,152,1466,140,82,359,202,129,250,304
"2011","Bexley 002A","E01000416","Total",1505,108,45,63,1397,142,74,268,154,124,310,325
"2011","Bexley 002B","E01000418","Total",1937,214,67,147,1723,139,136,378,238,157,317,358
"2011","Bexley 002C","E01000422","Total",1729,235,41,194,1494,297,44,336,150,101,296,270
"2011","Bexley 002D","E01000464","Total",1443,178,52,126,1265,154,84,193,118,100,290,326
"2011","Bexley 002E","E01000465","Total",1542,306,88,218,1236,172,94,251,182,114,166,257
"2011","Bexley 002F","E01000470","Total",1443,205,34,171,1238,243,60,209,158,113,255,200
"2011","Bexley 003A","E01000333","Total",1653,342,149,193,1311,169,114,309,236,100,145,238
"2011","Bexley 003B","E01000335","Total",1794,149,45,104,1645,254,76,353,184,122,321,335
"2011","Bexley 003C","E01000336","Total",1886,298,91,207,1588,260,64,387,218,87,275,297
"2011","Bexley 003D","E01000337","Total",1653,176,54,122,1477,161,96,356,240,78,238,308
"2011","Bexley 003E","E01000338","Total",1751,209,65,144,1542,143,74,353,244,78,299,351
"2011","Bexley 004A","E01000403","Total",2108,402,198,204,1706,284,176,369,284,94,219,280
"2011","Bexley 004B","E01000404","Total",2234,332,28,304,1902,371,30,514,378,163,239,207
"2011","Bexley 004C","E01000405","Total",1410,143,24,119,1267,143,38,308,164,157,213,244
"2011","Bexley 004D","E01000408","Total",1636,116,36,80,1520,145,68,300,196,123,312,376
"2011","Bexley 005A","E01000332","Total",1529,162,85,77,1367,71,228,214,174,84,264,332
"2011","Bexley 005B","E01000402","Total",1525,225,83,142,1300,145,112,267,214,127,147,288
"2011","Bexley 005C","E01000406","Total",1649,145,40,105,1504,120,86,331,196,139,296,336
"2011","Bexley 005D","E01000407","Total",1441,214,130,84,1227,70,236,165,168,94,143,351
"2011","Bexley 006A","E01000334","Total",1611,175,96,79,1436,84,160,279,220,125,222,346
"2011","Bexley 006B","E01000417","Total",1639,216,73,143,1423,82,190,306,268,94,143,340
"2011","Bexley 006C","E01000419","Total",1461,153,111,42,1308,53,214,297,168,77,157,342
"2011","Bexley 006D","E01000420","Total",1551,137,73,64,1414,79,214,212,186,72,278,373
"2011","Bexley 006E","E01000442","Total",1613,157,109,48,1456,71,210,331,168,94,235,347
"2011","Bexley 007A","E01000437","Total",1322,123,69,54,1199,75,130,273,150,62,184,325
"2011","Bexley 007B","E01000438","Total",1599,128,62,66,1471,114,128,325,218,87,242,357
"2011","Bexley 007C","E01000439","Total",1368,105,38,67,1263,115,92,267,152,125,204,308
"2011","Bexley 007D","E01000440","Total",1413,96,58,38,1317,33,212,246,128,89,214,395
"2011","Bexley 007E","E01000441","Total",1598,196,68,128,1402,212,126,323,200,76,189,276
"2011","Bexley 008A","E01000373","Total",1574,248,48,200,1326,373,44,407,160,115,110,117
"2011","Bexley 008B","E01000429","Total",1639,274,38,236,1365,267,50,378,222,103,171,174
"2011","Bexley 008C","E01000430","Total",1782,160,57,103,1622,203,92,468,232,124,232,271
"2011","Bexley 008D","E01000431","Total",1664,211,28,183,1453,280,86,301,198,119,262,207
"2011","Bexley 008E","E01000432","Total",1673,174,98,76,1499,157,152,332,168,152,261,277
"2011","Bexley 008F","E01000433","Total",1810,210,75,135,1600,305,118,329,198,124,256,270
"2011","Bexley 008G","E01000434","Total",1584,164,79,85,1420,256,84,290,154,161,226,249
"2011","Bexley 009A","E01000356","Total",1546,142,100,42,1404,47,302,247,164,94,153,397
"2011","Bexley 009B","E01000357","Total",1457,68,49,19,1389,28,134,352,150,107,271,347
"2011","Bexley 009C","E01000359","Total",1280,96,59,37,1184,34,186,311,144,52,157,300
"2011","Bexley 009D","E01000421","Total",1482,158,114,44,1324,44,250,316,168,36,189,321
"2011","Bexley 009E","E01000450","Total",1832,143,72,71,1689,88,162,364,156,208,353,358
"2011","Bexley 009F","E01000451","Total",1699,121,58,63,1578,95,156,348,214,122,236,407
"2011","Bexley 009G","E01000452","Total",1428,87,46,41,1341,69,108,343,168,119,223,311
"2011","Bexley 010A","E01000367","Total",1528,175,63,112,1353,117,134,301,160,72,244,325
"2011","Bexley 010B","E01000368","Total",1539,172,71,101,1367,214,130,360,178,47,192,246
"2011","Bexley 010C","E01000372","Total",1645,139,58,81,1506,115,144,245,162,181,276,383
"2011","Bexley 010D","E01000380","Total",1455,369,164,205,1086,124,112,248,242,79,81,200
"2011","Bexley 010E","E01000435","Total",1406,188,89,99,1218,180,128,260,164,76,181,229
"2011","Bexley 011A","E01000353","Total",1686,139,95,44,1547,15,278,286,214,102,231,421
"2011","Bexley 011B","E01000354","Total",1505,182,97,85,1323,83,154,334,186,53,215,298
"2011","Bexley 011C","E01000355","Total",1436,164,116,48,1272,36,252,263,202,40,152,327
"2011","Bexley 011D","E01000358","Total",1608,163,92,71,1445,63,200,356,218,41,162,405
"2011","Bexley 011E","E01000436","Total",1685,97,65,32,1588,21,226,391,208,100,228,414
"2011","Bexley 013A","E01000401","Total",1584,192,99,93,1392,134,126,228,204,114,235,351
"2011","Bexley 013B","E01000453","Total",1472,88,44,44,1384,53,144,330,166,97,270,324
"2011","Bexley 013C","E01000454","Total",1572,180,96,84,1392,70,168,301,196,75,230,352
"2011","Bexley 013D","E01000455","Total",1705,113,69,44,1592,48,160,389,188,102,281,424
"2011","Bexley 013E","E01000456","Total",1427,69,41,28,1358,70,122,351,138,106,228,343
"2011","Bexley 014A","E01000325","Total",1610,105,67,38,1505,49,170,379,178,93,188,448
"2011","Bexley 014B","E01000326","Total",1295,130,39,91,1165,104,116,348,252,62,103,180
"2011","Bexley 014C","E01000369","Total",1618,134,60,74,1484,90,168,288,248,99,186,405
"2011","Bexley 014D","E01000370","Total",1597,164,97,67,1433,32,242,369,204,92,169,325
"2011","Bexley 014E","E01000371","Total",1545,165,73,92,1380,52,172,350,234,64,182,326
"2011","Bexley 015A","E01000360","Total",1580,200,60,140,1380,113,104,322,248,123,169,301
"2011","Bexley 015B","E01000362","Total",1482,199,136,63,1283,55,184,243,194,96,172,339
"2011","Bexley 015C","E01000365","Total",1612,229,131,98,1383,94,200,285,236,85,208,275
"2011","Bexley 015D","E01000366","Total",1581,169,75,94,1412,62,150,360,280,119,104,337
"2011","Bexley 015E","E01000394","Total",1458,196,105,91,1262,36,202,349,184,74,163,254
"2011","Bexley 016A","E01000388","Total",1531,155,97,58,1376,38,272,254,190,80,222,320
"2011","Bexley 016B","E01000392","Total",1646,227,68,159,1419,218,90,342,196,108,154,311
"2011","Bexley 016C","E01000409","Total",1649,135,77,58,1514,39,212,408,246,62,209,338
"2011","Bexley 016D","E01000411","Total",1398,129,82,47,1269,52,144,304,200,71,170,328
"2011","Bexley 016E","E01000414","Total",1708,206,121,85,1502,72,150,343,172,102,236,427
"2011","Bexley 016F","E01000415","Total",1498,83,50,33,1415,33,160,222,144,86,293,477
"2011","Bexley 017A","E01000327","Total",1543,140,97,43,1403,51,228,292,184,96,183,369
"2011","Bexley 017B","E01000328","Total",1470,154,87,67,1316,49,178,352,196,53,168,320
"2011","Bexley 017C","E01000329","Total",1299,145,79,66,1154,65,130,228,152,72,200,307
"2011","Bexley 017D","E01000330","Total",1544,354,197,157,1190,97,156,241,226,53,141,276
"2011","Bexley 017E","E01000331","Total",1630,146,83,63,1484,108,202,308,174,124,239,329
"2011","Bexley 018A","E01000340","Total",1502,165,93,72,1337,61,200,337,216,68,163,292
"2011","Bexley 018B","E01000395","Total",1428,86,60,26,1342,26,186,265,128,57,249,431
"2011","Bexley 018C","E01000396","Total",1399,101,61,40,1298,47,148,282,138,82,226,375
"2011","Bexley 018D","E01000410","Total",1568,131,67,64,1437,76,164,316,180,98,212,391
"2011","Bexley 018E","E01000412","Total",1678,146,73,73,1532,71,132,422,214,83,258,352
"2011","Bexley 018F","E01000413","Total",1301,116,56,60,1185,75,122,269,188,36,235,260
"2011","Bexley 019A","E01000374","Total",1533,124,61,63,1409,201,116,331,102,120,292,247
"2011","Bexley 019B","E01000375","Total",1476,137,56,81,1339,85,108,295,212,107,255,277
"2011","Bexley 019C","E01000376","Total",1541,154,81,73,1387,99,120,397,222,119,175,255
"2011","Bexley 019D","E01000377","Total",1420,222,101,121,1198,65,194,283,210,64,99,283
"2011","Bexley 019E","E01000378","Total",2100,398,148,250,1702,114,168,437,340,125,204,314
"2011","Bexley 019F","E01000379","Total",1680,194,72,122,1486,109,150,377,182,127,263,278
"2011","Bexley 020A","E01000348","Total",1481,76,49,27,1405,25,188,333,162,96,215,386
"2011","Bexley 020B","E01000349","Total",1659,151,104,47,1508,37,254,388,192,116,196,325
"2011","Bexley 020C","E01000361","Total",1540,158,67,91,1382,76,108,358,200,66,192,382
"2011","Bexley 020D","E01000363","Total",1441,137,79,58,1304,41,152,236,210,52,241,372
"2011","Bexley 020E","E01000389","Total",1649,215,95,120,1434,98,228,245,252,72,180,359
"2011","Bexley 020F","E01000390","Total",1284,141,88,53,1143,36,184,220,146,58,192,307
"2011","Bexley 020G","E01000393","Total",1581,175,83,92,1406,61,124,361,228,53,198,381
"2011","Bexley 021A","E01000346","Total",1622,146,76,70,1476,71,160,398,196,89,211,351
"2011","Bexley 021B","E01000347","Total",1486,188,115,73,1298,114,136,307,192,70,156,323
"2011","Bexley 021C","E01000350","Total",1501,88,44,44,1413,91,164,265,128,56,276,433
"2011","Bexley 021D","E01000352","Total",1575,218,100,118,1357,101,176,328,188,87,173,304
"2011","Bexley 021E","E01000391","Total",1709,141,74,67,1568,101,166,398,206,68,237,392
"2011","Bexley 022A","E01000341","Total",1485,164,104,60,1321,57,250,346,138,82,132,316
"2011","Bexley 022B","E01000342","Total",1595,158,67,91,1437,57,150,457,234,56,138,345
"2011","Bexley 022C","E01000343","Total",1535,99,52,47,1436,40,168,388,156,118,213,353
"2011","Bexley 022D","E01000345","Total",1355,86,47,39,1269,72,122,309,130,59,190,387
"2011","Bexley 022E","E01000460","Total",1353,82,24,58,1271,29,132,253,210,55,206,386
"2011","Bexley 023A","E01000364","Total",1577,182,86,96,1395,55,240,288,180,110,156,366
"2011","Bexley 023B","E01000444","Total",1631,122,72,50,1509,43,288,308,206,62,254,348
"2011","Bexley 023C","E01000447","Total",1534,272,120,152,1262,83,136,376,252,76,121,218
"2011","Bexley 023D","E01000448","Total",1335,80,58,22,1255,13,240,314,160,88,131,309
"2011","Bexley 023E","E01000449","Total",1482,210,149,61,1272,37,238,290,190,88,117,312
"2011","Bexley 024A","E01000351","Total",1586,128,75,53,1458,47,234,324,196,71,244,342
"2011","Bexley 024B","E01000443","Total",1276,142,71,71,1134,25,162,318,134,93,151,251
"2011","Bexley 024C","E01000445","Total",1641,182,110,72,1459,36,310,340,170,76,182,345
"2011","Bexley 024D","E01000446","Total",1572,121,44,77,1451,53,148,384,252,127,140,347
"2011","Bexley 024E","E01000461","Total",1662,76,55,21,1586,36,206,271,150,132,229,562
"2011","Bexley 025A","E01000339","Total",1530,145,88,57,1385,81,192,329,180,55,209,339
"2011","Bexley 025B","E01000344","Total",1609,169,95,74,1440,65,206,411,190,97,150,321
"2011","Bexley 025C","E01000423","Total",1625,121,87,34,1504,30,216,432,192,68,210,356
"2011","Bexley 025D","E01000425","Total",1617,99,64,35,1518,33,220,373,184,104,224,380
"2011","Bexley 025E","E01000463","Total",1254,72,39,33,1182,32,136,321,142,58,176,317
"2011","Bexley 026A","E01000424","Total",1628,282,111,171,1346,27,202,256,316,78,155,312
"2011","Bexley 026B","E01000426","Total",1675,215,96,119,1460,87,144,389,276,87,164,313
"2011","Bexley 026C","E01000427","Total",1932,372,226,146,1560,109,230,347,282,74,177,341
"2011","Bexley 026D","E01000457","Total",1703,347,153,194,1356,95,130,302,328,46,95,360
"2011","Bexley 026E","E01000462","Total",1531,299,143,156,1232,73,166,288,242,25,110,328
"2011","Bexley 027A","E01000382","Total",1524,128,84,44,1396,43,232,291,182,110,201,337
"2011","Bexley 027B","E01000384","Total",1722,282,155,127,1440,83,164,376,264,84,135,334
"2011","Bexley 027C","E01000387","Total",1535,149,90,59,1386,62,218,294,218,85,199,310
"2011","Bexley 027D","E01000428","Total",1627,467,167,300,1160,100,134,205,268,53,110,290
"2011","Bexley 027E","E01000458","Total",1459,209,140,69,1250,26,224,268,174,45,177,336
"2011","Bexley 027F","E01000459","Total",1675,336,200,136,1339,68,214,266,198,60,233,300
"2011","Bexley 028A","E01000381","Total",1579,207,86,121,1372,116,164,375,194,89,199,235
"2011","Bexley 028B","E01000383","Total",1505,176,92,84,1329,58,240,215,226,98,204,288
"2011","Bexley 028C","E01000385","Total",1866,217,60,157,1649,277,150,353,252,186,174,257
"2011","Bexley 028D","E01000386","Total",1457,270,118,152,1187,181,112,257,144,126,113,254
"2011","Bexley 029A","E01000398","Total",1599,142,64,78,1457,104,188,273,186,71,303,332
"2011","Bexley 029B","E01000399","Total",1554,170,113,57,1384,61,194,257,174,35,278,385
"2011","Bexley 029C","E01000400","Total",1547,146,75,71,1401,53,152,311,194,93,241,357
"2011","Bexley 029D","E01032566","Total",1684,258,112,146,1426,146,190,276,222,84,193,315
"2011","Brent 001A","E01000587","Total",1653,56,29,27,1597,53,110,151,74,66,572,571
"2011","Brent 001B","E01000589","Total",1884,98,36,62,1786,29,128,327,112,128,414,648
"2011","Brent 001C","E01000590","Total",1789,166,76,90,1623,60,138,276,130,86,410,523
"2011","Brent 001D","E01000592","Total",1618,116,39,77,1502,58,106,180,94,62,419,583
"2011","Brent 001E","E01000593","Total",2134,110,36,74,2024,127,112,352,156,159,445,673
"2011","Brent 001F","E01000594","Total",1698,110,53,57,1588,70,94,270,78,110,382,584
"2011","Brent 002A","E01000513","Total",1638,68,39,29,1570,23,98,236,98,138,503,474
"2011","Brent 002B","E01000514","Total",1512,108,36,72,1404,73,60,285,114,79,373,420
"2011","Brent 002C","E01000516","Total",1691,93,33,60,1598,50,114,203,90,116,424,601
"2011","Brent 002D","E01000520","Total",1602,160,80,80,1442,77,122,292,128,92,322,409
"2011","Brent 002E","E01000588","Total",2197,118,34,84,2079,180,80,280,124,182,586,647
"2011","Brent 003A","E01000515","Total",1698,193,65,128,1505,96,74,316,156,62,406,395
"2011","Brent 003B","E01000517","Total",1609,82,45,37,1527,28,134,192,96,63,474,540
"2011","Brent 003E","E01000543","Total",1596,86,39,47,1510,41,118,207,104,85,400,555
"2011","Brent 003F","E01000591","Total",2075,133,45,88,1942,60,140,242,110,100,546,744
"2011","Brent 003G","E01033463","Total",2805,128,68,60,2677,44,228,277,120,139,726,1143
"2011","Brent 004A","E01000536","Total",1561,112,66,46,1449,46,134,173,118,67,346,565
"2011","Brent 004B","E01000538","Total",1554,66,43,23,1488,12,148,204,112,115,428,469
"2011","Brent 004C","E01000539","Total",1541,136,90,46,1405,27,134,221,122,53,277,571
"2011","Brent 004D","E01000540","Total",1477,68,47,21,1409,28,158,196,102,61,298,566
"2011","Brent 004E","E01000541","Total",1402,122,73,49,1280,56,100,251,136,54,278,405
"2011","Brent 005A","E01000518","Total",1662,119,55,64,1543,73,104,229,136,174,349,478
"2011","Brent 005B","E01000519","Total",1923,157,85,72,1766,68,100,284,140,188,498,488
"2011","Brent 005C","E01000623","Total",1772,90,42,48,1682,51,106,272,112,115,421,605
"2011","Brent 005D","E01000624","Total",1690,150,71,79,1540,62,168,245,144,90,444,387
"2011","Brent 005E","E01000629","Total",1911,119,54,65,1792,53,116,208,156,129,470,660
"2011","Brent 006A","E01000480","Total",1741,91,43,48,1650,40,132,212,106,109,439,612
"2011","Brent 006B","E01000484","Total",1228,111,39,72,1117,96,58,186,106,103,275,293
"2011","Brent 006C","E01000485","Total",1371,139,76,63,1232,42,100,222,104,57,271,436
"2011","Brent 006D","E01000486","Total",1702,99,42,57,1603,31,120,222,114,147,454,515
"2011","Brent 006E","E01000487","Total",1875,204,98,106,1671,53,120,224,170,138,397,569
"2011","Brent 007A","E01000572","Total",1481,84,51,33,1397,60,84,240,82,64,350,517
"2011","Brent 007B","E01000573","Total",1591,89,54,35,1502,14,108,181,76,155,469,499
"2011","Brent 007C","E01000574","Total",1355,79,45,34,1276,60,78,211,72,91,318,446
"2011","Brent 007D","E01000575","Total",1855,141,33,108,1714,72,96,250,196,139,407,554
"2011","Brent 007E","E01000577","Total",2369,161,25,136,2208,226,52,563,278,199,488,402
"2011","Brent 008A","E01000562","Total",1543,75,34,41,1468,34,120,169,108,86,381,570
"2011","Brent 008B","E01000563","Total",1480,67,41,26,1413,17,156,142,114,54,374,556
"2011","Brent 008C","E01000566","Total",1531,78,41,37,1453,37,136,182,94,86,392,526
"2011","Brent 008D","E01000568","Total",1599,439,30,409,1160,27,74,211,170,52,223,403
"2011","Brent 008E","E01000569","Total",1565,51,26,25,1514,16,138,212,108,97,356,587
"2011","Brent 009A","E01000479","Total",1620,102,50,52,1518,37,138,165,104,116,443,515
"2011","Brent 009B","E01000481","Total",1538,185,55,130,1353,127,76,266,188,72,261,363
"2011","Brent 009C","E01000482","Total",2790,290,78,212,2500,259,68,487,280,241,565,600
"2011","Brent 009D","E01000483","Total",1745,191,58,133,1554,146,64,370,158,171,294,351
"2011","Brent 009E","E01000625","Total",1469,173,81,92,1296,66,120,230,148,90,297,345
"2011","Brent 010B","E01000498","Total",1680,77,25,52,1603,82,90,150,56,234,588,403
"2011","Brent 010D","E01000622","Total",1585,215,60,155,1370,102,62,331,208,111,223,333
"2011","Brent 010E","E01000626","Total",1500,193,65,128,1307,159,48,273,164,152,283,228
"2011","Brent 010F","E01033464","Total",3018,139,74,65,2879,134,162,194,88,481,897,923
"2011","Brent 011A","E01000497","Total",1756,146,41,105,1610,93,98,207,162,122,367,561
"2011","Brent 011B","E01000499","Total",1732,69,37,32,1663,112,110,161,112,223,528,417
"2011","Brent 011C","E01000501","Total",1874,230,68,162,1644,225,106,353,188,150,317,305
"2011","Brent 011D","E01000502","Total",1375,115,45,70,1260,91,72,256,74,123,310,334
"2011","Brent 011E","E01000503","Total",1968,196,65,131,1772,128,154,258,186,115,382,549
"2011","Brent 012A","E01000570","Total",1578,103,41,62,1475,97,86,212,122,85,401,472
"2011","Brent 012B","E01000571","Total",1666,69,31,38,1597,57,108,155,104,103,491,579
"2011","Brent 012C","E01000576","Total",1660,121,67,54,1539,39,114,149,118,76,483,560
"2011","Brent 012D","E01000578","Total",1761,233,132,101,1528,81,144,226,164,76,302,535
"2011","Brent 013A","E01000564","Total",1557,82,29,53,1475,49,60,265,98,93,478,432
"2011","Brent 013B","E01000565","Total",1467,127,33,94,1340,64,84,219,88,72,319,494
"2011","Brent 013C","E01000607","Total",2214,141,60,81,2073,74,114,271,104,179,673,658
"2011","Brent 013D","E01000608","Total",2263,164,67,97,2099,115,112,389,138,146,562,637
"2011","Brent 013E","E01000613","Total",1659,188,46,142,1471,107,60,312,216,97,320,359
"2011","Brent 014A","E01000506","Total",1671,219,39,180,1452,177,48,294,192,124,191,426
"2011","Brent 014B","E01000509","Total",1453,87,35,52,1366,56,110,85,72,148,387,508
"2011","Brent 014C","E01000510","Total",1673,105,31,74,1568,143,98,240,108,108,419,452
"2011","Brent 014D","E01000511","Total",1629,129,36,93,1500,160,62,254,114,123,368,419
"2011","Brent 014E","E01000627","Total",1900,177,43,134,1723,157,76,210,152,249,366,513
"2011","Brent 014F","E01000628","Total",1882,186,47,139,1696,123,62,233,122,176,411,569
"2011","Brent 015A","E01000553","Total",2096,168,30,138,1928,108,46,305,218,77,444,730
"2011","Brent 015B","E01000554","Total",1857,172,41,131,1685,152,66,326,240,103,281,517
"2011","Brent 015C","E01000555","Total",1497,124,32,92,1373,56,110,184,136,108,284,495
"2011","Brent 015D","E01000556","Total",1869,312,28,284,1557,144,28,217,344,89,230,505
"2011","Brent 015E","E01000557","Total",1841,241,43,198,1600,67,76,270,308,48,279,552
"2011","Brent 015F","E01000558","Total",1465,259,49,210,1206,68,70,219,290,37,134,388
"2011","Brent 016A","E01000567","Total",1372,125,65,60,1247,50,98,252,116,79,266,386
"2011","Brent 016B","E01000606","Total",1703,154,81,73,1549,89,82,207,140,155,367,509
"2011","Brent 016C","E01000609","Total",2075,113,36,77,1962,95,104,309,120,149,592,593
"2011","Brent 016D","E01000611","Total",1415,111,39,72,1304,44,78,169,78,70,343,522
"2011","Brent 017B","E01000615","Total",1603,107,23,84,1496,80,92,283,216,103,291,431
"2011","Brent 017C","E01000617","Total",1741,118,69,49,1623,22,80,156,110,120,461,674
"2011","Brent 017D","E01000618","Total",1639,107,74,33,1532,63,126,104,88,178,456,517
"2011","Brent 017E","E01000619","Total",1652,58,34,24,1594,51,118,143,84,161,388,649
"2011","Brent 017F","E01033424","Total",1358,262,26,236,1096,135,12,252,298,100,107,192
"2011","Brent 017G","E01033457","Total",1700,120,33,87,1580,47,82,344,156,72,351,528
"2011","Brent 018A","E01000504","Total",1676,222,42,180,1454,71,76,251,276,83,162,535
"2011","Brent 018B","E01000505","Total",1660,124,37,87,1536,88,98,152,96,150,372,580
"2011","Brent 018C","E01000507","Total",1634,81,41,40,1553,55,118,155,126,124,357,618
"2011","Brent 018D","E01000512","Total",1702,157,32,125,1545,68,64,258,216,77,222,640
"2011","Brent 018E","E01000559","Total",1411,234,71,163,1177,53,40,215,364,25,73,407
"2011","Brent 019A","E01000610","Total",1870,159,52,107,1711,76,88,312,124,131,457,523
"2011","Brent 019B","E01000612","Total",1652,113,44,69,1539,34,98,199,114,142,432,520
"2011","Brent 019C","E01000631","Total",1882,78,33,45,1804,45,102,203,82,47,601,724
"2011","Brent 019D","E01000633","Total",1949,93,37,56,1856,22,98,209,124,58,593,752
"2011","Brent 019E","E01000634","Total",2343,123,29,94,2220,115,60,346,168,187,694,650
"2011","Brent 020A","E01000616","Total",1747,146,45,101,1601,55,74,226,166,62,371,647
"2011","Brent 020B","E01000620","Total",1637,90,38,52,1547,54,110,141,96,86,475,585
"2011","Brent 020C","E01000621","Total",1774,88,32,56,1686,59,86,186,74,110,541,630
"2011","Brent 020D","E01000635","Total",2392,174,28,146,2218,126,94,294,202,95,601,806
"2011","Brent 020E","E01000636","Total",1776,88,32,56,1688,26,94,205,80,35,440,808
"2011","Brent 021A","E01000596","Total",1694,213,79,134,1481,281,72,206,106,167,313,336
"2011","Brent 021B","E01000601","Total",1505,105,29,76,1400,230,46,191,96,193,376,268
"2011","Brent 021C","E01000602","Total",1541,143,40,103,1398,143,54,162,86,169,419,365
"2011","Brent 021D","E01000603","Total",1487,162,31,131,1325,243,52,314,154,107,180,275
"2011","Brent 021E","E01000604","Total",1766,122,32,90,1644,162,74,179,114,217,473,425
"2011","Brent 021F","E01000605","Total",1662,131,42,89,1531,186,74,190,100,176,411,394
"2011","Brent 022A","E01000488","Total",1573,125,31,94,1448,98,68,283,160,122,277,440
"2011","Brent 022B","E01000637","Total",1675,200,48,152,1475,102,70,238,204,83,260,518
"2011","Brent 022C","E01000639","Total",1757,228,39,189,1529,61,60,262,344,88,155,559
"2011","Brent 022D","E01000642","Total",2044,342,55,287,1702,79,60,280,468,60,204,551
"2011","Brent 022E","E01000644","Total",1948,208,67,141,1740,132,64,322,274,86,332,530
"2011","Brent 023A","E01000490","Total",1606,316,36,280,1290,81,48,306,436,34,67,318
"2011","Brent 023B","E01000494","Total",1699,281,100,181,1418,74,66,203,264,82,212,517
"2011","Brent 023C","E01000495","Total",1574,455,155,300,1119,83,68,173,322,54,91,328
"2011","Brent 023D","E01000560","Total",1614,258,50,208,1356,64,66,226,338,79,84,499
"2011","Brent 023E","E01000561","Total",1805,320,70,250,1485,110,68,313,372,111,92,419
"2011","Brent 024A","E01000638","Total",1939,219,35,184,1720,208,58,313,168,88,301,584
"2011","Brent 024B","E01000640","Total",2123,250,38,212,1873,167,70,310,284,112,425,505
"2011","Brent 024C","E01000641","Total",1945,203,50,153,1742,206,44,293,204,125,314,556
"2011","Brent 024D","E01000643","Total",2139,306,115,191,1833,216,74,344,200,177,392,430
"2011","Brent 025A","E01000508","Total",1961,227,73,154,1734,171,86,262,162,186,438,429
"2011","Brent 025B","E01000521","Total",2167,351,47,304,1816,274,74,347,244,177,327,373
"2011","Brent 025C","E01000522","Total",1923,184,53,131,1739,247,88,378,158,161,315,392
"2011","Brent 025D","E01000526","Total",2226,260,67,193,1966,303,80,264,174,197,477,471
"2011","Brent 025E","E01000527","Total",2174,264,60,204,1910,303,88,360,166,194,359,440
"2011","Brent 025F","E01000528","Total",1493,244,54,190,1249,158,60,217,106,122,318,268
"2011","Brent 026A","E01000471","Total",1638,66,24,42,1572,45,94,210,102,68,574,479
"2011","Brent 026B","E01000474","Total",1999,65,34,31,1934,28,62,162,88,119,865,610
"2011","Brent 026C","E01000476","Total",1618,56,33,23,1562,19,106,149,86,54,523,625
"2011","Brent 026D","E01000477","Total",1910,171,42,129,1739,113,64,379,176,107,448,452
"2011","Brent 026E","E01000630","Total",2254,219,41,178,2035,154,120,271,174,119,536,661
"2011","Brent 027A","E01000595","Total",1685,177,38,139,1508,257,54,214,104,137,431,311
"2011","Brent 027D","E01000599","Total",1308,146,57,89,1162,111,58,220,150,92,288,243
"2011","Brent 027E","E01000600","Total",2029,286,75,211,1743,201,54,382,182,164,426,334
"2011","Brent 027F","E01033456","Total",2200,230,87,143,1970,253,70,248,116,252,574,457
"2011","Brent 028A","E01000545","Total",1809,338,62,276,1471,89,62,231,444,43,109,493
"2011","Brent 028B","E01000546","Total",1645,285,65,220,1360,109,80,280,362,44,111,374
"2011","Brent 028C","E01000547","Total",1780,271,43,228,1509,107,82,343,322,31,187,437
"2011","Brent 028D","E01000548","Total",2034,442,77,365,1592,86,90,208,516,93,136,463
"2011","Brent 028E","E01000549","Total",1936,305,55,250,1631,103,76,388,486,82,136,360
"2011","Brent 029A","E01000472","Total",1346,146,29,117,1200,53,46,280,204,57,196,364
"2011","Brent 029B","E01000473","Total",1883,98,46,52,1785,42,72,148,84,47,668,724
"2011","Brent 029C","E01000475","Total",1976,102,39,63,1874,80,90,270,118,97,528,691
"2011","Brent 029D","E01000478","Total",1640,64,24,40,1576,51,94,104,72,91,603,561
"2011","Brent 029E","E01000632","Total",2087,73,32,41,2014,27,116,168,74,87,736,806
"2011","Brent 030A","E01000489","Total",1581,180,96,84,1401,58,94,211,166,109,254,509
"2011","Brent 030B","E01000491","Total",1989,297,85,212,1692,100,94,297,276,184,316,425
"2011","Brent 030C","E01000492","Total",1306,116,38,78,1190,26,104,206,120,76,205,453
"2011","Brent 030D","E01000493","Total",1637,129,52,77,1508,69,126,251,186,101,247,528
"2011","Brent 030E","E01000581","Total",1550,164,42,122,1386,84,56,353,242,132,136,383
"2011","Brent 031A","E01000523","Total",2610,313,60,253,2297,260,78,446,318,260,364,571
"2011","Brent 031B","E01000524","Total",2499,391,60,331,2108,396,78,373,276,137,428,420
"2011","Brent 031C","E01000525","Total",1986,276,60,216,1710,242,52,300,214,139,392,371
"2011","Brent 031E","E01000533","Total",2259,355,70,285,1904,252,66,428,294,121,312,431
"2011","Brent 031F","E01000535","Total",2170,243,43,200,1927,136,70,402,298,88,378,555
"2011","Brent 031G","E01033455","Total",1151,203,27,176,948,113,40,189,156,101,150,199
"2011","Brent 031H","E01033485","Total",1982,288,52,236,1694,221,86,298,180,103,342,464
"2011","Brent 032A","E01000579","Total",1659,204,43,161,1455,120,84,250,284,43,182,492
"2011","Brent 032B","E01000580","Total",1944,269,69,200,1675,110,112,420,312,129,166,426
"2011","Brent 032C","E01000582","Total",1847,198,43,155,1649,109,94,457,258,105,160,466
"2011","Brent 032D","E01000583","Total",2262,365,57,308,1897,92,94,405,522,92,176,516
"2011","Brent 032E","E01000586","Total",2456,378,52,326,2078,206,48,294,612,107,235,576
"2011","Brent 033A","E01000530","Total",1823,181,42,139,1642,108,128,264,242,77,242,581
"2011","Brent 033B","E01000531","Total",2070,323,72,251,1747,151,88,365,344,121,199,479
"2011","Brent 033C","E01000532","Total",1630,304,39,265,1326,72,94,226,236,60,208,430
"2011","Brent 033D","E01000534","Total",1771,187,51,136,1584,104,78,304,178,124,339,457
"2011","Brent 033E","E01000584","Total",1695,149,51,98,1546,88,106,312,206,82,233,519
"2011","Brent 033F","E01000585","Total",1814,200,23,177,1614,97,90,365,292,131,180,459
"2011","Brent 034A","E01000544","Total",1777,295,41,254,1482,148,34,233,266,147,346,308
"2011","Brent 034B","E01000550","Total",1941,363,86,277,1578,192,76,304,386,81,197,342
"2011","Brent 034C","E01000551","Total",2203,394,75,319,1809,307,96,323,208,269,282,324
"2011","Brent 034D","E01000552","Total",1817,349,88,261,1468,198,78,326,168,201,240,257
"2011","Bromley 001A","E01000779","Total",1185,189,67,122,996,36,144,229,224,40,103,220
"2011","Bromley 001B","E01000780","Total",1480,188,83,105,1292,177,142,240,230,95,151,257
"2011","Bromley 001C","E01000781","Total",1445,190,71,119,1255,216,104,310,190,103,145,187
"2011","Bromley 001D","E01000782","Total",1441,262,82,180,1179,216,110,227,136,71,218,201
"2011","Bromley 001E","E01000783","Total",1503,188,83,105,1315,227,116,336,180,73,181,202
"2011","Bromley 001F","E01000785","Total",1381,216,84,132,1165,162,116,271,184,69,153,210
"2011","Bromley 002A","E01000689","Total",1339,232,98,134,1107,104,118,242,214,47,165,217
"2011","Bromley 002B","E01000690","Total",1402,117,73,44,1285,50,156,374,160,66,169,310
"2011","Bromley 002C","E01000691","Total",1420,209,103,106,1211,86,150,358,178,48,140,251
"2011","Bromley 002D","E01000692","Total",1565,184,77,107,1381,107,158,393,246,63,125,289
"2011","Bromley 002E","E01000784","Total",1504,130,49,81,1374,73,118,430,214,107,144,288
"2011","Bromley 004A","E01000799","Total",1642,254,48,206,1388,148,98,310,256,72,202,302
"2011","Bromley 004B","E01000802","Total",1729,277,55,222,1452,93,78,348,288,101,257,287
"2011","Bromley 004C","E01000803","Total",1587,273,72,201,1314,118,96,330,304,72,157,237
"2011","Bromley 004D","E01000804","Total",1426,128,58,70,1298,39,164,280,184,103,203,325
"2011","Bromley 004E","E01000805","Total",1505,280,83,197,1225,132,110,291,274,61,134,223
"2011","Bromley 005A","E01000740","Total",1734,424,43,381,1310,151,34,368,306,123,144,184
"2011","Bromley 005B","E01000741","Total",1586,427,47,380,1159,154,50,247,338,32,156,182
"2011","Bromley 005C","E01000742","Total",1996,505,40,465,1491,256,32,320,446,52,151,234
"2011","Bromley 005D","E01000745","Total",1720,380,59,321,1340,187,68,329,446,52,118,140
"2011","Bromley 005E","E01000746","Total",1858,424,76,348,1434,169,82,363,418,58,129,215
"2011","Bromley 006A","E01000709","Total",1296,463,195,268,833,45,110,212,262,21,45,138
"2011","Bromley 006B","E01000710","Total",1583,391,109,282,1192,78,112,288,438,26,56,194
"2011","Bromley 006C","E01000711","Total",1683,531,145,386,1152,41,124,239,550,30,31,137
"2011","Bromley 006D","E01000714","Total",1863,491,125,366,1372,104,120,298,538,30,82,200
"2011","Bromley 006E","E01000718","Total",2061,386,99,287,1675,276,124,346,358,127,202,242
"2011","Bromley 007A","E01000645","Total",1375,100,48,52,1275,21,236,311,172,71,187,277
"2011","Bromley 007B","E01000649","Total",1899,212,104,108,1687,64,214,428,266,96,289,330
"2011","Bromley 007C","E01000694","Total",1589,138,93,45,1451,28,272,433,182,74,139,323
"2011","Bromley 007D","E01000695","Total",1469,154,81,73,1315,52,202,329,238,110,97,287
"2011","Bromley 007E","E01000696","Total",1460,196,99,97,1264,41,260,314,182,82,166,219
"2011","Bromley 007F","E01000697","Total",1611,288,100,188,1323,30,192,359,316,63,128,235
"2011","Bromley 008A","E01000674","Total",1545,377,167,210,1168,66,100,347,310,50,103,192
"2011","Bromley 008B","E01000676","Total",1729,367,122,245,1362,159,102,340,362,32,155,212
"2011","Bromley 008C","E01000820","Total",1346,262,86,176,1084,80,108,325,222,68,80,201
"2011","Bromley 008D","E01000822","Total",1570,267,80,187,1303,111,96,376,314,57,117,232
"2011","Bromley 008E","E01000823","Total",1671,257,59,198,1414,91,104,394,328,98,131,268
"2011","Bromley 008F","E01000824","Total",1206,166,35,131,1040,72,62,338,208,32,146,182
"2011","Bromley 008G","E01000825","Total",1547,360,119,241,1187,110,124,339,330,52,93,139
"2011","Bromley 009A","E01000743","Total",1703,378,85,293,1325,279,82,328,240,46,102,248
"2011","Bromley 009B","E01000744","Total",1484,296,72,224,1188,257,46,222,176,58,171,258
"2011","Bromley 009C","E01000796","Total",1630,184,39,145,1446,229,72,282,190,136,281,256
"2011","Bromley 009D","E01000798","Total",1464,314,72,242,1150,231,50,172,176,74,193,254
"2011","Bromley 009E","E01000800","Total",1612,356,40,316,1256,170,44,323,288,63,185,183
"2011","Bromley 009F","E01000806","Total",1721,301,48,253,1420,231,32,323,278,96,233,227
"2011","Bromley 010A","E01000693","Total",1257,199,125,74,1058,28,200,283,182,46,118,201
"2011","Bromley 010B","E01000698","Total",1177,71,51,20,1106,30,210,182,108,43,167,366
"2011","Bromley 010C","E01000736","Total",1560,179,76,103,1381,118,146,336,146,110,221,304
"2011","Bromley 010D","E01000737","Total",1329,203,89,114,1126,148,142,218,164,77,191,186
"2011","Bromley 011A","E01000672","Total",1461,208,72,136,1253,62,178,327,246,110,106,224
"2011","Bromley 011B","E01000673","Total",1562,174,63,111,1388,56,140,427,232,101,181,251
"2011","Bromley 011C","E01000716","Total",1463,280,105,175,1183,37,214,266,218,52,137,259
"2011","Bromley 011D","E01000717","Total",1609,427,116,311,1182,70,152,249,390,26,86,209
"2011","Bromley 011E","E01000828","Total",1584,305,145,160,1279,42,192,328,278,89,138,212
"2011","Bromley 012A","E01000712","Total",1641,370,121,249,1271,46,188,280,428,32,113,184
"2011","Bromley 012B","E01000713","Total",1693,383,100,283,1310,74,170,313,390,53,78,232
"2011","Bromley 012C","E01000715","Total",1648,408,159,249,1240,32,200,311,368,65,46,218
"2011","Bromley 012D","E01000770","Total",1429,275,152,123,1154,25,270,237,206,70,111,235
"2011","Bromley 012E","E01000772","Total",1516,293,176,117,1223,29,268,324,206,85,88,223
"2011","Bromley 013A","E01000700","Total",1509,208,51,157,1301,137,74,382,292,57,109,250
"2011","Bromley 013B","E01000702","Total",1321,181,52,129,1140,42,80,343,262,39,109,265
"2011","Bromley 013C","E01000703","Total",1581,237,64,173,1344,92,88,394,302,99,129,240
"2011","Bromley 013D","E01000706","Total",1293,224,76,148,1069,65,106,341,198,37,121,201
"2011","Bromley 013E","E01000797","Total",1562,229,58,171,1333,49,116,346,300,95,164,263
"2011","Bromley 014A","E01000729","Total",1783,361,94,267,1422,275,114,321,180,100,232,200
"2011","Bromley 014B","E01000730","Total",1724,171,56,115,1553,286,90,316,186,137,292,246
"2011","Bromley 014C","E01000735","Total",1484,162,69,93,1322,101,126,280,132,150,253,280
"2011","Bromley 014D","E01000738","Total",1527,182,102,80,1345,137,190,316,184,69,152,297
"2011","Bromley 014E","E01000739","Total",1523,231,106,125,1292,201,124,274,122,148,190,233
"2011","Bromley 015A","E01000699","Total",1432,254,45,209,1178,143,48,306,238,64,176,203
"2011","Bromley 015B","E01000701","Total",1327,214,52,162,1113,62,70,362,254,51,96,218
"2011","Bromley 015C","E01000704","Total",1444,192,82,110,1252,70,94,348,196,68,225,251
"2011","Bromley 015D","E01000705","Total",1305,206,56,150,1099,104,50,269,198,80,162,236
"2011","Bromley 015E","E01000801","Total",1410,263,67,196,1147,127,116,224,186,79,173,242
"2011","Bromley 016A","E01000646","Total",1564,275,110,165,1289,62,144,343,298,76,127,239
"2011","Bromley 016B","E01000647","Total",1609,142,53,89,1467,103,114,441,284,119,171,235
"2011","Bromley 016C","E01000648","Total",1708,149,45,104,1559,68,132,506,210,131,210,302
"2011","Bromley 016D","E01000653","Total",1487,164,96,68,1323,38,236,290,180,126,125,328
"2011","Bromley 016E","E01000678","Total",1707,174,70,104,1533,75,118,415,236,127,224,338
"2011","Bromley 018A","E01000670","Total",1926,301,69,232,1625,87,194,442,308,60,168,366
"2011","Bromley 018B","E01000675","Total",1612,218,81,137,1394,65,118,377,290,95,131,318
"2011","Bromley 018C","E01000677","Total",1769,263,50,213,1506,147,90,546,384,71,90,178
"2011","Bromley 018D","E01000762","Total",1623,271,132,139,1352,63,238,311,206,60,163,311
"2011","Bromley 018E","E01000829","Total",1733,227,76,151,1506,67,134,524,260,99,127,295
"2011","Bromley 019A","E01000719","Total",1896,294,88,206,1602,253,128,456,282,111,151,221
"2011","Bromley 019B","E01000720","Total",1622,210,44,166,1412,253,92,322,236,130,200,179
"2011","Bromley 019C","E01000721","Total",1327,165,78,87,1162,206,84,238,98,131,177,228
"2011","Bromley 019D","E01000724","Total",1760,187,77,110,1573,267,128,307,144,183,283,261
"2011","Bromley 019E","E01000728","Total",1471,215,88,127,1256,152,216,229,194,90,116,259
"2011","Bromley 020A","E01000651","Total",1474,221,112,109,1253,51,130,390,174,76,127,305
"2011","Bromley 020B","E01000668","Total",1620,218,78,140,1402,66,108,464,268,86,151,259
"2011","Bromley 020C","E01000669","Total",1672,251,74,177,1421,120,118,458,264,100,126,235
"2011","Bromley 020D","E01000671","Total",1744,301,163,138,1443,67,126,411,272,84,159,324
"2011","Bromley 020E","E01000679","Total",1660,166,53,113,1494,109,122,498,242,110,133,280
"2011","Bromley 021A","E01000826","Total",1625,89,48,41,1536,25,232,334,116,149,252,428
"2011","Bromley 021B","E01000827","Total",1692,293,137,156,1399,62,250,367,240,89,119,272
"2011","Bromley 021C","E01000830","Total",1550,76,53,23,1474,27,226,309,166,120,291,335
"2011","Bromley 021D","E01000831","Total",1622,334,156,178,1288,30,220,302,236,107,140,253
"2011","Bromley 021E","E01000833","Total",1462,74,50,24,1388,48,162,324,132,172,225,325
"2011","Bromley 022A","E01000650","Total",1880,203,107,96,1677,69,252,422,210,120,254,350
"2011","Bromley 022B","E01000652","Total",1625,158,101,57,1467,59,250,355,210,93,167,333
"2011","Bromley 022C","E01000807","Total",1532,115,61,54,1417,76,192,410,198,85,156,300
"2011","Bromley 022D","E01000809","Total",1517,171,106,65,1346,34,210,372,214,85,147,284
"2011","Bromley 023A","E01000722","Total",1636,208,81,127,1428,172,146,340,282,53,197,238
"2011","Bromley 023B","E01000725","Total",1641,314,106,208,1327,202,102,345,262,88,134,194
"2011","Bromley 023C","E01000731","Total",1361,127,58,69,1234,209,112,223,182,56,172,280
"2011","Bromley 023D","E01000732","Total",1475,147,79,68,1328,68,186,303,186,61,243,281
"2011","Bromley 023E","E01000733","Total",1593,177,82,95,1416,106,158,360,198,82,169,343
"2011","Bromley 024A","E01000769","Total",1301,86,46,40,1215,43,104,225,126,120,214,383
"2011","Bromley 024B","E01000773","Total",1521,163,121,42,1358,54,190,352,180,110,187,285
"2011","Bromley 024C","E01000775","Total",2266,207,91,116,2059,85,224,681,242,136,329,362
"2011","Bromley 024D","E01000777","Total",1567,101,49,52,1466,64,166,417,144,76,245,354
"2011","Bromley 024E","E01000778","Total",1580,170,88,82,1410,74,130,413,162,111,198,322
"2011","Bromley 025A","E01000808","Total",1604,126,78,48,1478,50,248,427,220,99,164,270
"2011","Bromley 025B","E01000810","Total",1503,112,73,39,1391,33,280,395,206,67,124,286
"2011","Bromley 025C","E01000811","Total",1320,163,83,80,1157,53,142,356,226,40,94,246
"2011","Bromley 025D","E01000813","Total",1610,142,104,38,1468,29,262,376,200,76,204,321
"2011","Bromley 025E","E01000815","Total",1537,79,55,24,1458,13,270,388,180,96,178,333
"2011","Bromley 026A","E01000661","Total",1583,201,67,134,1382,283,118,262,190,98,146,285
"2011","Bromley 026B","E01000662","Total",1741,185,97,88,1556,72,160,350,218,115,298,343
"2011","Bromley 026C","E01000663","Total",1627,197,113,84,1430,108,160,358,174,124,215,291
"2011","Bromley 026D","E01000664","Total",1610,151,96,55,1459,111,146,327,180,104,245,346
"2011","Bromley 027A","E01000763","Total",1452,95,54,41,1357,46,168,355,134,94,191,369
"2011","Bromley 027B","E01000764","Total",1615,169,108,61,1446,58,188,382,172,94,232,320
"2011","Bromley 027C","E01000766","Total",1714,131,85,46,1583,27,212,428,212,130,209,365
"2011","Bromley 027D","E01000767","Total",1646,108,78,30,1538,38,188,448,180,127,216,341
"2011","Bromley 027E","E01000834","Total",1328,68,37,31,1260,66,126,381,96,42,191,358
"2011","Bromley 028A","E01000727","Total",1553,227,133,94,1326,66,186,300,254,95,152,273
"2011","Bromley 028B","E01000734","Total",1360,95,48,47,1265,121,142,304,150,78,220,250
"2011","Bromley 028C","E01000790","Total",1982,297,99,198,1685,125,142,409,352,80,242,335
"2011","Bromley 028D","E01000812","Total",1491,211,103,108,1280,45,212,273,224,60,117,349
"2011","Bromley 028E","E01000814","Total",1531,85,59,26,1446,0,246,276,190,72,259,403
"2011","Bromley 029A","E01000723","Total",1247,153,96,57,1094,50,260,165,200,58,94,267
"2011","Bromley 029B","E01000726","Total",1282,204,89,115,1078,61,206,192,204,68,142,205
"2011","Bromley 029C","E01000787","Total",1405,265,124,141,1140,56,244,242,152,58,129,259
"2011","Bromley 029D","E01000788","Total",1526,167,84,83,1359,83,174,293,192,51,204,362
"2011","Bromley 029E","E01000791","Total",1445,179,125,54,1266,58,264,251,174,63,168,288
"2011","Bromley 030A","E01000832","Total",1488,152,109,43,1336,27,182,312,134,118,206,357
"2011","Bromley 030B","E01000835","Total",1588,192,90,102,1396,105,154,339,164,99,238,297
"2011","Bromley 030C","E01000836","Total",1419,83,41,42,1336,71,154,392,112,88,175,344
"2011","Bromley 030D","E01000837","Total",1512,224,125,99,1288,68,196,299,150,116,180,279
"2011","Bromley 030E","E01000838","Total",1416,126,81,45,1290,22,230,320,110,73,204,331
"2011","Bromley 030F","E01000839","Total",1488,86,52,34,1402,25,188,370,202,74,197,346
"2011","Bromley 030G","E01000840","Total",1552,204,173,31,1348,24,320,254,192,58,137,363
"2011","Bromley 030H","E01000841","Total",1559,140,97,43,1419,40,206,393,160,70,174,376
"2011","Bromley 031A","E01000753","Total",1806,192,127,65,1614,48,382,348,186,114,230,306
"2011","Bromley 031B","E01000754","Total",1675,261,145,116,1414,89,198,428,198,72,168,261
"2011","Bromley 031C","E01000755","Total",1505,174,114,60,1331,45,236,323,150,103,173,301
"2011","Bromley 031D","E01000757","Total",1499,120,88,32,1379,14,250,329,230,77,134,345
"2011","Bromley 031E","E01000758","Total",1479,137,97,40,1342,43,222,309,192,86,133,357
"2011","Bromley 032A","E01000786","Total",1421,160,111,49,1261,29,324,202,214,70,114,308
"2011","Bromley 032B","E01000789","Total",1800,168,48,120,1632,420,58,330,164,208,212,240
"2011","Bromley 032C","E01000792","Total",1142,134,80,54,1008,77,202,182,126,79,113,229
"2011","Bromley 032D","E01000793","Total",1589,135,101,34,1454,29,332,301,190,95,141,366
"2011","Bromley 032E","E01000795","Total",1412,123,62,61,1289,70,168,324,158,107,210,252
"2011","Bromley 033A","E01000665","Total",1815,205,97,108,1610,105,186,444,298,96,182,299
"2011","Bromley 033B","E01000666","Total",1814,201,116,85,1613,51,362,320,252,47,240,341
"2011","Bromley 033C","E01000667","Total",1620,124,88,36,1496,49,280,328,186,118,198,337
"2011","Bromley 033D","E01000756","Total",1563,132,86,46,1431,43,226,247,168,131,287,329
"2011","Bromley 034A","E01000759","Total",1542,94,63,31,1448,34,162,340,174,108,279,351
"2011","Bromley 034B","E01000760","Total",1417,140,84,56,1277,56,134,314,160,66,203,344
"2011","Bromley 034C","E01000761","Total",1552,110,55,55,1442,54,190,332,206,130,228,302
"2011","Bromley 034D","E01000765","Total",1697,188,88,100,1509,62,194,357,212,160,166,358
"2011","Bromley 034E","E01000768","Total",1517,160,112,48,1357,48,196,321,182,93,185,332
"2011","Bromley 035A","E01000681","Total",1705,148,85,63,1557,39,186,463,196,106,211,356
"2011","Bromley 035B","E01000682","Total",1524,195,131,64,1329,45,214,362,160,71,181,296
"2011","Bromley 035C","E01000683","Total",1567,255,89,166,1312,57,146,412,240,69,166,222
"2011","Bromley 035D","E01000684","Total",2036,138,65,73,1898,48,234,568,268,179,221,380
"2011","Bromley 035E","E01000794","Total",1546,120,76,44,1426,19,278,294,188,92,177,378
"2011","Bromley 036A","E01000749","Total",1588,139,92,47,1449,47,292,314,206,106,134,350
"2011","Bromley 036B","E01000750","Total",1492,240,115,125,1252,131,146,216,188,69,197,305
"2011","Bromley 036C","E01000751","Total",1961,236,130,106,1725,78,244,539,222,116,257,269
"2011","Bromley 036D","E01000752","Total",1606,301,173,128,1305,93,308,261,202,79,156,206
"2011","Bromley 037A","E01000680","Total",1609,134,68,66,1475,30,300,314,228,97,180,326
"2011","Bromley 037B","E01000685","Total",1565,162,88,74,1403,50,168,401,178,111,191,304
"2011","Bromley 037C","E01000686","Total",1508,195,117,78,1313,53,230,286,202,66,171,305
"2011","Bromley 037D","E01000687","Total",1603,157,88,69,1446,71,242,343,234,58,185,313
"2011","Bromley 037E","E01000688","Total",1365,80,56,24,1285,11,202,314,168,102,179,309
"2011","Bromley 039A","E01000654","Total",1273,89,29,60,1184,51,116,313,202,115,110,277
"2011","Bromley 039B","E01000655","Total",1323,91,30,61,1232,69,118,294,194,148,127,282
"2011","Bromley 039C","E01000656","Total",1400,90,45,45,1310,39,162,282,208,81,186,352
"2011","Bromley 039D","E01000657","Total",1587,191,90,101,1396,119,158,341,262,69,153,294
"2011","Bromley 039E","E01000659","Total",1462,89,38,51,1373,54,118,313,198,90,276,324
"2011","Bromley 040A","E01000816","Total",1481,140,69,71,1341,93,154,297,212,64,184,337
"2011","Bromley 040B","E01000818","Total",1467,116,61,55,1351,79,188,299,204,74,180,327
"2011","Bromley 040C","E01000819","Total",1710,260,101,159,1450,190,120,365,218,108,186,263
"2011","Bromley 040D","E01032562","Total",1507,197,71,126,1310,244,110,220,146,98,229,263
"2011","Bromley 040E","E01032563","Total",1400,155,81,74,1245,28,222,283,166,76,194,276
"2011","Bromley 041A","E01000707","Total",1455,115,41,74,1340,44,60,532,218,138,137,211
"2011","Bromley 041B","E01000708","Total",1543,201,92,109,1342,76,110,412,244,81,136,283
"2011","Bromley 041C","E01000771","Total",1616,126,63,63,1490,49,198,426,208,101,166,342
"2011","Bromley 041D","E01000774","Total",1473,141,62,79,1332,72,152,376,180,87,154,311
"2011","Bromley 041E","E01032568","Total",1488,229,97,132,1259,146,86,334,206,57,147,283
"2011","Bromley 042A","E01000658","Total",1358,118,82,36,1240,48,260,198,178,45,184,327
"2011","Bromley 042B","E01000747","Total",1914,196,85,111,1718,109,218,442,286,184,168,311
"2011","Bromley 042C","E01000748","Total",1602,174,96,78,1428,56,304,219,200,81,174,394
"2011","Bromley 042D","E01032570","Total",1541,195,122,73,1346,79,236,237,228,101,151,314
"2011","Croydon 001A","E01001137","Total",1739,388,113,275,1351,183,108,297,340,65,138,220
"2011","Croydon 001B","E01001138","Total",1582,319,74,245,1263,179,76,328,328,71,111,170
"2011","Croydon 001C","E01001156","Total",1638,288,96,192,1350,192,52,271,250,109,203,273
"2011","Croydon 001D","E01001162","Total",1698,262,59,203,1436,253,78,329,280,93,193,210
"2011","Croydon 001E","E01001164","Total",1879,404,47,357,1475,199,40,364,506,46,89,231
"2011","Croydon 002A","E01001084","Total",1794,153,70,83,1641,81,192,292,186,106,315,469
"2011","Croydon 002B","E01001157","Total",1697,142,53,89,1555,92,130,326,168,120,289,430
"2011","Croydon 002C","E01001159","Total",1801,221,88,133,1580,112,148,368,222,106,237,387
"2011","Croydon 002D","E01001160","Total",1881,122,46,76,1759,55,156,214,178,126,486,544
"2011","Croydon 002E","E01001163","Total",1939,245,69,176,1694,136,142,458,266,105,255,332
"2011","Croydon 003A","E01001083","Total",1609,100,51,49,1509,44,190,204,112,130,374,455
"2011","Croydon 003B","E01001086","Total",1745,123,56,67,1622,78,130,258,132,96,337,591
"2011","Croydon 003C","E01001087","Total",2163,285,72,213,1878,157,118,271,238,96,385,613
"2011","Croydon 003D","E01001161","Total",1849,106,36,70,1743,173,88,164,94,159,512,553
"2011","Croydon 004A","E01001085","Total",1606,204,97,107,1402,81,116,292,114,92,286,421
"2011","Croydon 004B","E01001088","Total",1709,109,38,71,1600,155,118,317,168,178,305,359
"2011","Croydon 004C","E01001089","Total",1891,223,87,136,1668,243,94,314,152,141,336,388
"2011","Croydon 004D","E01001090","Total",2287,270,77,193,2017,334,112,350,324,156,301,440
"2011","Croydon 004E","E01001091","Total",1579,130,53,77,1449,47,138,243,166,111,284,460
"2011","Croydon 005A","E01001147","Total",1621,183,38,145,1438,255,48,309,136,159,266,265
"2011","Croydon 005B","E01001148","Total",1605,235,53,182,1370,174,62,310,178,130,227,289
"2011","Croydon 005C","E01001151","Total",1569,269,94,175,1300,184,54,261,170,151,250,230
"2011","Croydon 005D","E01001152","Total",1662,242,52,190,1420,264,42,263,170,99,303,279
"2011","Croydon 005E","E01001158","Total",1564,251,46,205,1313,239,74,303,244,90,121,242
"2011","Croydon 006A","E01001146","Total",1615,152,41,111,1463,180,92,247,188,90,239,427
"2011","Croydon 006B","E01001149","Total",1572,174,27,147,1398,186,84,335,198,136,222,237
"2011","Croydon 006C","E01001150","Total",1652,158,39,119,1494,166,92,337,164,99,324,312
"2011","Croydon 006D","E01001153","Total",1617,165,56,109,1452,164,82,239,124,111,340,392
"2011","Croydon 006E","E01001154","Total",1967,199,49,150,1768,296,62,352,186,165,359,348
"2011","Croydon 007A","E01001136","Total",1828,445,67,378,1383,257,50,326,288,56,163,243
"2011","Croydon 007B","E01001139","Total",1602,243,59,184,1359,149,78,252,264,88,242,286
"2011","Croydon 007C","E01001140","Total",1573,317,61,256,1256,190,60,285,346,70,115,190
"2011","Croydon 007D","E01001142","Total",1526,178,50,128,1348,155,114,263,206,96,250,264
"2011","Croydon 007E","E01001144","Total",1663,367,56,311,1296,251,48,251,206,98,185,257
"2011","Croydon 008A","E01001141","Total",1246,227,49,178,1019,185,48,232,170,76,121,187
"2011","Croydon 008B","E01001143","Total",1941,322,99,223,1619,286,120,290,212,104,303,304
"2011","Croydon 008C","E01001145","Total",1686,384,64,320,1302,366,50,343,190,56,116,181
"2011","Croydon 008D","E01001191","Total",1764,347,47,300,1417,246,58,260,254,107,221,271
"2011","Croydon 008E","E01001192","Total",1644,269,69,200,1375,292,52,319,210,89,174,239
"2011","Croydon 009A","E01000994","Total",1592,118,35,83,1474,107,100,218,118,167,327,437
"2011","Croydon 009B","E01000995","Total",1631,167,58,109,1464,167,118,273,142,128,245,391
"2011","Croydon 009C","E01000996","Total",1254,109,34,75,1145,82,60,154,120,62,284,383
"2011","Croydon 009D","E01000997","Total",1351,122,51,71,1229,108,68,208,86,96,304,359
"2011","Croydon 009E","E01000999","Total",1332,92,42,50,1240,73,72,123,100,95,311,466
"2011","Croydon 009F","E01001002","Total",1343,148,57,91,1195,105,62,240,126,82,276,304
"2011","Croydon 010A","E01000998","Total",1551,214,35,179,1337,191,46,219,164,65,238,414
"2011","Croydon 010B","E01001000","Total",1251,124,29,95,1127,109,66,200,112,76,211,353
"2011","Croydon 010C","E01001003","Total",1497,211,48,163,1286,212,70,207,148,128,233,288
"2011","Croydon 010D","E01001111","Total",1604,160,37,123,1444,202,62,255,186,84,295,360
"2011","Croydon 010E","E01001155","Total",1591,355,128,227,1236,196,98,208,172,60,247,255
"2011","Croydon 011A","E01001174","Total",1620,109,49,60,1511,102,94,206,104,181,393,431
"2011","Croydon 011B","E01001175","Total",1448,140,59,81,1308,181,66,193,130,68,302,368
"2011","Croydon 011C","E01001176","Total",1899,133,38,95,1766,236,72,330,142,159,420,407
"2011","Croydon 011D","E01001182","Total",1422,112,33,79,1310,106,72,159,82,75,458,358
"2011","Croydon 011E","E01001183","Total",1572,128,31,97,1444,149,80,189,138,91,333,464
"2011","Croydon 011F","E01001184","Total",1349,96,45,51,1253,78,110,159,100,73,345,388
"2011","Croydon 013A","E01001001","Total",1184,180,35,145,1004,141,52,225,108,74,172,232
"2011","Croydon 013B","E01001109","Total",1935,329,106,223,1606,309,74,403,186,91,265,278
"2011","Croydon 013C","E01001112","Total",1693,301,65,236,1392,271,82,286,182,108,213,250
"2011","Croydon 013D","E01001113","Total",1828,290,37,253,1538,304,72,240,256,151,264,251
"2011","Croydon 013E","E01001114","Total",1400,163,28,135,1237,319,50,261,174,84,125,224
"2011","Croydon 013F","E01001116","Total",1359,139,35,104,1220,165,66,272,178,70,233,236
"2011","Croydon 014A","E01000992","Total",1973,211,52,159,1762,218,70,379,160,191,385,359
"2011","Croydon 014B","E01001185","Total",1636,257,62,195,1379,174,80,327,222,97,167,312
"2011","Croydon 014C","E01001186","Total",1743,363,102,261,1380,263,84,306,230,61,163,273
"2011","Croydon 014D","E01001188","Total",1818,221,46,175,1597,253,80,371,184,132,266,311
"2011","Croydon 014E","E01001193","Total",1807,98,21,77,1709,327,50,243,146,151,426,366
"2011","Croydon 015A","E01001004","Total",2125,195,48,147,1930,280,46,479,250,162,403,310
"2011","Croydon 015B","E01001115","Total",1706,193,75,118,1513,219,92,289,160,118,333,302
"2011","Croydon 015C","E01001117","Total",2655,398,43,355,2257,338,74,497,318,190,375,465
"2011","Croydon 015D","E01001178","Total",1341,157,34,123,1184,224,30,235,108,136,168,283
"2011","Croydon 015E","E01001181","Total",1818,244,64,180,1574,333,46,435,184,52,235,289
"2011","Croydon 016A","E01001006","Total",1558,181,20,161,1377,319,46,360,158,125,153,216
"2011","Croydon 016B","E01001007","Total",1968,111,49,62,1857,104,76,330,140,196,495,516
"2011","Croydon 016C","E01001177","Total",1614,128,33,95,1486,178,74,264,114,126,363,367
"2011","Croydon 016D","E01001179","Total",1534,122,41,81,1412,101,98,331,116,136,310,320
"2011","Croydon 016E","E01001180","Total",1737,125,36,89,1612,256,70,335,176,111,361,303
"2011","Croydon 017A","E01000980","Total",1407,168,41,127,1239,97,74,324,210,89,218,227
"2011","Croydon 017B","E01000981","Total",1642,168,49,119,1474,119,82,391,260,156,179,287
"2011","Croydon 017C","E01000982","Total",1599,205,48,157,1394,153,76,359,314,62,183,247
"2011","Croydon 017D","E01000983","Total",1712,170,51,119,1542,76,106,372,262,87,250,389
"2011","Croydon 017E","E01001187","Total",1940,272,47,225,1668,213,88,412,254,92,248,361
"2011","Croydon 018A","E01000989","Total",1707,132,72,60,1575,106,134,408,198,108,232,389
"2011","Croydon 018B","E01000991","Total",1649,156,96,60,1493,42,280,291,192,60,203,425
"2011","Croydon 018C","E01001131","Total",1563,234,127,107,1329,119,146,380,182,60,136,306
"2011","Croydon 018D","E01001132","Total",1464,162,106,56,1302,19,258,172,194,25,239,395
"2011","Croydon 018E","E01001134","Total",1617,222,84,138,1395,48,162,342,260,75,157,351
"2011","Croydon 019A","E01001005","Total",1687,98,28,70,1589,142,56,329,144,150,426,342
"2011","Croydon 019B","E01001008","Total",1608,107,50,57,1501,194,70,227,110,137,384,379
"2011","Croydon 019C","E01001009","Total",1846,133,32,101,1713,152,82,358,116,160,527,318
"2011","Croydon 019D","E01001010","Total",1514,118,46,72,1396,252,74,301,128,66,270,305
"2011","Croydon 019E","E01001011","Total",1867,251,36,215,1616,179,54,365,242,94,382,300
"2011","Croydon 020A","E01001012","Total",1895,267,35,232,1628,208,66,270,192,105,376,411
"2011","Croydon 020B","E01001013","Total",2010,355,98,257,1655,300,90,318,216,135,296,300
"2011","Croydon 020C","E01001048","Total",1936,370,60,310,1566,286,48,426,422,64,142,178
"2011","Croydon 020D","E01001110","Total",1772,284,29,255,1488,265,32,320,242,102,229,298
"2011","Croydon 020E","E01001118","Total",1882,259,78,181,1623,297,90,300,244,78,278,336
"2011","Croydon 021A","E01000985","Total",1447,92,44,48,1355,56,168,214,160,81,272,404
"2011","Croydon 021B","E01000986","Total",1721,186,83,103,1535,93,146,278,250,96,286,386
"2011","Croydon 021C","E01000987","Total",1431,94,57,37,1337,38,154,252,144,62,235,452
"2011","Croydon 021D","E01000993","Total",1620,145,59,86,1475,84,132,372,172,99,206,410
"2011","Croydon 022A","E01000975","Total",1607,234,49,185,1373,126,70,250,358,85,141,343
"2011","Croydon 022B","E01000976","Total",1867,290,78,212,1577,172,88,309,348,69,276,315
"2011","Croydon 022C","E01000977","Total",1677,475,143,332,1202,131,90,344,290,36,90,221
"2011","Croydon 022D","E01000978","Total",1775,439,85,354,1336,139,62,351,390,26,80,288
"2011","Croydon 022E","E01000979","Total",1703,305,59,246,1398,86,70,373,356,48,151,314
"2011","Croydon 022F","E01000984","Total",1785,348,122,226,1437,176,60,337,286,66,236,276
"2011","Croydon 023A","E01001044","Total",1880,322,120,202,1558,57,184,465,330,67,199,256
"2011","Croydon 023B","E01001046","Total",1751,365,112,253,1386,50,146,548,294,53,134,161
"2011","Croydon 023C","E01001049","Total",1393,100,55,45,1293,34,196,198,130,65,232,438
"2011","Croydon 023D","E01001050","Total",1598,362,208,154,1236,77,124,449,258,43,102,183
"2011","Croydon 024A","E01001014","Total",2663,373,66,307,2290,479,90,549,494,116,191,371
"2011","Croydon 024B","E01001042","Total",1818,312,48,264,1506,230,32,341,350,72,165,316
"2011","Croydon 024C","E01001165","Total",1656,208,47,161,1448,109,82,364,254,85,223,331
"2011","Croydon 024D","E01001166","Total",1814,313,79,234,1501,279,84,379,284,61,144,270
"2011","Croydon 024E","E01001168","Total",1737,242,70,172,1495,111,104,354,306,94,203,323
"2011","Croydon 025A","E01001127","Total",1607,100,57,43,1507,46,170,245,206,94,256,490
"2011","Croydon 025B","E01001128","Total",1611,107,49,58,1504,243,76,332,158,154,268,273
"2011","Croydon 025C","E01001130","Total",1776,85,34,51,1691,484,42,340,130,206,274,215
"2011","Croydon 025D","E01001135","Total",1646,151,85,66,1495,44,224,294,180,77,242,434
"2011","Croydon 026A","E01001062","Total",1531,113,56,57,1418,43,242,200,168,63,267,435
"2011","Croydon 026B","E01001063","Total",1539,139,68,71,1400,63,156,289,142,36,254,460
"2011","Croydon 026C","E01001064","Total",1568,133,73,60,1435,40,248,247,188,79,216,417
"2011","Croydon 026D","E01001129","Total",1455,74,51,23,1381,17,162,261,148,93,241,459
"2011","Croydon 026E","E01001133","Total",1557,295,215,80,1262,30,240,275,170,42,175,330
"2011","Croydon 027A","E01001035","Total",1647,369,62,307,1278,115,56,288,418,30,119,252
"2011","Croydon 027B","E01001043","Total",2559,423,46,377,2136,322,48,505,590,77,180,414
"2011","Croydon 027C","E01001045","Total",1692,491,104,387,1201,136,78,320,414,20,77,156
"2011","Croydon 027D","E01001047","Total",1665,413,96,317,1252,119,52,288,374,42,101,276
"2011","Croydon 027E","E01001170","Total",1946,437,160,277,1509,297,74,292,384,42,182,238
"2011","Croydon 028A","E01001167","Total",2193,203,69,134,1990,153,126,451,298,158,374,430
"2011","Croydon 028B","E01001169","Total",1680,200,82,118,1480,254,82,302,154,115,220,353
"2011","Croydon 028C","E01001171","Total",1484,238,62,176,1246,255,82,246,222,75,138,228
"2011","Croydon 028D","E01001172","Total",1726,166,65,101,1560,230,54,252,150,208,322,344
"2011","Croydon 028E","E01001173","Total",2547,344,96,248,2203,273,150,530,432,139,319,360
"2011","Croydon 029A","E01001036","Total",1459,204,71,133,1255,22,198,254,220,82,207,272
"2011","Croydon 029B","E01001037","Total",1396,184,41,143,1212,172,58,338,344,82,81,137
"2011","Croydon 029C","E01001038","Total",1778,431,43,388,1347,104,70,292,500,49,128,204
"2011","Croydon 029D","E01001039","Total",1465,145,60,85,1320,30,162,344,222,50,224,288
"2011","Croydon 029E","E01001040","Total",1708,240,55,185,1468,165,64,422,370,76,133,238
"2011","Croydon 030A","E01001051","Total",1549,168,101,67,1381,249,116,225,90,185,267,249
"2011","Croydon 030B","E01001052","Total",1447,73,39,34,1374,251,80,251,100,184,291,217
"2011","Croydon 030C","E01001054","Total",1710,114,53,61,1596,181,146,253,144,156,348,368
"2011","Croydon 030D","E01001056","Total",1851,81,25,56,1770,407,78,344,116,256,361,208
"2011","Croydon 030E","E01001057","Total",1814,90,21,69,1724,533,46,399,110,211,228,197
"2011","Croydon 031A","E01001033","Total",1616,228,79,149,1388,116,102,350,290,77,200,253
"2011","Croydon 031B","E01001034","Total",1498,215,46,169,1283,117,76,298,304,73,109,306
"2011","Croydon 031C","E01001041","Total",1605,294,62,232,1311,209,50,358,306,57,151,180
"2011","Croydon 031D","E01001095","Total",1455,154,45,109,1301,108,64,357,256,53,200,263
"2011","Croydon 031E","E01001100","Total",1472,198,75,123,1274,53,114,367,214,100,156,270
"2011","Croydon 032A","E01001053","Total",1512,103,49,54,1409,156,128,271,156,140,268,290
"2011","Croydon 032B","E01001055","Total",1595,160,83,77,1435,120,138,165,132,149,353,378
"2011","Croydon 032C","E01001077","Total",1396,110,39,71,1286,98,140,249,168,83,214,334
"2011","Croydon 032D","E01001078","Total",1404,97,45,52,1307,201,102,222,166,117,239,260
"2011","Croydon 032E","E01001082","Total",1627,95,50,45,1532,232,104,280,164,114,306,332
"2011","Croydon 033A","E01001120","Total",1263,95,55,40,1168,55,148,294,148,43,169,311
"2011","Croydon 033B","E01001122","Total",1384,86,42,44,1298,28,146,256,188,45,204,431
"2011","Croydon 033C","E01001123","Total",1514,134,94,40,1380,41,270,313,136,51,195,374
"2011","Croydon 033D","E01001124","Total",1539,124,87,37,1415,14,274,280,200,56,208,383
"2011","Croydon 033E","E01001125","Total",1650,129,64,65,1521,59,178,242,180,61,325,476
"2011","Croydon 034A","E01001058","Total",1326,117,58,59,1209,88,138,324,186,60,178,235
"2011","Croydon 034B","E01001059","Total",1396,296,78,218,1100,79,104,321,266,51,113,166
"2011","Croydon 034C","E01001060","Total",1581,207,87,120,1374,115,116,357,226,93,164,303
"2011","Croydon 034D","E01001061","Total",1533,237,68,169,1296,131,78,266,180,97,243,301
"2011","Croydon 034E","E01001065","Total",1334,306,94,212,1028,28,172,227,200,47,80,274
"2011","Croydon 034F","E01001066","Total",1369,117,57,60,1252,237,84,223,86,111,279,232
"2011","Croydon 034G","E01001119","Total",1470,132,59,73,1338,33,160,321,226,62,176,360
"2011","Croydon 034H","E01001126","Total",1402,158,74,84,1244,62,194,283,212,47,149,297
"2011","Croydon 035A","E01001032","Total",1365,93,51,42,1272,11,272,246,174,107,174,288
"2011","Croydon 035B","E01001101","Total",1423,87,55,32,1336,4,180,334,146,87,240,345
"2011","Croydon 035C","E01001102","Total",1454,190,138,52,1264,30,226,254,126,65,192,371
"2011","Croydon 035D","E01001107","Total",1586,178,65,113,1408,35,222,258,254,107,202,330
"2011","Croydon 035E","E01001108","Total",1711,100,65,35,1611,27,258,410,204,104,233,375
"2011","Croydon 036A","E01001076","Total",1606,128,55,73,1478,215,124,321,130,124,284,280
"2011","Croydon 036B","E01001079","Total",1681,141,80,61,1540,256,144,298,190,121,226,305
"2011","Croydon 036C","E01001080","Total",1619,256,123,133,1363,285,80,221,158,164,232,223
"2011","Croydon 036D","E01001081","Total",1409,113,64,49,1296,143,110,238,126,142,209,328
"2011","Croydon 037A","E01001073","Total",1422,207,66,141,1215,52,116,292,248,77,156,274
"2011","Croydon 037B","E01001092","Total",1555,150,74,76,1405,59,148,303,206,86,287,316
"2011","Croydon 037C","E01001093","Total",1738,191,65,126,1547,164,144,397,216,90,188,348
"2011","Croydon 037D","E01001096","Total",1532,66,38,28,1466,44,198,298,172,120,214,420
"2011","Croydon 037E","E01001097","Total",2066,467,175,292,1599,167,116,313,502,67,189,245
"2011","Croydon 037F","E01001098","Total",1432,66,40,26,1366,40,188,351,188,72,174,353
"2011","Croydon 038A","E01001028","Total",1586,82,52,30,1504,13,186,294,112,101,293,505
"2011","Croydon 038B","E01001029","Total",1472,105,37,68,1367,46,128,282,204,56,244,407
"2011","Croydon 038C","E01001030","Total",1392,61,34,27,1331,24,146,349,128,65,250,369
"2011","Croydon 038D","E01001031","Total",1466,63,36,27,1403,29,146,259,156,95,319,399
"2011","Croydon 038E","E01001094","Total",1525,89,47,42,1436,25,198,265,138,109,309,392
"2011","Croydon 039A","E01001103","Total",1680,162,111,51,1518,32,270,368,138,119,250,341
"2011","Croydon 039B","E01001105","Total",1729,150,89,61,1579,94,152,370,152,149,291,371
"2011","Croydon 039C","E01001106","Total",1490,102,53,49,1388,72,148,343,172,98,210,345
"2011","Croydon 039D","E01001121","Total",1279,82,58,24,1197,15,232,186,202,47,141,374
"2011","Croydon 040A","E01001069","Total",1306,106,46,60,1200,45,134,376,176,87,133,249
"2011","Croydon 040B","E01001070","Total",1693,151,68,83,1542,108,202,321,224,129,231,327
"2011","Croydon 040C","E01001075","Total",1501,210,58,152,1291,86,98,464,250,106,91,196
"2011","Croydon 040D","E01001099","Total",1477,138,32,106,1339,124,104,320,246,118,180,247
"2011","Croydon 041A","E01001015","Total",1440,106,46,60,1334,124,104,240,162,128,243,333
"2011","Croydon 041B","E01001016","Total",1705,161,86,75,1544,69,216,358,194,94,249,364
"2011","Croydon 041C","E01001023","Total",1282,224,84,140,1058,78,98,234,174,71,160,243
"2011","Croydon 041D","E01001067","Total",1631,74,42,32,1557,29,216,413,214,87,249,349
"2011","Croydon 041E","E01001074","Total",1922,280,79,201,1642,171,106,422,292,84,222,345
"2011","Croydon 042A","E01001068","Total",1924,194,64,130,1730,174,176,430,294,103,235,318
"2011","Croydon 042B","E01001071","Total",1891,176,65,111,1715,98,134,497,294,137,237,318
"2011","Croydon 042C","E01001072","Total",1420,87,57,30,1333,31,214,295,196,90,179,328
"2011","Croydon 042D","E01001104","Total",1665,131,58,73,1534,45,174,447,226,75,223,344
"2011","Croydon 043A","E01001017","Total",1611,144,82,62,1467,51,188,380,258,90,127,373
"2011","Croydon 043B","E01001024","Total",1428,113,54,59,1315,74,114,331,206,62,235,293
"2011","Croydon 043C","E01001025","Total",1296,102,60,42,1194,55,164,302,144,88,151,290
"2011","Croydon 043D","E01001026","Total",1729,132,69,63,1597,91,154,412,200,121,226,393
"2011","Croydon 043E","E01001027","Total",1567,89,40,49,1478,74,150,343,148,129,269,365
"2011","Croydon 044A","E01001018","Total",1556,155,72,83,1401,45,230,418,216,57,132,303
"2011","Croydon 044B","E01001019","Total",1511,147,105,42,1364,7,216,362,168,41,211,359
"2011","Croydon 044C","E01001020","Total",1615,164,105,59,1451,93,204,324,218,102,158,352
"2011","Croydon 044D","E01001021","Total",1332,211,141,70,1121,161,156,224,134,95,123,228
"2011","Croydon 044E","E01001022","Total",1441,152,99,53,1289,32,298,306,198,51,153,251
"2011","Croydon 045A","E01000990","Total",1420,165,72,93,1255,196,80,183,124,116,250,306
"2011","Croydon 045B","E01001189","Total",1211,119,42,77,1092,108,62,245,164,60,209,244
"2011","Croydon 045C","E01001190","Total",1586,181,56,125,1405,207,56,331,176,106,252,277
"2011","Croydon 045D","E01001194","Total",1572,157,36,121,1415,185,80,355,240,81,190,284
"2011","Croydon 045E","E01032569","Total",1731,141,53,88,1590,352,60,308,216,87,280,287
"2011","Ealing 001A","E01001269","Total",1983,126,48,78,1857,70,92,430,140,114,464,547
"2011","Ealing 001B","E01001271","Total",1802,122,47,75,1680,67,106,323,122,134,371,557
"2011","Ealing 001C","E01001309","Total",1830,130,45,85,1700,51,114,376,150,139,372,498
"2011","Ealing 001D","E01001310","Total",1789,182,55,127,1607,139,96,332,176,131,263,470
"2011","Ealing 001E","E01001311","Total",1977,168,56,112,1809,156,84,294,140,140,500,495
"2011","Ealing 002A","E01001307","Total",1833,130,52,78,1703,54,120,310,188,104,332,595
"2011","Ealing 002B","E01001308","Total",2042,147,65,82,1895,35,180,253,156,75,535,661
"2011","Ealing 002C","E01001312","Total",1839,111,56,55,1728,51,126,277,152,156,410,556
"2011","Ealing 002D","E01001313","Total",1701,78,40,38,1623,25,116,223,94,130,416,619
"2011","Ealing 002E","E01001314","Total",1585,88,40,48,1497,76,108,245,100,91,345,532
"2011","Ealing 003A","E01001315","Total",1461,92,29,63,1369,85,94,318,142,87,291,352
"2011","Ealing 003B","E01001316","Total",1583,191,60,131,1392,217,84,278,154,144,209,306
"2011","Ealing 003C","E01001317","Total",1862,182,64,118,1680,164,108,421,180,122,313,372
"2011","Ealing 003D","E01001318","Total",1790,196,89,107,1594,216,94,367,180,121,281,335
"2011","Ealing 003E","E01001320","Total",1548,118,25,93,1430,278,64,271,146,137,285,249
"2011","Ealing 003F","E01001321","Total",2021,200,95,105,1821,166,184,340,198,148,290,495
"2011","Ealing 004A","E01001270","Total",1721,101,47,54,1620,71,114,328,146,69,403,489
"2011","Ealing 004B","E01001319","Total",1498,83,39,44,1415,89,118,249,114,79,361,405
"2011","Ealing 004C","E01001322","Total",1692,162,43,119,1530,104,108,268,192,99,309,450
"2011","Ealing 004D","E01001323","Total",1728,204,72,132,1524,100,122,329,192,75,249,457
"2011","Ealing 005A","E01001341","Total",1712,89,31,58,1623,18,90,300,116,120,465,514
"2011","Ealing 005B","E01001342","Total",1867,152,35,117,1715,73,80,391,186,82,415,488
"2011","Ealing 005C","E01001343","Total",1504,86,34,52,1418,56,118,183,102,124,299,536
"2011","Ealing 005D","E01001345","Total",1680,86,44,42,1594,54,92,244,88,107,522,487
"2011","Ealing 006A","E01001265","Total",1692,176,37,139,1516,105,74,393,176,123,266,379
"2011","Ealing 006B","E01001266","Total",1832,88,40,48,1744,43,148,252,144,77,481,599
"2011","Ealing 006C","E01001267","Total",1932,309,140,169,1623,127,140,332,222,175,301,326
"2011","Ealing 006D","E01001272","Total",1607,115,43,72,1492,52,92,311,140,80,360,457
"2011","Ealing 006E","E01001349","Total",1404,142,51,91,1262,73,92,206,108,72,297,414
"2011","Ealing 007A","E01001344","Total",2161,270,74,196,1891,156,118,484,304,82,280,467
"2011","Ealing 007B","E01001346","Total",1878,128,49,79,1750,39,150,318,180,177,410,476
"2011","Ealing 007C","E01001347","Total",1534,110,48,62,1424,45,104,204,148,105,324,494
"2011","Ealing 007D","E01001348","Total",1599,185,59,126,1414,82,92,391,182,51,223,393
"2011","Ealing 008A","E01001257","Total",1783,203,72,131,1580,268,50,304,164,160,348,286
"2011","Ealing 008B","E01001324","Total",1541,238,38,200,1303,169,52,340,214,71,239,218
"2011","Ealing 008C","E01001326","Total",1719,224,110,114,1495,215,72,323,162,128,300,295
"2011","Ealing 008D","E01001330","Total",1598,231,84,147,1367,162,72,277,126,144,264,322
"2011","Ealing 008E","E01001332","Total",1503,174,43,131,1329,176,68,282,146,98,244,315
"2011","Ealing 009A","E01001325","Total",1758,147,72,75,1611,128,94,240,138,180,422,409
"2011","Ealing 009B","E01001327","Total",1803,173,81,92,1630,71,86,251,104,149,515,454
"2011","Ealing 009C","E01001328","Total",1730,164,66,98,1566,201,98,311,106,165,324,361
"2011","Ealing 009D","E01001329","Total",1783,156,77,79,1627,211,102,306,168,126,338,376
"2011","Ealing 009E","E01001331","Total",1674,176,32,144,1498,263,70,333,128,173,292,239
"2011","Ealing 010B","E01001258","Total",1690,182,86,96,1508,81,110,315,166,96,339,401
"2011","Ealing 010C","E01001262","Total",1522,165,70,95,1357,75,72,279,144,152,284,351
"2011","Ealing 010D","E01001263","Total",1672,211,72,139,1461,162,80,275,186,102,343,313
"2011","Ealing 010E","E01001264","Total",1655,160,75,85,1495,129,128,314,154,115,299,356
"2011","Ealing 010F","E01032743","Total",2173,218,13,205,1955,347,26,606,248,181,336,211
"2011","Ealing 010G","E01032744","Total",1378,140,40,100,1238,125,58,253,76,121,288,317
"2011","Ealing 011A","E01001276","Total",1788,193,47,146,1595,87,88,234,202,127,390,467
"2011","Ealing 011B","E01001277","Total",1844,172,48,124,1672,88,122,293,198,87,239,645
"2011","Ealing 011C","E01001278","Total",1962,257,74,183,1705,91,152,382,260,116,269,435
"2011","Ealing 011D","E01001280","Total",1740,266,91,175,1474,97,132,397,334,72,136,306
"2011","Ealing 012A","E01001218","Total",1908,201,85,116,1707,155,106,266,166,157,419,438
"2011","Ealing 012B","E01001260","Total",1899,177,87,90,1722,53,136,297,128,128,437,543
"2011","Ealing 012C","E01001261","Total",2135,203,57,146,1932,115,118,320,180,100,425,674
"2011","Ealing 012D","E01001268","Total",1736,162,76,86,1574,56,164,354,156,139,348,357
"2011","Ealing 013A","E01001209","Total",1712,158,64,94,1554,66,114,524,196,149,96,409
"2011","Ealing 013B","E01001211","Total",1649,242,94,148,1407,61,108,395,278,87,186,292
"2011","Ealing 013C","E01001279","Total",1473,133,62,71,1340,21,178,365,160,74,191,351
"2011","Ealing 013D","E01001281","Total",1533,181,75,106,1352,43,140,470,204,112,131,252
"2011","Ealing 014A","E01001217","Total",1539,66,34,32,1473,52,88,230,98,93,397,515
"2011","Ealing 014B","E01001259","Total",1457,134,51,83,1323,108,94,218,108,63,298,434
"2011","Ealing 014C","E01001291","Total",1642,71,20,51,1571,77,98,189,116,166,379,546
"2011","Ealing 014D","E01001292","Total",1708,82,38,44,1626,35,98,186,100,113,488,606
"2011","Ealing 014E","E01001293","Total",1598,88,31,57,1510,57,74,201,72,131,427,548
"2011","Ealing 015A","E01001196","Total",1727,315,101,214,1412,212,94,250,186,93,232,345
"2011","Ealing 015B","E01001238","Total",2868,453,48,405,2415,242,50,414,570,102,229,808
"2011","Ealing 015C","E01001239","Total",1522,152,25,127,1370,124,58,181,188,107,254,458
"2011","Ealing 015D","E01001246","Total",1360,133,33,100,1227,103,62,231,124,109,247,351
"2011","Ealing 015E","E01001247","Total",2170,134,59,75,2036,177,110,261,144,108,257,979
"2011","Ealing 016A","E01001210","Total",1675,323,149,174,1352,181,84,242,174,126,262,283
"2011","Ealing 016B","E01001282","Total",1557,215,117,98,1342,131,116,302,146,91,260,296
"2011","Ealing 016C","E01001283","Total",1595,294,151,143,1301,152,134,289,144,102,170,310
"2011","Ealing 016D","E01001285","Total",1627,130,45,85,1497,81,94,391,128,97,353,353
"2011","Ealing 016E","E01001286","Total",1674,151,61,90,1523,142,108,406,170,125,233,339
"2011","Ealing 016F","E01001287","Total",1437,100,34,66,1337,121,64,226,122,166,318,320
"2011","Ealing 017A","E01001294","Total",1894,85,37,48,1809,71,68,215,84,79,578,714
"2011","Ealing 017B","E01001295","Total",1826,74,33,41,1752,27,84,251,70,147,518,655
"2011","Ealing 017C","E01001296","Total",1481,55,27,28,1426,36,60,172,58,86,482,532
"2011","Ealing 017D","E01001297","Total",1814,80,48,32,1734,39,70,249,60,123,530,663
"2011","Ealing 017E","E01001298","Total",1812,98,49,49,1714,66,100,183,78,87,542,658
"2011","Ealing 018A","E01001204","Total",1586,130,47,83,1456,54,116,339,210,85,216,436
"2011","Ealing 018B","E01001205","Total",1559,175,34,141,1384,120,58,282,256,106,284,278
"2011","Ealing 018C","E01001206","Total",1714,142,42,100,1572,250,32,323,132,180,358,297
"2011","Ealing 018D","E01001207","Total",1570,210,44,166,1360,73,76,315,310,61,129,396
"2011","Ealing 018E","E01001208","Total",1366,112,58,54,1254,45,138,363,132,131,185,260
"2011","Ealing 018F","E01001212","Total",1534,258,98,160,1276,26,170,313,252,65,199,251
"2011","Ealing 019A","E01001222","Total",2381,457,40,417,1924,182,70,382,600,112,147,431
"2011","Ealing 019B","E01001224","Total",1609,114,34,80,1495,20,120,353,192,150,225,435
"2011","Ealing 019C","E01001226","Total",1491,236,83,153,1255,60,124,266,302,67,98,338
"2011","Ealing 019D","E01001227","Total",1490,172,48,124,1318,20,116,383,220,114,113,352
"2011","Ealing 019E","E01001228","Total",1680,309,90,219,1371,42,98,258,378,62,99,434
"2011","Ealing 020A","E01001221","Total",1837,416,88,328,1421,50,68,202,568,27,49,457
"2011","Ealing 020B","E01001223","Total",1408,233,60,173,1175,31,114,250,302,50,162,266
"2011","Ealing 020C","E01001225","Total",1772,317,118,199,1455,48,114,354,316,74,149,400
"2011","Ealing 020D","E01001235","Total",1487,230,56,174,1257,46,46,309,420,41,49,346
"2011","Ealing 020E","E01001236","Total",1587,295,103,192,1292,58,78,320,352,54,108,322
"2011","Ealing 020F","E01001273","Total",1623,148,60,88,1475,35,124,307,200,118,211,480
"2011","Ealing 020G","E01001274","Total",1630,141,56,85,1489,49,90,477,190,183,225,275
"2011","Ealing 020H","E01001275","Total",1866,364,95,269,1502,64,114,188,440,52,294,350
"2011","Ealing 021A","E01001195","Total",1833,127,60,67,1706,42,96,350,136,163,263,656
"2011","Ealing 021B","E01001197","Total",1700,227,66,161,1473,96,82,392,190,127,251,335
"2011","Ealing 021C","E01001198","Total",1432,193,47,146,1239,78,80,266,210,68,162,375
"2011","Ealing 021D","E01001199","Total",1694,233,34,199,1461,166,52,255,256,128,194,410
"2011","Ealing 022A","E01001284","Total",1539,99,51,48,1440,48,134,283,152,79,265,479
"2011","Ealing 022B","E01001288","Total",1497,112,24,88,1385,80,94,390,128,118,237,338
"2011","Ealing 022C","E01001289","Total",1383,99,23,76,1284,70,52,359,142,110,236,315
"2011","Ealing 022D","E01001290","Total",1856,215,63,152,1641,71,98,371,276,136,235,454
"2011","Ealing 023A","E01001213","Total",1810,86,47,39,1724,60,60,150,88,120,566,680
"2011","Ealing 023B","E01001214","Total",1749,73,40,33,1676,35,88,180,62,82,507,722
"2011","Ealing 023C","E01001215","Total",1765,148,85,63,1617,55,86,180,82,129,561,524
"2011","Ealing 023D","E01001216","Total",1537,98,36,62,1439,40,104,237,58,81,407,512
"2011","Ealing 023E","E01001361","Total",1671,73,24,49,1598,72,56,190,96,124,533,527
"2011","Ealing 024A","E01001240","Total",1615,125,58,67,1490,59,90,100,88,138,363,652
"2011","Ealing 024B","E01001241","Total",1501,129,49,80,1372,72,94,156,106,85,290,569
"2011","Ealing 024C","E01001242","Total",1441,169,47,122,1272,96,82,155,164,128,322,325
"2011","Ealing 024D","E01001243","Total",1742,231,63,168,1511,196,58,244,148,171,287,407
"2011","Ealing 024E","E01001244","Total",2539,411,89,322,2128,218,110,313,448,191,312,536
"2011","Ealing 024F","E01001245","Total",1914,246,49,197,1668,137,74,394,402,65,149,447
"2011","Ealing 025A","E01001200","Total",1508,182,36,146,1326,66,64,252,230,94,192,428
"2011","Ealing 025B","E01001201","Total",1537,208,49,159,1329,89,88,290,256,84,190,332
"2011","Ealing 025C","E01001202","Total",2114,315,80,235,1799,224,78,341,304,177,265,410
"2011","Ealing 025D","E01001203","Total",1732,417,85,332,1315,141,30,268,288,43,149,396
"2011","Ealing 025E","E01001351","Total",1864,319,97,222,1545,119,70,283,318,117,205,433
"2011","Ealing 026A","E01001359","Total",2201,84,40,44,2117,59,78,202,76,159,828,715
"2011","Ealing 026B","E01001360","Total",1923,66,33,33,1857,22,102,191,58,80,689,715
"2011","Ealing 026C","E01001362","Total",1896,110,32,78,1786,32,50,130,64,115,710,685
"2011","Ealing 026D","E01001363","Total",1685,69,36,33,1616,64,68,251,58,137,541,497
"2011","Ealing 026E","E01001364","Total",1676,136,66,70,1540,78,82,132,74,97,534,543
"2011","Ealing 026F","E01001365","Total",2194,94,50,44,2100,83,84,199,90,147,787,710
"2011","Ealing 027A","E01001231","Total",1866,177,48,129,1689,43,184,240,220,115,277,610
"2011","Ealing 027B","E01001234","Total",1391,248,37,211,1143,59,84,186,298,62,99,355
"2011","Ealing 027C","E01001350","Total",1483,222,67,155,1261,47,86,265,228,75,220,340
"2011","Ealing 027D","E01001352","Total",1495,166,50,116,1329,45,70,243,222,105,211,433
"2011","Ealing 027E","E01001354","Total",1744,188,66,122,1556,33,90,323,300,100,179,531
"2011","Ealing 028A","E01001249","Total",2316,385,63,322,1931,272,58,358,410,170,254,409
"2011","Ealing 028B","E01001250","Total",2005,453,82,371,1552,185,90,275,344,109,175,374
"2011","Ealing 028C","E01001255","Total",1603,168,44,124,1435,45,92,390,222,107,250,329
"2011","Ealing 028D","E01001383","Total",1768,162,54,108,1606,50,78,361,288,68,206,555
"2011","Ealing 028E","E01001388","Total",1640,310,109,201,1330,139,58,308,258,80,184,303
"2011","Ealing 028F","E01001389","Total",1649,266,88,178,1383,49,70,346,304,67,90,457
"2011","Ealing 029A","E01001219","Total",2015,183,56,127,1832,193,74,315,126,219,500,405
"2011","Ealing 029B","E01001220","Total",1509,93,37,56,1416,144,54,237,94,195,337,355
"2011","Ealing 029C","E01001334","Total",1623,150,51,99,1473,109,62,197,70,148,475,412
"2011","Ealing 029D","E01001337","Total",1388,126,31,95,1262,65,54,143,100,120,385,395
"2011","Ealing 029E","E01001338","Total",1894,94,37,57,1800,69,90,140,76,129,628,668
"2011","Ealing 029F","E01001339","Total",1841,111,17,94,1730,181,56,257,118,170,494,454
"2011","Ealing 029G","E01001340","Total",1368,137,12,125,1231,105,30,280,170,129,220,297
"2011","Ealing 030A","E01001251","Total",1654,189,43,146,1465,83,90,431,258,70,131,402
"2011","Ealing 030B","E01001252","Total",1938,246,47,199,1692,132,80,448,262,97,223,450
"2011","Ealing 030C","E01001253","Total",1646,204,50,154,1442,93,96,383,260,97,182,331
"2011","Ealing 030D","E01001254","Total",1675,293,103,190,1382,65,72,488,264,62,165,266
"2011","Ealing 031A","E01001229","Total",1522,159,60,99,1363,153,96,264,212,63,200,375
"2011","Ealing 031B","E01001230","Total",1372,221,49,172,1151,51,62,264,340,39,128,267
"2011","Ealing 031C","E01001232","Total",1538,176,71,105,1362,95,102,285,224,50,218,388
"2011","Ealing 031D","E01001233","Total",1424,206,74,132,1218,61,88,233,226,41,145,424
"2011","Ealing 031E","E01001237","Total",1476,216,58,158,1260,45,64,266,362,70,95,358
"2011","Ealing 031F","E01001386","Total",1793,221,73,148,1572,42,100,464,332,117,145,372
"2011","Ealing 032A","E01001303","Total",1639,141,49,92,1498,58,88,384,282,127,157,402
"2011","Ealing 032B","E01001382","Total",1566,117,47,70,1449,31,136,419,156,168,177,362
"2011","Ealing 032C","E01001384","Total",1645,213,56,157,1432,53,64,390,298,56,108,463
"2011","Ealing 032D","E01001385","Total",1682,191,72,119,1491,30,74,485,262,82,121,437
"2011","Ealing 032E","E01001387","Total",1471,294,56,238,1177,71,52,268,366,76,93,251
"2011","Ealing 033A","E01001353","Total",1664,275,87,188,1389,108,62,300,254,124,128,413
"2011","Ealing 033B","E01001355","Total",1664,297,86,211,1367,89,88,282,300,44,166,398
"2011","Ealing 033C","E01001356","Total",1969,362,128,234,1607,265,80,349,182,221,219,291
"2011","Ealing 033D","E01001357","Total",1141,127,21,106,1014,145,50,143,142,147,206,181
"2011","Ealing 033E","E01001358","Total",1602,170,37,133,1432,242,74,257,146,186,257,270
"2011","Ealing 034A","E01001375","Total",1665,198,43,155,1467,39,90,527,336,92,66,317
"2011","Ealing 034B","E01001377","Total",1764,225,92,133,1539,45,148,397,244,132,235,338
"2011","Ealing 034C","E01001379","Total",1679,206,66,140,1473,48,102,536,328,56,99,304
"2011","Ealing 034D","E01001381","Total",1649,271,66,205,1378,55,78,332,324,47,108,434
"2011","Ealing 035A","E01001248","Total",1547,149,58,91,1398,52,116,282,188,86,261,413
"2011","Ealing 035B","E01001299","Total",1833,129,65,64,1704,37,170,409,184,158,196,550
"2011","Ealing 035C","E01001305","Total",1716,139,62,77,1577,33,118,465,220,106,191,444
"2011","Ealing 035D","E01001306","Total",1607,242,82,160,1365,31,108,476,308,56,110,276
"2011","Ealing 037A","E01001366","Total",1914,83,24,59,1831,117,58,273,102,104,555,622
"2011","Ealing 037B","E01001367","Total",1764,118,28,90,1646,57,58,217,92,146,477,599
"2011","Ealing 037C","E01001368","Total",1723,50,23,27,1673,64,72,178,44,158,573,584
"2011","Ealing 037D","E01001370","Total",1980,71,28,43,1909,58,88,152,100,127,697,687
"2011","Ealing 037E","E01001371","Total",2081,90,38,52,1991,197,78,239,98,150,639,590
"2011","Ealing 037F","E01001372","Total",1763,83,31,52,1680,68,42,223,76,144,521,606
"2011","Ealing 037G","E01001373","Total",1499,70,23,47,1429,55,58,177,66,125,474,474
"2011","Ealing 038A","E01001333","Total",1806,151,58,93,1655,107,58,227,112,126,476,549
"2011","Ealing 038B","E01001335","Total",1699,125,57,68,1574,29,90,185,84,75,497,614
"2011","Ealing 038C","E01001336","Total",1572,130,52,78,1442,45,104,208,116,71,443,455
"2011","Ealing 038D","E01001369","Total",1846,90,29,61,1756,87,54,211,114,106,542,642
"2011","Ealing 039A","E01001300","Total",1688,121,38,83,1567,39,110,569,220,121,126,382
"2011","Ealing 039B","E01001301","Total",1523,243,100,143,1280,56,88,343,370,21,89,313
"2011","Ealing 039C","E01001302","Total",1621,155,56,99,1466,56,82,479,218,86,152,393
"2011","Ealing 039D","E01001304","Total",1627,245,71,174,1382,65,64,375,334,80,130,334
"2011","Ealing 040A","E01001374","Total",1798,277,65,212,1521,94,82,386,422,77,139,321
"2011","Ealing 040B","E01001376","Total",1579,303,60,243,1276,106,82,252,308,65,130,333
"2011","Ealing 040C","E01001380","Total",1759,258,95,163,1501,44,66,416,360,45,155,415
"2011","Ealing 040D","E01032572","Total",1575,310,55,255,1265,60,56,357,364,40,79,309
"2011","Enfield 001A","E01001444","Total",1676,145,67,78,1531,138,160,340,180,74,228,411
"2011","Enfield 001B","E01001446","Total",1817,215,70,145,1602,196,106,334,192,144,270,360
"2011","Enfield 001C","E01001546","Total",1783,133,45,88,1650,188,114,370,176,99,303,400
"2011","Enfield 001D","E01001552","Total",1762,161,64,97,1601,128,174,277,182,110,310,420
"2011","Enfield 002A","E01001442","Total",1661,161,74,87,1500,387,54,293,114,144,245,263
"2011","Enfield 002B","E01001545","Total",1841,174,70,104,1667,254,76,329,168,183,344,313
"2011","Enfield 002C","E01001547","Total",1758,175,79,96,1583,157,154,286,156,130,313,387
"2011","Enfield 002D","E01001548","Total",1819,169,75,94,1650,221,112,373,176,138,259,371
"2011","Enfield 002E","E01001551","Total",1692,201,73,128,1491,178,156,251,120,142,263,381
"2011","Enfield 003B","E01001445","Total",2281,323,53,270,1958,345,74,521,344,147,257,270
"2011","Enfield 003C","E01001447","Total",1936,234,85,149,1702,224,146,318,244,121,331,318
"2011","Enfield 003D","E01001448","Total",1831,162,44,118,1669,177,106,295,192,176,366,357
"2011","Enfield 003E","E01001449","Total",1635,117,31,86,1518,213,94,285,194,196,230,306
"2011","Enfield 003F","E01033148","Total",1950,136,25,111,1814,324,32,387,188,173,423,287
"2011","Enfield 003G","E01033150","Total",1656,210,6,204,1446,336,14,422,262,116,174,122
"2011","Enfield 004A","E01001408","Total",1646,229,82,147,1417,125,116,403,348,74,131,220
"2011","Enfield 004B","E01001411","Total",1840,210,76,134,1630,128,114,547,294,130,140,277
"2011","Enfield 004C","E01001412","Total",1834,146,66,80,1688,122,210,229,178,169,325,455
"2011","Enfield 004D","E01001413","Total",1581,149,91,58,1432,33,162,376,196,76,233,356
"2011","Enfield 004E","E01001414","Total",1563,259,118,141,1304,182,144,313,158,87,182,238
"2011","Enfield 005A","E01001407","Total",1627,125,59,66,1502,112,148,421,196,82,206,337
"2011","Enfield 005B","E01001409","Total",1881,301,71,230,1580,249,72,341,252,108,246,312
"2011","Enfield 005C","E01001410","Total",1667,284,47,237,1383,281,70,324,222,99,220,167
"2011","Enfield 005D","E01001516","Total",1825,145,65,80,1680,182,130,313,180,168,318,389
"2011","Enfield 005E","E01001537","Total",1705,198,78,120,1507,148,120,549,230,52,119,289
"2011","Enfield 006A","E01001439","Total",2074,224,65,159,1850,414,96,417,168,150,324,281
"2011","Enfield 006B","E01001441","Total",1512,225,47,178,1287,216,68,274,178,106,194,251
"2011","Enfield 006C","E01001517","Total",1890,201,64,137,1689,301,68,265,176,208,358,313
"2011","Enfield 006D","E01001549","Total",1975,251,46,205,1724,452,86,376,150,117,289,254
"2011","Enfield 006E","E01001550","Total",1661,104,36,68,1557,194,108,357,124,154,305,315
"2011","Enfield 007A","E01001433","Total",1822,97,35,62,1725,274,80,255,134,168,400,414
"2011","Enfield 007B","E01001434","Total",1567,129,51,78,1438,134,96,290,132,131,318,337
"2011","Enfield 007C","E01001435","Total",1480,80,36,44,1400,122,128,241,110,148,267,384
"2011","Enfield 007D","E01001436","Total",1883,124,51,73,1759,178,164,325,146,199,306,441
"2011","Enfield 007E","E01001438","Total",1656,97,29,68,1559,171,102,311,148,124,307,396
"2011","Enfield 008A","E01001469","Total",1630,160,70,90,1470,98,138,334,224,107,219,350
"2011","Enfield 008B","E01001536","Total",1699,227,97,130,1472,96,186,371,284,76,93,366
"2011","Enfield 008C","E01001540","Total",1763,272,92,180,1491,127,108,376,350,68,128,334
"2011","Enfield 008D","E01001541","Total",1497,224,68,156,1273,74,90,476,232,71,108,222
"2011","Enfield 008E","E01001542","Total",1563,237,121,116,1326,155,114,352,184,65,194,262
"2011","Enfield 009A","E01001538","Total",1660,114,61,53,1546,62,152,384,186,127,230,405
"2011","Enfield 009B","E01001539","Total",1653,175,83,92,1478,96,154,397,194,71,209,357
"2011","Enfield 009C","E01001543","Total",1672,108,64,44,1564,49,192,390,158,132,233,410
"2011","Enfield 009D","E01001544","Total",1583,148,83,65,1435,36,208,337,160,81,194,419
"2011","Enfield 010A","E01001457","Total",1576,331,104,227,1245,67,200,299,308,30,105,236
"2011","Enfield 010B","E01001468","Total",1205,181,93,88,1024,39,142,234,142,96,103,268
"2011","Enfield 010C","E01001471","Total",1710,452,157,295,1258,83,204,276,332,38,100,225
"2011","Enfield 010D","E01001472","Total",1682,278,107,171,1404,70,168,348,288,63,140,327
"2011","Enfield 010E","E01001474","Total",1767,298,112,186,1469,44,230,309,370,68,122,326
"2011","Enfield 011A","E01001415","Total",1541,238,172,66,1303,64,216,195,190,47,185,406
"2011","Enfield 011B","E01001417","Total",1673,126,83,43,1547,20,224,293,154,167,273,416
"2011","Enfield 011C","E01001418","Total",1639,231,127,104,1408,86,188,300,200,54,186,394
"2011","Enfield 011D","E01001422","Total",1641,74,36,38,1567,26,220,365,138,118,295,405
"2011","Enfield 012A","E01001440","Total",1641,162,88,74,1479,149,130,263,114,119,303,401
"2011","Enfield 012B","E01001504","Total",1540,102,48,54,1438,133,98,180,140,166,355,366
"2011","Enfield 012C","E01001505","Total",1727,126,47,79,1601,146,72,273,140,132,401,437
"2011","Enfield 012D","E01001507","Total",1870,268,71,197,1602,234,108,314,206,140,283,317
"2011","Enfield 012E","E01001508","Total",1914,204,47,157,1710,242,58,316,202,119,396,377
"2011","Enfield 012F","E01001513","Total",1770,158,79,79,1612,163,66,379,134,115,403,352
"2011","Enfield 013A","E01001416","Total",1733,100,64,36,1633,18,224,350,126,106,283,526
"2011","Enfield 013B","E01001470","Total",1598,179,104,75,1419,64,228,342,140,63,202,380
"2011","Enfield 013C","E01001473","Total",1534,96,62,34,1438,83,200,293,144,112,231,375
"2011","Enfield 013D","E01001475","Total",1704,140,87,53,1564,42,234,375,152,80,245,436
"2011","Enfield 014A","E01001437","Total",2373,334,108,226,2039,389,134,437,196,175,334,374
"2011","Enfield 014B","E01001506","Total",1635,133,30,103,1502,218,64,339,118,148,297,318
"2011","Enfield 014C","E01001509","Total",1738,220,43,177,1518,235,68,319,190,86,319,301
"2011","Enfield 014D","E01001510","Total",1496,205,34,171,1291,365,20,328,124,150,177,127
"2011","Enfield 015A","E01001405","Total",1641,383,176,207,1258,59,248,263,308,59,78,243
"2011","Enfield 015B","E01001406","Total",1598,209,56,153,1389,144,102,332,260,84,171,296
"2011","Enfield 015C","E01001450","Total",1865,382,161,221,1483,164,148,314,350,66,159,282
"2011","Enfield 015D","E01001512","Total",1767,287,88,199,1480,162,102,457,252,82,148,277
"2011","Enfield 015E","E01001515","Total",1938,231,52,179,1707,312,66,348,204,149,349,279
"2011","Enfield 016A","E01001401","Total",1323,130,72,58,1193,57,126,315,134,78,183,300
"2011","Enfield 016B","E01001478","Total",1531,114,54,60,1417,133,126,255,124,122,257,400
"2011","Enfield 016C","E01001484","Total",1362,141,69,72,1221,128,142,250,98,82,235,286
"2011","Enfield 016D","E01001511","Total",1747,145,68,77,1602,154,104,477,178,111,251,327
"2011","Enfield 016E","E01001514","Total",1765,180,54,126,1585,157,84,369,250,99,246,380
"2011","Enfield 016F","E01001518","Total",1767,177,49,128,1590,124,110,367,218,90,248,433
"2011","Enfield 017A","E01001451","Total",1621,192,78,114,1429,68,226,320,192,91,175,357
"2011","Enfield 017B","E01001452","Total",1356,85,44,41,1271,38,166,304,138,92,166,367
"2011","Enfield 017C","E01001453","Total",1677,164,83,81,1513,51,238,326,184,107,193,414
"2011","Enfield 017D","E01001454","Total",1620,189,130,59,1431,56,212,354,178,120,171,340
"2011","Enfield 018A","E01001476","Total",1666,138,63,75,1528,147,114,303,142,101,305,416
"2011","Enfield 018B","E01001477","Total",1850,128,46,82,1722,161,114,261,132,253,387,414
"2011","Enfield 018C","E01001481","Total",1620,131,53,78,1489,84,108,218,120,175,304,480
"2011","Enfield 018D","E01001502","Total",1720,154,57,97,1566,153,98,244,88,165,376,442
"2011","Enfield 018E","E01001503","Total",1844,143,80,63,1701,191,150,296,148,142,388,386
"2011","Enfield 019A","E01001520","Total",1680,189,62,127,1491,119,134,295,200,102,190,451
"2011","Enfield 019B","E01001522","Total",1727,228,32,196,1499,215,72,487,314,81,127,203
"2011","Enfield 019C","E01001523","Total",1739,240,144,96,1499,87,176,380,230,78,159,389
"2011","Enfield 019D","E01001524","Total",1522,121,59,62,1401,72,108,328,178,62,292,361
"2011","Enfield 019E","E01001526","Total",1619,176,98,78,1443,51,192,311,160,99,218,412
"2011","Enfield 020A","E01001419","Total",1938,215,116,99,1723,74,222,282,306,71,228,540
"2011","Enfield 020B","E01001420","Total",1553,140,63,77,1413,97,110,238,170,119,223,456
"2011","Enfield 020C","E01001421","Total",1672,240,124,116,1432,151,148,299,222,112,170,330
"2011","Enfield 020D","E01001519","Total",2496,411,109,302,2085,186,120,422,528,111,199,519
"2011","Enfield 020E","E01001525","Total",1747,215,72,143,1532,100,148,373,254,91,139,427
"2011","Enfield 021A","E01001398","Total",1368,88,43,45,1280,67,106,314,160,56,153,424
"2011","Enfield 021B","E01001399","Total",1437,84,48,36,1353,34,142,259,134,94,255,435
"2011","Enfield 021C","E01001400","Total",1528,147,113,34,1381,66,194,207,130,62,259,463
"2011","Enfield 021D","E01001402","Total",1809,173,71,102,1636,46,186,344,212,83,251,514
"2011","Enfield 021E","E01001403","Total",1602,197,100,97,1405,94,192,272,124,67,264,392
"2011","Enfield 021F","E01001455","Total",1491,151,60,91,1340,46,174,261,160,43,227,429
"2011","Enfield 022A","E01001456","Total",1400,83,47,36,1317,31,136,349,120,141,183,357
"2011","Enfield 022B","E01001564","Total",1624,182,54,128,1442,61,100,417,218,124,156,366
"2011","Enfield 022C","E01001567","Total",1583,162,85,77,1421,28,206,358,212,139,137,341
"2011","Enfield 022D","E01001568","Total",1580,80,42,38,1500,30,228,253,110,122,245,512
"2011","Enfield 022E","E01001569","Total",1722,248,92,156,1474,82,144,337,402,80,135,294
"2011","Enfield 023A","E01001479","Total",1683,203,61,142,1480,174,110,224,136,178,296,362
"2011","Enfield 023B","E01001482","Total",1854,207,62,145,1647,153,86,376,150,174,332,376
"2011","Enfield 023C","E01001487","Total",1949,228,103,125,1721,225,92,345,144,241,322,352
"2011","Enfield 023D","E01001489","Total",1803,171,49,122,1632,239,130,325,160,171,229,378
"2011","Enfield 023E","E01001491","Total",1973,195,61,134,1778,298,84,364,166,109,318,439
"2011","Enfield 024A","E01001459","Total",1675,102,43,59,1573,121,108,273,128,123,335,485
"2011","Enfield 024B","E01001460","Total",1689,215,40,175,1474,272,66,252,162,196,293,233
"2011","Enfield 024C","E01001462","Total",1339,176,33,143,1163,176,66,195,112,73,279,262
"2011","Enfield 024D","E01001480","Total",1516,183,51,132,1333,88,94,304,162,109,216,360
"2011","Enfield 024E","E01001488","Total",1883,163,55,108,1720,255,78,338,148,171,289,441
"2011","Enfield 025A","E01001483","Total",1150,318,37,281,832,170,48,171,142,61,130,110
"2011","Enfield 025B","E01001485","Total",1815,197,89,108,1618,227,104,308,166,168,326,319
"2011","Enfield 025C","E01001486","Total",2106,241,86,155,1865,323,74,446,198,168,277,379
"2011","Enfield 025E","E01001492","Total",1930,156,67,89,1774,245,116,250,158,178,321,506
"2011","Enfield 025F","E01033146","Total",1586,163,23,140,1423,229,40,348,172,132,315,187
"2011","Enfield 025G","E01033151","Total",1483,136,44,92,1347,274,64,238,118,116,267,270
"2011","Enfield 026A","E01001404","Total",1473,109,55,54,1364,89,140,248,140,88,296,363
"2011","Enfield 026B","E01001493","Total",1767,259,95,164,1508,129,142,302,206,88,254,387
"2011","Enfield 026C","E01001494","Total",1515,87,51,36,1428,54,162,253,108,81,340,430
"2011","Enfield 026D","E01001496","Total",1701,125,75,50,1576,57,150,274,170,108,345,472
"2011","Enfield 026E","E01001570","Total",1820,251,97,154,1569,174,94,378,232,92,206,393
"2011","Enfield 027A","E01001423","Total",1800,174,80,94,1626,160,108,298,152,163,424,321
"2011","Enfield 027B","E01001425","Total",1859,242,39,203,1617,350,54,332,146,185,265,285
"2011","Enfield 027C","E01001428","Total",1677,183,84,99,1494,183,68,230,124,151,368,370
"2011","Enfield 027D","E01001461","Total",1706,270,54,216,1436,236,78,297,148,96,290,291
"2011","Enfield 027E","E01001464","Total",1330,81,39,42,1249,90,92,164,86,87,411,319
"2011","Enfield 028A","E01001521","Total",1756,187,91,96,1569,57,136,440,240,62,208,426
"2011","Enfield 028B","E01001531","Total",1462,121,50,71,1341,32,132,341,176,84,212,364
"2011","Enfield 028C","E01001532","Total",1764,183,63,120,1581,57,144,354,242,98,233,453
"2011","Enfield 028D","E01001533","Total",1533,87,65,22,1446,21,208,274,110,128,201,504
"2011","Enfield 028E","E01001535","Total",1482,92,55,37,1390,52,148,253,116,60,259,502
"2011","Enfield 029A","E01001495","Total",1715,216,53,163,1499,67,92,361,348,85,127,419
"2011","Enfield 029B","E01001498","Total",1939,179,57,122,1760,95,110,422,312,62,245,514
"2011","Enfield 029C","E01001563","Total",1585,217,63,154,1368,67,84,350,292,97,137,341
"2011","Enfield 029D","E01001565","Total",1636,253,120,133,1383,93,122,290,240,80,188,370
"2011","Enfield 029E","E01001566","Total",1598,172,47,125,1426,39,78,343,256,94,213,403
"2011","Enfield 030A","E01001424","Total",1210,164,35,129,1046,198,30,283,138,85,151,161
"2011","Enfield 030B","E01001426","Total",1821,146,45,101,1675,217,80,279,138,131,391,439
"2011","Enfield 030C","E01001427","Total",1840,203,65,138,1637,272,54,319,166,223,301,302
"2011","Enfield 030D","E01001429","Total",2394,513,170,343,1881,345,110,453,282,205,234,252
"2011","Enfield 030E","E01001430","Total",1884,149,51,98,1735,364,66,335,154,217,319,280
"2011","Enfield 031A","E01001463","Total",1573,86,50,36,1487,86,116,231,118,148,323,465
"2011","Enfield 031B","E01001465","Total",1505,84,42,42,1421,119,116,262,120,59,312,433
"2011","Enfield 031C","E01001466","Total",1795,139,34,105,1656,245,62,354,172,161,348,314
"2011","Enfield 031D","E01001467","Total",1874,119,31,88,1755,206,80,335,172,182,340,440
"2011","Enfield 031E","E01001497","Total",1476,121,71,50,1355,115,120,270,102,86,262,400
"2011","Enfield 031F","E01001499","Total",1650,118,54,64,1532,46,172,206,114,115,343,536
"2011","Enfield 032A","E01001392","Total",1824,158,68,90,1666,48,122,302,244,96,270,584
"2011","Enfield 032B","E01001528","Total",1445,150,28,122,1295,171,62,210,158,88,202,404
"2011","Enfield 032C","E01001529","Total",1490,216,39,177,1274,155,78,224,230,59,187,341
"2011","Enfield 032D","E01001530","Total",1290,98,42,56,1192,59,108,226,152,50,221,376
"2011","Enfield 032E","E01001534","Total",1612,126,46,80,1486,49,170,289,174,89,243,472
"2011","Enfield 033A","E01001431","Total",1549,196,25,171,1353,204,48,277,176,196,194,258
"2011","Enfield 033B","E01001432","Total",1904,187,64,123,1717,235,82,329,178,190,314,389
"2011","Enfield 033C","E01001555","Total",1783,150,48,102,1633,157,124,275,136,146,380,415
"2011","Enfield 033D","E01001557","Total",1586,113,38,75,1473,176,94,278,126,172,304,323
"2011","Enfield 033E","E01001558","Total",1613,128,43,85,1485,266,62,270,114,206,282,285
"2011","Enfield 033F","E01001559","Total",1977,193,38,155,1784,298,58,354,224,113,295,442
"2011","Enfield 035A","E01001394","Total",1653,188,73,115,1465,107,104,221,212,83,251,487
"2011","Enfield 035B","E01001395","Total",1590,161,47,114,1429,220,64,308,182,92,211,352
"2011","Enfield 035C","E01001397","Total",1924,236,40,196,1688,179,104,363,294,67,241,440
"2011","Enfield 035D","E01001500","Total",1516,126,44,82,1390,76,120,309,164,64,294,363
"2011","Enfield 035E","E01001556","Total",1579,107,49,58,1472,95,136,241,126,88,301,485
"2011","Enfield 035F","E01001560","Total",1599,86,39,47,1513,110,106,208,130,154,308,497
"2011","Enfield 036A","E01001390","Total",1971,194,53,141,1777,72,84,370,348,86,160,657
"2011","Enfield 036B","E01001391","Total",1529,238,39,199,1291,82,70,298,320,35,124,362
"2011","Enfield 036C","E01001393","Total",2112,224,44,180,1888,81,94,406,390,85,184,648
"2011","Enfield 036D","E01001396","Total",1413,120,56,64,1293,79,144,184,118,31,204,533
"2011","Enfield 036E","E01001501","Total",1816,322,89,233,1494,136,66,349,302,43,239,359
"2011","Enfield 036F","E01001527","Total",1563,197,82,115,1366,69,150,297,228,57,146,419
"2011","Enfield 037A","E01001458","Total",1724,202,40,162,1522,260,66,329,146,108,241,372
"2011","Enfield 037B","E01001553","Total",1597,98,21,77,1499,215,84,261,112,124,403,300
"2011","Enfield 037C","E01001554","Total",1791,273,74,199,1518,251,68,354,188,115,316,226
"2011","Enfield 037D","E01001562","Total",1654,273,20,253,1381,235,48,273,210,120,271,224
"2011","Enfield 037E","E01032574","Total",2059,147,51,96,1912,290,106,351,142,166,387,470
"2011","Greenwich 001A","E01001690","Total",1931,373,73,300,1558,225,82,338,206,212,211,284
"2011","Greenwich 001B","E01001692","Total",1391,158,26,132,1233,164,46,261,126,162,212,262
"2011","Greenwich 001C","E01001693","Total",1558,203,30,173,1355,259,52,271,140,122,289,222
"2011","Greenwich 001D","E01001694","Total",1683,164,26,138,1519,137,48,296,184,161,343,350
"2011","Greenwich 002A","E01001687","Total",1206,195,53,142,1011,105,56,269,142,73,186,180
"2011","Greenwich 002B","E01001688","Total",2500,265,33,232,2235,411,44,707,204,252,283,334
"2011","Greenwich 002E","E01033739","Total",1443,156,4,152,1287,190,6,363,252,110,198,168
"2011","Greenwich 002F","E01033740","Total",1577,120,9,111,1457,200,32,390,172,147,289,227
"2011","Greenwich 002G","E01033741","Total",1681,111,7,104,1570,212,18,438,178,174,318,232
"2011","Greenwich 002H","E01033743","Total",2038,123,39,84,1915,374,28,479,154,244,384,252
"2011","Greenwich 002I","E01033745","Total",1820,104,12,92,1716,244,48,424,174,200,378,248
"2011","Greenwich 003A","E01001575","Total",1707,162,56,106,1545,226,88,235,118,234,333,311
"2011","Greenwich 003B","E01001576","Total",1700,211,64,147,1489,245,90,312,124,191,293,234
"2011","Greenwich 003C","E01001577","Total",1857,270,85,185,1587,255,104,302,144,215,340,227
"2011","Greenwich 003D","E01001578","Total",2129,232,65,167,1897,218,78,489,254,164,319,375
"2011","Greenwich 003E","E01001579","Total",1646,186,64,122,1460,205,120,283,150,142,262,298
"2011","Greenwich 004B","E01001709","Total",1170,202,39,163,968,114,66,116,110,97,202,263
"2011","Greenwich 004C","E01001711","Total",1413,245,26,219,1168,101,26,270,216,74,197,284
"2011","Greenwich 004D","E01001712","Total",2085,373,99,274,1712,317,38,474,262,164,181,276
"2011","Greenwich 004E","E01033731","Total",1017,258,3,255,759,84,2,143,350,21,64,95
"2011","Greenwich 004F","E01033734","Total",1320,215,3,212,1105,130,8,196,346,115,140,170
"2011","Greenwich 004G","E01033735","Total",1073,259,46,213,814,89,32,218,256,16,81,122
"2011","Greenwich 004H","E01033736","Total",1125,240,3,237,885,41,14,194,494,10,28,104
"2011","Greenwich 004I","E01033737","Total",1495,224,56,168,1271,189,36,265,132,143,237,269
"2011","Greenwich 005A","E01001705","Total",1993,239,53,186,1754,281,38,363,206,209,362,295
"2011","Greenwich 005B","E01001706","Total",1321,114,14,100,1207,134,58,199,134,111,229,342
"2011","Greenwich 005C","E01001708","Total",1595,199,55,144,1396,118,100,316,212,124,201,325
"2011","Greenwich 005D","E01001710","Total",1694,248,71,177,1446,297,38,334,164,122,249,242
"2011","Greenwich 005E","E01001713","Total",1690,207,26,181,1483,286,52,325,124,212,280,204
"2011","Greenwich 006A","E01001672","Total",2049,115,24,91,1934,157,72,254,152,195,571,533
"2011","Greenwich 006B","E01001673","Total",1892,254,98,156,1638,114,80,167,160,120,497,500
"2011","Greenwich 006C","E01001674","Total",1973,175,72,103,1798,157,112,282,156,154,504,433
"2011","Greenwich 006D","E01001675","Total",1980,149,37,112,1831,125,70,317,168,101,468,582
"2011","Greenwich 006E","E01001677","Total",1948,189,47,142,1759,170,62,303,206,127,489,402
"2011","Greenwich 007B","E01001631","Total",2072,272,39,233,1800,299,64,353,182,180,340,382
"2011","Greenwich 007C","E01001632","Total",2290,139,42,97,2151,91,40,283,144,86,866,641
"2011","Greenwich 007D","E01001635","Total",1661,174,36,138,1487,131,66,321,216,90,202,461
"2011","Greenwich 007E","E01001636","Total",1722,192,60,132,1530,94,78,245,132,84,321,576
"2011","Greenwich 007F","E01033742","Total",1352,180,14,166,1172,83,24,314,326,47,153,225
"2011","Greenwich 007G","E01033744","Total",1728,169,13,156,1559,190,42,360,220,161,269,317
"2011","Greenwich 008A","E01001571","Total",1639,157,48,109,1482,152,84,321,192,94,298,341
"2011","Greenwich 008B","E01001572","Total",1711,156,52,104,1555,113,100,362,208,172,306,294
"2011","Greenwich 008C","E01001573","Total",1505,101,32,69,1404,103,86,287,150,80,348,350
"2011","Greenwich 008D","E01001574","Total",1748,303,73,230,1445,316,80,406,144,108,167,224
"2011","Greenwich 009A","E01001629","Total",2176,266,57,209,1910,227,84,401,256,191,325,426
"2011","Greenwich 009B","E01001633","Total",1607,240,45,195,1367,157,56,292,192,159,233,278
"2011","Greenwich 009C","E01001634","Total",1661,217,44,173,1444,247,66,297,190,148,231,265
"2011","Greenwich 009D","E01001637","Total",1703,287,60,227,1416,133,76,247,200,75,317,368
"2011","Greenwich 011A","E01001695","Total",1626,256,97,159,1370,117,66,238,164,140,280,365
"2011","Greenwich 011B","E01001696","Total",1350,168,46,122,1182,155,30,231,112,101,290,263
"2011","Greenwich 011C","E01001697","Total",2094,224,34,190,1870,253,54,469,180,160,269,485
"2011","Greenwich 011D","E01001700","Total",2009,207,23,184,1802,238,50,330,184,212,356,432
"2011","Greenwich 011E","E01001703","Total",1934,277,38,239,1657,271,36,373,168,241,381,187
"2011","Greenwich 011F","E01001704","Total",1618,175,39,136,1443,93,74,288,214,176,245,353
"2011","Greenwich 012A","E01001588","Total",1615,239,113,126,1376,103,122,215,154,94,332,356
"2011","Greenwich 012B","E01001589","Total",1598,177,37,140,1421,97,86,250,230,59,300,399
"2011","Greenwich 012C","E01001591","Total",2034,308,110,198,1726,244,74,351,240,178,284,355
"2011","Greenwich 012D","E01001595","Total",1934,152,54,98,1782,229,98,378,212,189,297,379
"2011","Greenwich 014A","E01001590","Total",1777,203,50,153,1574,103,76,313,276,97,277,432
"2011","Greenwich 014B","E01001592","Total",1718,240,59,181,1478,63,76,483,336,62,159,299
"2011","Greenwich 014C","E01001593","Total",1631,226,74,152,1405,50,134,464,358,60,92,247
"2011","Greenwich 014D","E01001594","Total",1937,227,72,155,1710,267,68,420,264,137,260,294
"2011","Greenwich 015A","E01001698","Total",1774,228,33,195,1546,247,44,271,176,178,350,280
"2011","Greenwich 015B","E01001699","Total",1466,207,27,180,1259,164,32,427,188,79,196,173
"2011","Greenwich 015C","E01001701","Total",1520,215,42,173,1305,105,48,458,178,234,166,116
"2011","Greenwich 015D","E01001702","Total",1676,71,22,49,1605,211,46,187,102,257,502,300
"2011","Greenwich 016A","E01001581","Total",1675,388,140,248,1287,45,108,301,326,69,121,317
"2011","Greenwich 016B","E01001585","Total",1525,177,49,128,1348,39,114,457,298,62,152,226
"2011","Greenwich 016C","E01001586","Total",1422,280,93,187,1142,88,132,279,258,68,103,214
"2011","Greenwich 016D","E01001587","Total",1890,386,90,296,1504,75,142,382,386,86,143,290
"2011","Greenwich 017A","E01001678","Total",1667,156,82,74,1511,83,154,332,166,86,292,398
"2011","Greenwich 017B","E01001683","Total",1508,163,54,109,1345,65,78,277,178,155,220,372
"2011","Greenwich 017C","E01001684","Total",1472,145,59,86,1327,132,114,280,146,94,217,344
"2011","Greenwich 017D","E01001685","Total",1522,194,83,111,1328,98,112,268,170,65,225,390
"2011","Greenwich 019A","E01001646","Total",2828,386,57,329,2442,288,76,610,498,180,302,488
"2011","Greenwich 019B","E01001650","Total",1733,130,53,77,1603,134,142,273,180,88,312,474
"2011","Greenwich 019C","E01001651","Total",1714,303,81,222,1411,146,152,294,176,125,251,267
"2011","Greenwich 019D","E01001652","Total",1530,253,122,131,1277,41,122,292,258,77,175,312
"2011","Greenwich 020A","E01001679","Total",1346,135,38,97,1211,54,82,309,200,121,214,231
"2011","Greenwich 020B","E01001680","Total",1572,151,69,82,1421,69,178,326,198,63,210,377
"2011","Greenwich 020C","E01001681","Total",1224,153,39,114,1071,64,60,277,168,75,166,261
"2011","Greenwich 020D","E01001682","Total",1327,169,57,112,1158,84,164,246,212,93,152,207
"2011","Greenwich 020E","E01001686","Total",1770,289,74,215,1481,191,88,336,218,108,214,326
"2011","Greenwich 021A","E01001580","Total",1642,331,73,258,1311,52,110,306,466,62,76,239
"2011","Greenwich 021B","E01001582","Total",1442,235,81,154,1207,100,138,361,182,76,110,240
"2011","Greenwich 021C","E01001583","Total",1603,349,85,264,1254,47,118,256,438,88,112,195
"2011","Greenwich 021D","E01001584","Total",1465,290,89,201,1175,16,160,332,306,102,103,156
"2011","Greenwich 022A","E01001645","Total",1697,232,95,137,1465,142,126,329,202,90,200,376
"2011","Greenwich 022B","E01001647","Total",1491,163,71,92,1328,95,144,242,140,64,253,390
"2011","Greenwich 022C","E01001648","Total",1751,249,59,190,1502,78,126,323,234,114,258,369
"2011","Greenwich 022D","E01001649","Total",1524,146,48,98,1378,84,82,305,178,118,235,376
"2011","Greenwich 023A","E01001605","Total",1584,96,54,42,1488,8,200,323,184,112,248,413
"2011","Greenwich 023B","E01001606","Total",1637,130,58,72,1507,69,122,449,226,78,178,385
"2011","Greenwich 023C","E01001610","Total",1669,211,101,110,1458,71,160,404,252,63,163,345
"2011","Greenwich 023D","E01001611","Total",1659,263,129,134,1396,77,188,370,222,89,131,319
"2011","Greenwich 025A","E01001620","Total",1591,87,48,39,1504,87,112,195,122,142,408,438
"2011","Greenwich 025B","E01001621","Total",1491,209,78,131,1282,105,80,216,196,74,256,355
"2011","Greenwich 025C","E01001623","Total",1696,160,47,113,1536,125,108,334,280,140,203,346
"2011","Greenwich 025D","E01001624","Total",1551,174,74,100,1377,78,142,366,206,58,222,305
"2011","Greenwich 025E","E01001625","Total",1577,149,81,68,1428,88,130,222,154,99,316,419
"2011","Greenwich 027A","E01001604","Total",1440,152,67,85,1288,36,116,357,190,78,163,348
"2011","Greenwich 027B","E01001607","Total",1474,163,93,70,1311,73,130,359,220,64,139,326
"2011","Greenwich 027C","E01001608","Total",1447,196,98,98,1251,37,184,238,150,103,231,308
"2011","Greenwich 027D","E01001609","Total",1602,322,142,180,1280,58,138,319,166,99,110,390
"2011","Greenwich 028A","E01001613","Total",1586,343,138,205,1243,70,168,262,250,89,129,275
"2011","Greenwich 028B","E01001614","Total",1409,93,66,27,1316,21,250,199,160,35,223,428
"2011","Greenwich 028C","E01001615","Total",1517,346,131,215,1171,90,114,244,264,53,135,271
"2011","Greenwich 028D","E01001617","Total",1574,284,140,144,1290,47,218,279,228,61,130,327
"2011","Greenwich 029A","E01001653","Total",1547,168,55,113,1379,191,90,339,176,87,230,266
"2011","Greenwich 029B","E01001654","Total",1546,185,60,125,1361,151,118,291,124,190,227,260
"2011","Greenwich 029C","E01001655","Total",1465,218,48,170,1247,196,86,245,194,136,136,254
"2011","Greenwich 029D","E01001660","Total",1600,144,61,83,1456,142,122,253,152,151,273,363
"2011","Greenwich 029E","E01001661","Total",1525,142,77,65,1383,108,150,254,196,97,283,295
"2011","Greenwich 030C","E01001618","Total",1604,187,95,92,1417,120,148,387,192,89,162,319
"2011","Greenwich 030D","E01001619","Total",1880,255,80,175,1625,125,144,394,378,91,185,308
"2011","Greenwich 030E","E01033729","Total",1895,287,104,183,1608,244,122,341,202,131,208,360
"2011","Greenwich 031A","E01001597","Total",1543,181,75,106,1362,47,144,274,204,105,216,372
"2011","Greenwich 031B","E01001598","Total",1587,150,85,65,1437,42,174,252,188,53,257,471
"2011","Greenwich 031C","E01001602","Total",1873,209,99,110,1664,133,162,276,198,133,395,367
"2011","Greenwich 031D","E01001603","Total",1655,332,138,194,1323,156,130,339,166,82,174,276
"2011","Greenwich 032A","E01001596","Total",1558,120,86,34,1438,40,202,345,208,53,225,365
"2011","Greenwich 032B","E01001599","Total",1701,133,76,57,1568,56,172,309,162,121,297,451
"2011","Greenwich 032C","E01001600","Total",1557,215,68,147,1342,56,142,326,240,86,141,351
"2011","Greenwich 032D","E01001601","Total",1461,187,111,76,1274,31,122,346,204,68,182,321
"2011","Greenwich 033A","E01001669","Total",1874,191,68,123,1683,161,92,320,190,158,381,381
"2011","Greenwich 033B","E01001671","Total",1578,245,68,177,1333,157,82,384,212,69,174,255
"2011","Greenwich 033C","E01001676","Total",1791,172,38,134,1619,257,30,349,162,158,330,333
"2011","Greenwich 033D","E01032567","Total",1651,137,68,69,1514,83,116,286,140,130,317,442
"2011","Greenwich 034A","E01001656","Total",1272,209,103,106,1063,88,138,251,214,40,127,205
"2011","Greenwich 034B","E01001657","Total",1527,253,78,175,1274,68,154,388,228,92,166,178
"2011","Greenwich 034C","E01001658","Total",1549,287,120,167,1262,123,132,294,258,75,154,226
"2011","Greenwich 034D","E01001659","Total",1454,133,79,54,1321,42,126,241,124,66,245,477
"2011","Greenwich 034E","E01033726","Total",2439,164,67,97,2275,232,140,394,206,220,538,545
"2011","Greenwich 035A","E01001640","Total",2109,254,48,206,1855,309,52,378,366,134,162,454
"2011","Greenwich 035B","E01033727","Total",1861,282,32,250,1579,243,46,303,324,102,267,294
"2011","Greenwich 035C","E01033728","Total",1226,258,7,251,968,48,24,243,456,15,22,160
"2011","Greenwich 035D","E01033730","Total",1214,287,34,253,927,111,18,204,402,33,38,121
"2011","Greenwich 036A","E01001666","Total",1469,174,49,125,1295,67,66,224,202,55,248,433
"2011","Greenwich 036B","E01001667","Total",1564,291,110,181,1273,149,90,230,230,97,129,348
"2011","Greenwich 036C","E01001668","Total",2269,394,106,288,1875,222,138,446,456,146,187,280
"2011","Greenwich 036D","E01033732","Total",1053,143,5,138,910,125,12,214,300,20,84,155
"2011","Greenwich 036E","E01033733","Total",1134,164,3,161,970,47,18,279,454,21,29,122
"2011","Greenwich 037A","E01001662","Total",1608,189,36,153,1419,75,86,319,452,63,63,361
"2011","Greenwich 037B","E01001664","Total",1870,317,103,214,1553,54,118,314,408,87,159,413
"2011","Greenwich 037C","E01001665","Total",1863,250,34,216,1613,44,66,442,370,92,153,446
"2011","Greenwich 037D","E01033738","Total",1216,186,55,131,1030,41,36,208,234,44,115,352
"2011","Greenwich 038A","E01001638","Total",1894,285,55,230,1609,257,58,296,302,163,224,309
"2011","Greenwich 038B","E01001641","Total",1663,291,89,202,1372,90,96,281,406,139,85,275
"2011","Greenwich 038C","E01001642","Total",1768,247,94,153,1521,58,144,467,436,129,88,199
"2011","Greenwich 038D","E01001644","Total",2212,354,42,312,1858,119,86,433,598,61,137,424
"2011","Greenwich 038E","E01033746","Total",1436,278,120,158,1158,54,108,275,396,52,89,184
"2011","Harrow 001A","E01002112","Total",1890,150,93,57,1740,39,252,320,186,106,333,504
"2011","Harrow 001B","E01002114","Total",1990,424,259,165,1566,85,320,352,290,79,142,298
"2011","Harrow 001C","E01002225","Total",1450,155,97,58,1295,12,350,204,194,77,140,318
"2011","Harrow 001D","E01002226","Total",2228,351,206,145,1877,79,334,422,302,90,240,410
"2011","Harrow 002A","E01002113","Total",1547,168,82,86,1379,55,174,263,144,85,271,387
"2011","Harrow 002B","E01002115","Total",1509,82,55,27,1427,42,148,276,156,74,299,432
"2011","Harrow 002C","E01002116","Total",1668,200,111,89,1468,49,252,185,176,75,288,443
"2011","Harrow 002D","E01002117","Total",2105,131,52,79,1974,105,146,352,170,172,511,518
"2011","Harrow 002E","E01002118","Total",1696,193,100,93,1503,119,138,281,246,64,277,378
"2011","Harrow 003A","E01002227","Total",1733,160,80,80,1573,91,112,184,134,131,477,444
"2011","Harrow 003B","E01002228","Total",2103,123,47,76,1980,92,170,418,246,191,426,437
"2011","Harrow 003C","E01002229","Total",1710,270,149,121,1440,83,258,288,214,55,185,357
"2011","Harrow 003D","E01002230","Total",1776,114,64,50,1662,33,252,317,168,91,282,519
"2011","Harrow 004A","E01002144","Total",1570,138,91,47,1432,44,210,225,150,73,290,440
"2011","Harrow 004B","E01002146","Total",1481,97,67,30,1384,7,160,391,130,73,266,357
"2011","Harrow 004C","E01002147","Total",1309,108,65,43,1201,6,228,151,152,81,189,394
"2011","Harrow 004D","E01002149","Total",1361,63,46,17,1298,14,204,328,114,87,171,380
"2011","Harrow 005A","E01002140","Total",1702,131,79,52,1571,118,158,226,142,97,374,456
"2011","Harrow 005B","E01002141","Total",1753,194,131,63,1559,89,200,253,154,81,275,507
"2011","Harrow 005C","E01002142","Total",1779,135,68,67,1644,52,186,263,172,117,351,503
"2011","Harrow 005D","E01002143","Total",1568,92,40,52,1476,118,84,306,148,116,302,402
"2011","Harrow 005E","E01002145","Total",1496,207,141,66,1289,52,222,233,156,114,185,327
"2011","Harrow 006A","E01002139","Total",1426,120,70,50,1306,173,80,150,130,113,307,353
"2011","Harrow 006B","E01002148","Total",1449,73,46,27,1376,24,158,318,114,47,303,412
"2011","Harrow 006C","E01002150","Total",1843,311,149,162,1532,101,208,379,266,76,234,268
"2011","Harrow 006D","E01002151","Total",1479,143,81,62,1336,91,98,227,122,158,326,314
"2011","Harrow 006E","E01002152","Total",1624,160,99,61,1464,25,184,392,206,36,229,392
"2011","Harrow 007A","E01002119","Total",1708,109,45,64,1599,103,102,282,146,109,351,506
"2011","Harrow 007B","E01002120","Total",1296,147,66,81,1149,61,100,252,104,70,213,349
"2011","Harrow 007C","E01002121","Total",1761,85,41,44,1676,43,126,274,144,150,401,538
"2011","Harrow 007D","E01002122","Total",1706,140,66,74,1566,57,102,302,124,82,362,537
"2011","Harrow 007E","E01002123","Total",1735,97,45,52,1638,45,100,223,92,68,474,636
"2011","Harrow 008A","E01002106","Total",1983,98,44,54,1885,76,184,282,174,156,335,678
"2011","Harrow 008B","E01002108","Total",1819,58,34,24,1761,38,136,356,138,161,412,520
"2011","Harrow 008C","E01002109","Total",1785,132,75,57,1653,40,190,404,198,64,237,520
"2011","Harrow 008D","E01002110","Total",1762,59,34,25,1703,48,164,345,122,93,448,483
"2011","Harrow 008E","E01002111","Total",2169,114,54,60,2055,95,124,377,164,183,518,594
"2011","Harrow 009A","E01002185","Total",1543,144,70,74,1399,169,70,256,200,118,249,337
"2011","Harrow 009B","E01002186","Total",1644,328,128,200,1316,95,134,340,298,68,149,232
"2011","Harrow 009C","E01002187","Total",1821,221,129,92,1600,67,264,315,242,92,245,375
"2011","Harrow 009D","E01002190","Total",1672,117,83,34,1555,10,292,288,166,81,286,432
"2011","Harrow 010A","E01002124","Total",1769,60,30,30,1709,71,80,275,84,147,530,522
"2011","Harrow 010B","E01002125","Total",1678,75,30,45,1603,60,98,229,112,137,327,640
"2011","Harrow 010C","E01002198","Total",1820,51,26,25,1769,72,62,260,88,163,464,660
"2011","Harrow 010D","E01002200","Total",1688,67,41,26,1621,63,104,210,110,118,421,595
"2011","Harrow 010E","E01002203","Total",1751,66,28,38,1685,79,94,358,112,118,421,503
"2011","Harrow 011A","E01002232","Total",1936,181,80,101,1755,109,150,348,194,125,352,477
"2011","Harrow 011B","E01002233","Total",2029,210,73,137,1819,139,96,441,230,74,444,395
"2011","Harrow 011C","E01002234","Total",1741,105,43,62,1636,87,76,255,146,193,399,480
"2011","Harrow 011D","E01002235","Total",1922,147,90,57,1775,129,110,207,98,256,502,473
"2011","Harrow 011E","E01002236","Total",1803,121,40,81,1682,87,82,257,160,159,414,523
"2011","Harrow 012A","E01002107","Total",1774,93,44,49,1681,49,94,430,152,127,380,449
"2011","Harrow 012B","E01002197","Total",1330,80,54,26,1250,42,92,227,72,77,305,435
"2011","Harrow 012C","E01002199","Total",1533,72,32,40,1461,32,92,223,82,146,338,548
"2011","Harrow 012D","E01002201","Total",1742,64,41,23,1678,24,112,212,106,96,480,648
"2011","Harrow 012E","E01002202","Total",2039,152,66,86,1887,184,98,454,198,102,375,476
"2011","Harrow 013A","E01002179","Total",2247,173,50,123,2074,224,98,444,236,59,405,608
"2011","Harrow 013B","E01002180","Total",2085,217,71,146,1868,193,84,372,266,146,351,456
"2011","Harrow 013C","E01002183","Total",2070,145,67,78,1925,113,136,254,166,131,476,649
"2011","Harrow 013D","E01002184","Total",1885,154,67,87,1731,125,130,400,204,126,323,423
"2011","Harrow 013E","E01002231","Total",1924,156,69,87,1768,155,86,354,198,168,373,434
"2011","Harrow 015A","E01002154","Total",2021,150,75,75,1871,74,172,358,214,131,390,532
"2011","Harrow 015B","E01002156","Total",1516,62,39,23,1454,25,170,282,110,51,295,521
"2011","Harrow 015C","E01002162","Total",1879,167,66,101,1712,121,118,404,184,144,269,472
"2011","Harrow 015D","E01002163","Total",1636,84,47,37,1552,43,146,263,132,81,414,473
"2011","Harrow 016A","E01002188","Total",1616,140,91,49,1476,25,276,306,188,142,174,365
"2011","Harrow 016B","E01002189","Total",1661,230,120,110,1431,45,208,326,274,76,227,275
"2011","Harrow 016C","E01002192","Total",1532,188,112,76,1344,16,234,376,176,76,193,273
"2011","Harrow 016D","E01002193","Total",1797,217,89,128,1580,136,136,469,260,144,142,293
"2011","Harrow 017A","E01002165","Total",1734,86,44,42,1648,63,92,240,112,108,404,629
"2011","Harrow 017B","E01002166","Total",1663,65,35,30,1598,48,122,204,88,82,509,545
"2011","Harrow 017C","E01002167","Total",1623,74,53,21,1549,82,90,172,70,82,441,612
"2011","Harrow 017D","E01002168","Total",1492,121,58,63,1371,107,72,282,86,61,352,411
"2011","Harrow 017E","E01002169","Total",1619,99,62,37,1520,75,104,163,136,79,346,617
"2011","Harrow 019A","E01002153","Total",1757,121,82,39,1636,18,206,338,130,88,411,445
"2011","Harrow 019B","E01002155","Total",1630,167,97,70,1463,26,166,396,210,48,236,381
"2011","Harrow 019C","E01002157","Total",1687,120,51,69,1567,48,118,287,162,83,264,605
"2011","Harrow 019D","E01002158","Total",1457,74,45,29,1383,26,134,314,130,58,255,466
"2011","Harrow 020A","E01002128","Total",1968,232,46,186,1736,69,88,421,332,80,203,543
"2011","Harrow 020B","E01002130","Total",2260,224,39,185,2036,178,66,489,420,75,267,541
"2011","Harrow 020C","E01002181","Total",1853,167,62,105,1686,53,78,433,286,117,276,443
"2011","Harrow 020D","E01002182","Total",2044,147,42,105,1897,74,108,406,208,85,408,608
"2011","Harrow 021A","E01002159","Total",1857,163,57,106,1694,60,132,321,216,115,289,561
"2011","Harrow 021B","E01002160","Total",1967,166,38,128,1801,87,76,466,246,122,280,524
"2011","Harrow 021C","E01002161","Total",2029,181,70,111,1848,82,126,371,218,118,467,466
"2011","Harrow 021D","E01002164","Total",1753,180,59,121,1573,92,108,350,280,119,249,375
"2011","Harrow 022A","E01002191","Total",1964,110,55,55,1854,57,154,552,168,129,323,471
"2011","Harrow 022B","E01002194","Total",1721,128,82,46,1593,43,252,387,194,101,232,384
"2011","Harrow 022C","E01002195","Total",1635,127,87,40,1508,59,188,400,168,109,219,365
"2011","Harrow 022D","E01002196","Total",1759,99,71,28,1660,20,170,426,156,125,263,500
"2011","Harrow 023A","E01002126","Total",2747,397,160,237,2350,71,168,676,536,56,293,550
"2011","Harrow 023B","E01002127","Total",1653,144,49,95,1509,73,130,264,260,48,218,516
"2011","Harrow 023C","E01002129","Total",2026,304,76,228,1722,119,112,351,422,118,173,427
"2011","Harrow 023D","E01002131","Total",1624,146,68,78,1478,100,110,249,130,93,297,499
"2011","Harrow 024A","E01002237","Total",1626,196,44,152,1430,69,64,355,276,65,232,369
"2011","Harrow 024B","E01002238","Total",1800,106,49,57,1694,61,96,423,174,97,352,491
"2011","Harrow 024C","E01002240","Total",1712,176,71,105,1536,67,140,326,216,91,275,421
"2011","Harrow 024D","E01002242","Total",1890,87,48,39,1803,59,202,346,120,107,397,572
"2011","Harrow 025A","E01002208","Total",1357,78,56,22,1279,17,220,281,104,92,256,309
"2011","Harrow 025B","E01002209","Total",1638,85,41,44,1553,31,158,285,152,114,326,487
"2011","Harrow 025C","E01002239","Total",1678,142,74,68,1536,53,220,341,178,106,256,382
"2011","Harrow 025D","E01002241","Total",1636,104,34,70,1532,73,80,281,128,153,365,452
"2011","Harrow 027A","E01002133","Total",2031,350,127,223,1681,152,170,381,224,120,215,419
"2011","Harrow 027B","E01002136","Total",1741,143,81,62,1598,70,130,385,198,162,240,413
"2011","Harrow 027C","E01002138","Total",1544,91,36,55,1453,89,78,299,154,110,337,386
"2011","Harrow 027D","E01002213","Total",2911,316,99,217,2595,252,108,669,376,189,458,543
"2011","Harrow 028A","E01002211","Total",1514,72,23,49,1442,97,74,286,120,97,350,418
"2011","Harrow 028B","E01002212","Total",1749,165,67,98,1584,110,92,415,188,125,278,376
"2011","Harrow 028C","E01002216","Total",1699,70,39,31,1629,62,94,401,98,115,429,430
"2011","Harrow 028D","E01002217","Total",1526,151,49,102,1375,168,44,241,172,168,349,233
"2011","Harrow 029A","E01002132","Total",1962,246,60,186,1716,55,124,464,422,105,230,316
"2011","Harrow 029B","E01002134","Total",1419,191,65,126,1228,42,128,381,232,42,158,245
"2011","Harrow 029C","E01002135","Total",1700,181,81,100,1519,75,96,366,218,68,253,443
"2011","Harrow 029D","E01002137","Total",985,170,46,124,815,9,62,238,280,57,56,113
"2011","Harrow 030A","E01002218","Total",1647,171,79,92,1476,88,144,259,140,132,342,371
"2011","Harrow 030B","E01002219","Total",1810,140,78,62,1670,81,108,323,140,154,412,452
"2011","Harrow 030C","E01002221","Total",1559,106,41,65,1453,49,106,245,108,105,312,528
"2011","Harrow 030D","E01002222","Total",1608,72,33,39,1536,53,102,287,104,113,442,435
"2011","Harrow 031A","E01002214","Total",1856,128,68,60,1728,133,76,376,146,171,421,405
"2011","Harrow 031B","E01002215","Total",1535,176,103,73,1359,126,116,282,148,91,281,315
"2011","Harrow 031C","E01002220","Total",1628,68,34,34,1560,54,68,270,118,136,412,502
"2011","Harrow 031D","E01002223","Total",1873,87,37,50,1786,48,108,406,162,162,454,446
"2011","Harrow 031E","E01002224","Total",1530,79,19,60,1451,113,62,257,164,138,355,362
"2011","Harrow 032A","E01002204","Total",1730,157,57,100,1573,62,106,403,188,82,336,396
"2011","Harrow 032B","E01002206","Total",1387,83,56,27,1304,31,92,255,106,77,360,383
"2011","Harrow 032C","E01002207","Total",1729,75,45,30,1654,29,94,381,106,96,467,481
"2011","Harrow 032D","E01002210","Total",1595,68,37,31,1527,44,122,290,126,90,354,501
"2011","Harrow 032E","E01032576","Total",1667,66,45,21,1601,40,120,329,130,124,389,469
"2011","Harrow 033A","E01002170","Total",1324,64,32,32,1260,36,94,142,92,103,336,457
"2011","Harrow 033B","E01002171","Total",1677,77,32,45,1600,54,146,244,130,54,412,560
"2011","Harrow 033C","E01002172","Total",1579,64,31,33,1515,70,112,249,126,139,336,483
"2011","Harrow 033D","E01002173","Total",1730,77,39,38,1653,13,108,186,118,138,406,684
"2011","Harrow 033E","E01002174","Total",1582,68,39,29,1514,45,126,200,86,51,435,571
"2011","Harrow 033F","E01002175","Total",1379,57,34,23,1322,10,106,114,86,24,396,586
"2011","Harrow 033G","E01002176","Total",1710,68,34,34,1642,30,130,221,154,39,415,653
"2011","Harrow 033H","E01002177","Total",1443,67,37,30,1376,31,92,254,108,97,340,454
"2011","Harrow 033I","E01002178","Total",1679,59,34,25,1620,37,132,230,84,90,550,497
"2011","Havering 001A","E01002276","Total",1819,180,72,108,1639,133,166,276,202,130,316,416
"2011","Havering 001B","E01002278","Total",1593,196,97,99,1397,209,126,273,148,144,215,282
"2011","Havering 001C","E01002312","Total",1400,244,138,106,1156,94,242,223,156,105,139,197
"2011","Havering 001D","E01002313","Total",1526,216,104,112,1310,118,114,233,188,153,217,287
"2011","Havering 002A","E01002277","Total",1494,185,72,113,1309,105,120,244,190,79,211,360
"2011","Havering 002B","E01002279","Total",1584,195,84,111,1389,158,124,336,174,101,217,279
"2011","Havering 002C","E01002281","Total",1614,327,84,243,1287,216,88,287,208,116,164,208
"2011","Havering 002D","E01002283","Total",1517,186,110,76,1331,128,134,219,154,158,245,293
"2011","Havering 002E","E01002299","Total",1720,190,69,121,1530,95,126,326,188,150,294,351
"2011","Havering 003A","E01002301","Total",1561,148,72,76,1413,58,226,259,208,64,196,402
"2011","Havering 003B","E01002303","Total",2043,236,102,134,1807,203,204,357,242,151,326,324
"2011","Havering 003C","E01002304","Total",1315,131,78,53,1184,40,182,246,172,87,160,297
"2011","Havering 003D","E01002306","Total",1596,166,56,110,1430,230,100,323,188,155,171,263
"2011","Havering 003E","E01002307","Total",1673,163,66,97,1510,187,138,323,152,99,248,363
"2011","Havering 004A","E01002280","Total",1493,224,70,154,1269,172,76,343,146,103,207,222
"2011","Havering 004B","E01002282","Total",1594,265,66,199,1329,175,82,294,154,133,249,242
"2011","Havering 004C","E01002284","Total",1842,250,113,137,1592,147,132,405,226,155,219,308
"2011","Havering 004D","E01002297","Total",1484,290,69,221,1194,142,82,222,190,63,250,245
"2011","Havering 004E","E01002314","Total",1656,174,95,79,1482,164,116,296,144,157,271,334
"2011","Havering 004F","E01002316","Total",1535,350,133,217,1185,170,108,256,180,96,193,182
"2011","Havering 005A","E01002302","Total",1563,125,66,59,1438,112,162,294,206,120,181,363
"2011","Havering 005B","E01002305","Total",1519,154,82,72,1365,109,178,252,198,110,178,340
"2011","Havering 005C","E01002308","Total",1631,214,101,113,1417,109,156,311,182,124,222,313
"2011","Havering 005D","E01002326","Total",1496,190,93,97,1306,126,180,280,180,68,153,319
"2011","Havering 005E","E01002331","Total",1496,143,80,63,1353,62,192,244,208,76,215,356
"2011","Havering 006A","E01002309","Total",1528,202,94,108,1326,101,214,231,202,121,151,306
"2011","Havering 006B","E01002310","Total",1577,259,92,167,1318,187,134,273,248,53,172,251
"2011","Havering 006C","E01002311","Total",1690,186,82,104,1504,168,164,341,170,113,260,288
"2011","Havering 006D","E01002315","Total",1537,195,84,111,1342,159,114,280,206,116,198,269
"2011","Havering 007A","E01002293","Total",1572,351,75,276,1221,118,104,395,334,15,100,155
"2011","Havering 007B","E01002294","Total",1478,169,97,72,1309,29,226,279,220,40,191,324
"2011","Havering 007C","E01002296","Total",1673,187,101,86,1486,33,240,300,254,58,224,377
"2011","Havering 007D","E01002298","Total",1538,185,104,81,1353,68,200,259,256,87,209,274
"2011","Havering 007E","E01002300","Total",1593,216,136,80,1377,64,240,294,294,55,112,318
"2011","Havering 008A","E01002333","Total",1312,119,83,36,1193,52,208,225,126,63,159,360
"2011","Havering 008B","E01002334","Total",1663,157,101,56,1506,34,296,264,212,66,224,410
"2011","Havering 008C","E01002336","Total",1492,152,90,62,1340,62,234,278,202,92,164,308
"2011","Havering 008D","E01002339","Total",1610,122,81,41,1488,28,230,334,174,83,269,370
"2011","Havering 008E","E01002341","Total",1372,116,84,32,1256,19,262,246,188,56,128,357
"2011","Havering 009A","E01002327","Total",1470,158,97,61,1312,86,184,285,164,99,152,342
"2011","Havering 009B","E01002328","Total",1685,135,69,66,1550,71,154,399,228,117,186,395
"2011","Havering 009C","E01002332","Total",1631,199,100,99,1432,74,208,388,188,78,138,358
"2011","Havering 009D","E01002335","Total",1416,155,80,75,1261,96,162,264,196,30,110,403
"2011","Havering 009E","E01002338","Total",1371,132,75,57,1239,42,142,231,152,143,218,311
"2011","Havering 009F","E01002340","Total",1381,108,54,54,1273,37,134,321,160,108,220,293
"2011","Havering 010A","E01002268","Total",1350,123,85,38,1227,29,176,254,162,82,214,310
"2011","Havering 010B","E01002269","Total",1785,142,91,51,1643,77,244,341,170,97,280,434
"2011","Havering 010C","E01002295","Total",1525,210,70,140,1315,74,164,326,264,56,123,308
"2011","Havering 010D","E01002377","Total",1638,238,105,133,1400,76,138,349,262,79,207,289
"2011","Havering 010E","E01002378","Total",1678,115,74,41,1563,39,138,462,202,83,236,403
"2011","Havering 010F","E01002383","Total",1579,179,102,77,1400,35,186,383,242,40,180,334
"2011","Havering 011A","E01002244","Total",1697,262,67,195,1435,144,92,355,316,77,194,257
"2011","Havering 011B","E01002245","Total",1546,196,122,74,1350,93,116,329,206,104,210,292
"2011","Havering 011C","E01002325","Total",1709,230,131,99,1479,196,214,340,238,90,92,309
"2011","Havering 011D","E01002329","Total",1615,162,77,85,1453,60,186,345,220,122,208,312
"2011","Havering 011E","E01002330","Total",1730,225,85,140,1505,128,186,358,238,122,169,304
"2011","Havering 012A","E01002337","Total",1273,142,85,57,1131,21,182,199,180,64,188,297
"2011","Havering 012B","E01002354","Total",1365,153,81,72,1212,31,190,307,186,94,109,295
"2011","Havering 012C","E01002376","Total",1426,70,29,41,1356,59,176,337,206,71,161,346
"2011","Havering 012D","E01002379","Total",1458,228,121,107,1230,69,146,263,280,46,158,268
"2011","Havering 012E","E01002380","Total",2058,418,81,337,1640,207,172,343,462,67,113,276
"2011","Havering 012F","E01002381","Total",1527,183,78,105,1344,83,186,264,222,87,161,341
"2011","Havering 013A","E01002243","Total",1852,328,121,207,1524,254,100,344,286,83,204,253
"2011","Havering 013B","E01002353","Total",2005,249,108,141,1756,83,234,303,300,106,343,387
"2011","Havering 013C","E01002356","Total",2135,437,97,340,1698,255,108,381,354,93,172,335
"2011","Havering 013E","E01032741","Total",1078,387,49,338,691,87,38,127,294,20,62,63
"2011","Havering 013F","E01032742","Total",1260,290,135,155,970,47,120,284,238,10,71,200
"2011","Havering 014A","E01002272","Total",1319,134,71,63,1185,46,164,254,194,68,136,323
"2011","Havering 014B","E01002274","Total",1638,208,101,107,1430,40,194,304,258,107,221,306
"2011","Havering 014C","E01002317","Total",1528,89,47,42,1439,34,208,286,132,102,215,462
"2011","Havering 014D","E01002318","Total",1616,122,73,49,1494,49,236,299,196,70,212,432
"2011","Havering 014E","E01002355","Total",1470,117,66,51,1353,30,166,381,234,122,120,300
"2011","Havering 014F","E01002382","Total",1776,239,91,148,1537,88,184,349,314,77,186,339
"2011","Havering 015A","E01002270","Total",1664,191,112,79,1473,18,226,203,134,109,266,517
"2011","Havering 015B","E01002271","Total",1479,73,50,23,1406,21,268,187,134,77,277,442
"2011","Havering 015C","E01002273","Total",1309,79,53,26,1230,43,216,179,174,36,227,355
"2011","Havering 015D","E01002275","Total",1359,106,63,43,1253,8,240,133,158,82,255,377
"2011","Havering 016A","E01002319","Total",1591,210,121,89,1381,82,148,271,180,91,183,426
"2011","Havering 016B","E01002350","Total",1483,308,95,213,1175,142,88,265,230,64,121,265
"2011","Havering 016C","E01002351","Total",1580,177,64,113,1403,99,104,410,280,47,137,326
"2011","Havering 016D","E01002352","Total",1596,275,76,199,1321,99,98,327,280,73,168,276
"2011","Havering 016E","E01002358","Total",1772,275,53,222,1497,134,82,384,342,55,188,312
"2011","Havering 017A","E01002246","Total",1620,164,86,78,1456,84,170,303,200,78,274,347
"2011","Havering 017B","E01002247","Total",1800,193,64,129,1607,147,102,448,298,77,240,295
"2011","Havering 017C","E01002248","Total",1395,169,74,95,1226,141,142,306,202,63,118,254
"2011","Havering 017D","E01002249","Total",1905,200,52,148,1705,141,116,323,276,112,329,408
"2011","Havering 017E","E01002250","Total",1563,194,45,149,1369,106,112,322,196,100,203,330
"2011","Havering 017F","E01002251","Total",1393,127,51,76,1266,109,94,259,178,111,243,272
"2011","Havering 018A","E01002252","Total",1511,160,115,45,1351,63,236,247,162,83,192,368
"2011","Havering 018B","E01002256","Total",1498,159,106,53,1339,31,260,361,170,66,169,282
"2011","Havering 018C","E01002258","Total",1676,319,198,121,1357,120,238,292,190,79,147,291
"2011","Havering 018D","E01002259","Total",1486,173,116,57,1313,81,190,268,166,61,220,327
"2011","Havering 018E","E01002391","Total",1501,161,94,67,1340,37,244,284,144,47,234,350
"2011","Havering 019A","E01002253","Total",1539,139,107,32,1400,11,286,314,176,40,226,347
"2011","Havering 019B","E01002254","Total",1616,144,99,45,1472,40,300,274,166,97,233,362
"2011","Havering 019C","E01002257","Total",1697,172,124,48,1525,38,228,343,138,124,259,395
"2011","Havering 019D","E01002384","Total",1522,189,103,86,1333,43,222,337,204,57,112,358
"2011","Havering 020A","E01002359","Total",1322,142,110,32,1180,27,136,293,148,53,186,337
"2011","Havering 020B","E01002360","Total",1429,349,246,103,1080,41,232,192,192,43,134,246
"2011","Havering 020C","E01002361","Total",1695,322,144,178,1373,115,184,307,314,52,106,295
"2011","Havering 020D","E01002363","Total",1566,222,126,96,1344,99,172,314,240,60,156,303
"2011","Havering 020E","E01002367","Total",1550,195,79,116,1355,72,164,337,226,60,186,310
"2011","Havering 021A","E01002320","Total",1480,106,52,54,1374,31,130,349,154,56,236,418
"2011","Havering 021B","E01002321","Total",1636,155,74,81,1481,40,176,367,202,59,197,440
"2011","Havering 021C","E01002322","Total",1940,171,61,110,1769,50,140,374,280,89,306,530
"2011","Havering 021D","E01002323","Total",1676,130,77,53,1546,67,178,382,200,65,288,366
"2011","Havering 021E","E01002324","Total",1455,228,118,110,1227,77,160,200,214,58,148,370
"2011","Havering 022A","E01002255","Total",1483,160,81,79,1323,77,220,384,212,36,84,310
"2011","Havering 022B","E01002289","Total",1614,160,95,65,1454,66,190,289,164,93,291,361
"2011","Havering 022C","E01002292","Total",1549,181,115,66,1368,94,184,291,204,88,220,287
"2011","Havering 022D","E01002362","Total",1471,163,77,86,1308,66,192,251,210,52,163,374
"2011","Havering 022E","E01002386","Total",1839,335,144,191,1504,91,194,399,320,87,118,295
"2011","Havering 023A","E01002287","Total",1558,129,67,62,1429,57,204,295,168,62,209,434
"2011","Havering 023B","E01002291","Total",1582,302,113,189,1280,57,224,209,302,40,128,320
"2011","Havering 023C","E01002364","Total",1380,116,84,32,1264,33,226,234,168,97,144,362
"2011","Havering 023D","E01002365","Total",1316,169,93,76,1147,60,160,197,160,72,156,342
"2011","Havering 023E","E01002366","Total",1464,131,60,71,1333,79,140,255,194,130,171,364
"2011","Havering 024A","E01002385","Total",1556,133,74,59,1423,26,182,319,208,87,241,360
"2011","Havering 024B","E01002387","Total",1605,119,91,28,1486,28,246,371,178,80,181,402
"2011","Havering 024C","E01002388","Total",1620,107,82,25,1513,42,240,340,182,90,194,425
"2011","Havering 024D","E01002389","Total",1518,146,107,39,1372,26,278,252,194,74,145,403
"2011","Havering 024E","E01002390","Total",1449,85,64,21,1364,22,208,306,192,88,212,336
"2011","Havering 025A","E01002265","Total",1472,193,87,106,1279,47,144,313,272,56,133,314
"2011","Havering 025B","E01002285","Total",1245,140,82,58,1105,34,202,182,162,37,151,337
"2011","Havering 025C","E01002286","Total",1650,101,70,31,1549,68,226,345,218,73,235,384
"2011","Havering 025D","E01002288","Total",1548,85,46,39,1463,59,146,312,200,53,213,480
"2011","Havering 025E","E01002290","Total",1516,182,127,55,1334,46,260,207,176,57,216,372
"2011","Havering 026A","E01002260","Total",1535,107,62,45,1428,78,178,253,186,62,237,434
"2011","Havering 026B","E01002261","Total",1649,163,101,62,1486,115,154,269,202,126,218,402
"2011","Havering 026C","E01002262","Total",1626,165,96,69,1461,77,186,225,178,117,282,396
"2011","Havering 026D","E01002263","Total",1599,125,61,64,1474,52,170,260,238,96,195,463
"2011","Havering 026E","E01002264","Total",1475,295,163,132,1180,174,166,268,160,66,107,239
"2011","Havering 027A","E01002266","Total",1439,174,131,43,1265,40,226,258,146,20,185,390
"2011","Havering 027B","E01002267","Total",1671,232,154,78,1439,130,254,316,198,96,152,293
"2011","Havering 027C","E01002372","Total",1611,131,74,57,1480,92,204,267,154,105,258,400
"2011","Havering 027D","E01002373","Total",1581,156,93,63,1425,108,188,315,190,52,211,361
"2011","Havering 027E","E01002374","Total",1526,166,94,72,1360,111,152,234,188,71,237,367
"2011","Havering 028A","E01002368","Total",1594,274,58,216,1320,208,114,286,160,113,205,234
"2011","Havering 028B","E01002369","Total",1884,191,84,107,1693,129,186,306,206,94,331,441
"2011","Havering 028C","E01002370","Total",1973,308,109,199,1665,158,158,356,240,126,252,375
"2011","Havering 028D","E01002371","Total",1627,149,93,56,1478,112,242,251,180,74,227,392
"2011","Havering 028E","E01002375","Total",1696,200,102,98,1496,205,156,320,206,153,184,272
"2011","Havering 029A","E01002343","Total",1684,136,90,46,1548,77,238,231,162,110,269,461
"2011","Havering 029B","E01002344","Total",1524,192,98,94,1332,101,218,195,174,88,182,374
"2011","Havering 029C","E01002348","Total",1531,166,111,55,1365,48,292,268,178,46,153,380
"2011","Havering 029D","E01002349","Total",1508,161,97,64,1347,24,198,266,176,52,184,447
"2011","Havering 030A","E01002342","Total",1588,189,94,95,1399,125,114,308,176,93,205,378
"2011","Havering 030B","E01002345","Total",1679,272,66,206,1407,311,88,329,220,85,162,212
"2011","Havering 030C","E01002346","Total",1503,114,49,65,1389,102,98,260,216,105,262,346
"2011","Havering 030D","E01002347","Total",1440,114,58,56,1326,90,156,224,148,108,250,350
"2011","Hillingdon 001A","E01002473","Total",1547,191,78,113,1356,26,208,230,176,62,206,448
"2011","Hillingdon 001B","E01002475","Total",1455,258,99,159,1197,63,190,363,240,30,103,208
"2011","Hillingdon 001C","E01002476","Total",1562,143,73,70,1419,28,204,286,208,61,263,369
"2011","Hillingdon 001D","E01002477","Total",1217,199,72,127,1018,53,166,241,190,42,116,210
"2011","Hillingdon 001E","E01002482","Total",1607,121,74,47,1486,25,286,315,184,111,176,389
"2011","Hillingdon 002A","E01002472","Total",1476,345,163,182,1131,89,194,252,276,20,107,193
"2011","Hillingdon 002B","E01002474","Total",1507,218,114,104,1289,49,158,316,188,77,192,309
"2011","Hillingdon 002C","E01002478","Total",1494,207,81,126,1287,53,190,382,248,40,135,239
"2011","Hillingdon 002D","E01002483","Total",1739,205,101,104,1534,82,164,366,252,99,246,325
"2011","Hillingdon 002E","E01002484","Total",1424,185,82,103,1239,32,120,342,190,40,213,302
"2011","Hillingdon 002F","E01002485","Total",1708,274,101,173,1434,116,144,353,262,67,189,303
"2011","Hillingdon 003A","E01002438","Total",1240,99,32,67,1141,57,114,311,216,63,159,221
"2011","Hillingdon 003B","E01002439","Total",1482,172,96,76,1310,95,162,315,212,100,163,263
"2011","Hillingdon 003C","E01002440","Total",1441,191,103,88,1250,86,156,332,214,57,156,249
"2011","Hillingdon 003D","E01002441","Total",1506,236,92,144,1270,101,138,270,254,73,182,252
"2011","Hillingdon 003E","E01002442","Total",1512,201,67,134,1311,59,126,337,244,79,186,280
"2011","Hillingdon 004A","E01002433","Total",1823,257,124,133,1566,96,154,385,304,98,197,332
"2011","Hillingdon 004B","E01002436","Total",1608,182,93,89,1426,49,194,403,194,72,207,307
"2011","Hillingdon 004C","E01002479","Total",1644,154,61,93,1490,85,126,393,190,87,242,367
"2011","Hillingdon 004D","E01002480","Total",1760,170,107,63,1590,39,236,406,276,83,225,325
"2011","Hillingdon 004E","E01002481","Total",1633,190,102,88,1443,110,146,364,230,88,186,319
"2011","Hillingdon 005A","E01002533","Total",1462,158,41,117,1304,121,92,381,242,68,165,235
"2011","Hillingdon 005B","E01002534","Total",1465,186,111,75,1279,49,166,315,192,118,174,265
"2011","Hillingdon 005C","E01002538","Total",1569,292,119,173,1277,59,168,309,284,42,124,291
"2011","Hillingdon 005D","E01002539","Total",1524,155,104,51,1369,56,238,326,174,74,125,376
"2011","Hillingdon 006A","E01002418","Total",1789,162,99,63,1627,79,154,429,188,126,290,361
"2011","Hillingdon 006B","E01002419","Total",1531,145,68,77,1386,58,146,353,258,105,159,307
"2011","Hillingdon 006C","E01002431","Total",1415,77,53,24,1338,28,178,310,116,98,247,361
"2011","Hillingdon 006D","E01002432","Total",1561,170,101,69,1391,36,198,281,224,58,213,381
"2011","Hillingdon 006E","E01002437","Total",1469,153,121,32,1316,21,318,228,156,50,205,338
"2011","Hillingdon 007A","E01002430","Total",1469,73,51,22,1396,16,214,262,160,108,205,431
"2011","Hillingdon 007B","E01002434","Total",1358,89,67,22,1269,31,212,262,164,83,262,255
"2011","Hillingdon 007C","E01002435","Total",1436,103,69,34,1333,20,226,275,148,123,167,374
"2011","Hillingdon 007D","E01002470","Total",1658,209,109,100,1449,74,174,339,262,76,160,364
"2011","Hillingdon 007E","E01002535","Total",1743,285,117,168,1458,46,190,268,456,64,174,260
"2011","Hillingdon 008A","E01002416","Total",1741,91,47,44,1650,44,142,447,180,83,309,445
"2011","Hillingdon 008B","E01002417","Total",1596,173,99,74,1423,39,204,335,208,100,172,365
"2011","Hillingdon 008C","E01002420","Total",1595,204,98,106,1391,106,120,398,216,77,152,322
"2011","Hillingdon 008D","E01002421","Total",1646,149,84,65,1497,80,172,378,194,90,232,351
"2011","Hillingdon 008E","E01002471","Total",1619,152,72,80,1467,47,142,464,240,60,200,314
"2011","Hillingdon 009A","E01002465","Total",1553,167,73,94,1386,128,110,346,260,124,166,252
"2011","Hillingdon 009B","E01002467","Total",1517,176,145,31,1341,52,234,346,198,105,98,308
"2011","Hillingdon 009C","E01002494","Total",1696,144,58,86,1552,89,108,383,244,126,193,409
"2011","Hillingdon 009D","E01002536","Total",1342,210,49,161,1132,69,92,346,276,82,96,171
"2011","Hillingdon 009E","E01002537","Total",1404,159,44,115,1245,49,120,309,260,78,168,261
"2011","Hillingdon 010A","E01002415","Total",1710,131,70,61,1579,49,166,441,242,102,239,340
"2011","Hillingdon 010B","E01002466","Total",1680,135,66,69,1545,59,166,482,206,107,165,360
"2011","Hillingdon 010C","E01002468","Total",1696,141,65,76,1555,73,102,430,254,100,187,409
"2011","Hillingdon 010D","E01002469","Total",1670,133,61,72,1537,72,148,383,242,95,227,370
"2011","Hillingdon 010E","E01002495","Total",1804,144,50,94,1660,121,110,484,306,35,259,345
"2011","Hillingdon 011A","E01002458","Total",1416,115,81,34,1301,17,230,230,148,104,179,393
"2011","Hillingdon 011B","E01002459","Total",1601,115,83,32,1486,33,296,338,204,108,182,325
"2011","Hillingdon 011C","E01002460","Total",1338,219,141,78,1119,40,172,273,162,52,117,303
"2011","Hillingdon 011D","E01002462","Total",1418,91,55,36,1327,21,164,369,146,99,206,322
"2011","Hillingdon 011E","E01002464","Total",1586,158,77,81,1428,60,146,511,204,73,157,277
"2011","Hillingdon 013A","E01002461","Total",1435,108,63,45,1327,24,172,236,134,62,241,458
"2011","Hillingdon 013B","E01002463","Total",1544,79,57,22,1465,19,184,299,138,127,284,414
"2011","Hillingdon 013C","E01002512","Total",1700,148,78,70,1552,11,220,322,186,60,256,497
"2011","Hillingdon 013D","E01002513","Total",1341,161,94,67,1180,10,160,223,164,60,155,408
"2011","Hillingdon 013E","E01002516","Total",1435,91,44,47,1344,12,166,270,112,55,322,407
"2011","Hillingdon 014A","E01002450","Total",1421,95,41,54,1326,76,100,392,160,99,184,315
"2011","Hillingdon 014B","E01002451","Total",1514,73,45,28,1441,70,116,327,112,99,291,426
"2011","Hillingdon 014C","E01002452","Total",1539,68,38,30,1471,50,100,321,158,104,287,451
"2011","Hillingdon 014D","E01002453","Total",1692,110,61,49,1582,79,108,362,192,121,288,432
"2011","Hillingdon 014E","E01002454","Total",1777,167,77,90,1610,166,116,470,160,127,249,322
"2011","Hillingdon 015A","E01002414","Total",1180,185,54,131,995,55,76,172,230,26,94,342
"2011","Hillingdon 015C","E01002514","Total",1876,358,117,241,1518,61,122,403,386,69,140,337
"2011","Hillingdon 015D","E01002515","Total",1608,265,117,148,1343,132,70,327,278,71,144,321
"2011","Hillingdon 015F","E01033725","Total",2350,276,96,180,2074,80,158,465,404,124,246,597
"2011","Hillingdon 016B","E01002520","Total",1549,141,33,108,1408,98,74,372,270,70,194,330
"2011","Hillingdon 016C","E01002521","Total",1716,455,187,268,1261,134,102,249,306,92,85,293
"2011","Hillingdon 016D","E01002523","Total",1625,106,36,70,1519,55,76,258,230,79,277,544
"2011","Hillingdon 016F","E01033724","Total",2761,300,93,207,2461,150,156,436,328,131,250,1010
"2011","Hillingdon 017A","E01002410","Total",1694,156,72,84,1538,95,134,284,204,70,278,473
"2011","Hillingdon 017B","E01002412","Total",2261,167,56,111,2094,94,184,365,280,92,347,732
"2011","Hillingdon 017C","E01002456","Total",1629,159,92,67,1470,124,140,326,200,155,243,282
"2011","Hillingdon 017D","E01002509","Total",1448,89,72,17,1359,36,146,287,124,88,219,459
"2011","Hillingdon 017E","E01002511","Total",1522,179,87,92,1343,96,122,360,204,73,184,304
"2011","Hillingdon 018A","E01002422","Total",1436,86,43,43,1350,96,108,332,100,90,246,378
"2011","Hillingdon 018B","E01002423","Total",1644,108,50,58,1536,61,148,271,148,142,313,453
"2011","Hillingdon 018C","E01002424","Total",1574,96,48,48,1478,94,98,340,114,108,316,408
"2011","Hillingdon 018D","E01002425","Total",1795,149,57,92,1646,111,102,283,148,121,438,443
"2011","Hillingdon 018E","E01002427","Total",1444,107,62,45,1337,55,96,273,152,89,262,410
"2011","Hillingdon 018F","E01002428","Total",1464,76,47,29,1388,55,154,237,134,132,325,351
"2011","Hillingdon 019A","E01002408","Total",1527,234,75,159,1293,120,84,238,186,78,230,357
"2011","Hillingdon 019B","E01002409","Total",1765,166,91,75,1599,146,180,297,198,98,302,378
"2011","Hillingdon 019C","E01002429","Total",1413,125,47,78,1288,122,78,275,110,129,256,318
"2011","Hillingdon 019D","E01002455","Total",1724,163,74,89,1561,104,148,364,174,98,251,422
"2011","Hillingdon 019E","E01002457","Total",1560,79,20,59,1481,153,74,327,116,90,252,469
"2011","Hillingdon 020A","E01002392","Total",1675,156,63,93,1519,286,76,326,146,199,222,264
"2011","Hillingdon 020B","E01002393","Total",1982,184,54,130,1798,191,86,454,150,114,382,421
"2011","Hillingdon 020C","E01002540","Total",1676,162,34,128,1514,139,82,340,238,129,312,274
"2011","Hillingdon 020D","E01002542","Total",1906,141,53,88,1765,228,82,420,176,162,299,398
"2011","Hillingdon 020E","E01002543","Total",1728,164,65,99,1564,252,86,288,140,165,301,332
"2011","Hillingdon 021A","E01002394","Total",1619,97,58,39,1522,74,114,242,104,199,426,363
"2011","Hillingdon 021B","E01002395","Total",1407,69,20,49,1338,40,60,231,88,123,357,439
"2011","Hillingdon 021C","E01002397","Total",1689,82,27,55,1607,123,70,298,116,144,333,523
"2011","Hillingdon 021D","E01002398","Total",1702,76,26,50,1626,48,66,252,102,72,514,572
"2011","Hillingdon 021E","E01002399","Total",1591,81,36,45,1510,65,74,167,110,164,440,490
"2011","Hillingdon 021F","E01002426","Total",1783,123,63,60,1660,187,124,477,160,128,273,311
"2011","Hillingdon 022A","E01002411","Total",1703,160,75,85,1543,135,136,242,184,85,228,533
"2011","Hillingdon 022B","E01002413","Total",1530,159,71,88,1371,138,112,307,158,97,155,404
"2011","Hillingdon 022C","E01002518","Total",1321,126,57,69,1195,33,96,196,160,52,152,506
"2011","Hillingdon 022D","E01002519","Total",1485,318,103,215,1167,85,120,217,248,55,152,290
"2011","Hillingdon 022E","E01002550","Total",1806,277,41,236,1529,184,68,392,308,101,171,305
"2011","Hillingdon 022F","E01002554","Total",2543,337,38,299,2206,244,52,543,516,167,321,363
"2011","Hillingdon 023A","E01002541","Total",1949,227,55,172,1722,161,94,476,290,98,249,354
"2011","Hillingdon 023B","E01002544","Total",1678,115,35,80,1563,67,74,336,182,134,377,393
"2011","Hillingdon 023C","E01002545","Total",1503,54,14,40,1449,281,40,336,122,91,281,298
"2011","Hillingdon 023D","E01002546","Total",1567,60,27,33,1507,55,58,226,96,148,454,470
"2011","Hillingdon 023E","E01002547","Total",1566,77,22,55,1489,133,58,326,130,85,355,402
"2011","Hillingdon 024A","E01002400","Total",1770,119,62,57,1651,117,106,317,162,173,358,418
"2011","Hillingdon 024B","E01002401","Total",1673,158,58,100,1515,143,80,333,172,94,309,384
"2011","Hillingdon 024C","E01002402","Total",1494,109,49,60,1385,103,72,217,98,189,289,417
"2011","Hillingdon 024D","E01002403","Total",1795,94,49,45,1701,189,74,200,130,215,454,439
"2011","Hillingdon 024E","E01002404","Total",1838,168,60,108,1670,243,84,429,184,117,333,280
"2011","Hillingdon 025A","E01002548","Total",1675,203,111,92,1472,189,82,337,186,131,234,313
"2011","Hillingdon 025B","E01002549","Total",1743,168,75,93,1575,90,140,375,244,89,242,395
"2011","Hillingdon 025C","E01002551","Total",1905,131,79,52,1774,113,106,318,184,130,333,590
"2011","Hillingdon 025D","E01002552","Total",1582,87,41,46,1495,129,82,305,164,94,336,385
"2011","Hillingdon 025E","E01002553","Total",1688,136,60,76,1552,125,108,322,170,151,255,421
"2011","Hillingdon 026A","E01002396","Total",1747,137,97,40,1610,90,66,279,92,127,473,483
"2011","Hillingdon 026B","E01002501","Total",1666,87,40,47,1579,85,116,209,108,107,453,501
"2011","Hillingdon 026C","E01002502","Total",1583,101,48,53,1482,69,66,194,100,124,414,515
"2011","Hillingdon 026D","E01002505","Total",1694,209,56,153,1485,179,64,373,244,142,181,302
"2011","Hillingdon 026E","E01002508","Total",1955,173,99,74,1782,163,100,307,118,136,571,387
"2011","Hillingdon 027A","E01002405","Total",1812,168,68,100,1644,130,90,336,152,98,434,404
"2011","Hillingdon 027B","E01002406","Total",2135,131,51,80,2004,207,88,328,146,188,470,577
"2011","Hillingdon 027C","E01002503","Total",1679,78,25,53,1601,72,76,246,92,167,401,547
"2011","Hillingdon 027D","E01002504","Total",1955,174,63,111,1781,172,124,365,216,109,341,454
"2011","Hillingdon 027E","E01002506","Total",1831,177,52,125,1654,220,54,265,162,157,417,379
"2011","Hillingdon 027F","E01002507","Total",1656,63,27,36,1593,65,58,206,90,146,498,530
"2011","Hillingdon 028A","E01002486","Total",2192,125,58,67,2067,200,88,395,176,230,567,411
"2011","Hillingdon 028B","E01002487","Total",1821,154,53,101,1667,124,90,322,148,164,351,468
"2011","Hillingdon 028C","E01002526","Total",1917,120,49,71,1797,176,82,384,184,155,430,386
"2011","Hillingdon 028D","E01002528","Total",1685,103,55,48,1582,124,124,270,134,123,330,477
"2011","Hillingdon 028E","E01002532","Total",2289,244,40,204,2045,224,86,580,302,175,304,374
"2011","Hillingdon 029A","E01002445","Total",1703,114,55,59,1589,374,78,346,144,169,219,259
"2011","Hillingdon 029B","E01002525","Total",1566,178,62,116,1388,72,156,339,262,61,127,371
"2011","Hillingdon 029C","E01002529","Total",2085,184,44,140,1901,198,90,476,256,98,299,484
"2011","Hillingdon 029D","E01002530","Total",1634,159,84,75,1475,231,132,332,150,141,273,216
"2011","Hillingdon 029E","E01002531","Total",1593,178,93,85,1415,50,164,280,236,106,156,423
"2011","Hillingdon 030A","E01002407","Total",2269,137,35,102,2132,196,100,393,194,127,629,493
"2011","Hillingdon 030B","E01002488","Total",1729,86,43,43,1643,85,124,293,110,171,389,471
"2011","Hillingdon 030C","E01002489","Total",1814,95,54,41,1719,99,74,287,98,95,590,476
"2011","Hillingdon 030D","E01002490","Total",2076,115,42,73,1961,128,110,390,154,189,448,542
"2011","Hillingdon 030E","E01002492","Total",1647,67,31,36,1580,99,66,288,96,152,436,443
"2011","Hillingdon 031A","E01002444","Total",1551,205,63,142,1346,59,116,188,210,61,260,452
"2011","Hillingdon 031B","E01002446","Total",1562,166,62,104,1396,115,112,285,168,91,280,345
"2011","Hillingdon 031C","E01002447","Total",1696,151,35,116,1545,127,54,274,234,102,225,529
"2011","Hillingdon 031D","E01002527","Total",1462,190,86,104,1272,98,116,330,246,69,136,277
"2011","Hillingdon 032A","E01002443","Total",1625,108,29,79,1517,79,70,354,182,89,309,434
"2011","Hillingdon 032B","E01002448","Total",1957,228,86,142,1729,123,140,354,244,137,294,437
"2011","Hillingdon 032C","E01002449","Total",1768,223,47,176,1545,122,90,299,258,48,309,419
"2011","Hillingdon 032D","E01002491","Total",1604,106,49,57,1498,125,94,252,110,143,409,365
"2011","Hillingdon 032E","E01002493","Total",1868,87,30,57,1781,268,76,395,150,221,341,330
"2011","Hillingdon 033A","E01002496","Total",1768,258,89,169,1510,104,92,505,266,69,172,302
"2011","Hillingdon 033B","E01002497","Total",1832,227,96,131,1605,173,144,396,270,72,244,306
"2011","Hillingdon 033C","E01002498","Total",1416,102,53,49,1314,62,158,311,134,71,201,377
"2011","Hillingdon 033D","E01002499","Total",1705,171,78,93,1534,112,160,336,266,93,263,304
"2011","Hillingdon 033E","E01032577","Total",1683,106,58,48,1577,117,154,343,210,102,270,381
"2011","Hounslow 001A","E01002569","Total",1697,283,73,210,1414,44,102,401,404,61,81,321
"2011","Hounslow 001B","E01002570","Total",1663,242,60,182,1421,51,102,261,414,80,183,330
"2011","Hounslow 001C","E01002573","Total",1650,205,64,141,1445,49,94,411,308,119,171,293
"2011","Hounslow 001D","E01002574","Total",1537,182,59,123,1355,46,88,339,328,68,151,335
"2011","Hounslow 001E","E01002575","Total",1745,205,61,144,1540,37,114,311,268,186,215,409
"2011","Hounslow 003A","E01002562","Total",1368,145,64,81,1223,90,118,187,150,47,193,438
"2011","Hounslow 003B","E01002564","Total",1888,207,50,157,1681,161,104,370,248,138,229,431
"2011","Hounslow 003C","E01002566","Total",2123,431,71,360,1692,261,74,380,418,145,147,267
"2011","Hounslow 003D","E01002568","Total",2759,381,119,262,2378,390,118,453,504,146,293,474
"2011","Hounslow 003F","E01033081","Total",1242,271,44,227,971,122,34,249,360,22,49,135
"2011","Hounslow 003G","E01033082","Total",1223,327,115,212,896,86,92,208,254,17,88,151
"2011","Hounslow 004A","E01002620","Total",1851,185,58,127,1666,189,88,439,150,134,322,344
"2011","Hounslow 004B","E01002625","Total",1681,79,47,32,1602,59,78,206,108,60,544,547
"2011","Hounslow 004C","E01002626","Total",1626,100,49,51,1526,45,72,176,98,64,457,614
"2011","Hounslow 004D","E01002627","Total",1662,158,53,105,1504,172,80,283,134,98,294,443
"2011","Hounslow 004E","E01002631","Total",1628,84,19,65,1544,76,62,301,148,143,387,427
"2011","Hounslow 005A","E01002633","Total",1642,196,75,121,1446,148,78,306,156,118,314,326
"2011","Hounslow 005B","E01002634","Total",1712,86,40,46,1626,209,66,302,130,217,291,411
"2011","Hounslow 005C","E01002637","Total",1659,165,41,124,1494,83,74,219,112,167,371,468
"2011","Hounslow 005D","E01002638","Total",1823,111,48,63,1712,143,90,271,114,185,406,503
"2011","Hounslow 006A","E01002563","Total",1633,174,57,117,1459,43,152,258,232,32,260,482
"2011","Hounslow 006B","E01002565","Total",2053,461,124,337,1592,110,94,378,410,77,165,358
"2011","Hounslow 006C","E01002567","Total",1733,332,76,256,1401,94,74,364,404,65,105,295
"2011","Hounslow 006D","E01002684","Total",2291,424,80,344,1867,147,118,409,542,72,201,378
"2011","Hounslow 006E","E01002686","Total",1762,205,89,116,1557,119,82,286,206,81,336,447
"2011","Hounslow 007A","E01002571","Total",1325,212,59,153,1113,50,112,342,296,51,103,159
"2011","Hounslow 007B","E01002572","Total",1643,270,79,191,1373,182,78,259,224,113,218,299
"2011","Hounslow 007C","E01002577","Total",1635,190,50,140,1445,57,80,353,300,124,163,368
"2011","Hounslow 007D","E01002578","Total",1502,180,61,119,1322,45,154,314,188,142,170,309
"2011","Hounslow 007E","E01002689","Total",1585,368,123,245,1217,88,106,349,284,83,142,165
"2011","Hounslow 007F","E01002690","Total",1459,181,52,129,1278,57,88,301,282,107,150,293
"2011","Hounslow 008A","E01002576","Total",1746,262,67,195,1484,139,112,398,278,131,176,250
"2011","Hounslow 008B","E01002579","Total",1746,301,117,184,1445,57,188,423,334,52,116,275
"2011","Hounslow 008C","E01002580","Total",1386,302,96,206,1084,77,62,282,248,63,113,239
"2011","Hounslow 008D","E01002581","Total",1860,292,74,218,1568,73,118,486,446,50,65,330
"2011","Hounslow 008E","E01002582","Total",1668,237,86,151,1431,74,92,478,290,112,100,285
"2011","Hounslow 009A","E01002675","Total",2456,187,62,125,2269,135,126,523,316,148,384,637
"2011","Hounslow 009B","E01002678","Total",1855,162,46,116,1693,51,122,327,226,91,344,532
"2011","Hounslow 009C","E01002679","Total",1781,155,63,92,1626,53,132,322,186,81,288,564
"2011","Hounslow 009D","E01002680","Total",1937,191,54,137,1746,55,144,369,230,109,323,516
"2011","Hounslow 010A","E01002619","Total",1959,146,86,60,1813,52,118,222,118,125,503,675
"2011","Hounslow 010B","E01002622","Total",1731,94,30,64,1637,54,78,226,92,132,418,637
"2011","Hounslow 010C","E01002632","Total",1828,110,54,56,1718,80,110,266,84,151,460,567
"2011","Hounslow 010D","E01002635","Total",1753,74,27,47,1679,58,90,258,110,100,433,630
"2011","Hounslow 010E","E01002636","Total",2016,91,47,44,1925,74,134,229,132,161,528,667
"2011","Hounslow 011A","E01002618","Total",1714,68,33,35,1646,57,120,231,94,92,430,622
"2011","Hounslow 011B","E01002621","Total",1813,130,26,104,1683,91,84,302,128,133,364,581
"2011","Hounslow 011C","E01002623","Total",1635,86,35,51,1549,107,62,166,100,141,428,545
"2011","Hounslow 011D","E01002628","Total",1940,105,41,64,1835,60,134,339,138,74,447,643
"2011","Hounslow 011E","E01002629","Total",2087,183,87,96,1904,147,106,295,174,121,460,601
"2011","Hounslow 012A","E01002630","Total",1695,120,44,76,1575,54,82,371,132,81,359,496
"2011","Hounslow 012B","E01002639","Total",1695,63,37,26,1632,31,108,208,98,88,434,665
"2011","Hounslow 012C","E01002640","Total",1800,87,29,58,1713,30,106,291,134,51,428,673
"2011","Hounslow 012D","E01002674","Total",1707,194,60,134,1513,53,136,370,220,63,282,389
"2011","Hounslow 012E","E01002676","Total",1715,94,48,46,1621,33,172,228,126,47,423,592
"2011","Hounslow 013A","E01002583","Total",1706,75,24,51,1631,93,108,257,100,59,514,500
"2011","Hounslow 013B","E01002584","Total",1691,82,31,51,1609,90,78,179,86,120,488,568
"2011","Hounslow 013C","E01002585","Total",1651,89,43,46,1562,82,80,208,112,81,474,525
"2011","Hounslow 013D","E01002586","Total",1650,56,33,23,1594,26,84,140,64,84,482,714
"2011","Hounslow 013E","E01002589","Total",1982,164,51,113,1818,144,86,298,192,176,441,481
"2011","Hounslow 014A","E01002668","Total",1943,315,83,232,1628,123,78,444,472,102,138,271
"2011","Hounslow 014B","E01002669","Total",1782,190,47,143,1592,194,92,359,280,104,284,279
"2011","Hounslow 014C","E01002681","Total",2052,179,38,141,1873,167,68,357,264,117,403,497
"2011","Hounslow 014D","E01002682","Total",2317,280,83,197,2037,160,112,446,362,152,345,460
"2011","Hounslow 014E","E01002683","Total",2568,307,104,203,2261,77,108,774,440,170,263,429
"2011","Hounslow 015A","E01002642","Total",2005,176,75,101,1829,81,74,530,216,78,243,607
"2011","Hounslow 015B","E01002643","Total",2276,312,171,141,1964,118,162,426,230,112,350,566
"2011","Hounslow 015C","E01002645","Total",2043,243,98,145,1800,114,86,327,230,41,407,595
"2011","Hounslow 015D","E01002658","Total",1333,107,48,59,1226,36,108,283,202,84,193,320
"2011","Hounslow 015E","E01002677","Total",1554,221,56,165,1333,74,58,304,288,95,188,326
"2011","Hounslow 016A","E01002587","Total",1895,110,65,45,1785,79,122,264,154,82,465,619
"2011","Hounslow 016B","E01002588","Total",1755,212,68,144,1543,236,82,282,180,205,274,284
"2011","Hounslow 016C","E01002660","Total",1758,99,34,65,1659,39,70,203,138,69,539,601
"2011","Hounslow 016D","E01002661","Total",1847,64,24,40,1783,29,124,164,86,62,538,780
"2011","Hounslow 016E","E01002665","Total",1611,124,66,58,1487,112,82,190,88,84,414,517
"2011","Hounslow 017A","E01002624","Total",1503,88,26,62,1415,41,74,215,140,99,397,449
"2011","Hounslow 017B","E01002646","Total",2016,174,62,112,1842,190,86,450,190,178,341,407
"2011","Hounslow 017C","E01002662","Total",1991,125,33,92,1866,57,108,197,148,47,471,838
"2011","Hounslow 017D","E01002663","Total",2074,219,114,105,1855,71,126,354,174,121,467,542
"2011","Hounslow 017E","E01002664","Total",1714,155,46,109,1559,96,48,379,184,72,367,413
"2011","Hounslow 018A","E01002641","Total",1928,137,48,89,1791,98,116,291,158,48,453,627
"2011","Hounslow 018C","E01002648","Total",2689,182,48,134,2507,172,104,550,302,124,497,758
"2011","Hounslow 018D","E01002649","Total",1784,185,39,146,1599,141,60,334,302,42,304,416
"2011","Hounslow 018E","E01002657","Total",1876,119,51,68,1757,84,132,371,208,129,348,485
"2011","Hounslow 018F","E01033083","Total",1664,141,8,133,1523,44,16,732,294,10,140,287
"2011","Hounslow 018G","E01033084","Total",1711,166,23,143,1545,144,36,398,282,88,217,380
"2011","Hounslow 019A","E01002653","Total",1813,72,36,36,1741,14,110,273,98,91,502,653
"2011","Hounslow 019B","E01002654","Total",1785,159,49,110,1626,65,104,352,216,75,347,467
"2011","Hounslow 019C","E01002655","Total",1885,112,48,64,1773,58,130,342,160,60,458,565
"2011","Hounslow 019D","E01002656","Total",1318,118,69,49,1200,54,104,216,130,78,232,386
"2011","Hounslow 019E","E01002659","Total",1398,123,68,55,1275,61,120,235,120,98,247,394
"2011","Hounslow 020A","E01002667","Total",1529,195,52,143,1334,116,72,271,316,88,164,307
"2011","Hounslow 020B","E01002670","Total",1737,211,57,154,1526,90,124,368,254,75,237,378
"2011","Hounslow 020C","E01002671","Total",1659,152,62,90,1507,59,116,392,246,71,252,371
"2011","Hounslow 020D","E01002672","Total",1578,253,52,201,1325,116,68,196,308,88,297,252
"2011","Hounslow 020E","E01002673","Total",1634,177,35,142,1457,280,64,253,166,180,266,248
"2011","Hounslow 021A","E01002647","Total",2213,155,53,102,2058,164,98,558,210,177,494,357
"2011","Hounslow 021B","E01002650","Total",2436,159,35,124,2277,224,72,562,216,227,487,489
"2011","Hounslow 021C","E01002651","Total",1778,110,38,72,1668,66,76,189,140,124,498,575
"2011","Hounslow 021D","E01002652","Total",1765,81,19,62,1684,54,56,198,122,110,477,667
"2011","Hounslow 021E","E01002666","Total",1376,56,31,25,1320,77,80,156,52,63,361,531
"2011","Hounslow 022A","E01002555","Total",1917,150,65,85,1767,107,104,389,214,104,325,524
"2011","Hounslow 022B","E01002556","Total",1681,165,71,94,1516,89,128,390,200,139,263,307
"2011","Hounslow 022C","E01002590","Total",1839,206,81,125,1633,139,122,360,242,57,310,403
"2011","Hounslow 022D","E01002592","Total",1999,223,108,115,1776,168,170,373,202,81,380,402
"2011","Hounslow 022E","E01002595","Total",1924,192,83,109,1732,131,110,319,214,149,342,467
"2011","Hounslow 023A","E01002557","Total",1785,258,124,134,1527,110,146,293,236,81,286,375
"2011","Hounslow 023B","E01002558","Total",1945,231,70,161,1714,149,118,398,280,119,337,313
"2011","Hounslow 023C","E01002559","Total",2274,218,50,168,2056,156,118,504,346,134,435,363
"2011","Hounslow 023D","E01002560","Total",1702,149,93,56,1553,96,160,222,186,69,351,469
"2011","Hounslow 023E","E01002561","Total",1379,159,20,139,1220,204,26,312,212,159,126,181
"2011","Hounslow 024A","E01002591","Total",1729,143,79,64,1586,93,148,297,170,88,318,472
"2011","Hounslow 024B","E01002593","Total",1966,192,76,116,1774,42,158,336,214,106,368,550
"2011","Hounslow 024C","E01002594","Total",1954,107,57,50,1847,130,148,399,168,55,455,492
"2011","Hounslow 024D","E01002611","Total",1785,134,51,83,1651,96,144,344,172,111,335,449
"2011","Hounslow 024E","E01002612","Total",1670,225,103,122,1445,178,90,281,244,92,193,367
"2011","Hounslow 024F","E01002613","Total",1761,121,55,66,1640,71,120,350,188,87,396,428
"2011","Hounslow 025B","E01002598","Total",1840,148,63,85,1692,170,54,344,194,123,422,385
"2011","Hounslow 025C","E01002599","Total",1607,119,46,73,1488,139,78,408,174,105,280,304
"2011","Hounslow 025D","E01002600","Total",1524,97,59,38,1427,95,64,219,182,141,365,361
"2011","Hounslow 025E","E01002603","Total",1924,122,19,103,1802,202,42,453,240,139,385,341
"2011","Hounslow 025F","E01033000","Total",1785,179,56,123,1606,246,58,370,176,212,256,288
"2011","Hounslow 025G","E01033030","Total",1723,234,6,228,1489,124,8,658,450,63,90,96
"2011","Hounslow 026A","E01002604","Total",1733,123,27,96,1610,243,76,356,124,178,357,276
"2011","Hounslow 026B","E01002605","Total",1847,261,94,167,1586,152,120,336,224,120,350,284
"2011","Hounslow 026C","E01002606","Total",1641,247,69,178,1394,169,78,269,156,133,229,360
"2011","Hounslow 026D","E01002607","Total",1923,134,68,66,1789,127,102,357,236,201,356,410
"2011","Hounslow 026E","E01002615","Total",1470,211,80,131,1259,153,82,268,166,68,253,269
"2011","Hounslow 027A","E01002596","Total",1828,241,18,223,1587,188,40,541,336,92,216,174
"2011","Hounslow 027B","E01002601","Total",1665,138,31,107,1527,124,70,439,304,147,215,228
"2011","Hounslow 027C","E01002602","Total",1477,136,62,74,1341,50,96,380,190,97,218,310
"2011","Hounslow 027D","E01002614","Total",1746,225,64,161,1521,130,118,429,320,77,120,327
"2011","Hounslow 027E","E01002616","Total",1382,134,74,60,1248,73,134,265,166,109,167,334
"2011","Hounslow 028A","E01002608","Total",1717,198,60,138,1519,188,122,330,184,140,240,315
"2011","Hounslow 028B","E01002609","Total",1730,173,77,96,1557,73,138,344,186,99,253,464
"2011","Hounslow 028C","E01002610","Total",1564,180,79,101,1384,164,142,305,182,137,157,297
"2011","Hounslow 028D","E01002617","Total",1594,173,64,109,1421,80,140,332,242,66,216,345
"2011","Hounslow 029A","E01002687","Total",1707,308,73,235,1399,43,94,352,500,47,96,267
"2011","Hounslow 029B","E01002691","Total",1596,167,62,105,1429,76,120,232,184,71,207,539
"2011","Hounslow 029C","E01002692","Total",1776,390,64,326,1386,98,68,328,500,50,109,233
"2011","Hounslow 029D","E01002693","Total",1642,387,191,196,1255,50,118,301,358,50,107,271
"2011","Hounslow 029E","E01032573","Total",1614,384,106,278,1230,38,100,229,502,74,67,220
"2011","Kingston upon Thames 001A","E01003006","Total",1500,178,79,99,1322,77,142,326,206,127,186,258
"2011","Kingston upon Thames 001B","E01003007","Total",1513,103,58,45,1410,54,150,521,140,96,160,289
"2011","Kingston upon Thames 001C","E01003008","Total",1432,91,53,38,1341,38,128,568,160,112,136,199
"2011","Kingston upon Thames 001D","E01003009","Total",1895,221,83,138,1674,84,154,559,272,147,163,295
"2011","Kingston upon Thames 001E","E01003010","Total",1497,120,44,76,1377,33,124,424,170,102,169,355
"2011","Kingston upon Thames 002A","E01002952","Total",1418,79,53,26,1339,43,158,272,140,101,255,370
"2011","Kingston upon Thames 002B","E01002953","Total",1280,90,46,44,1190,25,94,217,146,98,241,369
"2011","Kingston upon Thames 002C","E01002955","Total",1377,125,61,64,1252,20,88,239,196,63,229,417
"2011","Kingston upon Thames 002D","E01002956","Total",1193,90,48,42,1103,29,166,249,106,86,208,259
"2011","Kingston upon Thames 002E","E01002959","Total",1420,77,53,24,1343,23,194,321,84,140,197,384
"2011","Kingston upon Thames 003A","E01002935","Total",1770,243,56,187,1527,50,48,355,436,63,132,443
"2011","Kingston upon Thames 003B","E01002938","Total",1935,196,79,117,1739,70,126,712,348,146,132,205
"2011","Kingston upon Thames 003C","E01002951","Total",1514,168,63,105,1346,68,144,342,276,95,118,303
"2011","Kingston upon Thames 003D","E01002954","Total",1148,227,94,133,921,78,76,272,244,52,36,163
"2011","Kingston upon Thames 003E","E01002957","Total",1717,136,35,101,1581,169,76,217,168,194,242,515
"2011","Kingston upon Thames 004A","E01002933","Total",1961,273,126,147,1688,133,88,558,256,121,217,315
"2011","Kingston upon Thames 004B","E01002934","Total",1821,112,31,81,1709,25,82,705,262,133,166,336
"2011","Kingston upon Thames 004D","E01002937","Total",1729,142,40,102,1587,32,74,756,232,101,106,286
"2011","Kingston upon Thames 004E","E01003011","Total",1741,203,87,116,1538,65,150,456,292,108,135,332
"2011","Kingston upon Thames 004F","E01033568","Total",1461,255,20,235,1206,156,38,317,458,56,51,130
"2011","Kingston upon Thames 004G","E01033569","Total",1564,219,25,194,1345,86,56,390,390,77,96,250
"2011","Kingston upon Thames 005A","E01002964","Total",2057,431,168,263,1626,100,66,392,392,55,120,501
"2011","Kingston upon Thames 005B","E01002969","Total",1748,271,70,201,1477,190,94,311,246,109,207,320
"2011","Kingston upon Thames 005C","E01002971","Total",1709,194,58,136,1515,58,78,430,360,71,124,394
"2011","Kingston upon Thames 005D","E01002972","Total",1809,275,85,190,1534,83,80,326,464,22,102,457
"2011","Kingston upon Thames 005E","E01002974","Total",1890,187,57,130,1703,90,92,402,280,93,253,493
"2011","Kingston upon Thames 006A","E01002932","Total",1726,201,35,166,1525,174,48,454,222,92,241,294
"2011","Kingston upon Thames 006B","E01002960","Total",1608,116,59,57,1492,32,136,361,182,142,235,404
"2011","Kingston upon Thames 006C","E01002962","Total",1527,88,41,47,1439,75,114,304,140,103,281,422
"2011","Kingston upon Thames 006D","E01002970","Total",1576,129,57,72,1447,90,76,287,194,83,245,472
"2011","Kingston upon Thames 006E","E01002973","Total",1372,95,33,62,1277,87,56,235,150,95,278,376
"2011","Kingston upon Thames 007A","E01002929","Total",1633,155,62,93,1478,28,164,418,236,111,181,340
"2011","Kingston upon Thames 007B","E01002930","Total",1682,183,67,116,1499,97,124,399,244,68,166,401
"2011","Kingston upon Thames 007C","E01002931","Total",1850,121,59,62,1729,42,110,534,244,159,244,396
"2011","Kingston upon Thames 007D","E01002963","Total",1731,284,121,163,1447,69,98,350,298,123,201,308
"2011","Kingston upon Thames 007E","E01002985","Total",1662,151,67,84,1511,67,96,394,184,102,333,335
"2011","Kingston upon Thames 008A","E01002927","Total",1556,187,95,92,1369,46,130,293,168,104,219,409
"2011","Kingston upon Thames 008B","E01002928","Total",1523,246,115,131,1277,74,108,281,202,88,191,333
"2011","Kingston upon Thames 008C","E01002958","Total",1680,165,50,115,1515,57,108,502,262,132,133,321
"2011","Kingston upon Thames 008D","E01002961","Total",1750,97,53,44,1653,25,178,479,178,107,278,408
"2011","Kingston upon Thames 008E","E01002986","Total",1273,117,62,55,1156,24,124,236,132,76,232,332
"2011","Kingston upon Thames 009A","E01002965","Total",2322,385,114,271,1937,98,128,318,506,31,135,721
"2011","Kingston upon Thames 009B","E01002967","Total",1852,375,114,261,1477,63,124,332,622,41,60,235
"2011","Kingston upon Thames 009C","E01002968","Total",2375,452,56,396,1923,43,112,425,526,61,151,605
"2011","Kingston upon Thames 009D","E01002990","Total",1680,443,96,347,1237,34,84,254,568,31,57,209
"2011","Kingston upon Thames 009E","E01002991","Total",1598,240,62,178,1358,24,80,329,380,83,92,370
"2011","Kingston upon Thames 010A","E01002922","Total",1632,253,96,157,1379,27,184,334,278,92,202,262
"2011","Kingston upon Thames 010B","E01002926","Total",1535,150,80,70,1385,49,126,448,164,119,159,320
"2011","Kingston upon Thames 010C","E01002966","Total",1873,204,50,154,1669,65,68,467,316,134,156,463
"2011","Kingston upon Thames 010D","E01002992","Total",1077,124,34,90,953,42,60,201,202,36,87,325
"2011","Kingston upon Thames 011A","E01002921","Total",1532,405,95,310,1127,48,46,280,526,6,46,175
"2011","Kingston upon Thames 011B","E01002987","Total",1508,425,145,280,1083,57,52,191,426,32,41,284
"2011","Kingston upon Thames 011C","E01002988","Total",1234,195,39,156,1039,82,52,251,338,55,46,215
"2011","Kingston upon Thames 011D","E01002989","Total",1830,313,38,275,1517,46,78,437,680,53,52,171
"2011","Kingston upon Thames 012A","E01002975","Total",1381,79,45,34,1302,48,166,290,126,87,259,326
"2011","Kingston upon Thames 012B","E01002977","Total",1665,180,70,110,1485,175,156,333,174,81,229,337
"2011","Kingston upon Thames 012C","E01002980","Total",1396,69,47,22,1327,33,186,248,136,78,267,379
"2011","Kingston upon Thames 012D","E01002981","Total",1533,100,56,44,1433,20,142,267,114,114,365,411
"2011","Kingston upon Thames 012E","E01002984","Total",1405,229,125,104,1176,57,140,279,156,106,166,272
"2011","Kingston upon Thames 013A","E01002923","Total",1563,384,180,204,1179,135,108,165,218,54,139,360
"2011","Kingston upon Thames 013B","E01002925","Total",1553,344,78,266,1209,70,26,388,428,30,71,196
"2011","Kingston upon Thames 013C","E01002993","Total",1519,400,128,272,1119,56,70,228,574,31,32,128
"2011","Kingston upon Thames 013D","E01002995","Total",1379,173,68,105,1206,18,172,332,288,60,128,208
"2011","Kingston upon Thames 013E","E01002999","Total",1427,316,64,252,1111,71,56,228,438,55,64,199
"2011","Kingston upon Thames 014A","E01002915","Total",1304,99,59,40,1205,12,130,203,178,61,242,379
"2011","Kingston upon Thames 014B","E01002916","Total",1478,97,67,30,1381,17,158,313,142,127,200,424
"2011","Kingston upon Thames 014C","E01002917","Total",1397,87,60,27,1310,23,174,330,118,82,181,402
"2011","Kingston upon Thames 014D","E01002920","Total",1604,130,85,45,1474,19,166,473,168,107,212,329
"2011","Kingston upon Thames 014E","E01002924","Total",1530,110,66,44,1420,21,214,404,136,143,167,335
"2011","Kingston upon Thames 015A","E01002976","Total",1654,135,66,69,1519,84,154,467,238,88,215,273
"2011","Kingston upon Thames 015B","E01002978","Total",1757,156,81,75,1601,44,180,332,260,66,236,483
"2011","Kingston upon Thames 015C","E01002979","Total",1549,170,54,116,1379,49,116,310,236,110,199,359
"2011","Kingston upon Thames 015D","E01002982","Total",1350,128,66,62,1222,39,178,222,126,72,245,340
"2011","Kingston upon Thames 015E","E01002983","Total",1626,119,67,52,1507,17,196,350,164,50,275,455
"2011","Kingston upon Thames 016A","E01002994","Total",1388,166,61,105,1222,24,128,375,298,56,76,265
"2011","Kingston upon Thames 016B","E01002996","Total",1484,156,57,99,1328,42,100,463,236,82,161,244
"2011","Kingston upon Thames 016C","E01002997","Total",1440,177,50,127,1263,20,104,387,214,92,117,329
"2011","Kingston upon Thames 016D","E01002998","Total",1522,158,70,88,1364,146,78,388,264,91,157,240
"2011","Kingston upon Thames 016E","E01003002","Total",1826,250,102,148,1576,104,134,473,288,57,204,316
"2011","Kingston upon Thames 017A","E01002918","Total",1758,112,48,64,1646,136,106,506,182,73,280,363
"2011","Kingston upon Thames 017B","E01002919","Total",1705,186,74,112,1519,122,122,320,204,113,252,386
"2011","Kingston upon Thames 017C","E01003000","Total",1553,142,58,84,1411,82,130,280,186,112,221,400
"2011","Kingston upon Thames 017D","E01003001","Total",1831,112,63,49,1719,87,120,380,182,110,333,507
"2011","Kingston upon Thames 017E","E01003003","Total",1512,147,56,91,1365,65,90,291,218,88,263,350
"2011","Kingston upon Thames 018A","E01002939","Total",1548,158,63,95,1390,63,106,366,236,99,215,305
"2011","Kingston upon Thames 018B","E01002941","Total",1487,196,111,85,1291,41,204,277,164,56,189,360
"2011","Kingston upon Thames 018C","E01002942","Total",1370,111,56,55,1259,31,174,275,180,112,166,321
"2011","Kingston upon Thames 018D","E01003004","Total",1578,122,53,69,1456,72,150,361,198,106,273,296
"2011","Kingston upon Thames 018E","E01003005","Total",1488,122,49,73,1366,55,136,381,210,111,191,282
"2011","Kingston upon Thames 019A","E01002944","Total",1342,115,43,72,1227,86,96,330,176,95,169,275
"2011","Kingston upon Thames 019B","E01002945","Total",1559,179,69,110,1380,104,120,391,274,63,140,288
"2011","Kingston upon Thames 019C","E01002946","Total",1498,126,54,72,1372,78,142,315,296,62,170,309
"2011","Kingston upon Thames 019D","E01002947","Total",1614,117,51,66,1497,51,162,331,204,121,217,411
"2011","Kingston upon Thames 020A","E01002940","Total",1580,141,85,56,1439,142,134,393,170,68,214,318
"2011","Kingston upon Thames 020B","E01002943","Total",1396,114,55,59,1282,64,122,230,156,135,226,349
"2011","Kingston upon Thames 020C","E01002948","Total",2055,184,63,121,1871,124,150,537,278,141,209,432
"2011","Kingston upon Thames 020D","E01002949","Total",1862,153,67,86,1709,96,160,375,222,147,315,394
"2011","Kingston upon Thames 020E","E01002950","Total",1596,244,105,139,1352,160,112,371,282,55,173,199
"2011","Merton 001A","E01003472","Total",1344,87,41,46,1257,11,92,494,176,106,119,259
"2011","Merton 001B","E01003473","Total",1334,106,31,75,1228,23,60,372,228,64,100,381
"2011","Merton 001C","E01003474","Total",1411,86,35,51,1325,14,116,317,164,154,254,306
"2011","Merton 001D","E01003475","Total",2511,379,52,327,2132,232,96,524,668,63,150,399
"2011","Merton 001E","E01003478","Total",1639,128,48,80,1511,25,88,525,256,164,121,332
"2011","Merton 002A","E01003460","Total",1459,261,119,142,1198,41,148,291,274,100,122,222
"2011","Merton 002B","E01003462","Total",1464,176,99,77,1288,20,184,327,182,138,145,292
"2011","Merton 002C","E01003464","Total",1328,156,80,76,1172,10,218,320,170,142,118,194
"2011","Merton 002D","E01003465","Total",1276,85,43,42,1191,26,186,303,144,117,148,267
"2011","Merton 003A","E01003400","Total",1484,215,41,174,1269,34,64,266,412,66,93,334
"2011","Merton 003B","E01003454","Total",1314,199,70,129,1115,37,72,301,300,25,119,261
"2011","Merton 003C","E01003456","Total",1465,242,58,184,1223,38,42,271,384,78,70,340
"2011","Merton 003D","E01003476","Total",1389,89,20,69,1300,71,48,290,210,116,247,318
"2011","Merton 003E","E01003477","Total",1516,121,35,86,1395,35,78,392,298,128,137,327
"2011","Merton 004A","E01003401","Total",1336,280,123,157,1056,13,58,352,280,52,64,237
"2011","Merton 004B","E01003402","Total",1552,267,87,180,1285,23,122,387,274,57,123,299
"2011","Merton 004C","E01003403","Total",1500,262,96,166,1238,25,122,287,386,84,91,243
"2011","Merton 004D","E01003404","Total",1647,438,185,253,1209,34,72,291,538,22,80,172
"2011","Merton 004E","E01003461","Total",1532,240,68,172,1292,19,128,256,440,120,91,238
"2011","Merton 005A","E01003367","Total",2186,277,44,233,1909,56,92,375,620,81,184,501
"2011","Merton 005B","E01003369","Total",1656,259,40,219,1397,78,58,260,466,21,120,394
"2011","Merton 005C","E01003370","Total",1979,278,36,242,1701,70,60,381,482,48,161,499
"2011","Merton 005D","E01003371","Total",1542,182,48,134,1360,26,84,268,300,41,137,504
"2011","Merton 005E","E01003455","Total",1572,252,31,221,1320,74,44,304,506,59,93,240
"2011","Merton 006A","E01003359","Total",1733,314,112,202,1419,71,92,324,414,63,124,331
"2011","Merton 006B","E01003360","Total",1687,237,46,191,1450,46,60,429,416,53,80,366
"2011","Merton 006C","E01003457","Total",1622,141,47,94,1481,22,60,627,316,82,102,272
"2011","Merton 006D","E01003458","Total",1601,199,35,164,1402,35,80,464,406,60,67,290
"2011","Merton 006E","E01003459","Total",2071,325,70,255,1746,163,80,393,538,89,152,331
"2011","Merton 007A","E01003394","Total",1924,127,59,68,1797,39,128,291,172,92,431,644
"2011","Merton 007B","E01003395","Total",1471,99,62,37,1372,56,122,217,138,68,316,455
"2011","Merton 007C","E01003396","Total",1592,111,46,65,1481,55,106,227,136,94,281,582
"2011","Merton 007D","E01003397","Total",1552,143,55,88,1409,50,84,275,162,85,294,459
"2011","Merton 007E","E01003398","Total",1730,135,56,79,1595,82,92,253,140,134,378,516
"2011","Merton 008A","E01003368","Total",1586,148,37,111,1438,53,108,244,182,73,289,489
"2011","Merton 008B","E01003372","Total",1532,210,41,169,1322,127,56,267,224,104,227,317
"2011","Merton 008C","E01003393","Total",1529,202,37,165,1327,61,44,345,306,57,172,342
"2011","Merton 008D","E01003406","Total",1641,118,15,103,1523,176,30,345,190,88,345,349
"2011","Merton 008E","E01003407","Total",1784,268,19,249,1516,75,38,372,382,80,213,356
"2011","Merton 009A","E01003355","Total",1556,269,46,223,1287,45,44,358,556,36,48,200
"2011","Merton 009B","E01003356","Total",1757,201,64,137,1556,31,70,468,304,112,164,407
"2011","Merton 009C","E01003358","Total",1765,245,63,182,1520,37,76,320,542,73,74,398
"2011","Merton 009D","E01003383","Total",1535,220,39,181,1315,21,42,382,444,57,67,302
"2011","Merton 009E","E01003384","Total",1521,163,42,121,1358,30,72,363,354,67,126,346
"2011","Merton 010A","E01003442","Total",1574,245,93,152,1329,51,118,384,324,101,130,221
"2011","Merton 010B","E01003443","Total",1564,174,66,108,1390,35,122,513,240,132,137,211
"2011","Merton 010C","E01003444","Total",1557,246,86,160,1311,29,128,440,296,139,92,187
"2011","Merton 010D","E01003445","Total",1713,163,84,79,1550,30,128,458,254,122,191,367
"2011","Merton 010E","E01003463","Total",1291,90,51,39,1201,24,150,305,118,151,159,294
"2011","Merton 011A","E01003380","Total",1648,174,62,112,1474,39,114,428,354,68,124,347
"2011","Merton 011B","E01003382","Total",1539,196,63,133,1343,21,106,383,406,89,98,240
"2011","Merton 011C","E01003385","Total",1581,158,44,114,1423,14,88,512,308,116,102,283
"2011","Merton 011D","E01003399","Total",1358,202,64,138,1156,36,96,216,362,51,88,307
"2011","Merton 011E","E01003423","Total",1540,147,42,105,1393,34,84,390,314,134,118,319
"2011","Merton 012A","E01003357","Total",1742,258,71,187,1484,152,66,324,290,60,170,422
"2011","Merton 012B","E01003376","Total",1553,158,52,106,1395,100,106,223,200,79,294,393
"2011","Merton 012C","E01003377","Total",1562,119,21,98,1443,138,46,230,148,174,368,339
"2011","Merton 012D","E01003408","Total",1852,310,56,254,1542,91,58,375,496,46,141,335
"2011","Merton 012E","E01003410","Total",1581,182,28,154,1399,116,72,294,256,97,231,333
"2011","Merton 013A","E01003386","Total",2198,138,46,92,2060,166,72,493,194,148,560,427
"2011","Merton 013B","E01003388","Total",1439,190,110,80,1249,92,118,242,146,76,207,368
"2011","Merton 013C","E01003389","Total",1764,168,47,121,1596,150,72,311,166,65,401,431
"2011","Merton 013D","E01003392","Total",1299,150,25,125,1149,51,78,202,158,95,248,317
"2011","Merton 013E","E01003409","Total",1710,126,51,75,1584,99,94,315,124,99,418,435
"2011","Merton 014A","E01003387","Total",1595,174,71,103,1421,155,88,287,182,64,328,317
"2011","Merton 014B","E01003391","Total",1333,185,34,151,1148,173,60,287,114,113,171,230
"2011","Merton 014C","E01003411","Total",1729,231,70,161,1498,158,88,412,240,73,235,292
"2011","Merton 014D","E01003412","Total",1660,160,49,111,1500,109,52,279,182,163,330,385
"2011","Merton 014E","E01003435","Total",1309,123,55,68,1186,39,120,216,144,110,231,326
"2011","Merton 015A","E01003361","Total",1646,160,52,108,1486,30,122,355,208,106,264,401
"2011","Merton 015B","E01003424","Total",1533,108,78,30,1425,38,198,384,184,89,201,331
"2011","Merton 015C","E01003425","Total",1440,80,44,36,1360,23,172,373,158,105,170,359
"2011","Merton 015D","E01003426","Total",1749,106,58,48,1643,54,202,291,172,158,275,491
"2011","Merton 015E","E01003428","Total",1457,240,109,131,1217,28,102,302,282,101,137,265
"2011","Merton 016A","E01003366","Total",1502,172,66,106,1330,35,100,281,218,26,219,451
"2011","Merton 016B","E01003381","Total",1451,275,98,177,1176,17,82,306,424,15,64,268
"2011","Merton 016C","E01003446","Total",1668,313,61,252,1355,51,92,287,396,53,120,356
"2011","Merton 016D","E01003447","Total",1501,246,63,183,1255,127,94,329,316,75,98,216
"2011","Merton 016E","E01003471","Total",1511,170,84,86,1341,41,122,369,228,92,137,352
"2011","Merton 017A","E01003413","Total",1900,186,52,134,1714,146,86,342,248,129,365,398
"2011","Merton 017B","E01003414","Total",1560,126,65,61,1434,67,110,203,144,89,382,439
"2011","Merton 017C","E01003415","Total",1622,117,58,59,1505,74,108,200,138,154,425,406
"2011","Merton 017D","E01003416","Total",1512,124,62,62,1388,66,136,173,134,84,389,406
"2011","Merton 017E","E01003434","Total",1489,111,57,54,1378,64,94,209,132,116,397,366
"2011","Merton 018A","E01003373","Total",1465,137,28,109,1328,181,68,233,144,168,296,238
"2011","Merton 018B","E01003378","Total",1992,174,47,127,1818,173,86,374,240,169,350,426
"2011","Merton 018C","E01003379","Total",1846,270,151,119,1576,182,104,373,164,107,350,296
"2011","Merton 018D","E01003390","Total",1597,200,36,164,1397,185,42,347,156,85,300,282
"2011","Merton 018E","E01003405","Total",1705,190,75,115,1515,101,114,272,136,88,384,420
"2011","Merton 019A","E01003429","Total",1456,110,43,67,1346,91,110,243,148,89,354,311
"2011","Merton 019B","E01003430","Total",1443,172,34,138,1271,214,62,222,108,83,362,220
"2011","Merton 019C","E01003431","Total",1506,141,33,108,1365,189,64,220,148,145,311,288
"2011","Merton 019D","E01003432","Total",1556,106,35,71,1450,243,66,206,96,143,382,314
"2011","Merton 019E","E01003433","Total",1521,168,70,98,1353,108,102,232,146,68,367,330
"2011","Merton 020A","E01003466","Total",1592,117,65,52,1475,35,172,373,216,96,199,384
"2011","Merton 020B","E01003467","Total",1612,118,62,56,1494,25,156,464,210,93,159,387
"2011","Merton 020C","E01003468","Total",1699,125,61,64,1574,42,152,478,242,101,192,367
"2011","Merton 020D","E01003469","Total",1620,106,38,68,1514,76,76,419,222,62,314,345
"2011","Merton 020E","E01003470","Total",1739,132,57,75,1607,59,120,379,176,97,354,422
"2011","Merton 021A","E01003362","Total",1320,116,69,47,1204,27,148,224,154,60,190,401
"2011","Merton 021B","E01003363","Total",1638,116,73,43,1522,32,164,354,184,108,290,390
"2011","Merton 021C","E01003364","Total",1720,153,93,60,1567,37,188,380,194,117,199,452
"2011","Merton 021D","E01003365","Total",1403,94,62,32,1309,23,178,208,132,62,278,428
"2011","Merton 021E","E01003421","Total",1600,186,67,119,1414,54,136,326,228,90,209,371
"2011","Merton 022A","E01003374","Total",1284,186,78,108,1098,150,72,277,176,61,159,203
"2011","Merton 022B","E01003375","Total",1591,230,108,122,1361,63,138,281,180,106,224,369
"2011","Merton 022C","E01003437","Total",1873,238,111,127,1635,48,228,321,232,94,338,374
"2011","Merton 022D","E01003440","Total",1536,188,62,126,1348,111,104,329,224,62,234,284
"2011","Merton 022E","E01003441","Total",1778,130,44,86,1648,111,126,299,192,133,394,393
"2011","Merton 023A","E01003427","Total",1749,213,91,122,1536,46,82,341,316,87,290,374
"2011","Merton 023B","E01003436","Total",1559,156,69,87,1403,93,122,315,184,116,282,291
"2011","Merton 023C","E01003439","Total",1439,137,49,88,1302,100,70,278,234,83,228,309
"2011","Merton 023D","E01003448","Total",1701,178,53,125,1523,136,118,325,188,102,331,323
"2011","Merton 023E","E01003453","Total",1685,199,83,116,1486,96,90,377,196,105,297,325
"2011","Merton 024A","E01003438","Total",1691,189,90,99,1502,130,102,371,174,83,288,354
"2011","Merton 024B","E01003449","Total",1759,206,89,117,1553,95,138,332,194,137,321,336
"2011","Merton 024C","E01003450","Total",1605,149,68,81,1456,125,112,356,160,101,339,263
"2011","Merton 024D","E01003451","Total",1644,137,80,57,1507,22,180,239,148,92,315,511
"2011","Merton 024E","E01003452","Total",1982,266,128,138,1716,137,148,402,234,92,289,414
"2011","Merton 025A","E01003417","Total",1559,136,73,63,1423,73,184,293,222,96,171,384
"2011","Merton 025B","E01003418","Total",1471,101,73,28,1370,41,146,288,172,72,255,396
"2011","Merton 025C","E01003419","Total",1703,144,62,82,1559,85,138,384,234,93,259,366
"2011","Merton 025D","E01003420","Total",1380,104,47,57,1276,55,128,344,154,88,212,295
"2011","Merton 025E","E01003422","Total",1341,135,69,66,1206,36,138,253,164,64,226,325
"2011","Redbridge 001A","E01003744","Total",1329,188,96,92,1141,22,212,250,206,31,156,264
"2011","Redbridge 001B","E01003745","Total",1435,60,36,24,1375,26,162,265,162,118,304,338
"2011","Redbridge 001C","E01003746","Total",1462,231,127,104,1231,20,256,278,194,80,159,244
"2011","Redbridge 001D","E01003747","Total",1343,96,69,27,1247,24,180,314,132,129,170,298
"2011","Redbridge 001E","E01003748","Total",1448,155,76,79,1293,23,178,298,178,75,227,314
"2011","Redbridge 001F","E01003749","Total",1597,205,105,100,1392,49,150,320,280,66,186,341
"2011","Redbridge 001G","E01003750","Total",1651,349,169,180,1302,46,160,303,262,77,151,303
"2011","Redbridge 002A","E01003720","Total",1777,327,149,178,1450,154,196,372,190,53,174,311
"2011","Redbridge 002B","E01003722","Total",1772,189,77,112,1583,147,168,307,184,134,265,378
"2011","Redbridge 002C","E01003723","Total",1742,215,87,128,1527,139,160,396,196,116,250,270
"2011","Redbridge 002D","E01003726","Total",1524,235,88,147,1289,201,92,268,176,129,198,225
"2011","Redbridge 003A","E01003721","Total",1609,156,72,84,1453,108,138,310,154,130,292,321
"2011","Redbridge 003B","E01003724","Total",1381,117,53,64,1264,124,96,273,156,99,211,305
"2011","Redbridge 003C","E01003725","Total",1498,195,54,141,1303,223,110,388,222,67,103,190
"2011","Redbridge 003D","E01003727","Total",1600,214,74,140,1386,141,128,383,166,76,238,254
"2011","Redbridge 004A","E01003654","Total",1563,155,67,88,1408,106,118,338,196,94,229,327
"2011","Redbridge 004B","E01003655","Total",1510,188,70,118,1322,62,128,370,260,40,177,285
"2011","Redbridge 004C","E01003658","Total",1649,252,92,160,1397,176,80,286,226,133,183,313
"2011","Redbridge 004D","E01003660","Total",1718,153,59,94,1565,54,106,444,252,72,194,443
"2011","Redbridge 005A","E01003656","Total",1489,230,104,126,1259,117,142,251,164,77,177,331
"2011","Redbridge 005B","E01003657","Total",2082,252,85,167,1830,124,210,450,280,101,242,423
"2011","Redbridge 005C","E01003659","Total",1640,152,45,107,1488,85,132,456,196,81,200,338
"2011","Redbridge 006A","E01003698","Total",1385,100,39,61,1285,71,138,314,182,51,220,309
"2011","Redbridge 006B","E01003699","Total",1415,189,78,111,1226,96,120,258,200,82,180,290
"2011","Redbridge 006C","E01003700","Total",2235,240,101,139,1995,128,194,389,248,126,428,482
"2011","Redbridge 006D","E01003701","Total",1788,132,67,65,1656,95,150,382,154,83,396,396
"2011","Redbridge 006E","E01003702","Total",1620,292,93,199,1328,123,112,348,238,41,180,286
"2011","Redbridge 006F","E01003703","Total",2501,263,71,192,2238,125,174,524,342,240,347,486
"2011","Redbridge 006G","E01003704","Total",1681,184,98,86,1497,163,120,391,172,47,258,346
"2011","Redbridge 007A","E01003668","Total",1610,287,114,173,1323,39,120,304,360,91,111,298
"2011","Redbridge 007B","E01003669","Total",1528,151,48,103,1377,26,94,405,290,91,197,274
"2011","Redbridge 007C","E01003670","Total",1496,141,55,86,1355,37,138,332,202,157,172,317
"2011","Redbridge 007D","E01003671","Total",1533,101,56,45,1432,23,134,448,174,70,205,378
"2011","Redbridge 007E","E01003672","Total",1430,297,135,162,1133,125,70,282,280,76,95,205
"2011","Redbridge 007F","E01003673","Total",1778,232,46,186,1546,65,98,494,454,50,145,240
"2011","Redbridge 007G","E01003674","Total",2099,382,88,294,1717,69,90,472,558,74,146,308
"2011","Redbridge 008A","E01003707","Total",1335,96,45,51,1239,38,132,222,114,110,235,388
"2011","Redbridge 008B","E01003708","Total",1476,201,90,111,1275,173,108,242,180,108,219,245
"2011","Redbridge 008C","E01003709","Total",1627,102,64,38,1525,73,224,262,130,93,362,381
"2011","Redbridge 008D","E01003710","Total",1515,114,78,36,1401,32,132,188,114,67,414,454
"2011","Redbridge 009A","E01003759","Total",1459,117,60,57,1342,26,150,378,206,57,199,326
"2011","Redbridge 009B","E01003760","Total",1783,149,48,101,1634,101,106,419,222,123,273,390
"2011","Redbridge 009C","E01003761","Total",1771,237,56,181,1534,270,24,414,192,266,219,149
"2011","Redbridge 009D","E01003762","Total",1604,182,54,128,1422,86,82,424,278,45,228,279
"2011","Redbridge 009E","E01003763","Total",1875,134,77,57,1741,87,152,353,212,202,347,388
"2011","Redbridge 009F","E01003764","Total",1954,267,75,192,1687,84,88,448,412,86,246,323
"2011","Redbridge 009G","E01003765","Total",1574,175,49,126,1399,56,86,440,286,75,171,285
"2011","Redbridge 010A","E01003705","Total",2192,183,82,101,2009,156,152,487,250,132,329,503
"2011","Redbridge 010B","E01003706","Total",1594,162,93,69,1432,133,168,383,146,112,222,268
"2011","Redbridge 010C","E01003711","Total",1770,166,92,74,1604,53,208,325,186,130,320,382
"2011","Redbridge 010D","E01003712","Total",1359,189,86,103,1170,94,78,250,122,120,232,274
"2011","Redbridge 012A","E01003646","Total",1742,172,85,87,1570,35,86,220,110,160,473,486
"2011","Redbridge 012B","E01003648","Total",1437,118,73,45,1319,6,212,199,142,90,244,426
"2011","Redbridge 012C","E01003649","Total",1627,72,34,38,1555,51,160,305,98,61,435,445
"2011","Redbridge 012D","E01003651","Total",1467,96,76,20,1371,16,98,214,80,89,398,476
"2011","Redbridge 013A","E01003639","Total",1758,195,95,100,1563,105,128,312,180,139,349,350
"2011","Redbridge 013B","E01003640","Total",1771,159,69,90,1612,70,124,392,168,133,387,338
"2011","Redbridge 013C","E01003641","Total",1692,91,44,47,1601,82,94,313,142,133,402,435
"2011","Redbridge 013D","E01003642","Total",1689,106,42,64,1583,122,112,250,100,179,424,396
"2011","Redbridge 014A","E01003774","Total",1750,369,96,273,1381,40,138,442,386,40,116,219
"2011","Redbridge 014B","E01003775","Total",1736,178,93,85,1558,38,196,364,224,103,266,367
"2011","Redbridge 014C","E01003776","Total",1632,517,248,269,1115,123,130,236,286,38,105,197
"2011","Redbridge 014D","E01003777","Total",1740,343,93,250,1397,30,120,310,468,47,142,280
"2011","Redbridge 014E","E01003778","Total",1831,342,134,208,1489,49,112,357,432,63,162,314
"2011","Redbridge 014F","E01003779","Total",1485,316,167,149,1169,29,82,371,240,57,155,235
"2011","Redbridge 014G","E01003780","Total",1516,87,61,26,1429,16,162,259,124,123,310,435
"2011","Redbridge 015A","E01003647","Total",1786,131,57,74,1655,63,114,252,194,122,415,495
"2011","Redbridge 015B","E01003650","Total",1513,165,104,61,1348,94,148,235,146,95,320,310
"2011","Redbridge 015C","E01003652","Total",1543,73,36,37,1470,60,114,259,90,114,448,385
"2011","Redbridge 015D","E01003653","Total",1471,125,41,84,1346,96,90,279,126,64,349,342
"2011","Redbridge 017A","E01003638","Total",1611,176,107,69,1435,56,132,228,140,107,355,417
"2011","Redbridge 017B","E01003643","Total",1796,147,97,50,1649,65,140,344,144,136,460,360
"2011","Redbridge 017C","E01003644","Total",1562,74,45,29,1488,57,124,313,116,117,318,443
"2011","Redbridge 017D","E01003645","Total",2506,193,35,158,2313,193,74,689,346,161,412,438
"2011","Redbridge 018A","E01003789","Total",1444,228,80,148,1216,18,116,256,236,86,157,347
"2011","Redbridge 018B","E01003794","Total",1472,117,49,68,1355,66,128,416,162,81,196,306
"2011","Redbridge 018C","E01003795","Total",1178,80,45,35,1098,37,136,303,142,63,163,254
"2011","Redbridge 018D","E01003796","Total",1566,179,73,106,1387,40,136,372,258,95,166,320
"2011","Redbridge 019A","E01003661","Total",1902,137,53,84,1765,110,128,355,146,101,396,529
"2011","Redbridge 019B","E01003662","Total",1859,240,50,190,1619,168,116,368,202,140,273,352
"2011","Redbridge 019C","E01003663","Total",1757,208,142,66,1549,58,188,298,124,215,298,368
"2011","Redbridge 019D","E01003664","Total",1776,115,49,66,1661,78,106,350,140,202,388,397
"2011","Redbridge 019E","E01003665","Total",1648,88,45,43,1560,105,112,329,126,155,344,389
"2011","Redbridge 019F","E01003666","Total",2198,325,44,281,1873,327,60,559,242,191,239,255
"2011","Redbridge 019H","E01033590","Total",1098,110,6,104,988,173,26,299,156,27,157,150
"2011","Redbridge 019I","E01033592","Total",1908,104,29,75,1804,148,82,407,210,109,412,436
"2011","Redbridge 020A","E01003751","Total",1954,103,47,56,1851,83,130,297,130,241,494,476
"2011","Redbridge 020B","E01003753","Total",1976,151,54,97,1825,99,88,398,146,170,483,441
"2011","Redbridge 020C","E01003754","Total",1636,148,96,52,1488,52,86,222,74,153,435,466
"2011","Redbridge 020D","E01003757","Total",1976,136,34,102,1840,167,56,305,112,231,530,439
"2011","Redbridge 022A","E01003769","Total",1711,121,29,92,1590,147,46,281,160,139,410,407
"2011","Redbridge 022B","E01003770","Total",2481,211,51,160,2270,109,98,574,232,226,527,504
"2011","Redbridge 022C","E01003771","Total",1918,107,28,79,1811,181,66,325,102,151,512,474
"2011","Redbridge 022D","E01003773","Total",1673,137,55,82,1536,89,80,324,170,166,377,330
"2011","Redbridge 023A","E01003752","Total",2492,176,51,125,2316,64,134,369,326,147,663,613
"2011","Redbridge 023B","E01003755","Total",2002,76,32,44,1926,52,88,400,114,174,658,440
"2011","Redbridge 023C","E01003756","Total",2118,96,45,51,2022,52,114,318,82,243,689,524
"2011","Redbridge 023D","E01003758","Total",2581,121,17,104,2460,315,60,655,180,196,562,492
"2011","Redbridge 024A","E01003766","Total",1900,74,28,46,1826,66,88,273,144,177,544,534
"2011","Redbridge 024B","E01003767","Total",1864,119,29,90,1745,112,70,289,102,151,491,530
"2011","Redbridge 024C","E01003768","Total",1716,156,41,115,1560,112,46,270,142,53,518,419
"2011","Redbridge 024D","E01003772","Total",1700,98,47,51,1602,79,98,232,106,137,467,483
"2011","Redbridge 026A","E01003781","Total",1632,185,53,132,1447,72,58,334,172,70,393,348
"2011","Redbridge 026B","E01003782","Total",1755,107,28,79,1648,75,44,293,114,233,475,414
"2011","Redbridge 026C","E01003786","Total",1419,80,34,46,1339,31,70,247,104,141,339,407
"2011","Redbridge 026D","E01003787","Total",1532,99,34,65,1433,50,60,218,104,198,413,390
"2011","Redbridge 027A","E01003790","Total",1417,165,71,94,1252,67,114,282,174,128,193,294
"2011","Redbridge 027B","E01003791","Total",1485,106,49,57,1379,50,152,270,192,48,251,416
"2011","Redbridge 027C","E01003792","Total",1394,119,44,75,1275,36,62,318,178,104,237,340
"2011","Redbridge 027D","E01003793","Total",1556,334,129,205,1222,127,134,283,252,88,100,238
"2011","Redbridge 029A","E01003783","Total",2184,307,73,234,1877,186,74,449,178,133,436,421
"2011","Redbridge 029B","E01003784","Total",1760,120,33,87,1640,98,68,265,138,145,519,407
"2011","Redbridge 029C","E01003785","Total",1898,201,42,159,1697,168,56,442,224,130,349,328
"2011","Redbridge 029D","E01003788","Total",1816,191,31,160,1625,148,54,350,176,111,420,366
"2011","Redbridge 030A","E01003683","Total",2144,81,31,50,2063,275,64,245,112,289,481,597
"2011","Redbridge 030B","E01003684","Total",1780,78,34,44,1702,147,68,206,76,208,571,426
"2011","Redbridge 030C","E01003685","Total",1822,68,32,36,1754,107,56,217,92,206,508,568
"2011","Redbridge 030D","E01003686","Total",1952,71,33,38,1881,170,74,216,98,209,622,492
"2011","Redbridge 030F","E01003688","Total",1791,107,23,84,1684,100,78,215,126,159,553,453
"2011","Redbridge 030G","E01003689","Total",1580,131,84,47,1449,178,54,186,78,81,436,436
"2011","Redbridge 030H","E01033589","Total",1676,142,12,130,1534,107,16,658,320,50,114,269
"2011","Redbridge 030I","E01033591","Total",1898,141,35,106,1757,134,68,327,162,220,402,444
"2011","Redbridge 031A","E01003737","Total",1793,124,88,36,1669,66,158,210,98,165,533,439
"2011","Redbridge 031B","E01003738","Total",2108,121,69,52,1987,87,130,270,122,224,546,608
"2011","Redbridge 031C","E01003739","Total",2121,125,44,81,1996,99,90,390,146,196,571,504
"2011","Redbridge 031D","E01003740","Total",2055,119,65,54,1936,98,124,212,124,223,568,587
"2011","Redbridge 031E","E01003741","Total",1737,188,118,70,1549,56,174,267,154,92,411,395
"2011","Redbridge 031F","E01003742","Total",2085,89,34,55,1996,183,50,342,150,240,533,498
"2011","Redbridge 031G","E01003743","Total",1747,70,33,37,1677,94,82,222,104,229,531,415
"2011","Redbridge 032A","E01003728","Total",2391,199,45,154,2192,212,58,464,248,210,424,576
"2011","Redbridge 032B","E01003729","Total",1745,115,57,58,1630,111,72,171,112,207,523,434
"2011","Redbridge 032C","E01003730","Total",1693,41,18,23,1652,146,40,154,70,257,535,450
"2011","Redbridge 032D","E01003732","Total",1545,142,22,120,1403,414,22,342,148,140,165,172
"2011","Redbridge 032E","E01003733","Total",1767,88,31,57,1679,138,56,221,98,202,454,510
"2011","Redbridge 033A","E01003731","Total",1461,103,29,74,1358,112,40,152,78,185,385,406
"2011","Redbridge 033B","E01003734","Total",1737,98,31,67,1639,127,66,225,102,265,436,418
"2011","Redbridge 033C","E01003735","Total",2339,200,93,107,2139,519,78,294,144,280,473,351
"2011","Redbridge 033D","E01003736","Total",1659,63,18,45,1596,181,24,291,100,242,401,357
"2011","Redbridge 034A","E01003713","Total",1740,76,38,38,1664,54,78,219,94,158,558,503
"2011","Redbridge 034B","E01003714","Total",2159,111,38,73,2048,165,88,309,122,274,540,550
"2011","Redbridge 034C","E01003715","Total",1970,113,35,78,1857,122,60,188,86,158,660,583
"2011","Redbridge 034D","E01003716","Total",1704,115,33,82,1589,69,58,216,132,145,519,450
"2011","Redbridge 034E","E01003718","Total",1847,178,25,153,1669,76,48,484,162,175,418,306
"2011","Redbridge 034F","E01003719","Total",1942,138,40,98,1804,116,94,283,170,129,503,509
"2011","Redbridge 034G","E01032581","Total",1652,252,45,207,1400,149,46,334,264,96,266,245
"2011","Redbridge 035A","E01003690","Total",1596,175,67,108,1421,66,128,225,202,72,334,394
"2011","Redbridge 035B","E01003691","Total",1434,79,32,47,1355,62,54,149,84,132,524,350
"2011","Redbridge 035C","E01003692","Total",1585,95,33,62,1490,68,104,255,112,141,440,370
"2011","Redbridge 035D","E01003693","Total",1541,61,32,29,1480,27,110,168,62,101,490,522
"2011","Redbridge 035E","E01003694","Total",1451,97,61,36,1354,38,114,167,72,97,411,455
"2011","Redbridge 035F","E01003695","Total",1518,151,27,124,1367,59,82,320,150,64,342,350
"2011","Redbridge 035G","E01003696","Total",1877,112,70,42,1765,48,122,195,86,146,519,649
"2011","Redbridge 035H","E01003697","Total",1621,89,35,54,1532,58,74,246,122,103,468,461
"2011","Redbridge 036A","E01003675","Total",1619,84,51,33,1535,37,118,246,98,144,487,405
"2011","Redbridge 036B","E01003676","Total",1690,75,43,32,1615,39,114,231,80,163,494,494
"2011","Redbridge 036C","E01003677","Total",1547,72,45,27,1475,26,212,195,100,121,420,401
"2011","Redbridge 036D","E01003678","Total",1605,54,36,18,1551,47,116,265,90,124,419,490
"2011","Redbridge 036E","E01003679","Total",1621,74,41,33,1547,35,128,196,92,88,491,517
"2011","Redbridge 036F","E01003680","Total",1619,47,26,21,1572,50,110,287,98,131,448,448
"2011","Redbridge 036G","E01003681","Total",1844,208,119,89,1636,98,170,296,120,120,415,417
"2011","Redbridge 036H","E01003682","Total",1696,69,47,22,1627,16,82,280,92,179,462,516
"2011","Richmond upon Thames 001A","E01003797","Total",1445,107,75,32,1338,18,178,404,134,189,189,226
"2011","Richmond upon Thames 001B","E01003798","Total",1503,254,112,142,1249,44,140,319,288,119,131,208
"2011","Richmond upon Thames 001C","E01003799","Total",1621,176,60,116,1445,26,120,409,288,177,168,257
"2011","Richmond upon Thames 001D","E01003800","Total",1573,186,73,113,1387,103,118,308,236,117,244,261
"2011","Richmond upon Thames 001E","E01003801","Total",1304,158,63,95,1146,20,100,288,226,83,134,295
"2011","Richmond upon Thames 001F","E01003802","Total",1328,225,54,171,1103,32,114,327,290,82,62,196
"2011","Richmond upon Thames 001G","E01003803","Total",1474,209,96,113,1265,115,120,250,200,124,118,338
"2011","Richmond upon Thames 002A","E01003846","Total",1734,122,59,63,1612,52,172,480,178,165,209,356
"2011","Richmond upon Thames 002B","E01003847","Total",1582,383,142,241,1199,22,136,320,416,41,65,199
"2011","Richmond upon Thames 002C","E01003849","Total",1480,227,81,146,1253,36,138,388,248,118,105,220
"2011","Richmond upon Thames 002D","E01003851","Total",1642,213,79,134,1429,52,176,529,228,124,103,217
"2011","Richmond upon Thames 002E","E01003860","Total",1681,278,63,215,1403,26,108,406,554,65,65,179
"2011","Richmond upon Thames 002F","E01003864","Total",1466,244,98,146,1222,20,118,345,326,67,144,202
"2011","Richmond upon Thames 003A","E01003852","Total",1324,268,103,165,1056,56,132,212,264,80,96,216
"2011","Richmond upon Thames 003B","E01003853","Total",1491,206,87,119,1285,92,130,341,172,123,114,313
"2011","Richmond upon Thames 003C","E01003854","Total",1413,237,85,152,1176,39,102,396,304,80,79,176
"2011","Richmond upon Thames 003D","E01003855","Total",1689,356,91,265,1333,133,98,300,368,72,104,258
"2011","Richmond upon Thames 003E","E01003856","Total",1568,270,63,207,1298,88,60,424,408,72,23,223
"2011","Richmond upon Thames 003F","E01003857","Total",1752,233,85,148,1519,81,114,605,338,80,115,186
"2011","Richmond upon Thames 003G","E01003858","Total",1628,192,70,122,1436,51,78,651,292,82,78,204
"2011","Richmond upon Thames 004A","E01003848","Total",1808,249,77,172,1559,95,100,482,460,91,104,227
"2011","Richmond upon Thames 004C","E01003861","Total",1751,321,89,232,1430,66,48,395,552,58,93,218
"2011","Richmond upon Thames 004D","E01003862","Total",1388,230,75,155,1158,75,96,288,256,107,93,243
"2011","Richmond upon Thames 004E","E01003863","Total",1420,255,136,119,1165,31,108,329,204,120,104,269
"2011","Richmond upon Thames 004F","E01003865","Total",1311,154,75,79,1157,76,102,360,174,74,135,236
"2011","Richmond upon Thames 004G","E01033570","Total",1552,245,29,216,1307,102,46,423,398,95,151,92
"2011","Richmond upon Thames 004H","E01033571","Total",1538,196,83,113,1342,60,148,339,166,147,211,271
"2011","Richmond upon Thames 005A","E01003804","Total",1758,245,107,138,1513,78,124,556,324,123,83,225
"2011","Richmond upon Thames 005B","E01003807","Total",1795,270,99,171,1525,75,136,416,416,87,128,267
"2011","Richmond upon Thames 005C","E01003808","Total",1782,266,94,172,1516,58,110,620,342,51,140,195
"2011","Richmond upon Thames 005D","E01003809","Total",1719,163,72,91,1556,47,150,475,202,169,143,370
"2011","Richmond upon Thames 005E","E01003859","Total",1622,163,83,80,1459,55,114,471,218,195,132,274
"2011","Richmond upon Thames 006A","E01003873","Total",1654,376,117,259,1278,45,112,376,422,115,90,118
"2011","Richmond upon Thames 006B","E01003874","Total",1508,340,83,257,1168,25,100,397,446,40,61,99
"2011","Richmond upon Thames 006C","E01003875","Total",1613,222,97,125,1391,32,164,388,238,177,177,215
"2011","Richmond upon Thames 006D","E01003878","Total",1331,295,114,181,1036,74,70,309,212,53,111,207
"2011","Richmond upon Thames 007A","E01003866","Total",1587,165,58,107,1422,50,86,638,280,95,99,174
"2011","Richmond upon Thames 007B","E01003868","Total",1506,185,39,146,1321,37,66,465,392,117,105,139
"2011","Richmond upon Thames 007C","E01003871","Total",1649,144,40,104,1505,91,96,615,274,104,120,205
"2011","Richmond upon Thames 007D","E01003872","Total",1451,271,61,210,1180,34,98,324,340,129,105,150
"2011","Richmond upon Thames 008A","E01003821","Total",1438,363,94,269,1075,49,110,277,414,41,52,132
"2011","Richmond upon Thames 008B","E01003876","Total",1591,385,109,276,1206,27,166,226,474,36,88,189
"2011","Richmond upon Thames 008C","E01003877","Total",1479,300,117,183,1179,32,126,360,328,113,89,131
"2011","Richmond upon Thames 008D","E01003879","Total",1338,216,56,160,1122,40,76,336,304,104,75,187
"2011","Richmond upon Thames 009A","E01003892","Total",1930,351,110,241,1579,40,176,590,430,109,80,154
"2011","Richmond upon Thames 009B","E01003893","Total",1569,307,85,222,1262,32,128,361,350,97,61,233
"2011","Richmond upon Thames 009C","E01003894","Total",1635,277,63,214,1358,37,98,383,422,158,77,183
"2011","Richmond upon Thames 009D","E01003895","Total",1698,275,77,198,1423,60,116,421,346,120,151,209
"2011","Richmond upon Thames 010A","E01003905","Total",1388,144,62,82,1244,38,122,354,190,78,158,304
"2011","Richmond upon Thames 010B","E01003906","Total",1538,195,77,118,1343,66,116,379,270,75,154,283
"2011","Richmond upon Thames 010C","E01003907","Total",1683,220,98,122,1463,77,120,384,182,120,227,353
"2011","Richmond upon Thames 010D","E01003908","Total",1817,133,72,61,1684,38,218,438,216,142,205,427
"2011","Richmond upon Thames 010E","E01003909","Total",1564,142,81,61,1422,65,186,299,192,85,191,404
"2011","Richmond upon Thames 011A","E01003867","Total",1485,146,57,89,1339,44,96,393,228,60,184,334
"2011","Richmond upon Thames 011B","E01003869","Total",1605,203,74,129,1402,28,88,386,390,65,167,278
"2011","Richmond upon Thames 011C","E01003870","Total",1863,174,56,118,1689,34,88,614,338,152,191,272
"2011","Richmond upon Thames 011D","E01003910","Total",1624,182,114,68,1442,32,210,413,232,72,153,330
"2011","Richmond upon Thames 012A","E01003805","Total",1667,102,70,32,1565,40,240,481,144,229,140,291
"2011","Richmond upon Thames 012B","E01003806","Total",1481,93,46,47,1388,45,176,411,134,137,206,279
"2011","Richmond upon Thames 012C","E01003816","Total",1707,147,82,65,1560,69,224,462,144,189,223,249
"2011","Richmond upon Thames 012D","E01003817","Total",1689,395,192,203,1294,59,198,324,302,106,77,228
"2011","Richmond upon Thames 013A","E01003840","Total",1584,111,41,70,1473,102,88,294,164,92,358,375
"2011","Richmond upon Thames 013B","E01003841","Total",1925,298,115,183,1627,209,100,389,182,128,259,360
"2011","Richmond upon Thames 013C","E01003842","Total",1677,122,57,65,1555,107,166,345,170,96,238,433
"2011","Richmond upon Thames 013D","E01003843","Total",2039,198,89,109,1841,117,182,385,174,144,375,464
"2011","Richmond upon Thames 013E","E01003844","Total",1444,112,54,58,1332,30,200,265,164,67,220,386
"2011","Richmond upon Thames 013F","E01003845","Total",1615,154,97,57,1461,35,216,249,184,92,266,419
"2011","Richmond upon Thames 014A","E01003882","Total",1790,263,74,189,1527,46,102,568,386,102,138,185
"2011","Richmond upon Thames 014B","E01003883","Total",1775,270,77,193,1505,31,64,595,540,40,53,182
"2011","Richmond upon Thames 014C","E01003896","Total",1646,316,75,241,1330,46,88,315,412,62,101,306
"2011","Richmond upon Thames 014D","E01003897","Total",1683,337,61,276,1346,69,70,430,492,61,54,170
"2011","Richmond upon Thames 015A","E01003898","Total",1458,212,64,148,1246,59,64,456,410,60,39,158
"2011","Richmond upon Thames 015B","E01003899","Total",1377,229,84,145,1148,47,80,449,266,52,72,182
"2011","Richmond upon Thames 015C","E01003900","Total",1562,179,76,103,1383,97,98,367,190,94,194,343
"2011","Richmond upon Thames 015D","E01003901","Total",1640,126,64,62,1514,37,102,581,244,116,164,270
"2011","Richmond upon Thames 015E","E01003902","Total",1296,116,52,64,1180,52,96,434,180,50,116,252
"2011","Richmond upon Thames 015F","E01003903","Total",1610,96,44,52,1514,125,130,377,198,116,199,369
"2011","Richmond upon Thames 015G","E01003904","Total",1536,231,90,141,1305,60,72,492,290,86,114,191
"2011","Richmond upon Thames 016A","E01003880","Total",1468,158,45,113,1310,39,114,422,210,112,150,263
"2011","Richmond upon Thames 016B","E01003881","Total",1105,159,62,97,946,43,82,280,248,54,100,139
"2011","Richmond upon Thames 016C","E01003884","Total",1568,241,75,166,1327,35,150,338,300,129,133,242
"2011","Richmond upon Thames 016D","E01003885","Total",1516,191,64,127,1325,75,110,432,268,112,120,208
"2011","Richmond upon Thames 017A","E01003818","Total",1560,200,114,86,1360,93,162,353,222,82,198,250
"2011","Richmond upon Thames 017B","E01003819","Total",1675,283,92,191,1392,138,126,353,214,88,182,291
"2011","Richmond upon Thames 017C","E01003820","Total",1949,190,112,78,1759,109,134,466,256,133,227,434
"2011","Richmond upon Thames 018A","E01003811","Total",1548,185,56,129,1363,52,78,571,270,127,73,192
"2011","Richmond upon Thames 018B","E01003812","Total",1836,221,48,173,1615,82,98,547,378,81,154,275
"2011","Richmond upon Thames 018C","E01003890","Total",1509,203,49,154,1306,41,104,446,254,97,111,253
"2011","Richmond upon Thames 018D","E01003891","Total",1706,329,116,213,1377,33,196,377,358,60,123,230
"2011","Richmond upon Thames 019A","E01003810","Total",1597,152,46,106,1445,51,90,529,246,85,177,267
"2011","Richmond upon Thames 019B","E01003813","Total",1618,157,80,77,1461,52,186,379,224,103,173,344
"2011","Richmond upon Thames 019C","E01003814","Total",1606,301,120,181,1305,67,136,363,308,105,116,210
"2011","Richmond upon Thames 019D","E01003815","Total",1794,290,86,204,1504,124,114,545,356,58,124,183
"2011","Richmond upon Thames 020A","E01003828","Total",1517,151,72,79,1366,74,222,283,228,97,128,334
"2011","Richmond upon Thames 020B","E01003829","Total",1675,213,88,125,1462,124,144,315,190,86,252,351
"2011","Richmond upon Thames 020C","E01003830","Total",1760,191,77,114,1569,89,232,432,258,82,166,310
"2011","Richmond upon Thames 020D","E01003831","Total",1611,220,85,135,1391,122,126,424,266,83,119,251
"2011","Richmond upon Thames 020E","E01003832","Total",1431,299,102,197,1132,115,82,258,212,81,141,243
"2011","Richmond upon Thames 020F","E01003833","Total",1352,268,80,188,1084,103,92,320,264,36,50,219
"2011","Richmond upon Thames 021A","E01003886","Total",1699,173,53,120,1526,58,98,540,340,125,153,212
"2011","Richmond upon Thames 021B","E01003887","Total",1724,293,93,200,1431,52,118,483,350,85,117,226
"2011","Richmond upon Thames 021C","E01003888","Total",1884,383,144,239,1501,90,128,392,344,115,123,309
"2011","Richmond upon Thames 021D","E01003889","Total",1706,281,92,189,1425,30,164,454,338,102,124,213
"2011","Richmond upon Thames 022A","E01003834","Total",1512,424,121,303,1088,53,96,314,360,65,65,135
"2011","Richmond upon Thames 022B","E01003835","Total",1498,110,39,71,1388,36,106,510,174,156,148,258
"2011","Richmond upon Thames 022C","E01003836","Total",1472,225,128,97,1247,47,116,389,148,113,159,275
"2011","Richmond upon Thames 022D","E01003837","Total",1797,261,113,148,1536,79,222,456,292,130,112,245
"2011","Richmond upon Thames 022E","E01003838","Total",1786,253,63,190,1533,90,94,481,300,134,162,272
"2011","Richmond upon Thames 022F","E01003839","Total",1864,370,117,253,1494,175,106,472,400,75,77,189
"2011","Richmond upon Thames 023A","E01003822","Total",1420,83,46,37,1337,13,196,337,170,122,196,303
"2011","Richmond upon Thames 023B","E01003823","Total",1638,284,118,166,1354,56,180,264,420,41,118,275
"2011","Richmond upon Thames 023C","E01003824","Total",1641,165,98,67,1476,67,166,499,208,96,155,285
"2011","Richmond upon Thames 023D","E01003825","Total",1762,132,73,59,1630,44,156,550,204,97,159,420
"2011","Richmond upon Thames 023E","E01003826","Total",1695,262,114,148,1433,159,138,368,266,87,139,276
"2011","Richmond upon Thames 023F","E01003827","Total",1712,288,80,208,1424,88,88,506,372,70,69,231
"2011","Sutton 001A","E01004125","Total",1583,203,99,104,1380,115,82,385,176,95,257,270
"2011","Sutton 001B","E01004183","Total",1667,199,62,137,1468,129,90,347,204,107,274,317
"2011","Sutton 001C","E01004184","Total",1590,145,62,83,1445,191,80,413,176,142,199,244
"2011","Sutton 001D","E01004185","Total",1427,172,33,139,1255,193,38,294,176,86,239,229
"2011","Sutton 001E","E01004189","Total",1879,214,99,115,1665,155,130,467,196,112,256,349
"2011","Sutton 002A","E01004123","Total",2126,249,67,182,1877,182,92,474,274,147,317,391
"2011","Sutton 002B","E01004124","Total",1826,143,54,89,1683,153,108,429,172,117,283,421
"2011","Sutton 002C","E01004126","Total",1509,123,51,72,1386,181,106,359,168,134,183,255
"2011","Sutton 002D","E01004128","Total",1401,142,70,72,1259,105,68,256,130,131,249,320
"2011","Sutton 002E","E01004129","Total",1762,277,134,143,1485,172,116,386,188,106,174,343
"2011","Sutton 003A","E01004130","Total",1598,197,104,93,1401,87,160,307,162,57,263,365
"2011","Sutton 003B","E01004131","Total",1632,155,86,69,1477,67,122,326,188,97,340,337
"2011","Sutton 003C","E01004134","Total",1435,134,60,74,1301,61,134,245,194,83,209,375
"2011","Sutton 003D","E01004135","Total",1448,86,51,35,1362,45,160,298,132,57,225,445
"2011","Sutton 003E","E01004136","Total",1553,95,46,49,1458,32,164,259,172,94,312,425
"2011","Sutton 004A","E01004164","Total",1476,225,73,152,1251,39,156,288,194,57,208,309
"2011","Sutton 004B","E01004166","Total",1449,228,81,147,1221,45,126,316,288,67,142,237
"2011","Sutton 004C","E01004169","Total",1135,144,34,110,991,90,54,268,174,76,188,141
"2011","Sutton 004D","E01004186","Total",1724,299,43,256,1425,136,62,488,306,61,151,221
"2011","Sutton 004E","E01004188","Total",1711,250,56,194,1461,152,80,394,284,167,173,211
"2011","Sutton 005A","E01004127","Total",1645,164,56,108,1481,128,104,404,194,132,244,275
"2011","Sutton 005B","E01004163","Total",1541,150,66,84,1391,62,160,397,250,37,206,279
"2011","Sutton 005C","E01004165","Total",1668,206,64,142,1462,103,116,376,316,90,194,267
"2011","Sutton 005D","E01004167","Total",1318,166,76,90,1152,116,98,253,146,64,208,267
"2011","Sutton 005E","E01004187","Total",1607,204,91,113,1403,137,90,329,184,111,244,308
"2011","Sutton 006A","E01004117","Total",1464,72,43,29,1392,20,142,403,160,95,198,374
"2011","Sutton 006B","E01004121","Total",1566,180,87,93,1386,43,124,341,236,57,281,304
"2011","Sutton 006C","E01004192","Total",1931,162,62,100,1769,112,98,575,362,57,236,329
"2011","Sutton 006D","E01004193","Total",2328,231,65,166,2097,211,102,746,386,193,194,265
"2011","Sutton 006E","E01004195","Total",1561,200,88,112,1361,55,124,398,248,67,194,275
"2011","Sutton 007A","E01004144","Total",1627,138,61,77,1489,60,206,307,208,65,240,403
"2011","Sutton 007B","E01004145","Total",2131,163,75,88,1968,82,176,506,266,119,355,464
"2011","Sutton 007C","E01004146","Total",1661,209,88,121,1452,111,124,461,236,83,192,245
"2011","Sutton 007D","E01004147","Total",1537,142,83,59,1395,39,182,326,200,88,230,330
"2011","Sutton 008A","E01004116","Total",1532,224,156,68,1308,26,198,300,128,76,231,349
"2011","Sutton 008B","E01004122","Total",1372,116,77,39,1256,25,160,315,124,53,223,356
"2011","Sutton 008C","E01004190","Total",1367,97,50,47,1270,24,160,250,146,51,272,367
"2011","Sutton 008D","E01004191","Total",1651,177,83,94,1474,54,200,352,198,84,225,361
"2011","Sutton 008E","E01004194","Total",1356,212,79,133,1144,65,114,333,256,79,104,193
"2011","Sutton 008F","E01004196","Total",1430,146,78,68,1284,54,156,288,182,86,197,321
"2011","Sutton 009A","E01004115","Total",1750,151,71,80,1599,71,168,419,232,119,261,329
"2011","Sutton 009B","E01004118","Total",1675,209,103,106,1466,52,152,316,186,118,251,391
"2011","Sutton 009C","E01004119","Total",1418,89,47,42,1329,35,136,296,160,76,185,441
"2011","Sutton 009D","E01004132","Total",1536,78,55,23,1458,39,122,371,140,178,271,337
"2011","Sutton 009E","E01004133","Total",1510,84,48,36,1426,54,138,444,166,97,198,329
"2011","Sutton 010A","E01004171","Total",1493,126,65,61,1367,52,150,348,176,108,220,313
"2011","Sutton 010B","E01004172","Total",1527,305,81,224,1222,197,80,300,298,55,125,167
"2011","Sutton 010C","E01004173","Total",1385,130,76,54,1255,63,122,216,156,92,252,354
"2011","Sutton 010D","E01004175","Total",1608,206,78,128,1402,90,148,430,266,61,185,222
"2011","Sutton 010E","E01004176","Total",1419,160,42,118,1259,68,74,389,254,78,161,235
"2011","Sutton 011A","E01004076","Total",1487,182,72,110,1305,101,114,379,224,56,201,230
"2011","Sutton 011B","E01004077","Total",1558,184,87,97,1374,57,142,362,200,85,223,305
"2011","Sutton 011C","E01004078","Total",1617,224,71,153,1393,112,92,390,246,121,169,263
"2011","Sutton 011D","E01004079","Total",1399,74,41,33,1325,24,148,296,156,83,243,375
"2011","Sutton 011E","E01004080","Total",1326,104,62,42,1222,49,160,222,180,88,182,341
"2011","Sutton 011F","E01004081","Total",1507,174,59,115,1333,71,124,459,234,109,117,219
"2011","Sutton 011G","E01004082","Total",1407,85,53,32,1322,38,116,329,168,36,270,365
"2011","Sutton 012A","E01004137","Total",1518,324,59,265,1194,86,112,423,316,45,68,144
"2011","Sutton 012B","E01004140","Total",1509,374,109,265,1135,122,86,220,198,57,172,280
"2011","Sutton 012C","E01004141","Total",1536,300,115,185,1236,135,100,296,260,44,141,260
"2011","Sutton 012D","E01004142","Total",2024,487,155,332,1537,195,100,436,396,71,132,207
"2011","Sutton 012E","E01004149","Total",1710,311,137,174,1399,87,222,325,262,90,153,260
"2011","Sutton 013A","E01004101","Total",1361,110,57,53,1251,26,198,313,190,67,198,259
"2011","Sutton 013B","E01004103","Total",1577,272,60,212,1305,107,62,377,354,30,145,230
"2011","Sutton 013C","E01004138","Total",1552,240,45,195,1312,103,76,426,312,50,138,207
"2011","Sutton 013D","E01004139","Total",1358,204,50,154,1154,63,78,354,226,35,160,238
"2011","Sutton 013E","E01004168","Total",1576,119,61,58,1457,45,172,355,156,81,238,410
"2011","Sutton 014A","E01004143","Total",1453,195,66,129,1258,101,84,405,250,52,158,208
"2011","Sutton 014B","E01004148","Total",1592,183,93,90,1409,135,94,465,232,113,164,206
"2011","Sutton 014C","E01004159","Total",1528,178,72,106,1350,59,176,362,204,66,193,290
"2011","Sutton 014D","E01004160","Total",1575,226,59,167,1349,67,76,441,264,51,210,240
"2011","Sutton 014E","E01004161","Total",1444,156,51,105,1288,62,86,421,272,81,141,225
"2011","Sutton 015A","E01004097","Total",1676,130,56,74,1546,48,122,435,242,86,242,371
"2011","Sutton 015B","E01004098","Total",1234,156,49,107,1078,64,108,296,156,69,132,253
"2011","Sutton 015C","E01004099","Total",1441,280,92,188,1161,95,94,384,340,36,91,121
"2011","Sutton 015D","E01004100","Total",1354,124,69,55,1230,41,172,266,200,96,178,277
"2011","Sutton 015E","E01004102","Total",1362,164,76,88,1198,14,110,314,218,131,131,280
"2011","Sutton 016A","E01004110","Total",1809,253,86,167,1556,93,162,408,314,83,156,340
"2011","Sutton 016B","E01004111","Total",1511,154,96,58,1357,41,148,434,154,118,198,264
"2011","Sutton 016C","E01004112","Total",1635,177,110,67,1458,47,224,403,222,91,198,273
"2011","Sutton 016D","E01004120","Total",1538,95,64,31,1443,31,180,285,146,40,325,436
"2011","Sutton 016E","E01004157","Total",1274,88,50,38,1186,13,138,246,120,127,195,347
"2011","Sutton 017A","E01004087","Total",1458,91,61,30,1367,24,220,242,136,67,280,398
"2011","Sutton 017B","E01004170","Total",1714,259,69,190,1455,71,130,360,294,84,185,331
"2011","Sutton 017C","E01004174","Total",1444,267,78,189,1177,106,86,316,222,72,131,244
"2011","Sutton 017D","E01004178","Total",1961,408,144,264,1553,121,134,393,358,95,199,253
"2011","Sutton 017E","E01004179","Total",1560,151,50,101,1409,41,146,355,184,112,222,349
"2011","Sutton 018A","E01004152","Total",1506,423,172,251,1083,135,120,214,332,32,49,201
"2011","Sutton 018B","E01004155","Total",1549,400,107,293,1149,53,78,419,336,46,70,147
"2011","Sutton 018C","E01004156","Total",1653,426,119,307,1227,71,120,418,374,35,61,148
"2011","Sutton 018D","E01004158","Total",1438,295,82,213,1143,44,112,294,278,74,119,222
"2011","Sutton 018E","E01004162","Total",1500,317,105,212,1183,62,90,408,324,45,82,172
"2011","Sutton 019A","E01004083","Total",1420,249,80,169,1171,163,72,196,202,118,254,166
"2011","Sutton 019B","E01004086","Total",1612,127,52,75,1485,94,162,300,172,87,284,386
"2011","Sutton 019C","E01004088","Total",1818,273,65,208,1545,284,60,240,168,164,389,240
"2011","Sutton 019D","E01004089","Total",1290,195,42,153,1095,230,64,253,142,104,165,137
"2011","Sutton 019E","E01004182","Total",1546,200,69,131,1346,201,98,374,206,92,151,224
"2011","Sutton 020A","E01004104","Total",1515,89,53,36,1426,43,206,317,186,124,206,344
"2011","Sutton 020B","E01004107","Total",1522,176,62,114,1346,109,110,392,224,103,148,260
"2011","Sutton 020C","E01004177","Total",1684,467,272,195,1217,147,160,296,238,50,111,215
"2011","Sutton 020D","E01004180","Total",1682,111,74,37,1571,28,236,267,194,88,280,478
"2011","Sutton 020E","E01004181","Total",1583,296,93,203,1287,97,146,282,284,56,154,268
"2011","Sutton 021A","E01004090","Total",1168,230,86,144,938,141,62,243,162,83,134,113
"2011","Sutton 021B","E01004096","Total",1412,361,90,271,1051,74,74,328,326,46,67,136
"2011","Sutton 021C","E01004150","Total",1548,557,233,324,991,107,86,254,316,25,49,154
"2011","Sutton 021D","E01004151","Total",1587,319,60,259,1268,75,92,355,404,40,108,194
"2011","Sutton 021E","E01004153","Total",1708,423,120,303,1285,96,132,403,368,46,95,145
"2011","Sutton 022A","E01004091","Total",1282,68,47,21,1214,23,214,241,144,52,168,372
"2011","Sutton 022B","E01004092","Total",1430,159,72,87,1271,32,192,243,184,61,162,397
"2011","Sutton 022C","E01004105","Total",1819,99,45,54,1720,77,176,417,222,176,217,435
"2011","Sutton 022D","E01004106","Total",1529,44,34,10,1485,18,208,235,216,117,271,420
"2011","Sutton 022E","E01004154","Total",1419,130,62,68,1289,20,190,307,212,88,174,298
"2011","Sutton 024A","E01004084","Total",1447,74,54,20,1373,28,200,208,130,57,270,480
"2011","Sutton 024B","E01004085","Total",1595,123,54,69,1472,31,204,295,166,96,243,437
"2011","Sutton 024C","E01004108","Total",1645,116,48,68,1529,79,164,433,192,128,225,308
"2011","Sutton 024D","E01004109","Total",1596,157,68,89,1439,97,144,352,234,92,159,361
"2011","Sutton 025A","E01004093","Total",1499,139,59,80,1360,36,176,379,220,100,146,303
"2011","Sutton 025B","E01004094","Total",1677,265,105,160,1412,83,116,515,284,65,121,228
"2011","Sutton 025C","E01004095","Total",1459,183,50,133,1276,33,184,333,258,61,127,280
"2011","Sutton 025D","E01004114","Total",1676,86,62,24,1590,27,290,327,146,135,212,453
"2011","Sutton 025E","E01032623","Total",1751,92,64,28,1659,16,314,288,190,126,370,355
"2011","Waltham Forest 001A","E01004349","Total",1439,131,78,53,1308,105,178,268,130,67,242,318
"2011","Waltham Forest 001B","E01004350","Total",1753,484,367,117,1269,109,206,276,158,67,197,256
"2011","Waltham Forest 001C","E01004351","Total",1584,173,96,77,1411,87,214,351,192,52,195,320
"2011","Waltham Forest 001D","E01004356","Total",1630,124,72,52,1506,102,172,254,156,87,311,424
"2011","Waltham Forest 001E","E01004357","Total",1556,132,65,67,1424,65,198,246,148,91,301,375
"2011","Waltham Forest 002A","E01004352","Total",1842,297,142,155,1545,46,188,334,266,94,149,468
"2011","Waltham Forest 002B","E01004353","Total",1789,270,131,139,1519,83,216,310,276,51,216,367
"2011","Waltham Forest 002C","E01004354","Total",1768,236,84,152,1532,127,158,373,254,97,164,359
"2011","Waltham Forest 002D","E01004358","Total",1647,349,153,196,1298,118,148,279,194,46,174,339
"2011","Waltham Forest 002E","E01004359","Total",1673,142,89,53,1531,43,140,339,184,82,328,415
"2011","Waltham Forest 003A","E01004384","Total",1737,224,94,130,1513,173,86,340,188,114,294,318
"2011","Waltham Forest 003B","E01004385","Total",1384,268,117,151,1116,140,140,271,184,71,104,206
"2011","Waltham Forest 003C","E01004386","Total",1661,142,84,58,1519,60,208,308,212,64,221,446
"2011","Waltham Forest 003D","E01004389","Total",1613,256,113,143,1357,160,156,278,188,119,187,269
"2011","Waltham Forest 003E","E01004390","Total",1596,206,90,116,1390,152,142,319,186,97,211,283
"2011","Waltham Forest 004A","E01004355","Total",1599,221,89,132,1378,111,124,341,206,92,178,326
"2011","Waltham Forest 004B","E01004360","Total",1319,105,64,41,1214,50,158,220,138,72,164,412
"2011","Waltham Forest 004C","E01004413","Total",1529,258,128,130,1271,147,130,297,186,64,214,233
"2011","Waltham Forest 004D","E01004415","Total",1535,162,79,83,1373,94,122,249,156,71,310,371
"2011","Waltham Forest 004E","E01004416","Total",1695,140,57,83,1555,111,160,291,192,129,224,448
"2011","Waltham Forest 005A","E01004361","Total",1294,116,53,63,1178,37,126,239,148,61,158,409
"2011","Waltham Forest 005B","E01004414","Total",1601,149,88,61,1452,95,164,290,192,97,268,346
"2011","Waltham Forest 005C","E01004417","Total",1615,215,103,112,1400,124,130,248,156,90,226,426
"2011","Waltham Forest 005D","E01004451","Total",1726,148,86,62,1578,103,168,287,172,67,276,505
"2011","Waltham Forest 005E","E01004452","Total",1630,239,121,118,1391,124,144,309,184,69,214,347
"2011","Waltham Forest 006A","E01004450","Total",1655,129,76,53,1526,97,162,322,176,94,251,424
"2011","Waltham Forest 006B","E01004453","Total",1625,214,52,162,1411,119,110,271,188,78,283,362
"2011","Waltham Forest 006C","E01004454","Total",1714,175,104,71,1539,112,138,296,170,120,313,390
"2011","Waltham Forest 006D","E01004455","Total",1511,137,47,90,1374,110,94,291,144,94,356,285
"2011","Waltham Forest 006E","E01004456","Total",1557,137,48,89,1420,143,76,197,132,113,408,351
"2011","Waltham Forest 007A","E01004379","Total",1430,116,57,59,1314,54,92,297,168,112,213,378
"2011","Waltham Forest 007B","E01004380","Total",1511,166,67,99,1345,98,154,311,186,69,226,301
"2011","Waltham Forest 007C","E01004381","Total",1815,173,49,124,1642,85,106,381,212,135,340,383
"2011","Waltham Forest 007D","E01004383","Total",1615,122,60,62,1493,78,128,355,172,91,296,373
"2011","Waltham Forest 007E","E01004387","Total",1500,94,49,45,1406,36,122,355,142,102,204,445
"2011","Waltham Forest 007F","E01004388","Total",1431,253,84,169,1178,87,118,261,206,67,165,274
"2011","Waltham Forest 008A","E01004343","Total",1794,139,66,73,1655,76,126,367,232,114,337,403
"2011","Waltham Forest 008B","E01004344","Total",1838,194,43,151,1644,162,62,407,164,154,366,329
"2011","Waltham Forest 008C","E01004382","Total",1350,159,45,114,1191,159,68,232,108,197,216,211
"2011","Waltham Forest 008D","E01004418","Total",1653,182,66,116,1471,141,124,340,218,105,211,332
"2011","Waltham Forest 008E","E01004419","Total",1594,212,59,153,1382,84,114,280,170,93,268,373
"2011","Waltham Forest 009A","E01004398","Total",1966,168,79,89,1798,167,98,245,174,181,436,497
"2011","Waltham Forest 009B","E01004399","Total",1733,147,41,106,1586,227,58,268,138,130,418,347
"2011","Waltham Forest 009C","E01004400","Total",1723,194,58,136,1529,113,74,300,194,151,314,383
"2011","Waltham Forest 009D","E01004402","Total",1804,194,59,135,1610,121,104,319,174,170,382,340
"2011","Waltham Forest 009E","E01004403","Total",1817,130,48,82,1687,120,90,321,184,227,378,367
"2011","Waltham Forest 010A","E01004345","Total",1925,125,41,84,1800,167,66,384,170,162,357,494
"2011","Waltham Forest 010B","E01004348","Total",2688,272,47,225,2416,190,64,632,280,189,468,593
"2011","Waltham Forest 010C","E01004377","Total",1782,135,45,90,1647,85,144,367,170,124,362,395
"2011","Waltham Forest 010D","E01004378","Total",1818,188,55,133,1630,154,104,340,192,102,304,434
"2011","Waltham Forest 011A","E01004342","Total",2143,210,84,126,1933,115,84,347,218,241,383,545
"2011","Waltham Forest 011B","E01004346","Total",1713,107,42,65,1606,104,92,383,132,208,355,332
"2011","Waltham Forest 011C","E01004347","Total",1983,232,63,169,1751,146,94,543,312,94,171,391
"2011","Waltham Forest 011D","E01004460","Total",1885,183,38,145,1702,105,54,352,220,137,383,451
"2011","Waltham Forest 011E","E01004462","Total",1788,187,48,139,1601,69,62,266,204,122,450,428
"2011","Waltham Forest 012A","E01004396","Total",1854,173,51,122,1681,72,74,439,180,103,394,419
"2011","Waltham Forest 012B","E01004457","Total",1892,224,50,174,1668,117,60,384,272,101,313,421
"2011","Waltham Forest 012C","E01004458","Total",1862,188,49,139,1674,87,92,318,238,138,337,464
"2011","Waltham Forest 012D","E01004459","Total",1635,118,56,62,1517,242,78,208,118,224,371,276
"2011","Waltham Forest 012E","E01004463","Total",2003,329,44,285,1674,171,68,494,400,74,181,286
"2011","Waltham Forest 013A","E01004407","Total",1370,169,40,129,1201,150,34,214,96,413,150,144
"2011","Waltham Forest 013B","E01004410","Total",1843,350,151,199,1493,205,92,310,286,130,169,301
"2011","Waltham Forest 013C","E01004464","Total",1579,254,55,199,1325,171,34,326,140,166,246,242
"2011","Waltham Forest 013D","E01004469","Total",1640,231,60,171,1409,145,72,274,122,191,345,260
"2011","Waltham Forest 013E","E01004470","Total",1505,208,71,137,1297,105,56,323,202,104,219,288
"2011","Waltham Forest 013F","E01004471","Total",1697,210,39,171,1487,190,100,321,200,103,240,333
"2011","Waltham Forest 014A","E01004391","Total",1849,358,54,304,1491,104,76,372,332,107,229,271
"2011","Waltham Forest 014B","E01004393","Total",2391,342,111,231,2049,129,84,346,274,87,197,932
"2011","Waltham Forest 014C","E01004401","Total",2102,236,59,177,1866,142,68,499,252,119,293,493
"2011","Waltham Forest 014D","E01004404","Total",2049,369,38,331,1680,154,40,463,274,161,326,262
"2011","Waltham Forest 014E","E01004461","Total",2125,202,60,142,1923,104,84,514,310,122,228,561
"2011","Waltham Forest 015A","E01004412","Total",1738,246,45,201,1492,88,70,419,358,81,251,225
"2011","Waltham Forest 015B","E01004465","Total",1502,157,44,113,1345,54,66,344,166,140,253,322
"2011","Waltham Forest 015C","E01004466","Total",1619,180,54,126,1439,66,62,408,282,83,180,358
"2011","Waltham Forest 015D","E01004467","Total",2155,341,90,251,1814,152,68,516,228,198,331,321
"2011","Waltham Forest 015E","E01004468","Total",1621,207,73,134,1414,57,126,290,256,68,309,308
"2011","Waltham Forest 016A","E01004406","Total",1837,274,45,229,1563,112,62,393,208,95,277,416
"2011","Waltham Forest 016B","E01004408","Total",1743,182,54,128,1561,120,72,442,276,100,220,331
"2011","Waltham Forest 016C","E01004409","Total",1638,286,96,190,1352,86,78,269,260,85,200,374
"2011","Waltham Forest 016D","E01004411","Total",1721,188,27,161,1533,58,72,275,274,51,340,463
"2011","Waltham Forest 016E","E01004443","Total",1833,135,36,99,1698,77,54,276,156,115,531,489
"2011","Waltham Forest 016F","E01004447","Total",1875,182,40,142,1693,49,60,270,222,137,437,518
"2011","Waltham Forest 017A","E01004392","Total",2283,286,44,242,1997,164,70,372,308,80,433,570
"2011","Waltham Forest 017B","E01004394","Total",1820,272,60,212,1548,126,72,329,226,139,302,354
"2011","Waltham Forest 017C","E01004397","Total",2313,237,27,210,2076,92,50,403,342,98,379,712
"2011","Waltham Forest 017D","E01004444","Total",2537,326,88,238,2211,173,64,476,272,265,532,429
"2011","Waltham Forest 017E","E01004446","Total",1915,177,33,144,1738,113,92,380,210,129,391,423
"2011","Waltham Forest 018A","E01004395","Total",1613,138,49,89,1475,78,96,298,172,154,314,363
"2011","Waltham Forest 018B","E01004421","Total",2086,125,46,79,1961,70,92,197,102,338,616,546
"2011","Waltham Forest 018C","E01004445","Total",1737,177,55,122,1560,51,76,279,206,118,373,457
"2011","Waltham Forest 018D","E01004448","Total",1897,226,31,195,1671,237,56,486,254,156,190,292
"2011","Waltham Forest 018E","E01004449","Total",1810,179,84,95,1631,134,86,189,88,239,515,380
"2011","Waltham Forest 019A","E01004363","Total",1563,100,39,61,1463,37,86,209,148,145,320,518
"2011","Waltham Forest 019B","E01004364","Total",1738,139,52,87,1599,128,62,214,122,174,430,469
"2011","Waltham Forest 019C","E01004366","Total",1852,163,65,98,1689,57,140,235,184,139,360,574
"2011","Waltham Forest 019D","E01004367","Total",1637,135,41,94,1502,69,58,229,142,162,408,434
"2011","Waltham Forest 019E","E01004368","Total",1870,239,46,193,1631,83,78,267,244,76,318,565
"2011","Waltham Forest 020A","E01004365","Total",2289,170,26,144,2119,101,56,289,204,171,474,824
"2011","Waltham Forest 020B","E01004405","Total",1616,165,40,125,1451,104,58,235,172,170,346,366
"2011","Waltham Forest 020C","E01004420","Total",2132,299,46,253,1833,99,88,291,158,155,406,636
"2011","Waltham Forest 020D","E01004423","Total",1848,252,115,137,1596,121,62,248,160,67,494,444
"2011","Waltham Forest 020G","E01033153","Total",2614,289,68,221,2325,318,112,409,190,373,487,436
"2011","Waltham Forest 021A","E01004362","Total",1589,257,51,206,1332,63,40,247,292,97,196,397
"2011","Waltham Forest 021B","E01004436","Total",1608,154,28,126,1454,103,52,215,242,62,300,480
"2011","Waltham Forest 021C","E01004437","Total",1812,306,64,242,1506,106,58,265,254,72,269,482
"2011","Waltham Forest 021D","E01004439","Total",1636,175,36,139,1461,121,76,266,220,79,232,467
"2011","Waltham Forest 021E","E01004442","Total",1754,165,31,134,1589,80,56,314,294,78,179,588
"2011","Waltham Forest 022A","E01004422","Total",1662,147,52,95,1515,103,110,283,156,151,364,348
"2011","Waltham Forest 022B","E01004424","Total",1830,173,36,137,1657,145,40,315,138,213,375,431
"2011","Waltham Forest 022C","E01004425","Total",2090,259,45,214,1831,252,64,513,302,166,215,319
"2011","Waltham Forest 022D","E01004426","Total",1787,157,46,111,1630,101,78,271,120,180,444,436
"2011","Waltham Forest 022E","E01004427","Total",2113,277,30,247,1836,197,44,685,262,93,297,258
"2011","Waltham Forest 023A","E01004369","Total",1766,148,25,123,1618,142,40,353,212,134,273,464
"2011","Waltham Forest 023B","E01004370","Total",1786,176,51,125,1610,44,78,323,188,210,271,496
"2011","Waltham Forest 023C","E01004372","Total",1831,238,44,194,1593,84,50,561,280,58,182,378
"2011","Waltham Forest 023D","E01004432","Total",1755,180,46,134,1575,123,70,434,174,200,212,362
"2011","Waltham Forest 023E","E01004435","Total",2010,215,60,155,1795,301,64,351,262,121,279,417
"2011","Waltham Forest 024A","E01004333","Total",1769,164,24,140,1605,161,58,322,146,159,331,428
"2011","Waltham Forest 024B","E01004334","Total",1507,255,97,158,1252,183,44,307,150,135,173,260
"2011","Waltham Forest 024C","E01004438","Total",2025,234,47,187,1791,63,38,307,322,60,290,711
"2011","Waltham Forest 024D","E01004440","Total",2132,200,33,167,1932,73,68,415,364,93,300,619
"2011","Waltham Forest 024E","E01004441","Total",1608,188,40,148,1420,61,64,253,252,64,231,495
"2011","Waltham Forest 025A","E01004371","Total",1693,154,36,118,1539,59,62,276,228,83,253,578
"2011","Waltham Forest 025B","E01004373","Total",1779,171,44,127,1608,65,88,250,180,184,271,570
"2011","Waltham Forest 025C","E01004374","Total",1886,186,50,136,1700,46,96,322,238,140,305,553
"2011","Waltham Forest 025D","E01004375","Total",1848,154,47,107,1694,77,50,348,252,92,323,552
"2011","Waltham Forest 025E","E01004376","Total",1994,162,33,129,1832,58,72,224,178,80,400,820
"2011","Waltham Forest 026A","E01004336","Total",1691,146,31,115,1545,54,56,138,178,48,329,742
"2011","Waltham Forest 026B","E01004428","Total",1763,198,52,146,1565,240,84,291,146,180,299,325
"2011","Waltham Forest 026C","E01004429","Total",1772,186,38,148,1586,159,68,236,220,95,352,456
"2011","Waltham Forest 026D","E01004430","Total",2200,247,35,212,1953,83,66,302,310,106,306,780
"2011","Waltham Forest 026E","E01004434","Total",2045,232,72,160,1813,195,74,301,176,169,406,492
"2011","Waltham Forest 027A","E01004335","Total",1843,177,33,144,1666,301,50,251,154,271,305,334
"2011","Waltham Forest 027B","E01004337","Total",1966,219,73,146,1747,128,74,305,154,179,421,486
"2011","Waltham Forest 027C","E01004338","Total",1771,130,25,105,1641,50,42,215,184,87,366,697
"2011","Waltham Forest 027D","E01004339","Total",1811,184,26,158,1627,107,32,414,248,124,271,431
"2011","Waltham Forest 027E","E01004340","Total",1831,221,58,163,1610,175,68,241,200,123,314,489
"2011","Waltham Forest 027F","E01004341","Total",1757,238,90,148,1519,126,58,217,162,169,372,415
"2011","Waltham Forest 028A","E01004327","Total",1213,140,53,87,1073,65,94,204,138,65,179,328
"2011","Waltham Forest 028B","E01004328","Total",1836,172,30,142,1664,102,76,305,232,118,300,531
"2011","Waltham Forest 028C","E01004329","Total",1923,178,32,146,1745,135,54,301,188,100,431,536
"2011","Waltham Forest 028D","E01004330","Total",1834,134,39,95,1700,79,92,306,178,122,339,584
"2011","Waltham Forest 028E","E01004331","Total",1841,201,53,148,1640,141,72,335,176,141,314,461
"2011","Waltham Forest 028F","E01004332","Total",1824,164,33,131,1660,113,58,286,208,156,341,498
"2011","Bracknell Forest 001C","E01016252","Total",1410,221,84,137,1189,55,198,221,298,67,110,240
"2011","Bracknell Forest 001D","E01016253","Total",1395,102,27,75,1293,58,128,478,184,71,212,162
"2011","Bracknell Forest 001E","E01032727","Total",3000,364,219,145,2636,64,570,798,458,187,238,321
"2011","Bracknell Forest 002A","E01016184","Total",2135,202,56,146,1933,133,144,550,490,94,220,302
"2011","Bracknell Forest 002B","E01016185","Total",1284,213,63,150,1071,62,62,298,346,70,85,148
"2011","Bracknell Forest 002C","E01016186","Total",1825,171,77,94,1654,80,218,421,278,120,170,367
"2011","Bracknell Forest 002D","E01016187","Total",1636,162,66,96,1474,45,154,465,316,109,118,267
"2011","Bracknell Forest 002E","E01016188","Total",1684,146,28,118,1538,70,80,632,344,131,120,161
"2011","Bracknell Forest 003A","E01016190","Total",1534,145,75,70,1389,87,206,298,196,85,247,270
"2011","Bracknell Forest 003B","E01016238","Total",1171,121,83,38,1050,48,144,167,216,93,129,253
"2011","Bracknell Forest 003C","E01016243","Total",1498,144,25,119,1354,60,62,612,282,50,120,168
"2011","Bracknell Forest 003D","E01016245","Total",2359,162,39,123,2197,75,110,833,444,127,298,310
"2011","Bracknell Forest 003E","E01016246","Total",1584,133,23,110,1451,66,60,617,280,76,183,169
"2011","Bracknell Forest 003F","E01016247","Total",1654,174,23,151,1480,78,68,574,392,81,100,187
"2011","Bracknell Forest 004A","E01016239","Total",1490,161,81,80,1329,87,178,247,232,92,185,308
"2011","Bracknell Forest 004B","E01016240","Total",1535,200,80,120,1335,123,116,380,222,60,158,276
"2011","Bracknell Forest 004C","E01016241","Total",1616,184,84,100,1432,126,154,326,210,171,163,282
"2011","Bracknell Forest 004D","E01016242","Total",1728,307,82,225,1421,180,112,391,292,75,118,253
"2011","Bracknell Forest 005A","E01016180","Total",1288,174,82,92,1114,81,160,266,208,77,161,161
"2011","Bracknell Forest 005B","E01016181","Total",1233,155,75,80,1078,51,168,236,240,46,119,218
"2011","Bracknell Forest 005C","E01016182","Total",1520,155,64,91,1365,93,190,404,212,94,141,231
"2011","Bracknell Forest 005D","E01016183","Total",1279,135,62,73,1144,76,112,427,166,50,83,230
"2011","Bracknell Forest 005E","E01016222","Total",1269,100,15,85,1169,29,66,393,278,35,120,248
"2011","Bracknell Forest 006B","E01016191","Total",1660,159,89,70,1501,77,206,405,190,81,209,333
"2011","Bracknell Forest 006C","E01016223","Total",1434,239,52,187,1195,92,104,310,254,71,144,220
"2011","Bracknell Forest 006D","E01016224","Total",1734,240,77,163,1494,203,120,438,278,106,113,236
"2011","Bracknell Forest 006E","E01016226","Total",1361,230,108,122,1131,79,118,280,246,56,108,244
"2011","Bracknell Forest 006F","E01032724","Total",1343,254,73,181,1089,176,98,230,224,53,101,207
"2011","Bracknell Forest 006G","E01032728","Total",1392,248,96,152,1144,79,78,282,266,46,146,247
"2011","Bracknell Forest 007A","E01016225","Total",2164,231,52,179,1933,187,172,531,370,115,262,296
"2011","Bracknell Forest 007B","E01016233","Total",2307,382,83,299,1925,229,110,480,404,207,206,289
"2011","Bracknell Forest 007C","E01016248","Total",1485,155,81,74,1330,79,118,282,172,90,272,317
"2011","Bracknell Forest 007D","E01016249","Total",1467,409,114,295,1058,126,104,242,276,65,71,174
"2011","Bracknell Forest 007E","E01016250","Total",1601,259,106,153,1342,93,178,275,216,111,152,317
"2011","Bracknell Forest 008A","E01016200","Total",1351,162,12,150,1189,71,48,379,268,67,135,221
"2011","Bracknell Forest 008B","E01016201","Total",1344,151,14,137,1193,54,52,359,316,49,121,242
"2011","Bracknell Forest 008C","E01016202","Total",1191,270,22,248,921,45,26,303,402,15,38,92
"2011","Bracknell Forest 008D","E01016203","Total",1311,216,96,120,1095,106,86,307,228,57,95,216
"2011","Bracknell Forest 008E","E01016204","Total",1212,127,37,90,1085,59,42,314,196,63,123,288
"2011","Bracknell Forest 009A","E01016209","Total",1491,88,44,44,1403,87,156,301,232,79,222,326
"2011","Bracknell Forest 009B","E01016210","Total",1224,115,38,77,1109,145,86,267,178,74,132,227
"2011","Bracknell Forest 009D","E01016213","Total",1143,74,30,44,1069,47,90,266,190,60,141,275
"2011","Bracknell Forest 009E","E01016214","Total",1374,65,32,33,1309,12,186,266,246,79,187,333
"2011","Bracknell Forest 009F","E01016215","Total",1255,112,40,72,1143,97,76,323,200,82,180,185
"2011","Bracknell Forest 009G","E01032725","Total",1585,104,8,96,1481,158,36,511,366,148,126,136
"2011","Bracknell Forest 009H","E01032726","Total",1421,128,55,73,1293,106,86,346,232,100,175,248
"2011","Bracknell Forest 010A","E01016205","Total",1327,153,43,110,1174,41,82,289,252,87,161,262
"2011","Bracknell Forest 010B","E01016217","Total",1404,152,33,119,1252,51,102,352,282,101,128,236
"2011","Bracknell Forest 010C","E01016218","Total",1375,235,99,136,1140,82,90,278,280,75,91,244
"2011","Bracknell Forest 010D","E01016231","Total",1894,191,60,131,1703,122,152,437,322,89,280,301
"2011","Bracknell Forest 010E","E01016232","Total",1404,177,59,118,1227,74,162,330,238,57,165,201
"2011","Bracknell Forest 011A","E01016212","Total",1301,99,24,75,1202,112,82,331,190,99,142,246
"2011","Bracknell Forest 011B","E01016216","Total",1296,178,47,131,1118,69,122,271,236,106,125,189
"2011","Bracknell Forest 011C","E01016219","Total",1341,124,63,61,1217,56,166,248,220,56,146,325
"2011","Bracknell Forest 011D","E01016220","Total",1363,190,44,146,1173,114,44,363,232,114,106,200
"2011","Bracknell Forest 011E","E01016221","Total",1264,198,63,135,1066,67,88,294,260,52,96,209
"2011","Bracknell Forest 012A","E01016206","Total",1763,197,85,112,1566,62,302,352,278,110,178,284
"2011","Bracknell Forest 012B","E01016208","Total",1874,305,138,167,1569,48,196,416,302,87,212,308
"2011","Bracknell Forest 012C","E01016229","Total",1177,144,92,52,1033,38,128,243,186,68,133,237
"2011","Bracknell Forest 012D","E01016230","Total",1040,156,64,92,884,18,72,258,202,83,73,178
"2011","Bracknell Forest 013A","E01016207","Total",1413,102,39,63,1311,72,96,409,170,98,217,249
"2011","Bracknell Forest 013B","E01016234","Total",1150,84,28,56,1066,32,108,264,242,45,138,237
"2011","Bracknell Forest 013C","E01016235","Total",1339,78,19,59,1261,51,98,333,212,57,173,337
"2011","Bracknell Forest 013D","E01016236","Total",1436,152,51,101,1284,134,86,331,238,74,174,247
"2011","Bracknell Forest 013E","E01016237","Total",1191,99,20,79,1092,49,82,344,240,55,126,196
"2011","Bracknell Forest 014A","E01016192","Total",1364,226,103,123,1138,48,136,362,194,94,101,203
"2011","Bracknell Forest 014B","E01016194","Total",1251,95,51,44,1156,18,224,276,236,60,103,239
"2011","Bracknell Forest 014C","E01016195","Total",1137,130,17,113,1007,66,46,334,234,56,112,159
"2011","Bracknell Forest 014D","E01016227","Total",1287,75,40,35,1212,40,144,328,220,90,173,217
"2011","Bracknell Forest 014E","E01016228","Total",1474,113,62,51,1361,33,178,386,234,68,162,300
"2011","Bracknell Forest 015A","E01016193","Total",1228,173,40,133,1055,58,46,285,244,41,174,207
"2011","Bracknell Forest 015B","E01016196","Total",1656,72,20,52,1584,71,70,610,224,138,251,220
"2011","Bracknell Forest 015C","E01016197","Total",1344,112,48,64,1232,96,118,285,182,70,176,305
"2011","Bracknell Forest 015D","E01016198","Total",1200,162,99,63,1038,31,114,268,212,68,117,228
"2011","Bracknell Forest 015E","E01016199","Total",1242,86,25,61,1156,38,108,274,224,79,139,294
"2011","Brighton and Hove 001A","E01016924","Total",1501,138,88,50,1363,54,178,399,174,111,168,279
"2011","Brighton and Hove 001B","E01016926","Total",1530,139,66,73,1391,162,124,367,182,109,158,289
"2011","Brighton and Hove 001C","E01016927","Total",1548,162,77,85,1386,84,134,351,234,105,170,308
"2011","Brighton and Hove 001D","E01016929","Total",1587,163,98,65,1424,85,154,397,234,92,130,332
"2011","Brighton and Hove 001E","E01016931","Total",1513,169,99,70,1344,55,208,359,228,73,109,312
"2011","Brighton and Hove 002A","E01016898","Total",1873,241,133,108,1632,115,166,260,210,83,243,555
"2011","Brighton and Hove 002B","E01016899","Total",1028,115,49,66,913,30,104,211,128,35,103,302
"2011","Brighton and Hove 002C","E01016914","Total",1483,108,25,83,1375,165,70,152,160,105,237,486
"2011","Brighton and Hove 002D","E01016915","Total",1544,106,45,61,1438,140,72,184,96,141,300,505
"2011","Brighton and Hove 003A","E01016923","Total",1557,241,147,94,1316,71,164,286,202,147,173,273
"2011","Brighton and Hove 003B","E01016928","Total",1596,151,90,61,1445,89,284,348,210,100,146,268
"2011","Brighton and Hove 003C","E01016998","Total",1504,119,76,43,1385,52,212,419,194,103,167,238
"2011","Brighton and Hove 003D","E01016999","Total",1410,124,74,50,1286,31,214,280,222,55,164,320
"2011","Brighton and Hove 003E","E01017000","Total",1711,357,199,158,1354,105,202,345,296,96,94,216
"2011","Brighton and Hove 004A","E01016925","Total",1520,164,66,98,1356,73,136,320,216,97,210,304
"2011","Brighton and Hove 004B","E01016930","Total",1843,179,99,80,1664,62,260,405,300,109,148,380
"2011","Brighton and Hove 004C","E01017001","Total",1504,140,100,40,1364,57,218,266,204,153,168,298
"2011","Brighton and Hove 004D","E01017003","Total",1636,191,72,119,1445,83,138,438,230,119,158,279
"2011","Brighton and Hove 005A","E01016916","Total",1457,143,85,58,1314,54,266,324,204,83,122,261
"2011","Brighton and Hove 005B","E01016917","Total",1368,123,58,65,1245,89,190,279,256,36,125,270
"2011","Brighton and Hove 005C","E01016918","Total",1425,186,102,84,1239,106,142,271,164,83,223,250
"2011","Brighton and Hove 005D","E01016919","Total",1379,131,38,93,1248,102,74,324,232,80,169,267
"2011","Brighton and Hove 005E","E01016920","Total",1571,151,64,87,1420,136,112,443,266,76,142,245
"2011","Brighton and Hove 006A","E01016882","Total",1454,166,92,74,1288,143,200,315,230,92,92,216
"2011","Brighton and Hove 006B","E01016883","Total",1455,179,128,51,1276,50,368,261,208,21,131,237
"2011","Brighton and Hove 006C","E01016884","Total",1594,162,92,70,1432,77,180,320,158,119,219,359
"2011","Brighton and Hove 006D","E01016885","Total",1370,231,74,157,1139,196,92,304,190,104,115,138
"2011","Brighton and Hove 006E","E01016886","Total",1557,194,126,68,1363,65,158,306,164,100,256,314
"2011","Brighton and Hove 007A","E01016980","Total",1480,140,65,75,1340,49,120,365,192,107,231,276
"2011","Brighton and Hove 007B","E01016982","Total",1302,103,74,29,1199,36,160,354,154,101,151,243
"2011","Brighton and Hove 007C","E01016983","Total",1387,112,62,50,1275,35,214,249,166,81,219,311
"2011","Brighton and Hove 007D","E01016984","Total",1475,119,75,44,1356,41,232,330,184,78,201,290
"2011","Brighton and Hove 007E","E01016985","Total",1580,154,64,90,1426,96,138,367,254,147,165,259
"2011","Brighton and Hove 008A","E01016900","Total",1544,346,132,214,1198,263,100,223,188,81,69,274
"2011","Brighton and Hove 008B","E01016902","Total",1501,122,42,80,1379,138,172,312,188,85,122,362
"2011","Brighton and Hove 008C","E01016904","Total",1589,236,76,160,1353,268,66,279,194,78,153,315
"2011","Brighton and Hove 008D","E01016905","Total",1712,358,137,221,1354,129,114,298,236,58,84,435
"2011","Brighton and Hove 008E","E01016909","Total",1891,149,76,73,1742,136,124,169,158,76,214,865
"2011","Brighton and Hove 009A","E01016906","Total",1610,146,64,82,1464,161,106,280,166,92,269,390
"2011","Brighton and Hove 009B","E01016907","Total",1811,119,68,51,1692,73,110,110,130,106,240,923
"2011","Brighton and Hove 009C","E01016908","Total",1535,158,60,98,1377,185,80,267,146,180,190,329
"2011","Brighton and Hove 009D","E01016910","Total",1527,125,65,60,1402,196,50,235,150,80,187,504
"2011","Brighton and Hove 009E","E01016911","Total",1503,106,44,62,1397,116,144,204,150,77,218,488
"2011","Brighton and Hove 010A","E01016901","Total",1661,136,55,81,1525,108,106,449,194,78,174,416
"2011","Brighton and Hove 010B","E01016903","Total",1961,134,35,99,1827,161,76,410,238,91,165,686
"2011","Brighton and Hove 010C","E01016934","Total",1404,137,44,93,1267,36,66,462,170,128,157,248
"2011","Brighton and Hove 010D","E01016939","Total",1631,126,44,82,1505,88,96,557,212,161,124,267
"2011","Brighton and Hove 010E","E01016940","Total",1659,138,30,108,1521,55,40,554,278,153,123,318
"2011","Brighton and Hove 011A","E01016981","Total",1594,167,86,81,1427,55,264,334,194,147,136,297
"2011","Brighton and Hove 011B","E01017002","Total",1677,259,119,140,1418,61,174,383,352,89,114,245
"2011","Brighton and Hove 011C","E01017004","Total",1663,313,89,224,1350,107,86,358,288,101,157,253
"2011","Brighton and Hove 011D","E01017005","Total",1695,220,55,165,1475,68,72,467,336,160,153,219
"2011","Brighton and Hove 011E","E01017006","Total",1572,283,61,222,1289,83,98,398,412,52,61,185
"2011","Brighton and Hove 012A","E01016921","Total",1553,177,63,114,1376,134,106,333,234,101,168,300
"2011","Brighton and Hove 012B","E01016922","Total",1278,130,61,69,1148,116,120,311,168,65,106,262
"2011","Brighton and Hove 012C","E01016973","Total",1528,178,110,68,1350,157,154,355,240,89,136,219
"2011","Brighton and Hove 012D","E01016977","Total",1503,172,91,81,1331,120,142,301,202,59,208,299
"2011","Brighton and Hove 012E","E01016978","Total",1589,250,101,149,1339,147,110,311,272,161,115,223
"2011","Brighton and Hove 013A","E01016879","Total",1482,131,67,64,1351,91,98,342,188,100,227,305
"2011","Brighton and Hove 013B","E01016880","Total",1357,111,46,65,1246,187,92,236,118,146,180,287
"2011","Brighton and Hove 013C","E01016881","Total",1510,181,97,84,1329,117,106,323,186,133,219,245
"2011","Brighton and Hove 013D","E01016887","Total",1425,190,100,90,1235,90,186,305,196,54,143,261
"2011","Brighton and Hove 013E","E01016888","Total",1472,173,127,46,1299,59,140,324,176,138,206,256
"2011","Brighton and Hove 013F","E01016976","Total",1654,135,81,54,1519,76,194,284,206,112,270,377
"2011","Brighton and Hove 014A","E01016932","Total",1620,240,63,177,1380,72,74,426,260,113,143,292
"2011","Brighton and Hove 014B","E01016933","Total",1421,214,57,157,1207,65,68,295,336,77,135,231
"2011","Brighton and Hove 014C","E01016935","Total",1574,354,157,197,1220,92,124,307,362,58,86,191
"2011","Brighton and Hove 014D","E01016936","Total",1634,211,25,186,1423,75,54,422,318,72,91,391
"2011","Brighton and Hove 014E","E01016937","Total",2002,440,56,384,1562,101,34,254,624,47,59,443
"2011","Brighton and Hove 015A","E01016890","Total",1744,289,29,260,1455,79,44,213,376,23,60,660
"2011","Brighton and Hove 015B","E01016966","Total",1792,277,91,186,1515,97,48,225,306,28,56,755
"2011","Brighton and Hove 015C","E01016970","Total",1636,220,53,167,1416,101,74,331,288,71,72,479
"2011","Brighton and Hove 015D","E01016971","Total",1954,261,24,237,1693,60,24,188,290,26,82,1023
"2011","Brighton and Hove 015E","E01016972","Total",1844,281,49,232,1563,96,48,290,398,68,96,567
"2011","Brighton and Hove 016A","E01016979","Total",1642,144,59,85,1498,109,96,513,230,84,170,296
"2011","Brighton and Hove 016B","E01016990","Total",1678,249,85,164,1429,180,62,497,324,78,87,201
"2011","Brighton and Hove 016C","E01016991","Total",1737,263,58,205,1474,158,64,465,400,62,95,230
"2011","Brighton and Hove 016D","E01016996","Total",1663,203,74,129,1460,115,88,579,300,87,84,207
"2011","Brighton and Hove 017A","E01017007","Total",1622,183,105,78,1439,190,168,310,156,108,186,321
"2011","Brighton and Hove 017B","E01017008","Total",1635,177,110,67,1458,84,274,233,238,92,153,384
"2011","Brighton and Hove 017C","E01017009","Total",1534,148,88,60,1386,95,210,284,222,102,159,314
"2011","Brighton and Hove 017D","E01017010","Total",1782,144,96,48,1638,105,258,307,240,129,210,389
"2011","Brighton and Hove 017E","E01017011","Total",1408,105,62,43,1303,158,140,217,168,131,219,270
"2011","Brighton and Hove 017F","E01017012","Total",1802,160,97,63,1642,119,230,427,264,88,202,312
"2011","Brighton and Hove 018A","E01016892","Total",1722,141,41,100,1581,124,78,383,218,108,94,576
"2011","Brighton and Hove 018B","E01016893","Total",1895,211,56,155,1684,90,68,451,372,45,113,545
"2011","Brighton and Hove 018C","E01016912","Total",1888,249,44,205,1639,100,52,270,358,21,81,757
"2011","Brighton and Hove 018D","E01016913","Total",1745,105,31,74,1640,82,92,181,230,21,93,941
"2011","Brighton and Hove 018E","E01016946","Total",1484,191,72,119,1293,94,88,387,222,60,107,335
"2011","Brighton and Hove 019A","E01016860","Total",1521,341,71,270,1180,110,82,272,410,51,59,196
"2011","Brighton and Hove 019B","E01016871","Total",1785,552,194,358,1233,121,142,199,480,22,29,240
"2011","Brighton and Hove 019C","E01016872","Total",1826,433,51,382,1393,106,52,334,482,42,67,310
"2011","Brighton and Hove 019D","E01016873","Total",1698,522,140,382,1176,60,52,296,536,17,4,211
"2011","Brighton and Hove 019E","E01016878","Total",1777,353,138,215,1424,84,90,366,436,112,81,255
"2011","Brighton and Hove 020A","E01016870","Total",1562,231,33,198,1331,104,58,342,336,77,142,272
"2011","Brighton and Hove 020B","E01016874","Total",1789,538,220,318,1251,96,148,359,440,26,40,142
"2011","Brighton and Hove 020C","E01016875","Total",1578,149,37,112,1429,45,52,461,276,132,166,297
"2011","Brighton and Hove 020D","E01016876","Total",1582,363,106,257,1219,82,72,296,394,63,35,277
"2011","Brighton and Hove 020E","E01016877","Total",1729,399,130,269,1330,111,132,296,476,40,92,183
"2011","Brighton and Hove 021A","E01016974","Total",1631,227,86,141,1404,124,96,427,248,76,143,290
"2011","Brighton and Hove 021B","E01016975","Total",1516,145,55,90,1371,117,112,350,214,118,207,253
"2011","Brighton and Hove 021C","E01016992","Total",1587,197,111,86,1390,52,150,474,224,95,121,274
"2011","Brighton and Hove 021D","E01016994","Total",1650,242,66,176,1408,131,88,438,288,94,97,272
"2011","Brighton and Hove 021E","E01016997","Total",1557,182,82,100,1375,46,116,483,218,117,111,284
"2011","Brighton and Hove 022A","E01016889","Total",1865,265,80,185,1600,65,70,348,290,47,50,730
"2011","Brighton and Hove 022B","E01016891","Total",1770,328,64,264,1442,109,60,237,346,48,71,571
"2011","Brighton and Hove 022C","E01016894","Total",1649,229,55,174,1420,132,52,223,338,21,101,553
"2011","Brighton and Hove 022D","E01016896","Total",1767,176,37,139,1591,82,26,409,350,46,49,629
"2011","Brighton and Hove 022E","E01016897","Total",1781,238,59,179,1543,98,68,454,380,45,62,436
"2011","Brighton and Hove 023A","E01016987","Total",1731,273,99,174,1458,73,128,398,306,128,132,293
"2011","Brighton and Hove 023B","E01016989","Total",1508,321,114,207,1187,62,124,302,304,66,86,243
"2011","Brighton and Hove 023C","E01016993","Total",1434,359,179,180,1075,100,162,321,222,37,72,161
"2011","Brighton and Hove 023D","E01016995","Total",1657,164,78,86,1493,54,162,454,234,142,192,255
"2011","Brighton and Hove 024A","E01016938","Total",1772,374,58,316,1398,87,54,293,576,35,75,278
"2011","Brighton and Hove 024B","E01016950","Total",1709,516,126,390,1193,76,74,203,658,41,9,132
"2011","Brighton and Hove 024C","E01016951","Total",1420,496,101,395,924,50,60,154,482,31,34,113
"2011","Brighton and Hove 024D","E01016967","Total",1921,551,43,508,1370,75,52,205,692,25,39,282
"2011","Brighton and Hove 024E","E01016968","Total",1585,462,44,418,1123,52,12,190,604,20,12,233
"2011","Brighton and Hove 025A","E01016864","Total",1446,155,80,75,1291,101,208,205,170,120,177,310
"2011","Brighton and Hove 025B","E01016865","Total",1578,136,44,92,1442,218,70,333,148,162,213,298
"2011","Brighton and Hove 025C","E01016866","Total",1466,141,47,94,1325,180,84,222,132,183,245,279
"2011","Brighton and Hove 025D","E01016867","Total",1450,265,75,190,1185,208,74,284,194,66,140,219
"2011","Brighton and Hove 025E","E01016868","Total",1548,304,92,212,1244,243,74,215,170,98,227,217
"2011","Brighton and Hove 025F","E01016895","Total",1558,150,63,87,1408,140,130,232,192,158,286,270
"2011","Brighton and Hove 026A","E01016849","Total",1539,442,82,360,1097,54,70,198,512,15,32,216
"2011","Brighton and Hove 026B","E01016852","Total",1593,505,64,441,1088,63,38,186,598,15,0,188
"2011","Brighton and Hove 026C","E01016853","Total",1872,557,104,453,1315,101,48,260,690,15,24,177
"2011","Brighton and Hove 026D","E01016855","Total",1717,502,75,427,1215,70,38,223,702,15,32,135
"2011","Brighton and Hove 026E","E01016856","Total",1608,559,204,355,1049,45,90,220,434,5,31,224
"2011","Brighton and Hove 027A","E01016952","Total",1550,345,37,308,1205,59,36,115,506,6,37,446
"2011","Brighton and Hove 027B","E01016953","Total",1618,389,75,314,1229,56,98,218,494,26,31,306
"2011","Brighton and Hove 027C","E01016964","Total",2069,474,83,391,1595,97,70,175,450,28,60,715
"2011","Brighton and Hove 027E","E01016969","Total",2018,443,133,310,1575,126,68,204,586,26,46,519
"2011","Brighton and Hove 027F","E01033328","Total",1451,286,70,216,1165,57,48,178,418,42,56,366
"2011","Brighton and Hove 027G","E01033329","Total",1706,269,16,253,1437,111,42,303,470,15,36,460
"2011","Brighton and Hove 028A","E01016857","Total",1440,395,83,312,1045,64,100,210,426,30,61,154
"2011","Brighton and Hove 028B","E01016858","Total",1410,475,89,386,935,61,90,183,478,25,19,79
"2011","Brighton and Hove 028C","E01016859","Total",1442,483,198,285,959,46,190,181,374,5,15,148
"2011","Brighton and Hove 028D","E01016986","Total",1514,404,136,268,1110,77,156,266,364,21,48,178
"2011","Brighton and Hove 028E","E01016988","Total",1417,363,121,242,1054,66,76,311,282,75,78,166
"2011","Brighton and Hove 029A","E01016850","Total",1739,384,61,323,1355,87,42,181,572,22,53,398
"2011","Brighton and Hove 029B","E01016851","Total",1709,480,78,402,1229,58,38,231,644,5,36,217
"2011","Brighton and Hove 029C","E01016854","Total",1620,531,60,471,1089,127,38,154,596,0,24,150
"2011","Brighton and Hove 029D","E01016954","Total",1783,606,78,528,1177,42,56,163,696,21,23,176
"2011","Brighton and Hove 029E","E01016955","Total",1728,548,76,472,1180,67,74,122,588,15,13,301
"2011","Brighton and Hove 030A","E01016941","Total",1905,574,134,440,1331,58,108,106,620,5,65,369
"2011","Brighton and Hove 030B","E01016945","Total",1603,553,66,487,1050,66,26,57,574,15,21,291
"2011","Brighton and Hove 030C","E01016947","Total",1607,458,103,355,1149,183,84,185,366,25,60,246
"2011","Brighton and Hove 030D","E01016948","Total",1775,273,52,221,1502,183,76,321,328,68,132,394
"2011","Brighton and Hove 030E","E01016949","Total",1678,489,166,323,1189,89,94,218,328,25,46,389
"2011","Brighton and Hove 031A","E01016861","Total",1593,416,59,357,1177,43,104,199,596,11,58,166
"2011","Brighton and Hove 031B","E01016862","Total",1508,408,144,264,1100,35,86,212,474,21,39,233
"2011","Brighton and Hove 031C","E01016942","Total",1516,807,527,280,709,47,244,66,204,16,29,103
"2011","Brighton and Hove 031D","E01016943","Total",1585,224,47,177,1361,128,46,391,334,79,82,301
"2011","Brighton and Hove 031E","E01016944","Total",1514,445,53,392,1069,45,42,159,470,30,52,271
"2011","Brighton and Hove 032A","E01016863","Total",1579,488,174,314,1091,154,130,193,340,5,61,208
"2011","Brighton and Hove 032B","E01016869","Total",1788,281,106,175,1507,116,146,298,344,83,112,408
"2011","Brighton and Hove 032C","E01016957","Total",1504,453,124,329,1051,58,158,135,444,32,44,180
"2011","Brighton and Hove 032D","E01016963","Total",1906,374,111,263,1532,106,128,337,522,60,65,314
"2011","Brighton and Hove 033A","E01016956","Total",1555,232,133,99,1323,93,244,281,280,61,123,241
"2011","Brighton and Hove 033B","E01016958","Total",1728,271,173,98,1457,78,318,346,310,68,68,269
"2011","Brighton and Hove 033C","E01016959","Total",1404,185,111,74,1219,34,244,242,236,67,129,267
"2011","Brighton and Hove 033D","E01016960","Total",1707,307,175,132,1400,123,272,288,280,92,156,189
"2011","Brighton and Hove 033E","E01016961","Total",1723,271,101,170,1452,63,206,411,320,30,133,289
"2011","Brighton and Hove 033F","E01016962","Total",1644,201,118,83,1443,56,304,347,280,66,125,265
"2011","Isle of Wight 001A","E01017300","Total",2193,576,286,290,1617,93,362,271,426,138,111,216
"2011","Isle of Wight 001B","E01017303","Total",1204,192,68,124,1012,39,104,252,252,63,109,193
"2011","Isle of Wight 001C","E01017305","Total",1346,269,80,189,1077,107,94,287,254,91,99,145
"2011","Isle of Wight 001D","E01017306","Total",1350,148,47,101,1202,111,116,284,216,99,180,196
"2011","Isle of Wight 001E","E01017309","Total",1642,218,75,143,1424,103,144,436,284,99,144,214
"2011","Isle of Wight 002A","E01017301","Total",1037,158,107,51,879,29,276,192,120,50,83,129
"2011","Isle of Wight 002B","E01017302","Total",1720,144,66,78,1576,68,244,418,240,175,146,285
"2011","Isle of Wight 002C","E01017304","Total",1398,148,69,79,1250,104,104,369,220,83,131,239
"2011","Isle of Wight 002D","E01017316","Total",1677,315,170,145,1362,68,292,306,282,48,151,215
"2011","Isle of Wight 002E","E01017329","Total",2304,237,167,70,2067,56,438,454,360,98,280,381
"2011","Isle of Wight 003A","E01017307","Total",1932,263,137,126,1669,86,440,284,376,74,160,249
"2011","Isle of Wight 003B","E01017308","Total",1700,224,111,113,1476,129,178,308,294,116,179,272
"2011","Isle of Wight 003D","E01033229","Total",1373,209,126,83,1164,41,294,221,248,62,115,183
"2011","Isle of Wight 003E","E01033237","Total",1329,167,82,85,1162,124,138,264,190,114,151,181
"2011","Isle of Wight 004A","E01017335","Total",1478,360,137,223,1118,106,128,276,256,45,116,191
"2011","Isle of Wight 004B","E01017336","Total",1499,424,101,323,1075,151,114,209,338,16,89,158
"2011","Isle of Wight 004C","E01017337","Total",1507,381,110,271,1126,85,142,229,302,64,121,183
"2011","Isle of Wight 004D","E01017346","Total",1441,324,100,224,1117,114,148,273,268,47,80,187
"2011","Isle of Wight 005A","E01017286","Total",1506,184,116,68,1322,28,396,217,260,57,137,227
"2011","Isle of Wight 005B","E01017287","Total",1648,220,136,84,1428,69,292,308,292,77,133,257
"2011","Isle of Wight 005C","E01017367","Total",1839,252,178,74,1587,37,480,263,302,62,187,256
"2011","Isle of Wight 005D","E01017368","Total",1546,254,155,99,1292,65,238,302,244,129,131,183
"2011","Isle of Wight 006A","E01017282","Total",1404,162,79,83,1242,107,172,253,218,86,164,242
"2011","Isle of Wight 006B","E01017283","Total",1519,196,92,104,1323,68,224,307,252,63,165,244
"2011","Isle of Wight 006C","E01017338","Total",1315,221,131,90,1094,76,250,212,182,45,112,217
"2011","Isle of Wight 006D","E01017341","Total",1532,187,100,87,1345,105,244,369,202,69,148,208
"2011","Isle of Wight 006E","E01017342","Total",1691,211,83,128,1480,175,186,350,252,127,166,224
"2011","Isle of Wight 007A","E01017339","Total",1634,185,83,102,1449,92,174,409,226,76,200,272
"2011","Isle of Wight 007B","E01017340","Total",1776,291,122,169,1485,198,126,439,230,90,171,231
"2011","Isle of Wight 007C","E01017343","Total",1307,201,92,109,1106,71,126,299,188,82,137,203
"2011","Isle of Wight 007D","E01017344","Total",1608,214,119,95,1394,48,312,273,282,81,126,272
"2011","Isle of Wight 007E","E01017345","Total",1980,241,55,186,1739,296,136,379,322,236,179,191
"2011","Isle of Wight 008A","E01017310","Total",1231,140,97,43,1091,26,210,147,200,61,203,244
"2011","Isle of Wight 008B","E01017311","Total",1510,239,93,146,1271,102,216,271,306,44,96,236
"2011","Isle of Wight 008C","E01017331","Total",1434,251,116,135,1183,147,180,235,206,98,114,203
"2011","Isle of Wight 008D","E01017332","Total",1272,163,82,81,1109,83,138,248,154,132,123,231
"2011","Isle of Wight 008E","E01017334","Total",1212,105,40,65,1107,44,138,252,204,112,125,232
"2011","Isle of Wight 009A","E01017295","Total",1265,139,51,88,1126,102,134,319,218,69,90,194
"2011","Isle of Wight 009B","E01017325","Total",1305,232,102,130,1073,104,138,258,206,54,129,184
"2011","Isle of Wight 009C","E01017326","Total",1568,402,160,242,1166,182,136,234,312,47,104,151
"2011","Isle of Wight 009D","E01017328","Total",1416,264,86,178,1152,167,110,278,220,89,108,180
"2011","Isle of Wight 009E","E01017333","Total",1803,120,48,72,1683,101,152,446,218,130,269,367
"2011","Isle of Wight 010A","E01017284","Total",1638,262,175,87,1376,47,432,223,240,123,101,210
"2011","Isle of Wight 010B","E01017285","Total",1834,344,231,113,1490,52,498,186,244,71,143,296
"2011","Isle of Wight 010C","E01017288","Total",1213,221,124,97,992,24,220,197,222,56,104,169
"2011","Isle of Wight 010D","E01017351","Total",1401,250,136,114,1151,46,304,200,196,85,125,195
"2011","Isle of Wight 010E","E01017352","Total",1142,194,152,42,948,26,350,115,184,32,75,166
"2011","Isle of Wight 011A","E01017292","Total",1591,164,70,94,1427,135,206,286,242,63,193,302
"2011","Isle of Wight 011B","E01017293","Total",2017,161,87,74,1856,124,218,521,276,175,207,335
"2011","Isle of Wight 011C","E01017296","Total",1236,127,69,58,1109,42,232,209,208,32,131,255
"2011","Isle of Wight 011D","E01017321","Total",1127,128,81,47,999,40,220,170,186,40,118,225
"2011","Isle of Wight 011E","E01017322","Total",1493,176,85,91,1317,155,132,197,222,109,218,284
"2011","Isle of Wight 011F","E01017327","Total",1647,189,98,91,1458,117,192,318,240,136,189,266
"2011","Isle of Wight 012A","E01017312","Total",1539,310,163,147,1229,96,284,215,244,67,139,184
"2011","Isle of Wight 012D","E01017315","Total",1495,236,143,93,1259,77,298,232,166,88,189,209
"2011","Isle of Wight 012E","E01017354","Total",1185,226,141,85,959,63,268,152,202,67,93,114
"2011","Isle of Wight 012F","E01017361","Total",1310,194,129,65,1116,60,370,159,218,37,78,194
"2011","Isle of Wight 012G","E01017362","Total",1445,215,102,113,1230,95,248,230,230,70,108,249
"2011","Isle of Wight 012H","E01033239","Total",2269,383,257,126,1886,78,654,228,362,84,114,366
"2011","Isle of Wight 013A","E01017290","Total",1308,148,72,76,1160,29,298,180,266,42,114,231
"2011","Isle of Wight 013B","E01017291","Total",1157,178,134,44,979,31,316,134,188,41,87,182
"2011","Isle of Wight 013C","E01017294","Total",1573,167,77,90,1406,59,232,263,284,91,215,262
"2011","Isle of Wight 013D","E01017353","Total",1225,127,77,50,1098,27,246,191,274,58,126,176
"2011","Isle of Wight 014A","E01017289","Total",2031,252,141,111,1779,92,388,288,364,98,201,348
"2011","Isle of Wight 014B","E01017347","Total",1606,223,109,114,1383,93,282,281,246,102,112,267
"2011","Isle of Wight 014C","E01017348","Total",1296,168,67,101,1128,80,156,226,154,59,218,235
"2011","Isle of Wight 014D","E01017349","Total",2042,311,127,184,1731,161,244,357,354,64,260,291
"2011","Isle of Wight 014E","E01017350","Total",1896,219,84,135,1677,190,244,412,272,115,213,231
"2011","Isle of Wight 015A","E01017317","Total",1549,193,116,77,1356,106,250,267,228,51,187,267
"2011","Isle of Wight 015B","E01017320","Total",1091,202,157,45,889,32,298,139,166,37,52,165
"2011","Isle of Wight 015C","E01017323","Total",1158,114,65,49,1044,13,282,179,224,41,111,194
"2011","Isle of Wight 015D","E01017324","Total",1451,147,75,72,1304,63,242,236,284,85,117,277
"2011","Isle of Wight 015E","E01017355","Total",1518,177,102,75,1341,84,264,232,246,69,134,312
"2011","Isle of Wight 015F","E01017358","Total",1276,183,125,58,1093,53,328,147,148,62,131,224
"2011","Isle of Wight 016A","E01017318","Total",1186,158,72,86,1028,106,160,241,152,64,120,185
"2011","Isle of Wight 016B","E01017319","Total",1273,305,215,90,968,47,268,143,160,47,125,178
"2011","Isle of Wight 016C","E01017356","Total",1428,290,126,164,1138,126,154,197,224,66,155,216
"2011","Isle of Wight 016D","E01017357","Total",1476,214,128,86,1262,84,220,200,192,64,218,284
"2011","Isle of Wight 016E","E01017359","Total",1410,240,118,122,1170,44,294,180,258,31,139,224
"2011","Isle of Wight 016F","E01017360","Total",1575,346,130,216,1229,129,214,232,286,84,71,213
"2011","Isle of Wight 017A","E01017297","Total",1433,149,88,61,1284,63,260,254,228,69,179,231
"2011","Isle of Wight 017B","E01017298","Total",1502,189,133,56,1313,30,328,231,278,88,124,234
"2011","Isle of Wight 017C","E01017299","Total",1216,150,69,81,1066,52,232,163,220,36,130,233
"2011","Isle of Wight 017D","E01017369","Total",1459,171,102,69,1288,40,286,241,226,104,166,225
"2011","Isle of Wight 018A","E01017363","Total",1480,392,147,245,1088,137,162,190,278,51,87,183
"2011","Isle of Wight 018B","E01017364","Total",1463,282,116,166,1181,55,242,170,198,149,137,230
"2011","Isle of Wight 018C","E01017365","Total",1380,251,163,88,1129,19,460,132,202,33,76,207
"2011","Isle of Wight 018D","E01017366","Total",1469,170,74,96,1299,126,184,255,230,107,140,257
"2011","Isle of Wight 018E","E01017370","Total",1753,230,148,82,1523,76,360,278,272,46,155,336
"2011","Medway 001A","E01016070","Total",1652,230,108,122,1422,87,240,257,294,62,237,245
"2011","Medway 001B","E01016071","Total",1646,140,56,84,1506,98,150,280,290,162,279,247
"2011","Medway 001C","E01016072","Total",1288,136,61,75,1152,66,142,210,220,102,151,261
"2011","Medway 001D","E01016074","Total",1655,328,168,160,1327,55,344,207,302,72,137,210
"2011","Medway 002A","E01016142","Total",1273,97,43,54,1176,24,134,298,222,73,163,262
"2011","Medway 002B","E01016144","Total",1496,114,56,58,1382,45,180,244,254,111,197,351
"2011","Medway 002C","E01016145","Total",1346,78,25,53,1268,54,102,395,208,115,108,286
"2011","Medway 002D","E01016149","Total",1435,166,79,87,1269,92,142,291,206,116,193,229
"2011","Medway 003A","E01016073","Total",2023,162,79,83,1861,50,276,456,306,89,243,441
"2011","Medway 003B","E01016075","Total",1435,131,78,53,1304,43,220,304,212,82,174,269
"2011","Medway 003C","E01016076","Total",2406,188,87,101,2218,123,250,505,362,193,317,468
"2011","Medway 003D","E01016077","Total",1468,202,108,94,1266,78,182,275,234,68,201,228
"2011","Medway 003E","E01016143","Total",2346,247,79,168,2099,176,164,681,382,170,220,306
"2011","Medway 004A","E01016146","Total",2006,252,142,110,1754,137,228,434,326,84,246,299
"2011","Medway 004B","E01016147","Total",1867,172,102,70,1695,46,248,387,250,154,202,408
"2011","Medway 004C","E01016148","Total",1941,126,53,73,1815,58,224,477,300,108,258,390
"2011","Medway 005A","E01016133","Total",1372,103,64,39,1269,13,250,212,208,83,180,323
"2011","Medway 005B","E01016134","Total",1429,90,41,49,1339,65,152,292,206,118,205,301
"2011","Medway 005C","E01016138","Total",1514,124,78,46,1390,48,242,256,216,69,197,362
"2011","Medway 005D","E01016139","Total",1683,113,62,51,1570,73,162,375,220,135,263,342
"2011","Medway 006A","E01016135","Total",1509,160,73,87,1349,123,140,319,260,68,159,280
"2011","Medway 006B","E01016136","Total",1530,191,78,113,1339,157,112,333,212,105,166,254
"2011","Medway 006C","E01016137","Total",1553,152,39,113,1401,110,84,363,260,108,200,276
"2011","Medway 006D","E01016140","Total",1350,199,45,154,1151,86,76,243,294,89,156,207
"2011","Medway 006E","E01016141","Total",1678,256,81,175,1422,163,66,390,256,92,191,264
"2011","Medway 007A","E01016035","Total",1851,223,49,174,1628,226,52,365,268,88,279,350
"2011","Medway 007D","E01016112","Total",2847,271,42,229,2576,166,156,900,608,176,148,422
"2011","Medway 007E","E01032798","Total",2690,476,128,348,2214,171,140,691,484,141,239,348
"2011","Medway 008A","E01016151","Total",1610,126,55,71,1484,39,192,345,244,105,240,319
"2011","Medway 008B","E01016152","Total",1477,207,103,104,1270,118,172,233,166,89,153,339
"2011","Medway 008C","E01016153","Total",1433,205,89,116,1228,158,120,230,180,130,160,250
"2011","Medway 008D","E01016155","Total",1549,156,75,81,1393,132,176,290,196,74,174,351
"2011","Medway 009A","E01016033","Total",1145,167,54,113,978,111,94,205,124,103,137,204
"2011","Medway 009B","E01016036","Total",1841,205,48,157,1636,154,116,296,250,75,175,570
"2011","Medway 009C","E01016037","Total",1709,193,45,148,1516,188,66,302,228,58,207,467
"2011","Medway 009D","E01016039","Total",1669,225,54,171,1444,119,74,392,242,98,179,340
"2011","Medway 010A","E01016030","Total",1800,169,44,125,1631,204,108,426,238,126,270,259
"2011","Medway 010B","E01016032","Total",1326,103,40,63,1223,180,42,212,150,200,228,211
"2011","Medway 010C","E01016034","Total",2568,294,79,215,2274,146,164,604,402,187,375,396
"2011","Medway 010D","E01016038","Total",1512,142,63,79,1370,147,114,291,232,131,174,281
"2011","Medway 011A","E01016150","Total",1605,155,54,101,1450,152,70,343,200,174,230,281
"2011","Medway 011B","E01016154","Total",1606,205,65,140,1401,109,100,307,224,110,254,297
"2011","Medway 011C","E01016156","Total",1677,147,33,114,1530,153,96,503,254,130,115,279
"2011","Medway 011D","E01016157","Total",1958,179,85,94,1779,138,180,474,318,105,198,366
"2011","Medway 011E","E01016158","Total",2143,239,92,147,1904,120,192,506,352,186,242,306
"2011","Medway 012A","E01016031","Total",1743,381,126,255,1362,259,58,374,262,88,95,226
"2011","Medway 012B","E01016041","Total",1658,223,47,176,1435,133,100,339,312,93,158,300
"2011","Medway 012C","E01016045","Total",1651,165,46,119,1486,96,88,378,194,144,199,387
"2011","Medway 012D","E01016049","Total",1920,347,87,260,1573,225,80,357,322,100,206,283
"2011","Medway 013A","E01016040","Total",1761,197,64,133,1564,104,120,306,204,172,301,357
"2011","Medway 013B","E01016042","Total",1503,149,34,115,1354,151,76,376,190,133,168,260
"2011","Medway 013C","E01016043","Total",1407,157,83,74,1250,51,122,273,192,135,157,320
"2011","Medway 013D","E01016177","Total",1558,166,62,104,1392,133,116,374,198,93,141,337
"2011","Medway 013E","E01016178","Total",1469,138,58,80,1331,77,120,349,172,133,201,279
"2011","Medway 014A","E01016117","Total",1760,401,110,291,1359,181,50,267,354,124,115,268
"2011","Medway 014B","E01016129","Total",1924,367,58,309,1557,218,92,449,454,73,83,188
"2011","Medway 014C","E01016130","Total",1808,410,128,282,1398,81,166,279,384,71,143,274
"2011","Medway 014D","E01016131","Total",1727,305,173,132,1422,66,172,365,244,103,163,309
"2011","Medway 015A","E01016016","Total",1519,230,63,167,1289,85,84,287,238,105,194,296
"2011","Medway 015B","E01016017","Total",1571,345,72,273,1226,76,94,198,278,66,154,360
"2011","Medway 015C","E01016019","Total",1866,163,37,126,1703,155,52,417,224,153,389,313
"2011","Medway 015D","E01016110","Total",1819,469,98,371,1350,109,72,195,414,27,103,430
"2011","Medway 015E","E01016111","Total",1175,269,109,160,906,67,64,295,170,68,118,124
"2011","Medway 016A","E01016044","Total",1673,193,53,140,1480,147,86,356,256,90,217,328
"2011","Medway 016B","E01016046","Total",1528,197,49,148,1331,105,90,326,254,91,191,274
"2011","Medway 016C","E01016047","Total",1706,179,64,115,1527,105,64,410,240,160,180,368
"2011","Medway 016D","E01016048","Total",1695,204,66,138,1491,108,94,414,240,130,218,287
"2011","Medway 017A","E01016113","Total",1486,152,58,94,1334,70,162,315,214,91,166,316
"2011","Medway 017B","E01016114","Total",1550,206,57,149,1344,128,68,296,286,82,187,297
"2011","Medway 017C","E01016115","Total",1944,171,68,103,1773,189,170,445,296,155,239,279
"2011","Medway 017D","E01016118","Total",1741,224,75,149,1517,109,114,351,344,97,181,321
"2011","Medway 018A","E01016160","Total",1474,191,103,88,1283,100,178,273,132,88,175,337
"2011","Medway 018B","E01016161","Total",1543,317,179,138,1226,129,168,234,218,86,131,260
"2011","Medway 018C","E01016162","Total",1646,163,83,80,1483,78,160,335,244,121,232,313
"2011","Medway 018D","E01016163","Total",1331,103,56,47,1228,68,140,266,174,76,197,307
"2011","Medway 018E","E01016164","Total",1495,198,122,76,1297,117,202,256,188,105,165,264
"2011","Medway 018F","E01016165","Total",1300,125,72,53,1175,59,180,202,176,91,195,272
"2011","Medway 019A","E01016159","Total",1381,106,44,62,1275,216,110,293,142,101,176,237
"2011","Medway 019B","E01016174","Total",1348,130,45,85,1218,36,86,277,192,25,256,346
"2011","Medway 019C","E01016175","Total",1827,150,70,80,1677,50,238,361,250,98,272,408
"2011","Medway 019D","E01016179","Total",1381,92,57,35,1289,32,158,284,174,83,200,358
"2011","Medway 020A","E01016061","Total",1695,225,37,188,1470,141,66,356,246,119,213,329
"2011","Medway 020B","E01016063","Total",1633,314,99,215,1319,159,92,266,220,155,172,255
"2011","Medway 020C","E01016064","Total",1541,291,92,199,1250,173,108,247,212,148,142,220
"2011","Medway 020D","E01016069","Total",1808,280,38,242,1528,145,64,433,228,165,194,299
"2011","Medway 021A","E01016020","Total",1244,156,54,102,1088,75,90,314,174,95,122,218
"2011","Medway 021B","E01016021","Total",1494,167,63,104,1327,86,104,355,186,54,194,348
"2011","Medway 021C","E01016022","Total",1423,115,34,81,1308,82,72,271,160,113,216,394
"2011","Medway 021D","E01016125","Total",1742,155,46,109,1587,86,126,363,238,86,340,348
"2011","Medway 022A","E01016018","Total",1985,199,56,143,1786,214,70,473,270,198,246,315
"2011","Medway 022B","E01016023","Total",1686,136,62,74,1550,256,92,296,168,232,242,264
"2011","Medway 022C","E01016024","Total",1957,197,52,145,1760,216,80,504,306,134,264,256
"2011","Medway 022D","E01016062","Total",1476,166,39,127,1310,169,116,295,202,86,216,226
"2011","Medway 023A","E01016093","Total",1548,164,116,48,1384,15,312,324,238,70,131,294
"2011","Medway 023B","E01016096","Total",1412,192,138,54,1220,59,262,235,220,44,120,280
"2011","Medway 023C","E01016166","Total",1450,126,73,53,1324,62,212,328,206,34,185,297
"2011","Medway 023D","E01016167","Total",1428,143,82,61,1285,86,196,259,188,89,152,315
"2011","Medway 024A","E01016116","Total",1829,220,111,109,1609,120,216,365,226,120,255,307
"2011","Medway 024B","E01016127","Total",1519,257,103,154,1262,99,166,310,254,87,131,215
"2011","Medway 024C","E01016128","Total",1295,142,80,62,1153,96,194,230,190,50,140,253
"2011","Medway 024D","E01016132","Total",1642,137,56,81,1505,54,208,390,222,63,222,346
"2011","Medway 025A","E01016094","Total",1456,157,84,73,1299,61,198,312,242,65,155,266
"2011","Medway 025B","E01016095","Total",1303,123,44,79,1180,71,96,375,238,96,118,186
"2011","Medway 025C","E01016097","Total",1448,225,87,138,1223,109,118,270,230,122,99,275
"2011","Medway 025D","E01016098","Total",1378,289,146,143,1089,130,112,260,254,67,97,169
"2011","Medway 025E","E01016102","Total",1445,205,95,110,1240,123,140,214,174,79,167,343
"2011","Medway 026A","E01016119","Total",1447,96,52,44,1351,31,192,302,162,52,275,337
"2011","Medway 026B","E01016120","Total",1374,196,117,79,1178,85,190,221,164,78,171,269
"2011","Medway 026C","E01016124","Total",1652,178,89,89,1474,56,200,383,252,90,174,319
"2011","Medway 026D","E01016126","Total",1682,118,67,51,1564,69,156,359,222,134,265,359
"2011","Medway 027A","E01016025","Total",1509,214,120,94,1295,89,184,273,160,142,182,265
"2011","Medway 027B","E01016065","Total",1410,212,86,126,1198,47,194,236,234,73,171,243
"2011","Medway 027C","E01016066","Total",1490,187,63,124,1303,102,142,243,188,123,189,316
"2011","Medway 027D","E01016067","Total",1611,188,88,100,1423,82,154,318,210,72,263,324
"2011","Medway 027E","E01016068","Total",1659,194,80,114,1465,191,108,371,192,135,195,273
"2011","Medway 028A","E01016026","Total",1258,125,37,88,1133,52,84,400,244,87,101,165
"2011","Medway 028B","E01016027","Total",1526,84,54,30,1442,32,214,361,228,132,130,345
"2011","Medway 028C","E01016028","Total",1357,178,113,65,1179,35,218,281,228,47,119,251
"2011","Medway 028D","E01016029","Total",1305,144,58,86,1161,75,122,257,228,93,159,227
"2011","Medway 029A","E01016087","Total",1668,172,88,84,1496,68,224,363,276,74,172,319
"2011","Medway 029B","E01016088","Total",1514,139,74,65,1375,67,162,303,234,104,188,317
"2011","Medway 029C","E01016089","Total",1565,211,131,80,1354,47,194,277,218,101,197,320
"2011","Medway 029D","E01016090","Total",1493,140,103,37,1353,45,230,350,196,37,164,331
"2011","Medway 030A","E01016085","Total",1599,117,75,42,1482,26,360,298,218,72,160,348
"2011","Medway 030B","E01016086","Total",1300,105,75,30,1195,19,178,236,172,68,157,365
"2011","Medway 030C","E01016091","Total",1514,123,86,37,1391,31,274,262,230,70,186,338
"2011","Medway 030D","E01016176","Total",1524,98,44,54,1426,40,168,274,268,87,235,354
"2011","Medway 031A","E01016058","Total",1473,161,49,112,1312,57,146,299,318,88,161,243
"2011","Medway 031B","E01016059","Total",1344,157,73,84,1187,86,80,328,182,100,197,214
"2011","Medway 031C","E01016079","Total",1353,94,34,60,1259,42,96,260,194,103,259,305
"2011","Medway 031D","E01016083","Total",1334,201,89,112,1133,125,98,252,170,79,188,221
"2011","Medway 031E","E01016084","Total",1518,95,26,69,1423,124,72,334,170,171,264,288
"2011","Medway 032A","E01016101","Total",1470,122,46,76,1348,77,98,399,234,117,148,275
"2011","Medway 032B","E01016103","Total",1458,119,46,73,1339,52,138,379,244,52,141,333
"2011","Medway 032C","E01016104","Total",1428,111,31,80,1317,68,98,386,308,94,115,248
"2011","Medway 032D","E01016107","Total",1547,130,44,86,1417,69,98,371,296,101,171,311
"2011","Medway 033A","E01016121","Total",1519,154,104,50,1365,79,282,292,246,62,154,250
"2011","Medway 033B","E01016122","Total",1501,151,86,65,1350,46,230,276,228,62,220,288
"2011","Medway 033C","E01016123","Total",1574,158,80,78,1416,72,182,307,222,78,206,349
"2011","Medway 033D","E01016173","Total",1590,195,70,125,1395,122,172,281,220,111,234,255
"2011","Medway 034A","E01016078","Total",1517,190,14,176,1327,98,38,560,340,58,92,141
"2011","Medway 034B","E01016080","Total",1513,153,66,87,1360,93,128,452,274,53,147,213
"2011","Medway 034C","E01016081","Total",1611,87,15,72,1524,96,56,443,274,141,241,273
"2011","Medway 034D","E01016082","Total",1587,89,23,66,1498,64,146,394,248,116,197,333
"2011","Medway 035A","E01016050","Total",1698,125,62,63,1573,33,220,330,326,102,217,345
"2011","Medway 035B","E01016051","Total",1558,130,49,81,1428,59,144,432,228,110,171,284
"2011","Medway 035C","E01016052","Total",1684,108,72,36,1576,32,306,308,242,84,221,383
"2011","Medway 035D","E01016053","Total",1508,154,113,41,1354,27,292,234,228,70,149,354
"2011","Medway 035E","E01016054","Total",1474,141,70,71,1333,36,178,283,228,54,194,360
"2011","Medway 036A","E01016092","Total",1553,150,73,77,1403,36,248,308,204,95,165,347
"2011","Medway 036B","E01016099","Total",1526,147,52,95,1379,130,118,405,258,80,140,248
"2011","Medway 036C","E01016100","Total",1533,184,94,90,1349,122,148,327,254,55,109,334
"2011","Medway 036D","E01016105","Total",1384,176,102,74,1208,45,206,262,182,71,159,283
"2011","Medway 036E","E01016106","Total",1449,139,81,58,1310,100,228,332,186,82,134,248
"2011","Medway 037A","E01016168","Total",1556,188,99,89,1368,82,198,295,226,101,142,324
"2011","Medway 037B","E01016169","Total",1709,121,52,69,1588,50,190,341,232,89,239,447
"2011","Medway 037C","E01016171","Total",1578,158,86,72,1420,131,188,313,208,133,184,263
"2011","Medway 037D","E01016172","Total",1441,139,86,53,1302,52,192,289,230,89,151,299
"2011","Medway 038A","E01016055","Total",1552,196,110,86,1356,87,184,308,194,69,156,358
"2011","Medway 038B","E01016056","Total",1391,207,61,146,1184,115,68,328,306,63,126,178
"2011","Medway 038C","E01016057","Total",1712,117,38,79,1595,137,124,449,248,80,215,342
"2011","Medway 038D","E01016060","Total",1607,123,75,48,1484,19,250,311,224,82,212,386
"2011","Medway 038E","E01016170","Total",1639,137,52,85,1502,123,160,372,230,79,282,256
"2011","Milton Keynes 001A","E01016796","Total",1463,201,96,105,1262,44,192,319,278,109,72,248
"2011","Milton Keynes 001B","E01016797","Total",1746,288,152,136,1458,47,234,402,320,116,113,226
"2011","Milton Keynes 001C","E01016798","Total",1924,144,63,81,1780,66,166,590,310,133,201,314
"2011","Milton Keynes 001D","E01016799","Total",1871,200,106,94,1671,42,222,531,340,148,121,267
"2011","Milton Keynes 001E","E01016800","Total",1632,179,75,104,1453,48,216,413,314,124,132,206
"2011","Milton Keynes 002A","E01016759","Total",1378,160,71,89,1218,79,144,337,250,85,101,222
"2011","Milton Keynes 002B","E01016760","Total",2386,213,76,137,2173,140,194,641,528,150,238,282
"2011","Milton Keynes 002C","E01016761","Total",1368,117,51,66,1251,45,210,289,288,81,104,234
"2011","Milton Keynes 002D","E01016801","Total",1350,129,73,56,1221,45,234,286,218,72,107,259
"2011","Milton Keynes 002E","E01016802","Total",1386,129,59,70,1257,35,208,290,258,93,148,225
"2011","Milton Keynes 002F","E01016803","Total",1318,116,63,53,1202,34,200,339,252,37,125,215
"2011","Milton Keynes 003A","E01016786","Total",1432,156,105,51,1276,48,256,239,266,70,107,290
"2011","Milton Keynes 003B","E01016787","Total",1565,199,105,94,1366,111,162,301,242,99,172,279
"2011","Milton Keynes 003C","E01016788","Total",1611,99,42,57,1512,66,128,383,314,68,166,387
"2011","Milton Keynes 003D","E01016789","Total",1334,87,13,74,1247,80,58,388,256,52,167,246
"2011","Milton Keynes 003E","E01016790","Total",1314,103,65,38,1211,36,192,248,226,47,166,296
"2011","Milton Keynes 004A","E01016791","Total",1437,149,88,61,1288,66,170,282,244,62,138,326
"2011","Milton Keynes 004B","E01016792","Total",1299,128,38,90,1171,51,84,345,246,81,133,231
"2011","Milton Keynes 004C","E01016793","Total",1922,195,85,110,1727,77,168,517,372,83,186,324
"2011","Milton Keynes 004D","E01016794","Total",1483,242,88,154,1241,77,130,331,308,59,60,276
"2011","Milton Keynes 004E","E01016795","Total",1553,204,67,137,1349,79,102,381,344,55,106,282
"2011","Milton Keynes 005A","E01016762","Total",1278,129,50,79,1149,75,130,243,222,94,138,247
"2011","Milton Keynes 005B","E01016764","Total",1431,143,59,84,1288,48,162,281,308,42,123,324
"2011","Milton Keynes 005C","E01016766","Total",1352,120,65,55,1232,99,112,228,252,97,141,303
"2011","Milton Keynes 005D","E01016767","Total",1324,93,43,50,1231,32,128,320,264,26,132,329
"2011","Milton Keynes 005E","E01016771","Total",1322,126,58,68,1196,96,100,230,168,115,217,270
"2011","Milton Keynes 006A","E01016806","Total",1955,175,58,117,1780,187,76,390,244,256,296,331
"2011","Milton Keynes 006B","E01016807","Total",1733,167,70,97,1566,98,132,325,288,121,269,333
"2011","Milton Keynes 006C","E01016809","Total",1424,105,37,68,1319,197,114,207,166,90,225,320
"2011","Milton Keynes 006D","E01016835","Total",1632,202,80,122,1430,200,96,325,238,112,184,275
"2011","Milton Keynes 007A","E01016763","Total",1340,223,109,114,1117,32,158,210,306,47,126,238
"2011","Milton Keynes 007B","E01016769","Total",1385,160,71,89,1225,52,120,310,264,78,128,273
"2011","Milton Keynes 007C","E01016770","Total",1674,186,57,129,1488,78,118,371,286,49,226,360
"2011","Milton Keynes 007D","E01016773","Total",1801,243,175,68,1558,39,274,294,322,68,210,351
"2011","Milton Keynes 008A","E01016836","Total",1677,123,47,76,1554,101,112,346,294,121,262,318
"2011","Milton Keynes 008B","E01016837","Total",1842,184,66,118,1658,103,74,404,288,123,325,341
"2011","Milton Keynes 008C","E01016838","Total",1606,145,78,67,1461,82,160,311,212,185,260,251
"2011","Milton Keynes 008D","E01016841","Total",2117,353,76,277,1764,157,92,485,516,191,116,207
"2011","Milton Keynes 009A","E01016721","Total",1666,170,76,94,1496,116,96,253,210,167,255,399
"2011","Milton Keynes 009B","E01016765","Total",1561,198,114,84,1363,93,162,231,262,109,235,271
"2011","Milton Keynes 009C","E01016772","Total",1338,132,52,80,1206,137,64,210,172,117,248,258
"2011","Milton Keynes 009D","E01016804","Total",1648,242,102,140,1406,205,100,279,306,125,178,213
"2011","Milton Keynes 010A","E01016812","Total",1562,155,61,94,1407,49,226,296,260,147,144,285
"2011","Milton Keynes 010B","E01016817","Total",1523,188,79,109,1335,84,162,252,312,99,107,319
"2011","Milton Keynes 010C","E01016818","Total",1644,347,153,194,1297,42,222,318,368,58,50,239
"2011","Milton Keynes 010D","E01016840","Total",2598,249,88,161,2349,107,238,495,526,276,262,445
"2011","Milton Keynes 011A","E01016719","Total",1458,201,75,126,1257,68,146,305,290,82,107,259
"2011","Milton Keynes 011B","E01016722","Total",1634,120,52,68,1514,55,134,330,268,120,197,410
"2011","Milton Keynes 011C","E01016805","Total",1342,172,53,119,1170,27,174,207,314,40,122,286
"2011","Milton Keynes 011D","E01016808","Total",1367,106,38,68,1261,62,116,296,258,104,131,294
"2011","Milton Keynes 012A","E01016810","Total",1319,226,62,164,1093,157,82,216,178,127,136,197
"2011","Milton Keynes 012B","E01016811","Total",1497,88,11,77,1409,273,42,231,138,229,289,207
"2011","Milton Keynes 012C","E01016819","Total",1158,154,64,90,1004,122,72,177,126,121,192,194
"2011","Milton Keynes 012D","E01016839","Total",1636,147,33,114,1489,272,40,317,224,235,211,190
"2011","Milton Keynes 013A","E01016717","Total",1545,187,77,110,1358,77,84,267,296,162,218,254
"2011","Milton Keynes 013B","E01016720","Total",1554,243,121,122,1311,165,70,328,156,180,154,258
"2011","Milton Keynes 013C","E01016723","Total",1738,100,24,76,1638,69,130,360,270,163,222,424
"2011","Milton Keynes 013D","E01016724","Total",1719,167,32,135,1552,122,80,286,242,108,287,427
"2011","Milton Keynes 014A","E01016718","Total",1609,194,24,170,1415,178,38,223,186,168,275,347
"2011","Milton Keynes 014B","E01016729","Total",2213,212,67,145,2001,203,68,366,268,190,421,485
"2011","Milton Keynes 014D","E01016768","Total",2041,259,50,209,1782,122,92,318,470,78,197,505
"2011","Milton Keynes 014E","E01033499","Total",1390,396,39,357,994,72,40,201,320,39,68,254
"2011","Milton Keynes 014F","E01033500","Total",1333,401,6,395,932,36,6,152,538,5,21,174
"2011","Milton Keynes 015A","E01016776","Total",1468,96,28,68,1372,61,120,308,212,64,214,393
"2011","Milton Keynes 015B","E01016813","Total",1398,264,19,245,1134,81,42,342,302,83,111,173
"2011","Milton Keynes 015C","E01016815","Total",1324,150,51,99,1174,79,84,320,178,109,122,282
"2011","Milton Keynes 015D","E01016816","Total",1493,134,62,72,1359,37,194,337,250,85,163,293
"2011","Milton Keynes 016A","E01016731","Total",1495,184,55,129,1311,74,156,287,300,82,167,245
"2011","Milton Keynes 016B","E01016732","Total",1405,102,31,71,1303,62,124,195,242,81,215,384
"2011","Milton Keynes 016D","E01016784","Total",1614,184,43,141,1430,123,162,287,266,71,146,375
"2011","Milton Keynes 016E","E01033501","Total",2062,115,12,103,1947,177,10,667,322,200,230,341
"2011","Milton Keynes 016F","E01033506","Total",2037,107,17,90,1930,110,60,758,308,153,242,299
"2011","Milton Keynes 017A","E01016783","Total",1944,176,18,158,1768,181,36,664,312,172,168,235
"2011","Milton Keynes 017C","E01016820","Total",1648,147,23,124,1501,105,70,407,268,164,196,291
"2011","Milton Keynes 017D","E01016821","Total",1316,89,18,71,1227,94,36,478,218,75,145,181
"2011","Milton Keynes 017E","E01016823","Total",1694,295,22,273,1399,147,24,502,360,73,128,165
"2011","Milton Keynes 017F","E01033503","Total",1548,111,31,80,1437,72,80,485,316,137,177,170
"2011","Milton Keynes 017G","E01033508","Total",1716,101,3,98,1615,122,14,662,358,89,174,196
"2011","Milton Keynes 017H","E01033509","Total",1665,114,3,111,1551,138,12,600,288,135,178,200
"2011","Milton Keynes 017I","E01033511","Total",1514,140,4,136,1374,117,26,391,370,89,190,191
"2011","Milton Keynes 017J","E01033512","Total",1668,84,12,72,1584,87,88,561,332,161,176,179
"2011","Milton Keynes 018A","E01016726","Total",1685,135,17,118,1550,218,20,206,242,152,399,313
"2011","Milton Keynes 018B","E01016733","Total",1910,129,32,97,1781,191,56,351,138,198,487,360
"2011","Milton Keynes 018C","E01016845","Total",1809,202,50,152,1607,270,74,342,230,234,222,235
"2011","Milton Keynes 018D","E01016846","Total",1635,182,61,121,1453,128,96,349,196,107,288,289
"2011","Milton Keynes 018E","E01016848","Total",1343,171,71,100,1172,92,144,214,240,91,148,243
"2011","Milton Keynes 019B","E01016780","Total",1730,135,29,106,1595,79,78,516,312,106,240,264
"2011","Milton Keynes 019C","E01016781","Total",1533,109,60,49,1424,35,82,454,202,76,275,300
"2011","Milton Keynes 019D","E01016814","Total",1642,195,126,69,1447,34,304,337,312,31,116,313
"2011","Milton Keynes 019E","E01033505","Total",1368,107,9,98,1261,69,32,468,274,123,162,133
"2011","Milton Keynes 019F","E01033522","Total",1349,147,15,132,1202,88,24,436,294,103,151,106
"2011","Milton Keynes 019G","E01033523","Total",1491,117,3,114,1374,124,10,392,256,162,283,147
"2011","Milton Keynes 019H","E01033525","Total",1747,94,15,79,1653,172,26,543,222,179,235,276
"2011","Milton Keynes 020A","E01016774","Total",1762,158,78,80,1604,49,136,502,278,105,233,301
"2011","Milton Keynes 020B","E01016775","Total",1733,172,51,121,1561,139,106,404,286,126,183,317
"2011","Milton Keynes 020C","E01016777","Total",1561,157,61,96,1404,67,102,475,304,83,145,228
"2011","Milton Keynes 020D","E01016778","Total",1767,159,48,111,1608,98,80,509,304,129,204,284
"2011","Milton Keynes 021A","E01016725","Total",1633,133,18,115,1500,128,42,266,244,189,270,361
"2011","Milton Keynes 021B","E01016727","Total",1742,177,59,118,1565,104,84,323,240,104,264,446
"2011","Milton Keynes 021C","E01016728","Total",1996,110,9,101,1886,108,50,609,364,157,237,361
"2011","Milton Keynes 021D","E01016847","Total",2065,264,87,177,1801,216,106,482,296,190,273,238
"2011","Milton Keynes 022A","E01016822","Total",1561,202,33,169,1359,151,72,453,272,100,140,171
"2011","Milton Keynes 022B","E01016824","Total",1622,173,19,154,1449,116,86,533,280,114,158,162
"2011","Milton Keynes 022C","E01016825","Total",1516,204,38,166,1312,106,70,450,238,114,158,176
"2011","Milton Keynes 022D","E01016827","Total",1684,206,21,185,1478,155,46,541,338,47,162,189
"2011","Milton Keynes 022E","E01016828","Total",1795,175,20,155,1620,61,128,531,370,88,171,271
"2011","Milton Keynes 023B","E01016842","Total",1594,181,46,135,1413,164,80,324,160,283,201,201
"2011","Milton Keynes 023C","E01016843","Total",1526,135,29,106,1391,274,44,232,142,247,212,240
"2011","Milton Keynes 023D","E01016844","Total",1613,198,71,127,1415,168,132,217,194,239,182,283
"2011","Milton Keynes 023E","E01033497","Total",1069,284,99,185,785,107,102,167,236,25,41,107
"2011","Milton Keynes 023F","E01033498","Total",1298,280,59,221,1018,98,76,285,244,35,102,178
"2011","Milton Keynes 024A","E01016734","Total",1213,131,75,56,1082,46,196,209,240,90,134,167
"2011","Milton Keynes 024B","E01016735","Total",2060,249,75,174,1811,76,190,524,392,139,160,330
"2011","Milton Keynes 024C","E01016736","Total",1308,185,107,78,1123,53,214,241,244,46,121,204
"2011","Milton Keynes 024D","E01016826","Total",1557,75,7,68,1482,54,64,500,234,81,267,282
"2011","Milton Keynes 025B","E01016752","Total",1742,95,15,80,1647,135,50,557,246,171,240,248
"2011","Milton Keynes 025C","E01016753","Total",2242,216,19,197,2026,194,42,710,412,152,273,243
"2011","Milton Keynes 025D","E01016755","Total",1898,173,60,113,1725,146,82,550,308,142,244,253
"2011","Milton Keynes 025E","E01033514","Total",1463,91,26,65,1372,92,18,633,214,130,154,131
"2011","Milton Keynes 025F","E01033515","Total",1950,84,26,58,1866,101,40,607,188,183,440,307
"2011","Milton Keynes 025G","E01033517","Total",1598,91,6,85,1507,64,14,703,224,116,215,171
"2011","Milton Keynes 026A","E01016754","Total",1652,220,96,124,1432,89,162,374,320,88,127,272
"2011","Milton Keynes 026B","E01016756","Total",2265,305,79,226,1960,207,92,611,316,176,269,289
"2011","Milton Keynes 026C","E01016757","Total",1579,113,31,82,1466,81,102,377,264,148,183,311
"2011","Milton Keynes 026D","E01016758","Total",1725,128,19,109,1597,114,90,497,320,69,216,291
"2011","Milton Keynes 027A","E01016737","Total",1641,100,35,65,1541,120,162,347,242,110,239,321
"2011","Milton Keynes 027B","E01016738","Total",1778,230,131,99,1548,196,174,330,274,121,195,258
"2011","Milton Keynes 027C","E01016739","Total",1569,111,40,71,1458,90,126,281,268,107,234,352
"2011","Milton Keynes 027D","E01016740","Total",1367,123,63,60,1244,64,250,216,196,91,178,249
"2011","Milton Keynes 027E","E01016741","Total",1670,234,85,149,1436,173,174,292,204,102,219,272
"2011","Milton Keynes 028A","E01016748","Total",1977,209,28,181,1768,150,58,660,406,112,166,216
"2011","Milton Keynes 028C","E01016750","Total",1619,159,58,101,1460,66,108,385,258,104,206,333
"2011","Milton Keynes 028D","E01016751","Total",1601,146,32,114,1455,93,74,554,270,96,180,188
"2011","Milton Keynes 028E","E01033519","Total",1870,154,11,143,1716,123,62,717,298,152,184,180
"2011","Milton Keynes 028F","E01033520","Total",1809,93,16,77,1716,93,60,654,280,174,213,242
"2011","Milton Keynes 029A","E01016829","Total",1564,187,94,93,1377,137,180,319,238,102,138,263
"2011","Milton Keynes 029B","E01016831","Total",1555,118,60,58,1437,81,200,274,254,75,223,330
"2011","Milton Keynes 029C","E01016832","Total",1279,101,49,52,1178,92,142,284,180,59,139,282
"2011","Milton Keynes 029D","E01016833","Total",1290,95,62,33,1195,17,242,218,164,68,158,328
"2011","Milton Keynes 029E","E01016834","Total",1543,196,125,71,1347,175,158,307,192,79,137,299
"2011","Milton Keynes 030A","E01016710","Total",1738,224,169,55,1514,106,258,251,258,147,175,319
"2011","Milton Keynes 030B","E01016714","Total",1883,224,126,98,1659,165,162,308,252,171,322,279
"2011","Milton Keynes 030C","E01016716","Total",1832,227,100,127,1605,111,220,340,266,132,188,348
"2011","Milton Keynes 030D","E01016745","Total",1567,128,66,62,1439,76,194,280,256,119,193,321
"2011","Milton Keynes 031A","E01016711","Total",2320,222,94,128,2098,125,300,406,418,80,339,430
"2011","Milton Keynes 031B","E01016713","Total",1670,164,88,76,1506,90,278,350,266,31,165,326
"2011","Milton Keynes 031C","E01016715","Total",1649,149,83,66,1500,124,162,280,234,155,242,303
"2011","Milton Keynes 031D","E01016830","Total",1172,144,49,95,1028,67,94,338,260,37,84,148
"2011","Milton Keynes 032A","E01016742","Total",1601,139,28,111,1462,260,82,286,160,262,214,198
"2011","Milton Keynes 032B","E01016743","Total",2024,185,39,146,1839,343,70,420,348,182,232,244
"2011","Milton Keynes 032C","E01016744","Total",1603,106,31,75,1497,210,74,307,170,231,274,231
"2011","Milton Keynes 032D","E01016746","Total",1726,169,80,89,1557,89,216,301,250,189,231,281
"2011","Portsmouth 001A","E01017112","Total",1838,158,50,108,1680,184,118,308,166,190,315,399
"2011","Portsmouth 001B","E01017115","Total",1359,94,45,49,1265,145,104,187,160,134,280,255
"2011","Portsmouth 001C","E01017117","Total",1570,130,52,78,1440,199,122,319,212,125,208,255
"2011","Portsmouth 001D","E01017119","Total",1727,149,66,83,1578,155,108,344,216,196,199,360
"2011","Portsmouth 001E","E01017120","Total",1492,266,132,134,1226,134,130,217,232,132,155,226
"2011","Portsmouth 002A","E01017051","Total",1877,216,64,152,1661,268,156,386,282,63,240,266
"2011","Portsmouth 002B","E01017052","Total",1417,163,76,87,1254,144,118,218,190,144,179,261
"2011","Portsmouth 002C","E01017053","Total",1349,154,65,89,1195,170,106,236,138,92,206,247
"2011","Portsmouth 002D","E01017118","Total",1564,127,50,77,1437,173,86,278,140,191,227,342
"2011","Portsmouth 003A","E01017050","Total",1543,221,145,76,1322,71,232,252,248,74,138,307
"2011","Portsmouth 003B","E01017061","Total",1658,144,88,56,1514,25,300,304,242,82,201,360
"2011","Portsmouth 003C","E01017063","Total",1586,132,98,34,1454,36,236,322,212,104,154,390
"2011","Portsmouth 003D","E01017064","Total",1605,230,151,79,1375,57,262,303,192,79,164,318
"2011","Portsmouth 004A","E01017054","Total",1412,216,115,101,1196,86,166,229,198,53,193,271
"2011","Portsmouth 004B","E01017113","Total",1510,164,78,86,1346,115,160,255,256,116,175,269
"2011","Portsmouth 004C","E01017114","Total",1351,276,82,194,1075,47,180,188,364,52,70,174
"2011","Portsmouth 004D","E01017116","Total",1596,141,63,78,1455,243,122,395,190,145,178,182
"2011","Portsmouth 006A","E01017055","Total",1529,234,115,119,1295,106,170,305,214,74,154,272
"2011","Portsmouth 006B","E01017056","Total",1371,102,64,38,1269,64,126,349,118,124,164,324
"2011","Portsmouth 006C","E01017057","Total",1517,103,50,53,1414,56,164,343,210,119,170,352
"2011","Portsmouth 006D","E01017058","Total",1671,146,58,88,1525,202,126,352,228,112,208,297
"2011","Portsmouth 006E","E01017060","Total",1549,182,116,66,1367,88,204,407,156,93,181,238
"2011","Portsmouth 007A","E01017086","Total",1325,98,63,35,1227,60,126,311,212,80,139,299
"2011","Portsmouth 007B","E01017089","Total",1604,137,54,83,1467,154,74,430,300,132,165,212
"2011","Portsmouth 007C","E01017090","Total",1557,134,48,86,1423,124,100,280,296,138,203,282
"2011","Portsmouth 007D","E01017091","Total",1528,275,152,123,1253,160,156,298,244,110,103,182
"2011","Portsmouth 007E","E01017092","Total",1453,197,89,108,1256,56,200,279,234,64,162,261
"2011","Portsmouth 008A","E01017014","Total",1586,150,60,90,1436,114,180,366,218,98,194,266
"2011","Portsmouth 008B","E01017046","Total",1708,252,67,185,1456,58,188,273,368,46,156,367
"2011","Portsmouth 008C","E01017047","Total",1647,148,78,70,1499,113,144,389,204,110,209,330
"2011","Portsmouth 008D","E01017048","Total",1576,105,52,53,1471,80,182,382,224,64,229,310
"2011","Portsmouth 008E","E01017085","Total",1428,237,101,136,1191,57,226,202,240,74,140,252
"2011","Portsmouth 009A","E01017084","Total",1423,151,54,97,1272,64,110,272,206,91,213,316
"2011","Portsmouth 009B","E01017087","Total",1454,165,49,116,1289,65,102,284,254,81,178,325
"2011","Portsmouth 009C","E01017088","Total",1690,214,66,148,1476,72,148,310,236,120,251,339
"2011","Portsmouth 009D","E01017105","Total",1402,236,102,134,1166,105,100,257,246,94,130,234
"2011","Portsmouth 009E","E01017107","Total",1537,221,55,166,1316,135,94,278,262,81,233,233
"2011","Portsmouth 010A","E01017104","Total",1150,128,58,70,1022,80,98,219,214,89,145,177
"2011","Portsmouth 010B","E01017106","Total",1498,190,65,125,1308,139,102,266,240,150,140,271
"2011","Portsmouth 010C","E01017108","Total",1542,266,130,136,1276,161,114,278,226,94,108,295
"2011","Portsmouth 010D","E01017109","Total",1358,192,75,117,1166,185,80,279,230,103,91,198
"2011","Portsmouth 011A","E01017041","Total",1398,122,48,74,1276,73,118,272,158,104,219,332
"2011","Portsmouth 011B","E01017043","Total",1465,119,43,76,1346,68,86,285,176,202,249,280
"2011","Portsmouth 011C","E01017044","Total",1537,179,56,123,1358,89,74,320,246,117,215,297
"2011","Portsmouth 011D","E01017049","Total",1498,143,75,68,1355,40,156,300,212,72,169,406
"2011","Portsmouth 011E","E01017110","Total",1465,172,45,127,1293,99,88,294,248,98,225,241
"2011","Portsmouth 011F","E01017111","Total",1454,168,48,120,1286,149,80,380,232,52,157,236
"2011","Portsmouth 012A","E01017013","Total",1605,164,63,101,1441,185,72,387,294,111,145,247
"2011","Portsmouth 012B","E01017042","Total",1412,103,35,68,1309,142,86,320,210,114,165,272
"2011","Portsmouth 012C","E01017045","Total",1358,96,32,64,1262,111,88,346,208,127,141,241
"2011","Portsmouth 012D","E01017075","Total",1629,185,52,133,1444,234,76,349,254,84,198,249
"2011","Portsmouth 012E","E01017082","Total",1744,225,47,178,1519,141,86,371,304,186,201,230
"2011","Portsmouth 012F","E01017083","Total",1734,204,55,149,1530,158,82,428,292,106,156,308
"2011","Portsmouth 013A","E01017036","Total",1568,126,45,81,1442,247,104,278,168,157,198,290
"2011","Portsmouth 013B","E01017037","Total",1492,230,105,125,1262,235,116,284,144,107,150,226
"2011","Portsmouth 013C","E01017038","Total",1614,402,224,178,1212,210,160,271,166,112,96,197
"2011","Portsmouth 013D","E01017102","Total",1570,294,122,172,1276,111,84,206,258,151,193,273
"2011","Portsmouth 013E","E01017103","Total",1252,136,50,86,1116,228,72,225,154,111,136,190
"2011","Portsmouth 014A","E01017015","Total",1466,182,81,101,1284,128,180,285,220,60,178,233
"2011","Portsmouth 014B","E01017016","Total",1587,172,72,100,1415,132,124,341,202,134,191,291
"2011","Portsmouth 014C","E01017017","Total",1522,156,84,72,1366,41,150,370,188,91,189,337
"2011","Portsmouth 014D","E01017018","Total",1601,154,96,58,1447,97,166,342,172,87,193,390
"2011","Portsmouth 014E","E01017019","Total",1784,208,68,140,1576,161,134,375,316,117,208,265
"2011","Portsmouth 014F","E01017020","Total",2290,263,109,154,2027,184,212,460,354,199,231,387
"2011","Portsmouth 015A","E01017076","Total",1615,242,59,183,1373,192,76,295,374,76,95,265
"2011","Portsmouth 015B","E01017077","Total",1720,439,172,267,1281,185,90,344,260,85,108,209
"2011","Portsmouth 015C","E01017078","Total",1568,166,51,115,1402,139,90,370,246,112,123,322
"2011","Portsmouth 015D","E01017079","Total",1579,162,49,113,1417,115,72,272,258,59,182,459
"2011","Portsmouth 015E","E01017080","Total",2028,268,56,212,1760,144,122,389,254,109,157,585
"2011","Portsmouth 015F","E01017081","Total",1654,170,53,117,1484,134,76,363,276,62,155,418
"2011","Portsmouth 016A","E01017031","Total",1939,469,178,291,1470,185,156,361,212,115,162,279
"2011","Portsmouth 016B","E01017032","Total",1141,337,66,271,804,96,66,131,166,48,87,210
"2011","Portsmouth 016D","E01017034","Total",1176,255,60,195,921,142,66,209,198,35,84,187
"2011","Portsmouth 016E","E01017039","Total",1754,294,134,160,1460,155,124,276,170,181,231,323
"2011","Portsmouth 016F","E01017040","Total",1479,254,92,162,1225,211,78,263,168,87,215,203
"2011","Portsmouth 016G","E01033381","Total",1401,303,21,282,1098,82,52,182,438,41,57,246
"2011","Portsmouth 016H","E01033383","Total",1295,211,70,141,1084,147,98,153,252,78,119,237
"2011","Portsmouth 017A","E01017021","Total",1380,184,117,67,1196,37,284,225,232,51,82,285
"2011","Portsmouth 017B","E01017093","Total",1046,169,65,104,877,68,182,176,172,30,70,179
"2011","Portsmouth 017C","E01017096","Total",1404,242,117,125,1162,107,148,311,250,58,48,240
"2011","Portsmouth 017D","E01017099","Total",1628,238,103,135,1390,130,138,264,230,93,160,375
"2011","Portsmouth 017E","E01017100","Total",1395,113,54,59,1282,75,126,347,150,132,173,279
"2011","Portsmouth 017F","E01017101","Total",1550,186,78,108,1364,154,130,320,234,112,114,300
"2011","Portsmouth 018A","E01017035","Total",1584,373,204,169,1211,200,116,245,150,164,176,160
"2011","Portsmouth 018B","E01017128","Total",1644,243,43,200,1401,39,42,84,276,44,109,807
"2011","Portsmouth 018C","E01017129","Total",1916,202,48,154,1714,60,30,118,230,43,146,1087
"2011","Portsmouth 018D","E01017130","Total",1917,278,125,153,1639,208,108,298,160,242,218,405
"2011","Portsmouth 018E","E01017132","Total",2406,298,136,162,2108,197,104,421,272,428,239,447
"2011","Portsmouth 018F","E01017133","Total",1867,375,181,194,1492,114,126,119,242,93,172,626
"2011","Portsmouth 019A","E01017023","Total",1694,180,68,112,1514,92,132,331,228,87,124,520
"2011","Portsmouth 019B","E01017025","Total",2066,209,70,139,1857,97,108,248,356,114,92,842
"2011","Portsmouth 019C","E01017026","Total",1956,239,109,130,1717,104,114,271,254,62,166,746
"2011","Portsmouth 019D","E01017029","Total",1752,203,71,132,1549,70,114,300,258,93,126,588
"2011","Portsmouth 019E","E01017030","Total",1988,158,58,100,1830,96,96,221,240,169,97,911
"2011","Portsmouth 020A","E01017022","Total",1423,277,82,195,1146,50,78,126,284,23,90,495
"2011","Portsmouth 020B","E01017024","Total",1810,202,41,161,1608,51,92,207,310,30,81,837
"2011","Portsmouth 020C","E01017027","Total",1794,157,52,105,1637,31,68,183,228,42,125,960
"2011","Portsmouth 020D","E01017028","Total",2177,132,29,103,2045,56,76,195,192,68,132,1326
"2011","Portsmouth 020E","E01017124","Total",1719,292,69,223,1427,48,86,342,444,66,97,344
"2011","Portsmouth 021A","E01017094","Total",1557,135,55,80,1422,67,108,459,252,51,178,307
"2011","Portsmouth 021B","E01017095","Total",1811,297,100,197,1514,155,132,426,448,28,95,230
"2011","Portsmouth 021C","E01017097","Total",1637,225,66,159,1412,143,110,364,336,76,80,303
"2011","Portsmouth 021D","E01017098","Total",1445,223,61,162,1222,167,72,280,264,74,118,247
"2011","Portsmouth 022A","E01017122","Total",1671,389,89,300,1282,65,76,138,474,109,102,318
"2011","Portsmouth 022B","E01017125","Total",1616,445,203,242,1171,52,140,171,298,43,89,378
"2011","Portsmouth 022C","E01017127","Total",1879,457,86,371,1422,47,66,190,568,35,102,414
"2011","Portsmouth 022D","E01017135","Total",1632,370,134,236,1262,50,128,197,364,37,76,410
"2011","Portsmouth 023A","E01017067","Total",1470,200,83,117,1270,106,196,296,234,89,93,256
"2011","Portsmouth 023B","E01017068","Total",1769,358,104,254,1411,162,184,295,432,52,69,217
"2011","Portsmouth 023C","E01017069","Total",1846,196,78,118,1650,56,160,371,326,376,120,241
"2011","Portsmouth 023D","E01017070","Total",1494,313,114,199,1181,40,188,164,274,91,109,315
"2011","Portsmouth 023E","E01017074","Total",1862,222,58,164,1640,222,130,517,306,181,79,205
"2011","Portsmouth 024A","E01017073","Total",1711,473,132,341,1238,100,126,199,452,36,85,240
"2011","Portsmouth 024B","E01017123","Total",1950,576,152,424,1374,49,178,203,568,38,42,296
"2011","Portsmouth 024C","E01017131","Total",1609,245,107,138,1364,54,198,251,354,162,58,287
"2011","Portsmouth 024E","E01033380","Total",1510,392,63,329,1118,34,112,173,536,40,86,137
"2011","Portsmouth 024F","E01033384","Total",1428,372,176,196,1056,28,244,186,340,10,60,188
"2011","Portsmouth 025A","E01017071","Total",1666,207,32,175,1459,51,64,201,296,216,181,450
"2011","Portsmouth 025B","E01017072","Total",1505,193,76,117,1312,29,168,255,252,135,153,320
"2011","Portsmouth 025C","E01017121","Total",1652,303,70,233,1349,51,138,267,338,68,120,367
"2011","Portsmouth 025D","E01017126","Total",1761,309,86,223,1452,66,88,256,404,59,85,494
"2011","Portsmouth 026A","E01017059","Total",1535,169,116,53,1366,36,318,372,166,90,141,243
"2011","Portsmouth 026B","E01017062","Total",1621,115,67,48,1506,40,168,527,278,88,167,238
"2011","Portsmouth 026C","E01017066","Total",1823,185,84,101,1638,119,246,379,282,97,184,331
"2011","Portsmouth 026D","E01032604","Total",1525,135,65,70,1390,55,204,325,222,92,196,296
"2011","Reading 001A","E01016407","Total",1512,191,120,71,1321,73,228,327,226,90,151,226
"2011","Reading 001B","E01016408","Total",1503,144,51,93,1359,46,132,353,206,81,256,285
"2011","Reading 001C","E01016410","Total",1646,136,47,89,1510,44,200,372,322,122,157,293
"2011","Reading 001D","E01016411","Total",1571,141,100,41,1430,19,342,311,206,149,128,275
"2011","Reading 001E","E01016412","Total",1543,126,42,84,1417,66,144,432,188,111,133,343
"2011","Reading 002A","E01016386","Total",1449,137,91,46,1312,17,276,332,218,77,154,238
"2011","Reading 002B","E01016387","Total",1549,105,66,39,1444,22,218,440,198,105,147,314
"2011","Reading 002C","E01016425","Total",1768,117,68,49,1651,40,192,591,256,159,193,220
"2011","Reading 002D","E01016426","Total",1400,83,51,32,1317,11,136,436,194,147,173,220
"2011","Reading 002E","E01016430","Total",1418,75,35,40,1343,37,122,447,212,127,185,213
"2011","Reading 003A","E01016364","Total",1414,172,79,93,1242,15,90,381,232,88,154,282
"2011","Reading 003B","E01016409","Total",1632,248,145,103,1384,62,218,366,240,50,177,271
"2011","Reading 003C","E01016427","Total",1506,163,94,69,1343,64,210,446,270,69,112,172
"2011","Reading 003D","E01016428","Total",1827,187,88,99,1640,77,210,537,238,187,125,266
"2011","Reading 003E","E01016429","Total",1590,122,58,64,1468,37,192,486,234,101,176,242
"2011","Reading 004A","E01016362","Total",1514,380,130,250,1134,79,94,280,416,50,48,167
"2011","Reading 004B","E01016363","Total",1860,162,21,141,1698,271,46,490,302,143,255,191
"2011","Reading 004C","E01016365","Total",1585,257,61,196,1328,74,94,340,486,46,60,228
"2011","Reading 004D","E01016366","Total",1582,192,62,130,1390,67,130,402,298,92,147,254
"2011","Reading 004E","E01016367","Total",1575,214,71,143,1361,84,116,339,330,117,153,222
"2011","Reading 005A","E01016380","Total",1643,172,65,107,1471,96,162,373,290,74,180,296
"2011","Reading 005B","E01016383","Total",1484,195,69,126,1289,114,86,345,316,73,102,253
"2011","Reading 005C","E01016384","Total",1620,95,45,50,1525,51,210,281,258,110,227,388
"2011","Reading 005D","E01016431","Total",1590,144,75,69,1446,68,170,391,228,88,187,314
"2011","Reading 005E","E01016432","Total",1469,201,144,57,1268,81,188,321,156,51,156,315
"2011","Reading 006A","E01016381","Total",1458,108,45,63,1350,134,94,278,206,145,232,261
"2011","Reading 006B","E01016382","Total",1746,187,61,126,1559,201,110,376,244,108,240,280
"2011","Reading 006C","E01016385","Total",1543,135,42,93,1408,104,88,411,280,94,179,252
"2011","Reading 006D","E01016396","Total",1275,186,46,140,1089,176,72,255,154,83,145,204
"2011","Reading 006E","E01016397","Total",1387,200,97,103,1187,163,88,210,156,171,188,211
"2011","Reading 007A","E01016355","Total",1836,243,38,205,1593,58,56,411,458,72,207,331
"2011","Reading 007B","E01016358","Total",1724,249,27,222,1475,122,60,265,346,109,216,357
"2011","Reading 007C","E01016359","Total",2093,230,44,186,1863,221,94,535,270,145,283,315
"2011","Reading 007D","E01016360","Total",2057,231,38,193,1826,124,60,352,322,198,390,380
"2011","Reading 007E","E01016361","Total",1743,220,48,172,1523,195,58,394,306,57,229,284
"2011","Reading 008A","E01016356","Total",1550,235,37,198,1315,172,50,331,304,100,154,204
"2011","Reading 008B","E01016357","Total",1657,270,36,234,1387,99,56,353,334,80,195,270
"2011","Reading 008C","E01016395","Total",1388,242,123,119,1146,88,200,225,170,72,149,242
"2011","Reading 008D","E01016398","Total",1700,226,23,203,1474,142,58,394,394,119,151,216
"2011","Reading 008E","E01016399","Total",1416,128,45,83,1288,91,106,315,252,63,158,303
"2011","Reading 008F","E01016400","Total",1481,230,59,171,1251,94,58,296,248,53,173,329
"2011","Reading 009A","E01016394","Total",1355,162,99,63,1193,177,176,245,152,89,155,199
"2011","Reading 009B","E01016433","Total",1379,207,130,77,1172,77,140,271,186,93,107,298
"2011","Reading 009C","E01016434","Total",1770,139,68,71,1631,103,196,366,264,163,201,338
"2011","Reading 009D","E01016435","Total",1410,157,97,60,1253,76,200,298,148,139,156,236
"2011","Reading 009E","E01016436","Total",1521,162,76,86,1359,76,160,351,194,108,197,273
"2011","Reading 010B","E01016402","Total",1911,143,36,107,1768,129,40,286,180,77,133,923
"2011","Reading 010C","E01016404","Total",2050,241,56,185,1809,121,42,458,370,127,313,378
"2011","Reading 010D","E01016405","Total",2079,146,24,122,1933,80,48,327,210,105,683,480
"2011","Reading 010E","E01016406","Total",1602,112,24,88,1490,37,42,155,140,91,272,753
"2011","Reading 010F","E01033417","Total",1095,270,48,222,825,25,42,146,390,0,59,163
"2011","Reading 010G","E01033421","Total",1780,385,76,309,1395,114,54,332,390,109,162,234
"2011","Reading 011B","E01016353","Total",1797,313,40,273,1484,114,72,340,380,81,176,321
"2011","Reading 011D","E01016378","Total",1924,421,43,378,1503,101,34,394,532,15,131,296
"2011","Reading 011E","E01016391","Total",1835,304,44,260,1531,180,54,415,438,77,150,217
"2011","Reading 011F","E01033415","Total",1382,359,33,326,1023,27,26,268,496,25,28,153
"2011","Reading 011G","E01033418","Total",1171,269,8,261,902,53,18,267,408,20,50,86
"2011","Reading 011H","E01033420","Total",1103,331,62,269,772,27,42,206,370,10,28,89
"2011","Reading 011I","E01033422","Total",1111,312,52,260,799,57,30,167,310,15,36,184
"2011","Reading 011J","E01033423","Total",1168,265,13,252,903,46,14,154,418,42,70,159
"2011","Reading 012A","E01016401","Total",1485,200,61,139,1285,53,74,240,242,69,188,419
"2011","Reading 012B","E01016403","Total",1912,160,49,111,1752,43,98,443,254,157,259,498
"2011","Reading 012C","E01016416","Total",1637,209,20,189,1428,39,26,180,260,45,94,784
"2011","Reading 012D","E01016417","Total",1701,142,32,110,1559,43,48,193,198,65,152,860
"2011","Reading 012E","E01016418","Total",1640,123,27,96,1517,79,62,187,250,72,74,793
"2011","Reading 013A","E01016388","Total",1435,167,76,91,1268,88,158,251,234,58,149,330
"2011","Reading 013B","E01016389","Total",1732,211,47,164,1521,263,76,369,214,186,218,195
"2011","Reading 013C","E01016390","Total",1477,342,83,259,1135,32,64,264,412,43,125,195
"2011","Reading 013D","E01016392","Total",1825,399,83,316,1426,103,116,389,572,15,90,141
"2011","Reading 013E","E01016393","Total",1490,214,82,132,1276,55,170,291,254,83,165,258
"2011","Reading 014A","E01016374","Total",1626,208,29,179,1418,84,58,272,380,47,193,384
"2011","Reading 014B","E01016375","Total",1258,170,35,135,1088,76,46,185,198,81,162,340
"2011","Reading 014C","E01016376","Total",1527,260,53,207,1267,49,58,226,300,49,144,441
"2011","Reading 014D","E01016379","Total",1750,242,36,206,1508,82,50,230,502,47,215,382
"2011","Reading 014E","E01016413","Total",1068,157,43,114,911,6,80,227,196,61,92,249
"2011","Reading 014F","E01016414","Total",1391,252,42,210,1139,41,62,294,314,25,120,283
"2011","Reading 015A","E01016419","Total",1636,286,104,182,1350,92,122,297,336,72,150,281
"2011","Reading 015B","E01016420","Total",1378,188,52,136,1190,239,76,309,126,113,166,161
"2011","Reading 015C","E01016421","Total",1271,135,91,44,1136,50,212,231,172,47,167,257
"2011","Reading 015D","E01016422","Total",1359,258,160,98,1101,116,212,176,174,84,123,216
"2011","Reading 015E","E01016423","Total",1480,182,105,77,1298,142,148,289,156,81,200,282
"2011","Reading 015F","E01016424","Total",1323,78,36,42,1245,47,126,324,176,82,146,344
"2011","Reading 016A","E01016370","Total",1173,153,51,102,1020,85,128,235,148,65,119,240
"2011","Reading 016B","E01016371","Total",1498,173,80,93,1325,75,154,194,230,118,232,322
"2011","Reading 016C","E01016373","Total",1515,115,34,81,1400,210,68,256,176,116,277,297
"2011","Reading 016D","E01016415","Total",1611,278,104,174,1333,163,108,281,164,141,253,223
"2011","Reading 017A","E01016368","Total",1412,152,69,83,1260,183,88,216,132,121,273,247
"2011","Reading 017B","E01016372","Total",1274,128,40,88,1146,140,80,193,148,143,228,214
"2011","Reading 017C","E01016377","Total",1639,201,60,141,1438,189,78,260,196,62,222,431
"2011","Reading 017D","E01016438","Total",1294,160,68,92,1134,150,96,250,146,84,187,221
"2011","Reading 017E","E01016442","Total",2805,300,36,264,2505,287,94,569,534,227,385,409
"2011","Reading 017F","E01016443","Total",1505,99,36,63,1406,228,94,276,190,170,250,198
"2011","Reading 018A","E01016369","Total",1603,162,88,74,1441,86,210,237,202,105,225,376
"2011","Reading 018B","E01016437","Total",1415,117,38,79,1298,99,82,293,186,134,248,256
"2011","Reading 018C","E01016439","Total",1534,132,55,77,1402,123,112,271,246,105,270,275
"2011","Reading 018D","E01016440","Total",1455,135,64,71,1320,122,108,251,186,97,261,295
"2011","Reading 018E","E01016441","Total",1449,172,69,103,1277,222,70,242,196,107,203,237
"2011","Slough 001A","E01016450","Total",1598,157,36,121,1441,229,60,338,148,211,272,183
"2011","Slough 001B","E01016451","Total",1620,203,73,130,1417,299,28,314,136,210,235,195
"2011","Slough 001C","E01016452","Total",1660,195,78,117,1465,125,126,333,156,127,274,324
"2011","Slough 001D","E01016453","Total",1558,227,91,136,1331,107,144,369,186,107,170,248
"2011","Slough 001E","E01016454","Total",1531,199,73,126,1332,108,108,349,144,160,194,269
"2011","Slough 001F","E01016455","Total",1397,136,41,95,1261,172,62,294,190,96,215,232
"2011","Slough 002A","E01016483","Total",1798,117,27,90,1681,118,54,318,108,147,437,499
"2011","Slough 002B","E01016484","Total",1578,143,30,113,1435,103,96,233,158,87,431,327
"2011","Slough 002C","E01016485","Total",1725,116,37,79,1609,107,58,280,110,177,449,428
"2011","Slough 002D","E01016486","Total",1650,214,57,157,1436,172,98,354,150,125,286,251
"2011","Slough 002E","E01016487","Total",1777,62,28,34,1715,99,66,172,70,151,599,558
"2011","Slough 002F","E01016488","Total",1806,230,55,175,1576,134,66,450,210,151,281,284
"2011","Slough 003A","E01016493","Total",1218,140,38,102,1078,67,82,261,192,57,167,252
"2011","Slough 003B","E01016494","Total",1929,263,36,227,1666,177,88,456,354,114,234,243
"2011","Slough 003C","E01016495","Total",1467,273,63,210,1194,64,124,361,266,57,170,152
"2011","Slough 003D","E01016496","Total",1298,200,84,116,1098,166,78,355,168,99,78,154
"2011","Slough 003E","E01016497","Total",1430,76,29,47,1354,53,150,295,132,120,267,337
"2011","Slough 003F","E01016498","Total",1642,176,29,147,1466,173,48,371,250,94,221,309
"2011","Slough 003G","E01016499","Total",1342,151,26,125,1191,146,32,306,142,77,256,232
"2011","Slough 004A","E01016444","Total",1715,75,33,42,1640,61,52,262,78,262,544,381
"2011","Slough 004B","E01016445","Total",1824,89,36,53,1735,116,60,294,108,225,551,381
"2011","Slough 004C","E01016446","Total",1613,76,40,36,1537,58,52,211,94,205,487,430
"2011","Slough 004D","E01016447","Total",1818,73,22,51,1745,110,70,206,120,225,542,472
"2011","Slough 004E","E01016448","Total",2346,198,83,115,2148,128,90,317,172,152,663,626
"2011","Slough 004F","E01016449","Total",2131,124,50,74,2007,101,68,316,156,290,580,496
"2011","Slough 005A","E01016516","Total",1723,69,36,33,1654,85,54,196,66,221,606,426
"2011","Slough 005B","E01016517","Total",1522,93,29,64,1429,46,64,218,108,126,463,404
"2011","Slough 005C","E01016518","Total",1735,158,34,124,1577,105,58,282,192,123,406,411
"2011","Slough 005D","E01016519","Total",2451,466,145,321,1985,93,186,420,192,229,467,398
"2011","Slough 005E","E01016520","Total",1681,130,60,70,1551,147,94,293,146,189,385,297
"2011","Slough 005F","E01016521","Total",1800,171,105,66,1629,45,124,332,154,205,386,383
"2011","Slough 006A","E01016467","Total",1457,183,33,150,1274,108,70,386,176,77,212,245
"2011","Slough 006B","E01016468","Total",1712,151,42,109,1561,73,92,473,190,121,231,381
"2011","Slough 006C","E01016469","Total",1643,224,70,154,1419,97,120,345,222,81,278,276
"2011","Slough 006D","E01016470","Total",1615,245,41,204,1370,98,86,334,226,117,242,267
"2011","Slough 006E","E01016471","Total",1343,112,40,72,1231,50,88,280,178,117,224,294
"2011","Slough 006F","E01016472","Total",1666,165,84,81,1501,106,106,268,150,147,364,360
"2011","Slough 007A","E01016456","Total",2112,181,69,112,1931,109,50,214,120,173,636,629
"2011","Slough 007B","E01016457","Total",1892,82,12,70,1810,94,68,177,100,140,651,580
"2011","Slough 007C","E01016458","Total",1720,139,47,92,1581,144,64,288,134,191,444,316
"2011","Slough 007D","E01016459","Total",2162,161,33,128,2001,145,56,382,208,144,631,435
"2011","Slough 007E","E01016460","Total",1869,93,41,52,1776,94,110,163,106,192,495,616
"2011","Slough 007F","E01016461","Total",2535,257,23,234,2278,147,62,566,346,154,544,459
"2011","Slough 008A","E01016473","Total",2136,174,31,143,1962,164,40,670,258,228,302,300
"2011","Slough 008B","E01016474","Total",1957,313,99,214,1644,124,116,408,282,154,326,234
"2011","Slough 008C","E01016475","Total",2083,132,47,85,1951,114,88,256,112,206,599,576
"2011","Slough 008D","E01016476","Total",1749,187,10,177,1562,156,30,613,248,162,174,179
"2011","Slough 008E","E01016477","Total",2343,358,23,335,1985,188,48,676,472,183,227,191
"2011","Slough 008F","E01016478","Total",1837,208,36,172,1629,88,70,436,248,123,340,324
"2011","Slough 009A","E01016462","Total",2389,235,27,208,2154,122,42,413,272,177,586,542
"2011","Slough 009B","E01016463","Total",1907,162,54,108,1745,127,98,234,142,257,485,402
"2011","Slough 009C","E01016464","Total",1874,190,34,156,1684,99,66,187,138,174,591,429
"2011","Slough 009D","E01016465","Total",2700,269,40,229,2431,214,96,637,242,246,479,517
"2011","Slough 009F","E01032729","Total",1573,192,40,152,1381,152,80,337,172,91,290,259
"2011","Slough 009G","E01032730","Total",1493,194,24,170,1299,147,18,456,276,60,177,165
"2011","Slough 010A","E01016506","Total",1765,310,22,288,1455,125,24,455,386,80,163,222
"2011","Slough 010B","E01016507","Total",1580,191,89,102,1389,61,98,323,168,137,226,376
"2011","Slough 010C","E01016508","Total",1741,117,54,63,1624,117,166,355,158,134,348,346
"2011","Slough 010D","E01016509","Total",1521,195,55,140,1326,45,108,291,228,80,245,329
"2011","Slough 010E","E01016510","Total",1468,54,32,22,1414,22,132,152,134,47,375,552
"2011","Slough 011A","E01016511","Total",1786,329,87,242,1457,91,72,350,226,92,332,294
"2011","Slough 011B","E01016512","Total",1843,357,60,297,1486,116,48,438,300,111,203,270
"2011","Slough 011C","E01016513","Total",1927,107,54,53,1820,27,114,256,128,205,571,519
"2011","Slough 011D","E01016514","Total",1741,343,71,272,1398,94,90,317,358,141,211,187
"2011","Slough 011E","E01016515","Total",2040,105,50,55,1935,26,116,365,142,125,591,570
"2011","Slough 012A","E01016500","Total",1796,123,48,75,1673,108,86,372,212,95,402,398
"2011","Slough 012B","E01016501","Total",1597,177,66,111,1420,166,86,331,194,139,290,214
"2011","Slough 012C","E01016502","Total",1458,124,60,64,1334,105,68,304,132,160,299,266
"2011","Slough 012D","E01016503","Total",1546,205,69,136,1341,87,80,312,158,105,320,279
"2011","Slough 012E","E01016504","Total",1394,108,44,64,1286,31,110,146,116,73,373,437
"2011","Slough 012F","E01016505","Total",1688,231,87,144,1457,142,76,339,158,137,289,316
"2011","Slough 013B","E01016490","Total",1956,329,103,226,1627,240,98,461,188,137,245,258
"2011","Slough 013C","E01016491","Total",1707,171,80,91,1536,68,212,349,212,53,300,342
"2011","Slough 013D","E01016492","Total",1673,140,55,85,1533,106,114,408,158,150,251,346
"2011","Slough 013E","E01032731","Total",1547,84,21,63,1463,147,42,453,152,160,255,254
"2011","Slough 013F","E01032732","Total",1618,220,71,149,1398,102,120,404,180,104,243,245
"2011","Slough 014A","E01016479","Total",1592,142,20,122,1450,146,44,369,182,119,292,298
"2011","Slough 014B","E01016480","Total",1377,133,26,107,1244,99,90,237,186,94,264,274
"2011","Slough 014C","E01016481","Total",1455,313,45,268,1142,136,40,298,324,40,144,160
"2011","Slough 014D","E01016482","Total",1731,232,40,192,1499,76,108,342,286,56,251,380
"2011","Southampton 001A","E01017144","Total",1015,116,46,70,899,50,132,138,178,51,106,244
"2011","Southampton 001B","E01017145","Total",1427,206,108,98,1221,16,218,195,308,52,157,275
"2011","Southampton 001C","E01017146","Total",1608,207,85,122,1401,26,196,401,330,49,125,274
"2011","Southampton 001D","E01017148","Total",1183,269,42,227,914,13,166,197,234,42,76,186
"2011","Southampton 001E","E01017149","Total",1400,90,39,51,1310,63,70,116,130,99,261,571
"2011","Southampton 002A","E01017180","Total",1491,123,39,84,1368,58,120,318,272,83,209,308
"2011","Southampton 002B","E01017181","Total",1405,133,66,67,1272,99,146,273,244,91,186,233
"2011","Southampton 002C","E01017183","Total",1628,140,60,80,1488,68,182,412,336,81,159,250
"2011","Southampton 002D","E01017185","Total",1767,201,88,113,1566,164,168,428,224,126,151,305
"2011","Southampton 002E","E01017187","Total",1587,197,61,136,1390,103,144,321,320,115,148,239
"2011","Southampton 003A","E01017264","Total",988,241,62,179,747,93,60,197,128,68,74,127
"2011","Southampton 003B","E01017265","Total",1632,307,116,191,1325,139,142,273,224,114,211,222
"2011","Southampton 003C","E01017270","Total",1135,234,141,93,901,29,146,185,192,71,85,193
"2011","Southampton 003D","E01017271","Total",1086,135,63,72,951,31,156,178,178,51,133,224
"2011","Southampton 004A","E01017182","Total",1401,364,258,106,1037,44,166,160,198,93,117,259
"2011","Southampton 004B","E01017184","Total",1407,177,80,97,1230,98,138,285,240,93,124,252
"2011","Southampton 004C","E01017186","Total",1652,225,53,172,1427,157,70,296,264,124,190,326
"2011","Southampton 004D","E01017188","Total",1708,124,54,70,1584,151,124,327,218,185,249,330
"2011","Southampton 005A","E01017266","Total",1442,90,42,48,1352,117,80,167,138,150,166,534
"2011","Southampton 005B","E01017267","Total",1238,107,27,80,1131,18,72,129,154,59,158,541
"2011","Southampton 005E","E01017272","Total",1413,103,43,60,1310,116,82,283,214,169,215,231
"2011","Southampton 005F","E01032756","Total",2916,201,78,123,2715,43,110,257,306,148,188,1663
"2011","Southampton 006A","E01017147","Total",1415,206,99,107,1209,30,140,267,312,44,128,288
"2011","Southampton 006B","E01017150","Total",1429,178,105,73,1251,15,248,234,228,80,141,305
"2011","Southampton 006C","E01017151","Total",1573,275,138,137,1298,68,200,270,250,62,190,258
"2011","Southampton 006D","E01017152","Total",1534,210,61,149,1324,78,120,347,248,68,168,295
"2011","Southampton 007A","E01017238","Total",1402,191,87,104,1211,137,142,204,170,102,211,245
"2011","Southampton 007B","E01017241","Total",1425,263,176,87,1162,180,132,232,178,107,121,212
"2011","Southampton 007C","E01017242","Total",1432,311,92,219,1121,88,112,253,338,48,81,201
"2011","Southampton 007D","E01017243","Total",1727,153,75,78,1574,51,148,324,250,118,259,424
"2011","Southampton 007E","E01017244","Total",1339,122,72,50,1217,122,112,210,186,114,211,262
"2011","Southampton 008A","E01017174","Total",1318,130,78,52,1188,60,236,279,184,80,97,252
"2011","Southampton 008B","E01017175","Total",1545,164,63,101,1381,70,162,385,214,62,231,257
"2011","Southampton 008C","E01017176","Total",1617,172,68,104,1445,96,206,318,280,80,186,279
"2011","Southampton 008D","E01017179","Total",1461,189,74,115,1272,164,130,298,224,87,158,211
"2011","Southampton 009A","E01017226","Total",1467,416,203,213,1051,17,198,159,382,22,86,187
"2011","Southampton 009D","E01017231","Total",1709,181,69,112,1528,31,90,150,230,42,97,888
"2011","Southampton 009E","E01017232","Total",1260,149,71,78,1111,17,106,235,152,77,74,450
"2011","Southampton 009F","E01032753","Total",2237,204,77,127,2033,33,184,317,260,111,221,907
"2011","Southampton 010A","E01017246","Total",1923,306,66,240,1617,115,142,473,432,46,173,236
"2011","Southampton 010B","E01017250","Total",1398,356,171,185,1042,152,140,216,184,85,91,174
"2011","Southampton 010C","E01017251","Total",1563,206,63,143,1357,150,114,336,238,57,245,217
"2011","Southampton 010D","E01017253","Total",1711,165,68,97,1546,145,142,334,226,179,224,296
"2011","Southampton 011A","E01017247","Total",1602,154,77,77,1448,43,158,370,238,110,218,311
"2011","Southampton 011B","E01017248","Total",1558,156,84,72,1402,24,152,376,206,127,242,275
"2011","Southampton 011C","E01017249","Total",1392,96,56,40,1296,21,156,310,188,113,236,272
"2011","Southampton 011D","E01017252","Total",1564,201,109,92,1363,26,172,356,244,80,186,299
"2011","Southampton 011E","E01017254","Total",1636,195,74,121,1441,120,104,366,296,99,196,260
"2011","Southampton 012A","E01017236","Total",1395,203,98,105,1192,211,118,232,166,105,128,232
"2011","Southampton 012B","E01017237","Total",1504,180,58,122,1324,131,98,310,170,171,224,220
"2011","Southampton 012C","E01017239","Total",1536,193,67,126,1343,103,114,330,260,129,202,205
"2011","Southampton 012D","E01017240","Total",1230,259,63,196,971,194,114,165,172,91,108,127
"2011","Southampton 012E","E01017245","Total",1500,170,75,95,1330,276,108,312,146,136,164,188
"2011","Southampton 013A","E01017227","Total",1258,133,21,112,1125,15,8,48,156,22,78,798
"2011","Southampton 013B","E01017228","Total",1545,261,56,205,1284,109,98,246,326,82,151,272
"2011","Southampton 013C","E01017233","Total",1613,242,89,153,1371,96,124,271,342,80,139,319
"2011","Southampton 013D","E01017234","Total",1863,259,84,175,1604,65,96,210,234,70,126,803
"2011","Southampton 013E","E01017235","Total",1538,232,36,196,1306,31,38,170,252,32,58,725
"2011","Southampton 014A","E01017171","Total",1805,362,82,280,1443,70,120,375,398,81,145,254
"2011","Southampton 014B","E01017172","Total",1769,303,58,245,1466,99,94,333,368,87,176,309
"2011","Southampton 014C","E01017173","Total",1436,178,78,100,1258,74,150,321,234,82,135,262
"2011","Southampton 014D","E01017177","Total",1492,313,106,207,1179,57,172,301,302,11,117,219
"2011","Southampton 014E","E01017178","Total",1523,124,38,86,1399,63,120,360,294,110,189,263
"2011","Southampton 015A","E01017207","Total",1582,243,70,173,1339,254,120,335,184,164,133,149
"2011","Southampton 015B","E01017209","Total",1440,168,59,109,1272,95,86,398,180,83,115,315
"2011","Southampton 015C","E01017211","Total",1727,480,269,211,1247,67,188,287,312,31,149,213
"2011","Southampton 015D","E01017212","Total",1374,151,66,85,1223,76,116,270,232,83,172,274
"2011","Southampton 015E","E01017213","Total",1515,259,60,199,1256,42,112,260,362,74,101,305
"2011","Southampton 016A","E01017200","Total",1772,323,186,137,1449,43,224,320,292,61,177,332
"2011","Southampton 016B","E01017201","Total",1368,231,88,143,1137,150,170,269,178,111,116,143
"2011","Southampton 016C","E01017202","Total",1648,247,59,188,1401,275,116,373,270,81,117,169
"2011","Southampton 016D","E01017203","Total",1634,137,63,74,1497,86,186,329,254,135,221,286
"2011","Southampton 016E","E01017204","Total",1522,161,88,73,1361,57,174,372,220,60,137,341
"2011","Southampton 017A","E01017157","Total",1520,221,47,174,1299,14,32,74,226,15,71,867
"2011","Southampton 017B","E01017158","Total",1858,315,80,235,1543,54,62,149,368,30,76,804
"2011","Southampton 017C","E01017159","Total",1674,114,12,102,1560,46,40,104,214,36,127,993
"2011","Southampton 017D","E01017160","Total",1481,241,34,207,1240,39,40,153,388,28,103,489
"2011","Southampton 018A","E01017198","Total",1434,249,156,93,1185,42,244,250,198,47,117,287
"2011","Southampton 018B","E01017199","Total",1614,274,158,116,1340,111,296,245,238,76,128,246
"2011","Southampton 018C","E01017205","Total",1365,154,81,73,1211,144,102,196,132,134,267,236
"2011","Southampton 018D","E01017206","Total",1612,175,80,95,1437,67,176,238,250,142,242,322
"2011","Southampton 019A","E01017208","Total",1424,163,58,105,1261,173,92,296,154,135,166,245
"2011","Southampton 019B","E01017210","Total",1532,166,81,85,1366,212,90,258,190,186,221,209
"2011","Southampton 019C","E01017214","Total",1416,136,38,98,1280,91,114,362,218,96,169,230
"2011","Southampton 019D","E01017215","Total",1777,163,74,89,1614,65,168,458,312,137,174,300
"2011","Southampton 019E","E01017216","Total",1464,154,44,110,1310,77,94,263,242,128,194,312
"2011","Southampton 020A","E01017189","Total",1437,364,34,330,1073,20,36,245,336,38,105,293
"2011","Southampton 020B","E01017190","Total",1457,317,38,279,1140,25,82,171,414,30,59,359
"2011","Southampton 020C","E01017191","Total",1718,348,29,319,1370,64,52,298,330,50,224,352
"2011","Southampton 020D","E01017196","Total",1915,423,58,365,1492,54,124,250,668,72,79,245
"2011","Southampton 020E","E01017197","Total",1507,127,45,82,1380,44,80,333,238,130,192,363
"2011","Southampton 021A","E01017192","Total",2020,332,76,256,1688,149,100,382,398,64,262,333
"2011","Southampton 021B","E01017193","Total",1657,394,137,257,1263,89,80,274,356,52,119,293
"2011","Southampton 021C","E01017194","Total",1795,321,58,263,1474,62,64,322,422,55,179,370
"2011","Southampton 021D","E01017195","Total",1929,382,79,303,1547,148,90,328,456,47,161,317
"2011","Southampton 022A","E01017153","Total",1623,96,19,77,1527,32,26,196,134,217,492,430
"2011","Southampton 022B","E01017154","Total",2289,325,48,277,1964,264,62,432,256,359,342,249
"2011","Southampton 022C","E01017155","Total",1698,149,35,114,1549,50,32,217,158,201,443,448
"2011","Southampton 022D","E01017156","Total",1813,104,26,78,1709,84,44,132,76,279,623,471
"2011","Southampton 022F","E01032738","Total",1249,301,15,286,948,44,16,102,326,10,29,421
"2011","Southampton 022G","E01032750","Total",1137,372,34,338,765,58,22,137,176,37,115,220
"2011","Southampton 023A","E01017136","Total",1607,228,74,154,1379,6,62,62,258,11,61,919
"2011","Southampton 023B","E01017137","Total",1719,246,18,228,1473,5,22,27,192,11,53,1163
"2011","Southampton 023C","E01017138","Total",2004,384,103,281,1620,57,82,183,484,32,9,773
"2011","Southampton 023D","E01017140","Total",1413,479,150,329,934,46,106,179,286,38,58,221
"2011","Southampton 024A","E01017217","Total",1522,228,100,128,1294,64,178,250,246,143,156,257
"2011","Southampton 024B","E01017223","Total",1676,149,55,94,1527,42,164,366,266,110,217,362
"2011","Southampton 024C","E01017224","Total",1353,129,66,63,1224,37,154,288,220,79,131,315
"2011","Southampton 024D","E01017225","Total",1533,143,62,81,1390,110,148,388,228,125,142,249
"2011","Southampton 025A","E01017162","Total",1435,176,103,73,1259,63,260,227,214,77,151,267
"2011","Southampton 025B","E01017163","Total",1549,220,55,165,1329,219,102,318,198,167,177,148
"2011","Southampton 025C","E01017164","Total",1503,220,99,121,1283,60,190,259,274,73,170,257
"2011","Southampton 025D","E01017165","Total",1440,204,128,76,1236,117,182,199,198,84,196,260
"2011","Southampton 025E","E01017166","Total",1507,257,113,144,1250,244,102,241,156,126,152,229
"2011","Southampton 026A","E01017256","Total",2024,236,115,121,1788,84,292,408,334,107,197,366
"2011","Southampton 026B","E01017257","Total",1560,342,112,230,1218,64,126,350,264,52,113,249
"2011","Southampton 026C","E01017259","Total",1451,138,68,70,1313,55,200,349,242,71,155,241
"2011","Southampton 026D","E01017260","Total",1382,222,131,91,1160,51,254,254,222,53,89,237
"2011","Southampton 026E","E01017262","Total",1335,123,55,68,1212,100,110,336,224,47,164,231
"2011","Southampton 027A","E01017167","Total",1527,242,50,192,1285,290,106,271,184,153,103,178
"2011","Southampton 027B","E01017168","Total",1695,337,99,238,1358,217,166,263,280,95,148,189
"2011","Southampton 027C","E01017169","Total",1554,212,112,100,1342,139,144,305,172,175,194,213
"2011","Southampton 027D","E01017170","Total",1572,213,105,108,1359,94,180,334,196,129,162,264
"2011","Southampton 028A","E01017218","Total",1353,107,43,64,1246,95,90,250,170,131,257,253
"2011","Southampton 028B","E01017219","Total",1708,383,123,260,1325,165,158,289,274,58,125,256
"2011","Southampton 028C","E01017220","Total",1830,291,110,181,1539,107,130,309,272,122,242,357
"2011","Southampton 028D","E01017221","Total",1624,169,54,115,1455,90,104,408,298,101,157,297
"2011","Southampton 028E","E01017222","Total",1526,178,35,143,1348,69,112,393,206,97,174,297
"2011","Southampton 029A","E01017139","Total",1859,429,125,304,1430,128,86,275,336,126,202,277
"2011","Southampton 029C","E01017142","Total",1733,485,21,464,1248,47,90,154,732,6,54,165
"2011","Southampton 029E","E01032745","Total",1268,240,36,204,1028,116,10,185,264,109,85,259
"2011","Southampton 029F","E01032746","Total",1165,348,4,344,817,20,16,145,556,5,8,67
"2011","Southampton 029G","E01032748","Total",1080,299,32,267,781,14,44,72,454,5,34,158
"2011","Southampton 029H","E01032751","Total",1159,224,32,192,935,52,54,170,312,37,81,229
"2011","Southampton 029I","E01032755","Total",1101,220,29,191,881,141,22,275,130,161,81,71
"2011","Southampton 030A","E01017255","Total",1594,199,76,123,1395,69,196,361,260,74,177,258
"2011","Southampton 030B","E01017258","Total",1558,203,89,114,1355,62,98,385,242,104,197,267
"2011","Southampton 030C","E01017261","Total",1691,201,86,115,1490,76,172,371,322,91,163,295
"2011","Southampton 030D","E01017263","Total",1429,174,78,96,1255,71,166,236,226,110,186,260
"2011","Southampton 031A","E01017273","Total",1341,187,73,114,1154,56,192,253,204,82,136,231
"2011","Southampton 031B","E01017275","Total",1626,213,59,154,1413,79,158,303,280,106,134,353
"2011","Southampton 031C","E01017276","Total",1713,238,51,187,1475,125,94,420,314,112,148,262
"2011","Southampton 031D","E01017278","Total",1335,184,57,127,1151,92,102,268,304,78,111,196
"2011","Southampton 031E","E01017279","Total",1622,234,79,155,1388,79,166,396,322,89,97,239
"2011","Southampton 032A","E01017274","Total",1490,174,83,91,1316,202,144,280,204,97,175,214
"2011","Southampton 032B","E01017277","Total",1485,119,46,73,1366,117,108,341,278,136,155,231
"2011","Southampton 032C","E01017280","Total",1394,214,102,112,1180,129,114,252,192,116,147,230
"2011","Southampton 032D","E01017281","Total",1644,369,69,300,1275,347,56,400,206,90,52,124
"2011","West Berkshire 001A","E01016277","Total",1345,91,53,38,1254,31,232,386,252,116,135,102
"2011","West Berkshire 001B","E01016286","Total",1557,123,46,77,1434,94,130,403,280,96,194,237
"2011","West Berkshire 001C","E01016287","Total",1452,121,40,81,1331,45,134,430,282,99,146,195
"2011","West Berkshire 001D","E01016288","Total",1640,137,67,70,1503,61,202,371,320,122,164,263
"2011","West Berkshire 002A","E01016303","Total",1468,174,62,112,1294,37,242,341,260,130,127,157
"2011","West Berkshire 002B","E01016304","Total",1536,192,78,114,1344,54,174,336,330,82,97,271
"2011","West Berkshire 002C","E01016305","Total",1217,201,83,118,1016,19,168,238,274,53,91,173
"2011","West Berkshire 002D","E01016306","Total",1307,142,64,78,1165,33,168,286,196,112,154,216
"2011","West Berkshire 003A","E01016256","Total",1747,108,42,66,1639,39,236,462,294,117,161,330
"2011","West Berkshire 003B","E01016257","Total",1328,126,63,63,1202,24,186,348,222,138,130,154
"2011","West Berkshire 003C","E01016313","Total",1611,218,109,109,1393,79,208,409,242,70,118,267
"2011","West Berkshire 003D","E01016314","Total",1167,159,78,81,1008,24,212,233,196,82,89,172
"2011","West Berkshire 004A","E01016315","Total",1581,210,80,130,1371,35,254,345,300,56,117,264
"2011","West Berkshire 004B","E01016316","Total",1998,161,72,89,1837,52,214,504,374,77,202,414
"2011","West Berkshire 004C","E01016317","Total",1368,84,43,41,1284,49,198,287,186,109,136,319
"2011","West Berkshire 004D","E01016318","Total",1543,147,65,82,1396,43,192,387,246,102,133,293
"2011","West Berkshire 005A","E01016258","Total",1530,196,110,86,1334,38,258,293,228,61,161,295
"2011","West Berkshire 005B","E01016261","Total",1647,55,16,39,1592,48,96,476,224,97,233,418
"2011","West Berkshire 005C","E01016349","Total",1230,81,59,22,1149,25,188,301,172,69,116,278
"2011","West Berkshire 005D","E01016350","Total",1526,129,81,48,1397,63,212,376,206,70,192,278
"2011","West Berkshire 006A","E01016259","Total",1550,102,34,68,1448,68,156,378,242,71,197,336
"2011","West Berkshire 006B","E01016260","Total",1710,85,41,44,1625,70,224,406,234,108,204,379
"2011","West Berkshire 006C","E01016262","Total",1340,106,77,29,1234,52,262,262,138,53,160,307
"2011","West Berkshire 006D","E01016272","Total",1543,115,36,79,1428,50,160,288,244,94,174,418
"2011","West Berkshire 006E","E01016273","Total",1514,202,123,79,1312,141,112,331,190,79,165,294
"2011","West Berkshire 007A","E01016263","Total",2251,149,62,87,2102,138,234,750,342,185,182,271
"2011","West Berkshire 007B","E01016278","Total",1185,45,21,24,1140,34,90,447,186,93,152,138
"2011","West Berkshire 007C","E01016283","Total",1491,83,41,42,1408,36,228,384,282,74,175,229
"2011","West Berkshire 007D","E01016284","Total",1401,80,38,42,1321,38,172,380,202,105,151,273
"2011","West Berkshire 007E","E01016285","Total",1592,139,65,74,1453,43,174,363,274,165,173,261
"2011","West Berkshire 008A","E01016271","Total",1401,168,75,93,1233,55,162,257,238,52,142,327
"2011","West Berkshire 008B","E01016274","Total",1375,76,23,53,1299,86,146,231,242,110,151,333
"2011","West Berkshire 008C","E01016275","Total",1470,199,43,156,1271,92,72,415,342,93,76,181
"2011","West Berkshire 008D","E01016276","Total",1471,137,30,107,1334,83,74,415,258,83,169,252
"2011","West Berkshire 009A","E01016327","Total",1196,86,31,55,1110,47,122,318,236,93,89,205
"2011","West Berkshire 009B","E01016328","Total",1757,176,69,107,1581,102,206,433,280,128,174,258
"2011","West Berkshire 009C","E01016344","Total",1488,276,120,156,1212,116,132,270,308,77,135,174
"2011","West Berkshire 009D","E01016345","Total",1336,140,35,105,1196,70,110,342,230,71,153,220
"2011","West Berkshire 010A","E01016296","Total",1565,294,157,137,1271,97,162,318,332,48,85,229
"2011","West Berkshire 010B","E01016297","Total",1533,163,92,71,1370,76,200,311,240,105,155,283
"2011","West Berkshire 010C","E01016298","Total",1106,218,87,131,888,42,148,225,270,35,43,125
"2011","West Berkshire 010D","E01016299","Total",1465,190,70,120,1275,39,188,408,264,85,93,198
"2011","West Berkshire 011A","E01016254","Total",1340,207,103,104,1133,42,188,260,264,42,126,211
"2011","West Berkshire 011B","E01016255","Total",1432,137,66,71,1295,27,192,288,260,105,148,275
"2011","West Berkshire 011C","E01016264","Total",1018,114,47,67,904,35,130,256,188,87,75,133
"2011","West Berkshire 011D","E01016265","Total",1456,119,56,63,1337,42,216,364,228,106,128,253
"2011","West Berkshire 011E","E01016266","Total",1364,113,62,51,1251,33,176,278,226,104,192,242
"2011","West Berkshire 011F","E01016339","Total",2804,243,63,180,2561,165,214,834,556,228,168,396
"2011","West Berkshire 012A","E01016310","Total",1797,319,176,143,1478,86,168,350,298,74,191,311
"2011","West Berkshire 012B","E01016311","Total",1610,334,135,199,1276,60,200,293,364,61,78,220
"2011","West Berkshire 012C","E01016323","Total",1345,176,95,81,1169,41,222,264,230,68,109,235
"2011","West Berkshire 012D","E01016324","Total",1390,145,77,68,1245,39,202,296,224,74,139,271
"2011","West Berkshire 012E","E01016325","Total",1538,187,102,85,1351,153,204,306,192,99,164,233
"2011","West Berkshire 013A","E01016279","Total",2090,311,84,227,1779,142,120,483,394,97,207,336
"2011","West Berkshire 013B","E01016280","Total",1759,162,49,113,1597,170,142,334,316,132,196,307
"2011","West Berkshire 013C","E01016281","Total",1422,113,50,63,1309,58,162,311,244,87,172,275
"2011","West Berkshire 013D","E01016282","Total",1475,147,34,113,1328,77,106,418,322,77,113,215
"2011","West Berkshire 014A","E01016329","Total",1461,153,26,127,1308,57,58,408,344,74,129,238
"2011","West Berkshire 014B","E01016340","Total",1573,153,79,74,1420,86,180,322,252,100,183,297
"2011","West Berkshire 014C","E01016341","Total",1399,78,30,48,1321,56,122,302,250,109,197,285
"2011","West Berkshire 014D","E01016342","Total",1967,168,35,133,1799,114,112,479,386,127,183,398
"2011","West Berkshire 014E","E01016343","Total",1448,129,66,63,1319,24,160,310,252,62,160,351
"2011","West Berkshire 015A","E01016267","Total",1424,92,40,52,1332,48,176,362,268,90,145,243
"2011","West Berkshire 015B","E01016268","Total",1588,141,55,86,1447,98,182,329,250,143,159,286
"2011","West Berkshire 015C","E01016269","Total",1397,142,63,79,1255,22,140,346,256,71,150,270
"2011","West Berkshire 015D","E01016270","Total",1474,83,23,60,1391,61,78,500,282,131,166,173
"2011","West Berkshire 016A","E01016330","Total",1420,243,84,159,1177,70,110,329,290,55,101,222
"2011","West Berkshire 016B","E01016331","Total",1601,119,56,63,1482,102,94,483,240,128,173,262
"2011","West Berkshire 016C","E01016332","Total",1533,330,210,120,1203,92,198,321,196,49,98,249
"2011","West Berkshire 016D","E01016334","Total",1675,146,32,114,1529,105,72,506,280,105,208,253
"2011","West Berkshire 016E","E01016336","Total",1272,120,51,69,1152,147,114,295,128,52,236,180
"2011","West Berkshire 017A","E01016333","Total",1297,100,20,80,1197,53,72,435,216,69,149,203
"2011","West Berkshire 017B","E01016335","Total",1560,101,34,67,1459,47,130,447,268,120,107,340
"2011","West Berkshire 017C","E01016337","Total",2179,229,97,132,1950,112,214,594,314,189,160,367
"2011","West Berkshire 017D","E01016338","Total",1882,171,68,103,1711,59,116,542,318,103,189,384
"2011","West Berkshire 018A","E01016300","Total",1442,193,92,101,1249,63,182,377,276,113,58,180
"2011","West Berkshire 018B","E01016301","Total",1902,158,72,86,1744,37,246,400,392,138,138,393
"2011","West Berkshire 018C","E01016302","Total",1643,120,55,65,1523,31,172,460,292,93,178,297
"2011","West Berkshire 018D","E01016326","Total",1299,129,64,65,1170,55,168,311,254,89,134,159
"2011","West Berkshire 019A","E01016293","Total",2681,190,53,137,2491,129,236,667,448,199,394,418
"2011","West Berkshire 019B","E01016346","Total",1282,379,118,261,903,67,98,187,316,20,70,145
"2011","West Berkshire 019C","E01016347","Total",1493,472,170,302,1021,63,126,264,382,32,43,111
"2011","West Berkshire 019D","E01016348","Total",2012,365,90,275,1647,72,88,521,546,72,105,243
"2011","West Berkshire 020A","E01016294","Total",1493,173,59,114,1320,37,172,354,306,73,71,307
"2011","West Berkshire 020B","E01016295","Total",1505,193,47,146,1312,222,66,286,224,153,140,221
"2011","West Berkshire 020C","E01016312","Total",1940,248,68,180,1692,97,136,527,348,103,191,290
"2011","West Berkshire 020D","E01016319","Total",1588,283,152,131,1305,57,196,342,250,66,162,232
"2011","West Berkshire 020E","E01016320","Total",1380,228,78,150,1152,36,188,302,224,70,126,206
"2011","West Berkshire 021A","E01016289","Total",1427,105,80,25,1322,26,316,274,208,113,105,280
"2011","West Berkshire 021B","E01016290","Total",1549,147,74,73,1402,56,172,443,254,86,108,283
"2011","West Berkshire 021C","E01016291","Total",1783,143,84,59,1640,51,200,589,258,145,138,259
"2011","West Berkshire 021D","E01016292","Total",1602,128,80,48,1474,70,180,293,220,126,244,341
"2011","West Berkshire 021E","E01016321","Total",1431,164,77,87,1267,63,168,273,256,51,148,308
"2011","West Berkshire 021F","E01016322","Total",1289,96,60,36,1193,30,188,293,152,100,144,286
"2011","West Berkshire 022A","E01016307","Total",1591,212,112,100,1379,70,220,357,202,134,152,244
"2011","West Berkshire 022B","E01016308","Total",1886,153,76,77,1733,67,288,431,344,219,152,232
"2011","West Berkshire 022C","E01016309","Total",2132,235,110,125,1897,142,274,552,360,139,138,292
"2011","Windsor and Maidenhead 001A","E01016570","Total",1595,143,76,67,1452,52,176,484,252,67,113,308
"2011","Windsor and Maidenhead 001B","E01016572","Total",1345,142,83,59,1203,66,200,273,206,92,123,243
"2011","Windsor and Maidenhead 001C","E01016582","Total",1475,122,48,74,1353,42,100,258,170,122,381,280
"2011","Windsor and Maidenhead 001D","E01016600","Total",1145,88,47,41,1057,35,212,236,148,81,162,183
"2011","Windsor and Maidenhead 002A","E01016530","Total",1471,213,119,94,1258,61,186,339,210,72,150,240
"2011","Windsor and Maidenhead 002B","E01016531","Total",1409,146,68,78,1263,39,268,321,246,88,104,197
"2011","Windsor and Maidenhead 002C","E01016532","Total",1948,220,95,125,1728,30,318,461,366,125,125,303
"2011","Windsor and Maidenhead 002D","E01016533","Total",1928,155,68,87,1773,66,298,550,294,142,165,258
"2011","Windsor and Maidenhead 002E","E01016578","Total",1438,140,63,77,1298,46,174,231,288,112,143,304
"2011","Windsor and Maidenhead 002F","E01016579","Total",1676,172,75,97,1504,62,244,407,276,87,183,245
"2011","Windsor and Maidenhead 002G","E01016581","Total",1441,137,60,77,1304,44,174,384,208,94,142,258
"2011","Windsor and Maidenhead 003A","E01016571","Total",1550,93,50,43,1457,38,166,403,188,119,191,352
"2011","Windsor and Maidenhead 003B","E01016573","Total",1391,127,57,70,1264,103,110,279,172,104,214,282
"2011","Windsor and Maidenhead 003C","E01016574","Total",1499,184,102,82,1315,50,202,240,190,103,260,270
"2011","Windsor and Maidenhead 003D","E01016599","Total",1606,132,46,86,1474,115,148,319,178,96,296,322
"2011","Windsor and Maidenhead 004A","E01016583","Total",1589,191,75,116,1398,16,232,333,290,88,128,311
"2011","Windsor and Maidenhead 004B","E01016585","Total",1575,306,109,197,1269,44,180,246,376,51,119,253
"2011","Windsor and Maidenhead 004C","E01016586","Total",1313,126,57,69,1187,22,250,209,210,92,136,268
"2011","Windsor and Maidenhead 004D","E01016591","Total",1703,105,40,65,1598,24,220,446,246,97,250,315
"2011","Windsor and Maidenhead 004E","E01016592","Total",1755,263,125,138,1492,37,228,378,342,68,141,298
"2011","Windsor and Maidenhead 005A","E01016525","Total",1601,149,67,82,1452,38,148,458,280,116,151,261
"2011","Windsor and Maidenhead 005B","E01016528","Total",1621,174,66,108,1447,27,158,373,236,132,261,260
"2011","Windsor and Maidenhead 005C","E01016529","Total",1627,238,101,137,1389,109,116,262,196,120,334,252
"2011","Windsor and Maidenhead 005D","E01016536","Total",1828,327,93,234,1501,61,110,366,400,90,206,268
"2011","Windsor and Maidenhead 005E","E01016584","Total",1672,196,70,126,1476,141,102,338,276,101,259,259
"2011","Windsor and Maidenhead 005G","E01032733","Total",1026,339,143,196,687,77,48,215,268,5,18,56
"2011","Windsor and Maidenhead 005H","E01032734","Total",1435,251,49,202,1184,78,70,337,246,79,126,248
"2011","Windsor and Maidenhead 006A","E01016526","Total",1851,179,69,110,1672,67,86,625,290,164,194,246
"2011","Windsor and Maidenhead 006B","E01016527","Total",1543,190,41,149,1353,64,80,484,320,55,139,211
"2011","Windsor and Maidenhead 006C","E01016534","Total",1524,108,71,37,1416,16,242,290,204,78,174,412
"2011","Windsor and Maidenhead 006D","E01016598","Total",1336,101,57,44,1235,19,208,343,156,98,133,278
"2011","Windsor and Maidenhead 006E","E01016601","Total",1620,155,64,91,1465,75,138,529,176,98,171,278
"2011","Windsor and Maidenhead 006F","E01016602","Total",1573,165,120,45,1408,40,218,369,184,73,175,349
"2011","Windsor and Maidenhead 007A","E01016535","Total",1273,122,49,73,1151,44,134,238,174,121,160,280
"2011","Windsor and Maidenhead 007B","E01016537","Total",1529,69,26,43,1460,39,112,283,130,198,348,350
"2011","Windsor and Maidenhead 007C","E01016538","Total",1611,141,44,97,1470,65,152,433,254,96,159,311
"2011","Windsor and Maidenhead 007D","E01016593","Total",1675,183,69,114,1492,94,130,334,252,166,259,257
"2011","Windsor and Maidenhead 007E","E01016594","Total",1452,166,66,100,1286,81,130,287,212,136,199,241
"2011","Windsor and Maidenhead 008A","E01016559","Total",1477,110,51,59,1367,15,222,361,166,99,160,344
"2011","Windsor and Maidenhead 008B","E01016560","Total",1518,207,88,119,1311,103,160,333,208,123,178,206
"2011","Windsor and Maidenhead 008C","E01016561","Total",1784,112,38,74,1672,49,172,490,286,46,221,408
"2011","Windsor and Maidenhead 008D","E01016562","Total",1384,86,51,35,1298,22,160,359,194,51,189,323
"2011","Windsor and Maidenhead 008E","E01016563","Total",1342,89,29,60,1253,33,122,342,218,65,112,361
"2011","Windsor and Maidenhead 008F","E01016580","Total",1517,209,83,126,1308,91,124,329,208,98,169,289
"2011","Windsor and Maidenhead 009A","E01016539","Total",1557,169,93,76,1388,22,212,368,246,83,188,269
"2011","Windsor and Maidenhead 009B","E01016540","Total",1616,159,71,88,1457,52,198,389,252,91,196,279
"2011","Windsor and Maidenhead 009C","E01016541","Total",1384,84,28,56,1300,29,166,320,200,83,173,329
"2011","Windsor and Maidenhead 009D","E01016542","Total",1202,136,59,77,1066,62,132,326,162,91,122,171
"2011","Windsor and Maidenhead 009E","E01016543","Total",1582,170,65,105,1412,48,208,367,302,86,135,266
"2011","Windsor and Maidenhead 010A","E01016544","Total",1528,356,101,255,1172,33,106,329,396,37,73,198
"2011","Windsor and Maidenhead 010B","E01016567","Total",1712,340,84,256,1372,44,140,315,362,131,154,226
"2011","Windsor and Maidenhead 010C","E01016568","Total",1240,132,81,51,1108,71,122,244,168,42,125,336
"2011","Windsor and Maidenhead 010D","E01016569","Total",1020,189,78,111,831,29,120,197,188,32,90,175
"2011","Windsor and Maidenhead 011A","E01016564","Total",1628,191,91,100,1437,84,128,332,224,125,262,282
"2011","Windsor and Maidenhead 011B","E01016565","Total",1538,157,73,84,1381,27,176,333,262,106,162,315
"2011","Windsor and Maidenhead 011C","E01016566","Total",1714,283,65,218,1431,106,102,369,330,126,163,235
"2011","Windsor and Maidenhead 011D","E01016577","Total",1676,217,75,142,1459,97,152,290,250,35,241,394
"2011","Windsor and Maidenhead 012A","E01016545","Total",1925,541,211,330,1384,123,114,399,466,32,84,166
"2011","Windsor and Maidenhead 012B","E01016547","Total",1688,243,68,175,1445,84,68,457,438,79,90,229
"2011","Windsor and Maidenhead 012C","E01016550","Total",1271,156,67,89,1115,36,84,391,168,75,148,213
"2011","Windsor and Maidenhead 012D","E01016552","Total",1606,211,64,147,1395,52,180,402,248,114,135,264
"2011","Windsor and Maidenhead 013A","E01016551","Total",1577,140,93,47,1437,29,282,304,168,76,207,371
"2011","Windsor and Maidenhead 013B","E01016553","Total",1467,246,146,100,1221,50,268,230,178,70,116,309
"2011","Windsor and Maidenhead 013C","E01016557","Total",1871,259,143,116,1612,97,238,320,312,59,213,373
"2011","Windsor and Maidenhead 013D","E01016558","Total",1696,95,32,63,1601,99,80,709,260,174,167,112
"2011","Windsor and Maidenhead 014A","E01016548","Total",1912,261,84,177,1651,75,176,428,352,107,213,300
"2011","Windsor and Maidenhead 014B","E01016549","Total",1925,306,149,157,1619,126,176,448,298,106,161,304
"2011","Windsor and Maidenhead 014C","E01016554","Total",1547,196,70,126,1351,153,166,357,192,116,141,226
"2011","Windsor and Maidenhead 014D","E01016555","Total",1455,175,68,107,1280,96,100,293,192,90,220,289
"2011","Windsor and Maidenhead 014E","E01016556","Total",1774,258,128,130,1516,130,174,325,234,80,219,354
"2011","Windsor and Maidenhead 015A","E01016546","Total",1607,265,73,192,1342,26,146,487,358,103,69,153
"2011","Windsor and Maidenhead 015B","E01016595","Total",1716,168,70,98,1548,107,152,436,292,137,179,245
"2011","Windsor and Maidenhead 015C","E01016596","Total",1793,272,103,169,1521,60,186,434,300,153,124,264
"2011","Windsor and Maidenhead 015D","E01016597","Total",1777,64,27,37,1713,37,252,464,202,112,262,384
"2011","Windsor and Maidenhead 016A","E01016575","Total",1666,122,69,53,1544,29,272,229,228,25,257,504
"2011","Windsor and Maidenhead 016B","E01016576","Total",1714,155,85,70,1559,34,206,364,222,111,283,339
"2011","Windsor and Maidenhead 016C","E01016587","Total",1574,161,89,72,1413,39,240,344,188,103,122,377
"2011","Windsor and Maidenhead 016D","E01016588","Total",1752,264,147,117,1488,43,200,400,282,82,146,335
"2011","Windsor and Maidenhead 016E","E01016589","Total",1564,166,97,69,1398,34,202,333,232,102,160,335
"2011","Windsor and Maidenhead 017A","E01016522","Total",1875,136,52,84,1739,31,202,513,236,178,186,393
"2011","Windsor and Maidenhead 017B","E01016523","Total",1416,169,55,114,1247,47,184,308,192,101,129,286
"2011","Windsor and Maidenhead 017C","E01016524","Total",1987,291,82,209,1696,76,228,455,290,197,166,284
"2011","Windsor and Maidenhead 017D","E01016609","Total",1814,211,90,121,1603,130,126,497,284,115,186,265
"2011","Windsor and Maidenhead 018A","E01016603","Total",1730,245,132,113,1485,36,238,415,230,130,185,251
"2011","Windsor and Maidenhead 018B","E01016604","Total",1871,230,108,122,1641,48,250,420,270,164,204,285
"2011","Windsor and Maidenhead 018C","E01016605","Total",1530,167,57,110,1363,50,180,371,202,158,148,254
"2011","Windsor and Maidenhead 018D","E01016606","Total",1639,158,49,109,1481,36,216,429,212,147,173,268
"2011","Windsor and Maidenhead 018E","E01016607","Total",1438,100,50,50,1338,28,178,302,176,134,211,309
"2011","Windsor and Maidenhead 018F","E01016608","Total",1820,269,136,133,1551,146,184,473,286,123,111,228
"2011","Wokingham 001A","E01016675","Total",1021,163,77,86,858,19,150,203,182,57,75,172
"2011","Wokingham 001B","E01016676","Total",1505,127,74,53,1378,40,294,336,240,98,135,235
"2011","Wokingham 001C","E01016677","Total",1437,175,97,78,1262,39,216,341,234,55,130,247
"2011","Wokingham 001D","E01016678","Total",1325,158,78,80,1167,20,202,272,220,97,120,236
"2011","Wokingham 002A","E01016619","Total",1555,75,35,40,1480,44,208,429,254,135,189,221
"2011","Wokingham 002B","E01016620","Total",1481,82,34,48,1399,36,136,439,200,106,200,282
"2011","Wokingham 002C","E01016692","Total",1436,200,119,81,1236,29,224,336,300,107,84,156
"2011","Wokingham 002D","E01016693","Total",1352,175,38,137,1177,39,114,393,354,50,100,127
"2011","Wokingham 002E","E01016694","Total",1421,263,137,126,1158,30,192,386,274,89,58,129
"2011","Wokingham 002F","E01016695","Total",1541,116,79,37,1425,39,190,447,250,109,120,270
"2011","Wokingham 003A","E01016621","Total",1478,115,57,58,1363,93,166,338,218,88,135,325
"2011","Wokingham 003B","E01016623","Total",1489,145,95,50,1344,32,240,368,198,92,137,277
"2011","Wokingham 003C","E01016624","Total",1438,79,56,23,1359,27,228,308,174,119,196,307
"2011","Wokingham 003D","E01016684","Total",1598,123,52,71,1475,72,220,319,218,102,182,362
"2011","Wokingham 003E","E01016685","Total",1533,163,99,64,1370,39,230,342,202,85,195,277
"2011","Wokingham 004A","E01016622","Total",1249,73,39,34,1176,21,180,256,182,123,145,269
"2011","Wokingham 004B","E01016657","Total",1483,96,32,64,1387,50,124,595,218,125,107,168
"2011","Wokingham 004C","E01016658","Total",1338,89,25,64,1249,50,50,377,206,96,192,278
"2011","Wokingham 004D","E01016659","Total",1410,224,69,155,1186,104,60,370,286,25,132,209
"2011","Wokingham 004E","E01016660","Total",1627,127,35,92,1500,63,124,426,274,113,201,299
"2011","Wokingham 005A","E01016615","Total",1519,193,135,58,1326,57,180,236,150,150,198,355
"2011","Wokingham 005B","E01016616","Total",1489,195,136,59,1294,31,242,235,178,120,197,291
"2011","Wokingham 005C","E01016617","Total",1210,124,99,25,1086,18,226,262,140,42,119,279
"2011","Wokingham 005D","E01016662","Total",1724,203,84,119,1521,119,148,377,228,200,193,256
"2011","Wokingham 006A","E01016613","Total",1534,80,39,41,1454,67,82,258,152,100,464,331
"2011","Wokingham 006B","E01016614","Total",1385,83,52,31,1302,26,150,191,172,108,288,367
"2011","Wokingham 006C","E01016618","Total",1283,124,83,41,1159,30,146,233,158,72,202,318
"2011","Wokingham 006D","E01016664","Total",1274,109,74,35,1165,22,166,371,104,110,144,248
"2011","Wokingham 006E","E01016668","Total",1587,139,65,74,1448,70,182,391,180,101,181,343
"2011","Wokingham 006F","E01016669","Total",1827,177,90,87,1650,44,224,404,234,142,287,315
"2011","Wokingham 007A","E01016661","Total",1370,71,33,38,1299,36,144,338,204,115,150,312
"2011","Wokingham 007B","E01016663","Total",1537,126,67,59,1411,46,196,341,214,117,181,316
"2011","Wokingham 007C","E01016686","Total",1139,142,32,110,997,48,74,278,216,43,121,217
"2011","Wokingham 007D","E01016687","Total",1276,105,53,52,1171,25,194,295,184,64,155,254
"2011","Wokingham 007E","E01016688","Total",1177,87,23,64,1090,55,124,237,184,53,134,303
"2011","Wokingham 007F","E01016689","Total",1412,138,85,53,1274,18,264,346,156,78,110,302
"2011","Wokingham 008B","E01016652","Total",1276,86,22,64,1190,60,116,351,162,82,135,284
"2011","Wokingham 008C","E01016653","Total",1251,83,50,33,1168,14,108,247,172,87,211,329
"2011","Wokingham 008D","E01016665","Total",1592,171,64,107,1421,60,140,479,236,81,148,277
"2011","Wokingham 008E","E01016666","Total",1383,74,27,47,1309,30,94,330,268,107,178,302
"2011","Wokingham 008G","E01032761","Total",2570,181,115,66,2389,26,394,603,342,189,339,496
"2011","Wokingham 009A","E01016647","Total",1834,85,13,72,1749,60,78,594,270,142,269,336
"2011","Wokingham 009B","E01016701","Total",1738,110,47,63,1628,20,184,480,268,119,220,337
"2011","Wokingham 009C","E01016702","Total",1825,135,45,90,1690,76,162,446,326,137,243,300
"2011","Wokingham 009D","E01016703","Total",1827,140,37,103,1687,71,132,565,302,149,206,262
"2011","Wokingham 009E","E01016704","Total",2013,205,67,138,1808,137,168,487,302,162,251,301
"2011","Wokingham 010A","E01016627","Total",1845,139,49,90,1706,42,194,437,334,164,172,363
"2011","Wokingham 010B","E01016628","Total",1534,128,78,50,1406,40,266,392,214,108,113,273
"2011","Wokingham 010C","E01016656","Total",1403,130,65,65,1273,36,164,271,248,87,202,265
"2011","Wokingham 010D","E01016700","Total",1886,142,56,86,1744,55,150,498,346,105,149,441
"2011","Wokingham 011A","E01016644","Total",1465,103,27,76,1362,54,74,514,200,85,177,258
"2011","Wokingham 011B","E01016645","Total",1539,306,45,261,1233,43,78,442,364,71,64,171
"2011","Wokingham 011C","E01016646","Total",1586,138,17,121,1448,27,78,494,296,117,184,252
"2011","Wokingham 011D","E01016648","Total",1433,208,43,165,1225,46,54,478,324,46,83,194
"2011","Wokingham 011E","E01016649","Total",1440,193,43,150,1247,23,76,354,310,78,147,259
"2011","Wokingham 012A","E01016651","Total",1406,157,52,105,1249,47,134,316,276,85,147,244
"2011","Wokingham 012B","E01016654","Total",1397,170,70,100,1227,44,142,352,250,52,144,243
"2011","Wokingham 012C","E01016655","Total",1302,96,19,77,1206,32,78,352,294,66,128,256
"2011","Wokingham 012D","E01016679","Total",2176,181,39,142,1995,136,134,585,364,114,243,419
"2011","Wokingham 012E","E01016680","Total",1288,132,49,83,1156,105,76,292,168,122,181,212
"2011","Wokingham 012G","E01032758","Total",1581,114,35,79,1467,82,88,574,292,74,128,229
"2011","Wokingham 012H","E01032759","Total",1443,111,48,63,1332,42,158,370,316,99,95,252
"2011","Wokingham 013A","E01016626","Total",1622,331,142,189,1291,87,148,365,334,78,132,147
"2011","Wokingham 013B","E01016671","Total",1598,407,270,137,1191,26,282,289,300,64,61,169
"2011","Wokingham 013C","E01016673","Total",1724,241,101,140,1483,162,178,334,248,101,200,260
"2011","Wokingham 013D","E01016674","Total",1410,152,54,98,1258,100,142,304,232,91,112,277
"2011","Wokingham 013E","E01016696","Total",1438,302,117,185,1136,59,106,338,382,51,42,158
"2011","Wokingham 014A","E01016670","Total",2058,188,45,143,1870,70,152,723,394,119,178,234
"2011","Wokingham 014B","E01016672","Total",1758,118,57,61,1640,28,296,490,304,88,134,300
"2011","Wokingham 014E","E01032763","Total",2252,191,117,74,2061,40,364,581,354,102,249,371
"2011","Wokingham 015A","E01016612","Total",2214,105,46,59,2109,36,248,695,316,177,248,389
"2011","Wokingham 015B","E01016629","Total",1372,83,53,30,1289,8,260,270,168,100,144,339
"2011","Wokingham 015C","E01016630","Total",1532,113,31,82,1419,59,80,447,256,113,156,308
"2011","Wokingham 015D","E01016635","Total",1394,95,37,58,1299,40,70,435,204,123,131,296
"2011","Wokingham 016A","E01016625","Total",1613,141,70,71,1472,46,272,364,274,131,162,223
"2011","Wokingham 016B","E01016631","Total",1359,166,68,98,1193,69,92,341,216,92,110,273
"2011","Wokingham 016C","E01016632","Total",1511,128,41,87,1383,18,142,442,254,79,171,277
"2011","Wokingham 016D","E01016634","Total",1463,147,62,85,1316,23,218,400,246,88,123,218
"2011","Wokingham 016E","E01016699","Total",1462,178,70,108,1284,43,206,348,268,82,135,202
"2011","Wokingham 017A","E01016682","Total",1854,176,65,111,1678,59,168,604,364,110,102,271
"2011","Wokingham 017B","E01016683","Total",1851,158,54,104,1693,57,190,520,296,118,154,358
"2011","Wokingham 017C","E01016690","Total",1770,206,95,111,1564,111,164,431,338,113,138,269
"2011","Wokingham 017D","E01016691","Total",1167,85,46,39,1082,8,140,318,208,69,161,178
"2011","Wokingham 018A","E01016610","Total",2797,239,66,173,2558,151,206,880,506,214,244,357
"2011","Wokingham 018B","E01016611","Total",1081,81,23,58,1000,42,88,369,240,65,61,135
"2011","Wokingham 018C","E01016641","Total",1365,122,76,46,1243,10,216,311,204,97,161,244
"2011","Wokingham 018D","E01016642","Total",1155,112,66,46,1043,81,116,238,170,89,117,232
"2011","Wokingham 019A","E01016633","Total",1362,74,29,45,1288,26,132,456,192,75,141,266
"2011","Wokingham 019B","E01016636","Total",1464,84,48,36,1380,16,248,392,218,45,159,302
"2011","Wokingham 019C","E01016637","Total",1084,59,30,29,1025,5,150,273,174,68,111,244
"2011","Wokingham 019D","E01016638","Total",1320,84,30,54,1236,44,116,435,204,86,135,216
"2011","Wokingham 019E","E01016639","Total",1595,119,45,74,1476,56,152,506,266,105,157,234
"2011","Wokingham 019F","E01016640","Total",1528,125,76,49,1403,20,234,329,250,78,180,312
"2011","Wokingham 019G","E01016643","Total",1387,76,17,59,1311,22,116,427,232,140,143,231
"2011","Wokingham 020A","E01016705","Total",1247,125,40,85,1122,44,118,336,216,72,170,166
"2011","Wokingham 020B","E01016706","Total",1667,107,47,60,1560,40,172,468,278,127,164,311
"2011","Wokingham 020C","E01016707","Total",1612,138,90,48,1474,50,232,461,180,109,153,289
"2011","Wokingham 020D","E01016708","Total",1577,145,71,74,1432,26,268,328,274,80,129,327
"2011","Wokingham 020E","E01016709","Total",1584,101,70,31,1483,37,344,355,174,159,137,277
"2011","Aylesbury Vale 001A","E01017648","Total",1806,120,46,74,1686,37,196,486,280,110,183,394
"2011","Aylesbury Vale 001B","E01017649","Total",1988,229,117,112,1759,110,214,441,328,112,183,371
"2011","Aylesbury Vale 001C","E01017650","Total",1668,111,44,67,1557,51,136,519,226,140,229,256
"2011","Aylesbury Vale 001F","E01032960","Total",2346,209,83,126,2137,80,288,502,440,114,246,467
"2011","Aylesbury Vale 002A","E01017644","Total",1501,178,58,120,1323,72,96,386,296,61,138,274
"2011","Aylesbury Vale 002B","E01017645","Total",1200,199,73,126,1001,83,76,196,324,49,72,201
"2011","Aylesbury Vale 002C","E01017646","Total",1812,245,146,99,1567,116,222,418,256,89,165,301
"2011","Aylesbury Vale 002D","E01017647","Total",1625,110,69,41,1515,29,238,379,232,142,199,296
"2011","Aylesbury Vale 003A","E01017671","Total",1591,119,55,64,1472,38,172,419,260,92,179,312
"2011","Aylesbury Vale 003B","E01017672","Total",1483,124,58,66,1359,31,158,363,258,123,139,287
"2011","Aylesbury Vale 003C","E01017695","Total",1185,127,75,52,1058,29,224,219,192,50,120,224
"2011","Aylesbury Vale 003D","E01017696","Total",1263,111,64,47,1152,37,168,265,226,76,153,227
"2011","Aylesbury Vale 004A","E01017693","Total",1083,97,41,56,986,28,124,247,210,57,134,186
"2011","Aylesbury Vale 004B","E01017694","Total",2306,125,49,76,2181,40,228,719,356,292,259,287
"2011","Aylesbury Vale 004C","E01017713","Total",1436,148,65,83,1288,61,142,316,262,104,137,266
"2011","Aylesbury Vale 004D","E01017714","Total",1333,98,39,59,1235,19,158,303,240,106,111,298
"2011","Aylesbury Vale 004E","E01017717","Total",1695,162,86,76,1533,76,236,373,296,151,137,264
"2011","Aylesbury Vale 004F","E01017718","Total",1568,167,76,91,1401,33,168,427,274,101,161,237
"2011","Aylesbury Vale 005A","E01017735","Total",1318,131,54,77,1187,36,170,268,254,85,179,195
"2011","Aylesbury Vale 005B","E01017736","Total",1526,193,111,82,1333,104,198,294,250,73,155,259
"2011","Aylesbury Vale 005C","E01017737","Total",1351,153,103,50,1198,30,248,269,230,55,101,265
"2011","Aylesbury Vale 005D","E01017738","Total",1479,232,102,130,1247,64,206,295,290,60,150,182
"2011","Aylesbury Vale 006A","E01017669","Total",1477,143,77,66,1334,47,182,282,278,77,152,316
"2011","Aylesbury Vale 006B","E01017670","Total",1548,138,63,75,1410,34,206,347,312,82,167,262
"2011","Aylesbury Vale 006C","E01017715","Total",1120,104,54,50,1016,16,178,279,190,50,122,181
"2011","Aylesbury Vale 006D","E01017716","Total",1826,153,70,83,1673,24,258,424,292,181,216,278
"2011","Aylesbury Vale 007A","E01017641","Total",1672,170,97,73,1502,31,284,387,288,62,158,292
"2011","Aylesbury Vale 007B","E01017731","Total",1323,153,75,78,1170,62,148,275,194,104,153,234
"2011","Aylesbury Vale 007C","E01017732","Total",1355,111,48,63,1244,42,142,317,284,80,106,273
"2011","Aylesbury Vale 007D","E01017733","Total",1194,128,73,55,1066,31,164,294,220,54,114,189
"2011","Aylesbury Vale 007E","E01017734","Total",1357,98,43,55,1259,26,168,348,318,90,108,201
"2011","Aylesbury Vale 008A","E01017703","Total",1292,128,61,67,1164,63,186,279,180,94,153,209
"2011","Aylesbury Vale 008B","E01017704","Total",1249,97,47,50,1152,11,168,332,194,123,110,214
"2011","Aylesbury Vale 008C","E01017719","Total",1199,144,76,68,1055,38,128,260,188,82,153,206
"2011","Aylesbury Vale 008D","E01017720","Total",1311,115,43,72,1196,48,114,283,240,141,150,220
"2011","Aylesbury Vale 008F","E01032958","Total",1522,140,68,72,1382,30,216,380,274,104,122,256
"2011","Aylesbury Vale 008G","E01032959","Total",1748,112,7,105,1636,210,24,609,268,251,148,126
"2011","Aylesbury Vale 009A","E01017651","Total",1557,115,58,57,1442,39,174,380,286,114,166,283
"2011","Aylesbury Vale 009B","E01017652","Total",1462,182,77,105,1280,51,164,383,242,72,139,229
"2011","Aylesbury Vale 009C","E01017657","Total",1421,135,80,55,1286,19,244,357,210,111,121,224
"2011","Aylesbury Vale 009D","E01017658","Total",1426,146,56,90,1280,29,146,345,296,99,138,227
"2011","Aylesbury Vale 009E","E01017701","Total",2190,152,59,93,2038,77,158,737,346,210,250,260
"2011","Aylesbury Vale 009F","E01017702","Total",1467,150,76,74,1317,30,186,347,260,97,147,250
"2011","Aylesbury Vale 010A","E01017642","Total",1269,153,82,71,1116,33,200,307,182,71,140,183
"2011","Aylesbury Vale 010B","E01017643","Total",1287,131,55,76,1156,15,152,304,238,69,123,255
"2011","Aylesbury Vale 010C","E01017673","Total",1300,89,39,50,1211,23,170,296,188,126,185,223
"2011","Aylesbury Vale 010D","E01017674","Total",1346,100,36,64,1246,26,110,347,258,106,192,207
"2011","Aylesbury Vale 011A","E01017659","Total",1608,149,68,81,1459,108,168,278,196,170,317,222
"2011","Aylesbury Vale 011B","E01017660","Total",1642,243,54,189,1399,121,66,484,374,84,149,121
"2011","Aylesbury Vale 011C","E01017661","Total",1565,183,61,122,1382,115,106,319,226,138,228,250
"2011","Aylesbury Vale 011D","E01017664","Total",1404,206,30,176,1198,37,76,364,330,41,92,258
"2011","Aylesbury Vale 012A","E01017705","Total",1175,114,28,86,1061,40,86,220,276,82,103,254
"2011","Aylesbury Vale 012B","E01017706","Total",1364,101,33,68,1263,112,56,307,210,172,144,262
"2011","Aylesbury Vale 012C","E01017707","Total",1310,99,37,62,1211,153,48,213,154,128,240,275
"2011","Aylesbury Vale 012D","E01017708","Total",1564,160,55,105,1404,171,100,307,190,132,263,241
"2011","Aylesbury Vale 013A","E01017665","Total",1539,157,63,94,1382,134,92,268,184,181,253,270
"2011","Aylesbury Vale 013B","E01017666","Total",1618,280,129,151,1338,97,100,329,284,112,148,268
"2011","Aylesbury Vale 013C","E01017667","Total",1369,118,45,73,1251,149,110,293,150,153,194,202
"2011","Aylesbury Vale 013D","E01017668","Total",1534,159,69,90,1375,78,118,364,278,80,208,249
"2011","Aylesbury Vale 014A","E01017697","Total",1426,174,33,141,1252,73,108,378,318,73,144,158
"2011","Aylesbury Vale 014B","E01017698","Total",1468,119,44,75,1349,125,82,318,184,146,257,237
"2011","Aylesbury Vale 014C","E01017699","Total",1073,126,36,90,947,55,56,269,214,75,108,170
"2011","Aylesbury Vale 014D","E01017700","Total",1547,119,83,36,1428,35,288,356,226,72,155,296
"2011","Aylesbury Vale 015B","E01017634","Total",1549,182,34,148,1367,68,50,328,366,103,210,242
"2011","Aylesbury Vale 015C","E01017662","Total",1296,148,53,95,1148,83,94,230,210,101,216,214
"2011","Aylesbury Vale 015D","E01017663","Total",1583,196,93,103,1387,85,88,235,222,116,368,273
"2011","Aylesbury Vale 015E","E01032955","Total",1211,393,178,215,818,35,102,214,314,10,25,118
"2011","Aylesbury Vale 015F","E01032961","Total",1039,202,47,155,837,95,40,201,230,35,70,166
"2011","Aylesbury Vale 016A","E01017653","Total",1481,149,46,103,1332,58,124,354,274,72,154,296
"2011","Aylesbury Vale 016B","E01017654","Total",1432,170,25,145,1262,108,40,252,192,219,237,214
"2011","Aylesbury Vale 016C","E01017655","Total",1892,225,40,185,1667,102,86,564,458,99,111,247
"2011","Aylesbury Vale 016E","E01032956","Total",1629,143,14,129,1486,55,48,580,462,138,84,119
"2011","Aylesbury Vale 016F","E01032957","Total",1356,165,14,151,1191,65,38,433,392,62,74,127
"2011","Aylesbury Vale 016G","E01032962","Total",1554,162,22,140,1392,90,74,584,384,61,79,120
"2011","Aylesbury Vale 017A","E01017635","Total",1439,197,88,109,1242,29,224,360,160,132,126,211
"2011","Aylesbury Vale 017B","E01017636","Total",1560,150,93,57,1410,52,278,405,178,82,131,284
"2011","Aylesbury Vale 017C","E01017637","Total",1288,102,42,60,1186,48,106,328,226,64,146,268
"2011","Aylesbury Vale 017D","E01017638","Total",1306,91,59,32,1215,15,242,281,146,103,141,287
"2011","Aylesbury Vale 017E","E01017639","Total",1594,110,63,47,1484,9,242,318,230,108,177,400
"2011","Aylesbury Vale 017F","E01017640","Total",1570,156,105,51,1414,25,222,341,210,125,213,278
"2011","Aylesbury Vale 018A","E01017709","Total",1675,149,88,61,1526,105,106,239,142,206,357,371
"2011","Aylesbury Vale 018B","E01017710","Total",1551,88,45,43,1463,77,114,242,172,181,340,337
"2011","Aylesbury Vale 018C","E01017711","Total",1566,196,88,108,1370,126,110,273,190,142,284,245
"2011","Aylesbury Vale 018D","E01017712","Total",2101,199,41,158,1902,170,76,407,386,238,374,251
"2011","Aylesbury Vale 019A","E01017687","Total",1996,338,46,292,1658,150,84,496,340,144,212,232
"2011","Aylesbury Vale 019B","E01017688","Total",1232,145,36,109,1087,48,70,358,264,84,122,141
"2011","Aylesbury Vale 019C","E01017689","Total",1389,138,63,75,1251,31,120,391,258,50,115,286
"2011","Aylesbury Vale 019D","E01017690","Total",1148,134,69,65,1014,53,132,234,184,41,105,265
"2011","Aylesbury Vale 019E","E01017691","Total",1342,101,28,73,1241,20,104,338,244,58,158,319
"2011","Aylesbury Vale 019F","E01017692","Total",1537,222,64,158,1315,89,136,296,278,94,149,273
"2011","Aylesbury Vale 020A","E01017721","Total",1575,296,56,240,1279,124,60,423,416,30,94,132
"2011","Aylesbury Vale 020B","E01017722","Total",1510,165,27,138,1345,80,64,365,336,129,119,252
"2011","Aylesbury Vale 020C","E01017723","Total",1372,116,35,81,1256,127,68,246,188,159,224,244
"2011","Aylesbury Vale 020D","E01017724","Total",1425,110,33,77,1315,128,76,326,164,175,232,214
"2011","Aylesbury Vale 021A","E01017627","Total",1594,198,72,126,1396,66,146,409,276,93,141,265
"2011","Aylesbury Vale 021B","E01017628","Total",1594,128,60,68,1466,53,200,366,268,118,158,303
"2011","Aylesbury Vale 021C","E01017629","Total",1595,137,62,75,1458,21,242,390,282,80,181,262
"2011","Aylesbury Vale 021D","E01017630","Total",1539,128,79,49,1411,36,258,334,238,112,147,286
"2011","Aylesbury Vale 021E","E01017631","Total",1586,164,85,79,1422,23,200,361,262,92,178,306
"2011","Aylesbury Vale 021F","E01017632","Total",1555,121,56,65,1434,40,202,363,292,82,150,305
"2011","Aylesbury Vale 022A","E01017675","Total",1431,137,77,60,1294,66,234,335,258,70,128,203
"2011","Aylesbury Vale 022B","E01017676","Total",1412,99,63,36,1313,13,286,332,236,79,128,239
"2011","Aylesbury Vale 022C","E01017677","Total",1342,171,105,66,1171,32,240,273,246,36,121,223
"2011","Aylesbury Vale 022D","E01017678","Total",1270,149,67,82,1121,19,156,261,248,30,76,331
"2011","Aylesbury Vale 022E","E01017679","Total",1559,129,60,69,1430,81,182,417,258,99,136,257
"2011","Aylesbury Vale 022F","E01017680","Total",992,155,93,62,837,27,146,176,148,53,113,174
"2011","Aylesbury Vale 023A","E01017681","Total",1230,143,89,54,1087,34,164,268,228,93,101,199
"2011","Aylesbury Vale 023B","E01017682","Total",1219,100,52,48,1119,27,218,311,164,130,121,148
"2011","Aylesbury Vale 023C","E01017683","Total",1700,127,69,58,1573,39,220,362,304,91,200,357
"2011","Aylesbury Vale 023D","E01017684","Total",1108,101,64,37,1007,21,202,231,200,87,92,174
"2011","Aylesbury Vale 024A","E01017726","Total",1069,194,124,70,875,16,240,147,178,66,56,172
"2011","Aylesbury Vale 024B","E01017727","Total",1638,158,102,56,1480,40,248,458,226,135,153,220
"2011","Aylesbury Vale 024C","E01017728","Total",2081,109,23,86,1972,158,48,796,348,215,206,201
"2011","Aylesbury Vale 024D","E01017729","Total",1691,167,94,73,1524,55,218,485,218,118,140,290
"2011","Aylesbury Vale 024E","E01017730","Total",1561,277,188,89,1284,82,208,350,232,120,93,199
"2011","Chiltern 001A","E01017750","Total",2201,213,97,116,1988,26,302,452,334,181,253,440
"2011","Chiltern 001B","E01017752","Total",2203,196,97,99,2007,27,350,506,328,184,225,387
"2011","Chiltern 001C","E01017766","Total",2304,173,109,64,2131,31,386,575,332,159,212,436
"2011","Chiltern 001D","E01017778","Total",1261,127,63,64,1134,33,202,296,168,131,76,228
"2011","Chiltern 002A","E01017747","Total",1399,135,61,74,1264,49,160,292,154,142,211,256
"2011","Chiltern 002B","E01017748","Total",1805,224,101,123,1581,79,160,448,220,164,217,293
"2011","Chiltern 002C","E01017749","Total",1636,155,94,61,1481,20,256,408,210,118,153,316
"2011","Chiltern 002D","E01017789","Total",1222,120,70,50,1102,55,160,262,208,93,98,226
"2011","Chiltern 002E","E01017790","Total",1382,100,47,53,1282,116,128,278,140,132,263,225
"2011","Chiltern 002F","E01017795","Total",2132,201,81,120,1931,90,200,501,328,183,259,370
"2011","Chiltern 003A","E01017769","Total",1561,151,56,95,1410,16,162,375,276,67,192,322
"2011","Chiltern 003B","E01017771","Total",1439,169,110,59,1270,32,288,264,208,69,165,244
"2011","Chiltern 003C","E01017780","Total",1262,102,38,64,1160,24,150,328,206,93,128,231
"2011","Chiltern 003D","E01017781","Total",1212,136,33,103,1076,60,50,291,164,133,243,135
"2011","Chiltern 004A","E01017770","Total",1497,227,108,119,1270,84,80,423,234,57,184,208
"2011","Chiltern 004B","E01017791","Total",1446,199,67,132,1247,109,114,327,232,103,157,205
"2011","Chiltern 004C","E01017792","Total",1847,396,191,205,1451,66,240,419,298,83,118,227
"2011","Chiltern 004D","E01017793","Total",1521,133,61,72,1388,83,188,298,242,103,123,351
"2011","Chiltern 005A","E01017768","Total",2223,283,185,98,1940,71,376,493,302,149,215,334
"2011","Chiltern 005B","E01017779","Total",1163,67,46,21,1096,17,174,257,140,137,155,216
"2011","Chiltern 005C","E01017785","Total",1677,121,60,61,1556,34,304,379,232,56,150,401
"2011","Chiltern 005D","E01017786","Total",1553,130,71,59,1423,29,204,413,208,92,179,298
"2011","Chiltern 005E","E01017787","Total",1614,108,72,36,1506,37,290,433,166,97,181,302
"2011","Chiltern 005F","E01017788","Total",1753,272,161,111,1481,109,160,447,196,130,161,278
"2011","Chiltern 006A","E01017741","Total",1567,213,141,72,1354,61,206,386,172,139,150,240
"2011","Chiltern 006B","E01017742","Total",1693,196,140,56,1497,42,212,462,244,130,166,241
"2011","Chiltern 006C","E01017743","Total",1597,157,62,95,1440,123,124,411,226,83,193,280
"2011","Chiltern 006D","E01017763","Total",1704,251,181,70,1453,46,226,399,258,134,189,201
"2011","Chiltern 006E","E01017764","Total",1726,95,67,28,1631,43,238,433,162,168,251,336
"2011","Chiltern 006F","E01017765","Total",1764,83,59,24,1681,6,308,418,164,234,258,293
"2011","Chiltern 007A","E01017739","Total",1254,101,45,56,1153,24,164,342,206,98,129,190
"2011","Chiltern 007B","E01017740","Total",1321,130,50,80,1191,41,114,398,228,70,127,213
"2011","Chiltern 007C","E01017744","Total",1435,132,72,60,1303,29,194,334,206,132,141,267
"2011","Chiltern 007D","E01017745","Total",1763,302,136,166,1461,25,282,396,282,123,162,191
"2011","Chiltern 007E","E01017746","Total",1533,113,54,59,1420,52,182,440,242,113,119,272
"2011","Chiltern 008A","E01017762","Total",1472,74,49,25,1398,16,228,376,172,152,212,242
"2011","Chiltern 008B","E01017775","Total",1557,206,126,80,1351,47,220,381,228,99,146,230
"2011","Chiltern 008C","E01017776","Total",1619,166,57,109,1453,88,182,362,260,148,169,244
"2011","Chiltern 008D","E01017777","Total",1637,147,101,46,1490,32,282,405,174,132,177,288
"2011","Chiltern 010A","E01017759","Total",1815,229,108,121,1586,81,266,474,248,139,128,250
"2011","Chiltern 010B","E01017760","Total",1699,124,98,26,1575,13,306,368,232,187,176,293
"2011","Chiltern 010C","E01017761","Total",2132,210,120,90,1922,63,318,613,288,144,192,304
"2011","Chiltern 010D","E01017794","Total",2311,205,117,88,2106,50,236,672,294,178,238,438
"2011","Chiltern 011A","E01017754","Total",1463,94,51,43,1369,22,252,336,168,130,172,289
"2011","Chiltern 011B","E01017755","Total",1514,217,113,104,1297,67,148,299,256,111,148,268
"2011","Chiltern 011C","E01017756","Total",1484,111,87,24,1373,32,268,319,194,102,177,281
"2011","Chiltern 011D","E01017757","Total",1225,117,74,43,1108,54,164,281,132,119,128,230
"2011","Chiltern 011E","E01017758","Total",1172,62,41,21,1110,30,166,304,138,99,134,239
"2011","Chiltern 012A","E01017751","Total",2163,144,95,49,2019,22,304,512,228,180,332,441
"2011","Chiltern 012B","E01017753","Total",1259,150,80,70,1109,57,134,337,162,91,118,210
"2011","Chiltern 012C","E01017767","Total",2170,229,126,103,1941,102,270,516,294,185,201,373
"2011","Chiltern 013A","E01017773","Total",1533,141,83,58,1392,31,262,345,178,88,195,293
"2011","Chiltern 013B","E01017774","Total",1296,98,79,19,1198,14,220,263,168,123,139,271
"2011","Chiltern 013C","E01017782","Total",1442,79,55,24,1363,23,278,353,184,148,146,231
"2011","Chiltern 013D","E01017783","Total",1468,143,69,74,1325,28,218,405,224,78,126,246
"2011","Chiltern 013E","E01017784","Total",1560,162,86,76,1398,18,234,400,214,65,144,323
"2011","Chiltern 013F","E01032609","Total",1210,160,75,85,1050,32,174,255,162,60,135,232
"2011","South Bucks 001A","E01017796","Total",1719,272,147,125,1447,60,222,339,252,105,140,329
"2011","South Bucks 001B","E01017797","Total",1513,89,59,30,1424,16,214,364,146,164,205,315
"2011","South Bucks 001C","E01017798","Total",1792,149,103,46,1643,29,366,377,206,163,223,279
"2011","South Bucks 001D","E01017799","Total",1967,223,115,108,1744,42,224,547,280,192,202,257
"2011","South Bucks 001E","E01017800","Total",1607,220,97,123,1387,86,126,553,230,107,113,172
"2011","South Bucks 001F","E01017801","Total",1624,110,56,54,1514,31,192,429,160,160,260,282
"2011","South Bucks 001G","E01017802","Total",1564,195,106,89,1369,87,216,317,172,131,166,280
"2011","South Bucks 002A","E01017818","Total",1957,144,73,71,1813,78,202,406,258,198,292,379
"2011","South Bucks 002B","E01017819","Total",1586,98,56,42,1488,21,194,321,146,220,252,334
"2011","South Bucks 002C","E01017820","Total",1497,256,169,87,1241,22,282,216,236,146,113,226
"2011","South Bucks 002D","E01017821","Total",1542,117,66,51,1425,25,182,266,176,169,264,343
"2011","South Bucks 002E","E01017822","Total",1943,72,52,20,1871,21,234,376,164,158,441,477
"2011","South Bucks 003A","E01017810","Total",1729,403,257,146,1326,106,266,290,280,43,118,223
"2011","South Bucks 003B","E01017811","Total",1132,135,80,55,997,29,228,180,160,30,88,282
"2011","South Bucks 003C","E01017812","Total",1667,170,69,101,1497,83,140,318,214,138,238,366
"2011","South Bucks 003D","E01017813","Total",1846,199,105,94,1647,54,210,326,322,85,179,471
"2011","South Bucks 004A","E01017815","Total",1783,135,79,56,1648,45,266,410,210,106,213,398
"2011","South Bucks 004B","E01017816","Total",1668,246,128,118,1422,45,182,381,246,101,147,320
"2011","South Bucks 004C","E01017817","Total",1865,182,84,98,1683,42,230,428,208,105,288,382
"2011","South Bucks 004D","E01017823","Total",1349,157,73,84,1192,47,196,344,198,88,116,203
"2011","South Bucks 005A","E01017830","Total",1822,237,118,119,1585,60,228,373,306,71,221,326
"2011","South Bucks 005B","E01017831","Total",1716,153,92,61,1563,30,250,345,180,126,299,333
"2011","South Bucks 005C","E01017832","Total",1625,151,87,64,1474,44,172,223,192,71,336,436
"2011","South Bucks 005D","E01017834","Total",1467,128,63,65,1339,43,186,233,180,73,283,341
"2011","South Bucks 005E","E01017835","Total",1698,275,112,163,1423,67,206,310,298,30,209,303
"2011","South Bucks 006A","E01017803","Total",1238,97,53,44,1141,37,208,219,186,107,136,248
"2011","South Bucks 006B","E01017806","Total",1685,130,78,52,1555,22,256,346,218,88,246,379
"2011","South Bucks 006C","E01017814","Total",1541,125,73,52,1416,30,218,321,218,67,195,367
"2011","South Bucks 006D","E01017833","Total",1641,271,113,158,1370,28,276,276,372,98,101,219
"2011","South Bucks 007A","E01017804","Total",1508,248,149,99,1260,45,212,253,208,60,169,313
"2011","South Bucks 007B","E01017805","Total",1853,232,86,146,1621,161,122,431,288,149,187,283
"2011","South Bucks 007C","E01017807","Total",1496,154,72,82,1342,64,150,352,244,98,137,297
"2011","South Bucks 007D","E01017808","Total",1480,197,64,133,1283,80,166,390,252,48,159,188
"2011","South Bucks 007E","E01017809","Total",1500,148,55,93,1352,83,104,394,230,82,212,247
"2011","South Bucks 008A","E01017824","Total",1690,197,88,109,1493,62,214,321,194,98,226,378
"2011","South Bucks 008B","E01017825","Total",1744,132,58,74,1612,60,160,426,244,84,241,397
"2011","South Bucks 008C","E01017826","Total",1506,201,121,80,1305,81,168,309,156,43,238,310
"2011","South Bucks 008D","E01017827","Total",1671,181,83,98,1490,53,182,365,224,43,256,367
"2011","South Bucks 008E","E01017828","Total",1591,210,120,90,1381,83,138,355,204,61,206,334
"2011","South Bucks 008F","E01017829","Total",1997,97,49,48,1900,31,180,330,208,99,406,646
"2011","Wycombe 001A","E01017929","Total",1532,402,267,135,1130,70,170,256,196,100,169,169
"2011","Wycombe 001B","E01017930","Total",1729,174,103,71,1555,43,296,389,288,76,118,345
"2011","Wycombe 001C","E01017931","Total",1396,167,73,94,1229,37,190,306,234,72,135,255
"2011","Wycombe 001D","E01017932","Total",1573,179,98,81,1394,30,304,272,270,102,161,255
"2011","Wycombe 001E","E01017933","Total",1724,187,141,46,1537,40,286,343,226,140,209,293
"2011","Wycombe 002A","E01017885","Total",1696,123,60,63,1573,49,284,416,274,106,159,285
"2011","Wycombe 002B","E01017886","Total",1486,149,71,78,1337,31,260,345,222,111,138,230
"2011","Wycombe 002C","E01017887","Total",1147,109,68,41,1038,19,182,269,184,90,101,193
"2011","Wycombe 002D","E01017888","Total",1712,95,50,45,1617,63,204,471,282,169,223,205
"2011","Wycombe 003A","E01017869","Total",1334,74,49,25,1260,26,242,299,176,62,132,323
"2011","Wycombe 003B","E01017870","Total",1242,68,42,26,1174,25,212,273,198,66,119,281
"2011","Wycombe 003C","E01017871","Total",1543,122,68,54,1421,18,270,319,218,88,204,304
"2011","Wycombe 003D","E01017872","Total",1643,142,97,45,1501,24,338,352,224,53,161,349
"2011","Wycombe 003E","E01017873","Total",1421,56,23,33,1365,36,180,406,242,75,126,300
"2011","Wycombe 003F","E01017874","Total",1149,109,63,46,1040,54,106,319,194,119,118,130
"2011","Wycombe 004A","E01017915","Total",1359,108,53,55,1251,68,164,289,216,89,154,271
"2011","Wycombe 004B","E01017916","Total",1179,100,37,63,1079,6,182,208,222,79,118,264
"2011","Wycombe 004C","E01017917","Total",1465,125,47,78,1340,71,136,339,250,102,139,303
"2011","Wycombe 004D","E01017918","Total",1530,255,128,127,1275,88,188,317,234,100,110,238
"2011","Wycombe 006A","E01017857","Total",1408,235,66,169,1173,98,82,197,188,135,221,252
"2011","Wycombe 006B","E01017858","Total",1395,201,16,185,1194,121,16,248,316,112,118,263
"2011","Wycombe 006C","E01017859","Total",1416,82,37,45,1334,34,150,290,182,130,176,372
"2011","Wycombe 006D","E01017860","Total",1450,93,35,58,1357,71,108,317,156,167,226,312
"2011","Wycombe 006E","E01017861","Total",1580,115,54,61,1465,40,188,469,242,82,190,254
"2011","Wycombe 006F","E01017862","Total",1880,144,73,71,1736,50,184,579,258,128,262,275
"2011","Wycombe 006G","E01017863","Total",1735,109,61,48,1626,37,238,435,210,144,190,372
"2011","Wycombe 007A","E01017842","Total",2685,200,88,112,2485,56,394,653,442,178,288,474
"2011","Wycombe 007B","E01017853","Total",1344,174,42,132,1170,50,128,292,256,125,100,219
"2011","Wycombe 007C","E01017854","Total",1282,116,45,71,1166,44,174,260,172,97,182,237
"2011","Wycombe 007D","E01017878","Total",2629,260,109,151,2369,43,444,564,410,244,284,380
"2011","Wycombe 008A","E01017920","Total",1256,106,47,59,1150,49,118,310,186,88,153,246
"2011","Wycombe 008B","E01017921","Total",1709,173,38,135,1536,103,114,292,304,78,216,429
"2011","Wycombe 008C","E01017922","Total",1641,211,73,138,1430,82,126,311,276,105,234,296
"2011","Wycombe 008D","E01017923","Total",1475,271,54,217,1204,77,76,191,264,48,184,364
"2011","Wycombe 008E","E01017924","Total",1527,97,33,64,1430,29,190,362,194,104,242,309
"2011","Wycombe 009A","E01017937","Total",1538,109,53,56,1429,30,164,441,200,142,173,279
"2011","Wycombe 009B","E01017938","Total",1360,90,43,47,1270,23,168,346,174,124,135,300
"2011","Wycombe 009C","E01017940","Total",1501,202,41,161,1299,52,122,389,354,52,111,219
"2011","Wycombe 009D","E01017942","Total",1510,122,86,36,1388,41,218,382,188,97,158,304
"2011","Wycombe 010A","E01017850","Total",1372,99,17,82,1273,99,36,250,198,149,295,246
"2011","Wycombe 010B","E01017851","Total",1709,209,79,130,1500,79,48,350,298,114,248,363
"2011","Wycombe 010C","E01017852","Total",2490,116,50,66,2374,77,132,308,146,331,724,656
"2011","Wycombe 010D","E01017919","Total",1346,248,107,141,1098,65,66,269,274,40,81,303
"2011","Wycombe 011A","E01017925","Total",2107,182,36,146,1925,141,124,358,360,219,298,425
"2011","Wycombe 011B","E01017926","Total",1500,233,67,166,1267,239,74,369,260,137,63,125
"2011","Wycombe 011C","E01017927","Total",1558,143,82,61,1415,41,162,304,218,157,269,264
"2011","Wycombe 011D","E01017928","Total",1397,219,109,110,1178,27,204,198,194,84,185,286
"2011","Wycombe 012A","E01017911","Total",1723,187,71,116,1536,152,108,368,242,169,229,268
"2011","Wycombe 012B","E01017912","Total",1388,125,32,93,1263,24,108,292,236,90,240,273
"2011","Wycombe 012C","E01017913","Total",1722,323,30,293,1399,82,42,352,246,127,266,284
"2011","Wycombe 012D","E01017914","Total",1364,110,33,77,1254,24,110,344,212,84,210,270
"2011","Wycombe 013A","E01017903","Total",1654,110,22,88,1544,67,48,203,156,176,549,345
"2011","Wycombe 013B","E01017904","Total",1746,184,25,159,1562,97,30,255,202,161,390,427
"2011","Wycombe 013C","E01017905","Total",2162,306,32,274,1856,130,52,220,326,135,408,585
"2011","Wycombe 013D","E01017906","Total",1980,53,16,37,1927,105,50,239,112,387,686,348
"2011","Wycombe 013E","E01017907","Total",1845,157,71,86,1688,114,110,300,164,239,410,351
"2011","Wycombe 014A","E01017899","Total",1656,216,104,112,1440,103,152,430,222,93,181,259
"2011","Wycombe 014B","E01017900","Total",1340,120,26,94,1220,142,90,264,224,135,138,227
"2011","Wycombe 014C","E01017901","Total",1206,110,28,82,1096,133,82,249,150,100,194,188
"2011","Wycombe 014D","E01017902","Total",1602,168,47,121,1434,218,78,322,232,123,235,226
"2011","Wycombe 015A","E01017836","Total",1657,129,32,97,1528,21,84,309,196,193,400,325
"2011","Wycombe 015B","E01017837","Total",1798,286,55,231,1512,151,78,246,286,75,196,480
"2011","Wycombe 015C","E01017838","Total",1559,93,38,55,1466,35,98,283,170,170,322,388
"2011","Wycombe 015D","E01017839","Total",1083,162,46,116,921,12,152,134,238,30,116,239
"2011","Wycombe 015E","E01017840","Total",1790,157,60,97,1633,39,162,310,264,139,293,426
"2011","Wycombe 015F","E01017841","Total",1412,76,25,51,1336,20,160,346,228,57,247,278
"2011","Wycombe 016A","E01017908","Total",2505,472,126,346,2033,209,110,546,470,177,214,307
"2011","Wycombe 016B","E01017909","Total",2182,269,39,230,1913,218,82,573,454,168,140,278
"2011","Wycombe 016C","E01017910","Total",2390,381,114,267,2009,71,164,463,512,112,229,458
"2011","Wycombe 016D","E01017941","Total",1398,257,78,179,1141,72,142,278,276,48,91,234
"2011","Wycombe 017A","E01017843","Total",1550,155,90,65,1395,41,292,299,242,40,148,333
"2011","Wycombe 017B","E01017844","Total",1647,306,168,138,1341,50,162,315,190,107,235,282
"2011","Wycombe 017C","E01017845","Total",1578,253,109,144,1325,55,146,292,282,99,191,260
"2011","Wycombe 017D","E01017855","Total",1435,169,87,82,1266,64,194,377,246,41,124,220
"2011","Wycombe 017E","E01017856","Total",1411,131,61,70,1280,91,112,249,206,192,179,251
"2011","Wycombe 018A","E01017864","Total",1339,89,50,39,1250,22,246,325,186,51,129,291
"2011","Wycombe 018B","E01017865","Total",1543,125,84,41,1418,19,288,350,202,72,181,306
"2011","Wycombe 018C","E01017867","Total",1545,160,99,61,1385,110,166,365,182,127,174,261
"2011","Wycombe 018D","E01017868","Total",1533,176,97,79,1357,37,274,338,204,83,171,250
"2011","Wycombe 019A","E01017934","Total",1737,260,74,186,1477,120,118,431,258,107,178,265
"2011","Wycombe 019B","E01017935","Total",1939,290,97,193,1649,111,160,541,398,62,129,248
"2011","Wycombe 019C","E01017936","Total",1554,171,94,77,1383,48,230,320,214,83,143,345
"2011","Wycombe 019D","E01017939","Total",1365,134,37,97,1231,82,142,289,238,89,136,255
"2011","Wycombe 020A","E01017866","Total",1438,162,82,80,1276,11,220,294,244,85,171,251
"2011","Wycombe 020B","E01017875","Total",1523,88,32,56,1435,29,156,517,206,164,202,161
"2011","Wycombe 020C","E01017876","Total",2076,122,71,51,1954,32,260,649,320,118,212,363
"2011","Wycombe 020D","E01017877","Total",1673,122,75,47,1551,55,270,352,234,189,203,248
"2011","Wycombe 021A","E01017846","Total",1387,238,127,111,1149,87,204,169,194,82,146,267
"2011","Wycombe 021B","E01017847","Total",1493,233,113,120,1260,53,234,364,216,66,113,214
"2011","Wycombe 021C","E01017848","Total",1190,96,66,30,1094,20,204,281,164,50,88,287
"2011","Wycombe 021D","E01017849","Total",1397,238,80,158,1159,35,174,290,302,65,96,197
"2011","Wycombe 022A","E01017889","Total",1301,152,67,85,1149,54,96,287,188,105,116,303
"2011","Wycombe 022B","E01017890","Total",1307,80,49,31,1227,19,206,337,182,95,143,245
"2011","Wycombe 022C","E01017891","Total",1432,207,132,75,1225,41,192,382,208,71,116,215
"2011","Wycombe 022D","E01017892","Total",1584,103,66,37,1481,44,340,417,162,130,166,222
"2011","Wycombe 022E","E01017893","Total",1553,363,206,157,1190,80,164,239,306,58,114,229
"2011","Wycombe 022F","E01017894","Total",1539,181,97,84,1358,45,242,396,242,110,108,215
"2011","Wycombe 023A","E01017895","Total",1317,240,110,130,1077,57,124,315,206,68,119,188
"2011","Wycombe 023B","E01017896","Total",1409,190,96,94,1219,48,262,325,216,65,104,199
"2011","Wycombe 023C","E01017897","Total",1568,166,67,99,1402,60,154,360,288,98,189,253
"2011","Wycombe 023D","E01017898","Total",1224,123,37,86,1101,85,64,281,238,85,101,247
"2011","Wycombe 024A","E01017880","Total",1423,64,37,27,1359,28,208,395,202,108,164,254
"2011","Wycombe 024B","E01017881","Total",1803,146,96,50,1657,52,288,424,222,135,174,362
"2011","Wycombe 024C","E01017882","Total",1619,150,76,74,1469,45,202,422,216,95,179,310
"2011","Wycombe 024D","E01017883","Total",1639,133,67,66,1506,67,182,354,252,152,236,263
"2011","Wycombe 024E","E01017884","Total",1442,221,145,76,1221,55,152,377,192,88,121,236
"2011","Wycombe 024F","E01032610","Total",1623,147,77,70,1476,66,254,376,192,82,164,342
"2011","Eastbourne 001A","E01020924","Total",1417,120,53,67,1297,77,184,234,214,87,220,281
"2011","Eastbourne 001B","E01020925","Total",1523,181,57,124,1342,166,86,238,182,122,242,306
"2011","Eastbourne 001C","E01020927","Total",1503,126,44,82,1377,119,122,315,198,138,224,261
"2011","Eastbourne 001D","E01020928","Total",1556,287,178,109,1269,78,352,247,304,31,108,149
"2011","Eastbourne 001E","E01020930","Total",1480,76,22,54,1404,167,48,283,154,116,280,356
"2011","Eastbourne 002A","E01020917","Total",1501,179,63,116,1322,160,66,267,186,204,159,280
"2011","Eastbourne 002B","E01020918","Total",1616,132,62,70,1484,175,132,328,268,132,208,241
"2011","Eastbourne 002C","E01020919","Total",1543,101,54,47,1442,110,162,364,236,129,199,242
"2011","Eastbourne 002D","E01020923","Total",1452,177,55,122,1275,173,76,250,162,176,173,265
"2011","Eastbourne 002E","E01020949","Total",1577,172,101,71,1405,103,290,256,248,57,133,318
"2011","Eastbourne 003A","E01020926","Total",1613,102,49,53,1511,73,232,256,232,107,240,371
"2011","Eastbourne 003B","E01020929","Total",1601,289,139,150,1312,155,202,291,198,131,136,199
"2011","Eastbourne 003C","E01020955","Total",1498,252,117,135,1246,147,204,284,230,61,153,167
"2011","Eastbourne 003D","E01020956","Total",1567,291,203,88,1276,41,522,187,246,26,77,177
"2011","Eastbourne 003E","E01020957","Total",1492,204,126,78,1288,143,246,241,186,94,120,258
"2011","Eastbourne 004A","E01020920","Total",1471,333,148,185,1138,118,182,289,206,74,114,155
"2011","Eastbourne 004B","E01020921","Total",1418,166,82,84,1252,87,192,267,198,70,162,276
"2011","Eastbourne 004C","E01020922","Total",1449,165,76,89,1284,144,144,260,196,111,184,245
"2011","Eastbourne 004D","E01020945","Total",1829,197,135,62,1632,46,462,327,234,60,135,368
"2011","Eastbourne 004E","E01020950","Total",1623,205,131,74,1418,69,402,225,224,79,102,317
"2011","Eastbourne 006A","E01020940","Total",1493,150,117,33,1343,30,298,255,154,147,165,294
"2011","Eastbourne 006B","E01020941","Total",1693,162,79,83,1531,176,142,332,202,129,239,311
"2011","Eastbourne 006C","E01020942","Total",1560,157,82,75,1403,76,180,321,212,135,167,312
"2011","Eastbourne 006D","E01020946","Total",1647,172,117,55,1475,34,426,257,274,57,123,304
"2011","Eastbourne 006E","E01020947","Total",1481,291,128,163,1190,64,282,285,166,56,109,228
"2011","Eastbourne 007A","E01020914","Total",1934,231,84,147,1703,149,140,390,358,113,203,350
"2011","Eastbourne 007B","E01020915","Total",1698,361,201,160,1337,131,192,366,250,63,139,196
"2011","Eastbourne 007C","E01020952","Total",1765,255,131,124,1510,129,152,345,220,95,249,320
"2011","Eastbourne 007D","E01020953","Total",1522,113,53,60,1409,50,158,331,218,119,216,317
"2011","Eastbourne 007E","E01020954","Total",1765,104,46,58,1661,58,186,452,168,160,238,399
"2011","Eastbourne 008A","E01020948","Total",1432,352,208,144,1080,15,366,190,148,36,125,200
"2011","Eastbourne 008B","E01020963","Total",1562,169,60,109,1393,65,186,277,236,117,226,286
"2011","Eastbourne 008C","E01020965","Total",1745,565,192,373,1180,65,136,187,454,33,97,208
"2011","Eastbourne 008D","E01020966","Total",1464,474,192,282,990,22,192,164,298,25,88,201
"2011","Eastbourne 009A","E01020938","Total",1568,169,86,83,1399,73,170,428,170,112,150,296
"2011","Eastbourne 009B","E01020939","Total",1577,193,100,93,1384,111,142,336,240,134,160,261
"2011","Eastbourne 009C","E01020943","Total",1593,280,123,157,1313,133,166,365,250,45,136,218
"2011","Eastbourne 009D","E01020964","Total",1614,429,247,182,1185,88,230,277,296,42,59,193
"2011","Eastbourne 009E","E01020967","Total",1689,546,353,193,1143,40,330,164,278,46,103,182
"2011","Eastbourne 010A","E01020910","Total",1670,385,143,242,1285,123,110,299,286,45,142,280
"2011","Eastbourne 010B","E01020911","Total",1960,444,87,357,1516,111,68,281,388,64,125,479
"2011","Eastbourne 010C","E01020912","Total",2026,528,90,438,1498,118,88,289,410,66,105,422
"2011","Eastbourne 010D","E01020916","Total",1686,255,99,156,1431,164,112,355,354,62,103,281
"2011","Eastbourne 011A","E01020935","Total",1843,556,189,367,1287,94,172,244,468,31,45,233
"2011","Eastbourne 011B","E01020936","Total",1613,570,340,230,1043,38,420,81,304,5,38,157
"2011","Eastbourne 011C","E01020937","Total",1277,394,148,246,883,44,166,163,292,54,55,109
"2011","Eastbourne 011D","E01020968","Total",1588,491,224,267,1097,53,174,258,336,46,74,156
"2011","Eastbourne 012A","E01020931","Total",1407,419,255,164,988,38,338,128,268,56,44,116
"2011","Eastbourne 012B","E01020932","Total",1319,461,346,115,858,32,488,73,134,15,24,92
"2011","Eastbourne 012C","E01020933","Total",909,140,82,58,769,22,252,157,124,37,74,103
"2011","Eastbourne 012D","E01020934","Total",1215,318,197,121,897,32,294,174,210,18,24,145
"2011","Eastbourne 012E","E01020944","Total",1483,125,73,52,1358,56,286,306,200,53,140,317
"2011","Eastbourne 013A","E01020913","Total",2112,344,161,183,1768,216,216,382,358,148,163,285
"2011","Eastbourne 013B","E01020951","Total",1513,223,105,118,1290,58,138,294,218,133,178,271
"2011","Eastbourne 013C","E01020959","Total",1429,180,121,59,1249,62,226,353,172,81,145,210
"2011","Eastbourne 013D","E01020961","Total",1412,178,121,57,1234,20,408,209,188,52,96,261
"2011","Eastbourne 013E","E01020962","Total",2004,335,166,169,1669,96,374,368,380,74,132,245
"2011","Eastbourne 014A","E01020960","Total",2455,417,144,273,2038,149,320,501,478,135,165,290
"2011","Eastbourne 014B","E01032831","Total",1578,177,56,121,1401,61,274,372,306,67,118,203
"2011","Eastbourne 014C","E01032832","Total",1600,183,53,130,1417,184,180,284,274,133,167,195
"2011","Eastbourne 014D","E01032833","Total",1338,247,37,210,1091,78,152,261,350,47,45,158
"2011","Hastings 001A","E01020969","Total",1476,200,105,95,1276,44,270,254,228,67,142,271
"2011","Hastings 001B","E01020970","Total",2677,192,69,123,2485,62,314,579,374,179,434,543
"2011","Hastings 001C","E01020971","Total",2037,226,97,129,1811,132,220,388,320,147,239,365
"2011","Hastings 001D","E01020987","Total",1797,209,56,153,1588,131,102,464,324,117,195,255
"2011","Hastings 002A","E01020974","Total",1428,146,95,51,1282,59,310,214,182,74,147,296
"2011","Hastings 002B","E01020986","Total",1402,122,68,54,1280,75,274,228,238,83,143,239
"2011","Hastings 002C","E01020988","Total",1683,194,134,60,1489,28,412,267,250,72,166,294
"2011","Hastings 002D","E01021007","Total",1442,190,130,60,1252,18,348,177,266,64,105,274
"2011","Hastings 002E","E01021008","Total",1583,352,233,119,1231,61,258,259,222,46,174,211
"2011","Hastings 002F","E01021009","Total",1935,197,114,83,1738,60,348,437,286,108,185,314
"2011","Hastings 003A","E01020993","Total",1343,211,78,133,1132,173,100,189,190,98,141,241
"2011","Hastings 003B","E01020994","Total",1533,138,46,92,1395,171,146,273,216,178,222,189
"2011","Hastings 003C","E01020995","Total",1431,179,69,110,1252,105,126,246,210,172,151,242
"2011","Hastings 003D","E01020996","Total",1784,91,25,66,1693,188,140,389,256,167,196,357
"2011","Hastings 003E","E01021019","Total",1607,400,173,227,1207,87,194,234,250,108,158,176
"2011","Hastings 004A","E01021004","Total",1729,237,115,122,1492,112,268,244,288,127,174,279
"2011","Hastings 004B","E01021005","Total",1617,199,88,111,1418,201,168,257,156,107,283,246
"2011","Hastings 004C","E01021006","Total",1787,286,102,184,1501,159,184,376,368,102,84,228
"2011","Hastings 004D","E01021013","Total",1811,181,63,118,1630,170,124,403,312,122,223,276
"2011","Hastings 005A","E01020972","Total",1549,242,87,155,1307,255,84,214,176,178,191,209
"2011","Hastings 005B","E01020973","Total",1752,186,110,76,1566,117,222,360,256,160,211,240
"2011","Hastings 005C","E01020977","Total",1588,305,65,240,1283,203,78,266,266,102,185,183
"2011","Hastings 005D","E01021015","Total",1606,228,68,160,1378,305,78,316,190,181,106,202
"2011","Hastings 006A","E01021010","Total",1582,157,78,79,1425,65,212,318,214,64,236,316
"2011","Hastings 006B","E01021011","Total",1560,189,70,119,1371,115,122,361,258,95,201,219
"2011","Hastings 006C","E01021012","Total",1624,325,162,163,1299,77,166,279,274,81,173,249
"2011","Hastings 006D","E01021020","Total",1850,202,114,88,1648,180,216,303,226,196,242,285
"2011","Hastings 006E","E01021021","Total",1865,260,90,170,1605,146,214,304,366,107,190,278
"2011","Hastings 007A","E01021000","Total",1485,220,68,152,1265,91,134,307,228,101,205,199
"2011","Hastings 007B","E01021001","Total",1237,134,57,77,1103,118,112,233,182,72,150,236
"2011","Hastings 007C","E01021002","Total",1423,221,73,148,1202,90,184,249,226,82,164,207
"2011","Hastings 007D","E01021003","Total",1619,494,166,328,1125,102,222,176,338,47,61,179
"2011","Hastings 007E","E01021014","Total",1884,253,76,177,1631,256,132,432,288,112,204,207
"2011","Hastings 008A","E01020975","Total",1730,369,145,224,1361,84,134,340,306,102,143,252
"2011","Hastings 008B","E01020976","Total",1892,301,121,180,1591,83,250,336,370,81,187,284
"2011","Hastings 008C","E01020990","Total",1619,252,59,193,1367,161,74,361,244,78,189,260
"2011","Hastings 008D","E01020991","Total",1274,305,72,233,969,73,128,224,246,33,91,174
"2011","Hastings 008E","E01020992","Total",1826,415,85,330,1411,174,90,298,320,108,162,259
"2011","Hastings 009A","E01020978","Total",1941,635,152,483,1306,156,78,284,366,106,116,200
"2011","Hastings 009B","E01020979","Total",1796,781,169,612,1015,143,88,186,338,38,91,131
"2011","Hastings 009C","E01020980","Total",1577,386,89,297,1191,132,82,261,332,78,139,167
"2011","Hastings 009D","E01020981","Total",1602,248,52,196,1354,73,134,317,286,142,192,210
"2011","Hastings 010A","E01020997","Total",1557,166,71,95,1391,97,156,351,258,131,158,240
"2011","Hastings 010B","E01020998","Total",1676,507,157,350,1169,88,146,229,346,66,147,147
"2011","Hastings 010C","E01020999","Total",1646,226,125,101,1420,62,308,294,266,116,131,243
"2011","Hastings 010D","E01021016","Total",1581,296,121,175,1285,142,166,248,286,58,186,199
"2011","Hastings 010E","E01021017","Total",1604,175,63,112,1429,96,146,319,272,74,191,331
"2011","Hastings 010F","E01021018","Total",1915,150,62,88,1765,71,254,421,252,57,310,400
"2011","Hastings 011A","E01020982","Total",1656,665,102,563,991,177,50,197,298,38,93,138
"2011","Hastings 011B","E01020983","Total",1598,676,249,427,922,123,124,133,288,74,71,109
"2011","Hastings 011C","E01020984","Total",1941,680,147,533,1261,123,120,269,462,61,75,151
"2011","Hastings 011D","E01020985","Total",1779,668,144,524,1111,105,130,236,330,70,118,122
"2011","Hastings 011E","E01020989","Total",1626,514,75,439,1112,130,84,303,316,63,104,112
"2011","Lewes 001A","E01021022","Total",2097,178,91,87,1919,87,320,503,324,155,237,293
"2011","Lewes 001B","E01021024","Total",1204,111,56,55,1093,102,124,266,202,35,122,242
"2011","Lewes 001C","E01021025","Total",1808,106,47,59,1702,58,268,434,290,155,204,293
"2011","Lewes 001D","E01021052","Total",1245,122,89,33,1123,33,200,260,202,72,118,238
"2011","Lewes 001E","E01021053","Total",1186,121,77,44,1065,46,202,253,148,73,110,233
"2011","Lewes 002A","E01021023","Total",1968,160,78,82,1808,60,226,433,284,158,211,436
"2011","Lewes 002B","E01021026","Total",2256,293,191,102,1963,50,516,457,280,174,178,308
"2011","Lewes 002C","E01021032","Total",2037,212,128,84,1825,56,362,380,300,117,277,333
"2011","Lewes 002D","E01021067","Total",1123,108,64,44,1015,15,124,264,166,36,115,295
"2011","Lewes 002E","E01021068","Total",1067,118,48,70,949,40,120,235,174,51,114,215
"2011","Lewes 003A","E01021033","Total",1751,298,143,155,1453,92,200,376,272,96,159,258
"2011","Lewes 003B","E01021034","Total",1317,159,55,104,1158,95,106,310,208,46,143,250
"2011","Lewes 003C","E01021035","Total",1710,426,175,251,1284,100,174,247,420,26,131,186
"2011","Lewes 003D","E01021036","Total",1455,196,92,104,1259,60,206,332,208,112,123,218
"2011","Lewes 003E","E01021037","Total",1595,181,74,107,1414,114,90,354,200,95,267,294
"2011","Lewes 003F","E01021038","Total",1719,309,130,179,1410,95,158,384,346,79,111,237
"2011","Lewes 004A","E01021054","Total",1447,141,75,66,1306,36,206,280,246,68,148,322
"2011","Lewes 004B","E01021055","Total",1747,237,174,63,1510,67,290,386,234,90,171,272
"2011","Lewes 004C","E01021056","Total",1642,198,112,86,1444,52,330,293,258,114,116,281
"2011","Lewes 004D","E01021057","Total",1525,207,111,96,1318,120,196,300,274,63,120,245
"2011","Lewes 005A","E01021039","Total",1423,235,107,128,1188,72,180,308,252,127,133,116
"2011","Lewes 005B","E01021040","Total",1426,270,121,149,1156,76,152,343,212,94,97,182
"2011","Lewes 005C","E01021041","Total",1567,178,123,55,1389,72,268,332,150,124,177,266
"2011","Lewes 005D","E01021042","Total",1346,97,54,43,1249,58,148,344,152,106,161,280
"2011","Lewes 005E","E01021043","Total",1607,138,57,81,1469,175,116,464,202,121,129,262
"2011","Lewes 006A","E01021027","Total",1557,170,91,79,1387,48,268,317,226,92,180,256
"2011","Lewes 006B","E01021028","Total",1614,118,58,60,1496,99,164,383,224,86,190,350
"2011","Lewes 006C","E01021029","Total",1530,135,70,65,1395,76,198,305,218,92,146,360
"2011","Lewes 006D","E01021030","Total",1225,213,138,75,1012,56,176,216,186,61,147,170
"2011","Lewes 006E","E01021031","Total",1449,304,150,154,1145,40,170,250,268,75,122,220
"2011","Lewes 007A","E01021061","Total",1546,104,48,56,1442,81,170,354,232,40,243,322
"2011","Lewes 007B","E01021063","Total",1703,175,85,90,1528,90,224,353,248,73,178,362
"2011","Lewes 007C","E01021064","Total",1608,322,179,143,1286,63,330,232,276,46,105,234
"2011","Lewes 007D","E01021065","Total",1189,326,168,158,863,83,164,196,198,56,45,121
"2011","Lewes 007E","E01021066","Total",1539,158,108,50,1381,91,294,230,224,73,140,329
"2011","Lewes 008A","E01021045","Total",1794,286,166,120,1508,86,400,261,264,90,160,247
"2011","Lewes 008B","E01021046","Total",1474,121,74,47,1353,73,212,333,244,65,149,277
"2011","Lewes 008C","E01021047","Total",1416,158,80,78,1258,95,194,282,234,31,121,301
"2011","Lewes 008D","E01021048","Total",1551,267,93,174,1284,125,156,325,286,27,116,249
"2011","Lewes 009A","E01021044","Total",1919,168,65,103,1751,195,136,390,258,209,272,291
"2011","Lewes 009B","E01021049","Total",1431,286,95,191,1145,125,80,289,256,79,122,194
"2011","Lewes 009C","E01021050","Total",1349,143,55,88,1206,109,106,286,196,109,140,260
"2011","Lewes 009D","E01021051","Total",1229,141,63,78,1088,54,142,300,228,67,121,176
"2011","Lewes 010A","E01021058","Total",1829,221,123,98,1608,121,260,349,306,101,153,318
"2011","Lewes 010B","E01021059","Total",1502,228,147,81,1274,77,308,205,262,61,100,261
"2011","Lewes 010C","E01021060","Total",1598,205,116,89,1393,82,302,236,264,83,179,247
"2011","Lewes 010D","E01021062","Total",1453,183,53,130,1270,105,172,242,218,96,212,225
"2011","Lewes 011A","E01021069","Total",1505,194,121,73,1311,42,292,285,200,68,102,322
"2011","Lewes 011B","E01021075","Total",1793,163,110,53,1630,86,370,390,252,132,133,267
"2011","Lewes 011C","E01021077","Total",1443,212,160,52,1231,37,290,223,208,63,141,269
"2011","Lewes 011D","E01021081","Total",1510,271,176,95,1239,29,354,161,268,50,145,232
"2011","Lewes 011E","E01021082","Total",1592,245,166,79,1347,12,446,227,308,51,69,234
"2011","Lewes 011F","E01021083","Total",1376,107,73,34,1269,41,360,154,196,108,119,291
"2011","Lewes 012A","E01021072","Total",1532,189,159,30,1343,20,544,182,216,43,96,242
"2011","Lewes 012B","E01021073","Total",1476,175,131,44,1301,27,304,259,202,89,185,235
"2011","Lewes 012C","E01021074","Total",1656,255,161,94,1401,102,330,262,260,99,136,212
"2011","Lewes 012D","E01021076","Total",1894,224,119,105,1670,145,242,354,258,109,261,301
"2011","Lewes 012E","E01021078","Total",1276,114,88,26,1162,32,320,201,224,67,95,223
"2011","Lewes 013A","E01021070","Total",1529,359,194,165,1170,87,188,246,280,66,80,223
"2011","Lewes 013B","E01021071","Total",1673,497,185,312,1176,117,228,227,380,26,42,156
"2011","Lewes 013C","E01021079","Total",1485,323,195,128,1162,74,274,228,228,51,97,210
"2011","Lewes 013D","E01021080","Total",1367,185,119,66,1182,45,226,244,220,37,169,241
"2011","Rother 001A","E01021132","Total",1200,124,74,50,1076,23,214,272,150,90,118,209
"2011","Rother 001B","E01021133","Total",1619,201,83,118,1418,73,214,339,312,119,111,250
"2011","Rother 001C","E01021134","Total",1481,149,68,81,1332,74,158,333,226,101,132,308
"2011","Rother 001D","E01021139","Total",1316,188,118,70,1128,82,186,279,162,148,148,123
"2011","Rother 001E","E01021140","Total",1750,149,77,72,1601,41,244,371,282,158,201,304
"2011","Rother 001F","E01021141","Total",1541,116,60,56,1425,43,204,376,216,155,165,266
"2011","Rother 002A","E01021103","Total",1474,207,114,93,1267,57,308,199,252,85,152,214
"2011","Rother 002B","E01021114","Total",1523,210,119,91,1313,57,334,231,232,88,159,212
"2011","Rother 002C","E01021115","Total",1546,202,120,82,1344,22,388,238,302,62,99,233
"2011","Rother 002D","E01021116","Total",1499,213,128,85,1286,71,232,229,256,79,133,286
"2011","Rother 003A","E01021098","Total",1656,193,98,95,1463,54,304,294,310,111,161,229
"2011","Rother 003B","E01021099","Total",1594,174,91,83,1420,26,282,322,282,79,147,282
"2011","Rother 003C","E01021100","Total",1754,126,55,71,1628,72,244,304,262,131,300,315
"2011","Rother 003D","E01021104","Total",1355,166,81,85,1189,45,252,220,212,77,166,217
"2011","Rother 003E","E01021105","Total",1212,188,95,93,1024,55,208,192,168,83,121,197
"2011","Rother 004A","E01021101","Total",1719,294,198,96,1425,81,382,195,280,97,122,268
"2011","Rother 004B","E01021102","Total",1607,282,136,146,1325,94,246,211,264,73,171,266
"2011","Rother 004C","E01021117","Total",1577,313,167,146,1264,52,294,231,282,70,137,198
"2011","Rother 004D","E01021118","Total",1557,291,162,129,1266,52,284,222,256,62,171,219
"2011","Rother 004E","E01021119","Total",1092,210,121,89,882,79,144,182,134,88,99,156
"2011","Rother 005A","E01021087","Total",1612,179,99,80,1433,30,324,243,266,77,208,285
"2011","Rother 005B","E01021088","Total",1488,181,123,58,1307,33,340,167,272,36,152,307
"2011","Rother 005C","E01021089","Total",1533,172,107,65,1361,75,252,253,218,86,191,286
"2011","Rother 005D","E01021109","Total",1571,181,102,79,1390,43,362,216,256,48,191,274
"2011","Rother 005E","E01021110","Total",2242,327,209,118,1915,35,686,225,436,51,160,322
"2011","Rother 006A","E01021084","Total",1847,437,258,179,1410,160,218,297,238,106,172,219
"2011","Rother 006B","E01021085","Total",1696,167,95,72,1529,67,276,373,238,111,185,279
"2011","Rother 006C","E01021086","Total",1689,198,122,76,1491,81,296,344,214,88,202,266
"2011","Rother 006D","E01021096","Total",1226,109,60,49,1117,29,180,198,210,116,172,212
"2011","Rother 006E","E01021097","Total",1332,102,53,49,1230,39,256,265,200,99,159,212
"2011","Rother 007A","E01021111","Total",929,266,175,91,663,53,182,106,122,39,56,105
"2011","Rother 007B","E01021113","Total",1394,193,108,85,1201,100,172,281,172,122,142,212
"2011","Rother 007C","E01021131","Total",1687,160,50,110,1527,158,126,399,164,128,264,288
"2011","Rother 007D","E01021135","Total",1836,226,95,131,1610,229,164,301,192,294,203,227
"2011","Rother 007E","E01021136","Total",1317,225,118,107,1092,156,124,214,120,167,124,187
"2011","Rother 007F","E01021137","Total",1468,178,99,79,1290,124,172,250,224,99,193,228
"2011","Rother 008A","E01021112","Total",1385,209,128,81,1176,38,298,227,198,69,145,201
"2011","Rother 008B","E01021120","Total",1251,405,324,81,846,27,356,95,134,43,64,127
"2011","Rother 008C","E01021126","Total",1318,250,128,122,1068,70,254,219,204,44,115,162
"2011","Rother 008D","E01021127","Total",1563,192,118,74,1371,106,262,262,266,88,146,241
"2011","Rother 008E","E01021128","Total",1825,275,179,96,1550,76,354,288,302,83,183,264
"2011","Rother 009A","E01021093","Total",1481,184,130,54,1297,25,458,162,238,53,141,220
"2011","Rother 009B","E01021095","Total",1291,184,142,42,1107,17,460,120,176,37,118,179
"2011","Rother 009C","E01021123","Total",1545,199,157,42,1346,27,462,216,198,57,133,253
"2011","Rother 009D","E01021124","Total",1674,271,196,75,1403,26,524,187,250,58,126,232
"2011","Rother 009E","E01021125","Total",1194,154,111,43,1040,22,340,113,202,58,119,186
"2011","Rother 009F","E01021129","Total",1789,204,133,71,1585,47,470,244,308,80,176,260
"2011","Rother 009G","E01021138","Total",1039,143,89,54,896,18,242,135,168,38,122,173
"2011","Rother 010A","E01021094","Total",1492,393,303,90,1099,32,448,119,198,21,85,196
"2011","Rother 010B","E01021106","Total",1658,374,298,76,1284,19,544,122,232,89,90,188
"2011","Rother 010C","E01021107","Total",1549,221,184,37,1328,12,532,197,200,69,120,198
"2011","Rother 010D","E01021108","Total",1433,191,99,92,1242,70,242,288,208,83,92,259
"2011","Rother 010E","E01021130","Total",1416,252,151,101,1164,58,288,209,222,54,132,201
"2011","Rother 011A","E01021090","Total",1666,337,108,229,1329,183,136,235,268,173,134,200
"2011","Rother 011B","E01021091","Total",1852,601,248,353,1251,122,214,259,342,60,67,187
"2011","Rother 011C","E01021092","Total",1934,674,358,316,1260,94,268,252,264,51,107,224
"2011","Rother 011D","E01021121","Total",1549,348,188,160,1201,62,290,209,304,36,103,197
"2011","Rother 011E","E01021122","Total",1306,531,274,257,775,65,198,148,248,22,9,85
"2011","Wealden 001A","E01021167","Total",2186,304,155,149,1882,165,246,435,296,112,239,389
"2011","Wealden 001B","E01021168","Total",1669,159,76,83,1510,65,254,365,218,92,164,352
"2011","Wealden 001C","E01021169","Total",1270,105,46,59,1165,42,168,240,182,66,204,263
"2011","Wealden 001D","E01021186","Total",1205,126,60,66,1079,37,188,264,190,85,85,230
"2011","Wealden 002A","E01021171","Total",2050,187,99,88,1863,76,268,486,292,150,204,387
"2011","Wealden 002B","E01021172","Total",1802,173,91,82,1629,71,278,455,242,163,152,268
"2011","Wealden 002C","E01021173","Total",1412,110,45,65,1302,32,208,290,232,141,193,206
"2011","Wealden 002D","E01021218","Total",1143,108,54,54,1035,31,212,219,188,62,126,197
"2011","Wealden 003A","E01021156","Total",1786,222,147,75,1564,65,214,447,294,120,169,255
"2011","Wealden 003B","E01021157","Total",1829,161,106,55,1668,43,324,333,266,129,203,370
"2011","Wealden 003C","E01021158","Total",2186,160,82,78,2026,80,314,538,304,155,261,374
"2011","Wealden 004A","E01021159","Total",2230,207,142,65,2023,29,480,310,362,109,260,473
"2011","Wealden 004B","E01021160","Total",1507,281,169,112,1226,49,290,241,248,89,82,227
"2011","Wealden 004C","E01021161","Total",1570,185,83,102,1385,77,230,361,220,76,140,281
"2011","Wealden 004D","E01021162","Total",1557,131,77,54,1426,33,318,294,244,71,155,311
"2011","Wealden 005A","E01021202","Total",1039,207,130,77,832,33,190,211,182,38,56,122
"2011","Wealden 005B","E01021203","Total",1484,157,78,79,1327,27,288,280,202,107,138,285
"2011","Wealden 005C","E01021229","Total",1669,188,91,97,1481,53,224,412,258,102,159,273
"2011","Wealden 005D","E01021230","Total",1723,153,84,69,1570,60,268,386,240,131,196,289
"2011","Wealden 005E","E01021231","Total",1727,260,158,102,1467,82,240,354,238,118,164,271
"2011","Wealden 006A","E01021151","Total",1769,127,64,63,1642,77,204,377,294,131,226,333
"2011","Wealden 006B","E01021152","Total",1270,130,67,63,1140,75,152,248,144,74,216,231
"2011","Wealden 006C","E01021153","Total",1963,285,122,163,1678,107,162,453,346,107,210,293
"2011","Wealden 006D","E01021154","Total",1472,156,61,95,1316,83,168,366,210,78,141,270
"2011","Wealden 006E","E01021155","Total",1163,112,40,72,1051,75,92,305,220,52,92,215
"2011","Wealden 007A","E01021163","Total",2031,187,114,73,1844,20,384,411,320,112,201,396
"2011","Wealden 007B","E01021164","Total",1791,204,86,118,1587,80,274,428,318,136,135,216
"2011","Wealden 007C","E01021187","Total",1401,124,56,68,1277,32,258,286,226,68,125,282
"2011","Wealden 008A","E01021144","Total",1779,125,75,50,1654,32,254,412,306,154,170,326
"2011","Wealden 008B","E01021145","Total",1933,208,109,99,1725,42,316,370,348,120,180,349
"2011","Wealden 008C","E01021170","Total",2727,222,107,115,2505,87,464,518,496,171,289,480
"2011","Wealden 008D","E01021217","Total",1286,149,91,58,1137,10,232,287,170,99,105,234
"2011","Wealden 009A","E01021219","Total",1350,105,69,36,1245,32,212,316,238,62,100,285
"2011","Wealden 009B","E01021220","Total",1615,311,191,120,1304,57,250,323,274,55,120,225
"2011","Wealden 009C","E01021223","Total",1121,157,80,77,964,49,146,231,184,50,103,201
"2011","Wealden 009D","E01021224","Total",1472,220,117,103,1252,89,130,240,214,151,156,272
"2011","Wealden 009E","E01021225","Total",1550,169,82,87,1381,79,240,400,276,66,107,213
"2011","Wealden 009F","E01021226","Total",1371,108,44,64,1263,103,88,322,236,104,171,239
"2011","Wealden 010A","E01021150","Total",1154,76,47,29,1078,3,200,260,168,96,113,238
"2011","Wealden 010B","E01021191","Total",1617,350,168,182,1267,68,284,266,304,30,107,208
"2011","Wealden 010C","E01021192","Total",1587,166,87,79,1421,62,212,385,222,87,109,344
"2011","Wealden 010D","E01021193","Total",1722,250,142,108,1472,98,206,304,272,114,210,268
"2011","Wealden 010E","E01021194","Total",1619,144,77,67,1475,106,164,445,210,137,178,235
"2011","Wealden 011A","E01021149","Total",1218,153,75,78,1065,35,178,232,204,56,117,243
"2011","Wealden 011B","E01021189","Total",1339,104,49,55,1235,19,184,284,228,102,175,243
"2011","Wealden 011C","E01021190","Total",1524,156,87,69,1368,26,280,273,266,107,139,277
"2011","Wealden 011D","E01021200","Total",1100,188,111,77,912,66,144,203,154,32,106,207
"2011","Wealden 011E","E01021201","Total",1477,135,82,53,1342,41,258,301,234,88,186,234
"2011","Wealden 012A","E01021221","Total",1270,160,57,103,1110,66,138,305,216,50,132,203
"2011","Wealden 012B","E01021222","Total",1506,250,118,132,1256,53,126,346,282,78,151,220
"2011","Wealden 012C","E01021227","Total",1639,103,37,66,1536,86,140,433,264,85,193,335
"2011","Wealden 012D","E01021228","Total",1513,114,51,63,1399,72,164,358,208,95,212,290
"2011","Wealden 013A","E01021146","Total",1737,143,79,64,1594,64,298,326,248,145,177,336
"2011","Wealden 013B","E01021147","Total",1643,145,61,84,1498,43,210,309,232,91,213,400
"2011","Wealden 013C","E01021148","Total",1496,132,66,66,1364,74,200,280,242,121,156,291
"2011","Wealden 013D","E01021165","Total",1187,75,42,33,1112,23,168,230,206,125,98,262
"2011","Wealden 014A","E01021188","Total",1136,119,58,61,1017,29,194,213,180,91,78,232
"2011","Wealden 014B","E01021198","Total",1516,194,96,98,1322,93,208,286,192,117,156,270
"2011","Wealden 014C","E01021199","Total",1306,152,85,67,1154,30,288,217,232,60,135,192
"2011","Wealden 014D","E01021204","Total",1203,135,87,48,1068,61,146,266,180,82,111,222
"2011","Wealden 014E","E01021205","Total",1192,114,58,56,1078,20,214,167,198,65,179,235
"2011","Wealden 015A","E01021174","Total",1623,149,84,65,1474,67,272,341,218,93,190,293
"2011","Wealden 015B","E01021175","Total",1460,166,95,71,1294,39,288,323,216,93,114,221
"2011","Wealden 015C","E01021176","Total",1403,234,160,74,1169,30,276,207,206,85,168,197
"2011","Wealden 015D","E01021177","Total",1077,268,152,116,809,55,172,159,202,25,62,134
"2011","Wealden 016A","E01021180","Total",1222,130,66,64,1092,59,256,233,212,50,96,186
"2011","Wealden 016B","E01021181","Total",1298,126,72,54,1172,41,232,333,146,82,126,212
"2011","Wealden 016C","E01021182","Total",1567,218,150,68,1349,48,300,230,170,130,147,324
"2011","Wealden 016D","E01021183","Total",1341,157,59,98,1184,168,110,278,158,145,140,185
"2011","Wealden 017A","E01021178","Total",1393,131,81,50,1262,129,204,298,142,130,137,222
"2011","Wealden 017B","E01021179","Total",1484,212,95,117,1272,153,128,220,232,148,152,239
"2011","Wealden 017C","E01021184","Total",1478,190,108,82,1288,31,312,273,220,140,134,178
"2011","Wealden 017D","E01021185","Total",1494,218,126,92,1276,145,144,279,214,173,122,199
"2011","Wealden 018A","E01021142","Total",1112,232,170,62,880,8,466,81,144,25,64,92
"2011","Wealden 018B","E01021143","Total",1166,187,105,82,979,49,236,167,228,48,119,132
"2011","Wealden 018C","E01021166","Total",2238,295,178,117,1943,39,610,310,398,123,168,295
"2011","Wealden 018D","E01021195","Total",1804,198,118,80,1606,61,328,259,322,106,207,323
"2011","Wealden 018E","E01021196","Total",1942,191,107,84,1751,95,326,377,282,115,174,382
"2011","Wealden 018F","E01021197","Total",1787,159,64,95,1628,70,208,420,314,109,159,348
"2011","Wealden 019A","E01021212","Total",1822,328,197,131,1494,80,414,291,342,67,84,216
"2011","Wealden 019B","E01021213","Total",1727,279,119,160,1448,147,208,344,320,75,134,220
"2011","Wealden 019C","E01021214","Total",1558,291,204,87,1267,61,348,283,234,60,88,193
"2011","Wealden 019D","E01021215","Total",1257,255,184,71,1002,41,276,175,224,36,89,161
"2011","Wealden 019E","E01021216","Total",1125,151,91,60,974,49,226,176,184,58,83,198
"2011","Wealden 020A","E01021206","Total",1427,233,153,80,1194,49,248,217,218,87,92,283
"2011","Wealden 020B","E01021207","Total",1339,224,124,100,1115,48,304,218,258,37,79,171
"2011","Wealden 020C","E01021208","Total",1942,127,64,63,1815,110,256,535,308,124,232,250
"2011","Wealden 020D","E01021209","Total",1614,130,79,51,1484,56,388,298,226,67,195,254
"2011","Wealden 020E","E01021210","Total",1598,85,35,50,1513,82,182,531,214,92,199,213
"2011","Wealden 020F","E01021211","Total",1511,338,215,123,1173,25,418,138,266,58,125,143
"2011","Wealden 021A","E01021232","Total",1652,291,194,97,1361,54,414,224,256,96,108,209
"2011","Wealden 021B","E01021233","Total",1475,181,118,63,1294,55,322,269,180,122,122,224
"2011","Wealden 021C","E01021234","Total",1475,193,127,66,1282,58,330,293,246,43,117,195
"2011","Wealden 021D","E01021235","Total",1341,198,137,61,1143,25,378,185,218,37,106,194
"2011","Wealden 021E","E01021236","Total",1478,273,163,110,1205,41,312,247,226,45,110,224
"2011","Basingstoke and Deane 001A","E01022553","Total",1457,156,62,94,1301,61,210,291,238,66,161,274
"2011","Basingstoke and Deane 001B","E01022554","Total",1670,164,83,81,1506,49,194,377,296,138,151,301
"2011","Basingstoke and Deane 001C","E01022555","Total",1468,184,99,85,1284,85,192,267,234,77,152,277
"2011","Basingstoke and Deane 001D","E01022556","Total",1567,206,94,112,1361,102,138,358,238,113,173,239
"2011","Basingstoke and Deane 001E","E01022560","Total",1177,119,42,77,1058,30,102,297,230,56,108,235
"2011","Basingstoke and Deane 002A","E01022493","Total",1337,95,39,56,1242,24,192,380,240,75,114,217
"2011","Basingstoke and Deane 002B","E01022536","Total",1320,127,73,54,1193,15,240,276,216,47,142,257
"2011","Basingstoke and Deane 002C","E01022537","Total",1293,119,73,46,1174,29,204,268,258,47,98,270
"2011","Basingstoke and Deane 002D","E01022557","Total",1496,165,58,107,1331,86,190,350,236,98,105,266
"2011","Basingstoke and Deane 002E","E01022558","Total",1247,241,49,192,1006,60,58,269,240,95,113,171
"2011","Basingstoke and Deane 002F","E01022559","Total",1280,130,58,72,1150,43,160,248,208,61,170,260
"2011","Basingstoke and Deane 003A","E01022488","Total",1185,90,47,43,1095,42,106,302,210,119,155,161
"2011","Basingstoke and Deane 003B","E01022489","Total",1389,108,61,47,1281,30,180,342,240,87,155,247
"2011","Basingstoke and Deane 003C","E01022499","Total",1498,86,40,46,1412,24,182,477,236,124,120,249
"2011","Basingstoke and Deane 003D","E01022500","Total",1360,103,48,55,1257,38,152,340,276,77,119,255
"2011","Basingstoke and Deane 003E","E01022513","Total",1599,109,56,53,1490,49,206,434,264,112,159,266
"2011","Basingstoke and Deane 004A","E01022472","Total",1243,97,49,48,1146,27,218,215,228,126,123,209
"2011","Basingstoke and Deane 004B","E01022473","Total",1246,106,54,52,1140,53,174,290,190,41,122,270
"2011","Basingstoke and Deane 004C","E01022520","Total",1642,282,136,146,1360,63,180,326,286,94,142,269
"2011","Basingstoke and Deane 004D","E01022521","Total",1708,207,97,110,1501,56,252,432,318,54,150,239
"2011","Basingstoke and Deane 004E","E01022522","Total",1535,127,47,80,1408,52,206,293,306,106,142,303
"2011","Basingstoke and Deane 005A","E01022490","Total",1773,178,68,110,1595,55,190,574,358,97,119,202
"2011","Basingstoke and Deane 005B","E01022491","Total",1947,148,37,111,1799,168,136,543,374,196,207,175
"2011","Basingstoke and Deane 005C","E01022492","Total",1549,152,61,91,1397,20,196,419,368,71,73,250
"2011","Basingstoke and Deane 005D","E01022546","Total",1339,145,65,80,1194,25,148,357,250,86,115,213
"2011","Basingstoke and Deane 005E","E01022547","Total",1710,180,99,81,1530,39,256,390,322,136,141,246
"2011","Basingstoke and Deane 006A","E01022495","Total",1455,207,31,176,1248,73,48,422,366,79,97,163
"2011","Basingstoke and Deane 006B","E01022496","Total",2470,167,18,149,2303,101,108,910,482,153,212,337
"2011","Basingstoke and Deane 006C","E01022497","Total",1362,196,45,151,1166,42,92,444,286,41,82,179
"2011","Basingstoke and Deane 006D","E01022498","Total",1519,172,32,140,1347,49,114,418,332,71,163,200
"2011","Basingstoke and Deane 007B","E01022539","Total",1227,130,40,90,1097,75,106,318,170,114,122,192
"2011","Basingstoke and Deane 007C","E01022540","Total",1955,175,43,132,1780,204,126,408,314,176,308,244
"2011","Basingstoke and Deane 007E","E01022542","Total",1263,100,28,72,1163,100,100,258,140,134,189,242
"2011","Basingstoke and Deane 007F","E01022543","Total",1572,201,53,148,1371,90,90,332,278,143,170,268
"2011","Basingstoke and Deane 007H","E01032843","Total",1609,188,8,180,1421,102,28,524,426,64,152,125
"2011","Basingstoke and Deane 007I","E01032844","Total",1528,252,106,146,1276,101,98,298,296,95,162,226
"2011","Basingstoke and Deane 007J","E01032851","Total",2079,235,63,172,1844,213,166,483,264,153,265,300
"2011","Basingstoke and Deane 008A","E01022470","Total",1881,214,67,147,1667,39,106,505,450,103,171,293
"2011","Basingstoke and Deane 008B","E01022471","Total",1541,125,38,87,1416,51,142,420,316,104,121,262
"2011","Basingstoke and Deane 008C","E01022494","Total",2433,292,71,221,2141,112,108,680,538,205,198,300
"2011","Basingstoke and Deane 008D","E01022523","Total",2037,222,71,151,1815,214,128,350,296,137,266,424
"2011","Basingstoke and Deane 009A","E01022524","Total",1909,202,73,129,1707,170,138,372,246,170,298,313
"2011","Basingstoke and Deane 009B","E01022525","Total",1582,177,77,100,1405,53,200,278,268,122,158,326
"2011","Basingstoke and Deane 009C","E01022526","Total",1667,157,56,101,1510,103,154,324,270,120,224,315
"2011","Basingstoke and Deane 009D","E01022527","Total",1599,297,124,173,1302,110,136,347,276,68,159,206
"2011","Basingstoke and Deane 010B","E01022566","Total",1287,63,35,28,1224,47,172,334,168,41,161,301
"2011","Basingstoke and Deane 010C","E01022567","Total",1277,144,73,71,1133,118,108,251,144,103,200,209
"2011","Basingstoke and Deane 010D","E01022568","Total",1421,208,87,121,1213,103,108,252,244,92,181,233
"2011","Basingstoke and Deane 010E","E01022570","Total",1554,124,59,65,1430,58,266,332,250,46,158,320
"2011","Basingstoke and Deane 010F","E01032840","Total",1754,188,8,180,1566,119,6,632,416,159,122,112
"2011","Basingstoke and Deane 010G","E01032841","Total",1655,200,19,181,1455,91,58,511,378,119,166,132
"2011","Basingstoke and Deane 011B","E01022502","Total",1541,232,77,155,1309,79,148,315,256,68,142,301
"2011","Basingstoke and Deane 011C","E01022506","Total",1265,215,69,146,1050,66,112,234,274,73,87,204
"2011","Basingstoke and Deane 011D","E01022507","Total",1557,222,62,160,1335,83,134,271,288,88,166,305
"2011","Basingstoke and Deane 011E","E01032842","Total",1239,319,16,303,920,36,18,311,412,5,55,83
"2011","Basingstoke and Deane 011F","E01032847","Total",1308,274,91,183,1034,76,102,203,304,64,114,171
"2011","Basingstoke and Deane 012A","E01022481","Total",1799,208,97,111,1591,61,226,380,290,63,233,338
"2011","Basingstoke and Deane 012B","E01022482","Total",1528,304,140,164,1224,135,106,240,228,74,190,251
"2011","Basingstoke and Deane 012D","E01022503","Total",1401,196,46,150,1205,46,108,242,314,93,151,251
"2011","Basingstoke and Deane 012E","E01032845","Total",1688,216,55,161,1472,92,86,422,342,77,136,317
"2011","Basingstoke and Deane 012F","E01032846","Total",1512,260,13,247,1252,86,28,452,504,30,30,122
"2011","Basingstoke and Deane 013A","E01022484","Total",1283,130,49,81,1153,138,90,297,158,90,140,240
"2011","Basingstoke and Deane 013B","E01022485","Total",1179,131,38,93,1048,90,116,227,160,108,175,172
"2011","Basingstoke and Deane 013C","E01022486","Total",2047,170,34,136,1877,203,84,554,410,134,211,281
"2011","Basingstoke and Deane 013D","E01022487","Total",1299,117,46,71,1182,114,98,238,164,166,182,220
"2011","Basingstoke and Deane 013E","E01022569","Total",1204,114,49,65,1090,39,192,251,216,84,80,228
"2011","Basingstoke and Deane 014A","E01022548","Total",1361,188,113,75,1173,95,254,223,246,74,79,202
"2011","Basingstoke and Deane 014B","E01022549","Total",1612,348,117,231,1264,125,166,305,216,90,134,228
"2011","Basingstoke and Deane 014C","E01022550","Total",1662,295,119,176,1367,147,234,310,246,111,89,230
"2011","Basingstoke and Deane 014D","E01022551","Total",1524,197,93,104,1327,68,166,282,222,85,180,324
"2011","Basingstoke and Deane 014E","E01022552","Total",1502,171,66,105,1331,112,108,314,220,110,140,327
"2011","Basingstoke and Deane 015A","E01022528","Total",1272,90,55,35,1182,31,184,245,218,82,166,256
"2011","Basingstoke and Deane 015B","E01022529","Total",1433,220,127,93,1213,53,196,218,302,96,115,233
"2011","Basingstoke and Deane 015C","E01022530","Total",1251,97,69,28,1154,19,270,180,224,65,147,249
"2011","Basingstoke and Deane 015D","E01022531","Total",1476,99,60,39,1377,37,252,296,288,74,142,288
"2011","Basingstoke and Deane 016A","E01022475","Total",1653,220,38,182,1433,113,72,389,356,61,147,295
"2011","Basingstoke and Deane 016B","E01022476","Total",1847,125,42,83,1722,72,130,531,344,133,200,312
"2011","Basingstoke and Deane 016C","E01022480","Total",1320,106,44,62,1214,95,82,272,182,112,174,297
"2011","Basingstoke and Deane 016D","E01022504","Total",1481,169,82,87,1312,43,292,235,246,92,155,249
"2011","Basingstoke and Deane 016E","E01022505","Total",1545,144,66,78,1401,43,218,305,242,108,207,278
"2011","Basingstoke and Deane 017A","E01022467","Total",1658,134,78,56,1524,24,302,301,266,139,173,319
"2011","Basingstoke and Deane 017B","E01022468","Total",1675,197,93,104,1478,65,302,375,344,77,138,177
"2011","Basingstoke and Deane 017C","E01022469","Total",1570,180,112,68,1390,39,222,392,226,117,124,270
"2011","Basingstoke and Deane 017D","E01022561","Total",1467,135,50,85,1332,34,214,326,300,112,132,214
"2011","Basingstoke and Deane 017E","E01022562","Total",1321,103,60,43,1218,22,212,311,288,96,110,179
"2011","Basingstoke and Deane 018A","E01022515","Total",1291,221,155,66,1070,15,412,113,194,10,65,261
"2011","Basingstoke and Deane 018B","E01022516","Total",1480,140,110,30,1340,20,292,287,198,77,151,315
"2011","Basingstoke and Deane 018C","E01022517","Total",1234,60,38,22,1174,14,214,244,268,81,101,252
"2011","Basingstoke and Deane 018D","E01022518","Total",2008,119,42,77,1889,49,176,568,354,184,207,351
"2011","Basingstoke and Deane 018E","E01022519","Total",1261,78,45,33,1183,17,232,270,208,83,126,247
"2011","Basingstoke and Deane 019A","E01022474","Total",1552,159,49,110,1393,181,108,352,208,124,178,242
"2011","Basingstoke and Deane 019B","E01022477","Total",1376,228,57,171,1148,98,76,361,292,41,130,150
"2011","Basingstoke and Deane 019C","E01022478","Total",1437,191,62,129,1246,132,82,396,252,60,74,250
"2011","Basingstoke and Deane 019D","E01022479","Total",1369,189,99,90,1180,124,98,266,232,92,111,257
"2011","Basingstoke and Deane 019E","E01022509","Total",1430,135,36,99,1295,69,80,499,278,60,125,184
"2011","Basingstoke and Deane 020A","E01022514","Total",1512,164,75,89,1348,42,204,325,260,103,142,272
"2011","Basingstoke and Deane 020B","E01022563","Total",1738,183,83,100,1555,44,206,416,360,99,155,275
"2011","Basingstoke and Deane 020C","E01022564","Total",1811,229,104,125,1582,69,268,451,284,132,161,217
"2011","Basingstoke and Deane 020D","E01022565","Total",1628,228,108,120,1400,85,174,380,298,68,157,238
"2011","Basingstoke and Deane 021B","E01022510","Total",1665,64,10,54,1601,73,52,603,278,78,199,318
"2011","Basingstoke and Deane 021C","E01022511","Total",1286,54,11,43,1232,33,66,383,232,120,163,235
"2011","Basingstoke and Deane 021D","E01022512","Total",1405,54,14,40,1351,36,42,458,202,111,245,257
"2011","Basingstoke and Deane 021E","E01032848","Total",1585,97,6,91,1488,129,28,592,270,182,143,144
"2011","Basingstoke and Deane 021F","E01032849","Total",1549,99,14,85,1450,130,30,615,260,161,111,143
"2011","Basingstoke and Deane 021G","E01032850","Total",1481,147,25,122,1334,90,56,436,340,105,115,192
"2011","Basingstoke and Deane 022A","E01022532","Total",1332,100,50,50,1232,43,192,292,260,108,101,236
"2011","Basingstoke and Deane 022B","E01022533","Total",1784,129,55,74,1655,66,200,441,346,106,208,288
"2011","Basingstoke and Deane 022C","E01022534","Total",1639,202,117,85,1437,54,244,421,292,72,77,277
"2011","Basingstoke and Deane 022D","E01022535","Total",1464,242,139,103,1222,25,268,310,250,56,129,184
"2011","East Hampshire 001A","E01022581","Total",1455,131,54,77,1324,46,172,379,220,165,143,199
"2011","East Hampshire 001B","E01022582","Total",1411,104,55,49,1307,22,226,313,240,78,170,258
"2011","East Hampshire 001C","E01022604","Total",1201,99,50,49,1102,32,200,283,198,99,95,195
"2011","East Hampshire 001D","E01022605","Total",1457,158,77,81,1299,23,164,293,278,125,185,231
"2011","East Hampshire 002A","E01022574","Total",1318,255,135,120,1063,55,108,329,194,53,109,215
"2011","East Hampshire 002B","E01022575","Total",1522,138,57,81,1384,131,114,264,202,200,222,251
"2011","East Hampshire 002C","E01022576","Total",1520,399,224,175,1121,143,130,238,270,40,134,166
"2011","East Hampshire 002D","E01022579","Total",1114,175,85,90,939,91,152,191,152,73,103,177
"2011","East Hampshire 003A","E01022571","Total",1203,78,43,35,1125,33,148,298,254,83,89,220
"2011","East Hampshire 003B","E01022572","Total",1244,117,45,72,1127,34,150,258,214,78,122,271
"2011","East Hampshire 003C","E01022573","Total",2444,319,127,192,2125,45,302,494,482,119,287,396
"2011","East Hampshire 003D","E01022577","Total",1483,305,189,116,1178,66,200,290,274,73,93,182
"2011","East Hampshire 003E","E01022578","Total",2971,244,119,125,2727,125,424,621,448,209,337,563
"2011","East Hampshire 003F","E01022580","Total",1180,99,47,52,1081,41,130,241,252,79,83,255
"2011","East Hampshire 004A","E01022603","Total",1416,121,53,68,1295,77,126,272,210,133,240,237
"2011","East Hampshire 004B","E01022634","Total",1079,194,103,91,885,56,76,219,210,47,112,165
"2011","East Hampshire 004C","E01022639","Total",1637,87,20,67,1550,78,50,679,246,159,198,140
"2011","East Hampshire 004D","E01022640","Total",1454,146,14,132,1308,114,46,398,254,129,138,229
"2011","East Hampshire 006A","E01022615","Total",2757,249,92,157,2508,124,296,649,438,157,284,560
"2011","East Hampshire 006B","E01022633","Total",1303,218,59,159,1085,42,126,297,284,41,129,166
"2011","East Hampshire 006C","E01022635","Total",1486,85,34,51,1401,120,116,280,182,163,251,289
"2011","East Hampshire 006D","E01022636","Total",1338,91,30,61,1247,58,88,316,242,92,188,263
"2011","East Hampshire 006E","E01022641","Total",1245,158,43,115,1087,54,104,253,214,93,138,231
"2011","East Hampshire 007A","E01022591","Total",2440,155,71,84,2285,46,464,573,416,168,222,396
"2011","East Hampshire 007B","E01022593","Total",1240,92,57,35,1148,25,212,279,178,61,139,254
"2011","East Hampshire 007C","E01022594","Total",1434,126,71,55,1308,56,208,340,262,80,140,222
"2011","East Hampshire 007D","E01022595","Total",1903,123,55,68,1780,60,232,454,312,161,167,394
"2011","East Hampshire 007E","E01022596","Total",1363,77,37,40,1286,4,282,292,246,67,130,265
"2011","East Hampshire 007F","E01022627","Total",2202,174,89,85,2028,60,350,440,352,137,254,435
"2011","East Hampshire 008A","E01022630","Total",2248,209,98,111,2039,59,382,452,398,102,222,424
"2011","East Hampshire 008D","E01022642","Total",1078,86,43,43,992,24,136,238,178,86,127,203
"2011","East Hampshire 008E","E01032663","Total",2336,244,98,146,2092,141,260,524,396,114,216,441
"2011","East Hampshire 009A","E01022583","Total",1680,190,101,89,1490,68,244,379,210,87,187,315
"2011","East Hampshire 009B","E01022584","Total",1737,316,175,141,1421,79,190,377,200,165,165,245
"2011","East Hampshire 009C","E01022585","Total",1615,145,94,51,1470,26,228,348,268,116,153,331
"2011","East Hampshire 009D","E01022586","Total",1638,119,56,63,1519,35,252,387,232,122,149,342
"2011","East Hampshire 009E","E01022587","Total",1719,238,114,124,1481,92,180,422,298,100,122,267
"2011","East Hampshire 010A","E01022616","Total",1670,248,126,122,1422,98,188,374,228,112,164,258
"2011","East Hampshire 010B","E01022617","Total",1542,196,111,85,1346,57,196,276,272,116,205,224
"2011","East Hampshire 010C","E01022618","Total",1624,143,87,56,1481,37,320,347,270,121,122,264
"2011","East Hampshire 010D","E01022631","Total",1292,129,64,65,1163,40,138,347,204,59,180,195
"2011","East Hampshire 010E","E01022632","Total",1118,101,42,59,1017,35,172,256,178,93,68,215
"2011","East Hampshire 011A","E01022592","Total",2286,222,114,108,2064,119,312,430,376,177,272,378
"2011","East Hampshire 011B","E01022597","Total",2487,225,99,126,2262,74,368,524,380,213,295,408
"2011","East Hampshire 011C","E01022619","Total",1268,120,43,77,1148,33,160,299,232,73,133,218
"2011","East Hampshire 011D","E01022624","Total",2272,274,168,106,1998,26,414,417,410,130,216,385
"2011","East Hampshire 011E","E01022625","Total",2659,282,157,125,2377,70,400,728,352,210,226,391
"2011","East Hampshire 012A","E01022620","Total",1137,150,54,96,987,47,90,279,222,57,104,188
"2011","East Hampshire 012B","E01022621","Total",1426,204,118,86,1222,108,144,284,184,153,171,178
"2011","East Hampshire 012C","E01022622","Total",1314,158,91,67,1156,34,238,358,170,74,69,213
"2011","East Hampshire 012D","E01022623","Total",2294,236,124,112,2058,173,270,525,366,165,231,328
"2011","East Hampshire 012F","E01032664","Total",1082,370,202,168,712,31,138,157,226,10,61,89
"2011","East Hampshire 012G","E01032665","Total",1356,259,125,134,1097,64,144,267,272,64,103,183
"2011","East Hampshire 013A","E01022588","Total",1611,127,80,47,1484,44,278,327,248,83,195,309
"2011","East Hampshire 013B","E01022589","Total",1745,185,81,104,1560,79,220,403,344,79,167,268
"2011","East Hampshire 013C","E01022590","Total",1496,86,46,40,1410,59,286,308,250,83,112,312
"2011","East Hampshire 013D","E01022607","Total",1192,132,69,63,1060,43,184,240,222,47,124,200
"2011","East Hampshire 013E","E01022608","Total",1335,83,42,41,1252,21,190,318,254,83,165,221
"2011","East Hampshire 014A","E01022606","Total",2394,184,76,108,2210,56,306,481,436,116,320,495
"2011","East Hampshire 014B","E01022611","Total",1531,172,99,73,1359,57,178,357,240,110,133,284
"2011","East Hampshire 014C","E01022613","Total",1371,94,47,47,1277,79,146,275,190,84,173,330
"2011","East Hampshire 014D","E01022614","Total",1087,127,66,61,960,73,188,188,170,42,81,218
"2011","East Hampshire 016A","E01022610","Total",1286,139,90,49,1147,27,164,215,208,69,159,305
"2011","East Hampshire 016B","E01022628","Total",1154,151,55,96,1003,64,152,240,242,51,65,189
"2011","East Hampshire 016C","E01022629","Total",1339,160,109,51,1179,22,382,180,214,41,125,215
"2011","East Hampshire 016D","E01032615","Total",1075,115,83,32,960,6,288,178,140,74,78,196
"2011","East Hampshire 016E","E01032616","Total",1569,125,62,63,1444,40,226,329,258,71,168,352
"2011","East Hampshire 017A","E01022599","Total",1261,233,125,108,1028,53,190,246,194,77,82,186
"2011","East Hampshire 017B","E01022600","Total",1452,159,92,67,1293,38,302,289,272,40,104,248
"2011","East Hampshire 017C","E01022601","Total",1435,141,93,48,1294,27,254,287,230,84,146,266
"2011","East Hampshire 017D","E01022602","Total",1267,79,49,30,1188,4,250,235,298,68,99,234
"2011","East Hampshire 017E","E01032625","Total",1096,109,84,25,987,18,248,167,144,124,109,177
"2011","Eastleigh 001A","E01022705","Total",1544,163,123,40,1381,18,356,362,158,91,154,242
"2011","Eastleigh 001B","E01022706","Total",1661,129,103,26,1532,7,312,323,212,136,196,346
"2011","Eastleigh 001C","E01022707","Total",2015,129,69,60,1886,63,278,497,268,215,191,374
"2011","Eastleigh 001D","E01022708","Total",1759,179,91,88,1580,68,278,463,278,93,144,256
"2011","Eastleigh 001E","E01022709","Total",1685,159,95,64,1526,84,334,392,222,98,174,222
"2011","Eastleigh 002A","E01022659","Total",1599,127,57,70,1472,84,146,381,246,56,202,357
"2011","Eastleigh 002B","E01022660","Total",1501,237,138,99,1264,47,186,243,212,121,136,319
"2011","Eastleigh 002C","E01022675","Total",1403,119,51,68,1284,26,180,257,282,50,149,340
"2011","Eastleigh 002D","E01022676","Total",1512,121,63,58,1391,34,196,243,298,69,155,396
"2011","Eastleigh 002E","E01022704","Total",1830,185,102,83,1645,62,246,460,270,96,206,305
"2011","Eastleigh 003A","E01022661","Total",1653,261,163,98,1392,48,314,320,358,36,98,218
"2011","Eastleigh 003B","E01022662","Total",1335,108,57,51,1227,20,202,270,258,56,127,294
"2011","Eastleigh 003C","E01022663","Total",1625,141,53,88,1484,42,174,371,288,82,219,308
"2011","Eastleigh 003D","E01022664","Total",1527,166,96,70,1361,51,212,357,280,101,123,237
"2011","Eastleigh 003E","E01022665","Total",1492,304,132,172,1188,86,160,279,320,32,118,193
"2011","Eastleigh 004A","E01022648","Total",1286,241,124,117,1045,43,162,174,234,63,126,243
"2011","Eastleigh 004B","E01022667","Total",1500,148,55,93,1352,71,116,363,296,62,101,343
"2011","Eastleigh 004C","E01022672","Total",1575,158,64,94,1417,52,154,291,228,107,200,385
"2011","Eastleigh 004D","E01022673","Total",2090,243,57,186,1847,111,172,471,378,110,255,350
"2011","Eastleigh 004E","E01022674","Total",1595,203,83,120,1392,72,152,327,380,53,83,325
"2011","Eastleigh 005A","E01022643","Total",1611,166,52,114,1445,60,172,410,270,53,135,345
"2011","Eastleigh 005B","E01022644","Total",1320,106,51,55,1214,78,122,325,216,102,129,242
"2011","Eastleigh 005C","E01022646","Total",1569,174,79,95,1395,104,164,355,228,76,184,284
"2011","Eastleigh 005D","E01022647","Total",1509,141,77,64,1368,46,194,339,250,94,115,330
"2011","Eastleigh 005E","E01022649","Total",1627,175,96,79,1452,169,174,345,190,169,186,219
"2011","Eastleigh 005F","E01022650","Total",1144,101,51,50,1043,42,134,251,212,67,96,241
"2011","Eastleigh 006A","E01022668","Total",2599,224,52,172,2375,156,134,575,516,225,320,449
"2011","Eastleigh 006B","E01022677","Total",2007,240,144,96,1767,170,134,474,350,106,176,357
"2011","Eastleigh 006C","E01022678","Total",1829,171,82,89,1658,126,164,467,274,115,190,322
"2011","Eastleigh 006D","E01022680","Total",1604,309,155,154,1295,134,210,326,248,56,142,179
"2011","Eastleigh 006E","E01022681","Total",1574,188,100,88,1386,117,166,249,230,106,205,313
"2011","Eastleigh 007A","E01022666","Total",2124,311,83,228,1813,97,110,436,444,128,187,411
"2011","Eastleigh 007B","E01022669","Total",1789,192,65,127,1597,96,114,401,386,123,205,272
"2011","Eastleigh 007C","E01022670","Total",1592,186,56,130,1406,198,62,343,322,135,114,232
"2011","Eastleigh 007D","E01022671","Total",1519,312,76,236,1207,81,74,308,270,102,148,224
"2011","Eastleigh 007E","E01022679","Total",1827,161,47,114,1666,122,126,436,370,136,177,299
"2011","Eastleigh 008A","E01022645","Total",1172,105,68,37,1067,13,226,201,236,37,120,234
"2011","Eastleigh 008B","E01022682","Total",1354,76,40,36,1278,18,186,301,212,68,153,340
"2011","Eastleigh 008C","E01022683","Total",1382,134,64,70,1248,47,112,373,212,83,140,281
"2011","Eastleigh 008D","E01022684","Total",1508,113,60,53,1395,51,232,406,202,65,127,312
"2011","Eastleigh 008E","E01022685","Total",1196,208,112,96,988,35,154,221,178,51,119,230
"2011","Eastleigh 008F","E01022686","Total",1661,126,50,76,1535,46,152,474,234,88,273,268
"2011","Eastleigh 008G","E01022687","Total",1760,139,32,107,1621,101,144,511,292,81,228,264
"2011","Eastleigh 009A","E01022713","Total",1620,180,92,88,1440,70,236,367,296,71,138,262
"2011","Eastleigh 009B","E01022714","Total",1668,183,134,49,1485,32,308,274,288,73,192,318
"2011","Eastleigh 009C","E01022715","Total",1589,249,92,157,1340,103,200,293,340,56,111,237
"2011","Eastleigh 009D","E01022716","Total",1550,310,64,246,1240,111,118,345,328,56,79,203
"2011","Eastleigh 009E","E01022717","Total",1204,140,33,107,1064,56,136,259,244,40,100,229
"2011","Eastleigh 009F","E01022718","Total",1462,156,63,93,1306,41,206,274,238,93,161,293
"2011","Eastleigh 009G","E01022719","Total",1516,223,135,88,1293,30,270,248,252,58,140,295
"2011","Eastleigh 010A","E01022653","Total",1456,144,99,45,1312,23,262,297,264,59,158,249
"2011","Eastleigh 010B","E01022691","Total",1583,150,32,118,1433,95,58,531,316,110,136,187
"2011","Eastleigh 010C","E01022692","Total",2845,224,13,211,2621,300,56,1062,572,178,200,253
"2011","Eastleigh 010D","E01022693","Total",1531,91,27,64,1440,42,74,602,220,105,160,237
"2011","Eastleigh 010E","E01022694","Total",1789,122,25,97,1667,112,58,637,340,111,169,240
"2011","Eastleigh 011A","E01022652","Total",1758,212,126,86,1546,73,236,383,274,82,190,308
"2011","Eastleigh 011B","E01022695","Total",1327,211,124,87,1116,64,146,241,194,74,143,254
"2011","Eastleigh 011C","E01022700","Total",1572,232,126,106,1340,87,158,368,208,115,160,244
"2011","Eastleigh 011D","E01022701","Total",1011,108,79,29,903,32,182,173,126,58,114,218
"2011","Eastleigh 011E","E01022703","Total",1467,209,69,140,1258,77,178,281,318,80,108,216
"2011","Eastleigh 012A","E01022651","Total",1834,195,56,139,1639,105,152,510,428,42,103,299
"2011","Eastleigh 012B","E01022696","Total",1556,137,96,41,1419,48,320,341,202,72,134,302
"2011","Eastleigh 012C","E01022697","Total",1525,119,70,49,1406,40,250,350,250,68,172,276
"2011","Eastleigh 012D","E01022698","Total",1565,145,97,48,1420,44,292,303,236,99,138,308
"2011","Eastleigh 012E","E01022699","Total",1516,134,47,87,1382,58,220,385,252,94,111,262
"2011","Eastleigh 012F","E01022702","Total",1286,99,27,72,1187,22,88,395,246,51,139,246
"2011","Eastleigh 013A","E01022654","Total",1344,154,36,118,1190,58,100,326,282,82,95,247
"2011","Eastleigh 013B","E01022655","Total",1536,120,47,73,1416,213,76,378,144,144,256,205
"2011","Eastleigh 013C","E01022656","Total",1462,150,79,71,1312,47,206,340,238,44,172,265
"2011","Eastleigh 013D","E01022657","Total",1618,244,79,165,1374,84,158,343,354,71,88,276
"2011","Eastleigh 013E","E01022658","Total",1669,165,72,93,1504,47,308,326,334,122,106,261
"2011","Eastleigh 014A","E01022710","Total",1947,375,178,197,1572,56,310,340,378,83,129,276
"2011","Eastleigh 014B","E01022711","Total",1713,264,149,115,1449,94,200,335,218,103,210,289
"2011","Eastleigh 014C","E01022712","Total",1586,203,51,152,1383,72,128,398,298,61,151,275
"2011","Eastleigh 015A","E01022688","Total",2221,340,107,233,1881,118,266,483,510,61,135,308
"2011","Eastleigh 015B","E01022689","Total",1513,158,82,76,1355,42,258,371,294,30,103,257
"2011","Eastleigh 015C","E01022690","Total",1963,209,116,93,1754,157,250,481,300,119,160,287
"2011","Fareham 001A","E01022758","Total",1522,113,48,65,1409,129,134,413,252,94,106,281
"2011","Fareham 001B","E01022771","Total",1645,93,18,75,1552,52,68,679,328,124,153,148
"2011","Fareham 001C","E01022772","Total",2211,95,16,79,2116,78,118,846,412,167,192,303
"2011","Fareham 001D","E01022773","Total",1571,134,59,75,1437,56,264,374,278,51,153,261
"2011","Fareham 001E","E01022774","Total",1898,119,56,63,1779,53,270,472,328,135,165,356
"2011","Fareham 002A","E01022749","Total",1359,97,61,36,1262,27,218,275,230,87,151,274
"2011","Fareham 002B","E01022753","Total",1248,116,66,50,1132,41,118,264,188,88,145,288
"2011","Fareham 002C","E01022754","Total",1759,222,69,153,1537,102,156,447,354,129,151,198
"2011","Fareham 002D","E01022780","Total",1549,116,30,86,1433,78,114,554,320,111,86,170
"2011","Fareham 002E","E01022787","Total",1309,137,79,58,1172,66,144,237,232,72,169,252
"2011","Fareham 002F","E01022788","Total",1256,146,55,91,1110,61,100,356,220,63,123,187
"2011","Fareham 003A","E01022730","Total",1474,160,87,73,1314,68,250,217,244,84,141,310
"2011","Fareham 003B","E01022731","Total",1341,87,31,56,1254,46,106,360,264,52,145,281
"2011","Fareham 003C","E01022732","Total",1531,211,99,112,1320,172,96,289,264,113,173,213
"2011","Fareham 003D","E01022733","Total",1685,198,117,81,1487,64,304,295,280,113,159,272
"2011","Fareham 003E","E01022734","Total",1326,121,51,70,1205,65,112,253,212,120,159,284
"2011","Fareham 004A","E01022720","Total",1396,66,36,30,1330,16,226,298,226,66,190,308
"2011","Fareham 004B","E01022725","Total",1214,91,71,20,1123,19,290,178,170,79,118,269
"2011","Fareham 004C","E01022726","Total",1414,153,106,47,1261,23,326,232,188,76,136,280
"2011","Fareham 004D","E01022727","Total",1568,163,103,60,1405,40,308,338,188,73,145,313
"2011","Fareham 004E","E01022729","Total",1177,83,28,55,1094,36,120,298,236,99,108,197
"2011","Fareham 004F","E01022743","Total",1789,208,111,97,1581,33,356,282,366,63,146,335
"2011","Fareham 005A","E01022750","Total",1483,195,136,59,1288,20,182,327,222,36,200,301
"2011","Fareham 005B","E01022751","Total",1567,168,104,64,1399,43,290,311,202,77,167,309
"2011","Fareham 005C","E01022752","Total",1418,90,50,40,1328,23,188,341,246,70,151,309
"2011","Fareham 005D","E01022757","Total",1603,198,31,167,1405,66,74,517,378,78,116,176
"2011","Fareham 005E","E01022790","Total",1800,150,60,90,1650,46,230,377,320,134,232,311
"2011","Fareham 006A","E01022755","Total",1463,125,72,53,1338,57,284,304,226,63,135,269
"2011","Fareham 006B","E01022756","Total",1303,118,49,69,1185,33,150,306,228,45,172,251
"2011","Fareham 006C","E01022791","Total",1883,250,145,105,1633,54,344,434,276,93,141,291
"2011","Fareham 006D","E01022792","Total",1542,150,68,82,1392,83,226,339,220,77,182,265
"2011","Fareham 006E","E01022793","Total",1732,109,61,48,1623,50,274,450,290,66,159,334
"2011","Fareham 007A","E01022781","Total",1388,151,69,82,1237,65,166,323,216,125,161,181
"2011","Fareham 007B","E01022782","Total",1403,193,92,101,1210,29,248,268,292,71,68,234
"2011","Fareham 007C","E01022785","Total",1493,150,64,86,1343,24,182,328,272,133,125,279
"2011","Fareham 007D","E01022786","Total",1597,144,58,86,1453,88,208,345,276,69,153,314
"2011","Fareham 007E","E01022789","Total",1438,178,53,125,1260,38,150,382,308,68,71,243
"2011","Fareham 008A","E01022721","Total",1384,189,71,118,1195,60,194,299,300,41,99,202
"2011","Fareham 008B","E01022722","Total",1612,245,146,99,1367,73,202,357,216,60,195,264
"2011","Fareham 008C","E01022723","Total",1464,280,99,181,1184,87,152,303,312,48,63,219
"2011","Fareham 008D","E01022724","Total",1450,130,51,79,1320,108,116,363,268,61,160,244
"2011","Fareham 008E","E01022737","Total",1562,162,77,85,1400,63,198,324,288,58,165,304
"2011","Fareham 008F","E01022766","Total",1283,96,48,48,1187,15,254,232,222,40,118,306
"2011","Fareham 008G","E01022769","Total",1223,164,44,120,1059,66,130,279,272,50,71,191
"2011","Fareham 009A","E01022740","Total",1620,187,91,96,1433,22,348,215,302,35,162,349
"2011","Fareham 009B","E01022741","Total",1212,78,42,36,1134,27,182,297,204,93,120,211
"2011","Fareham 009C","E01022742","Total",1753,297,212,85,1456,27,482,183,286,68,107,303
"2011","Fareham 009D","E01022783","Total",1477,155,93,62,1322,33,308,227,276,72,149,257
"2011","Fareham 009E","E01022784","Total",1334,68,32,36,1266,11,176,316,238,74,192,259
"2011","Fareham 010A","E01022759","Total",1530,176,107,69,1354,36,286,340,210,51,126,305
"2011","Fareham 010B","E01022763","Total",1535,168,110,58,1367,22,360,238,252,40,134,321
"2011","Fareham 010C","E01022765","Total",1692,243,162,81,1449,41,262,341,280,55,137,333
"2011","Fareham 010D","E01022768","Total",1357,169,70,99,1188,34,190,237,270,64,92,301
"2011","Fareham 010E","E01022770","Total",1706,135,81,54,1571,48,312,301,264,82,169,395
"2011","Fareham 011A","E01022728","Total",1733,325,181,144,1408,153,146,412,344,36,101,216
"2011","Fareham 011B","E01022735","Total",1441,160,53,107,1281,79,134,317,328,61,161,201
"2011","Fareham 011C","E01022736","Total",1537,194,87,107,1343,51,206,285,248,95,129,329
"2011","Fareham 011D","E01022738","Total",1043,178,66,112,865,79,100,222,168,81,46,169
"2011","Fareham 011E","E01022739","Total",1621,228,128,100,1393,157,104,378,182,131,250,191
"2011","Fareham 012A","E01022760","Total",1528,157,97,60,1371,66,216,295,262,58,160,314
"2011","Fareham 012B","E01022761","Total",1502,177,107,70,1325,90,262,238,258,71,115,291
"2011","Fareham 012C","E01022762","Total",1531,152,87,65,1379,67,218,291,266,80,189,268
"2011","Fareham 012D","E01022764","Total",1564,294,195,99,1270,48,278,239,236,36,129,304
"2011","Fareham 012E","E01022767","Total",1237,112,72,40,1125,56,188,272,190,41,107,271
"2011","Fareham 013B","E01022776","Total",1563,128,69,59,1435,30,240,291,252,93,180,349
"2011","Fareham 013C","E01022777","Total",1637,272,216,56,1365,67,354,225,192,68,185,274
"2011","Fareham 013D","E01022778","Total",1441,126,77,49,1315,48,276,291,218,71,142,269
"2011","Fareham 013F","E01032877","Total",2086,233,162,71,1853,63,494,300,312,97,227,360
"2011","Fareham 014A","E01022744","Total",1348,125,86,39,1223,22,288,196,194,60,150,313
"2011","Fareham 014B","E01022745","Total",1473,144,105,39,1329,25,318,238,256,57,162,273
"2011","Fareham 014C","E01022746","Total",1627,173,118,55,1454,24,370,433,226,71,146,184
"2011","Fareham 014D","E01022747","Total",1241,214,138,76,1027,57,180,203,202,58,119,208
"2011","Fareham 014E","E01022748","Total",1423,182,89,93,1241,58,214,275,218,66,100,310
"2011","Gosport 001A","E01022800","Total",1649,156,99,57,1493,110,162,224,264,107,291,335
"2011","Gosport 001B","E01022801","Total",1525,204,95,109,1321,122,160,219,218,139,172,291
"2011","Gosport 001C","E01022802","Total",1492,120,65,55,1372,86,210,277,266,67,119,347
"2011","Gosport 001D","E01022803","Total",1651,150,78,72,1501,123,136,274,200,123,277,368
"2011","Gosport 001E","E01022836","Total",1438,157,118,39,1281,53,370,195,226,53,111,273
"2011","Gosport 002A","E01022804","Total",1579,193,93,100,1386,48,210,266,278,61,206,317
"2011","Gosport 002B","E01022805","Total",1501,186,127,59,1315,81,194,326,248,75,162,229
"2011","Gosport 002C","E01022834","Total",1335,186,115,71,1149,85,250,167,252,63,102,230
"2011","Gosport 002D","E01022835","Total",1468,174,67,107,1294,113,180,253,268,81,174,225
"2011","Gosport 002E","E01022840","Total",1608,195,62,133,1413,110,138,248,248,144,219,306
"2011","Gosport 003A","E01022813","Total",1409,108,46,62,1301,80,146,278,240,88,196,273
"2011","Gosport 003B","E01022814","Total",1673,249,130,119,1424,89,172,322,332,100,151,258
"2011","Gosport 003C","E01022815","Total",1553,134,59,75,1419,38,202,376,220,87,191,305
"2011","Gosport 003D","E01022823","Total",1547,154,70,84,1393,79,182,280,290,96,158,308
"2011","Gosport 003E","E01022825","Total",1440,149,55,94,1291,65,142,353,262,83,135,251
"2011","Gosport 004A","E01022819","Total",1586,201,32,169,1385,252,60,372,278,90,175,158
"2011","Gosport 004B","E01022820","Total",1825,99,11,88,1726,279,20,469,234,298,247,179
"2011","Gosport 004E","E01022841","Total",1447,179,58,121,1268,104,104,408,228,120,120,184
"2011","Gosport 004F","E01022842","Total",1681,99,38,61,1582,142,104,580,226,157,182,191
"2011","Gosport 004G","E01032882","Total",2066,152,22,130,1914,360,80,418,286,243,249,278
"2011","Gosport 005A","E01022807","Total",1559,278,108,170,1281,143,118,298,354,67,79,222
"2011","Gosport 005B","E01022816","Total",1492,164,61,103,1328,88,120,319,280,118,158,245
"2011","Gosport 005C","E01022817","Total",1783,187,71,116,1596,113,130,353,286,165,202,347
"2011","Gosport 005D","E01022818","Total",1457,187,84,103,1270,138,126,274,186,89,207,250
"2011","Gosport 005E","E01022824","Total",2707,376,73,303,2331,215,158,670,584,125,196,383
"2011","Gosport 006A","E01022826","Total",1534,167,67,100,1367,79,226,298,332,46,109,277
"2011","Gosport 006C","E01022828","Total",1300,384,275,109,916,38,346,124,200,20,59,129
"2011","Gosport 006D","E01022829","Total",1985,198,115,83,1787,25,366,323,282,253,224,314
"2011","Gosport 006E","E01022830","Total",1402,165,112,53,1237,52,316,230,258,58,86,237
"2011","Gosport 006F","E01032880","Total",1415,74,17,57,1341,42,106,542,214,112,160,165
"2011","Gosport 006G","E01032881","Total",1744,92,18,74,1652,108,66,630,218,186,209,235
"2011","Gosport 006H","E01032883","Total",1366,216,130,86,1150,122,208,249,198,47,139,187
"2011","Gosport 007A","E01022806","Total",1445,148,59,89,1297,120,138,266,262,98,138,275
"2011","Gosport 007D","E01022832","Total",1648,191,49,142,1457,159,122,372,296,103,168,237
"2011","Gosport 007E","E01022839","Total",1339,263,94,169,1076,68,124,227,220,55,135,247
"2011","Gosport 007F","E01032884","Total",2094,304,143,161,1790,81,304,505,424,83,132,261
"2011","Gosport 008A","E01022810","Total",1574,295,160,135,1279,93,128,246,246,93,171,302
"2011","Gosport 008B","E01022811","Total",2267,410,66,344,1857,275,140,477,476,103,144,242
"2011","Gosport 008C","E01022833","Total",1822,353,97,256,1469,243,96,348,288,145,129,220
"2011","Gosport 008D","E01022843","Total",1537,273,118,155,1264,185,110,294,234,116,142,183
"2011","Gosport 008F","E01032878","Total",1109,275,48,227,834,137,66,114,306,26,65,120
"2011","Gosport 008G","E01032879","Total",1208,434,148,286,774,96,184,98,280,36,0,80
"2011","Gosport 009A","E01022794","Total",1411,172,114,58,1239,56,256,284,254,91,97,201
"2011","Gosport 009B","E01022795","Total",1503,287,127,160,1216,60,272,307,238,42,93,204
"2011","Gosport 009C","E01022796","Total",1119,127,99,28,992,21,294,240,152,31,123,131
"2011","Gosport 009D","E01022837","Total",1603,186,130,56,1417,42,298,279,204,110,169,315
"2011","Gosport 009E","E01022838","Total",1312,103,75,28,1209,37,250,241,190,93,182,216
"2011","Gosport 010A","E01022797","Total",1033,124,56,68,909,20,180,182,164,30,111,222
"2011","Gosport 010B","E01022798","Total",1068,151,83,68,917,34,184,189,216,30,69,195
"2011","Gosport 010C","E01022799","Total",1302,159,81,78,1143,27,216,276,260,51,113,200
"2011","Gosport 010D","E01022812","Total",1249,152,50,102,1097,60,112,266,232,67,146,214
"2011","Gosport 010E","E01022831","Total",1446,190,93,97,1256,102,154,259,262,72,180,227
"2011","Gosport 010F","E01022845","Total",1460,236,111,125,1224,101,144,326,262,75,101,215
"2011","Hart 001A","E01022890","Total",1470,155,90,65,1315,80,224,285,194,80,172,280
"2011","Hart 001B","E01022891","Total",1741,100,46,54,1641,54,178,446,264,91,189,419
"2011","Hart 001C","E01022892","Total",1862,183,93,90,1679,26,366,342,282,88,209,366
"2011","Hart 001D","E01022893","Total",1611,131,70,61,1480,69,208,376,222,124,176,305
"2011","Hart 001E","E01022894","Total",1478,175,82,93,1303,66,172,342,238,67,154,264
"2011","Hart 002A","E01022859","Total",1648,116,52,64,1532,45,176,426,294,133,183,275
"2011","Hart 002B","E01022895","Total",1834,179,81,98,1655,62,210,462,256,93,177,395
"2011","Hart 002C","E01022896","Total",1618,84,36,48,1534,43,212,339,204,97,182,457
"2011","Hart 002D","E01022897","Total",1697,109,27,82,1588,65,102,412,264,83,206,456
"2011","Hart 002E","E01022898","Total",1516,122,59,63,1394,25,164,323,236,102,195,349
"2011","Hart 003A","E01022846","Total",1070,106,36,70,964,30,148,199,232,41,78,236
"2011","Hart 003B","E01022847","Total",1738,218,86,132,1520,69,206,413,298,93,112,329
"2011","Hart 003C","E01022848","Total",1553,143,85,58,1410,35,278,308,206,72,179,332
"2011","Hart 003D","E01022874","Total",1360,85,51,34,1275,46,168,263,172,80,213,333
"2011","Hart 003E","E01022875","Total",1466,71,27,44,1395,67,92,317,192,163,249,315
"2011","Hart 003F","E01022876","Total",1360,80,36,44,1280,22,172,330,180,87,206,283
"2011","Hart 003G","E01022877","Total",1456,93,47,46,1363,27,226,303,168,139,175,325
"2011","Hart 004A","E01022858","Total",1045,80,29,51,965,31,186,171,146,61,144,226
"2011","Hart 004B","E01022878","Total",1731,136,85,51,1595,15,328,383,308,130,161,270
"2011","Hart 004C","E01022879","Total",1775,284,186,98,1491,100,246,363,302,132,166,182
"2011","Hart 004D","E01022880","Total",1493,175,82,93,1318,41,174,244,276,128,158,297
"2011","Hart 005A","E01022860","Total",1882,321,219,102,1561,28,338,349,302,86,173,285
"2011","Hart 005B","E01022862","Total",1926,402,177,225,1524,45,158,448,388,90,129,266
"2011","Hart 005D","E01022867","Total",1516,179,29,150,1337,47,84,488,348,63,120,187
"2011","Hart 005E","E01032852","Total",1742,95,12,83,1647,91,46,720,306,161,168,155
"2011","Hart 005F","E01032853","Total",1769,97,13,84,1672,41,56,822,286,141,159,167
"2011","Hart 005G","E01032854","Total",1672,92,6,86,1580,70,48,781,338,132,122,89
"2011","Hart 005H","E01032857","Total",1026,102,16,86,924,10,40,308,224,67,69,206
"2011","Hart 006A","E01022881","Total",2360,205,103,102,2155,104,172,659,372,209,223,416
"2011","Hart 006B","E01022882","Total",1438,117,46,71,1321,41,150,392,234,70,168,266
"2011","Hart 006C","E01022883","Total",1383,87,25,62,1296,68,116,360,250,102,150,250
"2011","Hart 006D","E01022884","Total",1560,195,116,79,1365,36,200,387,236,106,113,287
"2011","Hart 006E","E01022885","Total",1479,80,16,64,1399,67,100,435,274,76,152,295
"2011","Hart 007A","E01022861","Total",1711,98,53,45,1613,41,264,422,240,94,195,357
"2011","Hart 007B","E01022863","Total",1573,129,91,38,1444,32,294,399,216,102,131,270
"2011","Hart 007C","E01022865","Total",1621,114,65,49,1507,19,270,379,214,101,160,364
"2011","Hart 007D","E01022868","Total",1699,122,77,45,1577,2,308,479,246,98,98,346
"2011","Hart 007E","E01022870","Total",1427,143,84,59,1284,19,228,365,176,67,124,305
"2011","Hart 008A","E01022864","Total",1443,185,94,91,1258,40,308,325,180,80,128,197
"2011","Hart 008B","E01022871","Total",1418,140,38,102,1278,66,102,411,220,100,142,237
"2011","Hart 008C","E01022872","Total",1792,174,99,75,1618,38,264,410,232,149,216,309
"2011","Hart 008D","E01022873","Total",1672,101,59,42,1571,27,290,376,234,78,232,334
"2011","Hart 008E","E01022887","Total",1380,90,40,50,1290,30,236,272,280,72,126,274
"2011","Hart 009A","E01022849","Total",1701,128,74,54,1573,30,228,472,224,129,166,324
"2011","Hart 009B","E01022850","Total",1475,200,62,138,1275,49,172,364,218,99,143,230
"2011","Hart 009C","E01022851","Total",1653,141,67,74,1512,58,230,416,274,113,134,287
"2011","Hart 009D","E01022853","Total",1743,156,92,64,1587,47,236,559,234,88,179,244
"2011","Hart 009E","E01022869","Total",1435,153,71,82,1282,28,228,377,226,83,106,234
"2011","Hart 010A","E01022852","Total",1813,197,35,162,1616,82,106,531,402,135,163,197
"2011","Hart 010B","E01022854","Total",1736,113,45,68,1623,78,162,574,274,111,174,250
"2011","Hart 010C","E01022855","Total",1239,113,61,52,1126,43,212,283,182,108,122,176
"2011","Hart 010D","E01022856","Total",1477,123,72,51,1354,28,244,335,236,100,154,257
"2011","Hart 010E","E01022857","Total",1424,39,12,27,1385,54,44,436,178,252,236,185
"2011","Hart 011B","E01022888","Total",1680,202,102,100,1478,41,290,384,298,95,125,245
"2011","Hart 011C","E01022889","Total",1479,192,115,77,1287,72,194,314,228,96,154,229
"2011","Hart 011D","E01032855","Total",1102,96,40,56,1006,46,120,269,192,93,68,218
"2011","Hart 011E","E01032856","Total",1401,15,3,12,1386,33,42,757,250,140,87,77
"2011","Havant 003A","E01022930","Total",1649,203,140,63,1446,40,374,224,284,49,84,391
"2011","Havant 003B","E01022931","Total",1645,105,80,25,1540,47,290,357,250,60,182,354
"2011","Havant 003C","E01022935","Total",1514,177,119,58,1337,46,320,262,202,98,171,238
"2011","Havant 003D","E01022975","Total",1513,167,118,49,1346,31,412,172,258,41,164,268
"2011","Havant 003E","E01022976","Total",1469,293,118,175,1176,69,178,208,192,75,211,243
"2011","Havant 004A","E01022922","Total",1499,202,52,150,1297,100,68,399,358,65,79,228
"2011","Havant 004B","E01022971","Total",1509,267,112,155,1242,52,234,240,258,30,163,265
"2011","Havant 004C","E01022972","Total",1578,144,89,55,1434,33,262,292,254,87,177,329
"2011","Havant 004D","E01022974","Total",1425,121,56,65,1304,45,244,253,254,65,140,303
"2011","Havant 005A","E01022959","Total",1458,128,76,52,1330,157,150,212,180,125,279,227
"2011","Havant 005B","E01022962","Total",1474,152,85,67,1322,65,186,329,232,75,130,305
"2011","Havant 005C","E01022965","Total",1478,184,60,124,1294,125,124,279,168,121,234,243
"2011","Havant 005D","E01022973","Total",1894,346,221,125,1548,103,228,289,230,209,184,305
"2011","Havant 006A","E01022901","Total",1676,138,53,85,1538,170,168,341,242,159,191,267
"2011","Havant 006B","E01022902","Total",1572,108,45,63,1464,126,138,336,198,141,247,278
"2011","Havant 006C","E01022966","Total",1373,112,41,71,1261,179,94,268,172,135,185,228
"2011","Havant 006D","E01022967","Total",1240,178,76,102,1062,214,78,188,132,150,96,204
"2011","Havant 007A","E01022960","Total",1392,93,24,69,1299,108,60,264,246,134,180,307
"2011","Havant 007B","E01022961","Total",1382,72,22,50,1310,89,90,355,210,117,180,269
"2011","Havant 007C","E01022963","Total",1412,174,84,90,1238,23,256,232,244,56,161,266
"2011","Havant 007D","E01022964","Total",1376,278,130,148,1098,144,88,225,210,91,119,221
"2011","Havant 008A","E01022903","Total",1795,258,81,177,1537,215,150,361,226,145,178,262
"2011","Havant 008B","E01022906","Total",1479,127,65,62,1352,184,92,300,228,104,237,207
"2011","Havant 008C","E01022968","Total",1447,117,58,59,1330,175,76,269,162,147,227,274
"2011","Havant 008D","E01022969","Total",1667,124,42,82,1543,190,102,349,166,125,261,350
"2011","Havant 009A","E01022913","Total",1307,161,74,87,1146,135,118,222,194,98,115,264
"2011","Havant 009B","E01022914","Total",1302,186,63,123,1116,105,140,191,140,98,186,256
"2011","Havant 009C","E01022915","Total",1468,200,62,138,1268,181,112,227,200,131,168,249
"2011","Havant 009D","E01022916","Total",1586,159,60,99,1427,152,146,375,222,107,168,257
"2011","Havant 009E","E01022917","Total",1243,186,93,93,1057,109,144,194,124,55,216,215
"2011","Havant 010A","E01022900","Total",1854,190,84,106,1664,176,214,309,236,191,161,377
"2011","Havant 010B","E01022904","Total",1990,170,85,85,1820,104,234,364,266,169,253,430
"2011","Havant 010C","E01022905","Total",1779,305,120,185,1474,259,160,317,236,151,134,217
"2011","Havant 010D","E01022908","Total",1453,148,64,84,1305,111,174,279,202,96,153,290
"2011","Havant 010E","E01022970","Total",1892,139,62,77,1753,264,118,366,236,213,227,329
"2011","Havant 011A","E01022947","Total",1645,116,63,53,1529,45,198,393,264,57,156,416
"2011","Havant 011B","E01022948","Total",1639,213,99,114,1426,75,194,343,210,64,203,337
"2011","Havant 011C","E01022949","Total",1525,343,173,170,1182,102,120,293,244,76,104,243
"2011","Havant 011D","E01022950","Total",1453,116,79,37,1337,15,276,305,226,72,167,276
"2011","Havant 011E","E01022951","Total",1393,106,74,32,1287,48,218,268,246,53,160,294
"2011","Havant 011F","E01022952","Total",1463,155,74,81,1308,65,264,215,270,57,166,271
"2011","Havant 013A","E01022924","Total",1568,218,117,101,1350,58,280,273,280,58,101,300
"2011","Havant 013B","E01022925","Total",1400,149,102,47,1251,67,256,267,216,92,132,221
"2011","Havant 013C","E01022926","Total",1529,131,96,35,1398,35,330,341,198,97,156,241
"2011","Havant 013D","E01022927","Total",1544,238,161,77,1306,76,292,272,226,53,114,273
"2011","Havant 013E","E01022928","Total",1678,267,197,70,1411,9,464,301,266,62,97,212
"2011","Havant 013F","E01022929","Total",1559,397,223,174,1162,46,324,196,282,69,64,181
"2011","Havant 014A","E01022953","Total",1992,453,199,254,1539,151,234,321,386,74,133,240
"2011","Havant 014B","E01022954","Total",1503,198,112,86,1305,42,338,202,274,52,153,244
"2011","Havant 014C","E01022955","Total",1328,213,140,73,1115,26,256,233,190,30,123,257
"2011","Havant 014D","E01022956","Total",1214,132,45,87,1082,75,86,335,222,83,114,167
"2011","Havant 014E","E01022957","Total",1271,141,75,66,1130,41,168,301,180,51,190,199
"2011","Havant 014F","E01022958","Total",1436,139,79,60,1297,33,262,249,274,65,141,273
"2011","Havant 015A","E01022937","Total",1387,168,95,73,1219,60,194,229,188,71,153,324
"2011","Havant 015B","E01022943","Total",1408,174,109,65,1234,8,452,172,200,103,81,218
"2011","Havant 015C","E01022944","Total",1258,106,56,50,1152,18,242,177,274,35,142,264
"2011","Havant 015D","E01022946","Total",1740,220,129,91,1520,63,382,296,262,100,142,275
"2011","Havant 016A","E01022940","Total",1539,230,127,103,1309,84,304,235,256,60,95,275
"2011","Havant 016B","E01022942","Total",1505,394,207,187,1111,95,260,200,274,60,87,135
"2011","Havant 016C","E01022945","Total",2231,314,185,129,1917,111,524,348,364,110,110,350
"2011","Havant 017A","E01022936","Total",1491,278,116,162,1213,103,326,171,342,20,72,179
"2011","Havant 017B","E01022938","Total",1342,224,143,81,1118,41,280,183,198,54,110,252
"2011","Havant 017C","E01022939","Total",1528,206,119,87,1322,50,320,172,254,58,176,292
"2011","Havant 017D","E01022941","Total",1503,195,94,101,1308,39,338,188,290,51,158,244
"2011","Havant 018A","E01022899","Total",1381,94,44,50,1287,109,132,235,166,103,181,361
"2011","Havant 018B","E01022907","Total",1477,152,104,48,1325,26,284,263,246,37,189,280
"2011","Havant 018C","E01022909","Total",1555,120,79,41,1435,43,250,261,292,64,210,315
"2011","Havant 018D","E01022910","Total",1421,235,90,145,1186,86,146,223,256,69,124,282
"2011","Havant 018E","E01022911","Total",1496,169,89,80,1327,39,280,220,228,110,167,283
"2011","Havant 018F","E01032605","Total",1342,108,77,31,1234,22,230,261,214,50,113,344
"2011","Havant 019A","E01022919","Total",1619,138,70,68,1481,79,224,268,270,100,230,310
"2011","Havant 019B","E01022933","Total",1672,261,67,194,1411,208,100,304,192,176,216,215
"2011","Havant 019C","E01022934","Total",1923,257,63,194,1666,244,110,409,238,190,185,290
"2011","Havant 019D","E01032618","Total",1486,141,67,74,1345,73,206,272,268,80,174,272
"2011","Havant 020A","E01022918","Total",1498,197,130,67,1301,46,262,267,236,58,138,294
"2011","Havant 020B","E01022920","Total",1566,156,96,60,1410,55,232,329,284,94,97,319
"2011","Havant 020C","E01022921","Total",1563,152,78,74,1411,49,256,325,234,78,148,321
"2011","Havant 020D","E01032617","Total",1561,149,114,35,1412,66,336,262,228,53,143,324
"2011","New Forest 001A","E01023011","Total",1459,145,69,76,1314,52,232,311,242,78,100,299
"2011","New Forest 001B","E01023012","Total",1369,141,81,60,1228,30,280,268,242,35,133,240
"2011","New Forest 001C","E01023021","Total",1470,147,88,59,1323,24,278,312,258,75,137,239
"2011","New Forest 001D","E01023022","Total",1747,358,207,151,1389,101,240,381,334,48,65,220
"2011","New Forest 001E","E01023023","Total",1757,209,120,89,1548,67,312,310,268,117,174,300
"2011","New Forest 001F","E01023024","Total",1513,140,105,35,1373,54,252,315,248,82,142,280
"2011","New Forest 001G","E01023025","Total",1364,127,78,49,1237,16,326,221,240,70,129,235
"2011","New Forest 002A","E01023076","Total",1419,168,117,51,1251,28,328,204,238,45,138,270
"2011","New Forest 002B","E01023082","Total",1466,179,48,131,1287,86,92,387,240,46,123,313
"2011","New Forest 002C","E01023083","Total",1515,215,105,110,1300,111,138,328,252,68,145,258
"2011","New Forest 002D","E01023088","Total",1600,156,91,65,1444,92,160,275,252,102,240,323
"2011","New Forest 003A","E01023073","Total",1375,102,22,80,1273,64,72,346,228,37,182,344
"2011","New Forest 003B","E01023080","Total",1336,109,45,64,1227,96,148,278,204,84,167,250
"2011","New Forest 003C","E01023081","Total",2005,152,51,101,1853,107,130,606,318,155,236,301
"2011","New Forest 003D","E01023089","Total",1545,227,84,143,1318,63,190,334,330,41,121,239
"2011","New Forest 003E","E01023090","Total",1886,257,61,196,1629,128,122,521,352,60,165,281
"2011","New Forest 004A","E01023074","Total",1418,233,160,73,1185,27,214,298,198,50,121,277
"2011","New Forest 004B","E01023077","Total",1490,283,102,181,1207,128,134,337,228,48,138,194
"2011","New Forest 004C","E01023078","Total",1399,180,137,43,1219,15,282,239,256,67,94,266
"2011","New Forest 004D","E01023079","Total",1733,162,66,96,1571,88,190,394,256,98,183,362
"2011","New Forest 004E","E01023085","Total",1535,164,85,79,1371,129,172,366,212,82,163,247
"2011","New Forest 005A","E01023072","Total",1300,140,29,111,1160,62,92,344,272,47,85,258
"2011","New Forest 005B","E01023075","Total",1191,119,61,58,1072,61,158,290,158,51,99,255
"2011","New Forest 005C","E01023084","Total",1540,133,85,48,1407,47,236,348,240,66,158,312
"2011","New Forest 005D","E01023086","Total",1526,150,94,56,1376,105,272,293,210,60,142,294
"2011","New Forest 005E","E01023087","Total",1480,163,21,142,1317,90,78,403,332,63,117,234
"2011","New Forest 006A","E01022977","Total",1452,135,81,54,1317,14,286,289,246,77,162,243
"2011","New Forest 006B","E01022978","Total",1498,136,72,64,1362,43,300,269,238,40,137,335
"2011","New Forest 006C","E01022979","Total",1136,112,62,50,1024,24,260,178,204,21,70,267
"2011","New Forest 006D","E01022980","Total",1344,116,74,42,1228,16,242,217,214,67,139,333
"2011","New Forest 007A","E01022992","Total",1153,111,59,52,1042,10,206,203,214,16,126,267
"2011","New Forest 007B","E01022993","Total",1272,149,70,79,1123,24,230,230,254,65,97,223
"2011","New Forest 007C","E01023045","Total",1538,233,129,104,1305,32,300,313,260,70,126,204
"2011","New Forest 007D","E01023046","Total",1381,238,117,121,1143,54,230,195,236,102,85,241
"2011","New Forest 008A","E01023007","Total",1137,158,78,80,979,27,202,183,188,64,107,208
"2011","New Forest 008B","E01023010","Total",1537,200,39,161,1337,138,118,376,230,119,143,213
"2011","New Forest 008C","E01023047","Total",1328,125,35,90,1203,58,120,334,260,60,132,239
"2011","New Forest 008D","E01023048","Total",1358,90,45,45,1268,54,170,280,242,96,137,289
"2011","New Forest 008E","E01023049","Total",1568,187,27,160,1381,101,90,475,388,57,129,141
"2011","New Forest 008F","E01023050","Total",1768,140,30,110,1628,111,130,580,302,89,169,247
"2011","New Forest 009A","E01023008","Total",1528,393,237,156,1135,52,432,165,236,31,83,136
"2011","New Forest 009B","E01023009","Total",1503,169,49,120,1334,77,140,360,332,72,112,241
"2011","New Forest 009C","E01023038","Total",1458,136,89,47,1322,34,328,293,256,51,87,273
"2011","New Forest 009D","E01023039","Total",1433,205,117,88,1228,80,286,231,238,55,132,206
"2011","New Forest 009E","E01023040","Total",1450,182,122,60,1268,39,358,268,246,60,74,223
"2011","New Forest 010A","E01023026","Total",1106,128,75,53,978,35,164,189,222,42,128,198
"2011","New Forest 010B","E01023062","Total",1477,96,51,45,1381,43,212,336,216,82,189,303
"2011","New Forest 010C","E01023064","Total",1356,112,52,60,1244,101,164,310,198,57,174,240
"2011","New Forest 010D","E01023066","Total",1642,175,111,64,1467,42,344,312,230,98,199,242
"2011","New Forest 010E","E01023067","Total",1490,138,81,57,1352,33,282,385,240,86,131,195
"2011","New Forest 011A","E01023003","Total",1727,220,165,55,1507,64,364,252,264,51,152,360
"2011","New Forest 011B","E01023004","Total",1837,128,77,51,1709,87,278,384,262,101,211,386
"2011","New Forest 011C","E01023005","Total",1469,145,93,52,1324,27,276,251,260,84,114,312
"2011","New Forest 011D","E01023006","Total",1391,86,39,47,1305,148,116,233,178,109,259,262
"2011","New Forest 011E","E01023028","Total",2090,214,118,96,1876,140,278,536,300,131,202,289
"2011","New Forest 011F","E01023037","Total",1885,385,207,178,1500,128,266,278,320,108,166,234
"2011","New Forest 012A","E01023065","Total",1643,174,103,71,1469,62,306,300,202,119,190,290
"2011","New Forest 012B","E01023068","Total",1338,118,55,63,1220,86,208,249,164,104,158,251
"2011","New Forest 012C","E01023069","Total",1548,190,118,72,1358,77,236,276,254,80,176,259
"2011","New Forest 012D","E01023070","Total",1672,448,259,189,1224,132,216,293,312,52,75,144
"2011","New Forest 012E","E01023071","Total",1369,233,70,163,1136,64,160,285,276,66,112,173
"2011","New Forest 013A","E01023029","Total",1681,143,69,74,1538,263,94,327,174,169,241,270
"2011","New Forest 013B","E01023030","Total",1308,100,39,61,1208,54,122,329,224,66,173,240
"2011","New Forest 013C","E01023032","Total",1303,133,76,57,1170,35,228,259,222,46,125,255
"2011","New Forest 013D","E01023033","Total",1302,128,75,53,1174,97,184,224,188,111,156,214
"2011","New Forest 014A","E01023013","Total",1463,175,84,91,1288,80,274,237,266,61,111,259
"2011","New Forest 014B","E01023014","Total",1675,169,105,64,1506,96,332,257,274,78,153,316
"2011","New Forest 014C","E01023015","Total",1445,144,73,71,1301,78,224,254,242,83,148,272
"2011","New Forest 014D","E01023016","Total",1388,149,95,54,1239,5,290,233,284,61,119,247
"2011","New Forest 014E","E01023027","Total",1430,145,68,77,1285,66,200,256,228,115,134,286
"2011","New Forest 014F","E01023031","Total",1239,144,67,77,1095,57,204,183,226,30,107,288
"2011","New Forest 015A","E01022989","Total",1717,195,109,86,1522,64,308,350,214,78,223,285
"2011","New Forest 015B","E01022991","Total",2020,230,139,91,1790,33,466,272,344,104,202,369
"2011","New Forest 015C","E01022998","Total",1638,121,84,37,1517,22,436,240,258,119,183,259
"2011","New Forest 015D","E01023000","Total",1725,267,177,90,1458,63,316,314,260,123,136,246
"2011","New Forest 016A","E01022994","Total",1579,154,97,57,1425,33,324,277,274,107,160,250
"2011","New Forest 016B","E01022995","Total",1414,130,69,61,1284,42,246,288,242,67,138,261
"2011","New Forest 016C","E01022996","Total",1218,122,68,54,1096,46,232,210,212,71,119,206
"2011","New Forest 016D","E01022997","Total",1324,170,94,76,1154,42,246,259,202,59,82,264
"2011","New Forest 016E","E01023063","Total",1225,88,47,41,1137,22,166,262,154,116,166,251
"2011","New Forest 017A","E01022990","Total",1489,171,97,74,1318,56,302,250,224,98,135,253
"2011","New Forest 017B","E01022999","Total",2089,228,116,112,1861,44,396,333,396,149,160,383
"2011","New Forest 017C","E01023041","Total",1514,251,149,102,1263,41,384,215,254,66,97,206
"2011","New Forest 017D","E01023042","Total",1442,509,290,219,933,68,282,164,232,17,28,142
"2011","New Forest 017E","E01023043","Total",1724,301,188,113,1423,84,284,321,296,92,89,257
"2011","New Forest 018A","E01022984","Total",1467,158,119,39,1309,12,428,210,190,37,108,324
"2011","New Forest 018B","E01022985","Total",1224,117,66,51,1107,57,206,279,238,25,107,195
"2011","New Forest 018C","E01023020","Total",1434,138,96,42,1296,38,384,250,204,64,111,245
"2011","New Forest 018D","E01023034","Total",1724,229,145,84,1495,81,382,289,282,82,142,237
"2011","New Forest 018E","E01023035","Total",1754,164,110,54,1590,76,338,367,254,78,161,316
"2011","New Forest 018F","E01023036","Total",1984,268,206,62,1716,38,604,273,290,90,158,263
"2011","New Forest 019A","E01023001","Total",1782,326,121,205,1456,105,222,448,332,32,81,236
"2011","New Forest 019B","E01023002","Total",1719,255,128,127,1464,138,222,359,268,125,115,237
"2011","New Forest 019C","E01023058","Total",1490,218,112,106,1272,155,152,284,170,108,183,220
"2011","New Forest 019D","E01023060","Total",1397,146,95,51,1251,48,240,268,208,73,116,298
"2011","New Forest 019E","E01023061","Total",1465,232,123,109,1233,68,208,234,218,114,143,248
"2011","New Forest 020A","E01023017","Total",1954,203,123,80,1751,142,324,357,246,125,248,309
"2011","New Forest 020B","E01023018","Total",1380,265,150,115,1115,122,236,226,188,72,60,211
"2011","New Forest 020C","E01023019","Total",1451,251,105,146,1200,118,108,339,234,52,139,210
"2011","New Forest 020D","E01023055","Total",1290,150,76,74,1140,147,120,222,126,103,193,229
"2011","New Forest 021A","E01022986","Total",1398,194,140,54,1204,51,320,167,200,25,147,294
"2011","New Forest 021B","E01022988","Total",1454,241,106,135,1213,105,168,251,256,65,101,267
"2011","New Forest 021C","E01023054","Total",1704,329,216,113,1375,64,426,199,182,62,132,310
"2011","New Forest 021D","E01023056","Total",1484,362,281,81,1122,92,392,243,166,53,45,131
"2011","New Forest 021E","E01023057","Total",1667,428,267,161,1239,53,378,180,226,56,145,201
"2011","New Forest 022A","E01022981","Total",1882,249,195,54,1633,34,658,214,274,50,110,293
"2011","New Forest 022B","E01022982","Total",1794,329,233,96,1465,46,560,184,332,29,59,255
"2011","New Forest 022C","E01022983","Total",1631,257,180,77,1374,34,540,164,236,55,137,208
"2011","New Forest 022D","E01022987","Total",1838,266,196,70,1572,37,662,204,294,65,89,221
"2011","New Forest 023A","E01023044","Total",1058,171,125,46,887,7,408,124,152,20,87,89
"2011","New Forest 023B","E01023051","Total",1517,175,113,62,1342,26,372,288,184,46,142,284
"2011","New Forest 023C","E01023052","Total",1626,374,281,93,1252,26,520,142,234,30,82,218
"2011","New Forest 023D","E01023053","Total",1615,320,239,81,1295,31,520,163,282,64,75,160
"2011","New Forest 023E","E01023059","Total",1636,264,183,81,1372,53,402,235,222,71,164,225
"2011","Rushmoor 001A","E01023099","Total",1587,134,71,63,1453,109,168,336,194,124,214,308
"2011","Rushmoor 001B","E01023104","Total",1670,123,63,60,1547,74,152,282,218,118,409,294
"2011","Rushmoor 001C","E01023106","Total",1479,157,57,100,1322,108,112,260,192,72,279,299
"2011","Rushmoor 001D","E01023121","Total",2016,167,90,77,1849,102,204,402,288,116,314,423
"2011","Rushmoor 002A","E01023105","Total",1559,184,89,95,1375,94,96,292,166,71,259,397
"2011","Rushmoor 002B","E01023119","Total",1302,130,24,106,1172,131,52,237,130,115,258,249
"2011","Rushmoor 002C","E01023120","Total",1797,142,58,84,1655,109,100,284,198,121,503,340
"2011","Rushmoor 002D","E01023122","Total",1514,84,29,55,1430,100,74,274,156,91,346,389
"2011","Rushmoor 002E","E01023146","Total",1374,86,28,58,1288,76,70,231,168,106,303,334
"2011","Rushmoor 003A","E01023100","Total",1257,116,17,99,1141,82,54,327,216,100,169,193
"2011","Rushmoor 003B","E01023101","Total",1278,73,35,38,1205,33,174,231,214,65,156,332
"2011","Rushmoor 003C","E01023102","Total",1374,113,50,63,1261,34,130,332,250,57,154,304
"2011","Rushmoor 003D","E01023134","Total",1811,153,38,115,1658,63,118,377,384,135,253,328
"2011","Rushmoor 003E","E01023147","Total",1493,111,60,51,1382,50,176,311,200,81,218,346
"2011","Rushmoor 004A","E01023096","Total",2113,263,99,164,1850,103,256,468,370,84,228,341
"2011","Rushmoor 004B","E01023097","Total",1418,114,68,46,1304,18,212,267,260,59,204,284
"2011","Rushmoor 004C","E01023103","Total",1616,135,58,77,1481,43,160,407,278,60,192,341
"2011","Rushmoor 004D","E01023111","Total",1754,238,114,124,1516,43,212,387,264,66,196,348
"2011","Rushmoor 004E","E01023112","Total",1270,80,33,47,1190,44,70,400,196,71,129,280
"2011","Rushmoor 005A","E01023092","Total",1465,118,21,97,1347,45,74,509,274,86,106,253
"2011","Rushmoor 005B","E01023093","Total",1376,80,22,58,1296,33,122,427,252,37,97,328
"2011","Rushmoor 005C","E01023132","Total",1560,148,85,63,1412,34,156,353,246,101,198,324
"2011","Rushmoor 005D","E01023133","Total",1353,102,21,81,1251,52,76,404,298,56,159,206
"2011","Rushmoor 005E","E01023135","Total",2419,218,77,141,2201,187,198,662,410,179,263,302
"2011","Rushmoor 006A","E01023091","Total",1713,192,72,120,1521,147,84,428,202,116,258,286
"2011","Rushmoor 006B","E01023094","Total",1330,137,40,97,1193,39,182,250,274,87,129,232
"2011","Rushmoor 006C","E01023095","Total",1762,233,94,139,1529,89,122,466,312,72,189,279
"2011","Rushmoor 006D","E01023098","Total",1558,185,78,107,1373,64,152,322,310,63,142,320
"2011","Rushmoor 006E","E01023148","Total",1379,183,67,116,1196,34,184,265,226,31,149,307
"2011","Rushmoor 006F","E01023149","Total",1301,135,79,56,1166,19,248,253,184,53,136,273
"2011","Rushmoor 007A","E01023113","Total",1529,214,71,143,1315,87,146,310,272,58,128,314
"2011","Rushmoor 007B","E01023114","Total",1460,115,21,94,1345,43,92,498,240,116,119,237
"2011","Rushmoor 007C","E01023136","Total",1749,158,35,123,1591,39,76,498,286,164,210,318
"2011","Rushmoor 007D","E01023137","Total",1286,116,39,77,1170,78,80,349,260,42,138,223
"2011","Rushmoor 007E","E01023138","Total",1311,290,96,194,1021,75,84,264,270,51,85,192
"2011","Rushmoor 007F","E01023139","Total",1225,183,84,99,1042,60,98,303,196,77,151,157
"2011","Rushmoor 007G","E01023140","Total",1616,143,50,93,1473,55,20,631,290,171,181,125
"2011","Rushmoor 008A","E01023141","Total",1858,75,1,74,1783,84,4,979,294,160,152,110
"2011","Rushmoor 008B","E01023142","Total",1913,293,15,278,1620,83,72,625,400,50,179,211
"2011","Rushmoor 008C","E01023143","Total",2006,172,44,128,1834,54,24,818,254,305,264,115
"2011","Rushmoor 008D","E01023144","Total",1743,213,64,149,1530,72,62,378,254,65,365,334
"2011","Rushmoor 009A","E01023118","Total",1749,189,64,125,1560,73,84,382,256,76,292,397
"2011","Rushmoor 009B","E01023124","Total",1267,108,33,75,1159,40,78,296,236,48,190,271
"2011","Rushmoor 009C","E01023125","Total",2388,169,38,131,2219,122,172,660,452,175,228,410
"2011","Rushmoor 009F","E01032858","Total",2129,242,60,182,1887,234,116,508,312,125,226,366
"2011","Rushmoor 010A","E01023128","Total",1386,221,104,117,1165,48,112,284,230,103,141,247
"2011","Rushmoor 010B","E01023129","Total",1265,170,42,128,1095,60,78,208,224,21,253,251
"2011","Rushmoor 010C","E01023130","Total",1376,113,66,47,1263,49,178,273,232,46,140,345
"2011","Rushmoor 010D","E01023131","Total",1323,196,123,73,1127,32,186,242,212,60,152,243
"2011","Rushmoor 010E","E01023145","Total",1989,402,103,299,1587,80,78,389,398,51,289,302
"2011","Rushmoor 011A","E01023109","Total",1504,124,51,73,1380,71,126,340,272,50,140,381
"2011","Rushmoor 011B","E01023115","Total",1319,73,36,37,1246,32,116,312,182,78,228,298
"2011","Rushmoor 011C","E01023116","Total",1802,134,28,106,1668,62,108,329,312,82,320,455
"2011","Rushmoor 011D","E01023117","Total",1794,123,46,77,1671,34,172,399,300,139,191,436
"2011","Rushmoor 012A","E01023107","Total",1440,210,124,86,1230,81,136,282,190,86,180,275
"2011","Rushmoor 012B","E01023108","Total",1328,206,108,98,1122,74,176,229,180,101,147,215
"2011","Rushmoor 012C","E01023110","Total",1783,176,77,99,1607,134,146,384,250,109,201,383
"2011","Rushmoor 012D","E01023123","Total",1454,129,50,79,1325,53,138,330,278,56,224,246
"2011","Test Valley 001A","E01023165","Total",2109,190,87,103,1919,47,332,439,402,223,188,288
"2011","Test Valley 001B","E01023169","Total",1936,213,120,93,1723,29,312,398,390,52,177,365
"2011","Test Valley 001C","E01023181","Total",1408,71,12,59,1337,60,80,455,260,63,184,235
"2011","Test Valley 001D","E01023182","Total",1569,143,36,107,1426,76,88,488,344,75,86,269
"2011","Test Valley 002A","E01023153","Total",1668,243,45,198,1425,193,106,323,338,97,153,215
"2011","Test Valley 002B","E01023154","Total",1695,126,44,82,1569,144,138,439,236,147,154,311
"2011","Test Valley 002C","E01023156","Total",1475,69,16,53,1406,176,60,327,136,225,222,260
"2011","Test Valley 002D","E01023157","Total",1426,112,46,66,1314,164,108,302,192,108,190,250
"2011","Test Valley 002E","E01023205","Total",1348,66,24,42,1282,138,72,307,146,160,222,237
"2011","Test Valley 003A","E01023155","Total",2711,267,65,202,2444,151,208,636,480,236,304,429
"2011","Test Valley 003B","E01023201","Total",1587,141,83,58,1446,111,180,239,248,110,232,326
"2011","Test Valley 003C","E01023202","Total",1703,500,214,286,1203,107,158,263,378,46,73,178
"2011","Test Valley 003D","E01023215","Total",1558,191,110,81,1367,68,218,343,240,63,119,316
"2011","Test Valley 003E","E01023219","Total",1407,178,74,104,1229,74,210,236,244,42,164,259
"2011","Test Valley 004A","E01023179","Total",1819,156,67,89,1663,154,138,380,284,109,255,343
"2011","Test Valley 004B","E01023183","Total",1414,153,67,86,1261,92,144,333,216,90,138,248
"2011","Test Valley 004C","E01023190","Total",1189,186,104,82,1003,32,186,200,256,53,98,178
"2011","Test Valley 004D","E01023203","Total",1528,189,80,109,1339,51,212,246,294,36,230,270
"2011","Test Valley 004E","E01023204","Total",1666,209,84,125,1457,148,142,321,378,148,96,224
"2011","Test Valley 005B","E01023180","Total",1663,162,101,61,1501,69,264,335,314,140,127,252
"2011","Test Valley 005C","E01023186","Total",1707,189,73,116,1518,105,206,411,304,104,135,253
"2011","Test Valley 005D","E01023189","Total",1599,111,52,59,1488,49,160,406,272,116,198,287
"2011","Test Valley 005E","E01023196","Total",1659,162,81,81,1497,27,262,390,296,130,141,251
"2011","Test Valley 005F","E01032870","Total",1911,142,56,86,1769,46,212,499,312,154,279,267
"2011","Test Valley 005G","E01032871","Total",1531,165,90,75,1366,68,224,306,238,111,157,262
"2011","Test Valley 006A","E01023187","Total",1457,161,74,87,1296,37,168,296,344,91,113,247
"2011","Test Valley 006B","E01023188","Total",1332,111,48,63,1221,30,114,345,210,91,146,285
"2011","Test Valley 006C","E01023216","Total",1769,317,114,203,1452,103,182,346,354,78,135,254
"2011","Test Valley 006D","E01023217","Total",1564,184,95,89,1380,46,216,319,274,61,204,260
"2011","Test Valley 006E","E01023218","Total",1522,127,73,54,1395,39,258,349,278,80,148,243
"2011","Test Valley 007A","E01023159","Total",2174,218,103,115,1956,56,410,383,406,161,187,353
"2011","Test Valley 007B","E01023195","Total",1990,103,34,69,1887,26,168,674,376,220,184,239
"2011","Test Valley 007C","E01023197","Total",1503,105,46,59,1398,64,138,463,280,114,87,252
"2011","Test Valley 007D","E01023198","Total",1424,151,83,68,1273,30,250,276,302,93,115,207
"2011","Test Valley 008A","E01023160","Total",1434,135,87,48,1299,18,258,271,260,94,125,273
"2011","Test Valley 008B","E01023168","Total",1435,166,90,76,1269,10,274,254,302,36,119,274
"2011","Test Valley 008C","E01023178","Total",2260,194,91,103,2066,58,338,492,430,211,204,333
"2011","Test Valley 009A","E01023166","Total",1477,177,95,82,1300,60,210,271,290,108,106,255
"2011","Test Valley 009B","E01023167","Total",1562,195,135,60,1367,47,336,243,266,112,142,221
"2011","Test Valley 009C","E01023177","Total",2172,190,94,96,1982,70,324,434,390,185,218,361
"2011","Test Valley 009D","E01023184","Total",1356,75,38,37,1281,29,182,308,252,93,189,228
"2011","Test Valley 009E","E01023185","Total",1227,123,67,56,1104,52,216,263,186,87,125,175
"2011","Test Valley 010A","E01023174","Total",1737,183,64,119,1554,57,178,404,324,97,185,309
"2011","Test Valley 010B","E01023175","Total",1625,170,73,97,1455,50,330,378,266,62,149,220
"2011","Test Valley 010C","E01023176","Total",1494,256,126,130,1238,69,228,225,294,53,134,235
"2011","Test Valley 010D","E01023207","Total",1532,140,80,60,1392,38,306,363,244,51,136,254
"2011","Test Valley 010E","E01023208","Total",1151,125,56,69,1026,68,158,232,178,58,112,220
"2011","Test Valley 010F","E01023209","Total",1362,111,50,61,1251,28,174,295,242,79,140,293
"2011","Test Valley 011A","E01023150","Total",1507,293,151,142,1214,103,170,237,236,40,125,303
"2011","Test Valley 011B","E01023151","Total",1454,387,265,122,1067,113,212,231,194,58,67,192
"2011","Test Valley 011C","E01023152","Total",1600,380,257,123,1220,44,366,193,258,37,113,209
"2011","Test Valley 011D","E01023206","Total",1153,153,95,58,1000,45,188,183,154,60,176,194
"2011","Test Valley 012A","E01023158","Total",2261,192,111,81,2069,43,430,469,310,142,225,450
"2011","Test Valley 012B","E01023191","Total",1824,203,79,124,1621,72,192,409,404,128,156,260
"2011","Test Valley 012C","E01023192","Total",1817,280,160,120,1537,164,242,415,254,100,148,214
"2011","Test Valley 012D","E01023193","Total",1590,139,96,43,1451,41,308,291,242,71,146,352
"2011","Test Valley 012E","E01023194","Total",1542,113,84,29,1429,39,354,233,238,67,154,344
"2011","Test Valley 012F","E01023200","Total",1471,127,53,74,1344,42,158,352,320,56,130,286
"2011","Test Valley 013A","E01023162","Total",1671,131,72,59,1540,32,310,334,244,99,188,333
"2011","Test Valley 013B","E01023163","Total",1654,118,62,56,1536,24,322,311,274,95,158,352
"2011","Test Valley 013C","E01023164","Total",1540,171,97,74,1369,43,270,277,244,61,167,307
"2011","Test Valley 013D","E01023199","Total",1555,162,64,98,1393,50,194,297,242,90,175,345
"2011","Test Valley 014A","E01023210","Total",1579,55,15,40,1524,31,116,506,230,158,210,273
"2011","Test Valley 014B","E01023211","Total",1925,100,15,85,1825,128,52,789,330,155,181,190
"2011","Test Valley 014C","E01023212","Total",1511,124,55,69,1387,26,152,342,274,105,189,299
"2011","Test Valley 014D","E01023213","Total",1366,77,34,43,1289,37,100,450,212,96,111,283
"2011","Test Valley 014E","E01023214","Total",1332,108,36,72,1224,39,120,395,248,36,131,255
"2011","Test Valley 015A","E01023170","Total",1740,154,66,88,1586,114,198,403,290,62,213,306
"2011","Test Valley 015B","E01023171","Total",1568,105,52,53,1463,18,248,233,262,76,260,366
"2011","Test Valley 015C","E01023172","Total",1498,124,78,46,1374,19,250,254,276,87,148,340
"2011","Test Valley 015D","E01023173","Total",1475,108,58,50,1367,18,218,246,290,67,188,340
"2011","Winchester 001A","E01023286","Total",1419,153,82,71,1266,48,182,340,240,87,141,228
"2011","Winchester 001B","E01023287","Total",2811,148,86,62,2663,55,362,807,534,182,218,505
"2011","Winchester 001C","E01023288","Total",1387,129,51,78,1258,44,152,379,328,114,49,192
"2011","Winchester 002A","E01023236","Total",1896,203,95,108,1693,39,352,394,324,160,184,240
"2011","Winchester 002B","E01023237","Total",1249,182,89,93,1067,95,126,259,234,63,101,189
"2011","Winchester 002C","E01023238","Total",1434,127,66,61,1307,47,182,366,270,93,110,239
"2011","Winchester 002D","E01023239","Total",1624,145,62,83,1479,32,212,413,296,109,155,262
"2011","Winchester 003A","E01023240","Total",2210,196,132,64,2014,54,428,524,234,171,193,410
"2011","Winchester 003B","E01023241","Total",1204,111,65,46,1093,12,282,242,206,25,147,179
"2011","Winchester 003C","E01023248","Total",1710,148,110,38,1562,18,334,351,222,168,170,299
"2011","Winchester 003D","E01023253","Total",1525,239,139,100,1286,48,280,389,232,81,70,186
"2011","Winchester 003E","E01023274","Total",1514,153,97,56,1361,32,266,326,206,132,111,288
"2011","Winchester 004A","E01023225","Total",2184,149,87,62,2035,49,310,490,362,266,239,319
"2011","Winchester 004B","E01023278","Total",1621,236,151,85,1385,62,238,368,248,86,146,237
"2011","Winchester 004C","E01023279","Total",1464,136,76,60,1328,39,262,361,236,58,118,254
"2011","Winchester 004D","E01023280","Total",1501,117,68,49,1384,35,226,350,232,116,163,262
"2011","Winchester 004E","E01023281","Total",1729,301,197,104,1428,52,380,327,242,99,117,211
"2011","Winchester 005A","E01023247","Total",1475,176,120,56,1299,31,242,279,240,141,103,263
"2011","Winchester 005B","E01023249","Total",1220,173,104,69,1047,14,176,227,158,85,163,224
"2011","Winchester 005C","E01023250","Total",1661,201,121,80,1460,102,172,298,248,162,201,277
"2011","Winchester 005D","E01023268","Total",1289,105,38,67,1184,24,124,375,188,127,143,203
"2011","Winchester 005E","E01023269","Total",1698,152,49,103,1546,64,164,389,254,112,144,419
"2011","Winchester 005F","E01023270","Total",1194,103,53,50,1091,47,104,297,186,140,128,189
"2011","Winchester 006A","E01023251","Total",1130,331,227,104,799,49,116,164,222,16,41,191
"2011","Winchester 006B","E01023255","Total",1484,269,89,180,1215,78,128,325,268,47,89,280
"2011","Winchester 006C","E01023256","Total",1406,220,78,142,1186,133,124,220,202,92,132,283
"2011","Winchester 006D","E01023257","Total",1508,229,86,143,1279,96,162,279,266,47,128,301
"2011","Winchester 006E","E01023258","Total",1315,148,52,96,1167,55,104,248,210,136,113,301
"2011","Winchester 007A","E01023252","Total",1725,507,151,356,1218,55,114,225,408,36,116,264
"2011","Winchester 007B","E01023254","Total",1782,315,134,181,1467,96,140,444,342,163,85,197
"2011","Winchester 007C","E01023263","Total",1249,227,96,131,1022,28,186,225,218,68,68,229
"2011","Winchester 007D","E01023264","Total",1293,320,147,173,973,27,124,293,258,47,26,198
"2011","Winchester 007E","E01023265","Total",1748,325,163,162,1423,34,190,355,306,160,118,260
"2011","Winchester 007F","E01023267","Total",1201,179,44,135,1022,24,90,329,244,61,62,212
"2011","Winchester 008A","E01023260","Total",1317,145,65,80,1172,94,60,229,126,100,151,412
"2011","Winchester 008B","E01023261","Total",1584,204,95,109,1380,73,114,210,154,68,156,605
"2011","Winchester 008C","E01023262","Total",1551,81,45,36,1470,101,108,183,136,78,159,705
"2011","Winchester 008D","E01023266","Total",1434,169,72,97,1265,54,172,269,174,137,127,332
"2011","Winchester 009A","E01023229","Total",2016,172,97,75,1844,19,306,506,266,209,241,297
"2011","Winchester 009B","E01023242","Total",1209,120,37,83,1089,10,102,316,250,75,109,227
"2011","Winchester 009C","E01023243","Total",1292,224,51,173,1068,42,60,314,352,52,65,183
"2011","Winchester 009D","E01023244","Total",1547,149,107,42,1398,18,364,283,220,65,185,263
"2011","Winchester 009E","E01023259","Total",1490,117,72,45,1373,49,176,298,160,101,181,408
"2011","Winchester 010A","E01023226","Total",1554,161,87,74,1393,35,234,406,216,132,136,234
"2011","Winchester 010B","E01023227","Total",1839,222,105,117,1617,77,240,446,332,104,131,287
"2011","Winchester 010C","E01023228","Total",2018,242,126,116,1776,38,326,438,318,151,197,308
"2011","Winchester 010D","E01023230","Total",2024,184,67,117,1840,30,272,525,328,141,185,359
"2011","Winchester 010E","E01023246","Total",1476,120,58,62,1356,31,180,283,264,108,213,277
"2011","Winchester 011A","E01023235","Total",2000,184,111,73,1816,32,362,464,368,142,123,325
"2011","Winchester 011B","E01023275","Total",1455,129,89,40,1326,42,216,303,238,85,211,231
"2011","Winchester 011C","E01023276","Total",1562,84,42,42,1478,35,238,373,242,92,241,257
"2011","Winchester 011D","E01023277","Total",1234,85,47,38,1149,12,192,247,232,46,150,270
"2011","Winchester 011E","E01023282","Total",1873,228,116,112,1645,50,318,377,326,144,195,235
"2011","Winchester 012A","E01023220","Total",2016,225,80,145,1791,77,210,543,358,98,205,300
"2011","Winchester 012B","E01023221","Total",1706,316,206,110,1390,83,248,280,302,99,146,232
"2011","Winchester 012C","E01023222","Total",1481,160,75,85,1321,20,248,288,276,94,132,263
"2011","Winchester 012D","E01023223","Total",1460,149,88,61,1311,67,182,315,232,100,160,255
"2011","Winchester 012E","E01023272","Total",1255,117,54,63,1138,43,170,287,240,85,107,206
"2011","Winchester 012F","E01023273","Total",1481,123,61,62,1358,35,220,339,204,117,145,298
"2011","Winchester 013A","E01023245","Total",2273,184,93,91,2089,46,362,458,408,161,249,405
"2011","Winchester 013B","E01023271","Total",1143,97,61,36,1046,22,178,239,176,94,104,233
"2011","Winchester 013D","E01023284","Total",2641,358,89,269,2283,134,260,585,576,179,233,316
"2011","Winchester 013E","E01023285","Total",1540,232,148,84,1308,54,278,305,222,117,88,244
"2011","Winchester 013F","E01032859","Total",1794,98,14,84,1696,104,84,665,310,136,142,255
"2011","Winchester 013G","E01032860","Total",1442,176,12,164,1266,100,46,447,384,86,73,130
"2011","Winchester 014A","E01023224","Total",1300,88,52,36,1212,47,170,347,220,59,157,212
"2011","Winchester 014B","E01023231","Total",1753,112,60,52,1641,26,288,409,328,126,168,296
"2011","Winchester 014C","E01023232","Total",1885,142,71,71,1743,32,278,353,314,148,246,372
"2011","Winchester 014D","E01023233","Total",1454,194,123,71,1260,25,196,413,212,66,165,183
"2011","Winchester 014E","E01023234","Total",1583,193,116,77,1390,69,194,382,236,93,165,251
"2011","Ashford 001B","E01023987","Total",1039,134,77,57,905,23,162,196,174,96,83,171
"2011","Ashford 001C","E01023988","Total",1391,124,52,72,1267,22,220,273,214,108,183,247
"2011","Ashford 001D","E01024040","Total",1140,209,123,86,931,61,206,241,152,57,63,151
"2011","Ashford 001E","E01024041","Total",1115,174,107,67,941,30,196,227,170,76,114,128
"2011","Ashford 001F","E01032810","Total",1488,135,32,103,1353,142,96,437,246,141,92,199
"2011","Ashford 001G","E01032812","Total",1744,119,51,68,1625,69,188,510,302,82,266,208
"2011","Ashford 002A","E01023985","Total",1103,160,101,59,943,28,256,151,168,41,116,183
"2011","Ashford 002B","E01023986","Total",1213,185,104,81,1028,42,180,235,232,62,73,204
"2011","Ashford 002C","E01023989","Total",1182,84,51,33,1098,18,192,236,178,91,165,218
"2011","Ashford 002D","E01023990","Total",1194,114,64,50,1080,61,196,227,226,68,111,191
"2011","Ashford 002E","E01024033","Total",1713,130,75,55,1583,38,238,387,308,112,154,346
"2011","Ashford 002F","E01024035","Total",1073,111,67,44,962,17,200,217,168,72,131,157
"2011","Ashford 003A","E01023983","Total",1367,173,114,59,1194,39,264,265,214,66,96,250
"2011","Ashford 003B","E01023999","Total",2171,192,116,76,1979,65,402,409,412,130,235,326
"2011","Ashford 003D","E01032811","Total",1646,106,17,89,1540,148,82,488,246,178,172,226
"2011","Ashford 003E","E01032822","Total",1450,135,93,42,1315,47,194,315,162,88,220,289
"2011","Ashford 004A","E01023980","Total",1150,158,77,81,992,61,190,238,172,56,64,211
"2011","Ashford 004B","E01023981","Total",1219,144,68,76,1075,87,166,193,168,95,161,205
"2011","Ashford 004C","E01023984","Total",1210,135,49,86,1075,165,106,248,168,91,103,194
"2011","Ashford 004E","E01023992","Total",1499,184,84,100,1315,127,134,297,240,61,174,282
"2011","Ashford 004F","E01023993","Total",1464,97,34,63,1367,59,82,413,220,121,195,277
"2011","Ashford 004G","E01024021","Total",1274,254,81,173,1020,87,94,231,246,61,116,185
"2011","Ashford 004H","E01024022","Total",1393,173,101,72,1220,71,240,255,198,63,147,246
"2011","Ashford 004I","E01032820","Total",1559,134,20,114,1425,115,112,520,298,99,93,188
"2011","Ashford 004J","E01032821","Total",1714,116,56,60,1598,76,100,517,262,149,244,250
"2011","Ashford 005A","E01023973","Total",1591,257,88,169,1334,237,128,334,224,83,118,210
"2011","Ashford 005B","E01024002","Total",1439,140,43,97,1299,141,76,352,226,93,165,246
"2011","Ashford 005C","E01024023","Total",2454,281,111,170,2173,193,162,612,358,237,243,368
"2011","Ashford 005D","E01024027","Total",1529,293,90,203,1236,110,92,270,258,76,141,289
"2011","Ashford 005E","E01024029","Total",2372,258,116,142,2114,170,232,472,290,182,272,496
"2011","Ashford 006A","E01023972","Total",1281,138,65,73,1143,65,116,274,168,89,182,249
"2011","Ashford 006B","E01023995","Total",1199,105,44,61,1094,29,158,253,192,65,125,272
"2011","Ashford 006C","E01023996","Total",1328,77,29,48,1251,79,82,360,210,80,181,259
"2011","Ashford 006D","E01024003","Total",1701,208,120,88,1493,84,292,253,312,58,172,322
"2011","Ashford 006E","E01024004","Total",1704,173,68,105,1531,43,236,335,292,122,194,309
"2011","Ashford 006F","E01024005","Total",1564,191,85,106,1373,108,146,328,254,103,166,268
"2011","Ashford 007A","E01023974","Total",1306,134,69,65,1172,139,138,192,160,81,202,260
"2011","Ashford 007B","E01023975","Total",1644,142,77,65,1502,131,178,266,168,164,255,340
"2011","Ashford 007C","E01023977","Total",1160,160,52,108,1000,70,114,238,272,30,108,168
"2011","Ashford 007D","E01024016","Total",1363,254,53,201,1109,105,98,306,282,55,81,182
"2011","Ashford 007E","E01024017","Total",1729,247,89,158,1482,116,158,428,366,71,136,207
"2011","Ashford 007F","E01024028","Total",1718,199,65,134,1519,236,94,335,226,122,228,278
"2011","Ashford 008A","E01023976","Total",1636,227,125,102,1409,94,186,290,170,124,236,309
"2011","Ashford 008B","E01024019","Total",1472,93,18,75,1379,199,76,222,136,172,305,269
"2011","Ashford 008C","E01024020","Total",1979,112,32,80,1867,327,60,385,168,329,347,251
"2011","Ashford 008E","E01032816","Total",1765,122,26,96,1643,65,90,534,356,108,218,272
"2011","Ashford 008F","E01032823","Total",1673,120,37,83,1553,136,114,375,206,133,239,350
"2011","Ashford 009A","E01024001","Total",1529,200,85,115,1329,143,144,298,240,94,127,283
"2011","Ashford 009B","E01024006","Total",1308,57,20,37,1251,59,80,434,176,102,225,175
"2011","Ashford 009D","E01024008","Total",2044,100,23,77,1944,148,102,660,312,179,265,278
"2011","Ashford 009F","E01032815","Total",1044,128,28,100,916,131,52,244,144,137,84,124
"2011","Ashford 009G","E01032817","Total",1205,92,9,83,1113,126,42,320,186,87,159,193
"2011","Ashford 009H","E01032818","Total",1581,84,14,70,1497,140,58,520,242,190,180,167
"2011","Ashford 009I","E01032819","Total",1808,103,17,86,1705,150,64,579,306,193,228,185
"2011","Ashford 009J","E01032824","Total",1482,145,40,105,1337,78,116,371,246,79,199,248
"2011","Ashford 010A","E01024013","Total",1673,174,106,68,1499,92,272,326,268,93,130,318
"2011","Ashford 010B","E01024014","Total",1671,105,48,57,1566,58,302,300,270,130,198,308
"2011","Ashford 010C","E01024015","Total",1602,119,64,55,1483,22,292,311,294,100,156,308
"2011","Ashford 010D","E01024034","Total",2394,188,91,97,2206,73,298,568,442,119,305,401
"2011","Ashford 011A","E01023978","Total",1267,93,64,29,1174,30,304,199,180,77,175,209
"2011","Ashford 011B","E01023979","Total",1303,134,71,63,1169,76,184,311,182,104,130,182
"2011","Ashford 011C","E01024032","Total",1573,154,76,78,1419,58,220,290,204,122,237,288
"2011","Ashford 011D","E01024036","Total",1301,122,62,60,1179,40,172,247,238,76,157,249
"2011","Ashford 012B","E01024031","Total",1470,172,98,74,1298,49,256,224,238,117,141,273
"2011","Ashford 012C","E01024038","Total",1855,224,148,76,1631,38,430,363,268,103,155,274
"2011","Ashford 012D","E01024039","Total",1491,102,63,39,1389,30,244,259,246,90,253,267
"2011","Ashford 012E","E01032813","Total",1812,175,29,146,1637,118,68,654,350,112,170,165
"2011","Ashford 012F","E01032814","Total",1865,173,78,95,1692,85,198,504,302,128,184,291
"2011","Ashford 013A","E01024009","Total",1076,123,74,49,953,18,276,145,166,45,107,196
"2011","Ashford 013B","E01024010","Total",1276,188,97,91,1088,49,216,225,206,75,118,199
"2011","Ashford 013C","E01024011","Total",1232,126,79,47,1106,53,196,287,138,74,143,215
"2011","Ashford 013D","E01024012","Total",1074,118,67,51,956,50,168,215,168,73,106,176
"2011","Ashford 013E","E01024024","Total",2229,426,285,141,1803,100,526,331,286,116,170,274
"2011","Ashford 013F","E01024025","Total",1125,223,159,64,902,122,232,154,166,35,80,113
"2011","Ashford 014A","E01023997","Total",1453,163,90,73,1290,53,232,296,196,77,142,294
"2011","Ashford 014B","E01023998","Total",1112,119,69,50,993,54,200,185,178,63,111,202
"2011","Ashford 014C","E01024026","Total",1262,112,69,43,1150,22,234,222,154,113,159,246
"2011","Ashford 014D","E01024037","Total",1758,189,115,74,1569,83,294,387,272,119,136,278
"2011","Canterbury 001A","E01024078","Total",1667,512,192,320,1155,190,78,257,262,109,123,136
"2011","Canterbury 001B","E01024080","Total",1188,281,80,201,907,127,86,224,196,58,70,146
"2011","Canterbury 001C","E01024081","Total",1438,445,195,250,993,107,114,175,188,86,117,206
"2011","Canterbury 001D","E01024082","Total",1388,181,93,88,1207,135,154,290,214,74,126,214
"2011","Canterbury 001E","E01024095","Total",1407,178,68,110,1229,104,190,254,208,74,138,261
"2011","Canterbury 002A","E01024094","Total",2421,224,108,116,2197,62,440,480,372,162,297,384
"2011","Canterbury 002B","E01024096","Total",1703,218,146,72,1485,63,370,263,242,93,209,245
"2011","Canterbury 002C","E01024097","Total",1533,286,216,70,1247,53,344,217,210,51,103,269
"2011","Canterbury 002D","E01024098","Total",1518,151,118,33,1367,66,364,219,226,54,155,283
"2011","Canterbury 003A","E01024064","Total",2409,175,87,88,2234,66,310,575,344,140,388,411
"2011","Canterbury 003B","E01024066","Total",1595,178,109,69,1417,162,166,281,224,118,213,253
"2011","Canterbury 003C","E01024079","Total",1456,183,112,71,1273,74,226,287,202,85,148,251
"2011","Canterbury 003D","E01024083","Total",1357,266,168,98,1091,129,202,237,154,46,120,203
"2011","Canterbury 003E","E01024118","Total",1757,254,155,99,1503,116,254,271,212,117,249,284
"2011","Canterbury 004A","E01024059","Total",1529,308,193,115,1221,106,284,166,216,118,164,167
"2011","Canterbury 004B","E01024065","Total",2012,184,112,72,1828,112,256,382,282,136,300,360
"2011","Canterbury 004C","E01024117","Total",1406,179,118,61,1227,53,334,227,198,58,109,248
"2011","Canterbury 004D","E01024119","Total",1589,160,73,87,1429,180,146,403,154,141,177,228
"2011","Canterbury 004E","E01024120","Total",1565,258,152,106,1307,60,392,262,240,31,93,229
"2011","Canterbury 005A","E01024056","Total",1912,139,95,44,1773,17,478,310,290,99,242,337
"2011","Canterbury 005B","E01024057","Total",1792,204,130,74,1588,45,456,237,318,65,213,254
"2011","Canterbury 005C","E01024058","Total",1612,171,76,95,1441,96,226,315,244,96,175,289
"2011","Canterbury 005D","E01024114","Total",1720,263,163,100,1457,35,314,382,254,83,133,256
"2011","Canterbury 005E","E01024115","Total",1391,179,131,48,1212,30,362,196,226,52,134,212
"2011","Canterbury 006A","E01024073","Total",1943,193,93,100,1750,113,290,386,334,123,221,283
"2011","Canterbury 006B","E01024074","Total",1477,81,49,32,1396,72,182,263,224,125,165,365
"2011","Canterbury 006C","E01024075","Total",1567,188,103,85,1379,63,280,272,270,101,169,224
"2011","Canterbury 006D","E01024076","Total",1875,198,77,121,1677,123,190,439,280,85,299,261
"2011","Canterbury 006E","E01024077","Total",1467,109,45,64,1358,105,152,329,228,121,178,245
"2011","Canterbury 007A","E01024055","Total",1519,199,139,60,1320,35,342,286,218,55,131,253
"2011","Canterbury 007B","E01024061","Total",1496,243,132,111,1253,181,172,188,180,156,176,200
"2011","Canterbury 007C","E01024063","Total",1551,138,71,67,1413,59,226,346,236,103,162,281
"2011","Canterbury 007D","E01024071","Total",1675,226,107,119,1449,120,136,372,252,97,206,266
"2011","Canterbury 007E","E01024116","Total",1445,198,126,72,1247,39,262,291,212,86,144,213
"2011","Canterbury 008A","E01024060","Total",1519,202,91,111,1317,94,194,304,254,77,138,256
"2011","Canterbury 008B","E01024069","Total",1380,201,70,131,1179,121,80,359,242,95,118,164
"2011","Canterbury 008C","E01024070","Total",1360,307,112,195,1053,92,158,256,256,55,90,146
"2011","Canterbury 008D","E01024072","Total",1300,283,68,215,1017,119,102,293,248,41,83,131
"2011","Canterbury 008E","E01024106","Total",1491,212,121,91,1279,76,294,305,224,42,112,226
"2011","Canterbury 009A","E01024062","Total",1538,134,68,66,1404,61,208,297,272,123,174,269
"2011","Canterbury 009B","E01024105","Total",1530,203,121,82,1327,60,374,250,200,50,115,278
"2011","Canterbury 009C","E01024107","Total",1462,121,65,56,1341,63,254,331,194,66,143,290
"2011","Canterbury 009D","E01024108","Total",1146,163,69,94,983,110,194,214,206,46,104,109
"2011","Canterbury 009E","E01024109","Total",2247,239,165,74,2008,76,464,440,362,141,215,310
"2011","Canterbury 010A","E01024084","Total",1113,124,62,62,989,98,144,231,184,53,113,166
"2011","Canterbury 010B","E01024085","Total",1522,170,84,86,1352,45,230,309,252,91,179,246
"2011","Canterbury 010C","E01024086","Total",2050,184,52,132,1866,149,166,464,324,232,217,314
"2011","Canterbury 010D","E01024087","Total",1147,111,49,62,1036,39,158,235,210,63,142,189
"2011","Canterbury 011A","E01024091","Total",1431,92,32,60,1339,110,96,269,184,109,238,333
"2011","Canterbury 011B","E01024110","Total",1269,165,100,65,1104,19,266,241,150,21,138,269
"2011","Canterbury 011C","E01024111","Total",1519,148,82,66,1371,144,188,311,204,87,184,253
"2011","Canterbury 011D","E01024112","Total",1570,166,104,62,1404,39,248,297,246,63,155,356
"2011","Canterbury 011E","E01024113","Total",1253,153,88,65,1100,40,204,226,190,81,90,269
"2011","Canterbury 012C","E01024067","Total",1057,105,50,55,952,10,184,204,220,51,96,187
"2011","Canterbury 012D","E01024068","Total",1391,153,85,68,1238,49,278,242,192,77,118,282
"2011","Canterbury 012E","E01024123","Total",1572,165,93,72,1407,39,206,293,218,67,73,511
"2011","Canterbury 012F","E01032809","Total",2276,255,160,95,2021,79,382,400,330,141,178,511
"2011","Canterbury 013A","E01024099","Total",1500,141,58,83,1359,148,50,145,158,62,98,698
"2011","Canterbury 013B","E01024100","Total",1580,87,52,35,1493,61,128,166,104,60,97,877
"2011","Canterbury 013C","E01024101","Total",1842,124,49,75,1718,69,116,209,138,40,189,957
"2011","Canterbury 013D","E01024102","Total",1759,147,78,69,1612,29,200,211,228,36,176,732
"2011","Canterbury 013E","E01024103","Total",1625,187,78,109,1438,104,120,201,178,64,132,639
"2011","Canterbury 014A","E01024047","Total",1565,66,21,45,1499,77,38,563,122,234,193,272
"2011","Canterbury 014B","E01024049","Total",1477,154,79,75,1323,134,100,176,134,150,174,455
"2011","Canterbury 014C","E01024090","Total",1884,230,75,155,1654,129,104,193,278,129,154,667
"2011","Canterbury 014D","E01024092","Total",1492,242,92,150,1250,76,78,120,178,21,97,680
"2011","Canterbury 014E","E01024093","Total",1401,372,142,230,1029,148,54,134,252,61,52,328
"2011","Canterbury 016A","E01024044","Total",1884,311,110,201,1573,64,144,247,398,87,123,510
"2011","Canterbury 016B","E01024045","Total",1584,188,110,78,1396,58,226,213,242,92,155,410
"2011","Canterbury 016C","E01024046","Total",1702,281,138,143,1421,53,222,289,296,105,169,287
"2011","Canterbury 016D","E01024048","Total",1499,138,49,89,1361,108,82,148,148,83,85,707
"2011","Canterbury 016E","E01024131","Total",1504,217,85,132,1287,37,156,262,280,74,141,337
"2011","Canterbury 017A","E01024052","Total",2223,248,86,162,1975,166,166,572,388,221,221,241
"2011","Canterbury 017B","E01024053","Total",1847,148,68,80,1699,81,240,429,334,152,123,340
"2011","Canterbury 017C","E01024054","Total",1798,148,62,86,1650,45,298,413,324,101,172,297
"2011","Canterbury 017D","E01024127","Total",1549,162,93,69,1387,70,258,211,284,113,127,324
"2011","Canterbury 018A","E01024042","Total",1311,129,64,65,1182,68,158,242,234,101,143,236
"2011","Canterbury 018B","E01024043","Total",1340,144,85,59,1196,39,244,258,210,58,161,226
"2011","Canterbury 018C","E01024088","Total",1462,181,111,70,1281,55,220,330,194,72,169,241
"2011","Canterbury 018D","E01024089","Total",1193,131,86,45,1062,23,176,244,158,77,189,195
"2011","Canterbury 019A","E01024128","Total",1645,160,52,108,1485,194,94,302,244,144,174,333
"2011","Canterbury 019B","E01024129","Total",1600,172,48,124,1428,54,74,178,308,45,106,663
"2011","Canterbury 019C","E01024130","Total",2499,346,135,211,2153,134,204,418,476,130,155,636
"2011","Canterbury 020A","E01024104","Total",2005,364,136,228,1641,60,130,231,496,49,86,589
"2011","Canterbury 020B","E01024121","Total",1494,238,92,146,1256,34,142,179,294,37,109,461
"2011","Canterbury 020C","E01024122","Total",1357,251,167,84,1106,80,128,165,184,70,85,394
"2011","Canterbury 020D","E01024124","Total",1038,260,118,142,778,9,86,148,218,25,49,243
"2011","Canterbury 020E","E01024126","Total",1502,103,62,41,1399,130,130,250,148,68,265,408
"2011","Canterbury 020F","E01032807","Total",1461,325,95,230,1136,57,100,130,364,25,38,422
"2011","Canterbury 020G","E01032808","Total",1417,284,56,228,1133,119,28,230,402,25,23,306
"2011","Dartford 001A","E01024148","Total",1674,418,177,241,1256,234,140,250,166,99,175,192
"2011","Dartford 001B","E01024149","Total",2972,355,110,245,2617,360,144,783,466,226,346,292
"2011","Dartford 001C","E01024154","Total",1266,140,61,79,1126,126,136,185,156,103,202,218
"2011","Dartford 001D","E01024155","Total",1468,189,69,120,1279,188,106,265,130,166,259,165
"2011","Dartford 002A","E01024140","Total",2692,353,25,328,2339,194,60,860,636,121,253,215
"2011","Dartford 002B","E01024141","Total",1513,169,48,121,1344,72,154,354,274,72,136,282
"2011","Dartford 002C","E01024143","Total",2246,283,22,261,1963,117,108,650,594,81,157,256
"2011","Dartford 002D","E01024179","Total",2817,405,59,346,2412,263,86,789,484,173,238,379
"2011","Dartford 003A","E01024180","Total",1436,255,39,216,1181,105,60,362,300,61,92,201
"2011","Dartford 003B","E01024181","Total",1355,86,30,56,1269,75,102,363,210,97,165,257
"2011","Dartford 003C","E01024182","Total",1564,379,82,297,1185,76,60,339,240,72,140,258
"2011","Dartford 003D","E01024183","Total",1379,123,66,57,1256,47,132,343,154,83,206,291
"2011","Dartford 003E","E01024184","Total",1986,178,55,123,1808,136,130,521,294,165,191,371
"2011","Dartford 003F","E01024185","Total",2054,260,85,175,1794,108,146,543,326,125,229,317
"2011","Dartford 004A","E01024142","Total",2700,470,50,420,2230,186,106,703,570,157,169,339
"2011","Dartford 004B","E01024176","Total",1662,320,141,179,1342,189,154,361,226,84,115,213
"2011","Dartford 004C","E01024177","Total",1436,177,68,109,1259,252,146,191,166,102,179,223
"2011","Dartford 004D","E01024178","Total",1638,145,59,86,1493,150,114,361,218,122,215,313
"2011","Dartford 005A","E01024156","Total",1658,330,66,264,1328,100,88,297,326,62,236,219
"2011","Dartford 005B","E01024161","Total",1976,219,57,162,1757,144,70,481,358,112,173,419
"2011","Dartford 005C","E01024162","Total",1579,386,56,330,1193,85,68,315,346,51,143,185
"2011","Dartford 005D","E01024163","Total",1783,203,73,130,1580,100,174,440,236,57,260,313
"2011","Dartford 005E","E01024164","Total",1900,234,52,182,1666,111,98,502,376,120,196,263
"2011","Dartford 006A","E01024169","Total",1510,198,108,90,1312,96,146,330,190,100,194,256
"2011","Dartford 006B","E01024170","Total",1543,235,86,149,1308,151,110,350,208,98,209,182
"2011","Dartford 006C","E01024171","Total",1546,171,59,112,1375,95,100,326,264,118,191,281
"2011","Dartford 006D","E01024172","Total",1930,434,46,388,1496,124,86,407,444,75,111,249
"2011","Dartford 007A","E01024144","Total",1510,108,61,47,1402,31,150,374,160,77,218,392
"2011","Dartford 007B","E01024145","Total",1630,112,52,60,1518,72,186,310,200,119,282,349
"2011","Dartford 007C","E01024146","Total",1465,89,52,37,1376,24,208,292,176,79,224,373
"2011","Dartford 007D","E01024147","Total",1722,131,76,55,1591,27,198,418,232,117,241,358
"2011","Dartford 007E","E01024186","Total",1317,108,40,68,1209,57,156,324,182,94,168,228
"2011","Dartford 008A","E01024133","Total",1275,86,20,66,1189,49,80,364,200,129,191,176
"2011","Dartford 008B","E01024136","Total",1550,251,64,187,1299,69,114,319,214,85,208,290
"2011","Dartford 008C","E01024137","Total",1511,104,57,47,1407,64,146,406,170,58,232,331
"2011","Dartford 008D","E01024138","Total",1663,175,78,97,1488,157,118,419,206,104,162,322
"2011","Dartford 008E","E01024139","Total",1763,152,95,57,1611,38,282,296,228,109,223,435
"2011","Dartford 009A","E01024165","Total",1523,256,118,138,1267,150,98,295,200,138,180,206
"2011","Dartford 009B","E01024166","Total",1705,134,47,87,1571,154,100,370,220,121,290,316
"2011","Dartford 009C","E01024167","Total",1829,244,106,138,1585,143,140,390,272,129,167,344
"2011","Dartford 009D","E01024168","Total",1247,137,94,43,1110,78,126,174,126,74,209,323
"2011","Dartford 010A","E01024150","Total",1516,163,112,51,1353,40,374,178,170,68,202,321
"2011","Dartford 010B","E01024151","Total",1431,154,105,49,1277,29,382,255,164,71,91,285
"2011","Dartford 010C","E01024152","Total",2598,162,46,116,2436,230,138,681,384,255,346,402
"2011","Dartford 010D","E01024153","Total",1410,104,73,31,1306,45,264,273,128,72,160,364
"2011","Dartford 011A","E01024173","Total",1752,147,81,66,1605,65,232,442,272,72,195,327
"2011","Dartford 011B","E01024187","Total",1072,119,66,53,953,17,148,213,152,58,144,221
"2011","Dartford 011C","E01024188","Total",1268,123,75,48,1145,39,190,321,162,62,153,218
"2011","Dartford 011D","E01024189","Total",1574,225,134,91,1349,64,200,269,222,119,152,323
"2011","Dartford 012A","E01024132","Total",1286,98,44,54,1188,66,118,270,204,88,237,205
"2011","Dartford 012B","E01024134","Total",1643,132,56,76,1511,112,192,335,280,80,206,306
"2011","Dartford 012C","E01024135","Total",1299,159,72,87,1140,102,126,215,190,71,190,246
"2011","Dartford 012D","E01024174","Total",1148,167,82,85,981,39,130,214,182,38,174,204
"2011","Dartford 012E","E01024175","Total",1289,110,36,74,1179,62,156,310,226,62,116,247
"2011","Dartford 013A","E01024157","Total",1624,160,73,87,1464,71,264,294,260,90,172,313
"2011","Dartford 013B","E01024158","Total",1461,200,107,93,1261,41,280,260,198,51,160,271
"2011","Dartford 013C","E01024159","Total",1577,120,81,39,1457,16,330,280,246,47,162,376
"2011","Dartford 013D","E01024160","Total",1435,98,64,34,1337,19,276,270,174,93,185,320
"2011","Dover 001A","E01024206","Total",1799,164,86,78,1635,38,256,340,278,168,202,353
"2011","Dover 001B","E01024207","Total",1783,150,70,80,1633,48,258,453,296,106,174,298
"2011","Dover 001C","E01024208","Total",1580,185,103,82,1395,57,192,329,256,120,153,288
"2011","Dover 001D","E01024209","Total",1744,215,105,110,1529,79,280,348,270,147,123,282
"2011","Dover 002A","E01024202","Total",1881,245,135,110,1636,84,292,326,272,205,160,297
"2011","Dover 002B","E01024242","Total",1716,192,94,98,1524,54,344,264,278,179,191,214
"2011","Dover 002C","E01024243","Total",1658,276,175,101,1382,109,232,242,250,64,190,295
"2011","Dover 002D","E01024244","Total",1760,432,202,230,1328,93,316,215,380,53,77,194
"2011","Dover 002E","E01024245","Total",1791,176,97,79,1615,60,312,316,296,98,246,287
"2011","Dover 003A","E01024219","Total",1248,170,100,70,1078,96,230,172,184,38,146,212
"2011","Dover 003B","E01024220","Total",1523,307,211,96,1216,56,260,250,230,31,120,269
"2011","Dover 003C","E01024221","Total",1546,134,60,74,1412,60,230,299,290,104,116,313
"2011","Dover 003D","E01024227","Total",1472,239,89,150,1233,90,186,267,254,93,189,154
"2011","Dover 003E","E01024229","Total",1460,297,144,153,1163,73,192,221,268,56,78,275
"2011","Dover 004A","E01024228","Total",1514,387,185,202,1127,58,200,174,280,80,139,196
"2011","Dover 004B","E01024230","Total",1376,370,164,206,1006,78,210,164,272,21,104,157
"2011","Dover 004C","E01024231","Total",1510,330,125,205,1180,65,228,226,230,37,234,160
"2011","Dover 004D","E01024252","Total",2359,431,158,273,1928,80,316,456,458,75,223,320
"2011","Dover 005A","E01024201","Total",1486,154,67,87,1332,45,198,319,238,97,154,281
"2011","Dover 005B","E01024217","Total",1684,242,127,115,1442,105,220,266,282,90,170,309
"2011","Dover 005C","E01024223","Total",1585,153,83,70,1432,91,190,263,208,125,247,308
"2011","Dover 005D","E01024225","Total",1692,170,85,85,1522,90,164,350,248,172,172,326
"2011","Dover 005E","E01024226","Total",1458,181,104,77,1277,102,246,240,166,81,182,260
"2011","Dover 006A","E01024190","Total",1455,159,63,96,1296,48,192,208,244,100,260,244
"2011","Dover 006B","E01024191","Total",1752,171,64,107,1581,101,182,395,218,126,210,349
"2011","Dover 006C","E01024192","Total",1698,207,124,83,1491,155,182,265,176,232,199,282
"2011","Dover 006D","E01024204","Total",1580,166,93,73,1414,70,248,279,274,144,196,203
"2011","Dover 007A","E01024218","Total",1213,162,63,99,1051,145,108,214,174,60,107,243
"2011","Dover 007B","E01024222","Total",1571,199,94,105,1372,130,136,321,266,99,185,235
"2011","Dover 007C","E01024224","Total",1506,169,112,57,1337,37,234,334,266,50,134,282
"2011","Dover 007D","E01024250","Total",1643,282,176,106,1361,70,314,245,214,53,180,285
"2011","Dover 007E","E01024251","Total",1530,253,175,78,1277,35,364,231,234,53,141,219
"2011","Dover 008A","E01024200","Total",1706,171,84,87,1535,51,272,270,314,73,235,320
"2011","Dover 008B","E01024203","Total",1556,136,74,62,1420,29,258,252,330,78,159,314
"2011","Dover 008C","E01024205","Total",1620,148,67,81,1472,73,162,355,300,136,171,275
"2011","Dover 008D","E01024255","Total",1499,168,110,58,1331,38,318,223,262,47,112,331
"2011","Dover 009A","E01024232","Total",1989,266,143,123,1723,38,428,284,370,103,176,324
"2011","Dover 009B","E01024236","Total",1581,237,127,110,1344,52,348,224,266,74,114,266
"2011","Dover 009C","E01024237","Total",1571,234,142,92,1337,32,432,223,280,74,99,197
"2011","Dover 009D","E01024253","Total",1657,238,142,96,1419,40,414,205,290,57,164,249
"2011","Dover 010C","E01024233","Total",1605,123,77,46,1482,27,260,345,288,97,158,307
"2011","Dover 010D","E01024235","Total",1468,248,123,125,1220,61,274,233,226,58,130,238
"2011","Dover 010E","E01024254","Total",2162,163,60,103,1999,138,224,486,276,239,321,315
"2011","Dover 010F","E01024256","Total",1421,134,77,57,1287,50,262,258,266,81,130,240
"2011","Dover 010G","E01033210","Total",2227,255,130,125,1972,67,300,445,416,99,193,452
"2011","Dover 011A","E01024193","Total",1604,279,104,175,1325,166,128,291,226,184,120,210
"2011","Dover 011B","E01024194","Total",1506,201,45,156,1305,150,88,297,254,82,182,252
"2011","Dover 011C","E01024195","Total",1398,121,59,62,1277,75,92,243,216,77,261,313
"2011","Dover 011D","E01024196","Total",1486,191,76,115,1295,142,128,300,210,92,174,249
"2011","Dover 011E","E01024197","Total",1569,210,74,136,1359,120,196,326,232,95,121,269
"2011","Dover 011F","E01024240","Total",1682,195,70,125,1487,261,60,340,182,237,240,167
"2011","Dover 011G","E01024241","Total",2148,184,50,134,1964,265,106,502,310,222,272,287
"2011","Dover 011H","E01024248","Total",1900,308,85,223,1592,260,126,354,286,155,185,226
"2011","Dover 012B","E01024238","Total",1568,109,25,84,1459,81,72,543,222,102,254,185
"2011","Dover 012C","E01024239","Total",1746,398,190,208,1348,96,174,255,312,165,125,221
"2011","Dover 012D","E01024247","Total",1886,423,146,277,1463,75,138,267,302,148,212,321
"2011","Dover 012E","E01033209","Total",1019,293,100,193,726,35,164,83,202,30,67,145
"2011","Dover 012F","E01033211","Total",1103,373,161,212,730,25,196,80,236,5,83,105
"2011","Dover 013A","E01024214","Total",1642,286,86,200,1356,113,88,303,270,163,214,205
"2011","Dover 013B","E01024215","Total",1500,280,47,233,1220,105,42,276,274,92,237,194
"2011","Dover 013C","E01024216","Total",1484,143,62,81,1341,81,122,423,234,63,141,277
"2011","Dover 013D","E01024246","Total",2036,317,69,248,1719,194,106,447,352,240,177,203
"2011","Dover 013E","E01024249","Total",1963,361,184,177,1602,125,266,304,264,180,151,312
"2011","Dover 014A","E01024198","Total",2326,284,165,119,2042,42,576,320,480,76,193,355
"2011","Dover 014B","E01024212","Total",1512,202,65,137,1310,38,160,301,294,93,129,295
"2011","Dover 014C","E01024213","Total",1389,128,60,68,1261,49,180,319,240,62,88,323
"2011","Dover 014D","E01024234","Total",1360,101,55,46,1259,29,272,226,252,59,128,293
"2011","Gravesham 001A","E01024276","Total",2542,161,32,129,2381,164,148,602,402,143,431,491
"2011","Gravesham 001B","E01024277","Total",1828,265,86,179,1563,216,94,371,240,108,288,246
"2011","Gravesham 001C","E01024278","Total",1863,343,65,278,1520,314,78,424,264,120,143,177
"2011","Gravesham 001D","E01024279","Total",1510,195,59,136,1315,184,100,357,180,75,165,254
"2011","Gravesham 002A","E01024257","Total",2008,399,95,304,1609,122,66,347,268,97,362,347
"2011","Gravesham 002C","E01024290","Total",1601,174,56,118,1427,96,78,212,200,101,386,354
"2011","Gravesham 002D","E01024291","Total",1771,342,142,200,1429,105,98,322,232,88,294,290
"2011","Gravesham 002E","E01024295","Total",1788,480,163,317,1308,141,110,364,270,80,149,194
"2011","Gravesham 002F","E01032799","Total",1486,286,62,224,1200,63,62,217,236,82,229,311
"2011","Gravesham 002G","E01032800","Total",1161,398,90,308,763,78,58,150,272,12,79,114
"2011","Gravesham 003A","E01024258","Total",1571,196,44,152,1375,75,94,280,222,107,261,336
"2011","Gravesham 003B","E01024261","Total",2163,281,156,125,1882,68,368,432,298,51,230,435
"2011","Gravesham 003C","E01024293","Total",1729,124,56,68,1605,99,126,371,176,191,292,350
"2011","Gravesham 003D","E01024294","Total",2267,212,51,161,2055,302,60,524,260,195,407,307
"2011","Gravesham 003E","E01024296","Total",2842,372,74,298,2470,189,116,615,484,123,445,498
"2011","Gravesham 004A","E01024262","Total",1685,225,100,125,1460,117,100,366,290,91,200,296
"2011","Gravesham 004B","E01024263","Total",1489,166,95,71,1323,102,132,277,194,105,227,286
"2011","Gravesham 004C","E01024282","Total",1630,124,36,88,1506,103,78,337,218,117,313,340
"2011","Gravesham 004D","E01024283","Total",1320,118,58,60,1202,92,80,271,208,82,261,208
"2011","Gravesham 004E","E01024284","Total",1558,146,60,86,1412,122,100,352,208,117,198,315
"2011","Gravesham 005A","E01024259","Total",1509,98,61,37,1411,30,188,290,206,115,191,391
"2011","Gravesham 005B","E01024260","Total",1813,281,127,154,1532,74,188,381,292,56,192,349
"2011","Gravesham 005C","E01024292","Total",1622,121,52,69,1501,59,116,222,182,110,368,444
"2011","Gravesham 005D","E01024313","Total",1597,148,82,66,1449,94,170,368,228,52,206,331
"2011","Gravesham 005E","E01024317","Total",1702,181,118,63,1521,39,134,387,184,118,270,389
"2011","Gravesham 005F","E01024318","Total",1579,160,73,87,1419,88,138,367,226,108,208,284
"2011","Gravesham 006A","E01024280","Total",1673,201,67,134,1472,165,76,327,268,88,273,275
"2011","Gravesham 006B","E01024281","Total",1457,115,67,48,1342,97,150,241,130,102,290,332
"2011","Gravesham 006C","E01024285","Total",1345,131,58,73,1214,50,156,285,184,59,182,298
"2011","Gravesham 006D","E01024287","Total",1464,228,156,72,1236,86,242,219,170,68,213,238
"2011","Gravesham 006E","E01024288","Total",1266,96,73,23,1170,33,252,189,164,65,184,283
"2011","Gravesham 007A","E01024308","Total",1420,244,112,132,1176,154,104,247,132,98,202,239
"2011","Gravesham 007B","E01024310","Total",1544,161,93,68,1383,87,242,304,178,89,202,281
"2011","Gravesham 007C","E01024311","Total",1335,93,44,49,1242,145,60,281,116,104,311,225
"2011","Gravesham 007D","E01024314","Total",1283,111,66,45,1172,43,144,289,142,78,184,292
"2011","Gravesham 007E","E01024315","Total",1544,172,73,99,1372,74,162,220,190,97,358,271
"2011","Gravesham 008A","E01024297","Total",1551,96,49,47,1455,63,194,308,176,119,195,400
"2011","Gravesham 008B","E01024298","Total",1416,85,66,19,1331,33,236,284,172,62,172,372
"2011","Gravesham 008C","E01024299","Total",1430,111,64,47,1319,45,212,307,182,83,198,292
"2011","Gravesham 008D","E01024309","Total",1288,88,31,57,1200,154,106,288,190,103,157,202
"2011","Gravesham 008E","E01024312","Total",1297,96,52,44,1201,58,146,247,144,81,203,322
"2011","Gravesham 009A","E01024264","Total",1527,187,116,71,1340,107,180,240,134,104,251,324
"2011","Gravesham 009B","E01024286","Total",1626,129,78,51,1497,42,136,398,228,60,187,446
"2011","Gravesham 009C","E01024316","Total",1813,131,71,60,1682,93,178,440,248,97,250,376
"2011","Gravesham 009D","E01024319","Total",1600,88,60,28,1512,108,142,360,176,131,302,293
"2011","Gravesham 010A","E01024265","Total",1270,96,67,29,1174,20,212,255,222,61,195,209
"2011","Gravesham 010B","E01024266","Total",1153,134,88,46,1019,69,152,181,162,57,140,258
"2011","Gravesham 010C","E01024267","Total",1522,142,91,51,1380,75,252,281,222,94,138,318
"2011","Gravesham 010D","E01024300","Total",1457,116,84,32,1341,42,266,267,216,77,189,284
"2011","Gravesham 010E","E01024301","Total",1179,146,79,67,1033,16,232,195,176,76,117,221
"2011","Gravesham 011A","E01024303","Total",1546,216,84,132,1330,97,128,386,248,102,159,210
"2011","Gravesham 011B","E01024304","Total",1549,148,73,75,1401,137,182,292,214,78,242,256
"2011","Gravesham 011C","E01024305","Total",1520,140,48,92,1380,171,78,290,144,161,294,242
"2011","Gravesham 011D","E01024306","Total",1144,122,49,73,1022,135,82,176,120,110,200,199
"2011","Gravesham 011E","E01024307","Total",1462,214,129,85,1248,66,230,239,180,90,181,262
"2011","Gravesham 012A","E01024268","Total",1602,120,80,40,1482,25,340,267,188,109,202,351
"2011","Gravesham 012B","E01024269","Total",1835,153,105,48,1682,47,386,332,250,64,179,424
"2011","Gravesham 012C","E01024270","Total",1421,139,80,59,1282,58,224,329,204,64,99,304
"2011","Gravesham 012D","E01024271","Total",1414,143,86,57,1271,38,244,339,172,75,119,284
"2011","Gravesham 012E","E01024272","Total",1493,117,81,36,1376,13,300,346,190,56,204,267
"2011","Gravesham 013A","E01024273","Total",1529,71,37,34,1458,28,214,291,230,88,274,333
"2011","Gravesham 013B","E01024274","Total",1495,134,69,65,1361,47,216,272,276,68,145,337
"2011","Gravesham 013C","E01024275","Total",1406,94,28,66,1312,67,118,394,222,111,138,262
"2011","Gravesham 013D","E01024302","Total",1466,127,71,56,1339,34,294,258,198,97,122,336
"2011","Maidstone 001A","E01024333","Total",1376,102,17,85,1274,112,64,372,248,94,136,248
"2011","Maidstone 001B","E01024334","Total",1023,91,22,69,932,47,44,333,234,41,111,122
"2011","Maidstone 001C","E01024335","Total",1552,132,59,73,1420,37,186,276,258,83,219,361
"2011","Maidstone 001D","E01024338","Total",1383,83,22,61,1300,16,112,356,252,57,177,330
"2011","Maidstone 001E","E01024347","Total",1633,149,84,65,1484,47,214,346,276,87,187,327
"2011","Maidstone 002A","E01024353","Total",1776,150,70,80,1626,41,244,338,336,92,172,403
"2011","Maidstone 002B","E01024354","Total",1462,135,60,75,1327,121,166,374,262,46,94,264
"2011","Maidstone 002C","E01024355","Total",1963,221,78,143,1742,115,146,476,408,94,176,327
"2011","Maidstone 002D","E01024385","Total",1602,126,72,54,1476,77,216,355,220,115,191,302
"2011","Maidstone 002E","E01024386","Total",1659,181,68,113,1478,57,192,417,326,78,170,238
"2011","Maidstone 003A","E01024320","Total",1191,113,73,40,1078,39,174,278,214,55,122,196
"2011","Maidstone 003B","E01024321","Total",1709,191,145,46,1518,58,362,401,218,66,151,262
"2011","Maidstone 003C","E01024322","Total",1172,133,91,42,1039,24,216,273,156,51,102,217
"2011","Maidstone 003D","E01024323","Total",1339,159,89,70,1180,67,290,255,176,63,81,248
"2011","Maidstone 003E","E01024324","Total",1452,184,106,78,1268,56,244,371,212,61,140,184
"2011","Maidstone 003F","E01024341","Total",1620,162,98,64,1458,14,354,321,274,62,155,278
"2011","Maidstone 004A","E01024352","Total",1793,353,120,233,1440,175,78,359,386,68,134,240
"2011","Maidstone 004C","E01024382","Total",1451,184,27,157,1267,111,62,264,388,63,143,236
"2011","Maidstone 004D","E01024383","Total",2073,262,38,224,1811,111,50,686,442,97,209,216
"2011","Maidstone 004E","E01024384","Total",1783,247,88,159,1536,108,152,343,356,125,165,287
"2011","Maidstone 004F","E01033090","Total",1170,294,112,182,876,130,58,191,276,11,52,158
"2011","Maidstone 004G","E01033092","Total",1216,299,52,247,917,81,60,209,252,43,68,204
"2011","Maidstone 005A","E01024330","Total",1586,119,74,45,1467,38,258,435,280,102,87,267
"2011","Maidstone 005B","E01024336","Total",1665,106,50,56,1559,41,188,412,240,93,222,363
"2011","Maidstone 005C","E01024337","Total",1503,133,62,71,1370,83,202,386,220,89,123,267
"2011","Maidstone 005D","E01024348","Total",1360,89,35,54,1271,36,112,375,220,65,142,321
"2011","Maidstone 005E","E01024351","Total",1499,214,134,80,1285,51,196,255,260,63,138,322
"2011","Maidstone 006A","E01024339","Total",1807,331,96,235,1476,92,120,344,382,58,169,311
"2011","Maidstone 006B","E01024340","Total",2212,388,79,309,1824,98,142,437,514,101,213,319
"2011","Maidstone 006C","E01024356","Total",1529,165,38,127,1364,97,74,363,310,37,132,351
"2011","Maidstone 006E","E01024373","Total",1815,269,95,174,1546,119,140,325,290,98,197,377
"2011","Maidstone 006F","E01033087","Total",1301,304,21,283,997,132,28,217,404,21,44,151
"2011","Maidstone 006G","E01033091","Total",1615,236,46,190,1379,77,84,381,350,82,123,282
"2011","Maidstone 007A","E01024326","Total",1858,194,145,49,1664,13,432,434,210,78,147,350
"2011","Maidstone 007B","E01024327","Total",1633,161,83,78,1472,77,190,397,282,83,129,314
"2011","Maidstone 007C","E01024328","Total",1536,192,117,75,1344,69,260,362,234,57,117,245
"2011","Maidstone 007D","E01024329","Total",1520,135,93,42,1385,26,256,325,186,112,198,282
"2011","Maidstone 007E","E01024349","Total",1356,188,37,151,1168,78,56,433,298,53,58,192
"2011","Maidstone 008A","E01024357","Total",1686,168,33,135,1518,142,78,445,284,49,207,313
"2011","Maidstone 008B","E01024358","Total",1722,235,125,110,1487,144,188,363,226,81,184,301
"2011","Maidstone 008C","E01024367","Total",1397,121,54,67,1276,83,120,343,220,94,160,256
"2011","Maidstone 008E","E01024369","Total",1531,139,70,69,1392,77,202,412,208,81,163,249
"2011","Maidstone 008F","E01033088","Total",1403,112,13,99,1291,76,32,487,326,77,146,147
"2011","Maidstone 008G","E01033089","Total",1535,118,37,81,1417,152,80,383,238,157,172,235
"2011","Maidstone 009A","E01024360","Total",1522,132,41,91,1390,98,164,364,308,63,145,248
"2011","Maidstone 009B","E01024372","Total",1923,234,49,185,1689,120,104,400,352,87,199,427
"2011","Maidstone 009C","E01024374","Total",1763,93,25,68,1670,238,76,372,160,169,347,308
"2011","Maidstone 009D","E01024401","Total",1485,185,71,114,1300,140,82,359,302,71,149,197
"2011","Maidstone 009E","E01024403","Total",1767,236,78,158,1531,75,148,466,366,73,143,260
"2011","Maidstone 010A","E01024371","Total",1632,142,73,69,1490,75,196,343,278,105,188,305
"2011","Maidstone 010B","E01024392","Total",1598,127,64,63,1471,137,158,261,236,58,257,364
"2011","Maidstone 010C","E01024393","Total",1522,140,81,59,1382,105,194,320,212,106,147,298
"2011","Maidstone 010D","E01024395","Total",1475,111,66,45,1364,132,118,235,154,109,287,329
"2011","Maidstone 010E","E01024396","Total",1568,189,101,88,1379,129,146,372,176,97,216,243
"2011","Maidstone 011A","E01024361","Total",1686,209,126,83,1477,73,262,306,244,120,120,352
"2011","Maidstone 011B","E01024362","Total",1684,160,87,73,1524,46,204,403,328,43,192,308
"2011","Maidstone 011C","E01024363","Total",2063,172,87,85,1891,85,294,444,336,120,269,343
"2011","Maidstone 011D","E01024387","Total",2443,201,109,92,2242,52,412,487,418,150,277,446
"2011","Maidstone 012A","E01024331","Total",1411,136,73,63,1275,35,234,318,216,68,145,259
"2011","Maidstone 012B","E01024394","Total",1389,85,46,39,1304,23,218,251,202,79,234,297
"2011","Maidstone 012C","E01024402","Total",1439,133,85,48,1306,16,260,334,254,42,158,242
"2011","Maidstone 012D","E01024404","Total",1582,113,71,42,1469,42,250,392,222,123,156,284
"2011","Maidstone 012E","E01024405","Total",1998,292,163,129,1706,73,322,415,362,72,167,295
"2011","Maidstone 013A","E01024389","Total",2273,231,67,164,2042,583,118,506,274,190,205,166
"2011","Maidstone 013B","E01024390","Total",1401,161,62,99,1240,241,98,342,142,110,115,192
"2011","Maidstone 013C","E01024391","Total",1435,95,52,43,1340,163,98,271,124,160,248,276
"2011","Maidstone 013D","E01024397","Total",1450,238,115,123,1212,137,176,253,166,37,160,283
"2011","Maidstone 013E","E01024398","Total",1736,222,84,138,1514,235,128,303,182,122,211,333
"2011","Maidstone 013F","E01024399","Total",1308,238,151,87,1070,98,200,220,166,34,120,232
"2011","Maidstone 013G","E01024400","Total",1306,143,92,51,1163,95,260,237,156,46,157,212
"2011","Maidstone 014A","E01024325","Total",2327,238,163,75,2089,44,548,439,304,81,222,451
"2011","Maidstone 014B","E01024346","Total",1293,147,82,65,1146,42,250,254,204,47,160,189
"2011","Maidstone 014C","E01024377","Total",1609,230,100,130,1379,50,232,266,314,121,161,235
"2011","Maidstone 014D","E01024378","Total",1365,152,86,66,1213,48,212,292,228,120,114,199
"2011","Maidstone 015A","E01024332","Total",1196,116,57,59,1080,18,188,218,214,66,145,231
"2011","Maidstone 015B","E01024350","Total",1458,122,44,78,1336,67,128,370,228,105,155,283
"2011","Maidstone 015C","E01024375","Total",2384,199,105,94,2185,80,360,505,432,94,236,478
"2011","Maidstone 015D","E01024388","Total",2929,233,89,144,2696,212,196,842,542,220,300,384
"2011","Maidstone 015E","E01024410","Total",1498,142,77,65,1356,38,258,230,300,52,188,290
"2011","Maidstone 016A","E01024342","Total",1642,234,129,105,1408,102,234,265,330,101,146,230
"2011","Maidstone 016B","E01024343","Total",1419,85,48,37,1334,42,178,299,204,114,191,306
"2011","Maidstone 016C","E01024344","Total",1374,164,109,55,1210,28,288,267,224,32,97,274
"2011","Maidstone 016D","E01024376","Total",2234,189,108,81,2045,54,390,477,370,112,221,421
"2011","Maidstone 017A","E01024364","Total",1626,180,103,77,1446,94,300,310,228,110,125,279
"2011","Maidstone 017B","E01024365","Total",1749,215,115,100,1534,47,286,408,276,110,116,291
"2011","Maidstone 017C","E01024366","Total",1655,131,62,69,1524,59,226,279,274,95,263,328
"2011","Maidstone 017D","E01024411","Total",1200,96,39,57,1104,58,144,239,188,68,169,238
"2011","Maidstone 018A","E01024345","Total",1529,110,52,58,1419,25,230,324,286,130,167,257
"2011","Maidstone 018B","E01024379","Total",1713,128,66,62,1585,37,220,399,268,92,257,312
"2011","Maidstone 018C","E01024380","Total",1688,172,82,90,1516,39,222,388,282,117,205,263
"2011","Maidstone 018D","E01024381","Total",1426,165,75,90,1261,119,204,341,216,71,105,205
"2011","Maidstone 019A","E01024406","Total",1421,117,48,69,1304,78,130,397,208,135,137,219
"2011","Maidstone 019B","E01024407","Total",1472,119,49,70,1353,65,136,348,224,76,191,313
"2011","Maidstone 019C","E01024408","Total",1433,125,61,64,1308,51,180,340,268,101,112,256
"2011","Maidstone 019D","E01024409","Total",1479,157,103,54,1322,41,264,316,220,97,134,250
"2011","Sevenoaks 001A","E01024445","Total",1288,86,38,48,1202,29,182,291,194,61,152,293
"2011","Sevenoaks 001B","E01024446","Total",1478,114,58,56,1364,60,198,278,234,42,167,385
"2011","Sevenoaks 001C","E01024447","Total",1324,190,116,74,1134,44,202,239,172,89,110,278
"2011","Sevenoaks 001D","E01024472","Total",1396,107,51,56,1289,65,150,282,192,66,199,335
"2011","Sevenoaks 001E","E01024479","Total",1484,164,82,82,1320,42,222,291,212,80,127,346
"2011","Sevenoaks 002A","E01024476","Total",1540,152,46,106,1388,162,116,337,160,162,208,243
"2011","Sevenoaks 002B","E01024477","Total",1416,236,81,155,1180,96,132,264,154,76,188,270
"2011","Sevenoaks 002C","E01024478","Total",1422,123,67,56,1299,66,220,281,222,90,126,294
"2011","Sevenoaks 002D","E01024480","Total",1635,357,188,169,1278,141,186,311,220,62,115,243
"2011","Sevenoaks 002E","E01024481","Total",1535,203,103,100,1332,109,178,285,214,61,174,311
"2011","Sevenoaks 002F","E01024482","Total",1450,245,99,146,1205,106,120,270,222,101,102,284
"2011","Sevenoaks 003A","E01024421","Total",1909,235,135,100,1674,40,290,339,264,113,262,366
"2011","Sevenoaks 003B","E01024473","Total",1597,151,66,85,1446,62,176,331,210,73,175,419
"2011","Sevenoaks 003C","E01024474","Total",1266,74,30,44,1192,55,182,259,150,74,133,339
"2011","Sevenoaks 003D","E01024475","Total",1484,172,72,100,1312,73,206,332,196,37,168,300
"2011","Sevenoaks 004A","E01024441","Total",1524,127,97,30,1397,18,340,233,214,91,183,318
"2011","Sevenoaks 004B","E01024442","Total",1511,108,65,43,1403,48,274,249,254,79,198,301
"2011","Sevenoaks 004C","E01024443","Total",1422,219,170,49,1203,9,320,237,182,50,131,274
"2011","Sevenoaks 004D","E01024444","Total",1266,170,74,96,1096,74,106,221,182,99,184,230
"2011","Sevenoaks 005A","E01024431","Total",1814,259,142,117,1555,41,274,424,224,115,104,373
"2011","Sevenoaks 005B","E01024432","Total",1487,146,70,76,1341,53,192,312,258,107,124,295
"2011","Sevenoaks 005C","E01024433","Total",1308,162,80,82,1146,33,148,274,214,63,125,289
"2011","Sevenoaks 005D","E01024434","Total",1970,372,175,197,1598,80,192,386,378,116,174,272
"2011","Sevenoaks 007A","E01024435","Total",1522,113,57,56,1409,23,192,285,246,105,204,354
"2011","Sevenoaks 007B","E01024436","Total",1504,219,141,78,1285,23,346,169,246,68,123,310
"2011","Sevenoaks 007C","E01024437","Total",1499,161,97,64,1338,21,204,284,178,67,204,380
"2011","Sevenoaks 007D","E01024438","Total",1504,158,84,74,1346,19,276,289,202,64,200,296
"2011","Sevenoaks 008A","E01024422","Total",1840,235,73,162,1605,92,168,556,270,124,142,253
"2011","Sevenoaks 008B","E01024423","Total",1721,265,117,148,1456,83,102,523,336,106,105,201
"2011","Sevenoaks 008C","E01024439","Total",1563,140,73,67,1423,53,224,343,246,70,163,324
"2011","Sevenoaks 008D","E01024440","Total",1922,178,102,76,1744,68,256,442,270,100,192,416
"2011","Sevenoaks 008E","E01024452","Total",1390,168,85,83,1222,42,218,318,206,95,141,202
"2011","Sevenoaks 009A","E01024448","Total",1220,130,68,62,1090,40,156,322,180,75,94,223
"2011","Sevenoaks 009B","E01024449","Total",1440,87,64,23,1353,29,318,310,188,84,117,307
"2011","Sevenoaks 009C","E01024450","Total",1511,159,95,64,1352,91,194,342,214,111,135,265
"2011","Sevenoaks 009D","E01024453","Total",1625,133,96,37,1492,19,322,384,204,151,170,242
"2011","Sevenoaks 009E","E01024454","Total",1577,138,70,68,1439,62,226,477,190,114,125,245
"2011","Sevenoaks 010A","E01024457","Total",1161,173,93,80,988,57,142,298,190,36,129,136
"2011","Sevenoaks 010B","E01024460","Total",1662,178,87,91,1484,106,196,446,202,130,146,258
"2011","Sevenoaks 010C","E01024461","Total",2378,348,154,194,2030,48,228,679,438,163,211,263
"2011","Sevenoaks 010D","E01024465","Total",1384,195,71,124,1189,62,118,309,310,64,105,221
"2011","Sevenoaks 010E","E01024466","Total",1330,146,50,96,1184,74,122,316,176,114,152,230
"2011","Sevenoaks 010F","E01024468","Total",1485,176,69,107,1309,62,156,426,256,113,120,176
"2011","Sevenoaks 011A","E01024416","Total",1601,140,85,55,1461,18,200,430,238,174,152,249
"2011","Sevenoaks 011B","E01024418","Total",1387,85,58,27,1302,30,226,395,156,156,110,229
"2011","Sevenoaks 011C","E01024424","Total",1405,79,51,28,1326,10,166,456,144,206,171,173
"2011","Sevenoaks 011D","E01024463","Total",1502,68,40,28,1434,24,176,491,174,151,176,242
"2011","Sevenoaks 011E","E01024464","Total",1606,82,44,38,1524,31,228,430,190,183,178,284
"2011","Sevenoaks 011F","E01024467","Total",1705,138,78,60,1567,57,204,557,188,179,118,264
"2011","Sevenoaks 012A","E01024458","Total",1398,102,54,48,1296,40,186,264,210,172,221,203
"2011","Sevenoaks 012B","E01024459","Total",1581,177,104,73,1404,32,184,364,218,149,183,274
"2011","Sevenoaks 012C","E01024462","Total",1661,171,104,67,1490,40,216,391,196,156,199,292
"2011","Sevenoaks 012D","E01024469","Total",1557,256,80,176,1301,21,92,364,362,101,115,246
"2011","Sevenoaks 012E","E01024470","Total",1573,187,116,71,1386,35,204,463,196,170,88,230
"2011","Sevenoaks 012F","E01024471","Total",1497,340,225,115,1157,22,186,295,232,147,80,195
"2011","Sevenoaks 013A","E01024417","Total",1558,155,80,75,1403,66,204,346,294,107,138,248
"2011","Sevenoaks 013B","E01024419","Total",1748,173,72,101,1575,40,266,399,320,115,158,277
"2011","Sevenoaks 013C","E01024483","Total",1511,196,92,104,1315,58,210,304,332,48,119,244
"2011","Sevenoaks 013D","E01024484","Total",1219,107,59,48,1112,31,206,274,206,82,110,203
"2011","Sevenoaks 013E","E01024485","Total",1682,214,91,123,1468,115,140,471,228,100,132,282
"2011","Sevenoaks 014A","E01024425","Total",1578,271,169,102,1307,55,162,432,248,66,112,232
"2011","Sevenoaks 014B","E01024426","Total",1755,215,102,113,1540,17,266,390,364,73,179,251
"2011","Sevenoaks 014C","E01024427","Total",1271,132,55,77,1139,73,138,212,176,153,97,290
"2011","Sevenoaks 014D","E01024428","Total",1299,121,62,59,1178,54,168,349,226,86,132,163
"2011","Sevenoaks 014E","E01024429","Total",1531,187,80,107,1344,133,158,320,268,129,106,230
"2011","Sevenoaks 014F","E01024430","Total",1377,166,70,96,1211,52,180,315,274,78,124,188
"2011","Sevenoaks 015A","E01024420","Total",2026,217,95,122,1809,43,266,459,328,151,208,354
"2011","Sevenoaks 015B","E01024451","Total",2204,202,110,92,2002,68,228,481,362,201,220,442
"2011","Sevenoaks 015C","E01024455","Total",1206,105,48,57,1101,28,148,281,218,131,117,178
"2011","Sevenoaks 015D","E01024456","Total",1259,136,73,63,1123,32,212,263,176,120,138,182
"2011","Sevenoaks 016A","E01024413","Total",1623,248,102,146,1375,81,118,407,272,101,105,291
"2011","Sevenoaks 016B","E01024414","Total",1562,126,37,89,1436,94,94,369,280,112,188,299
"2011","Sevenoaks 016C","E01024415","Total",1358,83,34,49,1275,45,186,234,198,82,203,327
"2011","Sevenoaks 016D","E01032619","Total",1618,146,65,81,1472,51,194,396,236,89,180,326
"2011","Shepway 001A","E01024490","Total",2087,220,124,96,1867,32,374,346,352,105,238,420
"2011","Shepway 001B","E01024544","Total",1375,125,73,52,1250,27,264,208,240,37,186,288
"2011","Shepway 001C","E01024545","Total",1447,160,95,65,1287,33,256,211,268,91,173,255
"2011","Shepway 001D","E01024547","Total",1342,202,136,66,1140,49,222,256,202,85,102,224
"2011","Shepway 002A","E01024492","Total",1522,189,91,98,1333,74,184,285,220,77,209,284
"2011","Shepway 002B","E01024541","Total",2429,167,73,94,2262,174,206,562,366,207,387,360
"2011","Shepway 002C","E01024542","Total",2032,179,80,99,1853,86,256,493,302,174,236,306
"2011","Shepway 002E","E01033213","Total",1789,102,16,86,1687,154,78,551,290,170,251,193
"2011","Shepway 002F","E01033214","Total",1735,82,31,51,1653,69,164,505,284,170,226,235
"2011","Shepway 003A","E01024496","Total",1583,193,91,102,1390,186,156,256,220,157,209,206
"2011","Shepway 003B","E01024497","Total",1661,160,81,79,1501,97,192,295,242,161,262,252
"2011","Shepway 003C","E01024498","Total",1662,173,92,81,1489,173,150,229,180,187,293,277
"2011","Shepway 003D","E01024503","Total",1721,266,145,121,1455,70,208,276,278,134,228,261
"2011","Shepway 003E","E01024518","Total",1721,154,97,57,1567,51,230,314,242,99,255,376
"2011","Shepway 004A","E01024499","Total",1675,199,54,145,1476,158,98,295,218,243,219,245
"2011","Shepway 004B","E01024500","Total",1207,187,76,111,1020,141,96,230,170,63,168,152
"2011","Shepway 004C","E01024501","Total",1576,184,61,123,1392,218,88,338,234,194,126,194
"2011","Shepway 004D","E01024502","Total",1394,221,52,169,1173,142,80,204,232,181,154,180
"2011","Shepway 004E","E01024505","Total",1843,332,106,226,1511,159,128,323,294,177,239,191
"2011","Shepway 005A","E01024491","Total",1528,106,53,53,1422,140,98,315,178,110,246,335
"2011","Shepway 005B","E01024493","Total",1471,181,97,84,1290,57,132,246,174,177,226,278
"2011","Shepway 005C","E01024494","Total",1651,191,113,78,1460,69,170,254,186,110,334,337
"2011","Shepway 005D","E01024495","Total",1787,148,42,106,1639,87,98,607,262,96,265,224
"2011","Shepway 005E","E01024520","Total",1404,211,103,108,1193,74,176,296,210,74,173,190
"2011","Shepway 005F","E01024528","Total",1252,153,58,95,1099,55,170,282,186,31,163,212
"2011","Shepway 006A","E01024511","Total",1336,115,60,55,1221,59,214,257,188,50,165,288
"2011","Shepway 006B","E01024512","Total",1743,206,84,122,1537,108,180,349,194,98,237,371
"2011","Shepway 006C","E01024513","Total",1676,175,90,85,1501,89,166,318,198,153,277,300
"2011","Shepway 006D","E01024514","Total",1378,108,46,62,1270,66,146,265,156,132,220,285
"2011","Shepway 006E","E01024515","Total",1434,186,114,72,1248,55,242,214,236,59,132,310
"2011","Shepway 006F","E01024516","Total",1397,123,76,47,1274,42,206,212,196,84,249,285
"2011","Shepway 006G","E01024519","Total",1265,210,72,138,1055,36,202,227,312,59,59,160
"2011","Shepway 006H","E01024521","Total",1645,369,159,210,1276,72,242,238,354,37,115,218
"2011","Shepway 008A","E01024523","Total",1515,171,115,56,1344,52,404,253,202,88,120,225
"2011","Shepway 008B","E01024526","Total",1442,191,103,88,1251,26,342,230,242,41,133,237
"2011","Shepway 008C","E01024527","Total",1381,266,184,82,1115,44,330,184,210,64,92,191
"2011","Shepway 008D","E01024550","Total",1968,219,118,101,1749,89,376,377,332,92,204,279
"2011","Shepway 009A","E01024489","Total",1698,237,152,85,1461,13,440,170,286,53,188,311
"2011","Shepway 009B","E01024530","Total",1460,135,76,59,1325,29,256,230,186,82,228,314
"2011","Shepway 009C","E01024536","Total",1972,180,78,102,1792,46,312,421,322,90,228,373
"2011","Shepway 009D","E01024546","Total",1579,165,95,70,1414,52,256,326,242,83,164,291
"2011","Shepway 010A","E01024522","Total",1335,286,129,157,1049,72,216,233,250,47,73,158
"2011","Shepway 010B","E01024524","Total",1441,389,244,145,1052,86,214,182,210,97,71,192
"2011","Shepway 010C","E01024525","Total",1507,435,229,206,1072,111,300,134,240,32,95,160
"2011","Shepway 010D","E01024529","Total",1435,232,149,83,1203,63,312,203,222,55,128,220
"2011","Shepway 010E","E01024531","Total",1439,198,116,82,1241,76,270,206,186,136,131,236
"2011","Shepway 011A","E01024486","Total",1945,270,186,84,1675,62,414,226,280,89,245,359
"2011","Shepway 011B","E01024487","Total",1233,173,87,86,1060,41,254,127,182,52,153,251
"2011","Shepway 011C","E01024488","Total",1300,220,149,71,1080,49,400,122,218,39,36,216
"2011","Shepway 011D","E01024548","Total",1245,138,64,74,1107,37,154,216,186,111,191,212
"2011","Shepway 011E","E01024549","Total",1113,92,34,58,1021,37,150,182,210,86,129,227
"2011","Shepway 012A","E01024537","Total",1651,232,106,126,1419,43,330,201,292,99,187,267
"2011","Shepway 012B","E01024538","Total",1603,164,111,53,1439,28,396,201,260,40,170,344
"2011","Shepway 012C","E01024539","Total",1996,305,171,134,1691,145,260,356,272,123,194,341
"2011","Shepway 012D","E01024540","Total",1531,161,104,57,1370,25,278,237,224,73,202,331
"2011","Shepway 013A","E01024532","Total",1455,186,93,93,1269,54,272,190,210,81,172,290
"2011","Shepway 013B","E01024533","Total",1216,158,96,62,1058,68,278,142,230,64,119,157
"2011","Shepway 013C","E01024534","Total",1529,168,86,82,1361,105,154,311,172,125,251,243
"2011","Shepway 013D","E01024535","Total",2287,303,122,181,1984,132,354,361,388,185,258,306
"2011","Shepway 014A","E01024504","Total",2029,567,76,491,1462,221,64,305,360,142,204,166
"2011","Shepway 014B","E01024507","Total",1953,592,181,411,1361,173,78,295,344,115,183,173
"2011","Shepway 014C","E01033212","Total",1451,553,85,468,898,123,60,132,382,26,72,103
"2011","Shepway 014D","E01033215","Total",1195,513,201,312,682,61,188,61,216,50,25,81
"2011","Shepway 015A","E01024508","Total",1846,610,160,450,1236,201,132,277,444,21,63,98
"2011","Shepway 015B","E01024509","Total",1533,557,268,289,976,92,188,179,342,38,46,91
"2011","Shepway 015C","E01024510","Total",1538,436,153,283,1102,56,232,184,312,36,81,201
"2011","Shepway 015D","E01024517","Total",1562,312,54,258,1250,64,126,189,308,80,199,284
"2011","Swale 001A","E01024609","Total",1114,241,53,188,873,136,46,170,166,78,151,126
"2011","Swale 001B","E01024610","Total",1569,210,56,154,1359,240,104,347,182,105,142,239
"2011","Swale 001C","E01024611","Total",1561,170,60,110,1391,315,50,301,208,120,148,249
"2011","Swale 001D","E01024612","Total",1529,181,75,106,1348,197,124,246,204,107,174,296
"2011","Swale 002A","E01024613","Total",1408,227,81,146,1181,124,102,253,202,147,162,191
"2011","Swale 002B","E01024614","Total",1520,208,103,105,1312,207,144,308,148,146,133,226
"2011","Swale 002C","E01024615","Total",1495,197,91,106,1298,233,126,217,164,113,200,245
"2011","Swale 002D","E01024616","Total",1653,234,137,97,1419,133,164,303,198,150,218,253
"2011","Swale 003A","E01024585","Total",1419,191,109,82,1228,113,190,246,164,66,242,207
"2011","Swale 003B","E01024587","Total",1429,183,106,77,1246,52,272,148,260,57,182,275
"2011","Swale 003C","E01024588","Total",1407,123,64,59,1284,33,260,246,256,50,172,267
"2011","Swale 003D","E01024589","Total",1550,147,93,54,1403,39,308,162,286,83,157,368
"2011","Swale 004A","E01024595","Total",1492,181,112,69,1311,81,208,281,218,48,199,276
"2011","Swale 004B","E01024598","Total",1571,143,49,94,1428,95,168,320,242,130,222,251
"2011","Swale 004D","E01024619","Total",1428,167,86,81,1261,54,204,279,214,83,148,279
"2011","Swale 004E","E01024621","Total",1209,147,87,60,1062,210,108,190,92,83,205,174
"2011","Swale 004F","E01032653","Total",1501,176,66,110,1325,126,198,296,280,52,125,248
"2011","Swale 004G","E01032654","Total",1829,133,17,116,1696,149,64,526,404,127,205,221
"2011","Swale 005A","E01024594","Total",1383,150,103,47,1233,67,262,217,200,39,156,292
"2011","Swale 005B","E01024596","Total",1611,197,87,110,1414,170,178,347,270,89,122,238
"2011","Swale 005C","E01024597","Total",1454,188,81,107,1266,154,146,216,216,145,194,195
"2011","Swale 005D","E01024620","Total",1242,136,79,57,1106,47,252,128,232,69,131,247
"2011","Swale 006A","E01024580","Total",1642,300,149,151,1342,145,274,155,288,109,144,227
"2011","Swale 006B","E01024581","Total",1329,129,50,79,1200,101,156,227,230,82,176,228
"2011","Swale 006C","E01024586","Total",1624,153,89,64,1471,81,234,316,256,72,193,319
"2011","Swale 006D","E01024618","Total",1774,176,73,103,1598,112,218,262,346,115,250,295
"2011","Swale 007B","E01024576","Total",1648,169,28,141,1479,78,118,449,308,92,188,246
"2011","Swale 007C","E01024577","Total",1366,103,30,73,1263,119,118,303,220,121,135,247
"2011","Swale 007D","E01024578","Total",1634,154,46,108,1480,121,100,447,300,75,198,239
"2011","Swale 007E","E01024579","Total",2970,204,41,163,2766,374,104,750,406,390,390,352
"2011","Swale 007F","E01024583","Total",1629,143,45,98,1486,184,120,365,272,104,193,248
"2011","Swale 007G","E01032655","Total",1584,89,15,74,1495,81,68,600,322,127,135,162
"2011","Swale 007H","E01032656","Total",1503,115,38,77,1388,74,120,465,250,114,170,195
"2011","Swale 008A","E01024570","Total",1733,149,79,70,1584,74,262,317,236,126,251,318
"2011","Swale 008B","E01024571","Total",1489,186,68,118,1303,43,230,257,288,63,155,267
"2011","Swale 008C","E01024572","Total",1144,100,54,46,1044,28,122,231,178,63,157,265
"2011","Swale 008D","E01024573","Total",1340,127,79,48,1213,69,198,250,176,69,179,272
"2011","Swale 008E","E01024575","Total",1180,95,49,46,1085,40,154,231,214,73,155,218
"2011","Swale 009A","E01024554","Total",2379,216,78,138,2163,88,366,457,434,88,304,426
"2011","Swale 009B","E01024561","Total",1360,139,42,97,1221,125,88,241,230,105,182,250
"2011","Swale 009C","E01024567","Total",2772,308,87,221,2464,278,196,764,438,256,219,313
"2011","Swale 009D","E01024568","Total",2773,185,80,105,2588,108,256,818,428,222,333,423
"2011","Swale 009E","E01024582","Total",1525,151,74,77,1374,58,174,265,280,84,151,362
"2011","Swale 010A","E01024559","Total",1331,286,150,136,1045,107,110,258,198,31,147,194
"2011","Swale 010B","E01024584","Total",1704,224,123,101,1480,142,146,337,226,141,223,265
"2011","Swale 010C","E01024590","Total",1480,311,80,231,1169,178,92,249,168,154,163,165
"2011","Swale 010D","E01024599","Total",1926,261,104,157,1665,242,112,509,300,81,136,285
"2011","Swale 010E","E01024608","Total",1733,327,155,172,1406,94,184,297,254,62,214,301
"2011","Swale 011A","E01024591","Total",1810,239,69,170,1571,140,118,409,306,137,183,278
"2011","Swale 011B","E01024592","Total",1264,117,46,71,1147,60,170,318,186,66,91,256
"2011","Swale 011C","E01024593","Total",1371,101,29,72,1270,120,86,297,182,144,209,232
"2011","Swale 011D","E01024600","Total",1484,182,109,73,1302,99,170,200,226,65,232,310
"2011","Swale 011E","E01024601","Total",1605,243,126,117,1362,41,208,257,262,86,165,343
"2011","Swale 012A","E01024560","Total",1273,123,59,64,1150,107,118,213,180,106,198,228
"2011","Swale 012B","E01024562","Total",1462,118,58,60,1344,99,146,372,228,108,155,236
"2011","Swale 012C","E01024569","Total",1704,172,90,82,1532,60,264,348,258,78,203,321
"2011","Swale 012D","E01024630","Total",1645,230,149,81,1415,63,354,233,244,76,135,310
"2011","Swale 012E","E01024632","Total",1560,130,90,40,1430,31,366,267,228,36,193,309
"2011","Swale 013A","E01024606","Total",1322,129,63,66,1193,60,166,190,188,109,218,262
"2011","Swale 013C","E01024628","Total",1497,143,73,70,1354,59,226,297,212,93,196,271
"2011","Swale 013D","E01024629","Total",1138,76,39,37,1062,26,180,250,216,90,105,195
"2011","Swale 013E","E01024631","Total",1626,119,89,30,1507,23,324,308,224,77,200,351
"2011","Swale 013F","E01032735","Total",1568,97,39,58,1471,74,188,417,238,67,191,296
"2011","Swale 013G","E01032737","Total",1443,140,44,96,1303,93,132,367,250,86,153,222
"2011","Swale 014A","E01024564","Total",1012,112,72,40,900,29,212,197,146,35,107,174
"2011","Swale 014B","E01024603","Total",1246,125,50,75,1121,37,128,382,206,57,64,247
"2011","Swale 014C","E01024604","Total",1194,132,32,100,1062,154,68,274,174,131,134,127
"2011","Swale 014D","E01024605","Total",1339,150,87,63,1189,44,224,274,262,68,111,206
"2011","Swale 014E","E01024626","Total",1538,142,70,72,1396,39,214,416,256,96,172,203
"2011","Swale 014F","E01024627","Total",1925,253,110,143,1672,197,224,302,272,157,250,270
"2011","Swale 015A","E01024551","Total",2214,311,116,195,1903,186,164,528,448,132,183,262
"2011","Swale 015B","E01024552","Total",1848,221,116,105,1627,114,158,384,288,133,243,307
"2011","Swale 015C","E01024553","Total",1940,451,212,239,1489,74,240,388,386,76,94,231
"2011","Swale 015D","E01024563","Total",1574,222,96,126,1352,147,146,248,194,85,276,256
"2011","Swale 015E","E01024602","Total",1475,267,149,118,1208,76,172,314,234,67,107,238
"2011","Swale 015F","E01024625","Total",1846,188,84,104,1658,51,320,426,310,78,127,346
"2011","Swale 016A","E01024565","Total",1290,116,61,55,1174,42,182,216,234,127,177,196
"2011","Swale 016B","E01024566","Total",1475,131,66,65,1344,84,228,264,262,76,190,240
"2011","Swale 016C","E01024622","Total",1646,194,85,109,1452,119,232,311,302,62,151,275
"2011","Swale 016D","E01024623","Total",1826,235,128,107,1591,84,234,348,276,85,198,366
"2011","Swale 016E","E01024624","Total",1778,197,84,113,1581,110,234,372,266,94,208,297
"2011","Swale 017A","E01024555","Total",1219,137,72,65,1082,56,204,266,206,84,139,127
"2011","Swale 017B","E01024556","Total",1182,141,82,59,1041,36,164,219,184,71,168,199
"2011","Swale 017C","E01024557","Total",1493,156,73,83,1337,80,200,346,208,98,157,248
"2011","Swale 017D","E01024558","Total",1602,158,79,79,1444,39,228,313,298,113,173,280
"2011","Thanet 001A","E01024657","Total",2134,476,75,401,1658,340,48,365,316,231,198,160
"2011","Thanet 001B","E01024658","Total",2044,403,166,237,1641,224,224,352,270,132,217,222
"2011","Thanet 001C","E01024659","Total",1419,260,99,161,1159,90,126,229,196,105,219,194
"2011","Thanet 001D","E01024660","Total",1675,305,92,213,1370,205,94,243,260,132,241,195
"2011","Thanet 001E","E01024678","Total",1900,569,147,422,1331,242,98,254,316,88,152,181
"2011","Thanet 002A","E01024653","Total",1601,218,143,75,1383,50,368,264,214,101,107,279
"2011","Thanet 002B","E01024654","Total",1517,273,199,74,1244,43,358,213,214,70,146,200
"2011","Thanet 002C","E01024655","Total",1449,152,103,49,1297,58,352,192,190,87,109,309
"2011","Thanet 002D","E01024656","Total",1662,301,168,133,1361,38,306,192,224,84,249,268
"2011","Thanet 002E","E01024675","Total",2054,212,123,89,1842,64,412,338,302,86,221,419
"2011","Thanet 003A","E01024676","Total",1589,410,122,288,1179,192,98,261,260,61,138,169
"2011","Thanet 003B","E01024677","Total",1684,179,60,119,1505,250,86,399,252,136,166,216
"2011","Thanet 003C","E01024695","Total",1296,112,45,67,1184,129,78,359,176,135,156,151
"2011","Thanet 003D","E01024697","Total",1276,154,64,90,1122,188,62,253,126,131,172,190
"2011","Thanet 003E","E01024710","Total",1118,304,50,254,814,85,70,187,170,25,131,146
"2011","Thanet 004A","E01024661","Total",1499,228,53,175,1271,205,76,282,198,111,192,207
"2011","Thanet 004B","E01024664","Total",1475,165,68,97,1310,177,118,349,200,83,166,217
"2011","Thanet 004C","E01024665","Total",1508,154,81,73,1354,111,128,357,198,119,200,241
"2011","Thanet 004D","E01024694","Total",1752,314,115,199,1438,88,152,398,220,99,205,276
"2011","Thanet 004E","E01024696","Total",1348,179,86,93,1169,103,218,225,186,84,150,203
"2011","Thanet 005A","E01024672","Total",1451,185,101,84,1266,146,152,204,162,121,207,274
"2011","Thanet 005B","E01024673","Total",1792,260,143,117,1532,110,296,375,212,62,162,315
"2011","Thanet 005C","E01024674","Total",1606,120,64,56,1486,38,188,344,236,99,225,356
"2011","Thanet 005D","E01024711","Total",1385,137,80,57,1248,30,184,200,174,74,262,324
"2011","Thanet 005E","E01024712","Total",1517,160,83,77,1357,44,254,281,212,76,209,281
"2011","Thanet 006A","E01024633","Total",1545,223,126,97,1322,162,146,262,204,103,198,247
"2011","Thanet 006B","E01024634","Total",1403,133,59,74,1270,139,124,312,174,97,202,222
"2011","Thanet 006C","E01024662","Total",1579,154,81,73,1425,123,284,301,178,163,138,238
"2011","Thanet 006D","E01024663","Total",1587,157,40,117,1430,309,94,289,196,185,187,170
"2011","Thanet 006E","E01024666","Total",1655,273,106,167,1382,233,164,260,194,136,194,201
"2011","Thanet 007A","E01024641","Total",1457,305,194,111,1152,82,242,218,218,55,145,192
"2011","Thanet 007B","E01024713","Total",1640,227,107,120,1413,121,198,336,218,138,184,218
"2011","Thanet 007C","E01024714","Total",1371,340,183,157,1031,64,262,139,238,56,118,154
"2011","Thanet 007D","E01024715","Total",1676,522,165,357,1154,95,210,235,314,57,119,124
"2011","Thanet 007E","E01024716","Total",2018,248,124,124,1770,134,230,458,258,113,226,351
"2011","Thanet 008A","E01024636","Total",2022,438,307,131,1584,66,562,212,358,52,80,254
"2011","Thanet 008B","E01024637","Total",1611,217,167,50,1394,46,422,225,266,25,173,237
"2011","Thanet 008C","E01024638","Total",1563,286,201,85,1277,67,402,195,234,48,109,222
"2011","Thanet 008D","E01024639","Total",1624,316,189,127,1308,85,344,247,268,62,73,229
"2011","Thanet 008E","E01024640","Total",1589,273,199,74,1316,41,404,249,222,84,108,208
"2011","Thanet 009A","E01024635","Total",1653,170,92,78,1483,105,322,276,234,137,185,224
"2011","Thanet 009B","E01024642","Total",1439,270,179,91,1169,81,394,184,214,51,107,138
"2011","Thanet 009C","E01024644","Total",1280,170,108,62,1110,28,316,225,226,42,103,170
"2011","Thanet 009D","E01024692","Total",1642,333,206,127,1309,139,228,302,242,78,112,208
"2011","Thanet 009E","E01024693","Total",1372,174,104,70,1198,69,258,274,180,66,148,203
"2011","Thanet 010A","E01024643","Total",1233,268,101,167,965,81,110,198,250,75,76,175
"2011","Thanet 010B","E01024705","Total",1137,301,115,186,836,62,140,117,210,21,132,154
"2011","Thanet 010C","E01024706","Total",1418,224,114,110,1194,66,202,285,212,92,137,200
"2011","Thanet 010D","E01024707","Total",1348,180,92,88,1168,78,168,286,208,71,151,206
"2011","Thanet 010E","E01024708","Total",1451,187,133,54,1264,22,380,214,258,36,139,215
"2011","Thanet 011A","E01024686","Total",1633,237,142,95,1396,94,236,244,234,87,172,329
"2011","Thanet 011B","E01024688","Total",1558,242,133,109,1316,59,328,233,252,69,151,224
"2011","Thanet 011C","E01024689","Total",1253,149,101,48,1104,44,228,190,172,66,145,259
"2011","Thanet 011D","E01024690","Total",1435,209,156,53,1226,51,264,213,186,90,159,263
"2011","Thanet 011E","E01024691","Total",1190,108,56,52,1082,66,160,252,158,68,100,278
"2011","Thanet 012A","E01024669","Total",1684,211,66,145,1473,196,130,312,254,142,167,272
"2011","Thanet 012B","E01024698","Total",1427,199,82,117,1228,108,138,309,288,42,143,200
"2011","Thanet 012C","E01024699","Total",1853,214,102,112,1639,241,194,409,244,145,195,211
"2011","Thanet 012D","E01024700","Total",1804,184,93,91,1620,175,188,436,258,116,175,272
"2011","Thanet 012E","E01024709","Total",1336,172,129,43,1164,22,290,185,218,61,144,244
"2011","Thanet 013A","E01024682","Total",1723,230,76,154,1493,205,122,311,250,160,236,209
"2011","Thanet 013B","E01024683","Total",1720,216,88,128,1504,211,174,207,184,236,220,272
"2011","Thanet 013C","E01024684","Total",1601,173,74,99,1428,117,162,322,200,155,197,275
"2011","Thanet 013D","E01024685","Total",1854,214,110,104,1640,189,224,373,242,102,217,293
"2011","Thanet 013E","E01024687","Total",1445,236,86,150,1209,127,110,248,188,113,228,195
"2011","Thanet 014A","E01024701","Total",1985,219,92,127,1766,80,298,321,406,132,237,292
"2011","Thanet 014B","E01024702","Total",1325,217,152,65,1108,53,270,250,188,82,130,135
"2011","Thanet 014C","E01024703","Total",1736,220,108,112,1516,66,268,315,292,110,224,241
"2011","Thanet 014D","E01024704","Total",1668,200,105,95,1468,117,246,326,268,105,172,234
"2011","Thanet 015A","E01024645","Total",1516,167,72,95,1349,150,142,307,204,87,220,239
"2011","Thanet 015B","E01024647","Total",1570,215,48,167,1355,111,96,312,238,151,189,258
"2011","Thanet 015C","E01024668","Total",1188,126,45,81,1062,188,90,257,168,109,107,143
"2011","Thanet 015D","E01024670","Total",1533,251,102,149,1282,208,102,300,212,88,144,228
"2011","Thanet 015E","E01024681","Total",1703,180,68,112,1523,218,104,390,260,97,169,285
"2011","Thanet 016A","E01024646","Total",1900,445,162,283,1455,189,162,259,310,118,194,223
"2011","Thanet 016B","E01024648","Total",1489,327,110,217,1162,144,122,254,188,68,174,212
"2011","Thanet 016C","E01024649","Total",1695,456,115,341,1239,178,140,301,302,60,78,180
"2011","Thanet 016D","E01024667","Total",1721,519,174,345,1202,212,126,253,302,45,107,157
"2011","Thanet 016E","E01024671","Total",1638,475,177,298,1163,150,152,229,310,55,107,160
"2011","Thanet 017A","E01024650","Total",1442,158,81,77,1284,47,268,252,264,53,147,253
"2011","Thanet 017B","E01024651","Total",1383,266,146,120,1117,46,254,223,230,29,141,194
"2011","Thanet 017C","E01024652","Total",1822,176,106,70,1646,42,362,318,286,89,191,358
"2011","Thanet 017D","E01024679","Total",1261,212,150,62,1049,30,360,136,174,31,84,234
"2011","Thanet 017E","E01024680","Total",1600,204,120,84,1396,98,230,385,260,31,177,215
"2011","Tonbridge and Malling 001A","E01024719","Total",1968,189,73,116,1779,72,154,459,326,153,238,377
"2011","Tonbridge and Malling 001B","E01024720","Total",1394,100,62,38,1294,28,228,268,222,101,173,274
"2011","Tonbridge and Malling 001C","E01024721","Total",1282,84,45,39,1198,31,182,284,254,47,173,227
"2011","Tonbridge and Malling 001D","E01024722","Total",1374,133,49,84,1241,61,144,342,212,56,162,264
"2011","Tonbridge and Malling 001E","E01024727","Total",2596,302,92,210,2294,149,226,684,512,118,232,373
"2011","Tonbridge and Malling 001F","E01024728","Total",1638,158,68,90,1480,97,202,317,306,78,212,268
"2011","Tonbridge and Malling 002C","E01024771","Total",1835,207,58,149,1628,196,120,480,302,89,193,248
"2011","Tonbridge and Malling 002D","E01024772","Total",1644,140,49,91,1504,71,164,409,260,57,173,370
"2011","Tonbridge and Malling 002E","E01024773","Total",1704,183,86,97,1521,43,264,326,342,89,104,353
"2011","Tonbridge and Malling 002F","E01024774","Total",2451,376,124,252,2075,191,188,582,504,141,163,306
"2011","Tonbridge and Malling 002G","E01032830","Total",2488,311,132,179,2177,183,204,442,294,238,325,491
"2011","Tonbridge and Malling 003A","E01024741","Total",1538,113,60,53,1425,164,142,315,168,155,205,276
"2011","Tonbridge and Malling 003B","E01024761","Total",2214,202,101,101,2012,112,236,505,360,143,251,405
"2011","Tonbridge and Malling 003C","E01024762","Total",2054,172,63,109,1882,96,168,496,416,106,161,439
"2011","Tonbridge and Malling 003D","E01024763","Total",1394,90,57,33,1304,82,210,304,192,77,163,276
"2011","Tonbridge and Malling 003E","E01024764","Total",1226,129,68,61,1097,50,184,270,174,54,94,271
"2011","Tonbridge and Malling 003F","E01024765","Total",1365,101,53,48,1264,42,176,315,186,63,103,379
"2011","Tonbridge and Malling 003G","E01024782","Total",1286,94,35,59,1192,45,92,335,202,36,196,286
"2011","Tonbridge and Malling 003H","E01024785","Total",1480,165,86,79,1315,73,130,425,264,71,114,238
"2011","Tonbridge and Malling 005A","E01024717","Total",1543,246,190,56,1297,49,248,237,182,106,215,260
"2011","Tonbridge and Malling 005B","E01024718","Total",1336,73,50,23,1263,29,256,247,236,62,109,324
"2011","Tonbridge and Malling 005C","E01024735","Total",1570,104,71,33,1466,57,254,373,232,55,171,324
"2011","Tonbridge and Malling 005D","E01024736","Total",1703,176,95,81,1527,125,202,372,306,75,212,235
"2011","Tonbridge and Malling 005E","E01024737","Total",2331,198,67,131,2133,212,206,621,428,137,212,317
"2011","Tonbridge and Malling 006A","E01024723","Total",1582,150,79,71,1432,32,212,417,206,165,153,247
"2011","Tonbridge and Malling 006B","E01024724","Total",1950,144,94,50,1806,82,292,502,332,149,209,240
"2011","Tonbridge and Malling 006C","E01024725","Total",1600,137,76,61,1463,49,270,426,240,88,131,259
"2011","Tonbridge and Malling 006D","E01024726","Total",1719,213,134,79,1506,70,256,333,262,121,150,314
"2011","Tonbridge and Malling 006E","E01024755","Total",2078,120,65,55,1958,47,284,558,282,231,234,322
"2011","Tonbridge and Malling 006F","E01024786","Total",1906,225,132,93,1681,136,266,399,224,167,192,297
"2011","Tonbridge and Malling 007A","E01024746","Total",1083,100,39,61,983,30,126,220,178,94,130,205
"2011","Tonbridge and Malling 007C","E01024760","Total",1581,59,25,34,1522,67,148,603,172,169,137,226
"2011","Tonbridge and Malling 007D","E01024781","Total",2062,162,74,88,1900,64,270,534,338,110,239,345
"2011","Tonbridge and Malling 007E","E01032825","Total",1576,85,15,70,1491,140,56,593,250,188,142,122
"2011","Tonbridge and Malling 007F","E01032826","Total",1613,98,14,84,1515,90,72,570,250,231,165,137
"2011","Tonbridge and Malling 007G","E01032827","Total",1762,60,10,50,1702,98,66,820,196,234,140,148
"2011","Tonbridge and Malling 007H","E01032828","Total",1238,58,19,39,1180,33,86,467,204,148,102,140
"2011","Tonbridge and Malling 008A","E01024743","Total",1809,207,120,87,1602,62,220,373,274,110,213,350
"2011","Tonbridge and Malling 008B","E01024744","Total",2042,152,74,78,1890,41,304,434,310,130,224,447
"2011","Tonbridge and Malling 008C","E01024745","Total",1757,162,83,79,1595,63,320,343,250,130,159,330
"2011","Tonbridge and Malling 008D","E01024747","Total",1546,211,108,103,1335,108,168,278,194,98,189,300
"2011","Tonbridge and Malling 009A","E01024730","Total",1284,136,100,36,1148,38,300,285,150,62,79,234
"2011","Tonbridge and Malling 009B","E01024731","Total",1192,107,78,29,1085,12,232,250,132,107,110,242
"2011","Tonbridge and Malling 009C","E01024775","Total",1529,194,75,119,1335,155,156,313,188,99,168,256
"2011","Tonbridge and Malling 009D","E01024776","Total",1318,127,71,56,1191,78,182,246,124,110,174,277
"2011","Tonbridge and Malling 009E","E01024777","Total",1232,150,83,67,1082,47,174,182,128,70,190,291
"2011","Tonbridge and Malling 010A","E01024734","Total",1576,180,108,72,1396,46,252,352,222,82,152,290
"2011","Tonbridge and Malling 010B","E01024752","Total",1662,126,85,41,1536,46,258,447,214,101,212,258
"2011","Tonbridge and Malling 010C","E01024753","Total",1555,143,80,63,1412,54,202,380,220,92,157,307
"2011","Tonbridge and Malling 010D","E01024754","Total",1684,108,55,53,1576,33,206,394,266,180,195,302
"2011","Tonbridge and Malling 011A","E01024729","Total",1770,190,115,75,1580,136,240,362,220,136,229,257
"2011","Tonbridge and Malling 011B","E01024748","Total",1452,84,64,20,1368,27,262,265,166,114,238,296
"2011","Tonbridge and Malling 011C","E01024749","Total",1507,158,100,58,1349,122,204,401,174,93,133,222
"2011","Tonbridge and Malling 011D","E01024750","Total",1489,160,111,49,1329,55,326,273,170,107,157,241
"2011","Tonbridge and Malling 011E","E01024751","Total",1548,162,134,28,1386,23,374,303,162,104,161,259
"2011","Tonbridge and Malling 012A","E01024732","Total",1416,252,64,188,1164,67,80,366,284,61,110,196
"2011","Tonbridge and Malling 012B","E01024733","Total",1763,180,74,106,1583,67,204,420,260,160,163,309
"2011","Tonbridge and Malling 012C","E01024756","Total",1653,142,67,75,1511,137,142,431,236,89,208,268
"2011","Tonbridge and Malling 012D","E01024766","Total",1974,289,103,186,1685,78,178,433,488,67,137,304
"2011","Tonbridge and Malling 012E","E01024767","Total",1510,89,38,51,1421,129,122,338,184,151,211,286
"2011","Tonbridge and Malling 012F","E01024768","Total",1669,258,139,119,1411,32,184,347,316,117,182,233
"2011","Tonbridge and Malling 013A","E01024757","Total",1590,209,105,104,1381,42,118,431,318,88,145,239
"2011","Tonbridge and Malling 013B","E01024758","Total",1585,156,54,102,1429,51,140,367,242,140,167,322
"2011","Tonbridge and Malling 013C","E01024778","Total",1579,155,48,107,1424,61,104,466,342,101,121,229
"2011","Tonbridge and Malling 013D","E01024779","Total",1801,232,97,135,1569,37,156,368,374,117,194,323
"2011","Tonbridge and Malling 013E","E01024780","Total",1638,110,35,75,1528,121,100,440,254,130,220,263
"2011","Tonbridge and Malling 014A","E01024740","Total",1825,179,79,100,1646,86,232,372,336,141,183,296
"2011","Tonbridge and Malling 014B","E01024742","Total",1714,173,74,99,1541,130,204,466,270,96,153,222
"2011","Tonbridge and Malling 014C","E01024783","Total",1580,264,148,116,1316,59,192,241,298,62,172,292
"2011","Tonbridge and Malling 014D","E01024784","Total",1362,173,107,66,1189,21,162,328,236,88,121,233
"2011","Tonbridge and Malling 014E","E01032620","Total",2265,176,95,81,2089,68,398,349,368,140,271,495
"2011","Tonbridge and Malling 014F","E01032829","Total",1361,102,54,48,1259,43,212,286,244,91,132,251
"2011","Tunbridge Wells 001A","E01024798","Total",2434,176,88,88,2258,82,258,556,388,235,270,469
"2011","Tunbridge Wells 001B","E01024811","Total",1220,95,68,27,1125,33,178,264,160,46,124,320
"2011","Tunbridge Wells 001C","E01024812","Total",1305,105,69,36,1200,41,178,299,156,120,147,259
"2011","Tunbridge Wells 001D","E01024813","Total",1656,299,146,153,1357,69,138,347,366,98,98,241
"2011","Tunbridge Wells 001E","E01024814","Total",1338,110,71,39,1228,27,166,246,178,100,225,286
"2011","Tunbridge Wells 001F","E01024815","Total",1346,96,42,54,1250,67,150,256,188,140,180,269
"2011","Tunbridge Wells 001G","E01024816","Total",1371,88,41,47,1283,66,112,374,180,131,148,272
"2011","Tunbridge Wells 002A","E01024837","Total",1963,98,51,47,1865,81,110,480,222,298,321,353
"2011","Tunbridge Wells 002B","E01024844","Total",1645,185,52,133,1460,82,106,366,284,163,198,261
"2011","Tunbridge Wells 002C","E01024846","Total",1600,156,76,80,1444,57,152,366,280,135,165,289
"2011","Tunbridge Wells 002D","E01024849","Total",1644,184,96,88,1460,66,154,388,246,128,161,317
"2011","Tunbridge Wells 002E","E01024850","Total",1322,63,39,24,1259,18,242,294,120,115,167,303
"2011","Tunbridge Wells 003A","E01024836","Total",1760,202,67,135,1558,108,118,399,316,168,202,247
"2011","Tunbridge Wells 003B","E01024839","Total",1738,220,64,156,1518,64,210,354,316,187,103,284
"2011","Tunbridge Wells 003C","E01024845","Total",1348,125,70,55,1223,72,178,270,148,119,160,276
"2011","Tunbridge Wells 003D","E01024847","Total",1623,198,62,136,1425,108,154,370,312,143,126,212
"2011","Tunbridge Wells 003E","E01024848","Total",1283,293,198,95,990,54,180,215,156,101,101,183
"2011","Tunbridge Wells 004A","E01024793","Total",1682,161,81,80,1521,38,246,272,260,157,189,359
"2011","Tunbridge Wells 004B","E01024825","Total",1355,83,48,35,1272,27,222,268,218,103,157,277
"2011","Tunbridge Wells 004C","E01024826","Total",1467,189,95,94,1278,23,222,332,190,107,139,265
"2011","Tunbridge Wells 004D","E01024827","Total",1562,158,87,71,1404,64,168,390,176,137,202,267
"2011","Tunbridge Wells 004E","E01024828","Total",1540,187,86,101,1353,66,174,342,228,137,194,212
"2011","Tunbridge Wells 005A","E01024840","Total",2005,155,46,109,1850,204,108,337,234,325,311,331
"2011","Tunbridge Wells 005B","E01024841","Total",1929,322,112,210,1607,152,146,422,222,170,180,315
"2011","Tunbridge Wells 005C","E01024842","Total",1577,234,112,122,1343,85,222,311,218,111,132,264
"2011","Tunbridge Wells 005D","E01024843","Total",1475,151,42,109,1324,138,52,347,254,144,150,239
"2011","Tunbridge Wells 006A","E01024829","Total",1658,146,70,76,1512,61,186,427,250,120,158,310
"2011","Tunbridge Wells 006B","E01024851","Total",1671,186,91,95,1485,47,188,392,218,165,230,245
"2011","Tunbridge Wells 006C","E01024852","Total",1347,72,56,16,1275,15,296,303,136,100,195,230
"2011","Tunbridge Wells 006D","E01024853","Total",1316,140,76,64,1176,18,220,230,180,114,217,197
"2011","Tunbridge Wells 006E","E01024854","Total",1665,100,68,32,1565,31,198,431,210,189,239,267
"2011","Tunbridge Wells 007A","E01024799","Total",1904,359,162,197,1545,52,250,402,426,60,135,220
"2011","Tunbridge Wells 007B","E01024800","Total",1668,149,77,72,1519,27,258,339,234,185,191,285
"2011","Tunbridge Wells 007C","E01024835","Total",2101,217,50,167,1884,62,104,632,384,190,212,300
"2011","Tunbridge Wells 007D","E01024838","Total",1741,186,56,130,1555,58,96,454,258,168,238,283
"2011","Tunbridge Wells 008A","E01024801","Total",2511,676,94,582,1835,78,142,428,778,82,111,216
"2011","Tunbridge Wells 008B","E01024802","Total",2040,543,90,453,1497,53,82,382,502,88,150,240
"2011","Tunbridge Wells 008C","E01024823","Total",1819,352,123,229,1467,41,146,354,480,94,121,231
"2011","Tunbridge Wells 008D","E01024833","Total",2409,599,168,431,1810,138,78,426,600,185,171,212
"2011","Tunbridge Wells 009A","E01024821","Total",1986,370,213,157,1616,55,292,461,408,146,79,175
"2011","Tunbridge Wells 009B","E01024822","Total",1760,325,187,138,1435,50,268,405,270,50,131,261
"2011","Tunbridge Wells 009C","E01024824","Total",1560,154,83,71,1406,49,196,435,194,140,135,257
"2011","Tunbridge Wells 009D","E01024832","Total",1607,198,33,165,1409,54,126,470,306,121,132,200
"2011","Tunbridge Wells 009E","E01024834","Total",2245,208,48,160,2037,123,100,634,556,206,128,290
"2011","Tunbridge Wells 010A","E01024795","Total",1455,181,61,120,1274,159,100,280,190,150,171,224
"2011","Tunbridge Wells 010B","E01024796","Total",1392,222,75,147,1170,69,186,272,218,106,114,205
"2011","Tunbridge Wells 010C","E01024830","Total",1805,279,144,135,1526,116,216,359,276,99,99,361
"2011","Tunbridge Wells 010D","E01024831","Total",1449,199,75,124,1250,102,96,320,260,120,147,205
"2011","Tunbridge Wells 011A","E01024792","Total",1894,123,73,50,1771,41,228,408,250,189,239,416
"2011","Tunbridge Wells 011B","E01024794","Total",1721,163,81,82,1558,70,204,406,212,221,192,253
"2011","Tunbridge Wells 011C","E01024804","Total",1445,119,49,70,1326,47,184,355,182,180,177,201
"2011","Tunbridge Wells 011D","E01024805","Total",1706,145,66,79,1561,45,222,417,260,191,160,266
"2011","Tunbridge Wells 011E","E01024806","Total",1606,161,88,73,1445,48,240,349,214,153,176,265
"2011","Tunbridge Wells 012A","E01024797","Total",1623,223,115,108,1400,20,306,264,304,75,137,294
"2011","Tunbridge Wells 012B","E01024817","Total",1808,195,73,122,1613,40,262,462,324,160,147,218
"2011","Tunbridge Wells 012C","E01024818","Total",1688,198,90,108,1490,52,248,375,260,91,205,259
"2011","Tunbridge Wells 012D","E01024819","Total",1658,352,90,262,1306,38,134,292,498,82,69,193
"2011","Tunbridge Wells 012E","E01024820","Total",1700,152,87,65,1548,38,224,535,208,186,131,226
"2011","Tunbridge Wells 013A","E01024787","Total",1246,81,47,34,1165,49,124,253,194,175,140,230
"2011","Tunbridge Wells 013B","E01024788","Total",1489,163,78,85,1326,123,142,341,198,112,154,256
"2011","Tunbridge Wells 013C","E01024790","Total",1078,197,132,65,881,50,116,154,182,137,54,188
"2011","Tunbridge Wells 013D","E01024791","Total",1333,139,96,43,1194,74,248,247,156,74,116,279
"2011","Tunbridge Wells 013E","E01024803","Total",2144,157,93,64,1987,105,366,378,334,139,291,374
"2011","Tunbridge Wells 014A","E01024789","Total",1860,251,119,132,1609,66,282,375,248,134,220,284
"2011","Tunbridge Wells 014B","E01024807","Total",1567,213,121,92,1354,101,194,326,222,113,131,267
"2011","Tunbridge Wells 014C","E01024808","Total",1614,206,95,111,1408,69,222,324,298,121,143,231
"2011","Tunbridge Wells 014D","E01024809","Total",1469,130,69,61,1339,49,234,254,212,123,218,249
"2011","Tunbridge Wells 014E","E01024810","Total",1676,125,47,78,1551,51,184,338,200,244,199,335
"2011","Cherwell 001A","E01028479","Total",1249,137,72,65,1112,22,194,268,306,30,88,204
"2011","Cherwell 001B","E01028480","Total",1421,149,84,65,1272,45,240,313,258,65,109,242
"2011","Cherwell 001C","E01028508","Total",1089,78,43,35,1011,30,204,250,200,62,84,181
"2011","Cherwell 001D","E01028509","Total",1475,161,67,94,1314,32,258,294,278,90,91,271
"2011","Cherwell 002A","E01028441","Total",2474,265,80,185,2209,230,94,633,504,202,244,302
"2011","Cherwell 002C","E01028443","Total",1464,127,32,95,1337,92,110,421,278,42,159,235
"2011","Cherwell 002D","E01028444","Total",1533,91,56,35,1442,45,184,304,270,67,232,340
"2011","Cherwell 002E","E01032943","Total",1632,123,13,110,1509,126,60,509,362,138,187,127
"2011","Cherwell 002F","E01032944","Total",1347,198,38,160,1149,95,96,308,278,64,104,204
"2011","Cherwell 003A","E01028445","Total",1458,81,38,43,1377,105,104,374,192,125,241,236
"2011","Cherwell 003B","E01028446","Total",1544,154,84,70,1390,71,212,272,236,118,223,258
"2011","Cherwell 003C","E01028447","Total",1259,192,78,114,1067,64,76,215,226,76,184,226
"2011","Cherwell 003D","E01028448","Total",1564,199,108,91,1365,137,110,309,214,132,251,212
"2011","Cherwell 004A","E01028435","Total",1590,519,187,332,1071,117,118,172,310,35,116,203
"2011","Cherwell 004C","E01028437","Total",1545,134,39,95,1411,51,104,388,228,103,236,301
"2011","Cherwell 004D","E01028438","Total",1685,307,62,245,1378,74,56,375,360,103,219,191
"2011","Cherwell 004E","E01028439","Total",1423,142,28,114,1281,72,62,409,274,62,174,228
"2011","Cherwell 004F","E01028440","Total",1634,265,56,209,1369,136,54,376,348,87,131,237
"2011","Cherwell 004G","E01032941","Total",1433,242,129,113,1191,104,126,235,200,113,178,235
"2011","Cherwell 004H","E01032942","Total",1415,239,14,225,1176,164,8,305,348,53,106,192
"2011","Cherwell 005A","E01028449","Total",1354,144,76,68,1210,116,146,260,140,145,164,239
"2011","Cherwell 005B","E01028450","Total",1461,119,34,85,1342,196,84,307,148,109,228,270
"2011","Cherwell 005C","E01028451","Total",1308,80,43,37,1228,68,120,267,186,112,190,285
"2011","Cherwell 005D","E01028452","Total",1393,107,47,60,1286,128,82,323,166,118,243,226
"2011","Cherwell 005E","E01028453","Total",1359,90,33,57,1269,149,116,309,188,94,178,235
"2011","Cherwell 005F","E01028454","Total",1595,181,109,72,1414,176,150,210,134,160,313,271
"2011","Cherwell 006A","E01028430","Total",1439,240,63,177,1199,60,106,282,312,96,116,227
"2011","Cherwell 006B","E01028431","Total",1498,180,110,70,1318,40,294,277,230,57,167,253
"2011","Cherwell 006C","E01028432","Total",1551,151,78,73,1400,43,278,295,214,105,180,285
"2011","Cherwell 006D","E01028433","Total",1678,209,147,62,1469,40,370,277,248,62,156,316
"2011","Cherwell 006E","E01028434","Total",1326,91,50,41,1235,25,228,265,180,62,193,282
"2011","Cherwell 007A","E01028426","Total",1378,135,63,72,1243,71,136,366,222,62,139,247
"2011","Cherwell 007B","E01028427","Total",1512,236,39,197,1276,56,84,432,304,72,139,189
"2011","Cherwell 007C","E01028428","Total",1443,74,36,38,1369,32,214,269,196,130,227,301
"2011","Cherwell 007D","E01028429","Total",1030,166,101,65,864,23,162,185,142,45,111,196
"2011","Cherwell 008A","E01028422","Total",1548,129,74,55,1419,69,190,415,270,88,144,243
"2011","Cherwell 008B","E01028423","Total",1419,143,71,72,1276,55,298,279,228,66,137,213
"2011","Cherwell 008C","E01028475","Total",2105,200,105,95,1905,52,364,417,336,100,254,382
"2011","Cherwell 008D","E01028476","Total",2195,161,68,93,2034,67,310,543,382,132,186,414
"2011","Cherwell 009A","E01028474","Total",1582,162,78,84,1420,79,208,400,264,87,141,241
"2011","Cherwell 009B","E01028485","Total",1313,142,91,51,1171,58,142,330,186,119,131,205
"2011","Cherwell 009C","E01028486","Total",1280,120,57,63,1160,14,230,280,248,88,89,211
"2011","Cherwell 009D","E01028503","Total",1151,97,55,42,1054,25,234,198,252,66,104,175
"2011","Cherwell 009E","E01028504","Total",1418,141,55,86,1277,23,232,323,226,81,105,287
"2011","Cherwell 010A","E01028481","Total",1427,177,104,73,1250,58,256,330,212,79,142,173
"2011","Cherwell 010B","E01028482","Total",1224,102,64,38,1122,26,204,288,200,94,134,176
"2011","Cherwell 010C","E01028505","Total",1758,149,59,90,1609,100,182,438,364,141,112,272
"2011","Cherwell 010D","E01028506","Total",1753,169,69,100,1584,54,222,454,330,97,153,274
"2011","Cherwell 010E","E01028507","Total",1419,127,64,63,1292,23,214,356,248,98,84,269
"2011","Cherwell 011A","E01028425","Total",1946,96,14,82,1850,89,58,885,314,184,108,212
"2011","Cherwell 011B","E01028477","Total",1510,112,50,62,1398,61,142,338,282,128,196,251
"2011","Cherwell 011C","E01028478","Total",1404,88,21,67,1316,47,34,496,190,206,163,180
"2011","Cherwell 011D","E01028483","Total",1270,97,41,56,1173,24,160,332,244,112,104,197
"2011","Cherwell 011E","E01028484","Total",1093,111,46,65,982,19,154,266,184,40,120,199
"2011","Cherwell 011F","E01028499","Total",1521,132,68,64,1389,26,222,296,296,96,166,287
"2011","Cherwell 012A","E01028459","Total",1476,207,19,188,1269,71,34,472,358,64,120,150
"2011","Cherwell 012B","E01028460","Total",2159,95,12,83,2064,122,76,952,292,159,248,215
"2011","Cherwell 012C","E01028461","Total",1748,135,14,121,1613,102,52,604,354,66,194,241
"2011","Cherwell 012D","E01028462","Total",1631,134,49,85,1497,55,138,446,250,98,201,309
"2011","Cherwell 013A","E01028455","Total",1442,71,16,55,1371,61,96,381,266,74,148,345
"2011","Cherwell 013B","E01028456","Total",1451,141,82,59,1310,86,214,222,236,101,150,301
"2011","Cherwell 013C","E01028457","Total",1395,80,29,51,1315,26,114,337,232,97,174,335
"2011","Cherwell 013D","E01028458","Total",1545,162,48,114,1383,81,54,406,274,117,193,258
"2011","Cherwell 013E","E01028467","Total",1581,225,85,140,1356,52,228,345,274,90,139,228
"2011","Cherwell 014A","E01028466","Total",1730,175,69,106,1555,125,184,320,248,177,195,306
"2011","Cherwell 014B","E01028469","Total",1527,111,75,36,1416,26,272,268,202,102,148,398
"2011","Cherwell 014C","E01028470","Total",1698,140,68,72,1558,59,256,360,248,86,212,337
"2011","Cherwell 014D","E01028471","Total",1366,79,39,40,1287,123,104,311,166,117,197,269
"2011","Cherwell 014E","E01028472","Total",1295,77,36,41,1218,35,102,342,218,72,135,314
"2011","Cherwell 014F","E01028473","Total",1539,137,31,106,1402,36,96,366,308,91,212,293
"2011","Cherwell 015A","E01028463","Total",2523,274,24,250,2249,182,58,883,550,208,129,239
"2011","Cherwell 015B","E01028464","Total",1428,147,24,123,1281,48,64,475,296,104,117,177
"2011","Cherwell 015C","E01028465","Total",1460,86,14,72,1374,76,74,542,236,95,144,207
"2011","Cherwell 015D","E01028468","Total",1798,500,303,197,1298,56,178,317,368,46,108,225
"2011","Cherwell 016A","E01028424","Total",1521,159,65,94,1362,10,214,359,290,82,142,265
"2011","Cherwell 016B","E01028497","Total",1380,146,70,76,1234,37,254,267,228,92,108,248
"2011","Cherwell 016C","E01028498","Total",1633,161,71,90,1472,59,174,408,216,147,151,317
"2011","Cherwell 016D","E01028500","Total",1230,94,46,48,1136,53,186,275,242,73,107,200
"2011","Cherwell 016E","E01028501","Total",1185,88,45,43,1097,17,188,246,210,70,156,210
"2011","Cherwell 016F","E01028502","Total",1230,110,53,57,1120,33,160,334,244,86,105,158
"2011","Cherwell 017A","E01028487","Total",1274,146,49,97,1128,63,70,294,282,65,123,231
"2011","Cherwell 017B","E01028489","Total",1393,151,107,44,1242,9,344,213,220,40,129,287
"2011","Cherwell 017C","E01028490","Total",1208,132,83,49,1076,26,180,199,164,48,202,257
"2011","Cherwell 017D","E01028491","Total",1495,193,118,75,1302,22,256,298,252,61,104,309
"2011","Cherwell 017E","E01028494","Total",1166,101,55,46,1065,69,104,275,200,71,129,217
"2011","Cherwell 018A","E01028492","Total",1474,139,83,56,1335,37,238,265,214,43,188,350
"2011","Cherwell 018B","E01028493","Total",1366,110,64,46,1256,60,196,202,166,109,183,340
"2011","Cherwell 018C","E01028495","Total",1313,116,56,60,1197,54,130,303,214,57,158,281
"2011","Cherwell 018D","E01028496","Total",1401,96,59,37,1305,87,106,283,174,87,246,322
"2011","Cherwell 019A","E01028488","Total",1355,215,35,180,1140,75,102,360,286,20,89,208
"2011","Cherwell 019B","E01028510","Total",1553,152,88,64,1401,46,222,320,246,116,127,324
"2011","Cherwell 019C","E01028511","Total",1609,215,133,82,1394,44,290,290,234,52,113,371
"2011","Cherwell 019D","E01028512","Total",1443,146,59,87,1297,66,158,295,258,57,126,337
"2011","Oxford 001A","E01028594","Total",1543,176,92,84,1367,26,258,282,256,92,177,276
"2011","Oxford 001B","E01028595","Total",1435,204,100,104,1231,50,132,396,222,110,118,203
"2011","Oxford 001C","E01028596","Total",1452,260,108,152,1192,42,162,323,248,78,136,203
"2011","Oxford 001D","E01028597","Total",1417,236,108,128,1181,69,156,251,214,78,158,255
"2011","Oxford 002C","E01028591","Total",1218,203,79,124,1015,22,130,249,208,98,116,192
"2011","Oxford 002D","E01028592","Total",1061,216,74,142,845,29,56,220,208,76,65,191
"2011","Oxford 002F","E01032554","Total",2032,402,210,192,1630,37,250,394,380,99,138,332
"2011","Oxford 002G","E01032555","Total",1985,230,84,146,1755,229,114,436,266,147,241,322
"2011","Oxford 003A","E01028565","Total",1253,150,46,104,1103,14,92,333,218,88,108,250
"2011","Oxford 003B","E01028583","Total",843,212,109,103,631,34,118,116,152,48,71,92
"2011","Oxford 003C","E01028584","Total",2583,356,78,278,2227,110,236,668,440,218,222,333
"2011","Oxford 003D","E01028585","Total",840,188,39,149,652,24,96,132,130,72,96,102
"2011","Oxford 004A","E01028560","Total",1490,247,130,117,1243,60,202,247,216,58,193,267
"2011","Oxford 004B","E01028561","Total",1593,168,107,61,1425,72,254,245,176,92,175,411
"2011","Oxford 004C","E01028562","Total",1647,150,70,80,1497,108,124,304,186,161,211,403
"2011","Oxford 004D","E01028563","Total",1492,155,61,94,1337,39,110,328,242,91,191,336
"2011","Oxford 005A","E01028513","Total",2199,322,68,254,1877,349,60,390,348,154,250,326
"2011","Oxford 005B","E01028514","Total",1502,154,72,82,1348,202,98,194,134,152,296,272
"2011","Oxford 005C","E01028516","Total",1768,200,78,122,1568,187,156,345,220,110,187,363
"2011","Oxford 005D","E01028538","Total",1487,217,104,113,1270,93,152,254,184,94,202,291
"2011","Oxford 006A","E01028534","Total",1104,149,97,52,955,16,118,223,168,106,102,222
"2011","Oxford 006B","E01028535","Total",1581,191,60,131,1390,33,100,327,322,88,84,436
"2011","Oxford 006C","E01028536","Total",1337,248,109,139,1089,31,124,278,224,27,81,324
"2011","Oxford 006D","E01028537","Total",1624,383,93,290,1241,28,158,284,280,64,87,340
"2011","Oxford 006E","E01028539","Total",1884,150,52,98,1734,82,90,381,204,111,298,568
"2011","Oxford 006F","E01028540","Total",1353,158,72,86,1195,42,172,261,178,99,173,270
"2011","Oxford 007A","E01028515","Total",1682,174,51,123,1508,91,100,417,280,71,209,340
"2011","Oxford 007B","E01028571","Total",1584,205,83,122,1379,62,122,347,296,57,157,338
"2011","Oxford 007C","E01028572","Total",1633,177,64,113,1456,64,146,376,294,107,163,306
"2011","Oxford 007D","E01028573","Total",1725,194,85,109,1531,39,128,487,222,119,164,372
"2011","Oxford 007E","E01028574","Total",1345,239,126,113,1106,75,132,228,210,47,145,269
"2011","Oxford 008A","E01028521","Total",1283,307,24,283,976,17,68,118,368,38,64,303
"2011","Oxford 008B","E01028522","Total",1196,461,73,388,735,69,56,113,286,10,55,146
"2011","Oxford 008E","E01033282","Total",2633,557,178,379,2076,82,222,415,530,97,142,588
"2011","Oxford 009A","E01028548","Total",1708,278,101,177,1430,57,114,339,358,90,96,376
"2011","Oxford 009B","E01028549","Total",1643,306,73,233,1337,40,76,324,390,50,72,385
"2011","Oxford 009C","E01028550","Total",1402,323,84,239,1079,63,62,158,260,34,27,475
"2011","Oxford 009D","E01028551","Total",1397,182,39,143,1215,57,80,178,350,20,53,477
"2011","Oxford 010A","E01028523","Total",1450,230,44,186,1220,115,90,189,240,57,91,438
"2011","Oxford 010B","E01028524","Total",1527,227,77,150,1300,176,104,248,170,69,234,299
"2011","Oxford 010C","E01028525","Total",1661,248,112,136,1413,221,116,264,174,115,185,338
"2011","Oxford 010D","E01028526","Total",1523,152,52,100,1371,54,64,124,194,40,142,753
"2011","Oxford 011A","E01028579","Total",1649,108,28,80,1541,20,42,109,236,32,171,931
"2011","Oxford 011B","E01028580","Total",1421,189,47,142,1232,44,50,101,250,20,62,705
"2011","Oxford 011C","E01028581","Total",1298,117,43,74,1181,34,88,178,180,36,88,577
"2011","Oxford 011D","E01028582","Total",1313,261,87,174,1052,51,48,77,222,16,69,569
"2011","Oxford 011E","E01028586","Total",1702,261,39,222,1441,39,38,170,250,44,83,817
"2011","Oxford 011F","E01028587","Total",1964,264,30,234,1700,72,28,186,262,46,140,966
"2011","Oxford 011G","E01028588","Total",1249,146,14,132,1103,9,28,107,220,10,65,664
"2011","Oxford 012A","E01028541","Total",1472,199,63,136,1273,49,82,313,242,93,79,415
"2011","Oxford 012B","E01028542","Total",1820,236,49,187,1584,105,84,266,384,84,238,423
"2011","Oxford 012C","E01028543","Total",1320,250,83,167,1070,58,118,238,212,70,78,296
"2011","Oxford 012D","E01028544","Total",1300,252,91,161,1048,23,94,184,242,74,63,368
"2011","Oxford 013A","E01028531","Total",1884,309,32,277,1575,88,72,358,472,54,125,406
"2011","Oxford 013B","E01028532","Total",2597,355,71,284,2242,86,114,295,376,92,403,876
"2011","Oxford 013C","E01028533","Total",2197,229,52,177,1968,163,90,290,342,145,396,542
"2011","Oxford 013D","E01028556","Total",1769,186,53,133,1583,127,84,330,312,100,226,404
"2011","Oxford 013E","E01028557","Total",1929,182,71,111,1747,158,120,294,186,176,330,483
"2011","Oxford 013F","E01028558","Total",1698,121,50,71,1577,110,126,257,180,109,270,525
"2011","Oxford 013G","E01028559","Total",1698,159,57,102,1539,86,140,250,264,67,219,513
"2011","Oxford 014A","E01028545","Total",1596,179,24,155,1417,44,60,315,232,89,149,528
"2011","Oxford 014B","E01028546","Total",1900,236,100,136,1664,109,136,261,248,105,326,479
"2011","Oxford 014C","E01028547","Total",2153,232,46,186,1921,59,40,368,400,74,181,799
"2011","Oxford 015A","E01028527","Total",1675,212,89,123,1463,72,122,336,262,104,165,402
"2011","Oxford 015B","E01028528","Total",1530,137,51,86,1393,67,76,235,172,144,238,461
"2011","Oxford 015C","E01028529","Total",1570,210,85,125,1360,155,104,287,164,96,207,347
"2011","Oxford 015D","E01028530","Total",1707,166,91,75,1541,141,132,243,182,90,278,475
"2011","Oxford 015E","E01028575","Total",1500,230,107,123,1270,55,210,230,252,60,175,288
"2011","Oxford 015F","E01028578","Total",1548,224,100,124,1324,32,124,225,210,130,215,388
"2011","Oxford 016A","E01028552","Total",1724,242,95,147,1482,232,128,308,204,147,146,317
"2011","Oxford 016B","E01028553","Total",1648,240,48,192,1408,180,116,277,386,119,90,240
"2011","Oxford 016C","E01028554","Total",1326,176,58,118,1150,96,126,153,170,65,240,300
"2011","Oxford 016D","E01028555","Total",1580,186,67,119,1394,109,134,285,280,76,155,355
"2011","Oxford 016E","E01028576","Total",1462,109,34,75,1353,223,58,236,166,112,353,205
"2011","Oxford 016F","E01028577","Total",1960,229,87,142,1731,193,154,301,214,187,328,354
"2011","Oxford 017A","E01028517","Total",1307,132,24,108,1175,177,68,246,170,82,192,240
"2011","Oxford 017B","E01028518","Total",1571,249,64,185,1322,264,140,212,108,102,234,262
"2011","Oxford 017C","E01028519","Total",1451,127,61,66,1324,139,162,212,108,141,181,381
"2011","Oxford 017D","E01028567","Total",1756,193,93,100,1563,241,104,288,140,83,293,414
"2011","Oxford 018A","E01028520","Total",1702,172,65,107,1530,270,134,263,114,182,305,262
"2011","Oxford 018B","E01028568","Total",1601,187,90,97,1414,296,106,294,130,164,205,219
"2011","Oxford 018C","E01028569","Total",1680,209,28,181,1471,299,38,387,174,182,186,205
"2011","Oxford 018D","E01028570","Total",1899,230,16,214,1669,236,32,593,288,142,200,178
"2011","South Oxfordshire 001A","E01028666","Total",1536,238,93,145,1298,59,114,331,298,86,180,230
"2011","South Oxfordshire 001B","E01028667","Total",1384,114,33,81,1270,55,34,417,242,103,155,264
"2011","South Oxfordshire 001C","E01028668","Total",1402,124,64,60,1278,25,168,340,198,77,156,314
"2011","South Oxfordshire 001D","E01028669","Total",1353,112,61,51,1241,46,166,336,234,72,156,231
"2011","South Oxfordshire 002A","E01028638","Total",1382,120,59,61,1262,44,222,227,240,96,149,284
"2011","South Oxfordshire 002B","E01028639","Total",1240,104,52,52,1136,17,142,262,240,58,152,265
"2011","South Oxfordshire 002C","E01028640","Total",1428,142,63,79,1286,48,206,331,202,78,118,303
"2011","South Oxfordshire 002D","E01028683","Total",1378,153,91,62,1225,11,236,259,160,63,149,347
"2011","South Oxfordshire 003A","E01028670","Total",1446,108,70,38,1338,28,200,382,206,134,138,250
"2011","South Oxfordshire 003B","E01028671","Total",1420,283,174,109,1137,58,156,282,216,121,89,215
"2011","South Oxfordshire 003C","E01028672","Total",1710,148,80,68,1562,33,292,363,278,136,159,301
"2011","South Oxfordshire 003D","E01028673","Total",1260,116,45,71,1144,61,116,297,232,115,105,218
"2011","South Oxfordshire 004A","E01028646","Total",1150,115,53,62,1035,35,154,238,190,83,122,213
"2011","South Oxfordshire 004B","E01028647","Total",1549,120,58,62,1429,47,220,382,276,57,154,293
"2011","South Oxfordshire 004C","E01028681","Total",1292,109,66,43,1183,24,208,272,210,63,120,286
"2011","South Oxfordshire 004D","E01028682","Total",1179,133,83,50,1046,31,212,252,158,36,126,231
"2011","South Oxfordshire 004E","E01028684","Total",1423,197,76,121,1226,39,176,305,300,55,110,241
"2011","South Oxfordshire 005A","E01028598","Total",2370,199,101,98,2171,48,310,549,424,131,242,467
"2011","South Oxfordshire 005B","E01028613","Total",1437,73,28,45,1364,46,150,410,218,76,155,309
"2011","South Oxfordshire 005C","E01028614","Total",1498,137,67,70,1361,39,192,357,232,110,132,299
"2011","South Oxfordshire 005D","E01028615","Total",1553,173,114,59,1380,42,298,250,258,62,128,342
"2011","South Oxfordshire 005E","E01028616","Total",1406,97,36,61,1309,52,146,330,214,93,145,329
"2011","South Oxfordshire 006A","E01028604","Total",1548,124,39,85,1424,81,112,347,192,157,304,231
"2011","South Oxfordshire 006B","E01028605","Total",1555,173,81,92,1382,100,198,314,182,99,174,315
"2011","South Oxfordshire 006C","E01028607","Total",1274,105,55,50,1169,10,176,269,218,113,116,267
"2011","South Oxfordshire 006D","E01028641","Total",1204,117,71,46,1087,31,212,224,216,60,123,221
"2011","South Oxfordshire 006E","E01028657","Total",1192,195,53,142,997,32,116,207,262,61,98,221
"2011","South Oxfordshire 006F","E01028658","Total",1240,112,55,57,1128,33,184,259,158,113,132,249
"2011","South Oxfordshire 007A","E01028600","Total",1499,170,95,75,1329,52,228,325,224,105,141,254
"2011","South Oxfordshire 007B","E01028603","Total",1199,103,53,50,1096,20,132,277,174,125,119,249
"2011","South Oxfordshire 007C","E01028606","Total",1727,220,134,86,1507,40,326,346,244,108,142,301
"2011","South Oxfordshire 007D","E01028609","Total",1337,62,32,30,1275,50,182,341,210,133,121,238
"2011","South Oxfordshire 007E","E01028610","Total",1493,129,57,72,1364,30,196,343,262,37,137,359
"2011","South Oxfordshire 008A","E01028678","Total",1545,134,83,51,1411,40,264,431,242,92,116,226
"2011","South Oxfordshire 008B","E01028679","Total",2129,178,77,101,1951,51,318,460,362,141,254,365
"2011","South Oxfordshire 008C","E01028680","Total",1728,245,142,103,1483,42,256,435,294,129,148,179
"2011","South Oxfordshire 009A","E01028625","Total",1958,148,24,124,1810,85,42,796,478,109,129,171
"2011","South Oxfordshire 009B","E01028626","Total",1648,105,15,90,1543,79,36,543,376,94,146,269
"2011","South Oxfordshire 009C","E01028627","Total",1494,134,27,107,1360,106,66,525,338,67,94,164
"2011","South Oxfordshire 009D","E01028628","Total",1493,88,9,79,1405,68,60,470,274,82,175,276
"2011","South Oxfordshire 009E","E01028629","Total",1446,205,25,180,1241,60,36,436,332,89,123,165
"2011","South Oxfordshire 010A","E01028621","Total",1370,105,35,70,1265,162,64,401,200,135,118,185
"2011","South Oxfordshire 010B","E01028622","Total",1214,150,84,66,1064,54,202,245,176,52,114,221
"2011","South Oxfordshire 010C","E01028623","Total",1634,174,75,99,1460,65,144,319,238,123,170,401
"2011","South Oxfordshire 010D","E01028624","Total",1367,151,89,62,1216,41,204,247,202,77,127,318
"2011","South Oxfordshire 011A","E01028599","Total",1378,159,94,65,1219,20,250,286,238,47,138,240
"2011","South Oxfordshire 011B","E01028601","Total",1223,96,42,54,1127,20,148,388,166,105,106,194
"2011","South Oxfordshire 011C","E01028602","Total",1543,27,15,12,1516,21,54,821,302,156,95,67
"2011","South Oxfordshire 011D","E01028620","Total",2415,226,97,129,2189,79,318,614,404,140,232,402
"2011","South Oxfordshire 012A","E01028608","Total",1197,83,48,35,1114,16,204,282,174,65,190,183
"2011","South Oxfordshire 012B","E01028617","Total",1856,225,112,113,1631,68,254,465,304,165,107,268
"2011","South Oxfordshire 012C","E01028674","Total",1326,111,61,50,1215,49,236,353,218,93,72,194
"2011","South Oxfordshire 012D","E01028675","Total",1251,149,76,73,1102,54,100,275,170,110,142,251
"2011","South Oxfordshire 012E","E01028676","Total",1964,253,74,179,1711,94,182,480,300,134,164,357
"2011","South Oxfordshire 012F","E01028677","Total",1427,392,189,203,1035,43,146,287,292,62,70,135
"2011","South Oxfordshire 013A","E01028630","Total",1549,256,17,239,1293,98,36,393,336,61,129,240
"2011","South Oxfordshire 013B","E01028631","Total",1104,137,58,79,967,65,118,244,150,37,112,241
"2011","South Oxfordshire 013C","E01028632","Total",1477,100,44,56,1377,110,122,248,198,126,193,380
"2011","South Oxfordshire 013D","E01028633","Total",1505,260,33,227,1245,147,76,309,286,104,110,213
"2011","South Oxfordshire 014A","E01028634","Total",1337,102,59,43,1235,12,200,313,184,87,203,236
"2011","South Oxfordshire 014B","E01028635","Total",1528,157,85,72,1371,93,190,297,206,112,141,332
"2011","South Oxfordshire 014C","E01028636","Total",1307,215,155,60,1092,86,144,228,130,107,172,225
"2011","South Oxfordshire 014D","E01028637","Total",1555,136,72,64,1419,29,188,368,258,85,157,334
"2011","South Oxfordshire 015A","E01028618","Total",1761,134,52,82,1627,28,240,451,346,177,105,280
"2011","South Oxfordshire 015B","E01028619","Total",1835,164,84,80,1671,78,294,430,260,100,195,314
"2011","South Oxfordshire 015C","E01028644","Total",1583,200,130,70,1383,40,300,382,268,46,123,224
"2011","South Oxfordshire 015D","E01028648","Total",1162,116,67,49,1046,33,160,271,168,57,136,221
"2011","South Oxfordshire 015E","E01028649","Total",1555,108,61,47,1447,41,198,345,264,109,182,308
"2011","South Oxfordshire 016A","E01028650","Total",1956,243,140,103,1713,74,238,504,264,143,163,327
"2011","South Oxfordshire 016B","E01028651","Total",1555,290,167,123,1265,46,262,281,252,79,98,247
"2011","South Oxfordshire 016C","E01028652","Total",1990,454,229,225,1536,84,334,343,356,92,94,233
"2011","South Oxfordshire 017A","E01028653","Total",1398,225,79,146,1173,95,114,445,236,83,74,126
"2011","South Oxfordshire 017B","E01028654","Total",1609,142,78,64,1467,43,200,440,180,183,183,238
"2011","South Oxfordshire 017C","E01028655","Total",1714,353,139,214,1361,112,164,383,350,66,85,201
"2011","South Oxfordshire 017D","E01028656","Total",1297,114,77,37,1183,8,298,309,152,86,125,205
"2011","South Oxfordshire 018A","E01028611","Total",1142,91,45,46,1051,16,158,260,186,103,135,193
"2011","South Oxfordshire 018B","E01028642","Total",1295,91,64,27,1204,35,198,318,170,126,158,199
"2011","South Oxfordshire 018C","E01028643","Total",1356,135,73,62,1221,53,206,343,202,75,113,229
"2011","South Oxfordshire 018D","E01028645","Total",1389,171,116,55,1218,29,380,254,194,78,91,192
"2011","South Oxfordshire 018E","E01028685","Total",1188,99,59,40,1089,33,190,310,194,47,77,238
"2011","South Oxfordshire 018F","E01028686","Total",1194,106,50,56,1088,38,166,251,174,70,156,233
"2011","South Oxfordshire 019A","E01028612","Total",1225,114,43,71,1111,23,226,332,200,98,84,148
"2011","South Oxfordshire 019B","E01028660","Total",1743,160,84,76,1583,72,206,381,272,188,161,303
"2011","South Oxfordshire 019C","E01028661","Total",1511,107,70,37,1404,7,284,304,202,152,189,266
"2011","South Oxfordshire 019D","E01028662","Total",1316,80,47,33,1236,11,250,311,192,141,158,173
"2011","South Oxfordshire 020A","E01028659","Total",1603,115,59,56,1488,28,256,362,246,155,126,315
"2011","South Oxfordshire 020B","E01028663","Total",1483,163,82,81,1320,81,182,395,202,86,109,265
"2011","South Oxfordshire 020C","E01028664","Total",1289,131,97,34,1158,27,286,282,158,56,99,250
"2011","South Oxfordshire 020D","E01028665","Total",1302,102,70,32,1200,36,266,320,166,45,153,214
"2011","Vale of White Horse 001A","E01028708","Total",1729,219,120,99,1510,51,248,273,290,90,195,363
"2011","Vale of White Horse 001B","E01028709","Total",1572,142,62,80,1430,16,270,249,280,82,138,395
"2011","Vale of White Horse 001C","E01028710","Total",1618,150,86,64,1468,26,256,407,260,84,157,278
"2011","Vale of White Horse 001D","E01028711","Total",1673,147,81,66,1526,76,256,358,234,129,184,289
"2011","Vale of White Horse 002A","E01028733","Total",1279,158,96,62,1121,7,242,249,166,81,147,229
"2011","Vale of White Horse 002B","E01028734","Total",1520,182,97,85,1338,36,252,255,266,108,146,275
"2011","Vale of White Horse 002C","E01028735","Total",1634,130,79,51,1504,62,264,332,198,71,201,376
"2011","Vale of White Horse 002D","E01028740","Total",1553,177,94,83,1376,38,212,357,256,46,170,297
"2011","Vale of White Horse 002E","E01028741","Total",1307,108,53,55,1199,22,132,294,208,82,183,278
"2011","Vale of White Horse 002F","E01028742","Total",1552,286,169,117,1266,46,176,288,274,73,109,300
"2011","Vale of White Horse 003A","E01028738","Total",1427,45,21,24,1382,53,74,632,184,162,122,155
"2011","Vale of White Horse 003B","E01028739","Total",1684,165,112,53,1519,60,242,398,280,87,150,302
"2011","Vale of White Horse 003C","E01028743","Total",964,184,72,112,780,8,186,163,172,77,47,127
"2011","Vale of White Horse 003D","E01028744","Total",1230,139,81,58,1091,37,184,177,220,82,98,293
"2011","Vale of White Horse 003E","E01028750","Total",1466,146,91,55,1320,54,192,374,202,107,146,245
"2011","Vale of White Horse 003F","E01028751","Total",1434,125,64,61,1309,19,230,296,230,71,157,306
"2011","Vale of White Horse 003G","E01028752","Total",1697,130,65,65,1567,62,252,366,240,151,163,333
"2011","Vale of White Horse 004A","E01028693","Total",1612,107,54,53,1505,25,162,465,242,86,217,308
"2011","Vale of White Horse 004B","E01028694","Total",1470,181,24,157,1289,44,64,401,238,64,162,316
"2011","Vale of White Horse 004C","E01028701","Total",1561,153,69,84,1408,55,178,420,252,84,172,247
"2011","Vale of White Horse 004D","E01028705","Total",1289,67,37,30,1222,47,180,276,224,53,117,325
"2011","Vale of White Horse 004E","E01028706","Total",1497,131,37,94,1366,24,162,382,258,47,131,362
"2011","Vale of White Horse 004F","E01028707","Total",1555,117,40,77,1438,51,132,369,290,66,212,318
"2011","Vale of White Horse 005A","E01028688","Total",1211,137,36,101,1074,35,68,322,254,60,84,251
"2011","Vale of White Horse 005B","E01028689","Total",1471,196,33,163,1275,86,74,405,298,67,119,226
"2011","Vale of White Horse 005C","E01028695","Total",1563,154,88,66,1409,42,272,435,230,46,136,248
"2011","Vale of White Horse 005D","E01028699","Total",1598,146,82,64,1452,29,274,377,238,105,173,256
"2011","Vale of White Horse 006B","E01028696","Total",1314,115,64,51,1199,39,224,278,150,114,135,259
"2011","Vale of White Horse 006C","E01028697","Total",1504,227,87,140,1277,118,148,318,240,67,169,217
"2011","Vale of White Horse 006D","E01028698","Total",1493,197,53,144,1296,64,110,395,364,94,74,195
"2011","Vale of White Horse 006E","E01028700","Total",1676,224,116,108,1452,165,142,362,214,147,191,231
"2011","Vale of White Horse 006F","E01028703","Total",1656,320,116,204,1336,119,132,357,366,53,89,220
"2011","Vale of White Horse 006G","E01033305","Total",1287,272,53,219,1015,96,68,302,372,43,38,96
"2011","Vale of White Horse 006H","E01033306","Total",1518,374,127,247,1144,67,154,312,314,41,78,178
"2011","Vale of White Horse 007A","E01028726","Total",2191,213,118,95,1978,41,378,489,420,106,178,366
"2011","Vale of White Horse 007B","E01028736","Total",2346,183,85,98,2163,90,312,618,428,133,197,385
"2011","Vale of White Horse 007C","E01028737","Total",2334,215,88,127,2119,72,376,507,352,187,235,390
"2011","Vale of White Horse 008A","E01028690","Total",1622,202,69,133,1420,82,244,298,280,95,111,310
"2011","Vale of White Horse 008B","E01028691","Total",1424,193,113,80,1231,57,178,226,200,94,136,340
"2011","Vale of White Horse 008C","E01028692","Total",1411,126,56,70,1285,194,72,223,136,208,230,222
"2011","Vale of White Horse 008D","E01028702","Total",1241,106,57,49,1135,26,196,183,244,17,173,296
"2011","Vale of White Horse 008E","E01028704","Total",1858,297,148,149,1561,119,206,422,324,90,131,269
"2011","Vale of White Horse 009A","E01028716","Total",1883,170,47,123,1713,134,112,604,362,102,181,218
"2011","Vale of White Horse 009B","E01028717","Total",1580,400,156,244,1180,70,152,329,270,57,162,140
"2011","Vale of White Horse 009C","E01028718","Total",1499,182,71,111,1317,70,120,350,224,136,189,228
"2011","Vale of White Horse 009D","E01028719","Total",1560,131,81,50,1429,31,284,359,288,48,119,300
"2011","Vale of White Horse 009E","E01028749","Total",2396,242,105,137,2154,81,372,569,376,202,257,297
"2011","Vale of White Horse 010A","E01028714","Total",2353,247,144,103,2106,72,322,530,320,156,266,440
"2011","Vale of White Horse 010B","E01028731","Total",1292,147,93,54,1145,33,202,285,170,55,153,247
"2011","Vale of White Horse 010C","E01028732","Total",1182,136,39,97,1046,57,108,315,250,79,94,143
"2011","Vale of White Horse 010D","E01028753","Total",1422,148,71,77,1274,72,208,266,184,97,151,296
"2011","Vale of White Horse 010E","E01028754","Total",1347,157,61,96,1190,46,182,274,218,82,124,264
"2011","Vale of White Horse 011A","E01028721","Total",1348,102,23,79,1246,63,96,397,242,76,136,236
"2011","Vale of White Horse 011B","E01028722","Total",1601,190,78,112,1411,39,292,322,232,84,164,278
"2011","Vale of White Horse 011C","E01028723","Total",1418,133,87,46,1285,33,290,242,186,64,182,288
"2011","Vale of White Horse 011D","E01028724","Total",1299,92,38,54,1207,38,166,296,216,75,132,284
"2011","Vale of White Horse 011E","E01028725","Total",1512,165,61,104,1347,96,88,371,268,96,170,258
"2011","Vale of White Horse 014A","E01028755","Total",1664,187,118,69,1477,80,246,328,212,158,172,281
"2011","Vale of White Horse 014B","E01028756","Total",2322,471,167,304,1851,144,234,495,516,147,87,228
"2011","Vale of White Horse 014C","E01028758","Total",1553,134,102,32,1419,28,286,300,162,93,228,322
"2011","Vale of White Horse 014D","E01028759","Total",1526,167,75,92,1359,40,180,308,238,102,182,309
"2011","Vale of White Horse 014E","E01028760","Total",1238,86,49,37,1152,54,126,316,210,87,119,240
"2011","Vale of White Horse 014F","E01028761","Total",1354,93,24,69,1261,38,130,372,224,101,162,234
"2011","Vale of White Horse 015A","E01028712","Total",2002,244,130,114,1758,65,356,443,368,110,152,264
"2011","Vale of White Horse 015B","E01028727","Total",1620,148,83,65,1472,42,258,369,262,97,160,284
"2011","Vale of White Horse 015C","E01028728","Total",1156,124,72,52,1032,47,166,248,182,63,145,181
"2011","Vale of White Horse 015D","E01028729","Total",1068,96,40,56,972,44,120,294,214,80,55,165
"2011","Vale of White Horse 015E","E01028730","Total",1623,149,71,78,1474,24,234,388,250,141,169,268
"2011","Vale of White Horse 015F","E01028757","Total",1449,217,106,111,1232,128,170,267,232,114,130,191
"2011","Vale of White Horse 016E","E01028713","Total",2364,232,99,133,2132,50,322,543,436,186,187,408
"2011","Vale of White Horse 016F","E01028715","Total",1350,121,44,77,1229,49,204,370,240,83,114,169
"2011","Vale of White Horse 016G","E01028720","Total",2208,210,112,98,1998,54,358,413,396,186,207,384
"2011","Vale of White Horse 016A","E01028745","Total",1253,145,71,74,1108,47,206,286,248,98,82,141
"2011","Vale of White Horse 016B","E01028746","Total",1242,128,69,59,1114,25,210,254,170,72,134,249
"2011","Vale of White Horse 016C","E01028747","Total",1250,71,23,48,1179,24,82,485,196,143,107,142
"2011","Vale of White Horse 016D","E01028748","Total",1069,114,44,70,955,34,58,404,160,113,47,139
"2011","West Oxfordshire 001A","E01028780","Total",1990,283,128,155,1707,75,288,447,400,107,152,238
"2011","West Oxfordshire 001B","E01028781","Total",1255,153,85,68,1102,81,144,273,128,67,154,255
"2011","West Oxfordshire 001C","E01028782","Total",1551,160,86,74,1391,56,198,352,266,102,158,259
"2011","West Oxfordshire 001D","E01028783","Total",1487,298,158,140,1189,76,180,281,302,41,84,225
"2011","West Oxfordshire 002A","E01028795","Total",1540,170,79,91,1370,34,240,302,288,129,104,273
"2011","West Oxfordshire 002B","E01028796","Total",1179,151,69,82,1028,35,194,327,194,70,95,113
"2011","West Oxfordshire 002C","E01028797","Total",1106,112,49,63,994,6,164,280,170,92,91,191
"2011","West Oxfordshire 002D","E01028806","Total",1976,190,91,99,1786,45,288,496,336,117,167,337
"2011","West Oxfordshire 003A","E01028763","Total",1930,211,116,95,1719,60,316,425,370,159,117,272
"2011","West Oxfordshire 003B","E01028776","Total",1910,225,113,112,1685,22,286,346,326,189,203,313
"2011","West Oxfordshire 003C","E01028798","Total",2010,249,133,116,1761,62,346,488,278,145,143,299
"2011","West Oxfordshire 004B","E01028804","Total",1313,137,82,55,1176,44,210,323,188,108,124,179
"2011","West Oxfordshire 004D","E01028823","Total",1239,247,125,122,992,57,192,268,276,53,19,127
"2011","West Oxfordshire 004E","E01028824","Total",1540,196,120,76,1344,53,224,369,240,70,155,233
"2011","West Oxfordshire 004F","E01028825","Total",1165,125,74,51,1040,35,216,305,170,69,86,159
"2011","West Oxfordshire 004G","E01032954","Total",2716,288,153,135,2428,103,412,631,432,185,216,449
"2011","West Oxfordshire 005A","E01028777","Total",1100,195,87,108,905,51,152,193,232,68,69,140
"2011","West Oxfordshire 005B","E01028778","Total",1468,213,134,79,1255,59,226,297,218,89,96,270
"2011","West Oxfordshire 005C","E01028779","Total",1058,108,49,59,950,29,178,203,200,31,104,205
"2011","West Oxfordshire 005D","E01028799","Total",1911,168,95,73,1743,34,340,364,298,93,238,376
"2011","West Oxfordshire 006A","E01028788","Total",1599,209,106,103,1390,17,268,381,250,68,136,270
"2011","West Oxfordshire 006B","E01028789","Total",1448,145,79,66,1303,16,216,353,246,61,130,281
"2011","West Oxfordshire 006C","E01028790","Total",1182,91,47,44,1091,10,182,249,194,95,142,219
"2011","West Oxfordshire 006D","E01028791","Total",1487,106,56,50,1381,16,256,323,230,66,166,324
"2011","West Oxfordshire 007A","E01028784","Total",2110,186,95,91,1924,56,292,429,344,139,207,457
"2011","West Oxfordshire 007B","E01028792","Total",1073,113,60,53,960,24,198,212,184,82,54,206
"2011","West Oxfordshire 007C","E01028793","Total",1523,156,67,89,1367,73,186,327,258,94,204,225
"2011","West Oxfordshire 007D","E01028794","Total",1404,124,73,51,1280,38,246,281,222,41,149,303
"2011","West Oxfordshire 008A","E01028810","Total",1358,185,41,144,1173,40,104,327,254,54,163,231
"2011","West Oxfordshire 008B","E01028811","Total",1378,168,83,85,1210,97,142,293,236,79,137,226
"2011","West Oxfordshire 008D","E01028813","Total",1294,114,42,72,1180,74,126,267,164,98,178,273
"2011","West Oxfordshire 008E","E01028814","Total",1413,164,76,88,1249,46,186,276,264,70,150,257
"2011","West Oxfordshire 008F","E01028815","Total",1239,81,51,30,1158,9,236,273,206,37,94,303
"2011","West Oxfordshire 008G","E01032947","Total",1818,132,8,124,1686,132,36,711,370,132,139,166
"2011","West Oxfordshire 008H","E01032948","Total",1853,123,37,86,1730,46,190,604,346,164,158,222
"2011","West Oxfordshire 008I","E01032952","Total",1333,209,86,123,1124,54,140,272,278,51,126,203
"2011","West Oxfordshire 009A","E01028809","Total",1363,101,73,28,1262,137,210,206,164,172,148,225
"2011","West Oxfordshire 009B","E01028820","Total",1338,124,24,100,1214,31,72,410,252,62,168,219
"2011","West Oxfordshire 009C","E01028821","Total",1495,175,37,138,1320,75,78,386,314,106,165,196
"2011","West Oxfordshire 009D","E01028822","Total",1417,142,33,109,1275,23,90,423,294,82,114,249
"2011","West Oxfordshire 010A","E01028807","Total",2103,350,123,227,1753,83,212,405,520,96,121,316
"2011","West Oxfordshire 010B","E01028808","Total",1728,178,65,113,1550,92,248,320,298,101,198,293
"2011","West Oxfordshire 010C","E01028816","Total",1383,84,39,45,1299,30,132,300,172,108,194,363
"2011","West Oxfordshire 010D","E01028817","Total",1481,147,61,86,1334,72,148,294,234,100,169,317
"2011","West Oxfordshire 010E","E01028818","Total",1723,360,210,150,1363,90,210,264,260,87,151,301
"2011","West Oxfordshire 010F","E01028819","Total",1586,273,176,97,1313,116,212,231,234,115,127,278
"2011","West Oxfordshire 011A","E01028785","Total",1537,185,98,87,1352,74,202,339,238,64,142,293
"2011","West Oxfordshire 011B","E01028786","Total",1256,106,70,36,1150,17,252,265,180,40,119,277
"2011","West Oxfordshire 011C","E01028787","Total",1296,143,74,69,1153,55,190,236,206,95,133,238
"2011","West Oxfordshire 011D","E01028800","Total",1306,112,57,55,1194,56,150,311,210,105,132,230
"2011","West Oxfordshire 012A","E01028762","Total",1772,192,85,107,1580,45,224,415,380,122,145,249
"2011","West Oxfordshire 012B","E01028766","Total",1901,212,96,116,1689,74,270,400,422,127,125,271
"2011","West Oxfordshire 012C","E01028767","Total",1763,296,183,113,1467,43,404,278,330,92,91,229
"2011","West Oxfordshire 013D","E01028772","Total",1679,189,47,142,1490,64,200,378,418,51,85,294
"2011","West Oxfordshire 013E","E01032949","Total",1443,125,7,118,1318,88,24,437,368,85,141,175
"2011","West Oxfordshire 013F","E01032950","Total",1733,129,15,114,1604,124,28,589,434,130,140,159
"2011","West Oxfordshire 013G","E01032951","Total",1953,116,26,90,1837,91,96,710,308,165,218,249
"2011","West Oxfordshire 013H","E01032953","Total",2212,136,36,100,2076,95,174,835,434,123,168,247
"2011","West Oxfordshire 014A","E01028771","Total",1451,209,109,100,1242,59,200,223,250,67,134,309
"2011","West Oxfordshire 014B","E01028773","Total",1288,186,72,114,1102,54,182,232,206,21,144,263
"2011","West Oxfordshire 014C","E01028774","Total",1475,114,41,73,1361,63,78,482,168,124,189,257
"2011","West Oxfordshire 014D","E01028775","Total",1281,161,60,101,1120,27,144,248,254,40,126,281
"2011","West Oxfordshire 015A","E01028764","Total",1739,199,104,95,1540,44,294,349,330,100,123,300
"2011","West Oxfordshire 015B","E01028765","Total",1937,228,137,91,1709,67,288,427,284,135,180,328
"2011","West Oxfordshire 015C","E01028801","Total",1374,125,58,67,1249,35,158,335,226,96,147,252
"2011","West Oxfordshire 015D","E01028802","Total",1446,130,70,60,1316,25,252,313,270,119,144,193
"2011","Elmbridge 001A","E01030330","Total",1549,180,79,101,1369,40,202,389,260,65,169,244
"2011","Elmbridge 001B","E01030331","Total",1547,193,70,123,1354,66,174,396,314,58,113,233
"2011","Elmbridge 001C","E01030332","Total",1473,156,90,66,1317,75,174,339,196,67,177,289
"2011","Elmbridge 001D","E01030333","Total",1438,155,78,77,1283,35,196,346,168,61,163,314
"2011","Elmbridge 002A","E01030326","Total",1613,313,100,213,1300,34,162,308,358,73,136,229
"2011","Elmbridge 002B","E01030327","Total",1544,175,74,101,1369,21,186,396,244,98,155,269
"2011","Elmbridge 002C","E01030328","Total",1673,126,71,55,1547,10,182,604,228,99,156,268
"2011","Elmbridge 002D","E01030329","Total",1441,190,91,99,1251,40,178,385,250,51,132,215
"2011","Elmbridge 003A","E01030334","Total",1437,126,64,62,1311,50,144,272,160,73,213,399
"2011","Elmbridge 003B","E01030335","Total",1836,221,88,133,1615,83,180,455,248,161,176,312
"2011","Elmbridge 003C","E01030336","Total",1878,234,91,143,1644,129,130,512,324,125,144,280
"2011","Elmbridge 003D","E01030337","Total",1557,300,155,145,1257,66,146,356,226,76,142,245
"2011","Elmbridge 004A","E01030361","Total",1983,226,92,134,1757,70,142,623,322,86,197,317
"2011","Elmbridge 004B","E01030362","Total",1176,140,49,91,1036,75,116,242,170,72,175,186
"2011","Elmbridge 004C","E01030363","Total",1840,235,71,164,1605,102,146,500,318,98,141,300
"2011","Elmbridge 004D","E01030364","Total",1512,278,44,234,1234,109,48,367,318,101,78,213
"2011","Elmbridge 005A","E01030350","Total",1636,187,86,101,1449,46,174,490,300,132,78,229
"2011","Elmbridge 005B","E01030351","Total",1523,175,75,100,1348,29,124,477,282,116,125,195
"2011","Elmbridge 005C","E01030352","Total",1513,146,82,64,1367,49,148,370,194,192,157,257
"2011","Elmbridge 005D","E01030353","Total",1510,105,51,54,1405,33,94,473,254,196,149,206
"2011","Elmbridge 006A","E01030322","Total",1814,211,78,133,1603,43,124,619,340,117,134,226
"2011","Elmbridge 006B","E01030323","Total",1383,118,58,60,1265,19,154,399,172,133,129,259
"2011","Elmbridge 006C","E01030324","Total",1578,157,76,81,1421,53,120,466,306,106,146,224
"2011","Elmbridge 006D","E01030325","Total",1538,145,85,60,1393,20,162,447,180,107,187,290
"2011","Elmbridge 007A","E01030357","Total",1566,254,129,125,1312,43,190,409,290,58,65,257
"2011","Elmbridge 007B","E01030358","Total",1443,175,78,97,1268,44,166,392,254,70,118,224
"2011","Elmbridge 007C","E01030359","Total",2210,382,119,263,1828,118,202,528,506,106,114,254
"2011","Elmbridge 007D","E01030360","Total",1571,184,86,98,1387,74,148,331,288,96,177,273
"2011","Elmbridge 008A","E01030354","Total",1483,122,39,83,1361,120,70,384,190,103,216,278
"2011","Elmbridge 008B","E01030355","Total",1415,94,43,51,1321,47,106,451,208,130,116,263
"2011","Elmbridge 008C","E01030356","Total",1347,101,53,48,1246,52,110,439,192,104,128,221
"2011","Elmbridge 008D","E01030365","Total",1512,131,47,84,1381,36,162,422,260,77,170,254
"2011","Elmbridge 008E","E01030368","Total",1582,113,56,57,1469,66,206,496,214,91,117,279
"2011","Elmbridge 009A","E01030319","Total",1729,86,52,34,1643,45,212,578,180,101,235,292
"2011","Elmbridge 009B","E01030320","Total",1741,190,118,72,1551,69,114,540,220,113,223,272
"2011","Elmbridge 009C","E01030321","Total",1575,104,76,28,1471,16,200,479,176,101,212,287
"2011","Elmbridge 009D","E01030369","Total",2243,95,66,29,2148,32,242,729,286,192,321,346
"2011","Elmbridge 009E","E01030370","Total",1627,123,73,50,1504,43,134,581,192,149,177,228
"2011","Elmbridge 010A","E01030313","Total",1559,187,93,94,1372,79,128,462,230,73,135,265
"2011","Elmbridge 010B","E01030314","Total",1531,190,103,87,1341,36,162,444,254,113,133,199
"2011","Elmbridge 010C","E01030366","Total",1765,296,92,204,1469,61,162,385,340,87,156,278
"2011","Elmbridge 010D","E01030367","Total",1606,127,64,63,1479,18,240,360,210,118,180,353
"2011","Elmbridge 011A","E01030338","Total",1670,125,70,55,1545,18,214,632,170,131,186,194
"2011","Elmbridge 011B","E01030339","Total",1371,274,110,164,1097,49,176,378,282,47,52,113
"2011","Elmbridge 011C","E01030340","Total",1470,199,108,91,1271,60,160,356,186,112,163,234
"2011","Elmbridge 011D","E01030341","Total",1794,198,98,100,1596,28,250,517,254,124,142,281
"2011","Elmbridge 012A","E01030371","Total",1481,291,87,204,1190,70,126,301,288,95,105,205
"2011","Elmbridge 012B","E01030372","Total",1272,200,106,94,1072,43,86,431,162,81,120,149
"2011","Elmbridge 012C","E01030373","Total",1546,193,73,120,1353,56,138,509,268,98,112,172
"2011","Elmbridge 012D","E01030374","Total",1600,312,131,181,1288,26,174,375,312,97,89,215
"2011","Elmbridge 012E","E01030375","Total",1698,296,94,202,1402,68,118,450,330,119,128,189
"2011","Elmbridge 012F","E01030376","Total",1270,147,62,85,1123,62,132,365,238,62,98,166
"2011","Elmbridge 013A","E01030307","Total",1690,147,61,86,1543,31,198,446,220,171,196,281
"2011","Elmbridge 013B","E01030308","Total",1607,166,89,77,1441,23,236,434,180,120,157,291
"2011","Elmbridge 013C","E01030309","Total",1520,161,95,66,1359,39,248,336,190,130,179,237
"2011","Elmbridge 013D","E01030310","Total",1881,179,54,125,1702,167,96,481,268,118,241,331
"2011","Elmbridge 014A","E01030311","Total",1544,226,127,99,1318,94,172,336,192,116,129,279
"2011","Elmbridge 014B","E01030312","Total",1324,120,41,79,1204,84,98,319,206,46,173,278
"2011","Elmbridge 014C","E01030315","Total",1618,159,70,89,1459,68,166,489,198,86,146,306
"2011","Elmbridge 014D","E01030316","Total",1597,154,74,80,1443,27,238,419,202,123,190,244
"2011","Elmbridge 014E","E01030317","Total",1668,262,123,139,1406,50,214,387,242,107,139,267
"2011","Elmbridge 014F","E01030318","Total",1427,264,230,34,1163,10,274,239,102,107,211,220
"2011","Elmbridge 015A","E01030296","Total",1755,115,71,44,1640,28,246,515,194,155,140,362
"2011","Elmbridge 015B","E01030297","Total",2122,173,106,67,1949,44,294,611,276,190,182,352
"2011","Elmbridge 015C","E01030298","Total",1581,238,180,58,1343,51,186,432,194,93,174,213
"2011","Elmbridge 015D","E01030299","Total",1636,152,74,78,1484,60,156,493,228,85,167,295
"2011","Elmbridge 016A","E01030346","Total",1412,102,27,75,1310,40,132,322,198,188,188,242
"2011","Elmbridge 016B","E01030347","Total",1664,205,50,155,1459,80,94,524,268,90,169,234
"2011","Elmbridge 016C","E01030348","Total",1605,177,78,99,1428,22,178,452,278,103,160,235
"2011","Elmbridge 016D","E01030349","Total",1610,209,87,122,1401,38,222,422,284,109,143,183
"2011","Elmbridge 017A","E01030300","Total",1600,287,150,137,1313,90,164,439,250,46,83,241
"2011","Elmbridge 017B","E01030301","Total",1553,148,76,72,1405,30,198,439,178,152,175,233
"2011","Elmbridge 017C","E01030302","Total",1500,270,145,125,1230,43,222,330,242,56,112,225
"2011","Elmbridge 017D","E01030304","Total",1628,217,85,132,1411,132,120,383,248,88,112,328
"2011","Elmbridge 017E","E01030305","Total",1542,68,39,29,1474,28,170,468,162,218,197,231
"2011","Elmbridge 017F","E01030306","Total",1400,70,37,33,1330,22,156,441,134,186,215,176
"2011","Elmbridge 018A","E01030303","Total",1797,138,75,63,1659,28,274,547,252,191,187,180
"2011","Elmbridge 018B","E01030342","Total",1647,131,84,47,1516,16,236,376,184,168,288,248
"2011","Elmbridge 018C","E01030343","Total",1692,135,68,67,1557,22,182,561,216,85,249,242
"2011","Elmbridge 018D","E01030344","Total",1530,72,45,27,1458,24,180,407,162,164,237,284
"2011","Elmbridge 018E","E01030345","Total",1664,142,78,64,1522,61,212,499,210,132,155,253
"2011","Epsom and Ewell 001A","E01030386","Total",1446,79,44,35,1367,15,216,307,192,77,148,412
"2011","Epsom and Ewell 001B","E01030387","Total",1673,142,57,85,1531,59,124,474,258,60,252,304
"2011","Epsom and Ewell 001C","E01030388","Total",1307,111,67,44,1196,31,190,295,184,41,141,314
"2011","Epsom and Ewell 001D","E01030389","Total",1507,235,126,109,1272,62,142,304,242,58,164,300
"2011","Epsom and Ewell 001E","E01030393","Total",1898,261,149,112,1637,25,326,323,222,69,203,469
"2011","Epsom and Ewell 002A","E01030394","Total",1763,101,60,41,1662,30,200,446,190,117,235,444
"2011","Epsom and Ewell 002B","E01030399","Total",2053,314,125,189,1739,98,192,504,316,85,209,335
"2011","Epsom and Ewell 002C","E01030400","Total",1656,122,37,85,1534,235,88,342,196,159,260,254
"2011","Epsom and Ewell 002D","E01030414","Total",1321,138,68,70,1183,58,104,309,174,81,198,259
"2011","Epsom and Ewell 003A","E01030377","Total",2381,177,113,64,2204,50,346,629,270,168,241,500
"2011","Epsom and Ewell 003B","E01030378","Total",1551,120,55,65,1431,57,230,372,230,57,149,336
"2011","Epsom and Ewell 003C","E01030406","Total",1600,133,67,66,1467,57,178,330,214,82,232,374
"2011","Epsom and Ewell 003D","E01030407","Total",1390,112,71,41,1278,18,218,311,156,73,150,352
"2011","Epsom and Ewell 003E","E01030408","Total",1819,93,66,27,1726,10,222,423,198,133,265,475
"2011","Epsom and Ewell 004A","E01030395","Total",1754,205,148,57,1549,19,370,284,256,104,178,338
"2011","Epsom and Ewell 004B","E01030413","Total",2063,124,57,67,1939,101,140,660,270,151,211,406
"2011","Epsom and Ewell 004C","E01030415","Total",1653,114,63,51,1539,50,126,482,210,94,186,391
"2011","Epsom and Ewell 004D","E01030416","Total",1321,123,71,52,1198,30,164,268,182,66,164,324
"2011","Epsom and Ewell 005A","E01030383","Total",2373,225,50,175,2148,137,94,526,374,182,331,504
"2011","Epsom and Ewell 005B","E01030384","Total",2670,198,44,154,2472,164,98,907,390,205,276,432
"2011","Epsom and Ewell 005C","E01030401","Total",2454,274,117,157,2180,72,270,649,390,148,232,419
"2011","Epsom and Ewell 005D","E01030402","Total",1286,104,33,71,1182,100,80,443,172,73,113,201
"2011","Epsom and Ewell 007A","E01030385","Total",1654,246,124,122,1408,104,118,259,192,118,258,359
"2011","Epsom and Ewell 007B","E01030391","Total",1819,302,134,168,1517,60,172,428,286,91,101,379
"2011","Epsom and Ewell 007C","E01030403","Total",1545,132,73,59,1413,54,188,428,168,98,180,297
"2011","Epsom and Ewell 007D","E01030404","Total",1576,137,85,52,1439,26,220,409,228,147,84,325
"2011","Epsom and Ewell 007E","E01030409","Total",1488,105,48,57,1383,51,126,283,132,73,196,522
"2011","Epsom and Ewell 007F","E01030410","Total",1416,186,44,142,1230,83,66,378,224,91,89,299
"2011","Epsom and Ewell 008A","E01030381","Total",1430,242,138,104,1188,35,170,271,220,116,157,219
"2011","Epsom and Ewell 008B","E01030411","Total",2062,507,199,308,1555,92,118,412,498,45,79,311
"2011","Epsom and Ewell 008C","E01030412","Total",1852,411,165,246,1441,102,166,383,456,55,58,221
"2011","Epsom and Ewell 008D","E01030419","Total",1604,240,126,114,1364,38,220,453,224,116,97,216
"2011","Epsom and Ewell 009A","E01030379","Total",1263,128,59,69,1135,34,124,351,174,63,145,244
"2011","Epsom and Ewell 009B","E01030380","Total",1374,87,64,23,1287,15,226,326,160,118,180,262
"2011","Epsom and Ewell 009C","E01030405","Total",1614,156,62,94,1458,64,174,454,264,108,157,237
"2011","Epsom and Ewell 009D","E01030417","Total",1327,114,67,47,1213,20,214,353,164,111,147,204
"2011","Epsom and Ewell 009E","E01030418","Total",1465,112,50,62,1353,28,184,439,210,46,150,296
"2011","Epsom and Ewell 009F","E01030420","Total",1195,147,100,47,1048,64,118,269,150,91,147,209
"2011","Epsom and Ewell 010A","E01030382","Total",1388,174,67,107,1214,19,188,311,224,86,149,237
"2011","Epsom and Ewell 010B","E01030390","Total",1755,286,129,157,1469,89,174,489,322,51,134,210
"2011","Epsom and Ewell 010C","E01030392","Total",1857,234,131,103,1623,49,260,382,288,95,178,371
"2011","Epsom and Ewell 010D","E01030396","Total",1792,102,64,38,1690,10,274,413,192,122,289,390
"2011","Epsom and Ewell 010E","E01030398","Total",1760,96,66,30,1664,5,240,377,178,121,279,464
"2011","Epsom and Ewell 010F","E01032624","Total",1851,81,63,18,1770,13,312,440,166,126,242,471
"2011","Guildford 001A","E01030440","Total",1599,119,64,55,1480,40,254,371,214,169,184,248
"2011","Guildford 001B","E01030458","Total",1248,139,62,77,1109,20,166,282,222,101,105,213
"2011","Guildford 001C","E01030459","Total",1103,156,77,79,947,45,148,256,158,71,92,177
"2011","Guildford 001D","E01030475","Total",1308,100,59,41,1208,25,206,301,168,87,156,265
"2011","Guildford 001E","E01030476","Total",1222,55,29,26,1167,10,196,349,182,71,134,225
"2011","Guildford 001F","E01030477","Total",1671,206,99,107,1465,76,222,379,248,126,155,259
"2011","Guildford 002A","E01030465","Total",1429,127,67,60,1302,46,200,320,270,99,105,262
"2011","Guildford 002B","E01030466","Total",1546,221,124,97,1325,31,378,286,256,106,66,202
"2011","Guildford 002C","E01030473","Total",1723,123,58,65,1600,43,162,519,278,128,160,310
"2011","Guildford 002D","E01030474","Total",1461,11,1,10,1450,40,8,695,232,166,184,125
"2011","Guildford 003A","E01030441","Total",1256,112,71,41,1144,45,218,288,180,82,101,230
"2011","Guildford 003B","E01030442","Total",1490,85,61,24,1405,17,290,365,162,110,183,278
"2011","Guildford 003C","E01030443","Total",1346,100,70,30,1246,39,238,372,204,95,134,164
"2011","Guildford 003D","E01030444","Total",1552,129,82,47,1423,41,224,433,180,165,136,244
"2011","Guildford 003E","E01030445","Total",1389,197,128,69,1192,36,192,307,204,105,139,209
"2011","Guildford 003F","E01030446","Total",1310,113,72,41,1197,24,202,286,162,108,186,229
"2011","Guildford 003G","E01030447","Total",1341,132,74,58,1209,51,198,316,174,91,124,255
"2011","Guildford 004A","E01030426","Total",1491,147,22,125,1344,90,86,440,352,105,113,158
"2011","Guildford 004B","E01030427","Total",1502,139,63,76,1363,60,156,407,280,63,110,287
"2011","Guildford 004C","E01030428","Total",1196,133,65,68,1063,39,186,257,214,73,148,146
"2011","Guildford 004D","E01030429","Total",1489,277,56,221,1212,91,118,377,304,75,88,159
"2011","Guildford 004E","E01030430","Total",1448,145,66,79,1303,34,290,293,248,56,89,293
"2011","Guildford 005A","E01030499","Total",1541,155,96,59,1386,32,310,320,206,82,140,296
"2011","Guildford 005B","E01030500","Total",1527,136,58,78,1391,32,214,352,204,87,123,379
"2011","Guildford 005C","E01030501","Total",1625,136,49,87,1489,57,148,457,302,97,147,281
"2011","Guildford 005D","E01030502","Total",1191,125,67,58,1066,39,164,199,210,45,139,270
"2011","Guildford 005E","E01030503","Total",1445,146,38,108,1299,98,90,418,234,72,149,238
"2011","Guildford 005F","E01030504","Total",1120,138,93,45,982,24,236,221,156,35,118,192
"2011","Guildford 006A","E01030485","Total",1729,215,49,166,1514,81,92,396,366,84,88,407
"2011","Guildford 006B","E01030487","Total",1630,168,67,101,1462,53,96,338,266,66,120,523
"2011","Guildford 006C","E01030488","Total",1982,194,92,102,1788,74,142,554,318,113,223,364
"2011","Guildford 006D","E01030489","Total",2457,205,60,145,2252,89,108,813,446,159,209,428
"2011","Guildford 007A","E01030481","Total",1744,130,65,65,1614,80,156,256,236,185,224,477
"2011","Guildford 007B","E01030482","Total",1398,104,41,63,1294,81,94,301,194,66,155,403
"2011","Guildford 007C","E01030483","Total",1376,198,89,109,1178,128,102,222,188,83,129,326
"2011","Guildford 007D","E01030484","Total",1661,180,64,116,1481,68,122,308,280,96,189,418
"2011","Guildford 008A","E01030434","Total",1650,264,42,222,1386,56,92,540,318,100,97,183
"2011","Guildford 008B","E01030435","Total",1772,117,76,41,1655,56,232,544,202,125,230,266
"2011","Guildford 008C","E01030462","Total",1654,268,153,115,1386,57,164,387,260,61,183,274
"2011","Guildford 008D","E01030463","Total",1487,175,60,115,1312,53,122,384,280,50,137,286
"2011","Guildford 008E","E01030464","Total",1676,190,82,108,1486,111,134,369,158,135,279,300
"2011","Guildford 009A","E01030486","Total",1644,110,47,63,1534,29,154,428,248,87,159,429
"2011","Guildford 009B","E01030493","Total",1291,141,73,68,1150,65,74,255,178,73,99,406
"2011","Guildford 009C","E01030495","Total",1748,139,72,67,1609,25,146,292,208,42,123,773
"2011","Guildford 009D","E01030498","Total",1394,92,44,48,1302,26,108,326,210,82,123,427
"2011","Guildford 010A","E01030424","Total",1518,205,106,99,1313,109,154,362,242,86,115,245
"2011","Guildford 010B","E01030431","Total",1457,163,96,67,1294,44,244,266,270,67,154,249
"2011","Guildford 010C","E01030432","Total",1514,169,65,104,1345,90,162,344,270,117,125,237
"2011","Guildford 010D","E01030433","Total",1638,197,63,134,1441,88,140,323,338,83,194,275
"2011","Guildford 011A","E01030436","Total",2244,333,139,194,1911,69,204,578,366,147,160,387
"2011","Guildford 011B","E01030437","Total",1726,152,71,81,1574,47,242,397,282,145,166,295
"2011","Guildford 011C","E01030439","Total",1712,118,68,50,1594,15,278,444,148,133,232,344
"2011","Guildford 011D","E01030460","Total",1570,162,91,71,1408,18,240,372,208,175,168,227
"2011","Guildford 011E","E01030461","Total",1619,158,86,72,1461,61,218,407,196,143,139,297
"2011","Guildford 012A","E01030470","Total",1428,111,49,62,1317,24,110,192,192,112,87,600
"2011","Guildford 012B","E01030494","Total",1630,183,80,103,1447,52,196,220,218,114,171,476
"2011","Guildford 012C","E01030496","Total",1619,156,68,88,1463,90,124,297,150,98,138,566
"2011","Guildford 012D","E01030497","Total",1615,134,42,92,1481,172,68,351,210,76,199,405
"2011","Guildford 013A","E01030438","Total",1590,257,117,140,1333,50,152,336,328,62,133,272
"2011","Guildford 013B","E01030450","Total",2346,281,54,227,2065,66,62,512,544,89,128,664
"2011","Guildford 013C","E01030451","Total",1834,313,54,259,1521,59,80,396,500,30,69,387
"2011","Guildford 013D","E01030453","Total",1471,355,75,280,1116,17,94,319,398,66,60,162
"2011","Guildford 013E","E01030455","Total",1533,389,109,280,1144,35,110,189,462,50,52,246
"2011","Guildford 013F","E01030457","Total",1578,336,58,278,1242,54,52,287,368,47,86,348
"2011","Guildford 014A","E01030421","Total",1461,139,59,80,1322,42,230,328,298,66,118,240
"2011","Guildford 014B","E01030422","Total",1449,215,81,134,1234,60,128,341,264,66,113,262
"2011","Guildford 014C","E01030423","Total",1643,198,77,121,1445,39,224,351,326,112,132,261
"2011","Guildford 014D","E01030425","Total",1580,167,63,104,1413,28,220,378,262,81,138,306
"2011","Guildford 015A","E01030452","Total",1903,278,48,230,1625,24,60,316,452,50,82,641
"2011","Guildford 015B","E01030467","Total",1632,145,83,62,1487,16,196,398,214,152,133,378
"2011","Guildford 015C","E01030468","Total",1235,171,106,65,1064,17,54,121,168,57,89,558
"2011","Guildford 015D","E01030469","Total",1417,88,52,36,1329,51,148,288,158,142,109,433
"2011","Guildford 016A","E01030448","Total",1489,128,54,74,1361,9,198,355,312,91,114,282
"2011","Guildford 016B","E01030449","Total",1221,322,139,183,899,21,138,214,316,47,49,114
"2011","Guildford 016C","E01030454","Total",1703,236,96,140,1467,68,138,467,288,109,147,250
"2011","Guildford 016D","E01030456","Total",1445,92,62,30,1353,17,218,303,206,175,158,276
"2011","Guildford 017A","E01030471","Total",1218,78,47,31,1140,11,216,289,224,92,132,176
"2011","Guildford 017B","E01030472","Total",1283,125,61,64,1158,33,150,384,192,101,93,205
"2011","Guildford 017C","E01030478","Total",1698,158,66,92,1540,33,242,388,262,119,172,324
"2011","Guildford 017D","E01030479","Total",1769,213,104,109,1556,82,180,496,338,91,165,204
"2011","Guildford 017E","E01030480","Total",1819,227,136,91,1592,23,304,503,270,164,111,217
"2011","Guildford 018A","E01030490","Total",1598,169,90,79,1429,30,240,375,252,85,182,265
"2011","Guildford 018B","E01030491","Total",1843,253,119,134,1590,55,238,413,270,130,183,301
"2011","Guildford 018C","E01030492","Total",2010,156,79,77,1854,21,326,474,334,149,175,375
"2011","Mole Valley 001A","E01030506","Total",1353,80,58,22,1273,20,148,394,154,101,145,311
"2011","Mole Valley 001B","E01030508","Total",1288,100,76,24,1188,19,282,208,170,89,221,199
"2011","Mole Valley 001C","E01030509","Total",1072,194,99,95,878,25,182,291,154,20,52,154
"2011","Mole Valley 001D","E01030513","Total",1409,99,56,43,1310,45,190,348,138,101,223,265
"2011","Mole Valley 001E","E01030514","Total",1478,209,138,71,1269,34,208,374,186,153,82,232
"2011","Mole Valley 002A","E01030505","Total",1520,168,80,88,1352,62,186,342,222,82,148,310
"2011","Mole Valley 002B","E01030507","Total",1232,127,75,52,1105,16,148,358,212,90,120,161
"2011","Mole Valley 002C","E01030511","Total",1449,100,60,40,1349,18,230,361,172,153,150,265
"2011","Mole Valley 002D","E01030512","Total",1540,205,136,69,1335,26,242,387,224,116,94,246
"2011","Mole Valley 003A","E01030548","Total",1818,185,31,154,1633,111,112,380,316,196,214,304
"2011","Mole Valley 003B","E01030549","Total",1829,283,70,213,1546,103,112,415,414,103,148,251
"2011","Mole Valley 003C","E01030550","Total",1731,501,184,317,1230,66,164,338,344,47,79,192
"2011","Mole Valley 003D","E01030551","Total",1598,219,82,137,1379,134,114,360,242,86,176,267
"2011","Mole Valley 004A","E01030510","Total",1583,134,94,40,1449,27,238,434,214,100,163,273
"2011","Mole Valley 004B","E01030552","Total",1291,332,155,177,959,37,102,268,264,37,86,165
"2011","Mole Valley 004C","E01030553","Total",1672,289,147,142,1383,29,282,336,262,91,144,239
"2011","Mole Valley 004D","E01030554","Total",1133,81,59,22,1052,8,240,239,144,83,135,203
"2011","Mole Valley 005A","E01030539","Total",1755,173,74,99,1582,61,196,440,242,114,180,349
"2011","Mole Valley 005B","E01030540","Total",2056,132,96,36,1924,10,514,364,242,102,225,467
"2011","Mole Valley 005C","E01030541","Total",1343,85,58,27,1258,14,250,289,162,70,168,305
"2011","Mole Valley 005D","E01030542","Total",1271,104,59,45,1167,43,154,380,134,67,126,263
"2011","Mole Valley 005E","E01030543","Total",1484,148,63,85,1336,44,184,429,228,104,131,216
"2011","Mole Valley 006A","E01030516","Total",1257,299,154,145,958,65,220,247,152,60,91,123
"2011","Mole Valley 006B","E01030517","Total",1549,154,78,76,1395,20,304,323,178,119,145,306
"2011","Mole Valley 006C","E01030518","Total",1346,105,89,16,1241,7,334,272,132,77,150,269
"2011","Mole Valley 006D","E01030519","Total",1589,148,100,48,1441,61,228,336,188,168,202,258
"2011","Mole Valley 007A","E01030520","Total",1461,227,150,77,1234,61,250,338,170,94,106,215
"2011","Mole Valley 007B","E01030521","Total",1623,190,104,86,1433,46,252,368,218,61,204,284
"2011","Mole Valley 007C","E01030522","Total",1295,106,69,37,1189,18,248,281,176,81,131,254
"2011","Mole Valley 007D","E01030523","Total",1193,175,108,67,1018,31,242,252,128,91,90,184
"2011","Mole Valley 008A","E01030524","Total",2001,387,187,200,1614,20,484,274,336,94,137,269
"2011","Mole Valley 008B","E01030525","Total",1524,173,107,66,1351,29,256,333,210,95,146,282
"2011","Mole Valley 008C","E01030526","Total",1344,137,89,48,1207,48,178,369,194,62,129,227
"2011","Mole Valley 008D","E01030527","Total",1529,178,90,88,1351,39,292,305,244,94,135,242
"2011","Mole Valley 009A","E01030532","Total",1499,192,66,126,1307,55,124,459,252,93,99,225
"2011","Mole Valley 009B","E01030533","Total",1388,117,67,50,1271,24,138,429,150,110,134,286
"2011","Mole Valley 009C","E01030534","Total",1258,341,181,160,917,60,136,219,248,41,53,160
"2011","Mole Valley 009D","E01030556","Total",1811,242,115,127,1569,26,260,357,364,117,173,272
"2011","Mole Valley 010A","E01030535","Total",1823,286,152,134,1537,39,172,471,272,148,106,329
"2011","Mole Valley 010B","E01030536","Total",1728,280,120,160,1448,55,212,370,294,88,183,246
"2011","Mole Valley 010C","E01030537","Total",1663,253,145,108,1410,25,236,349,276,93,166,265
"2011","Mole Valley 010D","E01030538","Total",1586,235,85,150,1351,53,122,360,280,98,155,283
"2011","Mole Valley 011A","E01030544","Total",1547,171,88,83,1376,39,196,309,276,134,142,280
"2011","Mole Valley 011B","E01030545","Total",1556,216,63,153,1340,71,134,437,338,48,124,188
"2011","Mole Valley 011C","E01030546","Total",1645,192,88,104,1453,88,158,372,250,108,201,276
"2011","Mole Valley 011D","E01030547","Total",1601,206,89,117,1395,186,180,300,194,90,137,308
"2011","Mole Valley 012A","E01030529","Total",1680,173,77,96,1507,76,184,380,290,103,184,290
"2011","Mole Valley 012B","E01030555","Total",1727,138,74,64,1589,81,224,331,306,134,201,312
"2011","Mole Valley 012C","E01030557","Total",1877,165,77,88,1712,54,258,424,320,146,199,311
"2011","Mole Valley 012D","E01030558","Total",2183,262,111,151,1921,55,324,600,298,143,216,285
"2011","Mole Valley 013A","E01030515","Total",1880,281,143,138,1599,53,296,384,334,107,120,305
"2011","Mole Valley 013B","E01030528","Total",1413,161,78,83,1252,26,226,305,216,72,180,227
"2011","Mole Valley 013C","E01030530","Total",1279,96,58,38,1183,28,226,271,166,94,164,234
"2011","Mole Valley 013D","E01030531","Total",2225,243,100,143,1982,61,254,439,374,75,303,476
"2011","Reigate and Banstead 001A","E01030603","Total",1462,94,56,38,1368,24,182,313,202,102,163,382
"2011","Reigate and Banstead 001B","E01030604","Total",1530,161,86,75,1369,44,230,331,224,80,168,292
"2011","Reigate and Banstead 001C","E01030605","Total",1464,95,48,47,1369,37,118,430,192,105,184,303
"2011","Reigate and Banstead 001D","E01030607","Total",1733,128,77,51,1605,22,254,369,250,61,272,377
"2011","Reigate and Banstead 002A","E01030559","Total",1198,129,80,49,1069,22,244,241,138,66,106,252
"2011","Reigate and Banstead 002B","E01030560","Total",1485,334,190,144,1151,73,222,269,258,58,62,209
"2011","Reigate and Banstead 002C","E01030561","Total",1301,192,142,50,1109,41,254,224,180,41,116,253
"2011","Reigate and Banstead 002D","E01030562","Total",1284,189,74,115,1095,70,130,281,202,51,131,230
"2011","Reigate and Banstead 002E","E01030563","Total",1159,52,32,20,1107,19,140,367,126,75,117,263
"2011","Reigate and Banstead 002F","E01030564","Total",1402,101,56,45,1301,41,164,364,152,145,138,297
"2011","Reigate and Banstead 003A","E01030606","Total",1314,104,67,37,1210,25,206,277,160,100,183,259
"2011","Reigate and Banstead 003B","E01030641","Total",1591,147,76,71,1444,31,204,352,224,108,227,298
"2011","Reigate and Banstead 003C","E01030642","Total",1599,170,100,70,1429,64,230,390,202,127,144,272
"2011","Reigate and Banstead 003D","E01030644","Total",1278,93,56,37,1185,0,258,281,164,26,160,296
"2011","Reigate and Banstead 004A","E01030565","Total",1373,150,82,68,1223,66,194,286,184,60,133,300
"2011","Reigate and Banstead 004B","E01030566","Total",1521,94,41,53,1427,22,148,528,198,75,185,271
"2011","Reigate and Banstead 004C","E01030567","Total",1540,123,64,59,1417,20,228,268,276,95,161,369
"2011","Reigate and Banstead 004D","E01030568","Total",1551,91,41,50,1460,16,214,398,192,77,198,365
"2011","Reigate and Banstead 004E","E01030569","Total",2696,241,55,186,2455,175,148,742,406,248,324,412
"2011","Reigate and Banstead 005A","E01030608","Total",1421,188,105,83,1233,129,102,327,174,131,144,226
"2011","Reigate and Banstead 005B","E01030609","Total",1529,147,71,76,1382,167,80,418,178,122,197,220
"2011","Reigate and Banstead 005C","E01030640","Total",1532,297,87,210,1235,102,144,315,222,105,102,245
"2011","Reigate and Banstead 005D","E01030643","Total",1348,236,126,110,1112,81,144,326,206,62,111,182
"2011","Reigate and Banstead 006A","E01030635","Total",1549,185,91,94,1364,31,202,407,224,141,151,208
"2011","Reigate and Banstead 006B","E01030636","Total",1199,81,40,41,1118,24,158,291,146,57,160,282
"2011","Reigate and Banstead 006C","E01030637","Total",1249,58,36,22,1191,11,180,258,200,118,145,279
"2011","Reigate and Banstead 006D","E01030638","Total",1540,128,79,49,1412,29,228,340,218,92,200,305
"2011","Reigate and Banstead 006E","E01030639","Total",1369,236,160,76,1133,19,248,248,214,37,139,228
"2011","Reigate and Banstead 007A","E01030589","Total",1725,93,48,45,1632,15,326,316,236,83,266,390
"2011","Reigate and Banstead 007B","E01030590","Total",1864,167,69,98,1697,57,254,435,282,131,185,353
"2011","Reigate and Banstead 007C","E01030591","Total",1320,141,70,71,1179,20,180,280,194,71,145,289
"2011","Reigate and Banstead 007D","E01030592","Total",1842,293,149,144,1549,43,262,291,318,102,192,341
"2011","Reigate and Banstead 008A","E01030599","Total",1552,276,93,183,1276,156,58,249,178,130,182,323
"2011","Reigate and Banstead 008B","E01030600","Total",1518,151,76,75,1367,80,122,378,240,106,155,286
"2011","Reigate and Banstead 008C","E01030601","Total",1592,152,77,75,1440,79,92,438,198,150,234,249
"2011","Reigate and Banstead 008D","E01030602","Total",1742,182,79,103,1560,56,150,464,316,122,150,302
"2011","Reigate and Banstead 009A","E01030598","Total",1545,174,96,78,1371,56,194,334,286,104,147,250
"2011","Reigate and Banstead 009B","E01030623","Total",2033,290,119,171,1743,29,280,604,364,144,151,171
"2011","Reigate and Banstead 009C","E01030624","Total",1270,145,61,84,1125,41,166,346,208,168,103,93
"2011","Reigate and Banstead 009D","E01030625","Total",1227,90,43,47,1137,21,164,362,178,85,131,196
"2011","Reigate and Banstead 009E","E01030626","Total",1010,133,59,74,877,14,182,215,144,66,67,189
"2011","Reigate and Banstead 009F","E01030627","Total",1631,380,152,228,1251,28,158,343,390,60,87,185
"2011","Reigate and Banstead 010A","E01030615","Total",1558,223,65,158,1335,130,66,386,206,84,144,319
"2011","Reigate and Banstead 010B","E01030616","Total",1593,201,109,92,1392,29,284,363,220,121,120,255
"2011","Reigate and Banstead 010C","E01030617","Total",1620,197,92,105,1423,42,214,337,304,90,169,267
"2011","Reigate and Banstead 010D","E01030618","Total",1877,238,88,150,1639,75,114,465,268,133,199,385
"2011","Reigate and Banstead 010E","E01030619","Total",1484,230,115,115,1254,100,140,299,152,140,156,267
"2011","Reigate and Banstead 010F","E01030622","Total",1811,242,53,189,1569,71,88,504,360,110,152,284
"2011","Reigate and Banstead 011A","E01030610","Total",1290,176,56,120,1114,80,120,317,180,102,143,172
"2011","Reigate and Banstead 011B","E01030611","Total",2584,296,67,229,2288,139,120,710,614,152,211,342
"2011","Reigate and Banstead 011C","E01030612","Total",2472,412,60,352,2060,74,108,642,772,84,172,208
"2011","Reigate and Banstead 011D","E01030613","Total",1866,300,34,266,1566,70,64,540,474,102,109,207
"2011","Reigate and Banstead 011E","E01030614","Total",1611,104,40,64,1507,32,166,486,258,61,154,350
"2011","Reigate and Banstead 012A","E01030593","Total",1388,170,52,118,1218,51,110,379,280,100,78,220
"2011","Reigate and Banstead 012B","E01030596","Total",1482,78,49,29,1404,12,136,489,208,185,165,209
"2011","Reigate and Banstead 012C","E01030597","Total",1592,127,65,62,1465,37,136,664,254,94,78,202
"2011","Reigate and Banstead 012D","E01030620","Total",1764,277,129,148,1487,38,174,448,346,130,150,201
"2011","Reigate and Banstead 012E","E01030621","Total",1534,219,108,111,1315,80,130,429,196,156,130,194
"2011","Reigate and Banstead 013A","E01030594","Total",1788,174,87,87,1614,78,206,554,230,103,189,254
"2011","Reigate and Banstead 013B","E01030595","Total",1498,173,84,89,1325,46,126,464,194,120,164,211
"2011","Reigate and Banstead 013C","E01030630","Total",1641,133,76,57,1508,85,220,440,170,104,189,300
"2011","Reigate and Banstead 013D","E01030631","Total",1500,190,93,97,1310,101,160,394,262,86,123,184
"2011","Reigate and Banstead 014A","E01030570","Total",1587,171,82,89,1416,59,148,317,262,102,169,359
"2011","Reigate and Banstead 014B","E01030571","Total",1584,111,53,58,1473,55,176,392,236,113,171,330
"2011","Reigate and Banstead 014C","E01030572","Total",2045,269,51,218,1776,132,112,577,402,133,143,277
"2011","Reigate and Banstead 014D","E01030573","Total",1753,205,103,102,1548,67,156,457,284,127,214,243
"2011","Reigate and Banstead 014E","E01030574","Total",1759,203,63,140,1556,53,90,467,340,132,198,276
"2011","Reigate and Banstead 015A","E01030628","Total",1394,134,78,56,1260,20,166,293,208,42,153,378
"2011","Reigate and Banstead 015B","E01030629","Total",1191,150,60,90,1041,33,160,259,226,97,77,189
"2011","Reigate and Banstead 015C","E01030632","Total",1351,123,62,61,1228,42,154,347,190,98,138,259
"2011","Reigate and Banstead 015D","E01030633","Total",1350,160,86,74,1190,62,162,252,198,87,144,285
"2011","Reigate and Banstead 015E","E01030634","Total",1451,151,75,76,1300,121,158,329,162,109,191,230
"2011","Reigate and Banstead 016A","E01030584","Total",1631,113,66,47,1518,52,214,349,278,122,176,327
"2011","Reigate and Banstead 016B","E01030585","Total",1593,113,51,62,1480,51,192,369,294,83,138,353
"2011","Reigate and Banstead 016C","E01030586","Total",1695,149,61,88,1546,64,168,418,240,112,241,303
"2011","Reigate and Banstead 016D","E01030587","Total",1464,165,94,71,1299,42,178,395,182,28,162,312
"2011","Reigate and Banstead 016E","E01030588","Total",1465,190,83,107,1275,121,142,283,188,102,123,316
"2011","Reigate and Banstead 017A","E01030580","Total",1924,171,40,131,1753,120,94,604,368,90,191,286
"2011","Reigate and Banstead 017B","E01030581","Total",1257,92,56,36,1165,24,176,283,196,58,91,337
"2011","Reigate and Banstead 017C","E01030582","Total",1264,132,35,97,1132,64,54,389,280,86,103,156
"2011","Reigate and Banstead 017D","E01030583","Total",1462,92,60,32,1370,19,202,323,242,60,202,322
"2011","Reigate and Banstead 018A","E01030575","Total",2074,373,140,233,1701,98,114,474,462,89,125,339
"2011","Reigate and Banstead 018B","E01030576","Total",1662,159,45,114,1503,55,138,398,284,90,160,378
"2011","Reigate and Banstead 018C","E01030577","Total",1636,251,105,146,1385,83,140,365,286,62,131,318
"2011","Reigate and Banstead 018D","E01030578","Total",1448,190,107,83,1258,60,162,234,222,68,146,366
"2011","Reigate and Banstead 018E","E01030579","Total",1265,225,136,89,1040,40,206,194,224,49,96,231
"2011","Runnymede 001A","E01030667","Total",1427,369,149,220,1058,60,102,252,288,20,55,281
"2011","Runnymede 001B","E01030668","Total",1820,340,138,202,1480,79,132,340,406,60,83,380
"2011","Runnymede 001C","E01030669","Total",1634,145,60,85,1489,46,124,317,198,74,136,594
"2011","Runnymede 001D","E01030670","Total",1503,81,39,42,1422,35,120,289,144,63,123,648
"2011","Runnymede 002A","E01030671","Total",1014,127,33,94,887,38,86,252,166,41,76,228
"2011","Runnymede 002B","E01030672","Total",2064,184,74,110,1880,28,216,525,274,120,198,519
"2011","Runnymede 002C","E01030673","Total",1014,122,64,58,892,31,128,233,150,24,103,223
"2011","Runnymede 002D","E01030674","Total",1408,281,171,110,1127,66,136,219,172,61,108,365
"2011","Runnymede 002E","E01030675","Total",1347,172,62,110,1175,40,80,198,198,75,113,471
"2011","Runnymede 002F","E01030676","Total",1361,152,92,60,1209,46,76,118,120,103,134,612
"2011","Runnymede 003A","E01030663","Total",1582,195,110,85,1387,127,126,327,182,92,200,333
"2011","Runnymede 003B","E01030664","Total",1644,254,119,135,1390,98,146,304,222,108,193,319
"2011","Runnymede 003C","E01030665","Total",1519,172,50,122,1347,78,70,386,286,90,171,266
"2011","Runnymede 003D","E01030666","Total",1716,220,61,159,1496,46,150,410,354,78,149,309
"2011","Runnymede 003E","E01030687","Total",1145,127,53,74,1018,19,128,228,216,36,132,259
"2011","Runnymede 003F","E01030688","Total",1474,161,74,87,1313,51,136,341,238,68,136,343
"2011","Runnymede 004A","E01030656","Total",1543,133,63,70,1410,76,142,277,220,99,217,379
"2011","Runnymede 004B","E01030658","Total",1300,350,144,206,950,39,276,168,256,26,59,126
"2011","Runnymede 004C","E01030685","Total",1314,114,48,66,1200,35,160,348,170,33,158,296
"2011","Runnymede 004D","E01030686","Total",1394,152,72,80,1242,14,226,293,208,40,133,328
"2011","Runnymede 005A","E01030689","Total",1384,157,73,84,1227,18,164,291,234,63,162,295
"2011","Runnymede 005B","E01030690","Total",1577,189,72,117,1388,33,162,402,314,69,176,232
"2011","Runnymede 005C","E01030691","Total",1583,110,67,43,1473,31,252,434,192,126,173,265
"2011","Runnymede 005D","E01030692","Total",1257,122,71,51,1135,30,170,235,158,151,151,240
"2011","Runnymede 006A","E01030652","Total",1659,222,88,134,1437,86,146,390,268,115,148,284
"2011","Runnymede 006B","E01030653","Total",1392,236,91,145,1156,85,94,259,276,69,151,222
"2011","Runnymede 006C","E01030654","Total",1424,164,44,120,1260,71,132,398,318,72,66,203
"2011","Runnymede 006D","E01030657","Total",1488,224,96,128,1264,118,112,241,222,120,159,292
"2011","Runnymede 006E","E01030659","Total",1595,271,129,142,1324,33,178,344,270,67,141,291
"2011","Runnymede 007A","E01030647","Total",1620,291,151,140,1329,59,262,306,238,102,122,240
"2011","Runnymede 007B","E01030648","Total",1558,156,64,92,1402,65,160,415,220,60,179,303
"2011","Runnymede 007C","E01030649","Total",1659,321,132,189,1338,109,174,404,282,56,73,240
"2011","Runnymede 007D","E01030650","Total",1271,142,52,90,1129,115,98,319,176,69,117,235
"2011","Runnymede 007E","E01030651","Total",1334,142,54,88,1192,47,148,338,258,71,137,193
"2011","Runnymede 007F","E01030655","Total",1557,208,65,143,1349,35,226,311,264,61,158,294
"2011","Runnymede 007G","E01030662","Total",1548,142,78,64,1406,66,204,383,194,89,193,277
"2011","Runnymede 008A","E01030677","Total",1565,192,71,121,1373,45,176,377,304,69,145,257
"2011","Runnymede 008B","E01030678","Total",1263,225,80,145,1038,59,94,305,236,76,92,176
"2011","Runnymede 008C","E01030679","Total",1203,84,46,38,1119,30,200,309,224,71,76,209
"2011","Runnymede 008D","E01030680","Total",1527,149,87,62,1378,52,248,351,232,84,156,255
"2011","Runnymede 009A","E01030645","Total",1926,404,196,208,1522,142,166,379,226,133,165,311
"2011","Runnymede 009B","E01030646","Total",2050,335,126,209,1715,83,184,462,362,89,181,354
"2011","Runnymede 009C","E01030660","Total",2066,177,74,103,1889,89,170,550,334,116,272,358
"2011","Runnymede 009D","E01030661","Total",1601,160,93,67,1441,39,304,330,238,54,150,326
"2011","Runnymede 009E","E01030684","Total",1474,216,54,162,1258,60,150,348,242,74,113,271
"2011","Runnymede 010A","E01030681","Total",1571,172,82,90,1399,65,172,317,254,100,134,357
"2011","Runnymede 010B","E01030682","Total",1330,119,55,64,1211,60,130,394,160,46,130,291
"2011","Runnymede 010C","E01030683","Total",1342,137,50,87,1205,33,140,328,240,74,132,258
"2011","Runnymede 010D","E01030693","Total",1201,122,77,45,1079,38,196,234,204,71,97,239
"2011","Runnymede 010E","E01030694","Total",1362,137,79,58,1225,63,114,300,188,57,202,301
"2011","Runnymede 010F","E01030695","Total",1266,94,64,30,1172,12,244,261,158,55,118,324
"2011","Runnymede 010G","E01030696","Total",1470,165,108,57,1305,62,236,325,192,81,145,264
"2011","Spelthorne 001A","E01030743","Total",1499,224,75,149,1275,64,178,201,214,71,200,347
"2011","Spelthorne 001B","E01030744","Total",1578,433,78,355,1145,126,112,247,260,70,126,204
"2011","Spelthorne 001C","E01030745","Total",1587,118,50,68,1469,115,128,339,160,108,206,413
"2011","Spelthorne 001D","E01030747","Total",1371,129,25,104,1242,56,110,295,274,71,183,253
"2011","Spelthorne 002A","E01030709","Total",1540,116,34,82,1424,100,114,385,198,121,214,292
"2011","Spelthorne 002B","E01030710","Total",1668,163,65,98,1505,112,126,402,196,86,240,343
"2011","Spelthorne 002C","E01030711","Total",1727,156,40,116,1571,99,142,346,200,162,289,333
"2011","Spelthorne 002D","E01030746","Total",1628,169,100,69,1459,163,146,279,184,72,261,354
"2011","Spelthorne 003A","E01030707","Total",1603,178,66,112,1425,76,162,341,276,65,178,327
"2011","Spelthorne 003B","E01030708","Total",1649,124,62,62,1525,47,142,377,252,93,281,333
"2011","Spelthorne 003C","E01030712","Total",1292,125,47,78,1167,25,160,230,288,62,112,290
"2011","Spelthorne 003D","E01030713","Total",1229,131,60,71,1098,35,104,299,164,60,108,328
"2011","Spelthorne 003E","E01030714","Total",1240,98,45,53,1142,37,134,322,174,59,145,271
"2011","Spelthorne 003F","E01030715","Total",1512,145,65,80,1367,51,162,311,224,56,177,386
"2011","Spelthorne 003G","E01030716","Total",1525,135,88,47,1390,24,214,313,180,80,199,380
"2011","Spelthorne 004A","E01030734","Total",1517,106,35,71,1411,58,102,378,228,78,178,389
"2011","Spelthorne 004B","E01030735","Total",1571,181,58,123,1390,78,158,351,302,86,110,305
"2011","Spelthorne 004C","E01030736","Total",1792,412,67,345,1380,50,108,446,458,17,109,192
"2011","Spelthorne 004D","E01030737","Total",1427,271,92,179,1156,53,122,319,272,25,144,221
"2011","Spelthorne 004E","E01030738","Total",1504,249,73,176,1255,78,94,412,292,37,103,239
"2011","Spelthorne 005A","E01030701","Total",1577,162,98,64,1415,71,200,360,154,107,181,342
"2011","Spelthorne 005B","E01030702","Total",1143,171,78,93,972,64,96,284,146,91,135,156
"2011","Spelthorne 005C","E01030703","Total",1579,158,86,72,1421,80,222,324,162,88,154,391
"2011","Spelthorne 005D","E01030704","Total",1460,218,130,88,1242,41,230,230,192,70,157,322
"2011","Spelthorne 005E","E01030705","Total",1618,155,65,90,1463,40,210,314,222,98,231,348
"2011","Spelthorne 005F","E01030706","Total",1394,126,62,64,1268,41,154,318,200,56,163,336
"2011","Spelthorne 006A","E01030697","Total",1562,173,80,93,1389,50,214,329,182,60,213,341
"2011","Spelthorne 006B","E01030698","Total",1676,154,87,67,1522,76,178,439,214,67,179,369
"2011","Spelthorne 006C","E01030699","Total",1509,177,105,72,1332,74,244,301,176,67,190,280
"2011","Spelthorne 006D","E01030700","Total",1721,274,92,182,1447,78,156,392,292,74,194,261
"2011","Spelthorne 006E","E01030725","Total",1755,256,57,199,1499,115,68,467,400,86,147,216
"2011","Spelthorne 007A","E01030729","Total",1537,138,66,72,1399,74,212,347,236,73,152,305
"2011","Spelthorne 007B","E01030739","Total",1649,222,142,80,1427,107,150,384,186,121,208,271
"2011","Spelthorne 007C","E01030740","Total",1770,270,151,119,1500,84,180,310,186,119,258,363
"2011","Spelthorne 007D","E01030741","Total",1758,142,51,91,1616,65,126,408,242,140,203,432
"2011","Spelthorne 008A","E01030748","Total",1753,160,75,85,1593,78,170,363,228,116,292,346
"2011","Spelthorne 008B","E01030749","Total",1556,161,100,61,1395,138,108,394,200,88,210,257
"2011","Spelthorne 008C","E01030750","Total",1590,148,56,92,1442,92,126,294,262,117,231,320
"2011","Spelthorne 008D","E01030751","Total",1537,194,69,125,1343,65,116,321,262,75,135,369
"2011","Spelthorne 008E","E01030752","Total",1551,177,54,123,1374,98,102,342,220,87,253,272
"2011","Spelthorne 009A","E01030726","Total",1701,107,71,36,1594,16,244,441,222,114,193,364
"2011","Spelthorne 009B","E01030727","Total",1818,303,141,162,1515,74,232,399,346,30,116,318
"2011","Spelthorne 009C","E01030728","Total",1662,186,112,74,1476,33,316,318,292,67,142,308
"2011","Spelthorne 009D","E01030742","Total",1914,238,129,109,1676,48,260,432,252,100,190,394
"2011","Spelthorne 010A","E01030753","Total",1681,237,135,102,1444,31,246,344,288,97,139,299
"2011","Spelthorne 010B","E01030754","Total",1512,160,113,47,1352,24,260,347,182,70,149,320
"2011","Spelthorne 010C","E01030755","Total",1935,215,97,118,1720,152,160,493,316,89,196,314
"2011","Spelthorne 010D","E01030756","Total",1662,147,72,75,1515,33,250,354,238,61,194,385
"2011","Spelthorne 011A","E01030717","Total",1599,264,117,147,1335,89,216,317,214,72,125,302
"2011","Spelthorne 011B","E01030718","Total",1353,112,66,46,1241,27,160,366,124,78,179,307
"2011","Spelthorne 011C","E01030719","Total",1545,170,90,80,1375,73,194,308,180,63,230,327
"2011","Spelthorne 011D","E01030720","Total",1502,183,110,73,1319,36,228,296,210,70,204,275
"2011","Spelthorne 012A","E01030721","Total",1476,159,74,85,1317,85,186,306,238,73,147,282
"2011","Spelthorne 012B","E01030722","Total",1587,157,75,82,1430,62,204,368,238,83,102,373
"2011","Spelthorne 012C","E01030723","Total",1566,130,73,57,1436,35,226,313,214,76,167,405
"2011","Spelthorne 012D","E01030724","Total",1510,201,93,108,1309,85,162,326,216,68,162,290
"2011","Spelthorne 013A","E01030730","Total",1756,231,147,84,1525,23,390,346,230,70,117,349
"2011","Spelthorne 013B","E01030731","Total",1871,186,87,99,1685,80,264,475,252,96,159,359
"2011","Spelthorne 013C","E01030732","Total",1455,236,125,111,1219,27,260,274,266,36,123,233
"2011","Spelthorne 013D","E01030733","Total",1578,341,175,166,1237,63,254,282,274,25,72,267
"2011","Surrey Heath 001A","E01030763","Total",1175,119,62,57,1056,17,218,235,240,46,76,224
"2011","Surrey Heath 001B","E01030764","Total",1218,125,67,58,1093,11,196,259,216,97,128,186
"2011","Surrey Heath 001C","E01030765","Total",1395,177,106,71,1218,54,198,326,198,95,123,224
"2011","Surrey Heath 001D","E01030809","Total",1433,196,99,97,1237,42,192,358,270,78,81,216
"2011","Surrey Heath 001E","E01030810","Total",1406,85,30,55,1321,29,228,411,228,116,131,178
"2011","Surrey Heath 001F","E01030811","Total",1490,122,70,52,1368,26,222,481,214,55,101,269
"2011","Surrey Heath 002A","E01030757","Total",1591,204,34,170,1387,48,82,475,324,73,122,263
"2011","Surrey Heath 002B","E01030758","Total",1109,92,40,52,1017,27,148,313,176,54,110,189
"2011","Surrey Heath 002C","E01030759","Total",1588,271,150,121,1317,73,190,342,252,84,143,233
"2011","Surrey Heath 002D","E01030760","Total",1220,117,51,66,1103,30,128,344,210,46,115,230
"2011","Surrey Heath 003A","E01030778","Total",1820,173,61,112,1647,36,276,453,280,95,196,311
"2011","Surrey Heath 003B","E01030779","Total",1765,191,123,68,1574,25,282,409,280,92,172,314
"2011","Surrey Heath 003C","E01030780","Total",1593,151,65,86,1442,22,168,441,326,57,189,239
"2011","Surrey Heath 003D","E01030781","Total",1578,156,71,85,1422,67,170,466,238,73,147,261
"2011","Surrey Heath 004A","E01030786","Total",1791,251,114,137,1540,132,126,470,248,107,169,288
"2011","Surrey Heath 004B","E01030787","Total",1444,105,57,48,1339,70,168,286,150,103,250,312
"2011","Surrey Heath 004C","E01030788","Total",1401,86,47,39,1315,134,124,263,140,149,247,258
"2011","Surrey Heath 004D","E01030801","Total",1607,142,33,109,1465,58,96,458,332,88,150,283
"2011","Surrey Heath 004E","E01030802","Total",1659,158,70,88,1501,33,242,338,280,119,154,335
"2011","Surrey Heath 005A","E01030796","Total",1398,95,55,40,1303,19,230,359,160,63,194,278
"2011","Surrey Heath 005B","E01030797","Total",1424,92,37,55,1332,35,128,420,196,82,165,306
"2011","Surrey Heath 005C","E01030798","Total",1510,72,52,20,1438,16,264,342,170,148,202,296
"2011","Surrey Heath 005D","E01030799","Total",1376,71,30,41,1305,9,208,335,182,71,220,280
"2011","Surrey Heath 005E","E01030800","Total",1574,223,110,113,1351,57,190,352,272,57,161,262
"2011","Surrey Heath 006A","E01030761","Total",1545,111,67,44,1434,45,206,378,188,78,220,319
"2011","Surrey Heath 006B","E01030762","Total",1879,171,53,118,1708,54,146,534,294,81,196,403
"2011","Surrey Heath 006C","E01030806","Total",1574,77,45,32,1497,22,134,460,214,139,233,295
"2011","Surrey Heath 006D","E01030807","Total",1375,95,47,48,1280,12,162,390,170,134,129,283
"2011","Surrey Heath 006E","E01030808","Total",1575,156,72,84,1419,46,170,442,252,115,143,251
"2011","Surrey Heath 007A","E01030774","Total",1359,123,37,86,1236,44,102,410,202,111,157,210
"2011","Surrey Heath 007B","E01030775","Total",1450,101,59,42,1349,11,218,319,236,117,197,251
"2011","Surrey Heath 007C","E01030776","Total",1613,116,55,61,1497,37,202,402,222,105,175,354
"2011","Surrey Heath 007D","E01030777","Total",1604,141,66,75,1463,73,132,501,302,82,135,238
"2011","Surrey Heath 008A","E01030793","Total",1527,176,56,120,1351,129,86,303,210,113,230,280
"2011","Surrey Heath 008B","E01030794","Total",1542,174,56,118,1368,57,116,337,240,106,206,306
"2011","Surrey Heath 008C","E01030795","Total",2024,369,161,208,1655,29,256,396,390,107,170,307
"2011","Surrey Heath 008D","E01030803","Total",1705,147,55,92,1558,59,138,319,312,73,276,381
"2011","Surrey Heath 008E","E01030804","Total",1720,125,76,49,1595,26,254,355,272,121,202,365
"2011","Surrey Heath 008F","E01030805","Total",1625,135,76,59,1490,95,160,299,214,77,308,337
"2011","Surrey Heath 009A","E01030789","Total",1460,97,47,50,1363,8,260,266,214,84,203,328
"2011","Surrey Heath 009B","E01030790","Total",1703,157,90,67,1546,50,184,415,232,160,164,341
"2011","Surrey Heath 009C","E01030791","Total",1660,117,68,49,1543,24,282,354,234,77,199,373
"2011","Surrey Heath 009D","E01030792","Total",1336,69,31,38,1267,15,224,297,176,83,160,312
"2011","Surrey Heath 010A","E01030766","Total",1579,207,84,123,1372,35,148,336,264,47,224,318
"2011","Surrey Heath 010B","E01030767","Total",1622,142,61,81,1480,101,156,398,178,114,262,271
"2011","Surrey Heath 010C","E01030768","Total",1342,104,50,54,1238,36,210,301,164,95,178,254
"2011","Surrey Heath 010D","E01030769","Total",1531,87,41,46,1444,35,214,318,220,67,260,330
"2011","Surrey Heath 011A","E01030770","Total",1495,157,69,88,1338,25,164,402,244,72,131,300
"2011","Surrey Heath 011B","E01030771","Total",1270,87,35,52,1183,21,126,302,232,52,177,273
"2011","Surrey Heath 011C","E01030772","Total",1515,178,94,84,1337,57,154,333,228,88,179,298
"2011","Surrey Heath 011D","E01030773","Total",1437,101,51,50,1336,26,136,402,228,79,153,312
"2011","Surrey Heath 012A","E01030782","Total",1575,181,115,66,1394,18,226,306,234,92,178,340
"2011","Surrey Heath 012B","E01030783","Total",1614,143,64,79,1471,27,186,351,254,101,194,358
"2011","Surrey Heath 012C","E01030784","Total",2190,152,22,130,2038,80,70,761,396,186,282,263
"2011","Surrey Heath 012D","E01030785","Total",1429,197,111,86,1232,29,204,305,246,39,124,285
"2011","Tandridge 002A","E01030855","Total",1825,165,83,82,1660,17,350,285,296,68,196,448
"2011","Tandridge 002B","E01030856","Total",1486,168,92,76,1318,28,216,363,184,60,191,276
"2011","Tandridge 002C","E01030859","Total",1879,297,68,229,1582,64,142,470,364,69,152,321
"2011","Tandridge 002D","E01030860","Total",2019,338,75,263,1681,131,118,570,424,76,181,181
"2011","Tandridge 003A","E01030844","Total",1805,133,47,86,1672,102,160,483,274,127,205,321
"2011","Tandridge 003B","E01030845","Total",1272,137,59,78,1135,54,84,395,164,82,121,235
"2011","Tandridge 003C","E01030846","Total",1459,105,65,40,1354,32,228,275,190,110,218,301
"2011","Tandridge 003D","E01030857","Total",2156,236,61,175,1920,142,134,639,356,132,258,259
"2011","Tandridge 003E","E01030858","Total",2101,248,80,168,1853,122,174,571,350,147,169,320
"2011","Tandridge 004A","E01030828","Total",1215,114,55,59,1101,22,158,286,200,67,129,239
"2011","Tandridge 004B","E01030829","Total",1379,255,111,144,1124,71,156,265,286,68,70,208
"2011","Tandridge 004C","E01030830","Total",1327,118,62,56,1209,37,112,381,198,110,109,262
"2011","Tandridge 004D","E01030850","Total",2149,415,205,210,1734,102,136,541,424,168,111,252
"2011","Tandridge 004E","E01030851","Total",2044,199,54,145,1845,114,170,532,306,144,185,394
"2011","Tandridge 004F","E01030861","Total",1864,139,72,67,1725,33,310,373,330,133,222,324
"2011","Tandridge 005A","E01030820","Total",1675,115,76,39,1560,22,314,331,210,108,210,365
"2011","Tandridge 005B","E01030847","Total",1516,274,175,99,1242,26,234,230,192,98,189,273
"2011","Tandridge 005C","E01030848","Total",2128,240,117,123,1888,95,172,584,268,143,223,403
"2011","Tandridge 006A","E01030831","Total",2202,185,114,71,2017,32,344,448,368,155,256,414
"2011","Tandridge 006B","E01030832","Total",1302,157,93,64,1145,23,214,289,182,78,162,197
"2011","Tandridge 006C","E01030836","Total",1594,280,202,78,1314,87,206,358,180,98,159,226
"2011","Tandridge 006D","E01030837","Total",1435,114,69,45,1321,61,168,401,190,115,169,217
"2011","Tandridge 006E","E01030838","Total",1258,109,52,57,1149,31,170,328,210,64,118,228
"2011","Tandridge 006F","E01030839","Total",1435,113,76,37,1322,14,218,341,192,134,181,242
"2011","Tandridge 007A","E01030840","Total",1473,130,79,51,1343,86,174,373,182,87,166,275
"2011","Tandridge 007B","E01030841","Total",1264,97,62,35,1167,22,224,302,140,103,110,266
"2011","Tandridge 007C","E01030842","Total",1801,156,77,79,1645,69,172,450,250,174,192,338
"2011","Tandridge 007D","E01030843","Total",1468,162,58,104,1306,72,172,332,230,112,109,279
"2011","Tandridge 008A","E01030812","Total",1510,181,69,112,1329,75,164,356,232,92,158,252
"2011","Tandridge 008B","E01030813","Total",1507,194,76,118,1313,42,158,368,278,83,118,266
"2011","Tandridge 008C","E01030814","Total",1209,108,66,42,1101,40,154,237,178,97,188,207
"2011","Tandridge 008D","E01030815","Total",1438,164,74,90,1274,46,172,362,262,75,148,209
"2011","Tandridge 009A","E01030824","Total",1456,186,100,86,1270,116,142,341,202,120,106,243
"2011","Tandridge 009B","E01030825","Total",1369,185,101,84,1184,21,228,318,176,107,131,203
"2011","Tandridge 009C","E01030826","Total",1461,115,59,56,1346,85,178,365,222,64,239,193
"2011","Tandridge 009D","E01030827","Total",1546,124,55,69,1422,59,214,333,260,84,186,286
"2011","Tandridge 010A","E01030821","Total",1896,187,104,83,1709,21,280,376,298,135,238,361
"2011","Tandridge 010B","E01030822","Total",1753,124,65,59,1629,30,230,423,296,110,222,318
"2011","Tandridge 010C","E01030833","Total",1271,235,149,86,1036,43,192,283,188,62,98,170
"2011","Tandridge 010D","E01030834","Total",1393,146,65,81,1247,66,174,307,210,74,152,264
"2011","Tandridge 010E","E01030835","Total",1478,150,65,85,1328,19,164,389,218,151,168,219
"2011","Tandridge 011A","E01030816","Total",1561,147,56,91,1414,47,206,293,222,93,246,307
"2011","Tandridge 011B","E01030817","Total",1405,140,76,64,1265,2,210,329,242,99,121,262
"2011","Tandridge 011C","E01030818","Total",1250,157,76,81,1093,32,178,262,154,71,167,229
"2011","Tandridge 011D","E01030819","Total",1420,168,69,99,1252,29,220,255,258,71,143,276
"2011","Tandridge 011E","E01030823","Total",2075,168,105,63,1907,27,358,442,338,129,228,385
"2011","Tandridge 012A","E01030852","Total",1914,239,140,99,1675,109,218,395,270,71,212,400
"2011","Tandridge 012B","E01030853","Total",1690,212,139,73,1478,59,184,328,244,95,222,346
"2011","Tandridge 012C","E01030854","Total",1920,216,139,77,1704,56,330,453,216,63,163,423
"2011","Tandridge 012D","E01032571","Total",1863,164,89,75,1699,58,282,362,264,122,223,388
"2011","Waverley 001A","E01030890","Total",1556,187,93,94,1369,80,174,376,250,96,195,198
"2011","Waverley 001B","E01030902","Total",1319,107,60,47,1212,45,224,324,210,81,115,213
"2011","Waverley 001C","E01030903","Total",1582,188,76,112,1394,61,150,456,286,60,115,266
"2011","Waverley 001D","E01030904","Total",1394,203,120,83,1191,43,272,250,226,82,100,218
"2011","Waverley 002A","E01030891","Total",1575,136,68,68,1439,38,256,386,236,93,162,268
"2011","Waverley 002B","E01030892","Total",1307,113,45,68,1194,53,162,378,208,78,111,204
"2011","Waverley 002C","E01030899","Total",1606,166,81,85,1440,34,220,375,278,92,161,280
"2011","Waverley 002D","E01030900","Total",1222,113,74,39,1109,20,188,264,222,77,112,226
"2011","Waverley 002E","E01030901","Total",1416,104,23,81,1312,164,70,265,180,148,176,309
"2011","Waverley 003A","E01030884","Total",1473,258,86,172,1215,76,190,305,292,53,75,224
"2011","Waverley 003B","E01030885","Total",1112,410,254,156,702,23,136,119,220,27,29,148
"2011","Waverley 003C","E01030886","Total",1251,101,56,45,1150,19,170,323,178,91,112,257
"2011","Waverley 003D","E01030893","Total",1859,211,69,142,1648,40,158,479,392,139,163,277
"2011","Waverley 003E","E01030895","Total",1466,229,101,128,1237,47,100,316,260,90,101,323
"2011","Waverley 004A","E01030881","Total",1409,103,70,33,1306,31,268,380,154,143,113,217
"2011","Waverley 004B","E01030883","Total",1336,128,82,46,1208,29,196,286,174,158,185,180
"2011","Waverley 004C","E01030888","Total",1509,188,75,113,1321,26,162,459,240,175,97,162
"2011","Waverley 004D","E01030894","Total",1565,112,73,39,1453,15,256,356,238,128,207,253
"2011","Waverley 005A","E01030911","Total",1539,144,83,61,1395,26,230,387,192,84,143,333
"2011","Waverley 005B","E01030912","Total",1305,144,78,66,1161,59,194,230,194,42,139,303
"2011","Waverley 005C","E01030913","Total",1243,130,62,68,1113,110,114,299,176,53,159,202
"2011","Waverley 005D","E01030920","Total",1445,190,66,124,1255,76,134,344,278,35,119,269
"2011","Waverley 005E","E01030921","Total",1678,381,223,158,1297,75,124,367,302,117,91,221
"2011","Waverley 006A","E01030882","Total",1360,103,68,35,1257,26,192,421,174,117,120,207
"2011","Waverley 006B","E01030887","Total",1353,132,91,41,1221,34,174,384,156,134,105,234
"2011","Waverley 006C","E01030889","Total",1464,211,112,99,1253,58,180,345,196,123,122,229
"2011","Waverley 006D","E01030896","Total",1162,167,53,114,995,86,86,291,220,35,102,175
"2011","Waverley 006E","E01030897","Total",1340,111,44,67,1229,38,166,351,204,104,151,215
"2011","Waverley 007A","E01030916","Total",1663,293,102,191,1370,60,122,451,410,61,67,199
"2011","Waverley 007B","E01030917","Total",1090,185,35,150,905,26,94,278,278,41,59,129
"2011","Waverley 007C","E01030918","Total",1067,199,90,109,868,28,146,254,264,38,44,94
"2011","Waverley 007D","E01030919","Total",1261,103,46,57,1158,18,208,367,232,82,59,192
"2011","Waverley 007E","E01030922","Total",1416,170,58,112,1246,49,150,370,310,62,89,216
"2011","Waverley 008A","E01030863","Total",1870,178,108,70,1692,30,314,422,246,268,134,278
"2011","Waverley 008B","E01030865","Total",1378,216,128,88,1162,52,216,293,196,76,127,202
"2011","Waverley 008C","E01030866","Total",1558,157,96,61,1401,17,222,406,226,158,146,226
"2011","Waverley 008D","E01030940","Total",1755,208,113,95,1547,40,274,400,216,184,135,298
"2011","Waverley 009A","E01030898","Total",1614,133,73,60,1481,38,244,428,182,148,181,260
"2011","Waverley 009B","E01030905","Total",1496,159,57,102,1337,65,128,322,264,111,155,292
"2011","Waverley 009C","E01030906","Total",1707,195,85,110,1512,73,226,463,232,133,155,230
"2011","Waverley 009D","E01030907","Total",1177,98,73,25,1079,22,234,230,172,170,99,152
"2011","Waverley 010A","E01030914","Total",1270,150,65,85,1120,95,116,343,218,51,107,190
"2011","Waverley 010B","E01030915","Total",1626,154,71,83,1472,71,162,442,272,136,129,260
"2011","Waverley 010C","E01030923","Total",1460,114,62,52,1346,25,170,380,232,180,127,232
"2011","Waverley 010D","E01030924","Total",1237,117,45,72,1120,45,154,327,210,88,97,199
"2011","Waverley 010E","E01030925","Total",1553,98,56,42,1455,13,152,564,238,93,142,253
"2011","Waverley 011A","E01030877","Total",1155,166,100,66,989,17,226,223,168,66,133,156
"2011","Waverley 011B","E01030878","Total",1569,148,88,60,1421,37,308,335,188,112,180,261
"2011","Waverley 011C","E01030937","Total",1645,157,72,85,1488,51,196,425,256,182,152,226
"2011","Waverley 011D","E01030938","Total",1324,241,152,89,1083,46,164,284,210,67,103,209
"2011","Waverley 011E","E01030939","Total",1187,110,56,54,1077,50,144,313,170,79,116,205
"2011","Waverley 012A","E01030864","Total",1392,111,64,47,1281,26,196,369,240,120,146,184
"2011","Waverley 012B","E01030879","Total",1124,107,59,48,1017,21,176,244,198,141,69,168
"2011","Waverley 012C","E01030941","Total",1273,94,48,46,1179,25,156,316,214,131,151,186
"2011","Waverley 012D","E01030942","Total",1389,130,62,68,1259,22,186,367,220,135,130,199
"2011","Waverley 012E","E01030943","Total",1310,124,59,65,1186,72,142,342,170,161,111,188
"2011","Waverley 013A","E01030870","Total",1603,130,96,34,1473,40,324,320,204,114,143,328
"2011","Waverley 013B","E01030871","Total",1639,151,72,79,1488,45,198,451,240,76,179,299
"2011","Waverley 013C","E01030872","Total",1757,313,172,141,1444,112,248,388,218,88,161,229
"2011","Waverley 013D","E01030873","Total",1431,177,103,74,1254,68,194,271,204,123,115,279
"2011","Waverley 013E","E01030874","Total",1239,129,65,64,1110,8,202,246,190,91,113,260
"2011","Waverley 013F","E01030875","Total",1259,234,81,153,1025,48,164,228,206,91,92,196
"2011","Waverley 013G","E01030876","Total",1235,127,83,44,1108,13,330,191,176,81,110,207
"2011","Waverley 015A","E01030862","Total",1793,334,242,92,1459,45,338,320,246,78,143,289
"2011","Waverley 015B","E01030867","Total",1367,154,84,70,1213,47,234,300,256,73,127,176
"2011","Waverley 015C","E01030868","Total",1324,86,53,33,1238,25,196,360,138,118,159,242
"2011","Waverley 015D","E01030869","Total",1174,125,63,62,1049,32,156,285,178,99,133,166
"2011","Waverley 015E","E01030880","Total",1898,222,128,94,1676,36,334,434,322,175,145,230
"2011","Waverley 016A","E01030930","Total",1596,156,107,49,1440,20,238,451,244,160,117,210
"2011","Waverley 016B","E01030931","Total",1682,245,153,92,1437,39,256,425,284,129,95,209
"2011","Waverley 016C","E01030932","Total",1493,144,82,62,1349,67,148,376,220,135,124,279
"2011","Waverley 016D","E01030933","Total",1750,252,156,96,1498,45,272,423,260,169,94,235
"2011","Waverley 017A","E01030926","Total",1437,188,97,91,1249,13,178,407,198,118,120,215
"2011","Waverley 017B","E01030927","Total",1297,151,54,97,1146,26,118,304,194,135,107,262
"2011","Waverley 017C","E01030928","Total",1674,337,135,202,1337,79,114,436,372,36,138,162
"2011","Waverley 017D","E01030929","Total",1226,119,48,71,1107,15,154,376,188,67,118,189
"2011","Waverley 018A","E01030908","Total",1570,128,69,59,1442,21,206,363,188,162,178,324
"2011","Waverley 018B","E01030909","Total",1202,118,63,55,1084,27,180,223,226,122,113,193
"2011","Waverley 018C","E01030910","Total",1187,132,81,51,1055,18,216,274,158,77,147,165
"2011","Waverley 018D","E01030934","Total",1330,168,86,82,1162,18,232,313,198,97,175,129
"2011","Waverley 018E","E01030935","Total",1292,108,53,55,1184,25,138,351,222,81,158,209
"2011","Waverley 018F","E01032626","Total",1352,185,83,102,1167,22,216,295,270,67,72,225
"2011","Woking 001A","E01030946","Total",1337,211,113,98,1126,116,116,323,236,64,91,180
"2011","Woking 001B","E01030947","Total",1471,98,61,37,1373,73,142,349,168,120,215,306
"2011","Woking 001C","E01030948","Total",1575,139,72,67,1436,69,158,410,260,99,119,321
"2011","Woking 001D","E01030949","Total",1681,193,74,119,1488,89,146,460,280,117,121,275
"2011","Woking 001E","E01030950","Total",1598,223,135,88,1375,78,182,376,286,55,159,239
"2011","Woking 002A","E01030996","Total",1557,86,58,28,1471,11,270,420,166,121,146,337
"2011","Woking 002B","E01030998","Total",1876,111,80,31,1765,19,412,467,190,166,156,355
"2011","Woking 002C","E01031002","Total",1715,139,88,51,1576,33,228,421,296,111,195,292
"2011","Woking 002D","E01031003","Total",1791,104,66,38,1687,13,238,572,202,169,181,312
"2011","Woking 002E","E01031004","Total",2080,375,171,204,1705,117,160,562,434,65,107,260
"2011","Woking 003A","E01030963","Total",1472,76,55,21,1396,12,240,313,158,107,204,362
"2011","Woking 003B","E01030964","Total",1759,181,51,130,1578,31,238,398,354,99,121,337
"2011","Woking 003C","E01030965","Total",1448,91,41,50,1357,38,212,314,230,108,150,305
"2011","Woking 003D","E01030966","Total",1463,74,43,31,1389,37,148,469,148,157,164,266
"2011","Woking 003E","E01030967","Total",1587,149,93,56,1438,26,218,420,210,154,126,284
"2011","Woking 003F","E01030968","Total",1280,163,76,87,1117,63,96,261,208,108,133,248
"2011","Woking 004A","E01030980","Total",1706,134,25,109,1572,37,44,227,236,164,454,410
"2011","Woking 004B","E01030981","Total",1647,93,42,51,1554,19,100,147,90,204,655,339
"2011","Woking 004C","E01030982","Total",1836,114,30,84,1722,56,66,332,216,165,370,517
"2011","Woking 004D","E01030983","Total",1771,221,52,169,1550,54,36,356,302,84,351,367
"2011","Woking 004E","E01030984","Total",2038,151,84,67,1887,102,114,326,216,302,426,401
"2011","Woking 004F","E01030985","Total",1565,236,73,163,1329,106,78,316,156,125,268,280
"2011","Woking 005A","E01030951","Total",1320,244,76,168,1076,49,74,244,264,108,131,206
"2011","Woking 005B","E01030952","Total",1561,198,70,128,1363,194,86,379,88,227,190,199
"2011","Woking 005C","E01030953","Total",1472,215,89,126,1257,23,136,326,288,48,169,267
"2011","Woking 005D","E01030956","Total",1327,126,33,93,1201,46,48,295,232,78,169,333
"2011","Woking 005E","E01030957","Total",1319,105,28,77,1214,117,58,363,194,136,116,230
"2011","Woking 005F","E01030958","Total",1459,171,48,123,1288,58,86,339,298,67,140,300
"2011","Woking 005G","E01030959","Total",1026,173,90,83,853,25,100,252,178,21,104,173
"2011","Woking 006A","E01030988","Total",1904,250,55,195,1654,32,172,439,406,100,140,365
"2011","Woking 006B","E01030989","Total",1652,118,57,61,1534,38,138,410,252,122,227,347
"2011","Woking 006C","E01030990","Total",1486,142,79,63,1344,14,230,339,182,129,213,237
"2011","Woking 006D","E01030997","Total",1524,230,124,106,1294,35,296,317,206,94,123,223
"2011","Woking 007A","E01030974","Total",1556,186,45,141,1370,39,100,364,260,108,200,299
"2011","Woking 007B","E01030975","Total",1415,131,72,59,1284,24,144,381,192,82,153,308
"2011","Woking 007C","E01030976","Total",1538,162,71,91,1376,47,158,418,268,80,141,264
"2011","Woking 007D","E01030977","Total",1749,169,84,85,1580,46,182,434,282,117,211,308
"2011","Woking 007E","E01030979","Total",2154,178,29,149,1976,168,76,702,400,184,189,257
"2011","Woking 008A","E01030954","Total",2218,327,81,246,1891,60,110,517,500,82,205,417
"2011","Woking 008B","E01030969","Total",1451,112,54,58,1339,10,148,457,176,116,147,285
"2011","Woking 008C","E01030970","Total",1474,199,90,109,1275,24,130,419,246,112,141,203
"2011","Woking 008D","E01030991","Total",1904,494,242,252,1410,59,144,425,464,30,103,185
"2011","Woking 008E","E01030993","Total",2398,489,128,361,1909,108,104,654,680,46,83,234
"2011","Woking 009A","E01030960","Total",1721,222,76,146,1499,82,90,452,350,63,139,323
"2011","Woking 009B","E01030961","Total",1927,118,80,38,1809,53,294,424,226,128,266,418
"2011","Woking 009C","E01030962","Total",1682,279,121,158,1403,94,130,333,284,67,138,357
"2011","Woking 009D","E01031000","Total",1517,185,83,102,1332,35,188,355,288,93,124,249
"2011","Woking 010A","E01030955","Total",1394,154,62,92,1240,31,142,323,272,48,165,259
"2011","Woking 010B","E01030992","Total",1661,195,70,125,1466,35,168,383,312,112,155,301
"2011","Woking 010C","E01030999","Total",1372,70,49,21,1302,14,188,316,186,142,155,301
"2011","Woking 010D","E01031001","Total",1664,235,107,128,1429,24,190,384,332,76,129,294
"2011","Woking 011A","E01030971","Total",1930,179,90,89,1751,84,180,415,240,180,238,414
"2011","Woking 011B","E01030972","Total",1803,167,88,79,1636,77,172,363,274,82,258,410
"2011","Woking 011C","E01030973","Total",1767,178,80,98,1589,67,184,392,244,114,265,323
"2011","Woking 011D","E01030994","Total",1805,159,76,83,1646,58,120,550,264,189,181,284
"2011","Woking 011E","E01030995","Total",1386,147,52,95,1239,50,68,419,248,94,163,197
"2011","Woking 012A","E01030944","Total",1378,81,30,51,1297,30,136,416,188,106,190,231
"2011","Woking 012B","E01030945","Total",1168,96,59,37,1072,54,128,307,196,88,102,197
"2011","Woking 012C","E01030978","Total",1477,79,39,40,1398,48,124,437,170,122,195,302
"2011","Woking 012D","E01030986","Total",1074,97,65,32,977,13,232,219,156,56,118,183
"2011","Woking 012E","E01030987","Total",1396,77,46,31,1319,30,214,306,218,114,164,273
"2011","Adur 001A","E01031349","Total",1340,149,95,54,1191,33,210,227,160,65,176,320
"2011","Adur 001B","E01031350","Total",1201,154,59,95,1047,56,100,249,150,69,170,253
"2011","Adur 001C","E01031351","Total",1557,158,117,41,1399,46,294,337,184,87,126,325
"2011","Adur 001D","E01031352","Total",1455,163,101,62,1292,75,272,293,208,61,131,252
"2011","Adur 001E","E01031370","Total",1451,131,85,46,1320,82,172,342,192,88,160,284
"2011","Adur 001F","E01031374","Total",1493,193,104,89,1300,67,216,307,218,85,149,258
"2011","Adur 002A","E01031338","Total",1165,116,64,52,1049,27,206,275,184,46,93,218
"2011","Adur 002B","E01031339","Total",1175,157,60,97,1018,38,142,318,206,46,89,179
"2011","Adur 002C","E01031340","Total",1473,145,108,37,1328,23,274,271,274,46,173,267
"2011","Adur 002D","E01031365","Total",1473,196,107,89,1277,43,220,365,206,76,148,219
"2011","Adur 002E","E01031367","Total",1282,122,80,42,1160,20,248,295,232,20,123,222
"2011","Adur 003A","E01031345","Total",1472,179,104,75,1293,38,222,299,288,48,108,290
"2011","Adur 003B","E01031353","Total",1097,113,68,45,984,10,220,237,180,73,84,180
"2011","Adur 003C","E01031354","Total",1231,142,77,65,1089,57,200,236,250,37,99,210
"2011","Adur 003D","E01031355","Total",1635,198,102,96,1437,82,222,383,232,112,144,262
"2011","Adur 003E","E01031359","Total",1381,108,59,49,1273,56,134,332,214,75,201,261
"2011","Adur 004A","E01031347","Total",1624,190,98,92,1434,133,138,314,192,63,239,355
"2011","Adur 004B","E01031348","Total",1643,188,68,120,1455,183,118,367,220,156,168,243
"2011","Adur 004C","E01031366","Total",1311,129,46,83,1182,64,98,235,162,105,252,266
"2011","Adur 004D","E01031371","Total",1260,258,135,123,1002,134,142,251,166,56,85,168
"2011","Adur 004E","E01031372","Total",1270,160,92,68,1110,105,188,232,144,81,133,227
"2011","Adur 004F","E01031373","Total",1441,205,97,108,1236,72,158,334,222,87,151,212
"2011","Adur 004G","E01031375","Total",1439,272,156,116,1167,55,204,323,234,35,111,205
"2011","Adur 005A","E01031356","Total",2283,298,113,185,1985,108,306,566,472,92,99,342
"2011","Adur 005B","E01031357","Total",2237,375,143,232,1862,130,202,549,414,102,156,309
"2011","Adur 005C","E01031364","Total",1454,356,114,242,1098,128,154,251,358,20,38,149
"2011","Adur 005D","E01031368","Total",1225,169,89,80,1056,49,210,253,186,46,77,235
"2011","Adur 005E","E01031369","Total",1265,289,183,106,976,41,184,301,184,30,77,159
"2011","Adur 006A","E01031344","Total",1345,204,72,132,1141,65,204,212,220,101,101,238
"2011","Adur 006B","E01031346","Total",1367,216,105,111,1151,36,256,261,214,48,114,222
"2011","Adur 006C","E01031361","Total",1515,189,96,93,1326,118,182,294,198,89,196,249
"2011","Adur 006D","E01031362","Total",1240,109,41,68,1131,63,146,288,228,68,92,246
"2011","Adur 006E","E01031363","Total",1571,237,155,82,1334,58,352,241,234,42,141,266
"2011","Adur 007A","E01031358","Total",1522,211,146,65,1311,93,194,287,184,81,202,270
"2011","Adur 007B","E01031360","Total",1534,177,90,87,1357,96,212,293,210,78,157,311
"2011","Adur 007C","E01031376","Total",1237,235,134,101,1002,45,314,154,180,16,77,216
"2011","Adur 007D","E01031378","Total",1361,236,124,112,1125,61,236,229,254,56,74,215
"2011","Adur 008A","E01031341","Total",1351,249,135,114,1102,123,138,234,200,79,118,210
"2011","Adur 008B","E01031342","Total",1614,317,203,114,1297,93,364,248,282,41,70,199
"2011","Adur 008C","E01031343","Total",1395,198,111,87,1197,52,236,246,166,76,160,261
"2011","Adur 008D","E01031377","Total",1492,388,142,246,1104,98,172,277,310,35,57,155
"2011","Adur 008E","E01031379","Total",1547,274,183,91,1273,32,296,292,254,40,112,247
"2011","Arun 001A","E01031390","Total",1348,167,101,66,1181,53,276,231,184,87,109,241
"2011","Arun 001B","E01031391","Total",1475,280,115,165,1195,65,218,306,302,62,85,157
"2011","Arun 001C","E01031392","Total",1418,296,167,129,1122,40,282,196,264,56,33,251
"2011","Arun 001D","E01031465","Total",1367,154,83,71,1213,29,264,285,180,77,165,213
"2011","Arun 002A","E01031386","Total",1464,147,80,67,1317,51,212,273,226,106,205,244
"2011","Arun 002B","E01031387","Total",1521,236,132,104,1285,68,262,300,220,102,110,223
"2011","Arun 002C","E01031425","Total",1363,159,101,58,1204,43,310,262,226,31,120,212
"2011","Arun 002D","E01031426","Total",1180,162,93,69,1018,48,210,192,200,46,64,258
"2011","Arun 003A","E01031393","Total",1703,199,130,69,1504,46,338,295,292,56,167,310
"2011","Arun 003B","E01031394","Total",1652,184,85,99,1468,89,142,397,266,71,173,330
"2011","Arun 003C","E01031395","Total",1525,153,83,70,1372,52,256,364,248,77,130,245
"2011","Arun 003D","E01031396","Total",1904,218,107,111,1686,61,256,434,290,130,205,310
"2011","Arun 003E","E01031397","Total",1656,163,98,65,1493,40,262,308,268,63,229,323
"2011","Arun 003F","E01031466","Total",1409,146,90,56,1263,33,294,290,200,79,149,218
"2011","Arun 004A","E01031427","Total",1363,237,128,109,1126,118,148,273,160,78,160,189
"2011","Arun 004B","E01031429","Total",1451,151,55,96,1300,215,82,225,190,159,206,223
"2011","Arun 004C","E01031430","Total",1431,157,68,89,1274,104,210,291,202,92,129,246
"2011","Arun 004D","E01031467","Total",1698,216,102,114,1482,108,234,350,290,87,163,250
"2011","Arun 004E","E01031468","Total",2297,233,69,164,2064,129,196,535,414,162,262,366
"2011","Arun 005A","E01031388","Total",2644,248,118,130,2396,140,366,685,394,159,304,348
"2011","Arun 005B","E01031389","Total",2147,205,139,66,1942,65,510,476,304,109,211,267
"2011","Arun 005C","E01031414","Total",1508,171,121,50,1337,47,262,315,198,97,173,245
"2011","Arun 005D","E01031415","Total",1496,332,268,64,1164,54,360,206,194,45,101,204
"2011","Arun 005E","E01031459","Total",1731,310,162,148,1421,114,224,367,230,37,188,261
"2011","Arun 006A","E01031470","Total",1483,154,66,88,1329,102,230,349,268,65,152,163
"2011","Arun 006B","E01031471","Total",1285,118,54,64,1167,43,130,290,264,73,125,242
"2011","Arun 006C","E01031472","Total",1499,197,113,84,1302,61,256,237,246,92,172,238
"2011","Arun 006D","E01031473","Total",1195,154,69,85,1041,65,118,246,158,84,127,243
"2011","Arun 007A","E01031407","Total",1572,120,51,69,1452,114,154,443,232,93,146,270
"2011","Arun 007B","E01031408","Total",1935,209,72,137,1726,133,196,514,362,126,137,258
"2011","Arun 007C","E01031410","Total",1266,207,102,105,1059,59,156,242,266,57,90,189
"2011","Arun 007D","E01031462","Total",1470,189,103,86,1281,97,196,363,206,74,116,229
"2011","Arun 007E","E01031463","Total",1567,157,98,59,1410,78,290,354,180,75,160,273
"2011","Arun 007F","E01031464","Total",1584,352,249,103,1232,91,366,253,162,57,111,192
"2011","Arun 008A","E01031412","Total",1390,175,122,53,1215,10,406,239,192,53,105,210
"2011","Arun 008B","E01031422","Total",1461,279,201,78,1182,14,510,138,204,30,102,184
"2011","Arun 008C","E01031423","Total",1624,258,162,96,1366,29,444,260,214,42,143,234
"2011","Arun 008D","E01031424","Total",1323,240,183,57,1083,26,454,159,206,34,56,148
"2011","Arun 009A","E01031398","Total",1451,157,82,75,1294,55,228,256,202,58,197,298
"2011","Arun 009B","E01031399","Total",1668,190,135,55,1478,55,476,258,228,58,130,273
"2011","Arun 009C","E01031409","Total",1398,111,63,48,1287,86,134,254,144,114,249,306
"2011","Arun 009D","E01031455","Total",1373,249,174,75,1124,72,198,202,190,46,164,252
"2011","Arun 009E","E01031461","Total",1760,277,184,93,1483,54,448,242,272,65,129,273
"2011","Arun 009F","E01031469","Total",1677,233,136,97,1444,97,324,334,218,47,95,329
"2011","Arun 010A","E01031411","Total",1330,223,174,49,1107,21,462,148,184,25,76,191
"2011","Arun 010B","E01031413","Total",1218,266,179,87,952,42,276,182,200,40,61,151
"2011","Arun 010C","E01031457","Total",1581,385,268,117,1196,30,482,161,208,64,69,182
"2011","Arun 010D","E01031458","Total",1769,295,231,64,1474,13,632,178,304,31,99,217
"2011","Arun 010E","E01031460","Total",1661,447,321,126,1214,45,502,144,248,31,39,205
"2011","Arun 011A","E01031400","Total",1531,426,137,289,1105,62,196,247,278,63,95,164
"2011","Arun 011B","E01031428","Total",1541,208,79,129,1333,98,126,309,248,92,152,308
"2011","Arun 011C","E01031454","Total",2036,441,116,325,1595,159,154,344,352,76,214,296
"2011","Arun 011D","E01031456","Total",1670,568,236,332,1102,104,136,242,292,33,171,124
"2011","Arun 012A","E01031401","Total",1533,190,106,84,1343,89,230,316,252,52,126,278
"2011","Arun 012B","E01031402","Total",1617,190,100,90,1427,58,296,302,298,55,157,261
"2011","Arun 012C","E01031403","Total",1413,216,110,106,1197,71,192,256,218,79,172,209
"2011","Arun 012D","E01031405","Total",1377,195,116,79,1182,57,210,308,250,49,76,232
"2011","Arun 012E","E01031406","Total",1333,108,60,48,1225,58,104,335,162,82,214,270
"2011","Arun 013A","E01031417","Total",1603,196,116,80,1407,115,226,373,224,99,136,234
"2011","Arun 013B","E01031438","Total",1607,270,142,128,1337,100,200,389,226,80,116,226
"2011","Arun 013C","E01031439","Total",1914,329,228,101,1585,59,506,272,252,31,166,299
"2011","Arun 013D","E01031440","Total",1533,271,179,92,1262,33,396,170,284,40,106,233
"2011","Arun 014A","E01031404","Total",1198,170,67,103,1028,117,52,223,150,100,210,176
"2011","Arun 014B","E01031433","Total",1440,169,90,79,1271,86,248,241,176,62,150,308
"2011","Arun 014C","E01031434","Total",1534,252,89,163,1282,109,142,269,306,43,118,295
"2011","Arun 014D","E01031441","Total",1628,270,149,121,1358,102,194,316,240,83,172,251
"2011","Arun 014E","E01031442","Total",1562,163,66,97,1399,68,126,349,226,115,184,331
"2011","Arun 015A","E01031416","Total",1573,124,85,39,1449,11,350,229,222,81,204,352
"2011","Arun 015B","E01031418","Total",1683,234,165,69,1449,36,372,275,236,64,169,297
"2011","Arun 015C","E01031419","Total",1588,325,193,132,1263,83,270,232,224,37,182,235
"2011","Arun 015D","E01031420","Total",1611,228,154,74,1383,22,374,249,228,94,133,283
"2011","Arun 015E","E01031421","Total",1699,201,128,73,1498,67,346,348,204,118,163,252
"2011","Arun 016A","E01031443","Total",1348,117,49,68,1231,87,116,242,184,103,263,236
"2011","Arun 016B","E01031444","Total",1577,220,66,154,1357,97,96,329,202,89,175,369
"2011","Arun 016C","E01031450","Total",1246,163,48,115,1083,126,82,284,166,83,98,244
"2011","Arun 016D","E01031451","Total",1443,185,103,82,1258,104,164,335,214,68,149,224
"2011","Arun 016E","E01031452","Total",1403,123,65,58,1280,44,144,283,174,120,201,314
"2011","Arun 017A","E01031431","Total",804,281,177,104,523,27,112,67,158,16,45,98
"2011","Arun 017B","E01031432","Total",1796,446,145,301,1350,90,180,250,314,26,105,385
"2011","Arun 017C","E01031435","Total",1487,275,98,177,1212,54,196,217,296,57,116,276
"2011","Arun 017D","E01031436","Total",1770,536,194,342,1234,119,138,293,338,12,114,220
"2011","Arun 017E","E01031437","Total",1745,531,143,388,1214,93,174,269,342,26,113,197
"2011","Arun 017F","E01031453","Total",1500,329,174,155,1171,69,170,172,192,47,180,341
"2011","Arun 018A","E01031380","Total",1541,227,164,63,1314,35,482,194,220,30,101,252
"2011","Arun 018B","E01031381","Total",1549,267,207,60,1282,50,396,210,258,45,114,209
"2011","Arun 018C","E01031382","Total",1688,217,159,58,1471,32,508,259,266,45,100,261
"2011","Arun 018D","E01031383","Total",1543,197,160,37,1346,26,528,157,260,56,89,230
"2011","Arun 018E","E01031384","Total",1710,197,150,47,1513,36,446,314,248,46,97,326
"2011","Arun 019A","E01031385","Total",1561,273,177,96,1288,84,370,265,218,72,103,176
"2011","Arun 019B","E01031445","Total",1529,272,199,73,1257,48,534,183,152,41,80,219
"2011","Arun 019C","E01031446","Total",1330,181,121,60,1149,39,348,273,198,30,83,178
"2011","Arun 019D","E01031447","Total",1528,224,163,61,1304,49,436,192,226,65,117,219
"2011","Arun 019E","E01031448","Total",1534,260,157,103,1274,41,370,169,296,77,86,235
"2011","Arun 019F","E01031449","Total",1597,189,113,76,1408,94,206,350,210,64,190,294
"2011","Chichester 001A","E01031502","Total",1576,111,56,55,1465,44,188,535,218,160,73,247
"2011","Chichester 001B","E01031503","Total",1453,130,70,60,1323,75,148,381,212,128,139,240
"2011","Chichester 001C","E01031504","Total",2081,291,153,138,1790,97,354,499,334,139,110,257
"2011","Chichester 001D","E01031519","Total",1370,116,48,68,1254,25,190,350,216,124,138,211
"2011","Chichester 002A","E01031517","Total",1827,155,89,66,1672,37,302,396,288,199,158,292
"2011","Chichester 002B","E01031518","Total",1551,117,71,46,1434,40,290,353,232,126,151,242
"2011","Chichester 002C","E01031544","Total",1279,117,49,68,1162,50,204,293,198,67,173,177
"2011","Chichester 002D","E01031545","Total",1198,145,94,51,1053,20,210,233,190,77,79,244
"2011","Chichester 003A","E01031508","Total",2008,240,134,106,1768,38,376,393,326,115,194,326
"2011","Chichester 003B","E01031520","Total",1275,147,84,63,1128,40,228,243,206,65,130,216
"2011","Chichester 003C","E01031521","Total",1120,88,48,40,1032,26,184,231,208,104,81,198
"2011","Chichester 003D","E01031536","Total",1146,166,79,87,980,8,200,251,202,96,97,126
"2011","Chichester 004A","E01031497","Total",1320,158,85,73,1162,48,214,275,196,86,133,210
"2011","Chichester 004C","E01031511","Total",1460,296,195,101,1164,60,324,232,236,40,73,199
"2011","Chichester 004D","E01031512","Total",1874,328,186,142,1546,85,242,329,320,95,166,309
"2011","Chichester 004F","E01032717","Total",2491,473,263,210,2018,102,460,490,398,105,111,352
"2011","Chichester 005A","E01031478","Total",1036,133,66,67,903,12,214,219,162,68,47,181
"2011","Chichester 005B","E01031479","Total",992,118,59,59,874,28,182,152,196,70,55,191
"2011","Chichester 005C","E01031498","Total",1132,161,90,71,971,19,192,240,112,72,168,168
"2011","Chichester 005D","E01031514","Total",1596,270,164,106,1326,55,318,297,238,106,86,226
"2011","Chichester 005E","E01031515","Total",1593,220,106,114,1373,98,226,333,214,130,108,264
"2011","Chichester 005F","E01031516","Total",1450,169,85,84,1281,47,294,288,310,63,102,177
"2011","Chichester 006A","E01031477","Total",2166,335,170,165,1831,105,414,378,342,136,165,291
"2011","Chichester 006B","E01031485","Total",1511,197,155,42,1314,12,398,278,182,63,128,253
"2011","Chichester 006C","E01031487","Total",1528,198,134,64,1330,47,378,233,168,46,147,311
"2011","Chichester 006D","E01031509","Total",2294,275,118,157,2019,92,348,464,412,103,193,407
"2011","Chichester 007A","E01031506","Total",1268,123,69,54,1145,35,248,224,202,104,136,196
"2011","Chichester 007B","E01031507","Total",1379,138,64,74,1241,36,252,267,256,89,130,211
"2011","Chichester 007C","E01031531","Total",1298,115,75,40,1183,21,250,277,160,77,134,264
"2011","Chichester 007D","E01031533","Total",1150,164,108,56,986,47,168,235,150,34,122,230
"2011","Chichester 007E","E01031543","Total",2309,287,125,162,2022,127,346,492,410,154,193,300
"2011","Chichester 008A","E01031482","Total",1497,256,89,167,1241,126,76,228,274,68,91,378
"2011","Chichester 008B","E01031483","Total",2349,350,92,258,1999,167,138,429,380,128,264,493
"2011","Chichester 008C","E01031486","Total",1469,423,228,195,1046,41,280,147,294,33,25,226
"2011","Chichester 008D","E01031488","Total",1853,247,66,181,1606,86,142,385,266,98,143,486
"2011","Chichester 008E","E01031494","Total",1591,263,168,95,1328,140,210,288,194,58,87,351
"2011","Chichester 008F","E01031495","Total",1577,296,191,105,1281,52,236,234,260,64,105,330
"2011","Chichester 009A","E01031475","Total",1234,120,63,57,1114,19,222,323,156,63,77,254
"2011","Chichester 009B","E01031476","Total",1471,227,146,81,1244,13,358,301,208,67,102,195
"2011","Chichester 009C","E01031532","Total",1241,93,45,48,1148,13,94,555,176,149,98,63
"2011","Chichester 009D","E01031534","Total",1704,343,160,183,1361,101,332,251,296,60,127,194
"2011","Chichester 009E","E01031535","Total",1553,193,113,80,1360,58,266,269,276,109,159,223
"2011","Chichester 010A","E01031480","Total",1337,206,40,166,1131,76,108,282,290,80,68,227
"2011","Chichester 010B","E01031481","Total",1494,297,128,169,1197,84,186,262,284,69,69,243
"2011","Chichester 010C","E01031484","Total",1780,402,183,219,1378,90,232,251,322,33,114,336
"2011","Chichester 010D","E01031490","Total",1630,535,340,195,1095,30,252,179,298,37,67,232
"2011","Chichester 010E","E01031491","Total",1824,398,150,248,1426,58,248,352,356,85,90,237
"2011","Chichester 011A","E01031474","Total",1420,196,106,90,1224,66,196,294,246,67,131,224
"2011","Chichester 011B","E01031493","Total",1646,274,163,111,1372,61,334,254,248,79,109,287
"2011","Chichester 011C","E01031496","Total",2193,244,137,107,1949,97,334,467,374,97,197,383
"2011","Chichester 011D","E01031505","Total",2260,287,161,126,1973,70,360,456,356,106,235,390
"2011","Chichester 012A","E01031489","Total",1490,206,89,117,1284,54,184,300,220,59,165,302
"2011","Chichester 012B","E01031492","Total",1464,228,134,94,1236,98,108,197,162,107,199,365
"2011","Chichester 012C","E01031513","Total",2160,228,115,113,1932,78,368,433,320,144,177,412
"2011","Chichester 012D","E01031530","Total",1245,163,85,78,1082,64,148,206,206,98,154,206
"2011","Chichester 012E","E01031538","Total",1553,143,57,86,1410,98,170,310,274,124,193,241
"2011","Chichester 012F","E01031539","Total",1072,167,43,124,905,73,76,273,228,72,48,135
"2011","Chichester 013A","E01031499","Total",1800,247,119,128,1553,114,260,336,306,107,154,276
"2011","Chichester 013B","E01031500","Total",1760,208,123,85,1552,49,362,266,262,61,225,327
"2011","Chichester 013C","E01031501","Total",1377,293,188,105,1084,43,266,187,182,59,135,212
"2011","Chichester 013D","E01031529","Total",1156,108,56,52,1048,16,214,191,188,85,117,237
"2011","Chichester 013E","E01031540","Total",1337,228,159,69,1109,29,392,170,190,73,69,186
"2011","Chichester 013F","E01031541","Total",1336,279,200,79,1057,38,352,164,154,50,57,242
"2011","Chichester 013G","E01031542","Total",1772,204,138,66,1568,35,440,295,256,101,161,280
"2011","Chichester 014A","E01031522","Total",1955,367,233,134,1588,99,266,336,314,153,173,247
"2011","Chichester 014B","E01031523","Total",1535,221,141,80,1314,63,318,250,206,67,152,258
"2011","Chichester 014C","E01031524","Total",1431,253,185,68,1178,21,426,183,200,32,102,214
"2011","Chichester 014D","E01031525","Total",1345,201,132,69,1144,51,256,176,220,63,95,283
"2011","Chichester 014E","E01031526","Total",1276,129,93,36,1147,37,282,187,192,110,101,238
"2011","Chichester 014F","E01031527","Total",1514,186,124,62,1328,67,398,184,208,78,133,260
"2011","Chichester 014G","E01031528","Total",1405,258,137,121,1147,76,266,216,202,49,131,207
"2011","Crawley 001A","E01031573","Total",1623,198,91,107,1425,83,132,311,194,144,246,315
"2011","Crawley 001B","E01031574","Total",1868,132,64,68,1736,90,130,395,212,168,342,399
"2011","Crawley 001C","E01031575","Total",1640,198,40,158,1442,90,98,270,228,144,210,402
"2011","Crawley 001D","E01031576","Total",1629,141,78,63,1488,117,132,253,104,177,314,391
"2011","Crawley 001E","E01031577","Total",1359,84,50,34,1275,64,94,133,100,123,334,427
"2011","Crawley 002A","E01031586","Total",1787,220,70,150,1567,125,78,564,258,87,194,261
"2011","Crawley 002B","E01031587","Total",1669,116,50,66,1553,57,200,338,310,78,124,446
"2011","Crawley 002C","E01031588","Total",1498,172,89,83,1326,40,184,318,180,65,225,314
"2011","Crawley 002D","E01031590","Total",1593,166,59,107,1427,26,138,387,286,73,170,347
"2011","Crawley 002E","E01031593","Total",1399,171,47,124,1228,29,132,308,268,71,138,282
"2011","Crawley 003A","E01031570","Total",1325,110,55,55,1215,92,146,245,168,73,187,304
"2011","Crawley 003B","E01031571","Total",1645,203,111,92,1442,121,170,353,204,104,181,309
"2011","Crawley 003C","E01031572","Total",1424,223,105,118,1201,81,182,289,206,75,109,259
"2011","Crawley 003D","E01031609","Total",1571,255,122,133,1316,110,106,229,230,150,178,313
"2011","Crawley 003E","E01031610","Total",1801,277,136,141,1524,125,188,396,250,78,170,317
"2011","Crawley 004A","E01031583","Total",1978,353,71,282,1625,122,94,419,450,65,157,318
"2011","Crawley 004B","E01031584","Total",1663,173,87,86,1490,95,168,266,232,110,233,386
"2011","Crawley 004C","E01031585","Total",1648,224,112,112,1424,40,154,192,220,110,263,445
"2011","Crawley 004D","E01031601","Total",1244,125,64,61,1119,45,160,212,152,95,194,261
"2011","Crawley 004F","E01032835","Total",1473,307,36,271,1166,112,48,418,396,24,60,108
"2011","Crawley 004G","E01032836","Total",1604,191,103,88,1413,61,154,303,194,101,220,380
"2011","Crawley 005A","E01031589","Total",1767,202,109,93,1565,29,202,385,226,108,256,359
"2011","Crawley 005B","E01031591","Total",1814,212,69,143,1602,161,154,323,346,92,226,300
"2011","Crawley 005C","E01031594","Total",1415,155,73,82,1260,116,148,345,178,84,166,223
"2011","Crawley 005D","E01031600","Total",1384,221,107,114,1163,81,134,291,216,51,130,260
"2011","Crawley 005E","E01031603","Total",1484,156,61,95,1328,91,118,269,254,74,184,338
"2011","Crawley 006A","E01031564","Total",1471,157,77,80,1314,56,198,326,220,62,149,303
"2011","Crawley 006B","E01031565","Total",2168,234,136,98,1934,174,212,395,228,138,325,462
"2011","Crawley 006C","E01031566","Total",1606,177,68,109,1429,88,220,273,212,66,187,383
"2011","Crawley 006D","E01031567","Total",1299,120,51,69,1179,65,174,210,180,61,184,305
"2011","Crawley 006E","E01031568","Total",1391,213,41,172,1178,117,74,323,328,68,124,144
"2011","Crawley 007A","E01031596","Total",1875,251,101,150,1624,197,172,395,224,124,157,355
"2011","Crawley 007B","E01031597","Total",1470,150,85,65,1320,35,200,225,208,87,197,368
"2011","Crawley 007C","E01031598","Total",1588,330,113,217,1258,102,102,297,294,66,147,250
"2011","Crawley 007D","E01031599","Total",1735,263,106,157,1472,85,130,400,300,84,150,323
"2011","Crawley 007E","E01031608","Total",1712,251,63,188,1461,99,106,319,282,88,177,390
"2011","Crawley 008A","E01031578","Total",1790,206,40,166,1584,66,72,633,340,87,152,234
"2011","Crawley 008B","E01031580","Total",2348,133,27,106,2215,193,78,866,410,159,249,260
"2011","Crawley 008C","E01031581","Total",1785,85,12,73,1700,56,78,746,258,127,215,220
"2011","Crawley 008D","E01031592","Total",2009,147,46,101,1862,44,208,529,410,151,146,374
"2011","Crawley 009A","E01031560","Total",1472,186,99,87,1286,42,214,249,194,53,191,343
"2011","Crawley 009B","E01031561","Total",1427,152,84,68,1275,42,222,266,208,56,121,360
"2011","Crawley 009C","E01031562","Total",1287,247,133,114,1040,108,124,204,184,64,120,236
"2011","Crawley 009D","E01031563","Total",1247,113,75,38,1134,24,170,206,150,50,181,353
"2011","Crawley 009E","E01031579","Total",1628,233,65,168,1395,98,42,484,334,80,191,166
"2011","Crawley 009F","E01031582","Total",1818,241,13,228,1577,124,46,672,422,101,71,141
"2011","Crawley 010A","E01031547","Total",1332,143,34,109,1189,138,40,272,210,72,157,300
"2011","Crawley 010B","E01031548","Total",1596,277,49,228,1319,143,58,350,218,108,220,222
"2011","Crawley 010C","E01031549","Total",1482,120,23,97,1362,136,32,294,178,114,288,320
"2011","Crawley 010D","E01031550","Total",1455,117,8,109,1338,116,30,307,188,90,223,384
"2011","Crawley 010E","E01031569","Total",1577,156,61,95,1421,136,152,319,260,163,133,258
"2011","Crawley 011A","E01031595","Total",1692,146,77,69,1546,126,164,336,186,120,228,386
"2011","Crawley 011B","E01031604","Total",1563,222,122,100,1341,63,170,316,228,114,130,320
"2011","Crawley 011C","E01031605","Total",1574,140,86,54,1434,134,172,295,166,131,201,335
"2011","Crawley 011D","E01031606","Total",1523,161,97,64,1362,92,188,317,192,136,181,256
"2011","Crawley 011E","E01031607","Total",1418,180,93,87,1238,77,156,276,142,113,227,247
"2011","Crawley 012A","E01031546","Total",1455,74,11,63,1381,69,40,300,188,103,339,342
"2011","Crawley 012B","E01031551","Total",1545,67,14,53,1478,85,44,349,162,137,313,388
"2011","Crawley 012C","E01031553","Total",1559,80,15,65,1479,114,36,327,180,202,323,297
"2011","Crawley 012D","E01031554","Total",1714,226,31,195,1488,102,60,374,282,112,250,308
"2011","Crawley 012E","E01031555","Total",1563,76,21,55,1487,98,88,247,130,186,362,376
"2011","Crawley 013A","E01031552","Total",1898,200,67,133,1698,172,106,404,296,105,195,420
"2011","Crawley 013B","E01031556","Total",1655,180,15,165,1475,221,40,378,266,141,192,237
"2011","Crawley 013C","E01031557","Total",1726,361,27,334,1365,106,56,427,422,51,84,219
"2011","Crawley 013D","E01031558","Total",1572,246,103,143,1326,167,88,261,142,139,271,258
"2011","Crawley 013E","E01031559","Total",1529,83,20,63,1446,125,46,381,208,146,252,288
"2011","Horsham 001A","E01031670","Total",1547,247,85,162,1300,42,162,334,298,92,130,242
"2011","Horsham 001B","E01031671","Total",1628,349,106,243,1279,58,126,361,302,87,116,229
"2011","Horsham 001C","E01031673","Total",1511,190,65,125,1321,119,110,353,242,93,107,297
"2011","Horsham 001D","E01031676","Total",2636,250,80,170,2386,58,322,582,460,151,356,457
"2011","Horsham 002A","E01031644","Total",1441,118,38,80,1323,56,142,373,212,118,137,285
"2011","Horsham 002B","E01031645","Total",1439,111,40,71,1328,40,108,418,248,88,204,222
"2011","Horsham 002C","E01031646","Total",1529,145,41,104,1384,76,96,434,254,86,174,264
"2011","Horsham 002D","E01031647","Total",1197,164,61,103,1033,54,106,234,204,95,152,188
"2011","Horsham 002E","E01031649","Total",1147,116,45,71,1031,19,86,328,178,66,109,245
"2011","Horsham 002F","E01031650","Total",1320,89,25,64,1231,25,152,345,184,95,185,245
"2011","Horsham 002G","E01031666","Total",1602,112,75,37,1490,28,326,381,260,107,158,230
"2011","Horsham 002H","E01031668","Total",1531,157,105,52,1374,54,310,336,212,60,145,257
"2011","Horsham 003A","E01031620","Total",1601,203,67,136,1398,105,136,379,254,95,146,283
"2011","Horsham 003B","E01031648","Total",1670,281,119,162,1389,69,216,297,320,94,147,246
"2011","Horsham 003C","E01031651","Total",1634,161,54,107,1473,76,120,480,262,109,170,256
"2011","Horsham 003D","E01031658","Total",2003,247,144,103,1756,81,318,433,334,96,159,335
"2011","Horsham 003E","E01031689","Total",1566,194,84,110,1372,42,162,421,256,95,142,254
"2011","Horsham 004A","E01031654","Total",1567,179,107,72,1388,40,240,374,186,99,139,310
"2011","Horsham 004B","E01031655","Total",1524,165,55,110,1359,73,92,493,276,86,121,218
"2011","Horsham 004C","E01031667","Total",1565,181,98,83,1384,47,222,348,216,123,135,293
"2011","Horsham 004D","E01031669","Total",1570,220,87,133,1350,118,146,286,284,113,140,263
"2011","Horsham 004E","E01031672","Total",1676,344,118,226,1332,35,150,371,358,95,113,210
"2011","Horsham 005A","E01031657","Total",1851,224,95,129,1627,68,234,434,302,123,128,338
"2011","Horsham 005B","E01031659","Total",1468,111,62,49,1357,28,180,307,220,116,197,309
"2011","Horsham 005C","E01031674","Total",1239,159,86,73,1080,12,194,281,224,88,53,228
"2011","Horsham 005D","E01031675","Total",1367,114,56,58,1253,34,188,320,212,103,136,260
"2011","Horsham 006A","E01031636","Total",2107,515,211,304,1592,89,264,360,334,66,214,265
"2011","Horsham 006B","E01031652","Total",1728,155,80,75,1573,102,144,383,162,170,276,336
"2011","Horsham 006C","E01031653","Total",1622,314,92,222,1308,58,120,327,356,60,155,232
"2011","Horsham 006D","E01031656","Total",1733,347,168,179,1386,70,92,417,312,70,203,222
"2011","Horsham 006E","E01031688","Total",1371,205,138,67,1166,59,198,304,174,89,140,202
"2011","Horsham 006F","E01031691","Total",1652,268,157,111,1384,50,254,399,306,76,106,193
"2011","Horsham 007A","E01031619","Total",1511,200,50,150,1311,57,110,366,274,52,192,260
"2011","Horsham 007B","E01031637","Total",1883,222,101,121,1661,112,228,406,338,117,119,341
"2011","Horsham 007C","E01031638","Total",1791,245,95,150,1546,78,156,422,396,90,133,271
"2011","Horsham 007D","E01031690","Total",1516,161,108,53,1355,11,284,322,242,135,119,242
"2011","Horsham 008A","E01031639","Total",1823,222,89,133,1601,47,274,392,354,91,174,269
"2011","Horsham 008B","E01031640","Total",1808,112,83,29,1696,26,384,369,258,113,178,368
"2011","Horsham 008C","E01031660","Total",1240,113,62,51,1127,36,240,252,196,88,99,216
"2011","Horsham 008D","E01031661","Total",1531,127,66,61,1404,16,260,275,288,83,161,321
"2011","Horsham 008E","E01031679","Total",1260,113,42,71,1147,21,140,297,238,123,150,178
"2011","Horsham 009A","E01031677","Total",1490,158,82,76,1332,57,192,372,196,105,126,284
"2011","Horsham 009B","E01031678","Total",1631,79,39,40,1552,28,142,447,224,150,211,350
"2011","Horsham 009C","E01031680","Total",1394,71,31,40,1323,29,110,425,214,86,181,278
"2011","Horsham 009D","E01031681","Total",1512,137,60,77,1375,61,112,443,232,132,175,220
"2011","Horsham 009E","E01031682","Total",1188,113,26,87,1075,36,50,425,220,56,122,166
"2011","Horsham 009F","E01031683","Total",1477,172,53,119,1305,72,122,387,276,72,155,221
"2011","Horsham 010A","E01031611","Total",1606,167,68,99,1439,36,228,312,294,77,173,319
"2011","Horsham 010B","E01031612","Total",2109,223,99,124,1886,75,246,645,374,96,194,256
"2011","Horsham 010C","E01031613","Total",2063,226,85,141,1837,67,238,562,326,163,204,277
"2011","Horsham 010D","E01031614","Total",1994,253,130,123,1741,132,174,568,308,176,138,245
"2011","Horsham 010E","E01031615","Total",1541,256,151,105,1285,32,270,309,242,85,112,235
"2011","Horsham 011A","E01031632","Total",1450,144,57,87,1306,36,202,300,306,62,129,271
"2011","Horsham 011B","E01031633","Total",1293,131,71,60,1162,20,192,298,174,76,146,256
"2011","Horsham 011C","E01031634","Total",1229,112,49,63,1117,48,142,287,216,102,133,189
"2011","Horsham 011D","E01031635","Total",1426,111,43,68,1315,34,152,395,212,83,137,302
"2011","Horsham 012A","E01031621","Total",1664,159,124,35,1505,16,610,190,346,31,61,251
"2011","Horsham 012B","E01031623","Total",1711,189,129,60,1522,27,362,279,296,76,99,383
"2011","Horsham 012C","E01031627","Total",1992,196,135,61,1796,53,426,404,292,137,148,336
"2011","Horsham 012D","E01031664","Total",1608,132,77,55,1476,33,320,319,274,72,150,308
"2011","Horsham 013A","E01031626","Total",1490,194,116,78,1296,41,276,300,288,118,109,164
"2011","Horsham 013B","E01031630","Total",1693,321,218,103,1372,40,322,318,268,64,129,231
"2011","Horsham 013C","E01031631","Total",1559,323,213,110,1236,81,286,309,240,78,79,163
"2011","Horsham 013D","E01031662","Total",1481,261,117,144,1220,47,208,307,284,46,91,237
"2011","Horsham 013E","E01031663","Total",1773,236,99,137,1537,92,222,368,288,117,168,282
"2011","Horsham 013F","E01031665","Total",1205,147,81,66,1058,19,224,230,248,66,88,183
"2011","Horsham 014A","E01031618","Total",1329,105,50,55,1224,50,226,201,232,79,152,284
"2011","Horsham 014B","E01031641","Total",1567,273,173,100,1294,38,344,257,206,72,158,219
"2011","Horsham 014C","E01031642","Total",1849,175,112,63,1674,94,354,333,286,109,177,321
"2011","Horsham 014D","E01031643","Total",1590,264,165,99,1326,94,250,383,164,62,152,221
"2011","Horsham 014E","E01031687","Total",1598,225,117,108,1373,75,164,327,188,95,160,364
"2011","Horsham 015A","E01031622","Total",1609,114,44,70,1495,51,238,466,286,25,165,264
"2011","Horsham 015B","E01031624","Total",1517,110,48,62,1407,51,178,391,286,66,181,254
"2011","Horsham 015C","E01031625","Total",1433,103,51,52,1330,42,174,350,212,92,143,317
"2011","Horsham 015D","E01031628","Total",1231,134,51,83,1097,52,174,210,176,66,159,260
"2011","Horsham 015E","E01031629","Total",1435,138,88,50,1297,23,326,267,286,54,119,222
"2011","Horsham 016A","E01031616","Total",1600,210,86,124,1390,82,210,363,218,85,156,276
"2011","Horsham 016B","E01031617","Total",2344,257,142,115,2087,73,416,516,346,74,222,440
"2011","Horsham 016C","E01031684","Total",1457,175,95,80,1282,40,238,314,238,62,129,261
"2011","Horsham 016D","E01031685","Total",1669,349,216,133,1320,50,318,313,256,72,123,188
"2011","Horsham 016E","E01031686","Total",1421,183,125,58,1238,26,340,289,148,57,122,256
"2011","Mid Sussex 001A","E01031731","Total",2010,303,164,139,1707,155,174,402,238,152,197,389
"2011","Mid Sussex 001B","E01031732","Total",1806,143,62,81,1663,108,176,463,282,124,173,337
"2011","Mid Sussex 001C","E01031733","Total",1714,260,91,169,1454,94,140,453,278,71,120,298
"2011","Mid Sussex 001D","E01031734","Total",1664,100,53,47,1564,34,210,398,210,70,198,444
"2011","Mid Sussex 001E","E01031741","Total",1644,334,140,194,1310,57,186,326,332,47,132,230
"2011","Mid Sussex 001F","E01031742","Total",1829,479,252,227,1350,51,226,279,322,60,157,255
"2011","Mid Sussex 001G","E01031743","Total",1635,310,83,227,1325,103,118,309,306,111,124,254
"2011","Mid Sussex 002A","E01031718","Total",1781,144,63,81,1637,48,184,378,260,99,212,456
"2011","Mid Sussex 002B","E01031719","Total",1767,172,72,100,1595,87,222,375,270,123,183,335
"2011","Mid Sussex 002C","E01031720","Total",1422,117,62,55,1305,24,198,317,200,88,220,258
"2011","Mid Sussex 002D","E01031722","Total",1139,138,52,86,1001,22,108,225,204,115,123,204
"2011","Mid Sussex 003A","E01031695","Total",1446,125,57,68,1321,35,168,321,230,99,157,311
"2011","Mid Sussex 003B","E01031696","Total",1319,158,66,92,1161,56,194,306,188,56,119,242
"2011","Mid Sussex 003C","E01031729","Total",1792,129,82,47,1663,33,266,391,292,62,168,451
"2011","Mid Sussex 003D","E01031730","Total",1821,238,47,191,1583,94,62,541,400,101,141,244
"2011","Mid Sussex 003E","E01031735","Total",1691,148,61,87,1543,53,226,389,300,56,122,397
"2011","Mid Sussex 004A","E01031736","Total",1577,123,62,61,1454,21,268,300,242,144,148,331
"2011","Mid Sussex 004B","E01031737","Total",1539,109,40,69,1430,53,184,410,214,126,158,285
"2011","Mid Sussex 004C","E01031738","Total",1246,132,95,37,1114,8,218,251,152,80,138,267
"2011","Mid Sussex 004D","E01031739","Total",1762,176,80,96,1586,23,274,438,248,80,171,352
"2011","Mid Sussex 004E","E01031740","Total",1312,128,70,58,1184,20,210,268,214,82,113,277
"2011","Mid Sussex 005A","E01031721","Total",1502,233,154,79,1269,57,320,279,184,61,89,279
"2011","Mid Sussex 005B","E01031723","Total",1387,118,61,57,1269,20,202,255,214,77,134,367
"2011","Mid Sussex 005C","E01031724","Total",1386,77,30,47,1309,34,110,392,226,63,164,320
"2011","Mid Sussex 005D","E01031725","Total",1474,118,64,54,1356,41,226,311,250,106,171,251
"2011","Mid Sussex 006A","E01031694","Total",1695,183,93,90,1512,54,194,311,274,177,211,291
"2011","Mid Sussex 006B","E01031764","Total",1437,157,97,60,1280,34,216,372,210,96,131,221
"2011","Mid Sussex 006C","E01031765","Total",1580,127,74,53,1453,43,198,375,242,130,178,287
"2011","Mid Sussex 006D","E01031766","Total",2065,189,78,111,1876,40,294,497,324,94,234,393
"2011","Mid Sussex 007A","E01031692","Total",2170,260,90,170,1910,98,190,549,350,172,286,265
"2011","Mid Sussex 007B","E01031693","Total",1833,207,118,89,1626,30,242,458,288,147,193,268
"2011","Mid Sussex 007C","E01031697","Total",1205,122,60,62,1083,30,138,298,200,94,121,202
"2011","Mid Sussex 007D","E01031727","Total",1643,137,65,72,1506,27,264,434,214,121,158,288
"2011","Mid Sussex 008A","E01031758","Total",1389,79,32,47,1310,32,152,330,186,100,156,354
"2011","Mid Sussex 008B","E01031760","Total",1726,138,62,76,1588,44,176,494,346,144,124,260
"2011","Mid Sussex 008C","E01031772","Total",1601,227,140,87,1374,74,250,344,278,99,97,232
"2011","Mid Sussex 008D","E01031773","Total",1952,218,137,81,1734,33,344,442,282,219,152,262
"2011","Mid Sussex 008E","E01031774","Total",1637,142,95,47,1495,23,308,464,210,128,103,259
"2011","Mid Sussex 008F","E01031775","Total",1721,240,167,73,1481,45,350,398,242,118,91,237
"2011","Mid Sussex 009A","E01031751","Total",2611,384,93,291,2227,93,168,691,552,164,188,371
"2011","Mid Sussex 009B","E01031759","Total",1647,216,93,123,1431,23,214,373,296,91,188,246
"2011","Mid Sussex 009C","E01031761","Total",1959,573,227,346,1386,43,144,265,530,51,184,169
"2011","Mid Sussex 009E","E01032837","Total",1219,199,115,84,1020,38,114,380,222,100,59,107
"2011","Mid Sussex 009F","E01032838","Total",1319,140,10,130,1179,85,50,460,352,91,64,77
"2011","Mid Sussex 009G","E01032839","Total",1133,224,85,139,909,21,140,206,288,46,42,166
"2011","Mid Sussex 010A","E01031752","Total",1432,166,70,96,1266,104,112,310,168,201,162,209
"2011","Mid Sussex 010B","E01031753","Total",1363,176,72,104,1187,59,178,291,232,81,149,197
"2011","Mid Sussex 010C","E01031754","Total",1580,179,96,83,1401,45,146,439,234,50,180,307
"2011","Mid Sussex 010D","E01031755","Total",1323,132,62,70,1191,58,120,332,228,100,140,213
"2011","Mid Sussex 010E","E01031757","Total",1520,259,97,162,1261,77,158,365,238,121,97,205
"2011","Mid Sussex 011A","E01031726","Total",1472,184,68,116,1288,62,128,420,184,143,138,213
"2011","Mid Sussex 011B","E01031728","Total",1996,241,137,104,1755,42,318,474,290,205,140,286
"2011","Mid Sussex 011C","E01031749","Total",1470,132,69,63,1338,41,198,424,252,81,123,219
"2011","Mid Sussex 011D","E01031750","Total",1478,200,68,132,1278,77,154,357,220,85,138,247
"2011","Mid Sussex 011E","E01031756","Total",1829,212,68,144,1617,70,228,424,330,95,158,312
"2011","Mid Sussex 011F","E01031763","Total",1745,136,80,56,1609,29,316,409,252,129,157,317
"2011","Mid Sussex 012A","E01031699","Total",1677,165,45,120,1512,90,80,508,372,68,155,239
"2011","Mid Sussex 012B","E01031700","Total",1711,81,26,55,1630,65,102,609,272,118,212,252
"2011","Mid Sussex 012C","E01031701","Total",1846,193,63,130,1653,104,156,504,314,119,171,285
"2011","Mid Sussex 012D","E01031714","Total",1480,137,82,55,1343,59,142,366,174,115,174,313
"2011","Mid Sussex 013A","E01031704","Total",1745,179,80,99,1566,76,210,466,262,124,135,293
"2011","Mid Sussex 013B","E01031706","Total",1687,146,92,54,1541,28,250,357,238,113,172,383
"2011","Mid Sussex 013C","E01031711","Total",1748,135,72,63,1613,48,194,472,284,81,184,350
"2011","Mid Sussex 013D","E01031712","Total",1478,199,89,110,1279,112,138,342,254,71,166,196
"2011","Mid Sussex 013E","E01031713","Total",1393,108,62,46,1285,22,262,310,190,62,138,301
"2011","Mid Sussex 014A","E01031705","Total",1568,215,89,126,1353,74,102,341,262,138,163,273
"2011","Mid Sussex 014B","E01031707","Total",1538,168,110,58,1370,22,262,314,238,62,148,324
"2011","Mid Sussex 014C","E01031708","Total",1614,298,100,198,1316,47,102,360,308,69,160,270
"2011","Mid Sussex 014D","E01031709","Total",1606,348,157,191,1258,54,142,329,256,71,148,258
"2011","Mid Sussex 014E","E01031716","Total",1266,105,42,63,1161,123,130,325,154,140,153,136
"2011","Mid Sussex 014F","E01031717","Total",1397,146,51,95,1251,62,114,407,230,96,122,220
"2011","Mid Sussex 015A","E01031702","Total",1427,59,32,27,1368,23,232,268,200,85,144,416
"2011","Mid Sussex 015B","E01031703","Total",1571,130,83,47,1441,19,370,251,202,46,183,370
"2011","Mid Sussex 015C","E01031710","Total",1431,135,85,50,1296,42,270,320,186,67,109,302
"2011","Mid Sussex 015D","E01031715","Total",1567,122,36,86,1445,65,104,620,278,86,90,202
"2011","Mid Sussex 016A","E01031698","Total",1610,129,51,78,1481,37,176,349,278,128,200,313
"2011","Mid Sussex 016B","E01031767","Total",1374,123,68,55,1251,20,196,351,162,126,127,269
"2011","Mid Sussex 016C","E01031769","Total",1760,195,77,118,1565,99,146,568,244,104,218,186
"2011","Mid Sussex 016D","E01031770","Total",1662,216,100,116,1446,34,200,376,312,154,147,223
"2011","Mid Sussex 016E","E01031771","Total",1576,131,46,85,1445,100,114,404,246,154,207,220
"2011","Mid Sussex 017A","E01031744","Total",1469,135,93,42,1334,24,240,346,174,52,186,312
"2011","Mid Sussex 017B","E01031745","Total",1758,227,159,68,1531,58,316,423,294,112,65,263
"2011","Mid Sussex 017C","E01031746","Total",1640,253,135,118,1387,88,162,340,250,95,223,229
"2011","Mid Sussex 017D","E01031747","Total",1433,218,155,63,1215,36,328,282,214,50,111,194
"2011","Mid Sussex 017E","E01031748","Total",1318,161,97,64,1157,37,258,321,164,94,81,202
"2011","Mid Sussex 017F","E01031768","Total",1526,220,163,57,1306,30,296,355,192,106,93,234
"2011","Worthing 001A","E01031793","Total",1338,160,115,45,1178,27,276,226,276,74,92,207
"2011","Worthing 001B","E01031820","Total",1701,217,149,68,1484,19,544,223,224,61,139,274
"2011","Worthing 001C","E01031821","Total",1663,264,169,95,1399,56,270,401,270,63,101,238
"2011","Worthing 001D","E01031828","Total",1281,104,63,41,1177,21,282,244,238,45,136,211
"2011","Worthing 001E","E01031829","Total",1505,125,78,47,1380,33,312,222,248,58,197,310
"2011","Worthing 002A","E01031822","Total",1548,170,107,63,1378,61,268,306,210,63,184,286
"2011","Worthing 002B","E01031825","Total",1609,261,151,110,1348,38,400,225,290,47,124,224
"2011","Worthing 002C","E01031826","Total",1359,208,83,125,1151,75,154,308,222,45,109,238
"2011","Worthing 002D","E01031827","Total",1423,239,103,136,1184,82,168,272,214,93,150,205
"2011","Worthing 002E","E01031839","Total",1709,270,127,143,1439,102,162,449,256,96,128,246
"2011","Worthing 003A","E01031792","Total",1356,217,121,96,1139,55,198,283,208,91,117,187
"2011","Worthing 003B","E01031794","Total",1322,245,177,68,1077,37,318,182,204,58,83,195
"2011","Worthing 003C","E01031795","Total",1494,227,91,136,1267,107,60,363,244,146,120,227
"2011","Worthing 003D","E01031818","Total",2065,138,53,85,1927,136,142,444,314,181,262,448
"2011","Worthing 003E","E01031830","Total",1599,160,75,85,1439,145,222,284,224,157,162,245
"2011","Worthing 004A","E01031778","Total",1497,247,105,142,1250,53,184,292,218,83,169,251
"2011","Worthing 004B","E01031797","Total",1293,114,59,55,1179,39,182,277,186,70,171,254
"2011","Worthing 004C","E01031800","Total",1566,160,94,66,1406,73,184,491,192,113,143,210
"2011","Worthing 004D","E01031823","Total",1430,89,54,35,1341,14,222,362,182,89,222,250
"2011","Worthing 004E","E01031824","Total",1349,107,67,40,1242,45,174,309,162,114,148,290
"2011","Worthing 005A","E01031776","Total",1575,233,90,143,1342,97,100,466,262,88,125,204
"2011","Worthing 005B","E01031777","Total",1682,245,110,135,1437,79,140,459,244,98,175,242
"2011","Worthing 005C","E01031780","Total",1556,104,52,52,1452,55,110,414,190,125,216,342
"2011","Worthing 005D","E01031781","Total",1668,134,70,64,1534,111,144,424,224,135,193,303
"2011","Worthing 005E","E01031798","Total",1521,268,68,200,1253,41,122,326,278,72,197,217
"2011","Worthing 006A","E01031783","Total",1533,189,103,86,1344,80,166,272,166,156,236,268
"2011","Worthing 006B","E01031785","Total",1473,206,92,114,1267,99,178,307,248,74,128,233
"2011","Worthing 006C","E01031786","Total",1510,159,65,94,1351,88,180,322,240,106,139,276
"2011","Worthing 006D","E01031817","Total",1589,177,40,137,1412,96,90,364,274,112,240,236
"2011","Worthing 006E","E01031819","Total",1298,116,21,95,1182,166,62,262,146,133,213,200
"2011","Worthing 007A","E01031782","Total",1676,230,152,78,1446,54,436,274,222,69,93,298
"2011","Worthing 007B","E01031784","Total",1828,212,109,103,1616,106,258,377,284,99,181,311
"2011","Worthing 007C","E01031836","Total",1680,291,89,202,1389,134,160,380,262,113,148,192
"2011","Worthing 007D","E01031838","Total",1529,195,63,132,1334,75,190,348,244,78,127,272
"2011","Worthing 007E","E01031840","Total",1691,249,119,130,1442,70,230,374,310,76,119,263
"2011","Worthing 008A","E01031791","Total",2039,448,133,315,1591,201,98,487,342,115,126,222
"2011","Worthing 008B","E01031796","Total",1587,214,67,147,1373,118,76,457,266,111,139,206
"2011","Worthing 008C","E01031799","Total",1585,221,111,110,1364,147,102,326,216,114,180,279
"2011","Worthing 008D","E01031801","Total",1808,323,109,214,1485,159,106,443,264,130,109,274
"2011","Worthing 008E","E01031837","Total",1917,269,75,194,1648,107,114,527,272,96,213,319
"2011","Worthing 009A","E01031779","Total",1378,160,59,101,1218,175,92,271,148,125,209,198
"2011","Worthing 009B","E01031831","Total",1550,223,78,145,1327,64,176,377,222,88,188,212
"2011","Worthing 009C","E01031832","Total",1628,420,192,228,1208,41,266,280,238,49,100,234
"2011","Worthing 009D","E01031833","Total",1580,210,58,152,1370,128,88,361,246,127,165,255
"2011","Worthing 009E","E01031834","Total",1599,200,91,109,1399,76,136,327,240,141,210,269
"2011","Worthing 010A","E01031790","Total",1639,537,189,348,1102,106,160,264,314,25,87,146
"2011","Worthing 010B","E01031807","Total",1512,449,257,192,1063,52,230,232,250,58,86,155
"2011","Worthing 010C","E01031809","Total",1503,472,175,297,1031,57,186,232,350,41,41,124
"2011","Worthing 010D","E01031810","Total",1577,349,95,254,1228,113,100,358,288,72,99,198
"2011","Worthing 010E","E01031811","Total",1174,377,138,239,797,36,88,170,258,30,104,111
"2011","Worthing 011A","E01031787","Total",1860,605,173,432,1255,138,136,265,386,61,84,185
"2011","Worthing 011B","E01031788","Total",2095,404,145,259,1691,213,136,454,388,84,143,273
"2011","Worthing 011C","E01031789","Total",1887,518,160,358,1369,91,156,329,390,70,100,233
"2011","Worthing 011D","E01031808","Total",1337,555,142,413,782,73,74,188,260,16,53,118
"2011","Worthing 011E","E01031835","Total",1760,471,114,357,1289,90,162,281,414,29,76,237
"2011","Worthing 012A","E01031812","Total",1487,372,208,164,1115,36,290,209,280,26,79,195
"2011","Worthing 012B","E01031813","Total",1771,312,119,193,1459,97,182,396,228,116,182,258
"2011","Worthing 012C","E01031814","Total",1501,273,141,132,1228,38,268,246,262,53,102,259
"2011","Worthing 012D","E01031815","Total",1509,349,206,143,1160,36,290,227,264,12,113,218
"2011","Worthing 012E","E01031816","Total",1610,188,82,106,1422,92,116,501,240,90,139,244
"2011","Worthing 013A","E01031802","Total",1556,323,238,85,1233,27,492,169,258,61,78,148
"2011","Worthing 013B","E01031803","Total",1507,158,117,41,1349,30,344,263,198,51,160,303
"2011","Worthing 013C","E01031804","Total",1606,216,149,67,1390,46,392,249,230,83,151,239
"2011","Worthing 013D","E01031805","Total",1610,291,222,69,1319,39,454,242,210,62,101,211
"2011","Worthing 013E","E01031806","Total",1664,253,133,120,1411,109,188,344,196,124,169,281
"2011","Bath and North East Somerset 001A","E01014399","Total",1624,144,75,69,1480,91,242,341,248,83,122,353
"2011","Bath and North East Somerset 001B","E01014400","Total",1906,317,157,160,1589,43,226,327,322,145,203,323
"2011","Bath and North East Somerset 001C","E01014401","Total",1617,164,94,70,1453,145,208,299,182,87,192,340
"2011","Bath and North East Somerset 002A","E01014402","Total",1684,219,116,103,1465,136,220,329,258,68,167,287
"2011","Bath and North East Somerset 002B","E01014403","Total",1620,401,278,123,1219,25,242,281,200,78,109,284
"2011","Bath and North East Somerset 002C","E01014404","Total",1668,235,125,110,1433,166,214,421,222,76,117,217
"2011","Bath and North East Somerset 003A","E01014395","Total",1235,112,78,34,1123,20,274,172,194,67,111,285
"2011","Bath and North East Somerset 003B","E01014396","Total",1401,242,141,101,1159,108,192,285,198,60,105,211
"2011","Bath and North East Somerset 003C","E01014397","Total",1312,106,80,26,1206,16,214,261,162,101,174,278
"2011","Bath and North East Somerset 003D","E01014398","Total",1423,202,106,96,1221,49,252,277,200,66,104,273
"2011","Bath and North East Somerset 004A","E01014409","Total",1559,312,143,169,1247,98,154,334,228,96,92,245
"2011","Bath and North East Somerset 004B","E01014410","Total",1770,163,73,90,1607,122,264,426,282,121,131,261
"2011","Bath and North East Somerset 004C","E01014411","Total",2084,306,119,187,1778,84,232,520,394,95,158,295
"2011","Bath and North East Somerset 005A","E01014477","Total",1454,182,122,60,1272,29,284,286,194,60,95,324
"2011","Bath and North East Somerset 005B","E01014478","Total",1189,123,67,56,1066,127,106,253,118,67,138,257
"2011","Bath and North East Somerset 005C","E01014479","Total",1377,238,140,98,1139,30,240,243,234,74,121,197
"2011","Bath and North East Somerset 005D","E01014480","Total",1261,195,108,87,1066,61,122,271,186,103,129,194
"2011","Bath and North East Somerset 006A","E01014465","Total",1502,196,54,142,1306,109,140,401,308,36,102,210
"2011","Bath and North East Somerset 006B","E01014466","Total",1262,203,33,170,1059,112,86,294,218,70,76,203
"2011","Bath and North East Somerset 006C","E01014467","Total",1620,344,65,279,1276,41,158,315,416,56,62,228
"2011","Bath and North East Somerset 006D","E01014468","Total",1503,316,72,244,1187,61,90,234,406,50,37,309
"2011","Bath and North East Somerset 007A","E01014370","Total",1666,622,229,393,1044,46,148,84,426,11,35,294
"2011","Bath and North East Somerset 007B","E01014371","Total",1830,568,176,392,1262,37,178,173,572,33,32,237
"2011","Bath and North East Somerset 007C","E01014372","Total",1984,635,92,543,1349,58,124,169,550,23,52,373
"2011","Bath and North East Somerset 007D","E01014412","Total",1462,249,69,180,1213,61,130,292,316,102,86,226
"2011","Bath and North East Somerset 007E","E01014413","Total",1378,212,93,119,1166,71,304,248,232,63,94,154
"2011","Bath and North East Somerset 007F","E01014414","Total",1474,456,90,366,1018,63,84,176,376,26,44,249
"2011","Bath and North East Somerset 008A","E01014427","Total",1349,200,73,127,1149,64,98,280,210,72,86,339
"2011","Bath and North East Somerset 008B","E01014428","Total",1332,219,119,100,1113,16,118,228,160,179,141,271
"2011","Bath and North East Somerset 008C","E01014429","Total",1609,149,74,75,1460,86,156,454,224,136,127,277
"2011","Bath and North East Somerset 008D","E01014430","Total",1541,268,199,69,1273,71,212,330,202,95,96,267
"2011","Bath and North East Somerset 009A","E01014405","Total",2037,249,92,157,1788,42,172,428,346,100,136,564
"2011","Bath and North East Somerset 009C","E01014407","Total",1045,365,82,283,680,106,40,86,284,5,30,129
"2011","Bath and North East Somerset 009E","E01033080","Total",2187,587,105,482,1600,59,114,215,604,49,49,510
"2011","Bath and North East Somerset 010A","E01014373","Total",1545,188,90,98,1357,114,148,392,234,73,108,288
"2011","Bath and North East Somerset 010B","E01014374","Total",1392,221,145,76,1171,51,232,289,212,100,97,190
"2011","Bath and North East Somerset 010C","E01014375","Total",1247,112,54,58,1135,18,228,224,216,64,141,244
"2011","Bath and North East Somerset 010D","E01014376","Total",1466,148,82,66,1318,22,318,322,228,52,125,251
"2011","Bath and North East Somerset 010E","E01014377","Total",1407,211,126,85,1196,44,330,246,210,78,97,191
"2011","Bath and North East Somerset 010G","E01033078","Total",1693,187,89,98,1506,50,246,347,272,136,197,258
"2011","Bath and North East Somerset 010H","E01033079","Total",1164,120,61,59,1044,39,142,212,192,132,122,205
"2011","Bath and North East Somerset 011A","E01014461","Total",1172,112,58,54,1060,127,76,210,194,61,124,268
"2011","Bath and North East Somerset 011B","E01014462","Total",1476,174,64,110,1302,210,108,297,202,115,166,204
"2011","Bath and North East Somerset 011C","E01014463","Total",1297,209,81,128,1088,164,164,135,146,74,163,242
"2011","Bath and North East Somerset 011D","E01014464","Total",1248,268,63,205,980,183,54,195,172,82,97,197
"2011","Bath and North East Somerset 012A","E01014380","Total",1172,147,91,56,1025,37,280,213,158,60,87,190
"2011","Bath and North East Somerset 012B","E01014381","Total",1332,265,166,99,1067,29,228,238,240,48,65,219
"2011","Bath and North East Somerset 012C","E01014481","Total",1299,197,38,159,1102,27,70,183,276,33,47,466
"2011","Bath and North East Somerset 012D","E01014482","Total",1188,135,71,64,1053,14,204,282,204,72,102,175
"2011","Bath and North East Somerset 012E","E01014483","Total",1401,219,73,146,1182,74,126,244,304,41,61,332
"2011","Bath and North East Somerset 012F","E01014484","Total",1549,200,48,152,1349,4,96,165,238,41,100,705
"2011","Bath and North East Somerset 013A","E01014473","Total",1588,121,53,68,1467,41,114,246,214,56,49,747
"2011","Bath and North East Somerset 013B","E01014474","Total",1183,146,56,90,1037,57,76,161,212,27,76,428
"2011","Bath and North East Somerset 013C","E01014475","Total",1613,178,67,111,1435,28,118,193,232,36,55,773
"2011","Bath and North East Somerset 013D","E01014476","Total",1439,112,52,60,1327,49,108,196,162,35,57,720
"2011","Bath and North East Somerset 014A","E01014435","Total",1593,105,52,53,1488,12,104,169,160,48,48,947
"2011","Bath and North East Somerset 014B","E01014436","Total",1539,191,105,86,1348,45,114,207,198,46,91,647
"2011","Bath and North East Somerset 014C","E01014437","Total",1407,227,88,139,1180,110,116,243,218,68,119,306
"2011","Bath and North East Somerset 014D","E01014438","Total",1280,129,41,88,1151,91,102,224,146,61,140,387
"2011","Bath and North East Somerset 015A","E01014455","Total",1317,191,97,94,1126,61,134,254,174,62,153,288
"2011","Bath and North East Somerset 015B","E01014456","Total",1503,159,91,68,1344,59,186,274,232,121,134,338
"2011","Bath and North East Somerset 015C","E01014457","Total",1320,190,84,106,1130,34,200,185,294,38,107,272
"2011","Bath and North East Somerset 015D","E01014458","Total",1389,135,64,71,1254,194,98,217,120,154,200,271
"2011","Bath and North East Somerset 016A","E01014391","Total",1432,157,86,71,1275,35,224,257,270,72,129,288
"2011","Bath and North East Somerset 016B","E01014392","Total",1001,105,52,53,896,24,188,136,164,71,103,210
"2011","Bath and North East Somerset 016C","E01014452","Total",1471,201,147,54,1270,7,316,297,194,61,125,270
"2011","Bath and North East Somerset 016D","E01014453","Total",1243,110,79,31,1133,32,258,230,162,78,139,234
"2011","Bath and North East Somerset 016E","E01014454","Total",1340,92,60,32,1248,11,216,317,200,91,154,259
"2011","Bath and North East Somerset 016F","E01014459","Total",1412,181,94,87,1231,53,228,298,184,117,89,262
"2011","Bath and North East Somerset 016G","E01014460","Total",1143,128,65,63,1015,18,224,237,202,46,81,207
"2011","Bath and North East Somerset 017A","E01014415","Total",1975,168,61,107,1807,39,174,533,354,153,102,452
"2011","Bath and North East Somerset 017B","E01014416","Total",1665,214,123,91,1451,48,242,392,276,77,134,282
"2011","Bath and North East Somerset 017C","E01014417","Total",1770,191,101,90,1579,30,298,371,270,81,166,363
"2011","Bath and North East Somerset 018A","E01014387","Total",1232,138,86,52,1094,52,156,235,170,108,102,271
"2011","Bath and North East Somerset 018B","E01014388","Total",1270,153,89,64,1117,36,230,221,190,102,130,208
"2011","Bath and North East Somerset 018C","E01014389","Total",1361,242,162,80,1119,64,174,228,162,75,135,281
"2011","Bath and North East Somerset 018D","E01014390","Total",1517,222,66,156,1295,236,96,311,202,125,112,213
"2011","Bath and North East Somerset 019A","E01014431","Total",1225,135,68,67,1090,59,134,264,196,35,107,295
"2011","Bath and North East Somerset 019B","E01014432","Total",1277,172,80,92,1105,83,160,177,168,68,140,309
"2011","Bath and North East Somerset 019C","E01014433","Total",1358,147,41,106,1211,160,66,355,214,83,121,212
"2011","Bath and North East Somerset 019D","E01014434","Total",1821,178,82,96,1643,90,216,329,318,90,109,491
"2011","Bath and North East Somerset 020A","E01014385","Total",1351,97,48,49,1254,58,176,270,170,82,198,300
"2011","Bath and North East Somerset 020B","E01014386","Total",1157,99,51,48,1058,32,164,256,164,65,162,215
"2011","Bath and North East Somerset 020C","E01014419","Total",1245,115,49,66,1130,45,142,264,184,119,195,181
"2011","Bath and North East Somerset 020D","E01014446","Total",1119,99,48,51,1020,15,162,222,180,44,138,259
"2011","Bath and North East Somerset 020E","E01014447","Total",1301,108,62,46,1193,21,186,247,184,76,165,314
"2011","Bath and North East Somerset 021A","E01014382","Total",2384,203,116,87,2181,54,434,421,282,165,324,501
"2011","Bath and North East Somerset 021B","E01014383","Total",1016,107,55,52,909,23,172,208,160,56,116,174
"2011","Bath and North East Somerset 021C","E01014384","Total",1361,127,71,56,1234,68,212,253,172,82,188,259
"2011","Bath and North East Somerset 021D","E01014418","Total",1391,134,62,72,1257,49,200,249,216,108,149,286
"2011","Bath and North East Somerset 022A","E01014379","Total",2032,196,87,109,1836,57,336,440,328,111,239,325
"2011","Bath and North East Somerset 022B","E01014442","Total",1727,151,62,89,1576,80,192,464,328,102,165,245
"2011","Bath and North East Somerset 022C","E01014443","Total",1571,170,65,105,1401,76,188,333,258,71,145,330
"2011","Bath and North East Somerset 022D","E01014444","Total",1523,123,37,86,1400,69,128,497,270,103,130,203
"2011","Bath and North East Somerset 022E","E01014445","Total",1621,234,115,119,1387,103,140,347,182,119,206,290
"2011","Bath and North East Somerset 023A","E01014393","Total",1282,98,51,47,1184,35,156,346,262,76,89,220
"2011","Bath and North East Somerset 023B","E01014394","Total",1655,155,98,57,1500,65,194,408,294,55,164,320
"2011","Bath and North East Somerset 023C","E01014439","Total",1690,212,131,81,1478,67,238,396,224,107,157,289
"2011","Bath and North East Somerset 023D","E01014440","Total",1897,189,65,124,1708,86,166,464,314,142,157,379
"2011","Bath and North East Somerset 023E","E01014441","Total",1616,190,91,99,1426,72,280,337,304,65,96,272
"2011","Bath and North East Somerset 024A","E01014448","Total",1577,222,100,122,1355,118,194,276,212,112,190,253
"2011","Bath and North East Somerset 024B","E01014449","Total",1468,111,30,81,1357,130,110,431,250,86,121,229
"2011","Bath and North East Somerset 024C","E01014450","Total",1316,133,72,61,1183,144,126,210,192,143,132,236
"2011","Bath and North East Somerset 024D","E01014451","Total",1246,131,34,97,1115,86,128,221,238,80,117,245
"2011","Bath and North East Somerset 025A","E01014420","Total",1571,228,66,162,1343,88,150,414,272,106,127,186
"2011","Bath and North East Somerset 025B","E01014421","Total",1423,91,54,37,1332,61,174,342,184,66,199,306
"2011","Bath and North East Somerset 025C","E01014422","Total",1509,136,87,49,1373,80,258,297,250,71,139,278
"2011","Bath and North East Somerset 025D","E01014423","Total",1354,194,82,112,1160,96,150,281,252,65,109,207
"2011","Bath and North East Somerset 026A","E01014469","Total",1266,129,78,51,1137,40,158,252,132,112,192,251
"2011","Bath and North East Somerset 026B","E01014470","Total",1620,102,38,64,1518,133,128,412,298,101,135,311
"2011","Bath and North East Somerset 026C","E01014471","Total",1533,180,60,120,1353,73,134,390,292,78,152,234
"2011","Bath and North East Somerset 026D","E01014472","Total",1388,99,58,41,1289,101,150,316,242,50,150,280
"2011","Bath and North East Somerset 027A","E01014424","Total",1680,119,77,42,1561,53,278,396,270,82,155,327
"2011","Bath and North East Somerset 027B","E01014425","Total",1982,208,123,85,1774,108,352,380,254,90,188,402
"2011","Bath and North East Somerset 027C","E01014426","Total",1408,215,138,77,1193,90,222,217,198,63,130,273
"2011","Bournemouth 001A","E01015301","Total",1481,202,122,80,1279,39,300,254,230,69,137,250
"2011","Bournemouth 001B","E01015303","Total",1520,201,96,105,1319,54,250,230,220,90,153,322
"2011","Bournemouth 001C","E01015305","Total",1554,173,110,63,1381,106,186,276,166,115,203,329
"2011","Bournemouth 001D","E01015306","Total",1670,237,128,109,1433,147,224,271,212,112,186,281
"2011","Bournemouth 002A","E01015302","Total",1837,249,132,117,1588,111,346,325,292,43,135,336
"2011","Bournemouth 002B","E01015304","Total",1711,271,156,115,1440,184,220,363,232,88,84,269
"2011","Bournemouth 002C","E01015308","Total",1707,195,61,134,1512,158,150,393,288,78,161,284
"2011","Bournemouth 002D","E01015311","Total",1340,197,143,54,1143,8,490,95,270,20,54,206
"2011","Bournemouth 003A","E01015332","Total",1524,238,141,97,1286,62,296,236,214,102,139,237
"2011","Bournemouth 003B","E01015333","Total",1581,168,106,62,1413,68,276,320,250,74,108,317
"2011","Bournemouth 003C","E01015334","Total",1536,212,130,82,1324,90,274,225,206,108,150,271
"2011","Bournemouth 003D","E01015335","Total",1683,185,92,93,1498,72,240,313,238,77,172,386
"2011","Bournemouth 003E","E01015337","Total",1697,227,93,134,1470,87,158,382,282,87,171,303
"2011","Bournemouth 004A","E01015343","Total",1551,194,114,80,1357,75,178,344,208,106,212,234
"2011","Bournemouth 004B","E01015349","Total",1494,207,94,113,1287,92,164,325,264,134,149,159
"2011","Bournemouth 004C","E01015351","Total",1474,173,52,121,1301,85,98,353,248,121,157,239
"2011","Bournemouth 004D","E01015352","Total",1529,187,61,126,1342,112,110,484,246,105,133,152
"2011","Bournemouth 004E","E01015353","Total",1148,145,64,81,1003,64,162,264,168,72,97,176
"2011","Bournemouth 004F","E01015354","Total",1729,174,72,102,1555,106,160,475,296,97,186,235
"2011","Bournemouth 005A","E01015307","Total",1389,200,87,113,1189,135,136,259,192,70,187,210
"2011","Bournemouth 005B","E01015309","Total",1450,155,54,101,1295,202,126,299,184,67,172,245
"2011","Bournemouth 005C","E01015312","Total",1238,153,73,80,1085,136,154,239,150,101,125,180
"2011","Bournemouth 005D","E01015313","Total",1369,144,66,78,1225,117,102,225,142,105,254,280
"2011","Bournemouth 005E","E01015359","Total",1566,313,129,184,1253,50,178,253,266,78,161,267
"2011","Bournemouth 006A","E01015320","Total",1686,170,84,86,1516,53,174,379,252,112,176,370
"2011","Bournemouth 006B","E01015323","Total",1579,127,61,66,1452,60,152,356,216,145,172,351
"2011","Bournemouth 006C","E01015324","Total",1549,201,79,122,1348,105,114,342,270,71,140,306
"2011","Bournemouth 006D","E01015325","Total",1706,139,59,80,1567,58,150,471,236,131,168,353
"2011","Bournemouth 006E","E01015350","Total",1451,176,116,60,1275,28,258,264,192,114,185,234
"2011","Bournemouth 007A","E01015310","Total",1536,150,57,93,1386,114,130,282,208,106,188,358
"2011","Bournemouth 007B","E01015336","Total",1601,181,75,106,1420,66,208,286,280,79,154,347
"2011","Bournemouth 007C","E01015355","Total",1689,189,90,99,1500,83,228,355,266,75,169,324
"2011","Bournemouth 007D","E01015357","Total",1558,243,126,117,1315,80,184,281,234,101,149,286
"2011","Bournemouth 007E","E01015358","Total",1908,198,100,98,1710,92,192,316,216,131,213,550
"2011","Bournemouth 008A","E01015338","Total",1815,328,185,143,1487,116,236,383,192,112,209,239
"2011","Bournemouth 008B","E01015339","Total",1587,226,101,125,1361,107,180,279,208,92,213,282
"2011","Bournemouth 008C","E01015340","Total",1577,209,135,74,1368,39,360,280,252,63,100,274
"2011","Bournemouth 008D","E01015341","Total",1446,119,60,59,1327,149,102,275,186,113,256,246
"2011","Bournemouth 009A","E01015321","Total",1861,250,123,127,1611,58,118,377,228,103,211,516
"2011","Bournemouth 009B","E01015356","Total",1762,186,73,113,1576,94,154,306,202,78,207,535
"2011","Bournemouth 009C","E01015374","Total",2308,268,61,207,2040,149,60,325,330,43,114,1019
"2011","Bournemouth 009D","E01015375","Total",1842,207,77,130,1635,61,110,253,240,51,111,809
"2011","Bournemouth 009E","E01015377","Total",1637,143,44,99,1494,86,90,287,246,80,125,580
"2011","Bournemouth 010A","E01015322","Total",1660,176,89,87,1484,56,174,369,220,106,167,392
"2011","Bournemouth 010B","E01015330","Total",1733,272,112,160,1461,79,178,349,264,121,129,341
"2011","Bournemouth 010C","E01015342","Total",1549,130,71,59,1419,51,234,311,230,94,168,331
"2011","Bournemouth 010D","E01015373","Total",1703,193,54,139,1510,99,62,370,284,78,147,470
"2011","Bournemouth 010E","E01015378","Total",1735,119,39,80,1616,71,84,326,230,121,186,598
"2011","Bournemouth 011A","E01015314","Total",1521,153,94,59,1368,33,226,319,228,114,190,258
"2011","Bournemouth 011B","E01015315","Total",1932,147,86,61,1785,5,280,370,256,130,254,490
"2011","Bournemouth 011C","E01015318","Total",1664,211,83,128,1453,75,170,410,296,91,121,290
"2011","Bournemouth 011D","E01015319","Total",1386,227,42,185,1159,43,136,323,220,107,126,204
"2011","Bournemouth 012A","E01015344","Total",1683,170,88,82,1513,31,326,284,282,81,108,401
"2011","Bournemouth 012B","E01015346","Total",1637,248,79,169,1389,47,128,253,216,97,146,502
"2011","Bournemouth 012C","E01015348","Total",1769,226,97,129,1543,33,320,215,284,56,171,464
"2011","Bournemouth 012D","E01015360","Total",1780,103,39,64,1677,61,116,263,254,101,170,712
"2011","Bournemouth 013A","E01015326","Total",1901,262,70,192,1639,67,94,334,408,82,168,486
"2011","Bournemouth 013B","E01015331","Total",2254,354,80,274,1900,158,92,425,498,99,119,509
"2011","Bournemouth 013C","E01015345","Total",1845,216,49,167,1629,53,98,292,328,87,182,589
"2011","Bournemouth 013D","E01015376","Total",1751,142,42,100,1609,74,66,246,248,80,187,708
"2011","Bournemouth 014A","E01015316","Total",1591,177,93,84,1414,37,268,321,252,59,180,297
"2011","Bournemouth 014B","E01015317","Total",1574,184,86,98,1390,82,208,349,310,85,149,207
"2011","Bournemouth 014C","E01015361","Total",1415,135,54,81,1280,93,118,359,174,135,141,260
"2011","Bournemouth 014D","E01015362","Total",1246,106,43,63,1140,75,60,334,162,113,177,219
"2011","Bournemouth 014E","E01015363","Total",1672,184,45,139,1488,88,110,484,244,115,160,287
"2011","Bournemouth 015A","E01015292","Total",1696,270,68,202,1426,119,64,368,274,44,197,360
"2011","Bournemouth 015B","E01015293","Total",1530,200,50,150,1330,137,84,318,256,64,173,298
"2011","Bournemouth 015C","E01015294","Total",1949,263,43,220,1686,179,74,424,366,95,228,320
"2011","Bournemouth 015D","E01015327","Total",1960,227,60,167,1733,112,78,400,318,127,207,491
"2011","Bournemouth 015E","E01015329","Total",1660,215,38,177,1445,69,110,273,286,81,156,470
"2011","Bournemouth 016A","E01015272","Total",1671,313,163,150,1358,37,320,242,314,41,125,279
"2011","Bournemouth 016B","E01015273","Total",1964,390,58,332,1574,167,110,375,342,76,151,353
"2011","Bournemouth 016C","E01015275","Total",1737,248,47,201,1489,65,130,323,298,41,154,478
"2011","Bournemouth 016D","E01015276","Total",1646,182,51,131,1464,111,96,416,246,147,150,298
"2011","Bournemouth 016E","E01015277","Total",1944,318,81,237,1626,119,106,358,324,117,199,403
"2011","Bournemouth 017A","E01015283","Total",1782,471,89,382,1311,38,70,170,610,26,52,345
"2011","Bournemouth 017C","E01015286","Total",1870,558,273,285,1312,56,260,250,414,15,79,238
"2011","Bournemouth 017D","E01015287","Total",1722,814,187,627,908,34,124,150,384,22,27,167
"2011","Bournemouth 017E","E01015328","Total",1747,491,202,289,1256,60,100,253,410,42,86,305
"2011","Bournemouth 017F","E01033242","Total",982,344,95,249,638,29,48,142,250,15,16,138
"2011","Bournemouth 017G","E01033285","Total",1080,323,77,246,757,42,44,137,330,15,31,158
"2011","Bournemouth 018A","E01015274","Total",1766,383,127,256,1383,110,142,320,332,82,136,261
"2011","Bournemouth 018B","E01015297","Total",1330,310,162,148,1020,55,230,183,248,26,96,182
"2011","Bournemouth 018C","E01015364","Total",1585,203,106,97,1382,46,234,345,250,81,134,292
"2011","Bournemouth 018D","E01015365","Total",1646,321,91,230,1325,117,142,247,322,41,172,284
"2011","Bournemouth 018E","E01015366","Total",1591,454,214,240,1137,45,220,214,310,46,87,215
"2011","Bournemouth 019B","E01015279","Total",1776,531,76,455,1245,120,70,290,430,45,83,207
"2011","Bournemouth 019C","E01015280","Total",1777,516,51,465,1261,127,62,340,404,26,58,244
"2011","Bournemouth 019D","E01015281","Total",1722,447,90,357,1275,160,58,254,318,50,122,313
"2011","Bournemouth 019E","E01015282","Total",1907,736,84,652,1171,84,38,293,432,40,103,181
"2011","Bournemouth 019F","E01033241","Total",1087,395,91,304,692,43,80,130,298,10,31,100
"2011","Bournemouth 019G","E01033283","Total",1137,386,132,254,751,17,140,143,364,5,4,78
"2011","Bournemouth 020A","E01015295","Total",1427,173,115,58,1254,20,358,239,242,42,114,239
"2011","Bournemouth 020B","E01015296","Total",1671,525,248,277,1146,88,230,178,362,57,65,166
"2011","Bournemouth 020C","E01015298","Total",1512,296,199,97,1216,22,482,186,226,41,62,197
"2011","Bournemouth 020D","E01015299","Total",1700,194,105,89,1506,70,274,366,288,98,104,306
"2011","Bournemouth 020E","E01015300","Total",1552,197,111,86,1355,25,232,344,282,117,102,253
"2011","Bournemouth 021A","E01015285","Total",1948,520,117,403,1428,71,204,237,532,10,69,305
"2011","Bournemouth 021B","E01015288","Total",1855,433,98,335,1422,155,32,324,314,48,150,399
"2011","Bournemouth 021C","E01015289","Total",1814,531,150,381,1283,34,148,231,472,20,84,294
"2011","Bournemouth 021D","E01015290","Total",1632,435,99,336,1197,53,122,231,410,25,21,335
"2011","Bournemouth 021E","E01015291","Total",1905,503,237,266,1402,37,478,188,434,17,40,208
"2011","Bournemouth 023A","E01015371","Total",1518,453,90,363,1065,34,88,155,448,61,58,221
"2011","Bournemouth 023B","E01015372","Total",1672,694,371,323,978,46,194,151,400,15,29,143
"2011","Bournemouth 023C","E01033286","Total",1064,286,85,201,778,27,146,139,322,18,34,92
"2011","Bournemouth 023D","E01033288","Total",1045,291,107,184,754,18,162,137,334,26,5,72
"2011","Bournemouth 024A","E01015367","Total",1913,576,77,499,1337,53,120,165,596,48,56,299
"2011","Bournemouth 024B","E01015368","Total",1655,518,240,278,1137,28,444,167,346,0,30,122
"2011","Bournemouth 024C","E01015369","Total",1614,468,215,253,1146,44,314,203,410,17,16,142
"2011","Bournemouth 024D","E01015370","Total",1500,343,77,266,1157,42,154,191,466,30,48,226
"2011","Bristol 001A","E01014601","Total",1570,218,103,115,1352,115,194,269,250,99,145,280
"2011","Bristol 001B","E01014602","Total",1841,295,101,194,1546,255,142,371,236,114,193,235
"2011","Bristol 001C","E01014603","Total",2134,311,95,216,1823,172,196,446,426,96,194,293
"2011","Bristol 001E","E01014605","Total",1601,358,120,238,1243,272,160,283,218,59,124,127
"2011","Bristol 001G","E01032516","Total",1881,222,83,139,1659,159,262,296,382,82,162,316
"2011","Bristol 001H","E01032517","Total",1555,245,122,123,1310,159,150,209,248,123,203,218
"2011","Bristol 002A","E01014688","Total",1716,155,70,85,1561,239,112,310,228,164,213,295
"2011","Bristol 002B","E01014689","Total",1604,226,90,136,1378,251,94,163,150,276,211,233
"2011","Bristol 002C","E01014690","Total",2025,242,112,130,1783,174,136,424,232,200,271,346
"2011","Bristol 002D","E01014691","Total",1877,338,224,114,1539,157,186,292,234,127,192,351
"2011","Bristol 002E","E01014692","Total",1613,134,32,102,1479,192,104,298,226,168,187,304
"2011","Bristol 002F","E01014693","Total",1372,213,76,137,1159,65,204,264,284,22,72,248
"2011","Bristol 002G","E01014694","Total",1617,212,87,125,1405,106,140,307,220,95,243,294
"2011","Bristol 003A","E01014497","Total",1563,203,83,120,1360,188,154,272,222,137,118,269
"2011","Bristol 003B","E01014498","Total",1583,171,62,109,1412,248,134,419,196,69,134,212
"2011","Bristol 003C","E01014638","Total",1611,352,162,190,1259,223,138,230,232,112,126,198
"2011","Bristol 003D","E01014639","Total",1494,185,56,129,1309,346,76,345,172,89,144,137
"2011","Bristol 003E","E01014640","Total",1464,181,70,111,1283,144,116,281,184,82,209,267
"2011","Bristol 004A","E01014631","Total",1163,171,107,64,992,47,142,190,200,66,112,235
"2011","Bristol 004B","E01014632","Total",1538,165,77,88,1373,83,152,267,244,92,184,351
"2011","Bristol 004C","E01014633","Total",1571,189,86,103,1382,129,156,347,232,94,139,285
"2011","Bristol 004D","E01014636","Total",1465,182,66,116,1283,233,146,289,222,64,134,195
"2011","Bristol 005A","E01014630","Total",2091,274,75,199,1817,219,116,288,360,93,149,592
"2011","Bristol 005B","E01014634","Total",1699,190,55,135,1509,41,110,245,330,72,94,617
"2011","Bristol 005C","E01014659","Total",2069,298,63,235,1771,301,78,341,362,188,184,317
"2011","Bristol 005D","E01014661","Total",1622,135,51,84,1487,141,96,269,232,155,265,329
"2011","Bristol 006A","E01014616","Total",1475,266,176,90,1209,19,212,356,218,98,109,197
"2011","Bristol 006B","E01014719","Total",1366,207,92,115,1159,42,164,338,270,79,71,195
"2011","Bristol 006C","E01014720","Total",1598,313,169,144,1285,116,194,374,254,41,87,219
"2011","Bristol 006D","E01014721","Total",1438,192,104,88,1246,30,194,378,296,50,103,195
"2011","Bristol 007A","E01014641","Total",1403,179,83,96,1224,44,244,242,244,45,147,258
"2011","Bristol 007B","E01014642","Total",1449,183,84,99,1266,75,166,272,214,107,172,260
"2011","Bristol 007C","E01014643","Total",1364,174,86,88,1190,131,114,204,160,113,195,273
"2011","Bristol 007D","E01014644","Total",1512,161,86,75,1351,100,118,302,276,91,215,249
"2011","Bristol 008A","E01014492","Total",1478,308,146,162,1170,141,190,228,264,67,89,191
"2011","Bristol 008B","E01014493","Total",1482,179,80,99,1303,106,116,279,222,75,198,307
"2011","Bristol 008C","E01014494","Total",1472,154,76,78,1318,41,196,296,310,50,165,260
"2011","Bristol 008D","E01014495","Total",1638,223,112,111,1415,106,248,290,294,64,134,279
"2011","Bristol 008E","E01014496","Total",1628,219,66,153,1409,97,96,325,274,131,231,255
"2011","Bristol 008F","E01014499","Total",1563,144,59,85,1419,112,120,263,260,119,255,290
"2011","Bristol 009A","E01014715","Total",1607,123,74,49,1484,22,184,558,218,133,89,280
"2011","Bristol 009B","E01014716","Total",1494,141,101,40,1353,15,290,451,190,116,91,200
"2011","Bristol 009C","E01014717","Total",1404,246,210,36,1158,26,222,362,152,106,101,189
"2011","Bristol 009D","E01014718","Total",1387,211,111,100,1176,24,198,354,274,53,77,196
"2011","Bristol 010A","E01014510","Total",1951,178,56,122,1773,128,88,445,294,138,89,591
"2011","Bristol 010B","E01014635","Total",1865,198,64,134,1667,109,164,355,346,41,97,555
"2011","Bristol 010C","E01014637","Total",1352,153,48,105,1199,30,62,235,254,52,90,476
"2011","Bristol 010D","E01014662","Total",1569,186,68,118,1383,100,104,309,232,91,129,418
"2011","Bristol 011A","E01014615","Total",1525,136,84,52,1389,29,268,445,160,83,131,273
"2011","Bristol 011B","E01014617","Total",1339,86,44,42,1253,36,174,383,196,62,89,313
"2011","Bristol 011C","E01014618","Total",1547,156,106,50,1391,26,234,421,202,142,130,236
"2011","Bristol 011D","E01014620","Total",1445,215,137,78,1230,33,206,373,190,132,106,190
"2011","Bristol 012A","E01014571","Total",1588,219,80,139,1369,102,122,237,228,79,167,434
"2011","Bristol 012B","E01014577","Total",1496,196,77,119,1300,68,154,253,266,92,160,307
"2011","Bristol 012C","E01014586","Total",1454,264,143,121,1190,98,248,229,270,58,67,220
"2011","Bristol 012D","E01014587","Total",1342,240,127,113,1102,98,142,192,184,105,115,266
"2011","Bristol 013A","E01014588","Total",1606,301,141,160,1305,79,184,222,232,53,134,401
"2011","Bristol 013B","E01014589","Total",1407,238,99,139,1169,212,104,216,152,114,156,215
"2011","Bristol 013C","E01014590","Total",1699,281,128,153,1418,109,116,200,252,92,198,451
"2011","Bristol 013D","E01014591","Total",1759,280,141,139,1479,64,238,337,300,83,131,326
"2011","Bristol 013E","E01014592","Total",1590,228,110,118,1362,96,128,301,286,98,125,328
"2011","Bristol 014A","E01014660","Total",1555,245,126,119,1310,135,150,233,172,97,210,313
"2011","Bristol 014B","E01014663","Total",1438,213,80,133,1225,180,114,200,180,57,162,332
"2011","Bristol 014C","E01014664","Total",1609,218,92,126,1391,91,154,182,268,136,281,279
"2011","Bristol 014D","E01014665","Total",2099,195,85,110,1904,326,168,284,280,163,310,373
"2011","Bristol 015A","E01014709","Total",1135,242,118,124,893,25,238,121,242,32,80,155
"2011","Bristol 015B","E01014710","Total",1067,196,81,115,871,23,164,191,256,51,60,126
"2011","Bristol 015C","E01014711","Total",1217,118,72,46,1099,38,250,302,196,41,59,213
"2011","Bristol 015D","E01014712","Total",1250,136,77,59,1114,43,176,369,132,107,139,148
"2011","Bristol 015E","E01014713","Total",1270,164,74,90,1106,28,226,290,208,46,96,212
"2011","Bristol 015F","E01014714","Total",1322,109,62,47,1213,26,212,365,188,97,119,206
"2011","Bristol 016A","E01014507","Total",1664,183,53,130,1481,48,66,446,358,63,83,417
"2011","Bristol 016B","E01014508","Total",1410,108,25,83,1302,75,40,324,214,45,109,495
"2011","Bristol 016C","E01014509","Total",2061,254,36,218,1807,71,40,429,468,102,128,569
"2011","Bristol 016D","E01014511","Total",1454,106,37,69,1348,40,50,466,234,135,122,301
"2011","Bristol 016E","E01014512","Total",1485,165,76,89,1320,23,66,437,274,82,108,330
"2011","Bristol 016F","E01014513","Total",1580,169,77,92,1411,40,112,454,238,156,117,294
"2011","Bristol 016G","E01014514","Total",1900,253,62,191,1647,71,74,425,428,82,68,499
"2011","Bristol 017A","E01014619","Total",1442,178,58,120,1264,46,142,355,246,118,107,250
"2011","Bristol 017B","E01014621","Total",1469,169,66,103,1300,63,78,428,228,124,113,266
"2011","Bristol 017C","E01014666","Total",1824,142,67,75,1682,55,142,555,220,199,164,347
"2011","Bristol 017D","E01014667","Total",1637,161,40,121,1476,58,82,478,260,112,138,348
"2011","Bristol 017E","E01014672","Total",1940,436,123,313,1504,55,130,324,438,45,99,413
"2011","Bristol 018A","E01014624","Total",1733,167,70,97,1566,202,138,306,226,149,257,288
"2011","Bristol 018D","E01014629","Total",1473,137,59,78,1336,187,102,289,152,107,261,238
"2011","Bristol 018E","E01032518","Total",1838,253,98,155,1585,194,112,336,202,188,332,221
"2011","Bristol 018F","E01032519","Total",1159,152,64,88,1007,73,108,247,238,62,147,132
"2011","Bristol 019A","E01014572","Total",1835,304,45,259,1531,101,84,387,318,121,193,327
"2011","Bristol 019B","E01014573","Total",1837,304,69,235,1533,68,114,282,362,132,194,381
"2011","Bristol 019C","E01014575","Total",1531,257,57,200,1274,109,86,263,188,138,231,259
"2011","Bristol 019D","E01014576","Total",1919,260,83,177,1659,168,164,377,332,113,213,292
"2011","Bristol 020A","E01014487","Total",1995,256,27,229,1739,38,58,269,436,97,155,686
"2011","Bristol 020B","E01014491","Total",1917,222,37,185,1695,84,46,411,396,118,170,470
"2011","Bristol 020C","E01014668","Total",1638,166,35,131,1472,55,56,387,250,156,150,418
"2011","Bristol 020D","E01014669","Total",1499,192,22,170,1307,56,72,258,326,91,129,375
"2011","Bristol 020E","E01014670","Total",1501,190,27,163,1311,19,46,260,284,120,184,398
"2011","Bristol 020F","E01014671","Total",1533,243,48,195,1290,35,40,239,350,84,101,441
"2011","Bristol 021A","E01014622","Total",1530,190,68,122,1340,120,122,276,236,111,163,312
"2011","Bristol 021B","E01014623","Total",1610,180,77,103,1430,138,110,304,256,91,228,303
"2011","Bristol 021C","E01014626","Total",1960,355,128,227,1605,203,148,334,334,153,158,275
"2011","Bristol 021D","E01014627","Total",2100,260,82,178,1840,199,174,381,426,96,217,347
"2011","Bristol 022A","E01014557","Total",1634,156,45,111,1478,17,58,219,302,40,200,642
"2011","Bristol 022B","E01014558","Total",1798,284,42,242,1514,20,24,90,494,7,64,815
"2011","Bristol 022C","E01014559","Total",1963,273,63,210,1690,18,116,260,398,45,142,711
"2011","Bristol 022D","E01014560","Total",1669,296,45,251,1373,56,74,181,470,17,68,507
"2011","Bristol 022E","E01014562","Total",1832,204,20,184,1628,36,36,201,316,23,42,974
"2011","Bristol 023A","E01014485","Total",1807,300,87,213,1507,194,72,346,368,65,133,329
"2011","Bristol 023B","E01014486","Total",2297,449,70,379,1848,324,54,265,438,157,207,403
"2011","Bristol 023C","E01014488","Total",1971,244,40,204,1727,119,56,279,376,111,229,557
"2011","Bristol 023D","E01014489","Total",2390,486,45,441,1904,187,46,260,568,76,152,615
"2011","Bristol 023F","E01033347","Total",1114,292,22,270,822,121,4,94,370,42,43,148
"2011","Bristol 023G","E01033348","Total",1104,277,6,271,827,195,6,69,194,48,151,164
"2011","Bristol 023H","E01033366","Total",1507,191,22,169,1316,409,44,207,154,175,187,140
"2011","Bristol 025A","E01014539","Total",1823,274,54,220,1549,32,104,216,384,40,109,664
"2011","Bristol 025C","E01014561","Total",1703,272,50,222,1431,34,54,230,512,46,106,449
"2011","Bristol 025D","E01014563","Total",1807,289,20,269,1518,47,24,150,560,62,70,605
"2011","Bristol 025E","E01033342","Total",1383,577,19,558,806,38,14,114,364,28,29,219
"2011","Bristol 025F","E01033367","Total",1218,353,31,322,865,108,24,114,312,33,78,196
"2011","Bristol 026A","E01014551","Total",1767,325,27,298,1442,48,34,135,522,10,40,653
"2011","Bristol 026B","E01014552","Total",1826,274,44,230,1552,31,58,166,452,37,78,730
"2011","Bristol 026C","E01014553","Total",1711,271,61,210,1440,17,40,176,452,72,41,642
"2011","Bristol 026D","E01014554","Total",1661,354,51,303,1307,15,40,193,528,27,47,457
"2011","Bristol 026E","E01014556","Total",1689,389,118,271,1300,34,86,245,434,32,53,416
"2011","Bristol 027A","E01014673","Total",1734,315,87,228,1419,153,138,365,314,82,147,220
"2011","Bristol 027B","E01014674","Total",1568,170,67,103,1398,105,130,296,280,94,156,337
"2011","Bristol 027C","E01014675","Total",1494,223,75,148,1271,95,142,325,244,57,154,254
"2011","Bristol 027D","E01014676","Total",1535,224,133,91,1311,87,142,365,214,68,135,300
"2011","Bristol 028A","E01014682","Total",1489,190,70,120,1299,101,124,364,290,106,113,201
"2011","Bristol 028B","E01014683","Total",1655,419,157,262,1236,125,104,292,248,69,132,266
"2011","Bristol 028C","E01014685","Total",1582,178,49,129,1404,183,124,298,216,156,178,249
"2011","Bristol 028D","E01014686","Total",1630,225,84,141,1405,175,158,327,244,89,155,257
"2011","Bristol 028E","E01014687","Total",1580,251,100,151,1329,126,152,320,240,107,134,250
"2011","Bristol 029A","E01014565","Total",1652,317,111,206,1335,181,92,260,298,89,163,252
"2011","Bristol 029B","E01014566","Total",1669,329,71,258,1340,139,84,322,384,86,103,222
"2011","Bristol 029C","E01014567","Total",1909,314,50,264,1595,193,76,415,466,82,108,255
"2011","Bristol 029D","E01014681","Total",2139,417,134,283,1722,237,136,452,454,76,93,274
"2011","Bristol 029E","E01014684","Total",1654,350,49,301,1304,137,82,326,440,38,108,173
"2011","Bristol 030A","E01014544","Total",1203,224,64,160,979,42,112,168,290,47,99,221
"2011","Bristol 030B","E01014545","Total",1575,360,103,257,1215,17,100,164,456,43,87,348
"2011","Bristol 030C","E01014546","Total",1446,305,74,231,1141,29,62,76,478,0,33,463
"2011","Bristol 030D","E01014547","Total",1629,377,84,293,1252,29,102,193,498,26,52,352
"2011","Bristol 032A","E01014538","Total",1801,215,35,180,1586,12,32,117,370,10,34,1011
"2011","Bristol 032B","E01014540","Total",2450,515,41,474,1935,105,72,136,604,111,93,814
"2011","Bristol 032C","E01014542","Total",2045,371,69,302,1674,24,30,93,424,57,25,1021
"2011","Bristol 032E","E01033344","Total",1494,273,30,243,1221,50,30,100,294,5,15,727
"2011","Bristol 032F","E01033345","Total",1341,327,14,313,1014,7,32,51,370,5,46,503
"2011","Bristol 032G","E01033350","Total",1035,346,56,290,689,2,50,74,382,11,42,128
"2011","Bristol 033A","E01014677","Total",1413,217,41,176,1196,54,106,267,390,35,103,241
"2011","Bristol 033B","E01014678","Total",1549,192,74,118,1357,101,200,283,276,75,153,269
"2011","Bristol 033C","E01014679","Total",1535,201,70,131,1334,88,162,366,272,51,143,252
"2011","Bristol 033D","E01014680","Total",1287,121,56,65,1166,57,146,286,202,91,186,198
"2011","Bristol 034A","E01014548","Total",1690,359,68,291,1331,68,98,228,410,58,106,363
"2011","Bristol 034B","E01014549","Total",1191,232,59,173,959,36,74,133,258,61,52,345
"2011","Bristol 034C","E01014550","Total",1930,315,56,259,1615,50,126,279,548,25,53,534
"2011","Bristol 034D","E01014555","Total",1288,351,57,294,937,20,36,82,462,17,29,291
"2011","Bristol 035A","E01014528","Total",1497,212,44,168,1285,63,122,367,368,64,83,218
"2011","Bristol 035B","E01014529","Total",1431,183,57,126,1248,150,56,284,260,71,155,272
"2011","Bristol 035C","E01014530","Total",1384,249,51,198,1135,92,100,271,406,45,79,142
"2011","Bristol 035D","E01014531","Total",1647,249,54,195,1398,92,100,318,418,79,142,249
"2011","Bristol 035E","E01014532","Total",1468,174,59,115,1294,88,104,374,314,42,144,228
"2011","Bristol 035F","E01014537","Total",1773,256,104,152,1517,117,140,363,248,117,196,336
"2011","Bristol 036A","E01014695","Total",1692,385,151,234,1307,109,160,272,312,35,107,312
"2011","Bristol 036B","E01014696","Total",1666,211,44,167,1455,58,64,499,332,61,81,360
"2011","Bristol 036C","E01014698","Total",1839,301,76,225,1538,68,76,436,484,40,72,362
"2011","Bristol 036D","E01014699","Total",1412,282,69,213,1130,121,60,266,364,10,41,268
"2011","Bristol 036E","E01014700","Total",1559,175,73,102,1384,41,138,264,302,83,135,421
"2011","Bristol 036F","E01014701","Total",1684,197,32,165,1487,55,64,360,452,71,80,405
"2011","Bristol 037A","E01014730","Total",1604,445,71,374,1159,126,54,223,446,63,74,173
"2011","Bristol 037B","E01014731","Total",1524,312,45,267,1212,87,42,276,444,25,53,285
"2011","Bristol 037C","E01014732","Total",1689,281,24,257,1408,137,42,375,452,95,51,256
"2011","Bristol 037D","E01014735","Total",1680,212,53,159,1468,75,146,365,424,56,99,303
"2011","Bristol 038A","E01014523","Total",1277,149,88,61,1128,65,208,252,194,71,111,227
"2011","Bristol 038B","E01014524","Total",1443,142,81,61,1301,64,186,328,224,69,139,291
"2011","Bristol 038C","E01014525","Total",1586,145,58,87,1441,109,124,403,354,65,148,238
"2011","Bristol 038D","E01014526","Total",1513,211,60,151,1302,208,154,282,236,106,85,231
"2011","Bristol 038E","E01014527","Total",1344,269,128,141,1075,82,158,256,236,52,77,214
"2011","Bristol 039A","E01014500","Total",1534,214,85,129,1320,87,110,335,330,36,122,300
"2011","Bristol 039B","E01014502","Total",1716,231,108,123,1485,88,174,345,300,57,174,347
"2011","Bristol 039E","E01033359","Total",1184,364,13,351,820,65,22,115,434,16,47,121
"2011","Bristol 039F","E01033361","Total",1255,375,139,236,880,56,114,71,318,17,34,270
"2011","Bristol 039G","E01033362","Total",1114,366,111,255,748,48,34,114,416,5,31,100
"2011","Bristol 039H","E01033364","Total",1557,289,88,201,1268,62,96,273,494,20,59,264
"2011","Bristol 040A","E01014729","Total",1435,161,49,112,1274,181,72,219,280,124,179,219
"2011","Bristol 040B","E01014733","Total",1728,201,34,167,1527,134,48,345,454,71,108,367
"2011","Bristol 040C","E01014734","Total",1578,203,49,154,1375,100,62,442,334,51,60,326
"2011","Bristol 040D","E01014736","Total",1923,263,106,157,1660,112,152,399,370,94,191,342
"2011","Bristol 041A","E01014501","Total",1679,231,136,95,1448,79,276,285,274,91,142,301
"2011","Bristol 041B","E01014504","Total",1499,187,58,129,1312,57,98,326,368,30,90,343
"2011","Bristol 041C","E01014505","Total",1740,241,70,171,1499,90,102,301,570,35,70,331
"2011","Bristol 041D","E01014506","Total",1579,128,91,37,1451,44,176,387,198,84,171,391
"2011","Bristol 042A","E01014645","Total",1564,233,127,106,1331,66,192,270,218,77,186,322
"2011","Bristol 042B","E01014646","Total",1573,172,84,88,1401,65,188,300,204,118,192,334
"2011","Bristol 042C","E01014648","Total",1617,201,68,133,1416,86,102,395,322,86,139,286
"2011","Bristol 042D","E01014649","Total",1631,179,66,113,1452,57,132,462,290,63,188,260
"2011","Bristol 042E","E01014651","Total",1627,210,62,148,1417,64,124,420,252,105,109,343
"2011","Bristol 043A","E01014533","Total",1440,190,48,142,1250,24,116,343,282,68,145,272
"2011","Bristol 043B","E01014534","Total",1602,151,26,125,1451,85,96,391,332,107,121,319
"2011","Bristol 043C","E01014535","Total",1928,173,80,93,1755,97,202,388,292,142,202,432
"2011","Bristol 043D","E01014536","Total",1421,269,126,143,1152,101,152,248,218,79,111,243
"2011","Bristol 044A","E01014578","Total",1679,144,70,74,1535,200,136,332,242,99,211,315
"2011","Bristol 044B","E01014583","Total",1440,141,56,85,1299,191,88,199,156,151,271,243
"2011","Bristol 044C","E01014585","Total",1932,186,84,102,1746,420,96,323,202,265,236,204
"2011","Bristol 044D","E01014647","Total",1685,160,59,101,1525,133,100,303,176,246,252,315
"2011","Bristol 044E","E01014650","Total",1564,153,81,72,1411,86,158,330,232,91,199,315
"2011","Bristol 045A","E01014579","Total",1404,139,66,73,1265,163,130,304,146,115,166,241
"2011","Bristol 045B","E01014580","Total",1490,244,92,152,1246,202,128,216,204,115,119,262
"2011","Bristol 045C","E01014581","Total",1529,207,74,133,1322,245,114,252,186,125,179,221
"2011","Bristol 045D","E01014582","Total",1400,122,48,74,1278,169,78,240,186,151,175,279
"2011","Bristol 045E","E01014584","Total",1379,78,40,38,1301,164,68,266,160,153,250,240
"2011","Bristol 046A","E01014518","Total",1651,216,98,118,1435,97,134,375,320,71,108,330
"2011","Bristol 046B","E01014519","Total",1305,173,101,72,1132,78,154,216,182,90,184,228
"2011","Bristol 046C","E01014520","Total",1527,172,104,68,1355,35,280,230,232,42,183,353
"2011","Bristol 046D","E01014521","Total",1288,122,67,55,1166,79,164,262,168,81,142,270
"2011","Bristol 047A","E01014607","Total",1326,122,47,75,1204,88,174,229,216,103,123,271
"2011","Bristol 047B","E01014608","Total",1692,240,91,149,1452,220,118,284,222,95,238,275
"2011","Bristol 047C","E01014609","Total",1713,199,83,116,1514,181,142,383,246,85,164,313
"2011","Bristol 047D","E01014610","Total",1423,303,156,147,1120,147,132,235,262,56,112,176
"2011","Bristol 047E","E01014613","Total",1483,187,71,116,1296,112,220,261,254,51,94,304
"2011","Bristol 047F","E01014614","Total",1236,118,71,47,1118,35,170,227,194,67,172,253
"2011","Bristol 048A","E01014594","Total",1506,208,86,122,1298,291,104,307,152,113,88,243
"2011","Bristol 048B","E01014598","Total",1465,150,92,58,1315,59,262,233,238,83,130,310
"2011","Bristol 048C","E01014599","Total",1280,142,65,77,1138,58,154,324,206,77,122,197
"2011","Bristol 048D","E01014600","Total",1387,172,122,50,1215,122,158,225,222,104,145,239
"2011","Bristol 049A","E01014702","Total",1433,140,62,78,1293,78,238,289,208,72,137,271
"2011","Bristol 049B","E01014703","Total",1420,288,88,200,1132,137,110,240,214,52,152,227
"2011","Bristol 049C","E01014704","Total",1826,191,70,121,1635,154,174,342,292,109,245,319
"2011","Bristol 049D","E01014705","Total",1371,189,143,46,1182,48,292,225,168,54,110,285
"2011","Bristol 049E","E01014706","Total",1248,266,122,144,982,113,168,232,192,58,63,156
"2011","Bristol 049F","E01014707","Total",1591,136,90,46,1455,62,290,274,168,48,236,377
"2011","Bristol 049G","E01014708","Total",1772,157,87,70,1615,89,234,336,246,99,193,418
"2011","Bristol 050A","E01014515","Total",1481,182,108,74,1299,151,174,227,178,90,175,304
"2011","Bristol 050B","E01014516","Total",1407,226,97,129,1181,265,128,222,164,68,141,193
"2011","Bristol 050C","E01014517","Total",1209,140,58,82,1069,131,82,210,178,88,151,229
"2011","Bristol 050D","E01014522","Total",1650,249,110,139,1401,286,156,333,218,89,116,203
"2011","Bristol 051A","E01014593","Total",1512,139,41,98,1373,293,106,264,146,162,207,195
"2011","Bristol 051B","E01014595","Total",1417,242,85,157,1175,136,168,269,164,101,92,245
"2011","Bristol 051C","E01014596","Total",1526,175,86,89,1351,156,174,238,144,135,232,272
"2011","Bristol 051D","E01014597","Total",1313,248,83,165,1065,123,166,191,168,77,168,172
"2011","Bristol 052A","E01014611","Total",1285,145,99,46,1140,32,250,215,216,42,109,276
"2011","Bristol 052B","E01014612","Total",1451,162,102,60,1289,101,224,248,240,63,153,260
"2011","Bristol 052C","E01014722","Total",1488,146,82,64,1342,64,194,270,260,51,119,384
"2011","Bristol 052D","E01014723","Total",1344,104,50,54,1240,81,208,243,174,73,107,354
"2011","Bristol 052E","E01014725","Total",1468,128,79,49,1340,49,258,222,240,67,132,372
"2011","Bristol 053B","E01014726","Total",1650,213,63,150,1437,269,118,238,210,178,158,266
"2011","Bristol 053C","E01014727","Total",1539,189,83,106,1350,264,136,282,150,108,188,222
"2011","Bristol 053E","E01032514","Total",1964,335,106,229,1629,424,138,330,216,179,162,180
"2011","Bristol 053F","E01032515","Total",1371,212,99,113,1159,147,194,213,196,59,126,224
"2011","Bristol 054A","E01033352","Total",1231,296,24,272,935,92,10,124,468,54,16,171
"2011","Bristol 054B","E01033353","Total",1129,410,67,343,719,69,50,50,368,10,16,156
"2011","Bristol 054C","E01033355","Total",998,323,22,301,675,23,26,69,382,5,4,166
"2011","Bristol 054D","E01033358","Total",1542,294,62,232,1248,348,48,169,220,221,90,152
"2011","Bristol 054E","E01033370","Total",1125,415,101,314,710,100,52,118,268,36,60,76
"2011","Bristol 055A","E01014564","Total",1863,223,69,154,1640,196,76,255,280,201,290,342
"2011","Bristol 055B","E01014653","Total",2572,409,92,317,2163,517,66,343,250,336,347,304
"2011","Bristol 055C","E01014655","Total",2357,485,94,391,1872,295,90,306,316,206,324,335
"2011","Bristol 056A","E01014654","Total",2323,295,59,236,2028,331,98,300,230,281,429,359
"2011","Bristol 056B","E01014658","Total",2177,265,68,197,1912,541,72,336,206,283,299,175
"2011","Bristol 056C","E01033356","Total",1419,329,102,227,1090,253,70,186,208,137,116,120
"2011","Bristol 056D","E01033369","Total",1428,232,94,138,1196,269,72,188,132,210,124,201
"2011","Bristol 057A","E01014568","Total",2431,351,90,261,2080,290,80,325,370,320,309,386
"2011","Bristol 057B","E01014569","Total",2144,278,66,212,1866,199,84,339,334,168,341,401
"2011","Bristol 057C","E01014570","Total",1824,251,61,190,1573,171,86,410,308,121,198,279
"2011","Bristol 057D","E01014574","Total",2162,435,89,346,1727,298,78,314,306,187,263,281
"2011","Cornwall 010A","E01018753","Total",1608,161,80,81,1447,52,278,282,290,73,177,295
"2011","Cornwall 010B","E01018754","Total",1543,229,123,106,1314,70,180,266,258,106,159,275
"2011","Cornwall 010C","E01018755","Total",1490,180,95,85,1310,42,270,287,250,50,127,284
"2011","Cornwall 010D","E01018756","Total",1612,236,131,105,1376,52,314,227,304,111,163,205
"2011","Cornwall 012A","E01018777","Total",2015,203,102,101,1812,31,362,354,424,109,171,361
"2011","Cornwall 012B","E01018782","Total",1476,159,74,85,1317,83,242,302,266,56,143,225
"2011","Cornwall 012C","E01018783","Total",1536,168,81,87,1368,57,276,238,298,85,165,249
"2011","Cornwall 012D","E01018784","Total",1454,178,87,91,1276,47,272,251,264,90,113,239
"2011","Cornwall 013A","E01018750","Total",2265,240,124,116,2025,124,320,447,384,145,242,363
"2011","Cornwall 013B","E01018751","Total",1505,257,102,155,1248,64,186,250,266,103,140,239
"2011","Cornwall 013C","E01018752","Total",2016,206,90,116,1810,107,304,411,368,114,206,300
"2011","Cornwall 013D","E01018779","Total",2231,269,134,135,1962,80,376,401,406,156,190,353
"2011","Cornwall 016A","E01018758","Total",2425,281,155,126,2144,111,326,499,424,112,269,403
"2011","Cornwall 016B","E01018768","Total",1973,182,63,119,1791,149,176,488,320,105,278,275
"2011","Cornwall 016C","E01018769","Total",1851,273,142,131,1578,123,280,371,284,66,202,252
"2011","Cornwall 016D","E01018778","Total",1716,179,97,82,1537,62,286,292,362,109,158,268
"2011","Cornwall 017A","E01018767","Total",1490,214,106,108,1276,113,154,292,236,99,162,220
"2011","Cornwall 017B","E01018770","Total",1246,183,100,83,1063,100,162,213,184,68,152,184
"2011","Cornwall 017C","E01018771","Total",1300,342,105,237,958,55,132,198,280,48,72,173
"2011","Cornwall 017D","E01018772","Total",1557,205,115,90,1352,45,312,269,264,66,141,255
"2011","Cornwall 022A","E01018764","Total",1436,143,83,60,1293,18,280,321,266,65,102,241
"2011","Cornwall 022B","E01018787","Total",1560,113,40,73,1447,51,166,418,290,136,125,261
"2011","Cornwall 022C","E01018795","Total",1210,102,57,45,1108,29,216,200,254,46,144,219
"2011","Cornwall 022D","E01018796","Total",1206,117,38,79,1089,55,118,359,224,46,98,189
"2011","Cornwall 023A","E01018757","Total",2066,272,138,134,1794,58,406,307,384,109,175,355
"2011","Cornwall 023B","E01018763","Total",1115,104,43,61,1011,32,106,247,212,71,143,200
"2011","Cornwall 023C","E01018765","Total",1479,147,88,59,1332,35,398,230,330,56,93,190
"2011","Cornwall 023D","E01018785","Total",1946,196,107,89,1750,59,292,390,368,113,197,331
"2011","Cornwall 025A","E01018786","Total",1305,126,65,61,1179,50,214,251,254,56,125,229
"2011","Cornwall 025B","E01018788","Total",1384,312,203,109,1072,71,268,204,194,36,74,225
"2011","Cornwall 025C","E01018790","Total",1180,135,67,68,1045,63,132,213,174,75,115,273
"2011","Cornwall 025D","E01018794","Total",1382,174,84,90,1208,66,172,307,268,44,105,246
"2011","Cornwall 026A","E01018789","Total",1456,145,78,67,1311,71,204,293,226,62,134,321
"2011","Cornwall 026B","E01018791","Total",1222,166,83,83,1056,38,190,191,184,52,168,233
"2011","Cornwall 026C","E01018792","Total",2782,322,137,185,2460,111,326,750,482,99,255,437
"2011","Cornwall 026D","E01018793","Total",1703,261,98,163,1442,96,202,307,300,91,148,298
"2011","Cornwall 028A","E01018759","Total",1494,145,68,77,1349,48,260,236,274,93,132,306
"2011","Cornwall 028B","E01018760","Total",1240,125,68,57,1115,52,202,155,220,97,181,208
"2011","Cornwall 028C","E01018761","Total",1489,209,144,65,1280,39,400,180,224,63,136,238
"2011","Cornwall 028D","E01018766","Total",1825,294,170,124,1531,43,366,217,316,115,180,294
"2011","Cornwall 028E","E01018774","Total",1403,271,130,141,1132,63,188,198,232,84,145,222
"2011","Cornwall 029A","E01018797","Total",1127,169,61,108,958,70,154,218,168,106,73,169
"2011","Cornwall 029B","E01018798","Total",1481,217,112,105,1264,60,212,254,238,68,123,309
"2011","Cornwall 029C","E01018799","Total",1182,221,126,95,961,91,138,236,182,59,75,180
"2011","Cornwall 029D","E01018800","Total",1618,143,68,75,1475,104,168,456,286,88,150,223
"2011","Cornwall 034A","E01018780","Total",2278,271,131,140,2007,136,366,477,398,112,195,323
"2011","Cornwall 034B","E01018781","Total",1839,254,136,118,1585,58,402,274,364,77,164,246
"2011","Cornwall 034E","E01033294","Total",2287,297,136,161,1990,78,266,437,470,99,210,430
"2011","Cornwall 037A","E01018762","Total",1203,161,83,78,1042,34,208,189,256,67,94,194
"2011","Cornwall 037B","E01018773","Total",1517,245,116,129,1272,64,328,235,264,72,115,194
"2011","Cornwall 037C","E01018775","Total",1390,209,116,93,1181,30,290,202,176,87,100,296
"2011","Cornwall 037D","E01018776","Total",1159,242,108,134,917,36,210,159,254,20,101,137
"2011","Cornwall 032A","E01018815","Total",2026,221,70,151,1805,94,186,470,354,137,212,352
"2011","Cornwall 032B","E01018831","Total",1307,143,75,68,1164,47,156,262,228,122,133,216
"2011","Cornwall 032C","E01018832","Total",1327,124,61,63,1203,24,204,245,260,67,141,262
"2011","Cornwall 032D","E01018847","Total",1513,168,69,99,1345,72,148,356,278,73,124,294
"2011","Cornwall 033A","E01018833","Total",1486,147,82,65,1339,47,218,277,188,94,227,288
"2011","Cornwall 033B","E01018842","Total",1402,179,81,98,1223,63,200,217,278,85,127,253
"2011","Cornwall 033C","E01018843","Total",1292,124,67,57,1168,40,210,207,222,42,144,303
"2011","Cornwall 033D","E01018844","Total",1226,254,132,122,972,68,168,198,240,46,91,161
"2011","Cornwall 040A","E01018825","Total",1554,186,75,111,1368,57,188,356,274,91,152,250
"2011","Cornwall 040B","E01018826","Total",2127,358,195,163,1769,60,324,466,302,81,221,315
"2011","Cornwall 040C","E01018851","Total",1383,248,163,85,1135,48,204,257,278,41,108,199
"2011","Cornwall 040D","E01018852","Total",2501,290,156,134,2211,95,408,489,408,156,227,428
"2011","Cornwall 042A","E01018823","Total",1464,323,187,136,1141,64,224,232,244,27,116,234
"2011","Cornwall 042B","E01018824","Total",2553,263,146,117,2290,130,346,658,314,170,291,381
"2011","Cornwall 042C","E01018853","Total",2499,246,101,145,2253,185,222,526,394,150,284,492
"2011","Cornwall 042D","E01018854","Total",1344,200,104,96,1144,105,136,268,190,74,114,257
"2011","Cornwall 043A","E01018819","Total",1475,185,55,130,1290,84,146,306,332,61,122,239
"2011","Cornwall 043B","E01018822","Total",1234,128,76,52,1106,46,194,199,202,97,111,257
"2011","Cornwall 043C","E01018855","Total",2316,211,88,123,2105,136,218,605,400,116,173,457
"2011","Cornwall 043D","E01018856","Total",1391,213,107,106,1178,52,184,175,268,51,148,300
"2011","Cornwall 043E","E01018857","Total",1173,175,82,93,998,91,186,217,176,37,113,178
"2011","Cornwall 043F","E01018858","Total",1400,204,125,79,1196,52,282,268,182,81,103,228
"2011","Cornwall 044A","E01018807","Total",1303,211,113,98,1092,48,230,172,266,51,92,233
"2011","Cornwall 044B","E01018808","Total",1451,219,100,119,1232,51,162,303,266,89,126,235
"2011","Cornwall 044C","E01018809","Total",1951,635,295,340,1316,116,160,304,394,41,99,202
"2011","Cornwall 044D","E01018810","Total",1354,157,61,96,1197,40,150,292,270,76,112,257
"2011","Cornwall 047A","E01018816","Total",1683,181,124,57,1502,11,452,284,230,101,131,293
"2011","Cornwall 047B","E01018817","Total",2049,248,149,99,1801,59,386,367,298,87,237,367
"2011","Cornwall 047C","E01018818","Total",1616,203,150,53,1413,32,416,230,192,92,148,303
"2011","Cornwall 047D","E01018820","Total",1806,210,100,110,1596,66,220,389,312,101,203,305
"2011","Cornwall 047E","E01018821","Total",1227,115,44,71,1112,49,140,224,218,85,151,245
"2011","Cornwall 048A","E01018845","Total",1578,208,124,84,1370,37,200,333,244,139,177,240
"2011","Cornwall 048B","E01018846","Total",1321,181,87,94,1140,35,250,221,248,53,104,229
"2011","Cornwall 048C","E01018848","Total",1614,203,110,93,1411,57,238,365,252,72,182,245
"2011","Cornwall 048D","E01018849","Total",1857,370,226,144,1487,56,418,184,328,89,160,252
"2011","Cornwall 048E","E01018850","Total",1334,169,97,72,1165,33,286,204,192,71,138,241
"2011","Cornwall 056A","E01018827","Total",1503,189,119,70,1314,35,340,208,222,31,160,318
"2011","Cornwall 056B","E01018828","Total",1489,218,125,93,1271,46,326,238,238,57,130,236
"2011","Cornwall 056C","E01018829","Total",1353,110,45,65,1243,46,206,228,236,53,194,280
"2011","Cornwall 056D","E01018830","Total",1459,219,134,85,1240,35,328,201,208,102,89,277
"2011","Cornwall 060A","E01018834","Total",1798,165,73,92,1633,80,250,403,246,105,186,363
"2011","Cornwall 060B","E01018835","Total",1758,214,68,146,1544,119,192,305,326,70,184,348
"2011","Cornwall 060C","E01018836","Total",1580,313,106,207,1267,146,94,218,260,70,141,338
"2011","Cornwall 060D","E01018837","Total",1957,284,98,186,1673,90,276,327,458,77,134,311
"2011","Cornwall 062A","E01018838","Total",1557,184,100,84,1373,65,202,221,170,86,189,440
"2011","Cornwall 062B","E01018839","Total",1178,238,92,146,940,40,136,151,270,32,77,234
"2011","Cornwall 062C","E01018840","Total",1636,234,79,155,1402,54,124,188,274,47,99,616
"2011","Cornwall 062D","E01018841","Total",1435,147,78,69,1288,181,148,171,210,77,191,310
"2011","Cornwall 062E","E01018860","Total",1919,273,170,103,1646,133,254,321,222,112,263,341
"2011","Cornwall 063A","E01018803","Total",1748,523,181,342,1225,23,252,158,272,63,67,390
"2011","Cornwall 063B","E01018804","Total",1876,250,79,171,1626,59,76,217,288,61,101,824
"2011","Cornwall 063C","E01018805","Total",1458,221,137,84,1237,38,284,230,272,37,107,269
"2011","Cornwall 063D","E01018806","Total",1532,213,103,110,1319,67,114,235,232,52,78,541
"2011","Cornwall 064A","E01018811","Total",1490,159,86,73,1331,74,212,352,214,51,148,280
"2011","Cornwall 064B","E01018812","Total",1374,186,92,94,1188,86,126,325,236,73,104,238
"2011","Cornwall 064C","E01018813","Total",1424,167,83,84,1257,48,148,331,244,88,127,271
"2011","Cornwall 064D","E01018814","Total",1437,154,80,74,1283,76,186,294,194,36,169,328
"2011","Cornwall 064E","E01018859","Total",1731,218,138,80,1513,18,364,228,246,85,141,431
"2011","Cornwall 045A","E01018889","Total",1334,135,77,58,1199,38,168,275,228,62,161,267
"2011","Cornwall 045B","E01018890","Total",1420,164,96,68,1256,31,274,207,266,80,119,279
"2011","Cornwall 045C","E01018891","Total",1297,156,68,88,1141,128,206,235,256,37,81,198
"2011","Cornwall 045D","E01018892","Total",1336,166,85,81,1170,38,180,267,260,61,154,210
"2011","Cornwall 045E","E01018893","Total",1353,212,134,78,1141,58,218,213,192,75,117,268
"2011","Cornwall 046A","E01018908","Total",1668,184,90,94,1484,102,258,250,254,78,192,350
"2011","Cornwall 046B","E01018909","Total",1591,204,87,117,1387,104,150,431,292,77,128,205
"2011","Cornwall 046C","E01018910","Total",1861,262,122,140,1599,219,150,294,222,185,228,301
"2011","Cornwall 046D","E01018911","Total",1620,388,160,228,1232,86,156,311,292,69,131,187
"2011","Cornwall 049A","E01018912","Total",1443,170,85,85,1273,45,246,298,252,67,134,231
"2011","Cornwall 049B","E01018913","Total",1760,272,76,196,1488,89,122,475,300,64,192,246
"2011","Cornwall 049C","E01018914","Total",1873,237,95,142,1636,69,236,355,352,110,181,333
"2011","Cornwall 049D","E01018915","Total",1987,241,123,118,1746,149,274,387,366,106,182,282
"2011","Cornwall 050A","E01018916","Total",1328,122,56,66,1206,48,172,298,256,54,176,202
"2011","Cornwall 050B","E01018917","Total",1370,164,92,72,1206,38,220,306,236,60,121,225
"2011","Cornwall 050C","E01018918","Total",1771,229,138,91,1542,70,222,372,312,81,211,274
"2011","Cornwall 050D","E01018919","Total",1347,182,100,82,1165,39,240,234,248,64,97,243
"2011","Cornwall 051A","E01018894","Total",1778,203,76,127,1575,79,166,362,322,135,188,323
"2011","Cornwall 051B","E01018895","Total",1674,156,63,93,1518,54,214,334,284,95,223,314
"2011","Cornwall 051C","E01018896","Total",1528,178,86,92,1350,40,250,279,228,77,232,244
"2011","Cornwall 051D","E01018897","Total",1416,228,65,163,1188,78,126,278,256,62,152,236
"2011","Cornwall 051E","E01018898","Total",1290,193,78,115,1097,134,92,256,174,102,132,207
"2011","Cornwall 052A","E01018865","Total",1900,245,74,171,1655,160,222,354,316,141,217,245
"2011","Cornwall 052B","E01018866","Total",1585,210,114,96,1375,81,270,296,272,46,136,274
"2011","Cornwall 052C","E01018867","Total",1888,220,105,115,1668,187,184,343,296,133,206,319
"2011","Cornwall 052D","E01018868","Total",1768,236,97,139,1532,153,186,368,250,134,171,270
"2011","Cornwall 053A","E01018874","Total",1297,172,103,69,1125,44,282,207,192,60,114,226
"2011","Cornwall 053B","E01018875","Total",1346,249,168,81,1097,105,182,235,172,107,134,162
"2011","Cornwall 053C","E01018876","Total",1389,148,67,81,1241,69,178,278,226,81,163,246
"2011","Cornwall 053D","E01018877","Total",1420,178,118,60,1242,22,346,165,172,45,175,317
"2011","Cornwall 053E","E01018878","Total",1404,319,155,164,1085,111,132,212,198,79,99,254
"2011","Cornwall 055A","E01018869","Total",1570,173,79,94,1397,99,234,332,256,79,160,237
"2011","Cornwall 055B","E01018870","Total",1293,130,56,74,1163,135,76,237,142,146,205,222
"2011","Cornwall 055C","E01018871","Total",1657,171,99,72,1486,61,250,312,320,71,167,305
"2011","Cornwall 055D","E01018872","Total",1250,143,56,87,1107,64,188,254,182,58,121,240
"2011","Cornwall 055E","E01018873","Total",1297,119,58,61,1178,102,154,267,180,118,166,191
"2011","Cornwall 059A","E01018863","Total",1652,160,74,86,1492,63,176,408,250,99,178,318
"2011","Cornwall 059B","E01018864","Total",1639,154,86,68,1485,37,238,303,290,110,208,299
"2011","Cornwall 059C","E01018921","Total",2101,205,103,102,1896,72,302,386,388,91,267,390
"2011","Cornwall 059D","E01018922","Total",2372,200,89,111,2172,54,302,368,402,166,408,472
"2011","Cornwall 066A","E01018879","Total",1727,231,149,82,1496,27,426,260,282,61,84,356
"2011","Cornwall 066B","E01018880","Total",2110,294,173,121,1816,65,336,351,304,176,239,345
"2011","Cornwall 066C","E01018899","Total",1448,165,98,67,1283,44,252,214,244,71,159,299
"2011","Cornwall 066D","E01018900","Total",1486,167,94,73,1319,25,242,268,284,76,148,276
"2011","Cornwall 066E","E01018901","Total",1651,207,107,100,1444,41,292,296,234,89,232,260
"2011","Cornwall 071A","E01018882","Total",1521,114,58,56,1407,82,224,346,266,52,178,259
"2011","Cornwall 071B","E01018883","Total",1561,151,78,73,1410,68,216,331,280,106,148,261
"2011","Cornwall 071C","E01018884","Total",1654,141,83,58,1513,121,248,380,284,76,145,259
"2011","Cornwall 071D","E01018885","Total",1453,229,106,123,1224,96,200,273,280,50,115,210
"2011","Cornwall 071E","E01018886","Total",1946,147,66,81,1799,66,154,736,300,206,148,189
"2011","Cornwall 071F","E01018887","Total",1586,167,61,106,1419,130,140,343,252,158,176,220
"2011","Cornwall 071G","E01018888","Total",1912,329,162,167,1583,171,278,361,314,104,150,205
"2011","Cornwall 072A","E01018861","Total",1434,170,90,80,1264,24,222,273,226,68,149,302
"2011","Cornwall 072B","E01018862","Total",1384,162,91,71,1222,19,304,184,266,79,111,259
"2011","Cornwall 072C","E01018905","Total",1316,160,93,67,1156,48,212,187,222,84,136,267
"2011","Cornwall 072D","E01018906","Total",1225,188,107,81,1037,53,222,205,188,77,88,204
"2011","Cornwall 072E","E01018907","Total",1226,215,116,99,1011,66,222,188,206,72,111,146
"2011","Cornwall 073A","E01018881","Total",1842,234,123,111,1608,59,356,243,290,91,204,365
"2011","Cornwall 073B","E01018902","Total",1183,127,73,54,1056,36,200,285,214,48,70,203
"2011","Cornwall 073C","E01018903","Total",1026,121,65,56,905,33,182,195,178,85,83,149
"2011","Cornwall 073D","E01018904","Total",2091,278,174,104,1813,79,412,292,366,147,178,339
"2011","Cornwall 073E","E01018920","Total",2008,251,146,105,1757,66,418,305,290,78,206,394
"2011","Cornwall 001A","E01018936","Total",1495,270,117,153,1225,43,224,261,262,47,179,209
"2011","Cornwall 001B","E01018937","Total",1874,190,79,111,1684,167,212,453,308,96,230,218
"2011","Cornwall 001C","E01018938","Total",1641,321,214,107,1320,64,326,262,252,76,119,221
"2011","Cornwall 001D","E01018959","Total",1387,225,136,89,1162,30,392,213,222,25,112,168
"2011","Cornwall 001E","E01018960","Total",1891,205,102,103,1686,116,282,401,318,124,184,261
"2011","Cornwall 001F","E01018961","Total",1428,276,123,153,1152,63,278,232,232,59,103,185
"2011","Cornwall 002A","E01018943","Total",2116,227,108,119,1889,32,354,410,380,147,216,350
"2011","Cornwall 002B","E01018951","Total",2227,250,142,108,1977,63,396,318,376,176,249,399
"2011","Cornwall 002C","E01018974","Total",2454,234,123,111,2220,59,372,390,416,189,237,557
"2011","Cornwall 003A","E01018940","Total",1538,207,101,106,1331,53,294,268,250,83,137,246
"2011","Cornwall 003B","E01018941","Total",1544,218,99,119,1326,64,228,325,244,99,149,217
"2011","Cornwall 003C","E01018942","Total",1459,238,111,127,1221,54,296,200,240,73,140,218
"2011","Cornwall 003D","E01018969","Total",2209,296,161,135,1913,66,446,342,420,113,147,379
"2011","Cornwall 004B","E01018953","Total",1209,110,60,50,1099,15,232,224,200,57,154,217
"2011","Cornwall 004C","E01018968","Total",2440,210,119,91,2230,52,422,434,466,102,327,427
"2011","Cornwall 004D","E01033291","Total",1573,156,81,75,1417,50,312,228,250,91,189,297
"2011","Cornwall 004E","E01033292","Total",1349,170,75,95,1179,131,106,306,232,121,135,148
"2011","Cornwall 005A","E01018946","Total",1468,221,132,89,1247,38,270,254,246,101,87,251
"2011","Cornwall 005B","E01018947","Total",2850,320,121,199,2530,193,256,664,508,228,264,417
"2011","Cornwall 005C","E01018948","Total",1632,209,82,127,1423,102,212,275,278,128,157,271
"2011","Cornwall 005D","E01018949","Total",1402,123,53,70,1279,114,90,322,176,181,199,197
"2011","Cornwall 005E","E01018950","Total",1625,367,136,231,1258,91,170,240,358,47,150,202
"2011","Cornwall 006A","E01018925","Total",2092,246,109,137,1846,39,398,344,370,102,217,376
"2011","Cornwall 006B","E01018952","Total",1162,120,71,49,1042,39,248,224,190,47,95,199
"2011","Cornwall 006C","E01018965","Total",2318,263,146,117,2055,57,436,362,390,137,248,425
"2011","Cornwall 006D","E01018966","Total",1086,101,57,44,985,12,198,161,242,16,125,231
"2011","Cornwall 006E","E01018967","Total",1291,128,65,63,1163,25,180,232,252,108,134,232
"2011","Cornwall 007A","E01018924","Total",1118,127,73,54,991,25,162,191,168,65,150,230
"2011","Cornwall 007B","E01018962","Total",2046,298,163,135,1748,51,372,383,326,88,169,359
"2011","Cornwall 007E","E01033289","Total",2093,365,225,140,1728,50,482,277,276,171,162,310
"2011","Cornwall 008A","E01018954","Total",1227,104,47,57,1123,75,112,325,196,115,134,166
"2011","Cornwall 008B","E01018955","Total",1543,203,102,101,1340,48,316,297,198,104,113,264
"2011","Cornwall 008C","E01018956","Total",1076,136,85,51,940,22,252,149,138,61,112,206
"2011","Cornwall 008D","E01018957","Total",1280,146,74,72,1134,73,204,223,190,51,174,219
"2011","Cornwall 008E","E01018958","Total",1307,258,148,110,1049,39,224,185,190,57,139,215
"2011","Cornwall 009A","E01018970","Total",1521,159,89,70,1362,70,232,317,220,52,174,297
"2011","Cornwall 009B","E01018971","Total",1872,282,178,104,1590,81,352,377,250,61,198,271
"2011","Cornwall 009C","E01018972","Total",1749,327,171,156,1422,100,246,276,274,79,169,278
"2011","Cornwall 009D","E01018973","Total",1387,219,112,107,1168,90,202,264,208,63,99,242
"2011","Cornwall 011A","E01018923","Total",1235,136,70,66,1099,42,264,239,172,76,121,185
"2011","Cornwall 011B","E01018926","Total",2335,278,139,139,2057,49,472,359,402,102,259,414
"2011","Cornwall 011C","E01018944","Total",1148,91,46,45,1057,27,172,194,182,62,140,280
"2011","Cornwall 011D","E01018945","Total",1264,144,81,63,1120,32,234,227,168,61,109,289
"2011","Cornwall 014A","E01018932","Total",1633,203,76,127,1430,124,192,301,294,54,195,270
"2011","Cornwall 014B","E01018933","Total",1384,269,76,193,1115,99,146,191,238,71,153,217
"2011","Cornwall 014C","E01018934","Total",1988,179,98,81,1809,53,326,379,318,115,222,396
"2011","Cornwall 014D","E01018935","Total",2259,217,83,134,2042,167,270,561,358,159,210,317
"2011","Cornwall 015A","E01018927","Total",1554,197,101,96,1357,68,156,297,238,133,192,273
"2011","Cornwall 015B","E01018928","Total",1697,310,122,188,1387,123,140,350,272,118,119,265
"2011","Cornwall 015C","E01018929","Total",1215,162,88,74,1053,60,198,234,184,53,140,184
"2011","Cornwall 015D","E01018930","Total",1570,217,76,141,1353,194,86,310,232,181,136,214
"2011","Cornwall 015E","E01018931","Total",1175,121,75,46,1054,53,240,225,164,71,99,202
"2011","Cornwall 054A","E01019008","Total",1374,220,110,110,1154,104,176,218,240,28,133,255
"2011","Cornwall 054B","E01019009","Total",1517,157,67,90,1360,94,152,312,194,139,193,276
"2011","Cornwall 054C","E01019010","Total",1362,153,82,71,1209,72,212,230,172,72,160,291
"2011","Cornwall 054D","E01019011","Total",1350,182,93,89,1168,39,294,211,260,25,111,228
"2011","Cornwall 054E","E01019012","Total",1740,525,235,290,1215,49,310,206,300,20,102,228
"2011","Cornwall 057A","E01018978","Total",1481,177,86,91,1304,50,218,264,242,120,146,264
"2011","Cornwall 057B","E01018981","Total",2012,297,162,135,1715,51,340,379,314,63,213,355
"2011","Cornwall 057C","E01018982","Total",2139,278,138,140,1861,141,228,482,350,124,254,282
"2011","Cornwall 057D","E01018983","Total",1532,194,105,89,1338,54,328,241,232,67,141,275
"2011","Cornwall 057E","E01018984","Total",2061,316,153,163,1745,180,216,378,246,116,262,347
"2011","Cornwall 058A","E01018985","Total",2185,278,140,138,1907,112,426,350,404,62,193,360
"2011","Cornwall 058B","E01018986","Total",1475,280,160,120,1195,46,338,252,260,26,108,165
"2011","Cornwall 058C","E01018987","Total",2076,251,120,131,1825,40,366,397,370,91,192,369
"2011","Cornwall 061A","E01018975","Total",1911,222,125,97,1689,92,340,430,270,88,175,294
"2011","Cornwall 061B","E01018979","Total",1317,138,51,87,1179,50,190,244,214,82,167,232
"2011","Cornwall 061C","E01018980","Total",1323,165,84,81,1158,50,210,259,236,78,149,176
"2011","Cornwall 061D","E01018990","Total",1753,331,189,142,1422,92,366,281,254,93,103,233
"2011","Cornwall 061E","E01019007","Total",2178,222,99,123,1956,97,318,406,374,129,238,394
"2011","Cornwall 065A","E01018988","Total",1500,191,109,82,1309,71,236,276,276,47,124,279
"2011","Cornwall 065B","E01018989","Total",1695,202,98,104,1493,74,230,290,274,90,164,371
"2011","Cornwall 065C","E01018991","Total",1518,211,110,101,1307,102,206,252,278,42,168,259
"2011","Cornwall 065D","E01019006","Total",1557,192,94,98,1365,34,264,249,278,90,153,297
"2011","Cornwall 067A","E01018976","Total",2092,306,185,121,1786,81,382,391,400,94,131,307
"2011","Cornwall 067B","E01018977","Total",1411,188,88,100,1223,142,148,273,182,67,183,228
"2011","Cornwall 067C","E01018994","Total",1601,275,162,113,1326,78,328,210,272,74,123,241
"2011","Cornwall 067D","E01018996","Total",1531,337,129,208,1194,84,190,263,212,118,155,172
"2011","Cornwall 067E","E01018997","Total",1471,162,70,92,1309,158,104,306,160,110,270,201
"2011","Cornwall 068A","E01018995","Total",1989,500,199,301,1489,150,236,244,324,101,154,280
"2011","Cornwall 068B","E01018998","Total",1434,254,74,180,1180,142,108,341,290,60,80,159
"2011","Cornwall 068C","E01018999","Total",1422,419,185,234,1003,90,122,246,266,25,87,167
"2011","Cornwall 068D","E01019001","Total",1631,496,233,263,1135,98,208,223,284,31,83,208
"2011","Cornwall 069A","E01018992","Total",1567,236,107,129,1331,65,226,222,318,73,123,304
"2011","Cornwall 069B","E01018993","Total",1626,326,136,190,1300,119,174,254,278,57,140,278
"2011","Cornwall 069C","E01019005","Total",2030,277,132,145,1753,73,320,371,372,131,169,317
"2011","Cornwall 070A","E01019000","Total",1370,240,158,82,1130,60,362,169,192,48,79,220
"2011","Cornwall 070B","E01019002","Total",1380,268,143,125,1112,63,312,193,216,46,62,220
"2011","Cornwall 070C","E01019003","Total",1687,221,108,113,1466,62,330,241,352,79,151,251
"2011","Cornwall 070D","E01019004","Total",1590,281,136,145,1309,165,222,228,234,84,138,238
"2011","Cornwall 018A","E01019048","Total",1734,250,118,132,1484,51,274,246,366,101,110,336
"2011","Cornwall 018B","E01019049","Total",1751,209,77,132,1542,74,212,398,332,86,193,247
"2011","Cornwall 018C","E01019050","Total",1366,150,71,79,1216,38,234,259,272,47,214,152
"2011","Cornwall 018D","E01019051","Total",1583,236,136,100,1347,120,216,343,210,38,123,297
"2011","Cornwall 019A","E01019060","Total",1492,152,76,76,1340,37,270,282,226,67,130,328
"2011","Cornwall 019B","E01019061","Total",1713,189,76,113,1524,70,238,410,282,87,182,255
"2011","Cornwall 019C","E01019062","Total",1917,199,97,102,1718,150,198,415,330,127,213,285
"2011","Cornwall 019D","E01019063","Total",1934,174,72,102,1760,99,234,434,378,78,184,353
"2011","Cornwall 019E","E01019064","Total",1928,202,85,117,1726,97,216,420,274,100,261,358
"2011","Cornwall 019F","E01019065","Total",1326,120,57,63,1206,75,164,267,196,101,148,255
"2011","Cornwall 020A","E01019028","Total",1997,383,152,231,1614,141,156,347,382,100,197,291
"2011","Cornwall 020B","E01019029","Total",1368,307,131,176,1061,83,94,232,278,46,81,247
"2011","Cornwall 020C","E01019030","Total",1754,192,69,123,1562,95,216,367,324,95,124,341
"2011","Cornwall 020D","E01019031","Total",1481,261,104,157,1220,73,242,287,302,51,118,147
"2011","Cornwall 021A","E01019018","Total",1598,141,94,47,1457,46,310,308,206,73,152,362
"2011","Cornwall 021B","E01019019","Total",1366,223,116,107,1143,51,230,162,224,51,181,244
"2011","Cornwall 021C","E01019020","Total",1414,298,46,252,1116,96,100,175,256,77,136,276
"2011","Cornwall 021D","E01019021","Total",1486,174,91,83,1312,71,240,272,264,50,162,253
"2011","Cornwall 021E","E01019022","Total",1695,252,120,132,1443,163,214,295,278,63,127,303
"2011","Cornwall 021F","E01019023","Total",1596,119,36,83,1477,152,118,414,286,93,117,297
"2011","Cornwall 024A","E01019052","Total",1771,180,83,97,1591,82,202,378,294,110,180,345
"2011","Cornwall 024B","E01019053","Total",1942,227,81,146,1715,89,274,426,366,116,160,284
"2011","Cornwall 024C","E01019054","Total",1816,161,82,79,1655,61,264,371,334,98,231,296
"2011","Cornwall 024D","E01019055","Total",1484,133,74,59,1351,116,148,299,222,128,174,264
"2011","Cornwall 027A","E01019035","Total",1452,289,163,126,1163,53,262,235,232,57,116,208
"2011","Cornwall 027B","E01019036","Total",1667,184,80,104,1483,45,300,280,328,75,164,291
"2011","Cornwall 027C","E01019037","Total",1448,163,90,73,1285,70,210,299,204,67,191,244
"2011","Cornwall 027D","E01019074","Total",1775,177,63,114,1598,96,180,381,310,119,259,253
"2011","Cornwall 027E","E01019075","Total",1720,162,74,88,1558,68,174,352,330,90,268,276
"2011","Cornwall 027F","E01019076","Total",1868,173,67,106,1695,152,210,393,252,174,238,276
"2011","Cornwall 030A","E01019069","Total",1308,126,49,77,1182,85,108,309,244,99,115,222
"2011","Cornwall 030B","E01019070","Total",1999,258,111,147,1741,119,260,330,334,151,257,290
"2011","Cornwall 030C","E01019071","Total",1580,114,55,59,1466,33,212,322,252,116,245,286
"2011","Cornwall 030D","E01019072","Total",1513,160,89,71,1353,74,166,307,206,120,210,270
"2011","Cornwall 030E","E01019073","Total",1415,115,65,50,1300,57,244,250,242,121,138,248
"2011","Cornwall 031A","E01019056","Total",1551,169,92,77,1382,188,116,307,174,142,256,199
"2011","Cornwall 031B","E01019057","Total",1849,232,98,134,1617,125,198,395,322,77,227,273
"2011","Cornwall 031C","E01019058","Total",1768,196,88,108,1572,69,236,410,286,113,169,289
"2011","Cornwall 031D","E01019059","Total",1550,209,120,89,1341,102,252,260,226,84,153,264
"2011","Cornwall 035A","E01019024","Total",1397,170,96,74,1227,86,194,247,232,62,151,255
"2011","Cornwall 035B","E01019025","Total",1326,168,99,69,1158,48,322,200,242,55,112,179
"2011","Cornwall 035C","E01019026","Total",1444,203,135,68,1241,36,264,229,220,91,158,243
"2011","Cornwall 035D","E01019027","Total",1455,265,148,117,1190,50,296,264,250,48,94,188
"2011","Cornwall 036A","E01019013","Total",2191,254,138,116,1937,132,362,450,292,119,247,335
"2011","Cornwall 036B","E01019014","Total",1377,126,71,55,1251,58,226,220,220,56,153,318
"2011","Cornwall 036C","E01019015","Total",1432,150,60,90,1282,46,206,306,202,88,137,297
"2011","Cornwall 036D","E01019016","Total",1881,110,30,80,1771,110,158,566,342,143,215,237
"2011","Cornwall 036E","E01019017","Total",2302,292,168,124,2010,83,614,371,382,87,175,298
"2011","Cornwall 038A","E01019032","Total",1413,160,77,83,1253,54,220,274,260,62,156,227
"2011","Cornwall 038B","E01019034","Total",1474,174,68,106,1300,92,154,335,252,68,135,264
"2011","Cornwall 038C","E01019045","Total",2064,221,92,129,1843,102,248,447,384,77,267,318
"2011","Cornwall 038D","E01019047","Total",1066,172,93,79,894,46,170,133,146,60,131,208
"2011","Cornwall 039A","E01019033","Total",1375,330,147,183,1045,109,154,211,188,121,88,174
"2011","Cornwall 039B","E01019041","Total",1649,305,131,174,1344,140,166,306,228,140,172,192
"2011","Cornwall 039C","E01019042","Total",1679,258,101,157,1421,122,176,271,270,82,186,314
"2011","Cornwall 039D","E01019043","Total",1503,208,102,106,1295,43,292,231,210,74,138,307
"2011","Cornwall 039E","E01019044","Total",1485,239,154,85,1246,52,356,243,234,21,94,246
"2011","Cornwall 039F","E01019046","Total",1367,193,116,77,1174,78,138,244,200,53,165,296
"2011","Cornwall 041A","E01019038","Total",1062,221,120,101,841,20,248,159,180,41,81,112
"2011","Cornwall 041B","E01019039","Total",1345,172,104,68,1173,27,290,188,208,100,150,210
"2011","Cornwall 041C","E01019040","Total",1213,155,75,80,1058,60,240,136,226,73,120,203
"2011","Cornwall 041D","E01019066","Total",1167,136,65,71,1031,28,200,212,194,59,148,190
"2011","Cornwall 041E","E01019067","Total",1097,150,91,59,947,21,228,192,186,48,118,154
"2011","Cornwall 041F","E01019068","Total",1604,203,135,68,1401,45,394,288,230,55,163,226
"2011","Isles of Scilly 001A","E01019077","Total",2123,336,150,186,1787,53,358,490,382,81,107,316
"2011","North Somerset 001B","E01014790","Total",1436,166,97,69,1270,40,258,295,248,71,126,232
"2011","North Somerset 001C","E01014795","Total",1366,205,77,128,1161,111,150,283,202,50,163,202
"2011","North Somerset 001D","E01014797","Total",1727,222,114,108,1505,73,226,336,266,101,162,341
"2011","North Somerset 001E","E01032675","Total",1355,208,38,170,1147,92,90,390,358,40,68,109
"2011","North Somerset 001F","E01032676","Total",1334,321,74,247,1013,51,168,234,374,36,78,72
"2011","North Somerset 001G","E01032681","Total",1232,278,196,82,954,48,186,299,170,35,63,153
"2011","North Somerset 002A","E01014789","Total",1287,189,99,90,1098,21,318,176,234,70,88,191
"2011","North Somerset 002B","E01014793","Total",1512,173,85,88,1339,54,284,405,260,51,100,185
"2011","North Somerset 002C","E01014794","Total",1643,187,128,59,1456,37,404,291,302,60,103,259
"2011","North Somerset 002D","E01014798","Total",1532,96,54,42,1436,34,248,325,218,112,159,340
"2011","North Somerset 003B","E01014792","Total",1818,330,201,129,1488,60,330,296,338,105,130,229
"2011","North Somerset 003C","E01014796","Total",1663,217,116,101,1446,36,302,327,260,107,136,278
"2011","North Somerset 003D","E01032677","Total",1365,167,45,122,1198,131,40,507,264,77,99,80
"2011","North Somerset 003E","E01032678","Total",1589,79,9,70,1510,61,68,666,258,176,141,140
"2011","North Somerset 003F","E01032682","Total",1059,102,37,65,957,97,84,382,144,52,76,122
"2011","North Somerset 004A","E01014766","Total",1267,162,74,88,1105,36,240,240,214,76,123,176
"2011","North Somerset 004B","E01014767","Total",1303,140,87,53,1163,11,328,246,176,67,66,269
"2011","North Somerset 004C","E01014786","Total",1596,235,117,118,1361,99,234,287,250,112,121,258
"2011","North Somerset 004D","E01014787","Total",1892,222,103,119,1670,68,274,475,328,92,151,282
"2011","North Somerset 005A","E01014752","Total",1510,155,81,74,1355,67,202,329,294,72,93,298
"2011","North Somerset 005B","E01014754","Total",1114,293,129,164,821,51,200,146,282,15,50,77
"2011","North Somerset 005C","E01014758","Total",1199,114,51,63,1085,13,292,218,180,58,128,196
"2011","North Somerset 005D","E01014759","Total",1353,142,116,26,1211,20,342,241,214,62,99,233
"2011","North Somerset 006B","E01014849","Total",1547,166,98,68,1381,28,362,370,246,46,105,224
"2011","North Somerset 006C","E01014850","Total",2043,193,96,97,1850,64,276,538,330,169,190,283
"2011","North Somerset 006D","E01014851","Total",2559,289,121,168,2270,152,302,850,422,156,133,255
"2011","North Somerset 006E","E01014852","Total",1554,127,52,75,1427,52,170,433,258,80,144,290
"2011","North Somerset 006F","E01032674","Total",2483,162,59,103,2321,125,224,939,436,195,166,236
"2011","North Somerset 006G","E01032680","Total",1832,182,113,69,1650,33,418,300,320,63,187,329
"2011","North Somerset 007A","E01014750","Total",1547,278,115,163,1269,70,184,315,314,94,116,176
"2011","North Somerset 007B","E01014751","Total",1584,258,138,120,1326,94,200,279,222,111,144,276
"2011","North Somerset 007C","E01014753","Total",1777,285,138,147,1492,110,200,423,288,93,119,259
"2011","North Somerset 007D","E01014755","Total",1165,289,142,147,876,10,234,180,206,47,53,146
"2011","North Somerset 007E","E01014760","Total",1457,168,95,73,1289,40,270,279,232,72,152,244
"2011","North Somerset 008A","E01014780","Total",1545,255,140,115,1290,89,262,264,206,101,145,223
"2011","North Somerset 008B","E01014781","Total",1605,323,203,120,1282,84,290,300,218,83,110,197
"2011","North Somerset 008C","E01014782","Total",1391,147,89,58,1244,34,302,287,208,62,73,278
"2011","North Somerset 008D","E01014783","Total",1549,273,115,158,1276,67,180,243,294,66,167,259
"2011","North Somerset 008E","E01014784","Total",1569,219,155,64,1350,57,288,320,216,84,118,267
"2011","North Somerset 008F","E01014785","Total",1386,106,79,27,1280,24,308,200,264,41,126,317
"2011","North Somerset 009A","E01014775","Total",1231,99,49,50,1132,46,134,291,222,61,75,303
"2011","North Somerset 009B","E01014776","Total",1317,89,40,49,1228,47,154,304,190,98,116,319
"2011","North Somerset 009C","E01014777","Total",1547,162,83,79,1385,70,186,483,206,101,118,221
"2011","North Somerset 009D","E01014778","Total",1298,92,67,25,1206,21,282,217,242,54,88,302
"2011","North Somerset 009E","E01014779","Total",1153,127,76,51,1026,46,194,150,180,80,110,266
"2011","North Somerset 010A","E01014756","Total",1622,297,95,202,1325,86,206,297,250,77,158,251
"2011","North Somerset 010B","E01014757","Total",1473,155,66,89,1318,74,154,378,280,53,129,250
"2011","North Somerset 010C","E01014761","Total",1614,233,104,129,1381,64,198,361,290,80,104,284
"2011","North Somerset 010D","E01014762","Total",1437,160,81,79,1277,56,174,311,272,92,133,239
"2011","North Somerset 010E","E01014763","Total",1821,176,54,122,1645,109,114,494,286,124,207,311
"2011","North Somerset 011A","E01014737","Total",1507,137,114,23,1370,30,274,293,204,118,201,250
"2011","North Somerset 011B","E01014738","Total",1457,121,68,53,1336,85,172,409,180,101,160,229
"2011","North Somerset 011C","E01014739","Total",1462,117,72,45,1345,47,294,208,226,98,180,292
"2011","North Somerset 011D","E01014740","Total",1321,115,54,61,1206,64,188,357,176,71,142,208
"2011","North Somerset 012A","E01014855","Total",1406,118,64,54,1288,25,260,293,244,45,123,298
"2011","North Somerset 012B","E01014856","Total",1536,121,60,61,1415,74,182,351,224,102,185,297
"2011","North Somerset 012C","E01014857","Total",1521,134,71,63,1387,55,242,362,226,98,163,241
"2011","North Somerset 012D","E01014858","Total",1717,183,42,141,1534,82,158,376,374,103,188,253
"2011","North Somerset 012E","E01014859","Total",1514,178,90,88,1336,67,216,341,206,87,150,269
"2011","North Somerset 012F","E01014860","Total",1483,185,93,92,1298,73,178,281,204,85,146,331
"2011","North Somerset 013A","E01014847","Total",1713,155,77,78,1558,48,238,370,272,112,197,321
"2011","North Somerset 013B","E01014848","Total",1268,131,58,73,1137,27,190,233,192,52,143,300
"2011","North Somerset 013C","E01014853","Total",1645,248,143,105,1397,58,266,378,216,117,128,234
"2011","North Somerset 013D","E01014854","Total",1348,115,59,56,1233,20,274,236,196,98,154,255
"2011","North Somerset 014A","E01014764","Total",1606,192,111,81,1414,68,262,316,244,84,119,321
"2011","North Somerset 014B","E01014765","Total",1838,154,80,74,1684,91,308,336,294,122,183,350
"2011","North Somerset 014C","E01014773","Total",1690,124,34,90,1566,68,128,471,298,84,248,269
"2011","North Somerset 014D","E01014774","Total",1583,191,100,91,1392,51,256,210,320,89,159,307
"2011","North Somerset 015A","E01014821","Total",1218,128,42,86,1090,108,72,343,208,56,95,208
"2011","North Somerset 015B","E01014822","Total",1474,75,26,49,1399,66,148,459,244,81,160,241
"2011","North Somerset 015C","E01014823","Total",1292,104,60,44,1188,69,116,287,218,63,142,293
"2011","North Somerset 015D","E01014824","Total",1457,182,90,92,1275,63,204,299,288,79,101,241
"2011","North Somerset 015E","E01014825","Total",1226,98,54,44,1128,50,186,222,204,101,127,238
"2011","North Somerset 015F","E01014826","Total",1573,171,56,115,1402,142,86,451,224,71,178,250
"2011","North Somerset 015G","E01014827","Total",1359,201,72,129,1158,134,94,327,216,52,150,185
"2011","North Somerset 016A","E01014817","Total",1520,199,107,92,1321,62,348,314,244,57,129,167
"2011","North Somerset 016B","E01014820","Total",1392,309,228,81,1083,63,290,190,190,67,75,208
"2011","North Somerset 016C","E01014835","Total",1414,251,160,91,1163,102,170,236,182,103,146,224
"2011","North Somerset 016D","E01014836","Total",1468,203,122,81,1265,96,230,277,194,89,117,262
"2011","North Somerset 016E","E01014838","Total",1396,154,96,58,1242,107,228,216,206,95,180,210
"2011","North Somerset 016F","E01014840","Total",1390,177,95,82,1213,147,244,242,214,65,117,184
"2011","North Somerset 017A","E01014812","Total",1406,219,133,86,1187,56,290,234,256,58,118,175
"2011","North Somerset 017B","E01014813","Total",1734,208,98,110,1526,109,250,364,226,97,204,276
"2011","North Somerset 017C","E01014815","Total",1340,187,78,109,1153,90,154,274,208,89,140,198
"2011","North Somerset 017D","E01014816","Total",1457,171,108,63,1286,14,326,255,252,84,130,225
"2011","North Somerset 017E","E01014818","Total",1698,189,121,68,1509,25,356,301,312,81,130,304
"2011","North Somerset 017F","E01014819","Total",1531,235,138,97,1296,53,350,212,274,102,97,208
"2011","North Somerset 018A","E01014841","Total",1587,534,147,387,1053,62,204,127,420,30,44,166
"2011","North Somerset 018B","E01014842","Total",1378,443,134,309,935,82,200,187,278,14,46,128
"2011","North Somerset 018C","E01014843","Total",1252,297,110,187,955,52,218,153,248,41,47,196
"2011","North Somerset 018D","E01014844","Total",1180,488,147,341,692,44,118,146,240,20,41,83
"2011","North Somerset 018E","E01014845","Total",1206,196,106,90,1010,26,254,212,206,36,95,181
"2011","North Somerset 018F","E01014846","Total",1382,210,98,112,1172,60,224,200,250,16,176,246
"2011","North Somerset 020A","E01014799","Total",1503,405,91,314,1098,119,124,257,246,42,135,175
"2011","North Somerset 020B","E01014800","Total",1535,419,86,333,1116,161,74,262,218,60,153,188
"2011","North Somerset 020C","E01014801","Total",1330,471,210,261,859,57,228,119,144,45,86,180
"2011","North Somerset 020D","E01014802","Total",1347,423,138,285,924,82,118,141,222,44,97,220
"2011","North Somerset 020E","E01014809","Total",1680,290,75,215,1390,134,186,342,250,98,185,195
"2011","North Somerset 020F","E01014811","Total",1561,297,134,163,1264,86,188,292,234,64,163,237
"2011","North Somerset 021A","E01014829","Total",1793,265,102,163,1528,214,140,340,310,95,187,242
"2011","North Somerset 021B","E01014830","Total",1562,227,55,172,1335,125,104,311,200,114,190,291
"2011","North Somerset 021C","E01014831","Total",1253,228,61,167,1025,193,64,254,144,87,114,169
"2011","North Somerset 021D","E01014832","Total",1418,241,115,126,1177,147,146,222,158,108,152,244
"2011","North Somerset 021E","E01014833","Total",1466,225,85,140,1241,211,132,287,176,92,122,221
"2011","North Somerset 022A","E01014804","Total",1249,251,138,113,998,32,254,201,196,32,107,176
"2011","North Somerset 022B","E01014806","Total",1377,429,185,244,948,92,196,181,184,56,105,134
"2011","North Somerset 022C","E01014807","Total",1613,393,104,289,1220,99,110,271,284,55,152,249
"2011","North Somerset 022D","E01014808","Total",1426,147,73,74,1279,75,216,304,190,68,135,291
"2011","North Somerset 023A","E01014744","Total",1342,163,100,63,1179,41,302,219,242,67,100,208
"2011","North Somerset 023B","E01014746","Total",1410,159,92,67,1251,112,226,242,214,112,132,213
"2011","North Somerset 023C","E01014769","Total",2349,207,99,108,2142,157,300,664,378,170,162,311
"2011","North Somerset 023D","E01014770","Total",1354,159,110,49,1195,29,378,173,270,63,68,214
"2011","North Somerset 023E","E01014771","Total",1383,186,127,59,1197,44,330,190,212,68,93,260
"2011","North Somerset 023F","E01014772","Total",1319,168,104,64,1151,25,322,223,254,30,102,195
"2011","North Somerset 024A","E01014741","Total",1388,237,152,85,1151,55,236,221,202,98,141,198
"2011","North Somerset 024B","E01014742","Total",1416,153,108,45,1263,13,318,248,216,73,144,251
"2011","North Somerset 024C","E01014745","Total",1451,195,140,55,1256,40,298,242,238,55,109,274
"2011","North Somerset 024D","E01014747","Total",1353,153,85,68,1200,28,242,267,250,82,123,208
"2011","North Somerset 024E","E01014748","Total",1097,98,62,36,999,34,192,181,176,70,135,211
"2011","North Somerset 024F","E01014749","Total",1337,77,41,36,1260,55,182,298,238,88,134,265
"2011","North Somerset 025A","E01014803","Total",1445,206,109,97,1239,41,292,224,180,90,157,255
"2011","North Somerset 025B","E01014805","Total",1422,176,125,51,1246,14,508,166,236,37,81,204
"2011","North Somerset 025C","E01014828","Total",1440,154,74,80,1286,199,160,279,150,135,149,214
"2011","North Somerset 025D","E01014834","Total",1393,202,103,99,1191,186,176,229,184,97,95,224
"2011","North Somerset 026A","E01014839","Total",1600,142,57,85,1458,148,130,379,274,125,184,218
"2011","North Somerset 026B","E01032666","Total",1153,110,50,60,1043,49,164,236,214,52,137,191
"2011","North Somerset 026C","E01032667","Total",1089,87,22,65,1002,99,90,332,204,76,100,101
"2011","North Somerset 026D","E01032668","Total",1496,155,11,144,1341,156,50,492,260,133,118,132
"2011","North Somerset 026E","E01032672","Total",1321,167,48,119,1154,71,86,410,314,86,101,86
"2011","North Somerset 026F","E01032673","Total",1247,255,117,138,992,99,166,237,226,62,72,130
"2011","North Somerset 027A","E01014810","Total",1312,303,87,216,1009,145,132,267,244,35,55,131
"2011","North Somerset 027B","E01032669","Total",1469,94,6,88,1375,168,36,489,324,154,113,91
"2011","North Somerset 027C","E01032670","Total",1645,106,10,96,1539,237,28,500,242,164,187,181
"2011","North Somerset 027D","E01032671","Total",1397,90,8,82,1307,154,48,535,168,138,161,103
"2011","North Somerset 027E","E01032679","Total",1281,141,17,124,1140,149,82,372,258,77,80,122
"2011","Plymouth 001A","E01015025","Total",1504,149,99,50,1355,31,348,217,264,47,132,316
"2011","Plymouth 001B","E01015097","Total",1667,263,177,86,1404,15,524,148,292,25,101,299
"2011","Plymouth 001C","E01015160","Total",1485,127,80,47,1358,48,308,291,258,61,129,263
"2011","Plymouth 001D","E01015164","Total",1988,114,54,60,1874,106,144,654,354,164,198,254
"2011","Plymouth 002A","E01015027","Total",1623,133,58,75,1490,47,192,363,306,119,153,310
"2011","Plymouth 002B","E01015159","Total",1600,264,140,124,1336,128,310,253,230,78,104,233
"2011","Plymouth 002C","E01015161","Total",1483,172,88,84,1311,125,250,249,188,96,139,264
"2011","Plymouth 002D","E01015162","Total",1447,187,102,85,1260,80,210,268,222,77,152,251
"2011","Plymouth 002E","E01015166","Total",1865,249,92,157,1616,225,184,381,334,123,138,231
"2011","Plymouth 003A","E01015023","Total",1640,206,93,113,1434,115,192,298,224,106,180,319
"2011","Plymouth 003B","E01015026","Total",1582,312,95,217,1270,163,136,346,244,108,55,218
"2011","Plymouth 003C","E01015028","Total",1446,202,87,115,1244,179,142,337,218,67,136,165
"2011","Plymouth 003D","E01015163","Total",1406,140,77,63,1266,107,250,254,198,68,132,257
"2011","Plymouth 003E","E01015165","Total",1684,125,47,78,1559,131,138,542,272,104,149,223
"2011","Plymouth 004A","E01015024","Total",1431,178,51,127,1253,83,140,304,354,56,83,233
"2011","Plymouth 004B","E01015082","Total",1625,198,85,113,1427,154,170,299,234,111,179,280
"2011","Plymouth 004C","E01015083","Total",1448,279,82,197,1169,88,166,225,220,65,179,226
"2011","Plymouth 004D","E01015084","Total",1467,162,82,80,1305,99,212,177,268,123,170,256
"2011","Plymouth 005A","E01015090","Total",1370,108,36,72,1262,78,178,244,290,61,78,333
"2011","Plymouth 005B","E01015091","Total",1539,121,68,53,1418,53,206,271,330,50,158,350
"2011","Plymouth 005C","E01015092","Total",1089,167,48,119,922,75,104,165,186,79,114,199
"2011","Plymouth 005D","E01015093","Total",1378,209,103,106,1169,78,126,274,286,57,89,259
"2011","Plymouth 005E","E01015094","Total",1403,170,106,64,1233,100,136,279,228,74,179,237
"2011","Plymouth 006A","E01015085","Total",1611,209,115,94,1402,91,274,288,262,120,127,240
"2011","Plymouth 006B","E01015087","Total",1594,115,58,57,1479,117,128,292,172,168,337,265
"2011","Plymouth 006C","E01015088","Total",1584,178,76,102,1406,235,92,323,192,205,177,182
"2011","Plymouth 006D","E01015147","Total",1202,117,69,48,1085,64,194,164,192,51,144,276
"2011","Plymouth 006E","E01015148","Total",1515,218,91,127,1297,102,120,357,266,104,145,203
"2011","Plymouth 007A","E01015030","Total",1550,328,115,213,1222,156,152,237,244,99,137,197
"2011","Plymouth 007B","E01015070","Total",2500,311,106,205,2189,152,210,637,452,136,174,428
"2011","Plymouth 007C","E01015081","Total",1555,159,79,80,1396,138,160,288,214,127,161,308
"2011","Plymouth 007D","E01015086","Total",1342,211,120,91,1131,113,192,212,218,61,114,221
"2011","Plymouth 007E","E01015089","Total",1606,233,95,138,1373,102,242,342,288,51,140,208
"2011","Plymouth 008A","E01015029","Total",1910,129,57,72,1781,206,158,510,288,192,208,219
"2011","Plymouth 008B","E01015064","Total",1620,184,133,51,1436,24,342,272,276,93,147,282
"2011","Plymouth 008C","E01015065","Total",1464,211,156,55,1253,42,200,366,200,115,144,186
"2011","Plymouth 008D","E01015071","Total",1524,239,134,105,1285,65,212,324,232,67,141,244
"2011","Plymouth 009A","E01015076","Total",1438,165,74,91,1273,78,160,307,300,57,124,247
"2011","Plymouth 009B","E01015142","Total",1312,190,64,126,1122,64,156,262,270,30,108,232
"2011","Plymouth 009C","E01015143","Total",1344,178,80,98,1166,79,202,259,242,57,83,244
"2011","Plymouth 009D","E01015144","Total",1529,166,62,104,1363,145,128,289,222,146,197,236
"2011","Plymouth 009E","E01015146","Total",1772,158,36,122,1614,238,86,389,260,223,166,252
"2011","Plymouth 009F","E01015149","Total",1451,199,107,92,1252,126,138,234,212,102,201,239
"2011","Plymouth 009G","E01015150","Total",1378,225,119,106,1153,46,240,231,208,55,131,242
"2011","Plymouth 010A","E01015063","Total",1440,184,77,107,1256,105,146,311,272,60,111,251
"2011","Plymouth 010B","E01015068","Total",1628,116,63,53,1512,91,188,403,272,128,164,266
"2011","Plymouth 010C","E01015069","Total",1594,179,97,82,1415,110,178,337,274,135,141,240
"2011","Plymouth 010D","E01015095","Total",1394,202,102,100,1192,66,234,259,246,58,89,240
"2011","Plymouth 010E","E01015096","Total",1443,167,94,73,1276,114,186,256,236,74,158,252
"2011","Plymouth 011A","E01015074","Total",1510,224,114,110,1286,144,176,220,242,98,189,217
"2011","Plymouth 011B","E01015077","Total",1683,227,115,112,1456,122,234,330,280,56,146,288
"2011","Plymouth 011C","E01015079","Total",1481,170,97,73,1311,82,224,249,232,92,153,279
"2011","Plymouth 011D","E01015102","Total",1683,260,78,182,1423,110,138,337,350,82,162,244
"2011","Plymouth 011E","E01015104","Total",1534,114,67,47,1420,58,176,389,224,114,156,303
"2011","Plymouth 012A","E01015035","Total",1537,141,70,71,1396,64,208,341,272,65,183,263
"2011","Plymouth 012B","E01015037","Total",1340,188,106,82,1152,92,208,252,196,66,119,219
"2011","Plymouth 012C","E01015058","Total",1471,133,56,77,1338,180,100,272,182,181,203,220
"2011","Plymouth 012D","E01015066","Total",1485,122,57,65,1363,78,182,311,276,82,137,297
"2011","Plymouth 012E","E01015067","Total",1482,113,83,30,1369,41,340,184,212,66,178,348
"2011","Plymouth 013A","E01015072","Total",1588,137,70,67,1451,107,150,242,232,157,244,319
"2011","Plymouth 013B","E01015073","Total",1450,207,96,111,1243,126,138,171,254,107,132,315
"2011","Plymouth 013C","E01015078","Total",1245,144,83,61,1101,93,104,175,134,170,172,253
"2011","Plymouth 013D","E01015080","Total",1406,97,32,65,1309,219,72,245,98,249,198,228
"2011","Plymouth 013E","E01015106","Total",1232,129,71,58,1103,77,136,214,274,68,90,244
"2011","Plymouth 014A","E01015039","Total",1081,134,55,79,947,88,80,209,216,88,103,163
"2011","Plymouth 014B","E01015040","Total",1505,160,49,111,1345,132,108,272,196,115,227,295
"2011","Plymouth 014C","E01015041","Total",1419,185,46,139,1234,116,102,354,340,53,102,167
"2011","Plymouth 014D","E01015075","Total",1444,214,107,107,1230,155,160,258,238,102,130,187
"2011","Plymouth 014E","E01015145","Total",1815,110,15,95,1705,378,28,661,202,142,169,125
"2011","Plymouth 015A","E01015120","Total",1516,127,78,49,1389,77,208,322,248,94,153,287
"2011","Plymouth 015B","E01015121","Total",1508,156,107,49,1352,58,326,290,200,97,131,250
"2011","Plymouth 015C","E01015123","Total",1522,240,137,103,1282,62,318,298,232,51,119,202
"2011","Plymouth 015D","E01015124","Total",1571,189,124,65,1382,45,288,372,238,57,121,261
"2011","Plymouth 015E","E01015125","Total",1538,119,62,57,1419,56,238,329,238,78,150,330
"2011","Plymouth 016A","E01015033","Total",1570,147,83,64,1423,24,232,286,228,133,188,332
"2011","Plymouth 016B","E01015034","Total",1326,117,49,68,1209,23,178,278,206,99,172,253
"2011","Plymouth 016C","E01015036","Total",1481,236,127,109,1245,41,170,372,220,125,120,197
"2011","Plymouth 016D","E01015038","Total",1695,169,69,100,1526,79,182,349,354,75,182,305
"2011","Plymouth 016E","E01015101","Total",1541,129,102,27,1412,29,240,383,252,112,133,263
"2011","Plymouth 017A","E01015098","Total",1565,194,89,105,1371,64,104,358,298,117,168,262
"2011","Plymouth 017B","E01015099","Total",1476,178,57,121,1298,53,124,370,318,60,125,248
"2011","Plymouth 017C","E01015100","Total",1477,181,49,132,1296,71,100,320,258,56,149,342
"2011","Plymouth 017D","E01015103","Total",1459,189,66,123,1270,64,120,370,258,71,130,257
"2011","Plymouth 017E","E01015105","Total",1468,153,69,84,1315,45,126,368,334,85,134,223
"2011","Plymouth 018A","E01015107","Total",1552,110,32,78,1442,83,108,423,282,102,183,261
"2011","Plymouth 018B","E01015110","Total",1588,81,26,55,1507,68,194,303,336,105,154,347
"2011","Plymouth 018C","E01015111","Total",1641,165,34,131,1476,110,94,510,406,52,106,198
"2011","Plymouth 018D","E01015119","Total",1725,86,30,56,1639,87,142,465,326,122,185,312
"2011","Plymouth 019A","E01015112","Total",1416,120,57,63,1296,62,140,336,250,130,146,232
"2011","Plymouth 019B","E01015113","Total",1495,142,83,59,1353,57,256,345,250,68,141,236
"2011","Plymouth 019C","E01015114","Total",1455,180,80,100,1275,37,174,306,256,66,159,277
"2011","Plymouth 019D","E01015118","Total",1634,166,95,71,1468,50,236,509,214,71,127,261
"2011","Plymouth 019E","E01015122","Total",1582,155,107,48,1427,63,270,366,180,70,174,304
"2011","Plymouth 020A","E01015042","Total",1473,219,49,170,1254,118,90,316,288,76,152,214
"2011","Plymouth 020B","E01015044","Total",1408,342,67,275,1066,66,90,224,320,15,114,237
"2011","Plymouth 020C","E01015167","Total",1543,191,41,150,1352,92,100,342,356,73,124,265
"2011","Plymouth 020D","E01015168","Total",1810,277,53,224,1533,114,118,310,392,58,184,357
"2011","Plymouth 020E","E01015171","Total",1585,354,80,274,1231,78,88,273,378,54,114,246
"2011","Plymouth 021A","E01015055","Total",1433,192,75,117,1241,97,132,265,198,96,169,284
"2011","Plymouth 021B","E01015056","Total",1533,275,100,175,1258,66,188,266,328,63,83,264
"2011","Plymouth 021C","E01015057","Total",1493,235,106,129,1258,166,104,247,216,125,147,253
"2011","Plymouth 021D","E01015059","Total",1555,161,45,116,1394,104,126,314,308,100,188,254
"2011","Plymouth 021E","E01015060","Total",1573,177,63,114,1396,119,172,269,234,171,200,231
"2011","Plymouth 021F","E01015176","Total",1427,162,74,88,1265,49,140,237,232,91,172,344
"2011","Plymouth 022A","E01015108","Total",1952,154,70,84,1798,106,182,606,334,174,168,228
"2011","Plymouth 022B","E01015109","Total",1457,195,57,138,1262,92,106,264,308,36,147,309
"2011","Plymouth 022C","E01015115","Total",1362,337,234,103,1025,60,204,194,164,31,163,209
"2011","Plymouth 022D","E01015116","Total",1497,119,72,47,1378,64,208,372,246,30,154,304
"2011","Plymouth 022E","E01015117","Total",1450,114,45,69,1336,62,184,323,280,50,124,313
"2011","Plymouth 023A","E01015031","Total",1541,227,34,193,1314,49,100,184,370,61,87,463
"2011","Plymouth 023B","E01015032","Total",1879,354,81,273,1525,42,30,168,348,10,70,857
"2011","Plymouth 023C","E01015049","Total",1578,196,45,151,1382,31,74,144,252,40,54,787
"2011","Plymouth 023D","E01015050","Total",1756,238,26,212,1518,22,16,87,414,20,75,884
"2011","Plymouth 023E","E01015051","Total",1539,127,35,92,1412,29,98,94,234,27,58,872
"2011","Plymouth 024A","E01015169","Total",1832,392,75,317,1440,49,116,207,278,62,181,547
"2011","Plymouth 024B","E01015170","Total",1580,268,99,169,1312,110,126,347,346,40,120,223
"2011","Plymouth 024C","E01015173","Total",1658,254,73,181,1404,76,160,293,360,91,124,300
"2011","Plymouth 024D","E01015174","Total",1604,172,75,97,1432,55,206,329,316,109,124,293
"2011","Plymouth 025A","E01015061","Total",1452,194,55,139,1258,108,70,261,274,81,102,362
"2011","Plymouth 025B","E01015062","Total",1949,208,38,170,1741,59,72,142,302,57,90,1019
"2011","Plymouth 025C","E01015175","Total",1633,202,58,144,1431,63,88,240,284,91,123,542
"2011","Plymouth 025D","E01015177","Total",1741,199,51,148,1542,76,144,284,336,57,187,458
"2011","Plymouth 025E","E01015178","Total",2026,267,64,203,1759,63,72,222,370,63,95,874
"2011","Plymouth 026A","E01015043","Total",1491,236,54,182,1255,198,72,297,242,89,134,223
"2011","Plymouth 026B","E01015045","Total",1452,331,60,271,1121,201,62,308,294,41,77,138
"2011","Plymouth 026C","E01015046","Total",1952,448,152,296,1504,164,118,332,222,224,227,217
"2011","Plymouth 026D","E01015047","Total",1504,214,56,158,1290,228,68,292,200,122,157,223
"2011","Plymouth 026E","E01015048","Total",1176,298,56,242,878,145,50,201,164,94,99,125
"2011","Plymouth 027A","E01015053","Total",1320,245,40,205,1075,50,48,97,242,32,51,555
"2011","Plymouth 027B","E01015054","Total",1475,189,49,140,1286,23,34,65,228,31,49,856
"2011","Plymouth 027C","E01015152","Total",1796,473,113,360,1323,204,122,298,238,93,55,313
"2011","Plymouth 027E","E01015156","Total",1189,453,130,323,736,43,116,113,308,5,35,116
"2011","Plymouth 027F","E01032657","Total",1444,368,96,272,1076,37,120,82,396,23,51,367
"2011","Plymouth 027G","E01032658","Total",1261,494,144,350,767,74,60,90,368,30,37,108
"2011","Plymouth 028A","E01015052","Total",1902,349,64,285,1553,59,48,193,320,20,77,836
"2011","Plymouth 028B","E01015179","Total",1669,224,57,167,1445,80,74,184,316,62,84,645
"2011","Plymouth 028C","E01015180","Total",1760,382,128,254,1378,148,104,267,348,118,116,277
"2011","Plymouth 028D","E01015181","Total",2035,435,78,357,1600,153,96,270,428,63,144,446
"2011","Plymouth 028E","E01015182","Total",1847,307,94,213,1540,123,126,332,372,106,208,273
"2011","Plymouth 029A","E01015151","Total",1915,436,81,355,1479,122,76,229,322,92,73,565
"2011","Plymouth 029B","E01015153","Total",1734,465,123,342,1269,156,102,333,280,74,120,204
"2011","Plymouth 029C","E01015155","Total",1719,509,118,391,1210,159,92,306,260,105,105,183
"2011","Plymouth 029D","E01015157","Total",2019,649,133,516,1370,86,132,264,554,32,105,197
"2011","Plymouth 029E","E01015158","Total",2100,766,220,546,1334,76,232,147,608,43,37,191
"2011","Plymouth 029F","E01015172","Total",1790,310,63,247,1480,72,104,320,404,45,192,343
"2011","Plymouth 030A","E01015126","Total",1405,159,126,33,1246,40,406,269,202,52,68,209
"2011","Plymouth 030B","E01015127","Total",1428,151,73,78,1277,72,226,303,246,39,93,298
"2011","Plymouth 030C","E01015131","Total",1458,142,100,42,1316,30,380,259,246,26,114,261
"2011","Plymouth 030D","E01015132","Total",1507,207,150,57,1300,36,254,300,230,93,135,252
"2011","Plymouth 030E","E01015133","Total",1535,140,100,40,1395,38,350,231,218,77,141,340
"2011","Plymouth 031A","E01015135","Total",1532,156,91,65,1376,54,208,285,236,73,216,304
"2011","Plymouth 031B","E01015136","Total",1515,179,115,64,1336,76,208,278,186,100,166,322
"2011","Plymouth 031C","E01015137","Total",1555,169,80,89,1386,68,194,387,282,91,139,225
"2011","Plymouth 031D","E01015138","Total",1518,233,95,138,1285,31,264,311,248,62,122,247
"2011","Plymouth 031E","E01015139","Total",1423,154,79,75,1269,106,222,262,252,65,131,231
"2011","Plymouth 031F","E01015141","Total",1820,157,102,55,1663,47,346,348,276,173,161,312
"2011","Plymouth 032A","E01015128","Total",1634,229,142,87,1405,46,332,262,292,86,118,269
"2011","Plymouth 032B","E01015129","Total",1481,229,63,166,1252,155,82,385,272,65,100,193
"2011","Plymouth 032C","E01015130","Total",1714,98,50,48,1616,55,124,547,236,134,227,293
"2011","Plymouth 032D","E01015134","Total",1528,227,150,77,1301,64,228,324,198,132,104,251
"2011","Plymouth 032E","E01015140","Total",1516,160,130,30,1356,22,318,398,254,87,132,145
"2011","Poole 001A","E01015431","Total",1090,77,39,38,1013,32,178,237,188,43,91,244
"2011","Poole 001B","E01015432","Total",1643,235,151,84,1408,63,302,338,246,58,125,276
"2011","Poole 001C","E01015433","Total",1480,108,65,43,1372,12,330,251,228,68,155,328
"2011","Poole 001D","E01015434","Total",1582,143,119,24,1439,36,326,286,216,62,169,344
"2011","Poole 002A","E01015379","Total",1368,88,45,43,1280,84,120,244,176,137,273,246
"2011","Poole 002B","E01015435","Total",1523,186,32,154,1337,105,102,422,344,76,106,182
"2011","Poole 002C","E01015436","Total",1339,117,60,57,1222,34,180,279,208,81,123,317
"2011","Poole 002D","E01015437","Total",1280,80,35,45,1200,13,212,201,228,54,170,322
"2011","Poole 003A","E01015395","Total",1319,221,166,55,1098,36,290,199,180,52,134,207
"2011","Poole 003B","E01015396","Total",1508,145,106,39,1363,31,342,265,212,64,155,294
"2011","Poole 003C","E01015397","Total",1496,69,33,36,1427,31,162,409,190,103,237,295
"2011","Poole 003D","E01015398","Total",1390,61,34,27,1329,41,206,341,208,89,145,299
"2011","Poole 003E","E01015399","Total",1452,187,145,42,1265,20,286,241,180,50,214,274
"2011","Poole 003F","E01015400","Total",1518,127,97,30,1391,26,336,365,180,62,137,285
"2011","Poole 003G","E01015401","Total",1523,161,121,40,1362,37,338,316,178,45,170,278
"2011","Poole 004A","E01015412","Total",1307,64,26,38,1243,20,178,268,188,66,143,380
"2011","Poole 004B","E01015413","Total",1457,194,85,109,1263,88,126,363,266,79,97,244
"2011","Poole 004C","E01015414","Total",1454,148,62,86,1306,96,170,286,286,57,99,312
"2011","Poole 004D","E01015415","Total",1262,184,54,130,1078,126,46,259,216,109,93,229
"2011","Poole 004E","E01015416","Total",1335,119,67,52,1216,33,162,349,220,84,201,167
"2011","Poole 005A","E01015407","Total",1467,146,74,72,1321,62,264,280,220,46,130,319
"2011","Poole 005B","E01015408","Total",1365,92,61,31,1273,55,180,307,148,110,181,292
"2011","Poole 005C","E01015409","Total",1499,172,59,113,1327,136,62,329,202,150,196,252
"2011","Poole 005D","E01015410","Total",1515,204,29,175,1311,90,72,366,318,73,143,249
"2011","Poole 005E","E01015411","Total",1359,103,41,62,1256,75,142,313,200,61,139,326
"2011","Poole 006A","E01015417","Total",1460,166,99,67,1294,60,196,267,258,101,143,269
"2011","Poole 006B","E01015418","Total",1522,239,101,138,1283,57,166,357,292,75,133,203
"2011","Poole 006C","E01015419","Total",1756,221,106,115,1535,77,294,413,288,87,100,276
"2011","Poole 006D","E01015420","Total",1560,161,109,52,1399,95,214,369,234,97,152,238
"2011","Poole 006E","E01015421","Total",1422,174,124,50,1248,53,314,175,220,83,144,259
"2011","Poole 006F","E01015422","Total",1447,159,34,125,1288,73,78,422,324,62,83,246
"2011","Poole 007A","E01015380","Total",1697,201,131,70,1496,58,348,208,276,54,184,368
"2011","Poole 007B","E01015381","Total",1629,154,78,76,1475,117,230,293,224,126,179,306
"2011","Poole 007C","E01015382","Total",1853,196,51,145,1657,176,92,445,400,134,173,237
"2011","Poole 007D","E01015383","Total",1419,212,127,85,1207,40,324,177,284,32,47,303
"2011","Poole 007E","E01015384","Total",1608,61,28,33,1547,192,80,226,122,220,358,349
"2011","Poole 007F","E01015385","Total",1731,283,169,114,1448,121,260,231,226,117,179,314
"2011","Poole 008A","E01015438","Total",1529,140,68,72,1389,54,192,306,270,76,168,323
"2011","Poole 008B","E01015439","Total",1723,260,119,141,1463,68,130,357,302,88,205,313
"2011","Poole 008C","E01015441","Total",1872,314,143,171,1558,102,148,351,296,89,198,374
"2011","Poole 008D","E01015442","Total",1920,260,154,106,1660,128,198,415,206,139,238,336
"2011","Poole 008E","E01015443","Total",1784,222,106,116,1562,117,222,301,276,114,197,335
"2011","Poole 008F","E01015444","Total",1735,162,72,90,1573,79,174,369,264,130,195,362
"2011","Poole 009A","E01015386","Total",1653,387,164,223,1266,122,118,233,358,93,104,238
"2011","Poole 009B","E01015387","Total",1469,194,105,89,1275,69,210,304,296,36,101,259
"2011","Poole 009C","E01015388","Total",1288,89,32,57,1199,41,172,296,164,56,101,369
"2011","Poole 009D","E01015389","Total",1453,208,79,129,1245,31,174,305,382,52,96,205
"2011","Poole 010A","E01015390","Total",1688,269,95,174,1419,111,114,358,288,85,157,306
"2011","Poole 010B","E01015391","Total",1455,153,73,80,1302,38,194,259,302,87,151,271
"2011","Poole 010C","E01015392","Total",1415,210,110,100,1205,74,136,328,282,30,85,270
"2011","Poole 010D","E01015393","Total",1260,135,37,98,1125,72,96,287,252,121,93,204
"2011","Poole 010E","E01015394","Total",1591,139,61,78,1452,92,156,384,270,47,192,311
"2011","Poole 011A","E01015440","Total",1942,235,105,130,1707,127,238,347,364,91,202,338
"2011","Poole 011B","E01015447","Total",1574,141,75,66,1433,43,282,313,224,101,128,342
"2011","Poole 011C","E01015449","Total",1690,216,105,111,1474,113,156,296,234,80,274,321
"2011","Poole 011D","E01015456","Total",1731,272,136,136,1459,92,184,303,298,94,169,319
"2011","Poole 011E","E01015457","Total",1599,322,159,163,1277,47,296,267,298,77,90,202
"2011","Poole 012A","E01015445","Total",1927,192,105,87,1735,42,276,385,284,119,243,386
"2011","Poole 012B","E01015446","Total",1583,203,125,78,1380,48,180,310,168,88,263,323
"2011","Poole 012C","E01015448","Total",1525,162,81,81,1363,65,210,306,242,111,156,273
"2011","Poole 012D","E01015450","Total",1738,148,81,67,1590,84,202,358,226,94,192,434
"2011","Poole 012E","E01015451","Total",1461,162,111,51,1299,38,278,253,240,76,150,264
"2011","Poole 013A","E01015458","Total",1469,167,104,63,1302,28,342,336,238,82,90,186
"2011","Poole 013B","E01015460","Total",1720,215,82,133,1505,128,114,450,298,93,146,276
"2011","Poole 013C","E01015461","Total",1554,206,70,136,1348,79,96,398,246,92,190,247
"2011","Poole 013D","E01015462","Total",1585,218,44,174,1367,53,100,406,304,108,120,276
"2011","Poole 013E","E01015463","Total",1538,279,110,169,1259,36,166,366,324,71,109,187
"2011","Poole 013F","E01015464","Total",1575,137,67,70,1438,43,220,455,314,62,120,224
"2011","Poole 014A","E01015427","Total",1628,174,35,139,1454,97,84,470,274,148,176,205
"2011","Poole 014B","E01015428","Total",2164,260,137,123,1904,103,406,418,366,102,184,325
"2011","Poole 014C","E01015429","Total",1702,178,93,85,1524,125,180,341,228,123,219,308
"2011","Poole 014D","E01015430","Total",1547,134,36,98,1413,154,128,272,186,160,247,266
"2011","Poole 015A","E01015465","Total",1748,260,86,174,1488,95,132,354,326,70,163,348
"2011","Poole 015B","E01015466","Total",1640,236,127,109,1404,51,242,323,252,67,122,347
"2011","Poole 015D","E01015468","Total",1794,426,259,167,1368,97,234,333,320,59,124,201
"2011","Poole 015F","E01032659","Total",1116,292,92,200,824,60,92,202,294,15,37,124
"2011","Poole 015G","E01032660","Total",1406,218,47,171,1188,92,88,311,376,51,96,174
"2011","Poole 015H","E01032661","Total",1303,286,105,181,1017,37,188,211,276,52,66,187
"2011","Poole 015I","E01032662","Total",1114,329,157,172,785,79,150,149,208,35,45,119
"2011","Poole 016A","E01015423","Total",2009,364,137,227,1645,139,224,323,432,78,133,316
"2011","Poole 016B","E01015424","Total",1369,181,78,103,1188,93,170,250,258,60,111,246
"2011","Poole 016C","E01015425","Total",1292,128,77,51,1164,73,208,198,228,61,126,270
"2011","Poole 016D","E01015426","Total",1324,149,74,75,1175,92,156,208,224,111,111,273
"2011","Poole 017A","E01015452","Total",1792,295,214,81,1497,61,352,423,220,98,97,246
"2011","Poole 017B","E01015453","Total",1840,433,161,272,1407,112,174,373,464,51,84,149
"2011","Poole 017C","E01015454","Total",1801,365,143,222,1436,81,176,408,318,88,111,254
"2011","Poole 017D","E01015455","Total",1878,319,204,115,1559,87,376,397,292,57,121,229
"2011","Poole 017E","E01015459","Total",1719,241,152,89,1478,35,420,347,274,115,102,185
"2011","Poole 018A","E01015402","Total",1544,320,177,143,1224,38,312,214,298,86,68,208
"2011","Poole 018B","E01015403","Total",1694,579,399,180,1115,32,608,81,270,16,8,100
"2011","Poole 018C","E01015404","Total",1645,313,189,124,1332,36,508,213,262,43,79,191
"2011","Poole 018D","E01015405","Total",1645,197,93,104,1448,14,414,284,360,46,104,226
"2011","Poole 018E","E01015406","Total",1708,382,182,200,1326,73,370,209,306,92,60,216
"2011","South Gloucestershire 001A","E01014985","Total",1383,213,84,129,1170,46,178,254,282,54,125,231
"2011","South Gloucestershire 001B","E01014986","Total",1523,207,130,77,1316,124,256,234,186,91,163,262
"2011","South Gloucestershire 001C","E01014987","Total",1228,113,52,61,1115,42,218,260,206,87,89,213
"2011","South Gloucestershire 001D","E01014988","Total",1359,114,75,39,1245,32,238,333,186,81,118,257
"2011","South Gloucestershire 001E","E01014989","Total",1055,115,39,76,940,7,174,176,160,43,166,214
"2011","South Gloucestershire 002A","E01014990","Total",1484,158,102,56,1326,40,298,258,220,53,113,344
"2011","South Gloucestershire 002B","E01014991","Total",2164,368,191,177,1796,174,252,420,272,170,196,312
"2011","South Gloucestershire 002C","E01014992","Total",1483,106,48,58,1377,49,218,328,228,88,140,326
"2011","South Gloucestershire 002D","E01014993","Total",1442,98,44,54,1344,35,210,302,210,100,192,295
"2011","South Gloucestershire 003A","E01014884","Total",1544,124,53,71,1420,70,142,340,234,142,219,273
"2011","South Gloucestershire 003B","E01014885","Total",1867,117,51,66,1750,62,276,495,286,100,212,319
"2011","South Gloucestershire 003C","E01014929","Total",2005,157,72,85,1848,90,294,402,304,127,205,426
"2011","South Gloucestershire 003D","E01014930","Total",1926,128,56,72,1798,105,166,508,274,134,261,350
"2011","South Gloucestershire 004A","E01014863","Total",1493,180,132,48,1313,45,364,274,180,50,126,274
"2011","South Gloucestershire 004B","E01014864","Total",1438,149,91,58,1289,13,340,231,246,54,110,295
"2011","South Gloucestershire 004C","E01014962","Total",1712,112,55,57,1600,30,304,279,278,121,217,371
"2011","South Gloucestershire 004D","E01014963","Total",1871,194,113,81,1677,56,296,404,258,108,204,351
"2011","South Gloucestershire 005A","E01014861","Total",1863,163,85,78,1700,79,254,357,290,99,204,417
"2011","South Gloucestershire 005B","E01014862","Total",2797,179,99,80,2618,213,346,703,460,190,234,472
"2011","South Gloucestershire 005C","E01014953","Total",2108,172,78,94,1936,98,248,469,290,205,235,391
"2011","South Gloucestershire 005D","E01014954","Total",1531,215,76,139,1316,90,196,330,306,65,103,226
"2011","South Gloucestershire 006A","E01015014","Total",1466,81,28,53,1385,31,148,407,232,94,148,325
"2011","South Gloucestershire 006B","E01015015","Total",1388,158,17,141,1230,67,50,329,282,62,184,256
"2011","South Gloucestershire 006C","E01015016","Total",1217,61,35,26,1156,19,204,278,174,56,160,265
"2011","South Gloucestershire 006D","E01015017","Total",1369,175,97,78,1194,48,176,238,224,71,174,263
"2011","South Gloucestershire 006E","E01015018","Total",1507,108,58,50,1399,55,200,301,206,96,221,320
"2011","South Gloucestershire 007A","E01015019","Total",1774,225,66,159,1549,159,122,345,318,94,204,307
"2011","South Gloucestershire 007B","E01015020","Total",1556,215,62,153,1341,146,134,282,198,171,184,226
"2011","South Gloucestershire 007C","E01015021","Total",1571,142,65,77,1429,38,186,384,276,60,168,317
"2011","South Gloucestershire 007D","E01015022","Total",1550,207,47,160,1343,75,134,358,292,64,148,272
"2011","South Gloucestershire 008A","E01014886","Total",1791,301,168,133,1490,81,324,285,234,123,155,288
"2011","South Gloucestershire 008B","E01014887","Total",1397,156,65,91,1241,29,248,290,294,70,84,226
"2011","South Gloucestershire 008C","E01014888","Total",1400,164,95,69,1236,21,296,264,242,86,130,197
"2011","South Gloucestershire 008D","E01014889","Total",1567,107,53,54,1460,68,242,401,240,77,132,300
"2011","South Gloucestershire 009A","E01014872","Total",1593,247,9,238,1346,94,40,424,394,88,131,175
"2011","South Gloucestershire 009B","E01014874","Total",1481,170,20,150,1311,69,58,516,268,115,128,157
"2011","South Gloucestershire 009C","E01014876","Total",1716,230,17,213,1486,127,36,596,372,106,123,126
"2011","South Gloucestershire 009D","E01014877","Total",1563,143,27,116,1420,75,56,552,258,104,154,221
"2011","South Gloucestershire 009E","E01014879","Total",1712,253,89,164,1459,57,156,435,308,112,118,273
"2011","South Gloucestershire 009F","E01014881","Total",1956,128,10,118,1828,83,22,763,388,118,226,228
"2011","South Gloucestershire 010A","E01015009","Total",1384,213,144,69,1171,79,234,229,164,98,146,221
"2011","South Gloucestershire 010B","E01015010","Total",1322,117,44,73,1205,76,170,304,176,89,102,288
"2011","South Gloucestershire 010C","E01015011","Total",1501,205,90,115,1296,102,178,234,250,41,183,308
"2011","South Gloucestershire 010D","E01015012","Total",1214,140,89,51,1074,29,234,227,188,82,69,245
"2011","South Gloucestershire 010E","E01015013","Total",1349,97,36,61,1252,111,110,331,206,114,154,226
"2011","South Gloucestershire 011A","E01014946","Total",1572,165,65,100,1407,132,166,262,236,110,144,357
"2011","South Gloucestershire 011B","E01014947","Total",1419,168,123,45,1251,18,372,166,196,52,171,276
"2011","South Gloucestershire 011C","E01014948","Total",1692,327,135,192,1365,167,164,323,250,115,174,172
"2011","South Gloucestershire 011D","E01014949","Total",1420,113,38,75,1307,96,108,318,212,89,128,356
"2011","South Gloucestershire 011E","E01014950","Total",1428,171,61,110,1257,58,130,358,254,77,122,258
"2011","South Gloucestershire 011F","E01014951","Total",1322,186,49,137,1136,129,116,288,214,65,118,206
"2011","South Gloucestershire 011G","E01014952","Total",1641,186,77,109,1455,51,254,256,278,37,165,414
"2011","South Gloucestershire 012A","E01014873","Total",1507,99,16,83,1408,48,90,440,280,88,163,299
"2011","South Gloucestershire 012B","E01014875","Total",1791,252,25,227,1539,117,50,566,396,92,123,195
"2011","South Gloucestershire 012C","E01014878","Total",2113,208,29,179,1905,104,70,756,458,112,175,230
"2011","South Gloucestershire 012D","E01014880","Total",1833,154,15,139,1679,127,54,687,342,118,149,202
"2011","South Gloucestershire 012E","E01014882","Total",2084,197,22,175,1887,197,80,598,382,123,234,273
"2011","South Gloucestershire 012F","E01014883","Total",1232,152,30,122,1080,46,104,393,252,50,87,148
"2011","South Gloucestershire 013A","E01014911","Total",1369,106,74,32,1263,37,300,224,182,95,176,249
"2011","South Gloucestershire 013B","E01014912","Total",1827,145,71,74,1682,65,286,463,308,74,199,287
"2011","South Gloucestershire 013C","E01014913","Total",1622,128,72,56,1494,66,300,378,228,85,167,270
"2011","South Gloucestershire 013D","E01014914","Total",1677,146,92,54,1531,94,188,400,182,107,218,342
"2011","South Gloucestershire 014A","E01014892","Total",1642,188,62,126,1454,146,82,455,286,105,116,264
"2011","South Gloucestershire 014B","E01014893","Total",1494,175,59,116,1319,96,152,324,222,120,178,227
"2011","South Gloucestershire 014C","E01014894","Total",1308,90,26,64,1218,81,110,322,188,101,133,283
"2011","South Gloucestershire 014D","E01014895","Total",1422,92,19,73,1330,81,92,349,250,105,198,255
"2011","South Gloucestershire 014E","E01014896","Total",1332,91,22,69,1241,80,56,374,204,144,166,217
"2011","South Gloucestershire 015A","E01014979","Total",1515,196,73,123,1319,75,142,368,320,46,150,218
"2011","South Gloucestershire 015B","E01014980","Total",1621,144,53,91,1477,42,166,425,260,62,153,369
"2011","South Gloucestershire 015C","E01014982","Total",1519,184,65,119,1335,57,142,415,242,83,156,240
"2011","South Gloucestershire 015D","E01014983","Total",1518,191,71,120,1327,142,146,322,246,86,135,250
"2011","South Gloucestershire 015E","E01014984","Total",1481,176,95,81,1305,78,176,294,198,105,124,330
"2011","South Gloucestershire 016A","E01014998","Total",1500,172,116,56,1328,63,310,299,156,78,165,257
"2011","South Gloucestershire 016B","E01014999","Total",1574,126,82,44,1448,52,326,374,180,83,155,278
"2011","South Gloucestershire 016C","E01015000","Total",1524,210,124,86,1314,69,208,278,200,102,183,274
"2011","South Gloucestershire 016D","E01015001","Total",1609,120,77,43,1489,70,268,367,186,93,157,348
"2011","South Gloucestershire 017A","E01014978","Total",1530,122,40,82,1408,54,92,506,278,83,148,247
"2011","South Gloucestershire 017B","E01014981","Total",2829,302,53,249,2527,229,154,751,580,180,220,413
"2011","South Gloucestershire 017C","E01014996","Total",1518,228,118,110,1290,41,304,276,240,104,113,212
"2011","South Gloucestershire 017E","E01033331","Total",1336,194,7,187,1142,74,16,246,350,49,88,319
"2011","South Gloucestershire 017F","E01033333","Total",1364,147,50,97,1217,53,148,246,206,56,127,381
"2011","South Gloucestershire 018A","E01014904","Total",1482,214,102,112,1268,92,176,285,210,46,151,308
"2011","South Gloucestershire 018B","E01014905","Total",1639,177,82,95,1462,26,170,348,244,79,155,440
"2011","South Gloucestershire 018C","E01014906","Total",1626,302,177,125,1324,123,146,271,208,73,183,320
"2011","South Gloucestershire 018D","E01014907","Total",1530,230,106,124,1300,56,184,248,272,75,107,358
"2011","South Gloucestershire 018E","E01014908","Total",1304,148,64,84,1156,28,208,249,224,62,132,253
"2011","South Gloucestershire 018F","E01014909","Total",1488,171,57,114,1317,65,104,223,210,71,184,460
"2011","South Gloucestershire 018G","E01014910","Total",1462,195,86,109,1267,99,138,318,238,52,154,268
"2011","South Gloucestershire 019A","E01014867","Total",1239,133,80,53,1106,56,240,210,178,51,127,244
"2011","South Gloucestershire 019B","E01014868","Total",1545,146,48,98,1399,90,154,341,282,71,150,311
"2011","South Gloucestershire 019D","E01014994","Total",1701,204,139,65,1497,35,318,263,270,58,216,337
"2011","South Gloucestershire 019E","E01014995","Total",1666,149,98,51,1517,21,354,343,240,61,172,326
"2011","South Gloucestershire 019F","E01033338","Total",1575,149,26,123,1426,80,114,456,290,62,206,218
"2011","South Gloucestershire 019G","E01033339","Total",1418,184,60,124,1234,146,104,281,274,88,183,158
"2011","South Gloucestershire 020A","E01014901","Total",1685,149,89,60,1536,42,244,441,216,144,174,275
"2011","South Gloucestershire 020B","E01014902","Total",1319,117,80,37,1202,29,238,329,198,93,127,188
"2011","South Gloucestershire 020C","E01014903","Total",1487,183,126,57,1304,22,282,351,190,62,128,269
"2011","South Gloucestershire 020D","E01014965","Total",1494,136,94,42,1358,35,270,336,206,92,120,299
"2011","South Gloucestershire 021A","E01014964","Total",1711,136,45,91,1575,76,180,514,282,123,160,240
"2011","South Gloucestershire 021B","E01014966","Total",1576,151,41,110,1425,107,46,587,332,107,115,131
"2011","South Gloucestershire 021C","E01014967","Total",2117,162,43,119,1955,63,170,798,356,174,136,258
"2011","South Gloucestershire 021D","E01014969","Total",1590,127,56,71,1463,60,234,471,252,99,137,210
"2011","South Gloucestershire 021F","E01033334","Total",1609,165,12,153,1444,75,32,580,322,154,97,184
"2011","South Gloucestershire 021G","E01033336","Total",1757,85,28,57,1672,90,74,718,250,155,186,199
"2011","South Gloucestershire 022A","E01014897","Total",1498,127,79,48,1371,48,256,363,196,104,170,234
"2011","South Gloucestershire 022B","E01014898","Total",1650,257,176,81,1393,40,158,402,250,85,161,297
"2011","South Gloucestershire 022C","E01014899","Total",1625,279,127,152,1346,49,190,351,246,94,110,306
"2011","South Gloucestershire 022D","E01014900","Total",1433,230,108,122,1203,31,142,291,214,60,186,279
"2011","South Gloucestershire 023A","E01014959","Total",1387,115,70,45,1272,82,180,239,170,86,169,346
"2011","South Gloucestershire 023B","E01014960","Total",1631,203,108,95,1428,101,192,257,246,122,190,320
"2011","South Gloucestershire 023C","E01014961","Total",1651,173,98,75,1478,135,206,358,200,138,164,277
"2011","South Gloucestershire 023D","E01014968","Total",1712,242,143,99,1470,151,244,314,172,118,149,322
"2011","South Gloucestershire 024A","E01014865","Total",1888,205,73,132,1683,122,248,381,290,121,191,330
"2011","South Gloucestershire 024B","E01014869","Total",1715,209,99,110,1506,63,228,392,224,137,187,275
"2011","South Gloucestershire 024C","E01014870","Total",1600,149,72,77,1451,54,192,252,264,69,227,393
"2011","South Gloucestershire 024D","E01014871","Total",1220,129,86,43,1091,61,244,217,158,58,125,228
"2011","South Gloucestershire 024E","E01014890","Total",2035,175,70,105,1860,63,302,437,326,165,168,399
"2011","South Gloucestershire 024F","E01014891","Total",1659,169,82,87,1490,24,264,319,270,93,144,376
"2011","South Gloucestershire 025A","E01014955","Total",1300,129,73,56,1171,39,232,265,228,44,85,278
"2011","South Gloucestershire 025B","E01014956","Total",1579,166,107,59,1413,81,258,229,238,76,205,326
"2011","South Gloucestershire 025C","E01014957","Total",1255,105,59,46,1150,45,208,280,190,45,128,254
"2011","South Gloucestershire 025D","E01014974","Total",1564,260,156,104,1304,39,204,318,240,117,151,235
"2011","South Gloucestershire 025E","E01014977","Total",1258,357,128,229,901,151,100,192,198,40,42,178
"2011","South Gloucestershire 026A","E01014922","Total",1383,115,48,67,1268,71,178,318,186,66,141,308
"2011","South Gloucestershire 026B","E01014923","Total",1456,203,74,129,1253,141,180,302,210,104,98,218
"2011","South Gloucestershire 026C","E01014924","Total",1690,285,69,216,1405,101,146,374,348,80,121,235
"2011","South Gloucestershire 026D","E01014973","Total",1464,217,111,106,1247,72,192,314,188,67,154,260
"2011","South Gloucestershire 026E","E01014975","Total",1567,223,64,159,1344,102,206,322,248,78,74,314
"2011","South Gloucestershire 026F","E01014976","Total",1440,205,79,126,1235,84,164,238,320,79,125,225
"2011","South Gloucestershire 027A","E01014925","Total",1492,160,85,75,1332,88,214,280,234,85,148,283
"2011","South Gloucestershire 027B","E01014926","Total",1685,184,101,83,1501,213,182,283,202,129,151,341
"2011","South Gloucestershire 027C","E01014927","Total",1604,375,160,215,1229,115,198,274,234,49,80,279
"2011","South Gloucestershire 027D","E01014928","Total",1526,183,106,77,1343,112,202,287,194,103,146,299
"2011","South Gloucestershire 027E","E01014958","Total",1175,115,59,56,1060,116,138,275,160,36,126,209
"2011","South Gloucestershire 028A","E01014915","Total",1556,185,93,92,1371,78,192,351,210,85,154,301
"2011","South Gloucestershire 028B","E01015003","Total",1611,156,64,92,1455,46,278,356,198,92,153,332
"2011","South Gloucestershire 028C","E01015005","Total",1996,240,58,182,1756,155,152,508,372,101,194,274
"2011","South Gloucestershire 028D","E01015007","Total",1674,295,118,177,1379,161,176,266,284,81,117,294
"2011","South Gloucestershire 028E","E01015008","Total",1625,175,87,88,1450,91,186,297,230,115,203,328
"2011","South Gloucestershire 029A","E01014943","Total",1722,315,43,272,1407,81,42,473,400,56,122,233
"2011","South Gloucestershire 029B","E01014944","Total",1860,153,45,108,1707,90,102,601,300,123,195,296
"2011","South Gloucestershire 029C","E01014972","Total",1681,215,122,93,1466,69,148,391,248,105,174,331
"2011","South Gloucestershire 029D","E01015002","Total",1544,172,62,110,1372,123,114,368,270,58,108,331
"2011","South Gloucestershire 029E","E01015004","Total",1713,192,55,137,1521,111,144,327,306,97,161,375
"2011","South Gloucestershire 029F","E01015006","Total",1571,161,78,83,1410,99,226,258,272,76,171,308
"2011","South Gloucestershire 030A","E01014936","Total",1439,122,43,79,1317,69,148,335,210,98,187,270
"2011","South Gloucestershire 030B","E01014938","Total",1548,137,39,98,1411,94,138,431,284,61,155,248
"2011","South Gloucestershire 030C","E01014939","Total",1191,123,34,89,1068,105,98,273,230,31,112,219
"2011","South Gloucestershire 030D","E01014940","Total",1331,85,24,61,1246,52,124,260,250,67,164,329
"2011","South Gloucestershire 030E","E01014941","Total",1588,165,107,58,1423,187,190,241,206,94,170,335
"2011","South Gloucestershire 030F","E01014942","Total",1485,203,97,106,1282,119,186,277,218,124,101,257
"2011","South Gloucestershire 030G","E01014945","Total",1677,151,82,69,1526,109,222,312,292,89,176,326
"2011","South Gloucestershire 031A","E01014916","Total",1508,252,125,127,1256,74,168,335,226,78,113,262
"2011","South Gloucestershire 031B","E01014917","Total",1428,151,84,67,1277,76,242,292,234,27,112,294
"2011","South Gloucestershire 031C","E01014918","Total",1433,204,121,83,1229,27,276,266,212,66,156,226
"2011","South Gloucestershire 031D","E01014919","Total",1267,98,76,22,1169,18,260,255,156,97,122,261
"2011","South Gloucestershire 031E","E01014920","Total",1328,108,73,35,1220,28,216,245,200,56,123,352
"2011","South Gloucestershire 031F","E01014921","Total",1369,134,61,73,1235,35,198,317,182,57,176,270
"2011","South Gloucestershire 032A","E01014866","Total",1574,139,76,63,1435,55,260,306,248,78,108,380
"2011","South Gloucestershire 032B","E01014931","Total",1395,201,108,93,1194,21,184,188,254,102,139,306
"2011","South Gloucestershire 032C","E01014932","Total",1641,205,105,100,1436,58,294,312,268,47,124,333
"2011","South Gloucestershire 032D","E01014933","Total",1460,160,33,127,1300,56,180,324,284,72,112,272
"2011","South Gloucestershire 032E","E01014934","Total",1237,113,78,35,1124,9,210,251,182,66,121,285
"2011","South Gloucestershire 032F","E01014935","Total",1506,198,59,139,1308,57,156,381,294,31,103,286
"2011","South Gloucestershire 032G","E01014937","Total",1282,113,79,34,1169,43,226,253,190,41,146,270
"2011","Swindon 001A","E01015519","Total",1446,262,153,109,1184,56,244,259,220,94,142,169
"2011","Swindon 001B","E01015520","Total",1189,186,105,81,1003,54,216,214,192,53,98,176
"2011","Swindon 001C","E01015521","Total",1432,146,75,71,1286,51,240,279,236,65,146,269
"2011","Swindon 001D","E01015522","Total",1441,181,80,101,1260,77,140,306,322,53,95,267
"2011","Swindon 001E","E01015523","Total",1505,188,109,79,1317,41,230,264,262,72,154,294
"2011","Swindon 001F","E01015524","Total",1199,100,43,57,1099,44,128,336,174,74,136,207
"2011","Swindon 003A","E01015543","Total",1362,177,108,69,1185,99,206,255,218,70,103,234
"2011","Swindon 003B","E01015544","Total",1666,276,115,161,1390,194,144,332,202,132,153,233
"2011","Swindon 003C","E01015545","Total",1598,235,69,166,1363,253,122,334,202,146,145,161
"2011","Swindon 003D","E01015546","Total",1702,216,86,130,1486,268,86,446,210,157,145,174
"2011","Swindon 004A","E01015513","Total",1555,190,31,159,1365,98,92,478,322,51,127,197
"2011","Swindon 004B","E01015514","Total",1266,104,65,39,1162,31,282,237,182,84,126,220
"2011","Swindon 004C","E01015515","Total",1431,108,29,79,1323,41,138,389,326,64,92,273
"2011","Swindon 004D","E01015516","Total",1270,245,119,126,1025,59,202,191,210,29,109,225
"2011","Swindon 004E","E01015517","Total",1438,192,116,76,1246,36,350,238,252,59,113,198
"2011","Swindon 005A","E01015555","Total",1454,213,127,86,1241,52,258,253,228,71,113,266
"2011","Swindon 005B","E01015556","Total",1600,165,66,99,1435,62,192,363,312,70,181,255
"2011","Swindon 005C","E01015557","Total",1395,196,58,138,1199,37,186,258,264,40,138,276
"2011","Swindon 005D","E01015558","Total",1543,204,132,72,1339,120,198,260,156,164,179,262
"2011","Swindon 005E","E01015559","Total",1472,171,90,81,1301,45,248,241,272,62,170,263
"2011","Swindon 005F","E01015560","Total",1606,166,63,103,1440,62,258,394,232,78,175,241
"2011","Swindon 006A","E01015526","Total",1480,145,19,126,1335,90,102,363,332,93,139,216
"2011","Swindon 006B","E01015528","Total",1817,290,145,145,1527,149,144,349,248,178,214,245
"2011","Swindon 006C","E01015529","Total",1524,200,113,87,1324,74,242,254,272,53,125,304
"2011","Swindon 006D","E01015530","Total",1666,240,138,102,1426,74,166,279,222,127,257,301
"2011","Swindon 007A","E01015506","Total",1551,204,89,115,1347,126,132,252,204,137,211,285
"2011","Swindon 007B","E01015507","Total",1613,207,80,127,1406,232,56,278,214,214,197,215
"2011","Swindon 007C","E01015527","Total",1742,180,90,90,1562,153,180,318,226,166,230,289
"2011","Swindon 007D","E01015580","Total",1660,152,95,57,1508,87,160,387,220,99,220,335
"2011","Swindon 008A","E01015473","Total",1671,125,67,58,1546,43,266,315,318,95,149,360
"2011","Swindon 008B","E01015474","Total",1644,117,59,58,1527,71,238,297,278,98,166,379
"2011","Swindon 008C","E01015547","Total",1572,100,45,55,1472,33,200,360,258,120,166,335
"2011","Swindon 008D","E01015548","Total",1575,118,48,70,1457,38,198,420,284,117,156,244
"2011","Swindon 009A","E01015549","Total",1744,150,73,77,1594,83,250,379,298,87,185,312
"2011","Swindon 009B","E01015550","Total",1802,299,110,189,1503,50,320,317,390,57,107,262
"2011","Swindon 009C","E01015551","Total",1474,135,83,52,1339,47,282,297,250,72,147,244
"2011","Swindon 009D","E01015552","Total",2038,221,69,152,1817,53,146,592,320,120,229,357
"2011","Swindon 009E","E01015553","Total",1595,218,54,164,1377,53,94,369,266,110,209,276
"2011","Swindon 009F","E01015554","Total",1429,219,138,81,1210,41,276,303,134,83,118,255
"2011","Swindon 010A","E01015508","Total",1400,231,102,129,1169,88,100,287,204,90,198,202
"2011","Swindon 010B","E01015509","Total",1618,207,75,132,1411,111,118,350,340,83,124,285
"2011","Swindon 010C","E01015510","Total",1874,320,113,207,1554,98,136,341,338,109,197,335
"2011","Swindon 010D","E01015511","Total",1556,252,71,181,1304,56,120,368,296,69,132,263
"2011","Swindon 011A","E01015562","Total",1537,128,22,106,1409,117,40,488,278,71,193,222
"2011","Swindon 011B","E01015563","Total",1569,133,22,111,1436,47,72,520,274,63,199,261
"2011","Swindon 011C","E01015565","Total",1607,177,50,127,1430,84,82,402,266,80,222,294
"2011","Swindon 011D","E01015566","Total",1593,185,19,166,1408,113,72,397,348,73,120,285
"2011","Swindon 012B","E01015578","Total",1606,279,90,189,1327,90,132,340,320,124,87,234
"2011","Swindon 012C","E01015579","Total",1585,212,68,144,1373,75,122,450,328,114,67,217
"2011","Swindon 012D","E01015581","Total",1516,158,82,76,1358,34,174,365,244,69,149,323
"2011","Swindon 012E","E01015582","Total",1874,282,88,194,1592,71,166,456,316,55,218,310
"2011","Swindon 012F","E01032708","Total",1642,250,10,240,1392,71,22,392,536,64,116,191
"2011","Swindon 012G","E01032716","Total",1449,219,58,161,1230,77,90,325,296,78,149,215
"2011","Swindon 013A","E01015481","Total",1744,212,84,128,1532,72,202,411,356,108,148,235
"2011","Swindon 013B","E01015482","Total",1278,98,52,46,1180,17,186,270,236,35,146,290
"2011","Swindon 013C","E01015483","Total",1438,184,123,61,1254,20,332,228,222,47,136,269
"2011","Swindon 013D","E01015484","Total",1403,157,96,61,1246,21,298,270,244,40,110,263
"2011","Swindon 013E","E01015485","Total",1440,214,46,168,1226,42,112,380,326,42,78,246
"2011","Swindon 013F","E01015486","Total",1439,156,71,85,1283,57,214,283,272,75,131,251
"2011","Swindon 014A","E01015561","Total",1466,210,29,181,1256,56,110,316,294,71,154,255
"2011","Swindon 014B","E01015564","Total",1566,132,37,95,1434,59,106,366,272,90,180,361
"2011","Swindon 014C","E01015567","Total",1492,234,42,192,1258,47,80,403,310,49,116,253
"2011","Swindon 014D","E01015568","Total",1430,200,40,160,1230,90,110,313,228,58,108,323
"2011","Swindon 015A","E01015475","Total",2176,171,58,113,2005,68,94,302,156,75,764,546
"2011","Swindon 015B","E01015476","Total",2227,621,103,518,1606,90,100,386,496,28,221,285
"2011","Swindon 015C","E01015477","Total",1539,266,85,181,1273,81,68,372,318,40,119,275
"2011","Swindon 015D","E01015480","Total",2371,212,42,170,2159,60,64,360,212,163,763,537
"2011","Swindon 016A","E01015538","Total",1761,354,130,224,1407,161,148,353,242,120,144,239
"2011","Swindon 016B","E01015572","Total",1250,178,45,133,1072,116,92,209,150,110,182,213
"2011","Swindon 016C","E01015573","Total",2133,388,127,261,1745,207,122,439,236,187,298,256
"2011","Swindon 016D","E01015575","Total",1184,165,48,117,1019,157,120,172,122,117,129,202
"2011","Swindon 017A","E01015479","Total",1617,202,34,168,1415,87,90,309,286,114,195,334
"2011","Swindon 017B","E01015493","Total",1773,221,69,152,1552,53,132,343,274,107,325,318
"2011","Swindon 017C","E01015574","Total",1636,159,68,91,1477,78,194,371,222,105,204,303
"2011","Swindon 017D","E01015576","Total",1559,221,146,75,1338,37,274,241,196,84,201,305
"2011","Swindon 018A","E01015499","Total",1270,66,12,54,1204,22,66,298,258,41,176,343
"2011","Swindon 018B","E01015500","Total",1523,181,51,130,1342,100,66,347,354,87,142,246
"2011","Swindon 018C","E01015504","Total",1372,87,19,68,1285,68,54,414,254,45,170,280
"2011","Swindon 018D","E01015505","Total",1496,203,22,181,1293,162,48,395,344,70,96,178
"2011","Swindon 019A","E01015494","Total",1777,289,58,231,1488,47,74,338,448,56,186,339
"2011","Swindon 019C","E01015496","Total",1614,325,45,280,1289,77,70,321,488,48,83,202
"2011","Swindon 019D","E01015497","Total",1517,296,47,249,1221,81,70,315,282,78,141,254
"2011","Swindon 019E","E01032714","Total",1235,325,44,281,910,32,34,232,362,25,65,160
"2011","Swindon 019F","E01032715","Total",945,285,65,220,660,44,40,139,264,37,29,107
"2011","Swindon 020A","E01015537","Total",1773,179,79,100,1594,218,158,341,242,131,214,290
"2011","Swindon 020B","E01015539","Total",1620,148,66,82,1472,117,160,297,228,187,171,312
"2011","Swindon 020C","E01015540","Total",1827,232,76,156,1595,168,136,339,244,156,236,316
"2011","Swindon 020D","E01015541","Total",1781,238,102,136,1543,201,150,283,220,106,278,305
"2011","Swindon 020E","E01015542","Total",1451,210,105,105,1241,188,122,205,188,111,171,256
"2011","Swindon 021A","E01015478","Total",1483,217,76,141,1266,68,92,342,316,88,134,226
"2011","Swindon 021B","E01015498","Total",1726,241,37,204,1485,61,134,444,404,59,116,267
"2011","Swindon 021D","E01015532","Total",1429,215,52,163,1214,64,96,369,294,95,99,197
"2011","Swindon 021E","E01032706","Total",1412,279,10,269,1133,60,24,302,464,43,100,140
"2011","Swindon 021F","E01032707","Total",1832,175,73,102,1657,17,178,491,348,148,155,320
"2011","Swindon 022A","E01015501","Total",1369,84,25,59,1285,62,112,236,278,92,178,327
"2011","Swindon 022B","E01015502","Total",1545,200,81,119,1345,120,92,326,232,135,180,260
"2011","Swindon 022C","E01015503","Total",1314,253,110,143,1061,114,102,203,212,97,122,211
"2011","Swindon 022D","E01015569","Total",1510,209,62,147,1301,83,122,283,226,111,144,332
"2011","Swindon 022E","E01015570","Total",1531,364,144,220,1167,135,106,249,260,33,201,183
"2011","Swindon 022F","E01015571","Total",1590,164,66,98,1426,79,196,262,260,105,234,290
"2011","Swindon 023A","E01015487","Total",1615,92,58,34,1523,69,204,309,276,71,182,412
"2011","Swindon 023B","E01015488","Total",1410,244,90,154,1166,93,150,256,244,73,125,225
"2011","Swindon 023C","E01015489","Total",1438,108,44,64,1330,65,190,250,234,81,209,301
"2011","Swindon 023D","E01015490","Total",1285,138,40,98,1147,97,114,259,274,68,107,228
"2011","Swindon 023E","E01015491","Total",1473,304,117,187,1169,110,146,239,232,102,128,212
"2011","Swindon 023F","E01015492","Total",1434,116,46,70,1318,167,96,251,232,110,173,289
"2011","Swindon 024A","E01015533","Total",1497,191,123,68,1306,21,352,304,212,15,169,233
"2011","Swindon 024B","E01015534","Total",1904,506,206,300,1398,64,274,307,396,76,106,175
"2011","Swindon 024C","E01015535","Total",1475,162,85,77,1313,11,224,344,250,90,149,245
"2011","Swindon 024D","E01015536","Total",2400,246,93,153,2154,126,304,579,476,166,171,332
"2011","Swindon 025A","E01015583","Total",2282,152,46,106,2130,108,180,633,414,207,225,363
"2011","Swindon 025B","E01015584","Total",1400,204,123,81,1196,18,354,244,180,32,154,214
"2011","Swindon 025C","E01015585","Total",1608,170,67,103,1438,67,182,386,260,112,164,267
"2011","Swindon 025D","E01015586","Total",1410,162,112,50,1248,28,340,235,210,46,125,264
"2011","Swindon 025E","E01015587","Total",1878,325,195,130,1553,59,290,305,262,121,178,338
"2011","Swindon 025F","E01015588","Total",1818,156,86,70,1662,84,282,380,300,114,177,325
"2011","Swindon 026A","E01015525","Total",1578,176,21,155,1402,47,112,499,330,84,108,222
"2011","Swindon 026B","E01032700","Total",1612,80,5,75,1532,65,32,732,340,142,97,124
"2011","Swindon 026C","E01032703","Total",1468,92,3,89,1376,90,42,627,312,87,90,128
"2011","Swindon 026D","E01032705","Total",1479,142,4,138,1337,123,16,550,288,122,126,112
"2011","Swindon 026E","E01032709","Total",1358,127,5,122,1231,106,28,531,288,72,98,108
"2011","Swindon 026F","E01032713","Total",1762,90,4,86,1672,95,18,748,344,159,135,173
"2011","Swindon 027A","E01032701","Total",1219,161,7,154,1058,66,36,413,326,72,66,79
"2011","Swindon 027B","E01032702","Total",1413,142,25,117,1271,62,82,544,252,116,89,126
"2011","Swindon 027C","E01032704","Total",1419,143,5,138,1276,134,22,498,320,98,81,123
"2011","Swindon 027D","E01032711","Total",1330,184,7,177,1146,77,28,440,368,53,78,102
"2011","Swindon 027E","E01032712","Total",1408,156,8,148,1252,135,16,477,336,88,63,137
"2011","Swindon 028A","E01015471","Total",1655,167,36,131,1488,64,108,595,328,70,165,158
"2011","Swindon 028B","E01015472","Total",2754,240,16,224,2514,186,104,976,604,178,236,230
"2011","Swindon 028C","E01015512","Total",1715,88,15,73,1627,69,58,643,340,146,185,186
"2011","Swindon 028D","E01015518","Total",1561,57,5,52,1504,83,66,563,276,140,186,190
"2011","Swindon 028E","E01032710","Total",1343,128,16,112,1215,53,28,502,286,75,136,135
"2011","Torbay 001A","E01015262","Total",1352,118,61,57,1234,86,160,200,184,82,246,276
"2011","Torbay 001B","E01015263","Total",1514,188,66,122,1326,202,134,325,174,146,145,200
"2011","Torbay 001C","E01015264","Total",1323,175,97,78,1148,44,352,189,212,60,94,197
"2011","Torbay 001D","E01015265","Total",1471,164,98,66,1307,105,308,166,254,49,130,295
"2011","Torbay 001E","E01015266","Total",1494,215,113,102,1279,125,132,247,172,135,251,217
"2011","Torbay 002A","E01015236","Total",1444,184,84,100,1260,89,226,216,268,69,127,265
"2011","Torbay 002B","E01015237","Total",1358,116,61,55,1242,113,114,315,180,98,200,222
"2011","Torbay 002C","E01015238","Total",1361,192,90,102,1169,105,174,287,234,67,94,208
"2011","Torbay 002D","E01015239","Total",1422,414,241,173,1008,100,220,177,186,18,102,205
"2011","Torbay 003A","E01015249","Total",1478,191,121,70,1287,89,172,287,190,114,196,239
"2011","Torbay 003B","E01015250","Total",1438,165,67,98,1273,136,132,393,222,100,69,221
"2011","Torbay 003C","E01015251","Total",1143,112,63,49,1031,42,134,247,172,65,130,241
"2011","Torbay 003D","E01015252","Total",2368,238,64,174,2130,277,214,641,438,125,181,254
"2011","Torbay 003E","E01015253","Total",1559,144,39,105,1415,148,104,439,316,116,119,173
"2011","Torbay 003F","E01015254","Total",1394,160,110,50,1234,45,292,237,230,63,111,256
"2011","Torbay 004A","E01015257","Total",1354,171,68,103,1183,142,112,238,220,95,164,212
"2011","Torbay 004B","E01015258","Total",1861,334,89,245,1527,134,200,310,328,60,193,302
"2011","Torbay 004C","E01015259","Total",1396,175,70,105,1221,141,94,305,196,53,167,265
"2011","Torbay 004D","E01015260","Total",1477,386,120,266,1091,117,114,214,276,41,126,203
"2011","Torbay 005A","E01015240","Total",1337,408,235,173,929,72,264,136,242,26,41,148
"2011","Torbay 005B","E01015241","Total",1453,217,115,102,1236,87,178,233,178,116,206,238
"2011","Torbay 005C","E01015242","Total",1237,160,61,99,1077,114,116,251,146,57,155,238
"2011","Torbay 005D","E01015243","Total",1260,194,123,71,1066,39,262,187,190,50,80,258
"2011","Torbay 006A","E01015214","Total",1407,218,63,155,1189,141,84,248,268,69,150,229
"2011","Torbay 006B","E01015215","Total",1450,168,75,93,1282,86,166,366,212,52,172,228
"2011","Torbay 006C","E01015216","Total",1416,199,50,149,1217,141,112,296,240,88,99,241
"2011","Torbay 006D","E01015218","Total",1351,189,75,114,1162,92,152,247,210,92,156,213
"2011","Torbay 008A","E01015217","Total",1495,370,99,271,1125,188,94,213,278,91,95,166
"2011","Torbay 008B","E01015255","Total",1433,450,67,383,983,108,80,189,304,47,56,199
"2011","Torbay 008C","E01015256","Total",1741,544,146,398,1197,90,198,231,426,28,38,186
"2011","Torbay 008D","E01015261","Total",1792,431,155,276,1361,131,158,280,316,66,164,246
"2011","Torbay 010A","E01015267","Total",1385,452,160,292,933,71,228,122,350,12,48,102
"2011","Torbay 010B","E01015268","Total",1540,402,177,225,1138,66,352,156,300,32,76,156
"2011","Torbay 010C","E01015269","Total",1508,348,156,192,1160,40,272,195,302,57,86,208
"2011","Torbay 010D","E01015270","Total",1533,413,175,238,1120,73,342,153,306,10,60,176
"2011","Torbay 010E","E01015271","Total",1403,232,154,78,1171,24,438,162,216,35,70,226
"2011","Torbay 011A","E01015224","Total",1458,170,87,83,1288,100,198,293,236,96,147,218
"2011","Torbay 011B","E01015225","Total",1409,185,105,80,1224,55,184,226,202,104,192,261
"2011","Torbay 011C","E01015226","Total",1392,132,78,54,1260,36,310,254,254,83,125,198
"2011","Torbay 011D","E01015227","Total",1505,148,99,49,1357,32,252,323,222,52,164,312
"2011","Torbay 011E","E01015228","Total",1455,327,205,122,1128,65,244,232,194,36,112,245
"2011","Torbay 011F","E01015230","Total",1415,157,114,43,1258,28,388,243,214,51,95,239
"2011","Torbay 012A","E01015202","Total",1513,128,71,57,1385,72,208,337,210,123,156,279
"2011","Torbay 012B","E01015203","Total",1272,133,87,46,1139,39,288,224,184,70,128,206
"2011","Torbay 012C","E01015204","Total",1360,220,88,132,1140,79,198,266,198,68,140,191
"2011","Torbay 012D","E01015205","Total",1489,154,85,69,1335,63,248,308,260,67,150,239
"2011","Torbay 012E","E01015206","Total",1386,199,80,119,1187,80,164,278,268,73,84,240
"2011","Torbay 013A","E01015190","Total",1666,205,102,103,1461,89,278,218,248,161,222,245
"2011","Torbay 013B","E01015191","Total",1662,135,50,85,1527,134,190,389,284,161,142,227
"2011","Torbay 013C","E01015192","Total",1450,145,72,73,1305,161,166,240,222,119,165,232
"2011","Torbay 013D","E01015193","Total",1283,152,97,55,1131,47,220,233,190,104,113,224
"2011","Torbay 013E","E01015194","Total",1400,196,77,119,1204,99,190,185,198,96,202,234
"2011","Torbay 013F","E01015195","Total",1506,204,103,101,1302,78,192,247,206,100,249,230
"2011","Torbay 013G","E01015196","Total",1508,166,73,93,1342,200,90,269,162,175,207,239
"2011","Torbay 014A","E01015229","Total",1272,255,149,106,1017,43,220,157,186,59,149,203
"2011","Torbay 014B","E01015231","Total",1547,465,165,300,1082,146,106,270,230,51,106,173
"2011","Torbay 014C","E01015232","Total",1477,445,167,278,1032,75,206,135,290,40,114,172
"2011","Torbay 014D","E01015233","Total",1308,352,117,235,956,99,154,179,204,47,95,178
"2011","Torbay 014E","E01015234","Total",1318,224,89,135,1094,139,98,242,220,102,143,150
"2011","Torbay 014F","E01015235","Total",1510,408,235,173,1102,41,348,165,256,31,85,176
"2011","Torbay 015A","E01015219","Total",1355,316,184,132,1039,45,238,142,178,77,146,213
"2011","Torbay 015B","E01015220","Total",1370,168,103,65,1202,49,294,220,220,55,128,236
"2011","Torbay 015C","E01015221","Total",1426,206,119,87,1220,69,200,237,228,86,129,271
"2011","Torbay 015D","E01015222","Total",1411,172,103,69,1239,94,284,220,216,78,87,260
"2011","Torbay 015E","E01015223","Total",1304,88,44,44,1216,53,188,258,204,78,146,289
"2011","Torbay 016A","E01015197","Total",1439,146,103,43,1293,25,406,212,196,58,105,291
"2011","Torbay 016B","E01015198","Total",1567,220,180,40,1347,43,438,203,224,63,91,285
"2011","Torbay 016C","E01015199","Total",1276,191,144,47,1085,12,424,87,196,51,61,254
"2011","Torbay 016D","E01015200","Total",1016,135,83,52,881,55,182,181,136,36,139,152
"2011","Torbay 016E","E01015201","Total",1295,159,100,59,1136,34,262,196,218,41,118,267
"2011","Torbay 017A","E01015183","Total",1291,186,106,80,1105,44,248,201,172,69,121,250
"2011","Torbay 017B","E01015184","Total",1275,183,133,50,1092,18,426,155,192,43,108,150
"2011","Torbay 017C","E01015185","Total",1321,285,163,122,1036,67,260,201,214,35,80,179
"2011","Torbay 017D","E01015186","Total",1337,269,104,165,1068,139,164,197,270,36,87,175
"2011","Torbay 017E","E01015187","Total",1377,266,176,90,1111,56,376,139,218,36,95,191
"2011","Torbay 017F","E01015188","Total",1450,202,133,69,1248,73,342,164,202,63,160,244
"2011","Torbay 017G","E01015189","Total",1165,206,84,122,959,71,182,158,206,70,101,171
"2011","Torbay 018A","E01015244","Total",1463,174,106,68,1289,62,304,244,214,90,165,210
"2011","Torbay 018B","E01015245","Total",1312,167,108,59,1145,82,324,195,188,41,119,196
"2011","Torbay 018C","E01015246","Total",1337,175,114,61,1162,57,270,242,192,68,115,218
"2011","Torbay 018D","E01015247","Total",1707,206,114,92,1501,87,268,324,268,109,170,275
"2011","Torbay 018E","E01015248","Total",1433,234,127,107,1199,121,158,228,214,55,150,273
"2011","Torbay 019E","E01015207","Total",1570,171,66,105,1399,80,168,352,250,95,169,285
"2011","Torbay 019F","E01015208","Total",1835,240,176,64,1595,47,502,249,266,100,123,308
"2011","Torbay 019A","E01015209","Total",1297,266,108,158,1031,60,158,218,198,73,139,185
"2011","Torbay 019B","E01015210","Total",1507,176,94,82,1331,137,162,362,240,69,131,230
"2011","Torbay 019G","E01015211","Total",1461,126,74,52,1335,55,246,303,208,112,138,273
"2011","Torbay 019C","E01015212","Total",1369,181,53,128,1188,96,130,308,218,84,112,240
"2011","Torbay 019D","E01015213","Total",1433,136,74,62,1297,71,178,311,206,83,205,243
"2011","Wiltshire 012A","E01031841","Total",1813,211,90,121,1602,88,286,407,320,111,162,228
"2011","Wiltshire 012B","E01031868","Total",1762,125,50,75,1637,41,224,350,332,122,245,323
"2011","Wiltshire 012C","E01031873","Total",1768,194,106,88,1574,73,206,420,306,101,160,308
"2011","Wiltshire 012D","E01031874","Total",1529,184,113,71,1345,25,230,308,242,146,134,260
"2011","Wiltshire 012E","E01031884","Total",1612,167,85,82,1445,51,230,348,290,89,178,259
"2011","Wiltshire 019A","E01031861","Total",2334,302,174,128,2032,109,336,411,394,140,174,468
"2011","Wiltshire 019B","E01031862","Total",1554,274,127,147,1280,124,144,343,218,86,101,264
"2011","Wiltshire 019C","E01031863","Total",1131,236,84,152,895,32,188,186,230,50,87,122
"2011","Wiltshire 019D","E01031864","Total",1329,102,54,48,1227,10,194,374,198,81,141,229
"2011","Wiltshire 019E","E01031865","Total",1213,207,136,71,1006,70,224,191,148,71,63,239
"2011","Wiltshire 024A","E01031866","Total",1565,186,80,106,1379,39,242,326,306,66,145,255
"2011","Wiltshire 024B","E01031869","Total",1839,302,177,125,1537,140,252,343,286,86,163,267
"2011","Wiltshire 024C","E01031870","Total",1747,263,118,145,1484,58,258,349,354,93,136,236
"2011","Wiltshire 024D","E01031871","Total",1653,192,81,111,1461,79,246,394,280,78,150,234
"2011","Wiltshire 025A","E01031850","Total",1855,362,173,189,1493,104,266,381,398,41,90,213
"2011","Wiltshire 025B","E01031851","Total",1512,179,56,123,1333,162,148,268,220,121,122,292
"2011","Wiltshire 025C","E01031852","Total",2030,192,98,94,1838,79,314,474,284,130,235,322
"2011","Wiltshire 025E","E01032688","Total",1331,90,27,63,1241,132,94,379,224,138,121,153
"2011","Wiltshire 025F","E01032689","Total",1338,116,57,59,1222,92,154,339,206,89,128,214
"2011","Wiltshire 025G","E01032692","Total",1167,135,26,109,1032,99,86,344,266,37,80,120
"2011","Wiltshire 025H","E01032693","Total",1371,143,36,107,1228,107,132,326,268,140,128,127
"2011","Wiltshire 026A","E01031853","Total",1409,219,81,138,1190,79,232,224,226,62,106,261
"2011","Wiltshire 026B","E01031854","Total",1767,548,242,306,1219,113,218,246,336,41,88,177
"2011","Wiltshire 026C","E01031855","Total",1508,155,96,59,1353,47,304,262,244,126,124,246
"2011","Wiltshire 026D","E01031856","Total",1557,282,147,135,1275,95,288,239,230,82,110,231
"2011","Wiltshire 028A","E01031845","Total",1538,153,88,65,1385,63,250,242,324,77,111,318
"2011","Wiltshire 028B","E01031846","Total",1627,164,91,73,1463,62,246,332,334,88,141,260
"2011","Wiltshire 028C","E01031848","Total",1782,145,82,63,1637,51,288,392,296,94,195,321
"2011","Wiltshire 028D","E01031872","Total",1617,156,90,66,1461,93,256,257,312,147,170,226
"2011","Wiltshire 028E","E01031876","Total",1502,123,66,57,1379,54,290,243,268,128,161,235
"2011","Wiltshire 029A","E01031843","Total",1782,221,111,110,1561,67,262,427,324,136,132,213
"2011","Wiltshire 029B","E01031847","Total",1772,171,94,77,1601,42,266,403,310,127,170,283
"2011","Wiltshire 029C","E01031849","Total",1626,138,57,81,1488,79,208,326,356,88,169,262
"2011","Wiltshire 029D","E01031877","Total",1833,167,81,86,1666,50,304,457,356,174,133,192
"2011","Wiltshire 034A","E01031844","Total",1926,224,76,148,1702,133,228,424,356,128,152,281
"2011","Wiltshire 034B","E01031857","Total",1535,172,75,97,1363,96,164,282,250,133,152,286
"2011","Wiltshire 034C","E01031858","Total",1752,184,91,93,1568,67,196,297,304,161,231,312
"2011","Wiltshire 034D","E01031883","Total",1775,194,122,72,1581,56,370,310,344,81,156,264
"2011","Wiltshire 038A","E01031842","Total",1907,154,80,74,1753,59,316,423,310,131,191,323
"2011","Wiltshire 038B","E01031867","Total",1789,222,104,118,1567,112,210,348,402,66,119,310
"2011","Wiltshire 038C","E01031882","Total",2018,194,96,98,1824,65,298,546,390,117,124,284
"2011","Wiltshire 041A","E01031859","Total",1697,252,97,155,1445,161,154,274,284,123,189,260
"2011","Wiltshire 041B","E01031860","Total",1510,155,63,92,1355,90,148,367,318,95,120,217
"2011","Wiltshire 041C","E01031878","Total",2117,128,28,100,1989,123,102,759,352,245,206,202
"2011","Wiltshire 041D","E01031879","Total",1733,27,12,15,1706,39,16,978,374,174,76,49
"2011","Wiltshire 041E","E01031880","Total",1942,48,10,38,1894,61,30,751,220,368,271,193
"2011","Wiltshire 041G","E01032697","Total",1481,137,8,129,1344,150,18,524,252,150,118,132
"2011","Wiltshire 041H","E01032698","Total",1671,124,57,67,1547,119,112,431,244,147,227,267
"2011","Wiltshire 001A","E01031887","Total",1748,154,89,65,1594,72,234,407,320,120,150,291
"2011","Wiltshire 001B","E01031934","Total",1749,127,68,59,1622,50,272,377,306,97,185,335
"2011","Wiltshire 001C","E01031935","Total",1719,175,76,99,1544,63,236,394,352,107,140,252
"2011","Wiltshire 001D","E01031936","Total",1478,181,95,86,1297,132,184,293,230,97,119,242
"2011","Wiltshire 002A","E01031885","Total",1581,136,54,82,1445,26,212,404,300,140,145,218
"2011","Wiltshire 002B","E01031947","Total",1657,209,120,89,1448,124,220,304,224,124,196,256
"2011","Wiltshire 002C","E01031948","Total",2095,178,70,108,1917,107,190,667,346,133,173,301
"2011","Wiltshire 002D","E01031949","Total",1771,282,106,176,1489,81,222,334,398,110,100,244
"2011","Wiltshire 003A","E01031954","Total",1342,112,60,52,1230,34,184,306,222,95,182,207
"2011","Wiltshire 003B","E01031955","Total",1536,165,100,65,1371,35,260,279,288,127,161,221
"2011","Wiltshire 003C","E01031956","Total",1239,134,62,72,1105,117,164,231,186,113,128,166
"2011","Wiltshire 003D","E01031962","Total",1330,109,71,38,1221,11,236,340,214,62,135,223
"2011","Wiltshire 004A","E01031886","Total",1414,102,45,57,1312,15,216,352,268,71,132,258
"2011","Wiltshire 004B","E01031892","Total",1379,102,51,51,1277,14,264,333,242,88,124,212
"2011","Wiltshire 004C","E01031893","Total",1576,107,54,53,1469,62,214,343,280,102,196,272
"2011","Wiltshire 004D","E01031894","Total",1515,110,64,46,1405,26,236,379,258,116,91,299
"2011","Wiltshire 005A","E01031957","Total",1477,173,95,78,1304,63,182,338,236,137,135,213
"2011","Wiltshire 005B","E01031958","Total",1375,129,64,65,1246,54,200,346,230,61,125,230
"2011","Wiltshire 005C","E01031959","Total",1551,204,109,95,1347,23,266,363,278,100,98,219
"2011","Wiltshire 005D","E01031960","Total",1385,80,34,46,1305,57,154,480,252,88,134,140
"2011","Wiltshire 006A","E01031963","Total",1771,216,120,96,1555,137,222,272,216,132,232,344
"2011","Wiltshire 006B","E01031964","Total",1681,246,108,138,1435,58,232,258,344,50,149,344
"2011","Wiltshire 006C","E01031967","Total",1869,313,168,145,1556,126,206,386,362,78,134,264
"2011","Wiltshire 006D","E01031969","Total",1438,134,22,112,1304,44,100,370,290,26,190,284
"2011","Wiltshire 007B","E01031944","Total",1062,90,26,64,972,50,140,230,266,41,86,159
"2011","Wiltshire 007D","E01031946","Total",1561,22,2,20,1539,65,12,700,242,238,155,127
"2011","Wiltshire 007E","E01031961","Total",1301,92,39,53,1209,43,222,251,250,77,105,261
"2011","Wiltshire 007F","E01031965","Total",1385,189,89,100,1196,35,204,244,264,73,115,261
"2011","Wiltshire 007G","E01031966","Total",1525,134,76,58,1391,39,246,321,258,78,149,300
"2011","Wiltshire 007H","E01031968","Total",1599,170,70,100,1429,36,224,348,286,76,138,321
"2011","Wiltshire 007I","E01032699","Total",2306,227,122,105,2079,63,358,661,470,76,145,306
"2011","Wiltshire 008A","E01031939","Total",2140,174,92,82,1966,79,280,493,350,117,304,343
"2011","Wiltshire 008B","E01031940","Total",2214,240,116,124,1974,47,328,539,346,147,228,339
"2011","Wiltshire 008C","E01031950","Total",1392,98,41,57,1294,20,186,335,242,128,132,251
"2011","Wiltshire 008D","E01031951","Total",1199,77,45,32,1122,23,162,329,234,84,143,147
"2011","Wiltshire 009A","E01031907","Total",2473,166,40,126,2307,90,156,767,430,138,356,370
"2011","Wiltshire 009B","E01031910","Total",1419,154,49,105,1265,72,130,355,230,66,166,246
"2011","Wiltshire 009C","E01031914","Total",1321,126,47,79,1195,131,86,265,162,173,192,186
"2011","Wiltshire 009D","E01031915","Total",1366,192,101,91,1174,40,150,360,252,61,140,171
"2011","Wiltshire 009E","E01031919","Total",1581,116,76,40,1465,58,228,412,174,136,210,247
"2011","Wiltshire 009F","E01031920","Total",1262,131,49,82,1131,42,98,343,208,104,107,229
"2011","Wiltshire 010A","E01031905","Total",1461,53,9,44,1408,49,82,399,220,133,205,320
"2011","Wiltshire 010B","E01031906","Total",1467,171,30,141,1296,83,80,404,380,87,87,175
"2011","Wiltshire 010C","E01031908","Total",1628,221,81,140,1407,154,144,319,274,98,157,261
"2011","Wiltshire 010D","E01031909","Total",1271,123,67,56,1148,43,202,270,200,53,144,236
"2011","Wiltshire 010E","E01031925","Total",1171,145,78,67,1026,119,150,203,162,103,104,185
"2011","Wiltshire 010F","E01031926","Total",1491,164,92,72,1327,96,160,355,230,69,161,256
"2011","Wiltshire 010G","E01031927","Total",1306,79,48,31,1227,35,196,300,208,50,166,272
"2011","Wiltshire 011A","E01031911","Total",1369,194,93,101,1175,127,90,223,196,132,208,199
"2011","Wiltshire 011B","E01031912","Total",1358,361,113,248,997,117,110,238,254,62,39,177
"2011","Wiltshire 011C","E01031913","Total",1322,133,53,80,1189,44,154,319,280,91,88,213
"2011","Wiltshire 011D","E01031917","Total",1354,271,82,189,1083,82,104,273,318,54,72,180
"2011","Wiltshire 011E","E01031918","Total",2411,366,205,161,2045,96,496,473,418,124,166,272
"2011","Wiltshire 011F","E01031928","Total",1336,227,108,119,1109,165,132,209,184,57,145,217
"2011","Wiltshire 013A","E01031891","Total",2248,162,77,85,2086,84,316,446,420,107,278,435
"2011","Wiltshire 013B","E01031904","Total",2098,156,80,76,1942,80,284,440,322,173,264,379
"2011","Wiltshire 013C","E01031937","Total",1091,85,55,30,1006,25,162,233,232,66,92,196
"2011","Wiltshire 013D","E01031938","Total",1416,120,57,63,1296,58,174,363,264,117,135,185
"2011","Wiltshire 014A","E01031916","Total",1299,139,80,59,1160,78,150,269,196,42,149,276
"2011","Wiltshire 014B","E01031921","Total",1453,96,33,63,1357,53,62,491,234,94,131,292
"2011","Wiltshire 014C","E01031922","Total",1273,226,38,188,1047,33,48,329,300,69,78,190
"2011","Wiltshire 014D","E01031923","Total",1374,109,30,79,1265,39,110,401,254,77,142,242
"2011","Wiltshire 014E","E01031924","Total",1663,175,33,142,1488,80,52,556,316,77,194,213
"2011","Wiltshire 015A","E01031895","Total",1590,150,85,65,1440,90,208,338,228,138,198,240
"2011","Wiltshire 015B","E01031896","Total",1184,224,90,134,960,137,142,213,166,66,63,173
"2011","Wiltshire 015C","E01031897","Total",2141,176,52,124,1965,122,216,626,348,167,190,296
"2011","Wiltshire 015D","E01031898","Total",1536,179,74,105,1357,107,144,360,306,111,123,206
"2011","Wiltshire 015F","E01032690","Total",1794,128,15,113,1666,110,56,587,340,229,205,139
"2011","Wiltshire 015G","E01032691","Total",1537,138,55,83,1399,89,106,481,244,144,126,209
"2011","Wiltshire 016A","E01031900","Total",2181,359,197,162,1822,67,368,442,424,42,179,300
"2011","Wiltshire 016B","E01031901","Total",1453,205,69,136,1248,109,156,343,244,84,117,195
"2011","Wiltshire 016C","E01031902","Total",1157,129,36,93,1028,92,92,219,204,52,161,208
"2011","Wiltshire 016D","E01031903","Total",2320,244,124,120,2076,84,356,492,450,97,246,351
"2011","Wiltshire 017A","E01031888","Total",1303,151,80,71,1152,46,210,255,270,92,126,153
"2011","Wiltshire 017B","E01031889","Total",1852,185,67,118,1667,115,140,542,344,139,141,246
"2011","Wiltshire 017C","E01031890","Total",1476,163,90,73,1313,52,246,295,230,145,120,225
"2011","Wiltshire 017D","E01031929","Total",1314,135,90,45,1179,61,208,273,206,91,131,209
"2011","Wiltshire 017E","E01031930","Total",1367,56,14,42,1311,55,54,529,258,153,118,144
"2011","Wiltshire 018A","E01031931","Total",1635,217,128,89,1418,69,344,314,222,91,141,237
"2011","Wiltshire 018B","E01031932","Total",1400,225,140,85,1175,41,268,223,240,25,97,281
"2011","Wiltshire 018C","E01031933","Total",1548,153,76,77,1395,111,166,394,214,82,158,270
"2011","Wiltshire 018D","E01031941","Total",1595,138,59,79,1457,111,176,433,248,102,142,245
"2011","Wiltshire 018E","E01031942","Total",1309,114,60,54,1195,47,220,268,258,64,97,241
"2011","Wiltshire 018F","E01031952","Total",2359,392,180,212,1967,228,280,341,398,161,200,359
"2011","Wiltshire 018G","E01031953","Total",2880,272,86,186,2608,196,248,831,562,171,266,334
"2011","Wiltshire 045B","E01031988","Total",1588,44,3,41,1544,42,6,763,384,144,105,100
"2011","Wiltshire 045C","E01031998","Total",2331,37,7,30,2294,90,6,1221,344,299,225,109
"2011","Wiltshire 045D","E01032026","Total",1599,154,82,72,1445,46,268,353,262,93,147,276
"2011","Wiltshire 045F","E01032696","Total",2078,195,88,107,1883,83,270,536,374,102,152,366
"2011","Wiltshire 046A","E01031989","Total",1543,128,63,65,1415,99,140,382,186,154,177,277
"2011","Wiltshire 046B","E01031996","Total",1397,129,80,49,1268,83,190,220,194,100,177,304
"2011","Wiltshire 046C","E01031997","Total",1434,137,44,93,1297,78,154,305,248,79,112,321
"2011","Wiltshire 046D","E01031999","Total",1524,145,72,73,1379,73,234,262,302,71,127,310
"2011","Wiltshire 048A","E01031974","Total",1264,179,118,61,1085,41,282,197,188,37,105,235
"2011","Wiltshire 048B","E01031975","Total",1260,165,98,67,1095,88,174,157,158,90,177,251
"2011","Wiltshire 048C","E01031976","Total",1420,62,17,45,1358,107,40,523,248,165,147,128
"2011","Wiltshire 048D","E01031977","Total",2878,205,55,150,2673,201,180,854,488,161,361,428
"2011","Wiltshire 048E","E01031978","Total",1753,142,33,109,1611,159,80,518,336,105,157,256
"2011","Wiltshire 048F","E01031979","Total",1960,270,115,155,1690,88,232,378,376,74,155,387
"2011","Wiltshire 049A","E01032013","Total",1964,199,109,90,1765,66,372,403,318,118,196,292
"2011","Wiltshire 049B","E01032032","Total",1598,121,67,54,1477,40,338,313,290,70,161,265
"2011","Wiltshire 049C","E01032033","Total",1424,134,61,73,1290,53,226,340,316,45,119,191
"2011","Wiltshire 049D","E01032034","Total",1398,128,87,41,1270,48,224,333,246,93,106,220
"2011","Wiltshire 050A","E01032010","Total",2057,265,148,117,1792,47,402,340,406,158,167,272
"2011","Wiltshire 050B","E01032035","Total",1502,172,117,55,1330,38,402,232,286,84,110,178
"2011","Wiltshire 050C","E01032036","Total",1457,172,99,73,1285,58,270,258,246,122,88,243
"2011","Wiltshire 050D","E01032037","Total",1438,260,135,125,1178,91,248,221,226,109,87,196
"2011","Wiltshire 051A","E01031984","Total",1600,105,41,64,1495,67,132,519,280,102,178,217
"2011","Wiltshire 051B","E01031985","Total",1258,139,73,66,1119,97,132,339,186,63,130,172
"2011","Wiltshire 051C","E01031986","Total",1242,229,124,105,1013,93,190,204,204,77,49,196
"2011","Wiltshire 051D","E01032017","Total",1466,147,97,50,1319,35,256,309,204,110,122,283
"2011","Wiltshire 052A","E01031980","Total",1538,137,49,88,1401,114,96,331,254,110,210,286
"2011","Wiltshire 052B","E01031981","Total",1636,138,63,75,1498,180,116,258,196,167,241,340
"2011","Wiltshire 052C","E01031982","Total",1448,126,66,60,1322,74,150,267,214,102,205,310
"2011","Wiltshire 052D","E01031983","Total",1747,197,60,137,1550,252,114,384,230,147,156,267
"2011","Wiltshire 053A","E01032018","Total",1580,119,74,45,1461,34,282,283,268,102,156,336
"2011","Wiltshire 053B","E01032019","Total",1411,222,147,75,1189,100,160,256,180,90,159,244
"2011","Wiltshire 053C","E01032020","Total",1474,192,111,81,1282,54,210,261,232,118,153,254
"2011","Wiltshire 053D","E01032025","Total",1472,167,86,81,1305,39,186,297,258,70,121,334
"2011","Wiltshire 054A","E01031990","Total",1964,185,103,82,1779,57,342,412,314,148,182,324
"2011","Wiltshire 054B","E01032004","Total",2266,271,150,121,1995,95,426,423,398,156,188,309
"2011","Wiltshire 054C","E01032027","Total",1326,171,96,75,1155,36,278,247,260,32,90,212
"2011","Wiltshire 054D","E01032038","Total",1321,209,133,76,1112,24,290,205,246,66,53,228
"2011","Wiltshire 054E","E01032039","Total",1363,262,121,141,1101,75,158,333,276,61,53,145
"2011","Wiltshire 054F","E01032040","Total",1459,162,79,83,1297,107,224,263,230,99,136,238
"2011","Wiltshire 055A","E01032001","Total",1496,154,54,100,1342,49,168,375,232,73,146,299
"2011","Wiltshire 055B","E01032002","Total",1321,198,71,127,1123,56,108,298,290,69,76,226
"2011","Wiltshire 055C","E01032003","Total",1414,331,152,179,1083,51,132,245,310,53,76,216
"2011","Wiltshire 055D","E01032024","Total",2344,412,109,303,1932,156,148,467,562,95,144,360
"2011","Wiltshire 056A","E01032014","Total",1610,428,211,217,1182,78,162,225,302,83,103,229
"2011","Wiltshire 056B","E01032015","Total",1342,202,69,133,1140,79,106,221,266,72,122,274
"2011","Wiltshire 056C","E01032016","Total",1360,210,66,144,1150,46,126,244,308,86,107,233
"2011","Wiltshire 056D","E01032021","Total",1426,258,107,151,1168,66,160,295,318,41,87,201
"2011","Wiltshire 057A","E01032000","Total",2245,261,123,138,1984,90,320,465,352,187,244,326
"2011","Wiltshire 057B","E01032011","Total",2519,233,104,129,2286,213,246,613,462,187,212,353
"2011","Wiltshire 057C","E01032012","Total",1733,188,134,54,1545,39,450,323,230,89,145,269
"2011","Wiltshire 058A","E01032008","Total",1513,235,140,95,1278,69,224,273,200,101,188,223
"2011","Wiltshire 058B","E01032009","Total",1792,278,180,98,1514,26,386,290,272,112,146,282
"2011","Wiltshire 058C","E01032022","Total",1617,488,280,208,1129,71,208,171,340,66,55,218
"2011","Wiltshire 059A","E01032005","Total",1265,139,80,59,1126,39,170,332,206,52,129,198
"2011","Wiltshire 059B","E01032006","Total",1254,107,52,55,1147,46,172,365,224,56,124,160
"2011","Wiltshire 059C","E01032007","Total",1348,139,45,94,1209,94,88,378,224,96,119,210
"2011","Wiltshire 059D","E01032023","Total",1702,375,207,168,1327,165,172,305,234,114,92,245
"2011","Wiltshire 060A","E01031970","Total",1575,140,79,61,1435,43,274,340,286,71,143,278
"2011","Wiltshire 060B","E01031971","Total",1177,140,65,75,1037,49,166,199,236,65,146,176
"2011","Wiltshire 060C","E01031972","Total",1501,120,71,49,1381,63,238,310,248,93,172,257
"2011","Wiltshire 060D","E01032041","Total",1925,153,97,56,1772,23,398,367,314,121,197,352
"2011","Wiltshire 060E","E01032042","Total",1723,143,82,61,1580,59,236,341,276,155,255,258
"2011","Wiltshire 061A","E01031991","Total",1849,240,123,117,1609,66,364,328,358,95,117,281
"2011","Wiltshire 061B","E01032029","Total",1373,175,100,75,1198,32,238,243,256,104,140,185
"2011","Wiltshire 061C","E01032030","Total",1530,261,147,114,1269,102,250,270,230,79,132,206
"2011","Wiltshire 061D","E01032031","Total",1075,123,73,50,952,16,280,153,210,71,62,160
"2011","Wiltshire 062A","E01031973","Total",1822,139,73,66,1683,35,328,348,302,162,209,299
"2011","Wiltshire 062B","E01031992","Total",1479,132,89,43,1347,28,288,268,280,79,139,265
"2011","Wiltshire 062C","E01031993","Total",1456,166,109,57,1290,68,282,264,200,119,124,233
"2011","Wiltshire 062D","E01031994","Total",1288,108,61,47,1180,77,174,260,184,83,114,288
"2011","Wiltshire 062E","E01031995","Total",1617,207,111,96,1410,79,288,326,274,114,90,239
"2011","Wiltshire 020A","E01032063","Total",1910,185,86,99,1725,162,262,389,278,122,216,296
"2011","Wiltshire 020B","E01032064","Total",1335,123,48,75,1212,95,118,253,192,151,205,198
"2011","Wiltshire 020C","E01032065","Total",1569,164,90,74,1405,111,194,353,240,117,156,234
"2011","Wiltshire 020D","E01032073","Total",1422,131,43,88,1291,128,98,338,264,138,119,206
"2011","Wiltshire 020E","E01032074","Total",1108,158,85,73,950,27,292,140,204,16,86,185
"2011","Wiltshire 021A","E01032043","Total",1191,123,70,53,1068,37,224,254,216,81,101,155
"2011","Wiltshire 021B","E01032044","Total",1324,128,89,39,1196,25,274,239,214,61,154,229
"2011","Wiltshire 021C","E01032057","Total",1171,124,70,54,1047,28,176,254,194,64,91,240
"2011","Wiltshire 021D","E01032070","Total",1506,216,111,105,1290,71,220,249,268,84,134,264
"2011","Wiltshire 021E","E01032071","Total",2295,148,69,79,2147,81,324,506,396,140,311,389
"2011","Wiltshire 021F","E01032072","Total",2032,110,31,79,1922,144,126,543,316,155,282,356
"2011","Wiltshire 022A","E01032062","Total",1550,361,154,207,1189,100,118,270,244,128,132,197
"2011","Wiltshire 022B","E01032066","Total",1514,172,67,105,1342,107,164,389,226,108,154,194
"2011","Wiltshire 022C","E01032067","Total",1531,166,85,81,1365,71,284,299,232,91,141,247
"2011","Wiltshire 022D","E01032068","Total",1378,327,195,132,1051,98,182,242,200,44,102,183
"2011","Wiltshire 022E","E01032069","Total",1266,93,49,44,1173,73,184,213,210,86,129,278
"2011","Wiltshire 023A","E01032058","Total",1377,166,85,81,1211,48,206,290,250,95,148,174
"2011","Wiltshire 023B","E01032059","Total",1771,168,95,73,1603,45,316,415,250,103,196,278
"2011","Wiltshire 023C","E01032060","Total",1517,223,148,75,1294,52,346,273,208,71,104,240
"2011","Wiltshire 023D","E01032061","Total",1162,145,81,64,1017,32,224,224,202,77,101,157
"2011","Wiltshire 027A","E01032045","Total",1469,133,74,59,1336,48,280,325,222,117,133,211
"2011","Wiltshire 027B","E01032046","Total",1547,236,137,99,1311,79,226,375,236,74,97,224
"2011","Wiltshire 027C","E01032047","Total",1382,170,115,55,1212,44,284,284,182,64,104,250
"2011","Wiltshire 027D","E01032048","Total",1698,239,135,104,1459,102,246,357,262,90,170,232
"2011","Wiltshire 027E","E01032049","Total",1550,228,123,105,1322,46,246,300,264,86,138,242
"2011","Wiltshire 027F","E01032050","Total",1739,384,184,200,1355,31,318,303,336,66,68,233
"2011","Wiltshire 030A","E01032077","Total",1665,131,61,70,1534,65,240,357,318,72,159,323
"2011","Wiltshire 030B","E01032078","Total",2835,271,55,216,2564,254,204,781,636,169,193,327
"2011","Wiltshire 030C","E01032079","Total",1496,164,106,58,1332,82,248,250,240,93,165,254
"2011","Wiltshire 030D","E01032080","Total",1719,85,37,48,1634,76,162,590,270,159,148,229
"2011","Wiltshire 031A","E01032085","Total",1625,177,66,111,1448,55,108,368,322,69,197,329
"2011","Wiltshire 031B","E01032086","Total",2370,528,131,397,1842,213,114,465,432,90,236,292
"2011","Wiltshire 031C","E01032087","Total",2103,290,146,144,1813,89,330,375,316,99,219,385
"2011","Wiltshire 032A","E01032099","Total",2925,200,75,125,2725,185,298,946,534,234,249,279
"2011","Wiltshire 032B","E01032100","Total",1481,186,98,88,1295,71,234,317,252,77,131,213
"2011","Wiltshire 032C","E01032101","Total",1638,323,156,167,1315,127,122,287,302,76,123,278
"2011","Wiltshire 032D","E01032102","Total",1514,174,120,54,1340,47,248,294,272,86,136,257
"2011","Wiltshire 033A","E01032096","Total",1876,231,96,135,1645,257,164,327,204,172,227,294
"2011","Wiltshire 033B","E01032097","Total",1840,155,98,57,1685,42,288,337,298,102,237,381
"2011","Wiltshire 033C","E01032098","Total",1642,120,63,57,1522,75,246,276,222,121,192,390
"2011","Wiltshire 035A","E01032092","Total",1402,167,53,114,1235,70,144,278,332,42,125,244
"2011","Wiltshire 035B","E01032093","Total",1860,178,63,115,1682,241,128,414,224,124,329,222
"2011","Wiltshire 035C","E01032094","Total",2329,339,108,231,1990,210,158,515,368,202,229,308
"2011","Wiltshire 035D","E01032095","Total",1698,127,49,78,1571,110,182,395,302,148,119,315
"2011","Wiltshire 036A","E01032088","Total",1517,157,99,58,1360,77,238,270,232,118,153,272
"2011","Wiltshire 036B","E01032089","Total",1475,204,52,152,1271,70,86,377,354,63,107,214
"2011","Wiltshire 036C","E01032090","Total",1435,180,88,92,1255,52,182,332,220,86,135,248
"2011","Wiltshire 036D","E01032091","Total",1228,166,53,113,1062,106,154,269,194,66,101,172
"2011","Wiltshire 037A","E01032053","Total",1412,125,72,53,1287,64,252,247,242,102,163,217
"2011","Wiltshire 037B","E01032083","Total",2271,196,92,104,2075,91,358,471,384,174,233,364
"2011","Wiltshire 037C","E01032084","Total",2569,240,122,118,2329,109,486,533,458,180,180,383
"2011","Wiltshire 039A","E01032052","Total",1274,140,72,68,1134,30,226,222,270,36,100,250
"2011","Wiltshire 039B","E01032054","Total",1285,124,61,63,1161,82,186,224,212,109,160,188
"2011","Wiltshire 039C","E01032055","Total",1235,116,74,42,1119,13,272,234,268,54,82,196
"2011","Wiltshire 039D","E01032056","Total",1357,124,57,67,1233,89,196,311,222,106,112,197
"2011","Wiltshire 039E","E01032121","Total",1565,198,103,95,1367,54,278,328,268,107,117,215
"2011","Wiltshire 040A","E01032115","Total",1700,334,160,174,1366,131,184,313,282,36,189,231
"2011","Wiltshire 040B","E01032116","Total",2573,251,113,138,2322,155,326,628,444,168,222,379
"2011","Wiltshire 040C","E01032117","Total",2628,212,81,131,2416,222,204,764,422,154,218,432
"2011","Wiltshire 040D","E01032118","Total",1551,114,56,58,1437,172,130,309,166,129,283,248
"2011","Wiltshire 040E","E01032119","Total",1855,350,100,250,1505,201,172,402,430,55,65,180
"2011","Wiltshire 040G","E01032694","Total",1644,94,14,80,1550,186,58,505,294,116,205,186
"2011","Wiltshire 040H","E01032695","Total",1394,154,78,76,1240,31,218,251,286,101,136,217
"2011","Wiltshire 042A","E01032104","Total",1222,150,84,66,1072,113,136,227,144,94,139,219
"2011","Wiltshire 042B","E01032105","Total",1441,182,117,65,1259,42,326,233,272,41,109,236
"2011","Wiltshire 042C","E01032107","Total",1553,44,5,39,1509,51,12,737,218,232,157,102
"2011","Wiltshire 042D","E01032108","Total",1288,232,153,79,1056,26,222,215,240,99,97,157
"2011","Wiltshire 043A","E01032110","Total",1604,155,94,61,1449,67,324,331,296,71,113,247
"2011","Wiltshire 043B","E01032111","Total",1272,154,74,80,1118,83,166,244,196,53,126,250
"2011","Wiltshire 043C","E01032112","Total",1464,160,52,108,1304,107,104,334,314,82,143,220
"2011","Wiltshire 043D","E01032113","Total",1373,169,83,86,1204,84,180,271,242,60,104,263
"2011","Wiltshire 044A","E01032103","Total",1680,367,177,190,1313,104,238,189,356,47,151,228
"2011","Wiltshire 044B","E01032106","Total",1352,148,101,47,1204,52,292,197,214,57,135,257
"2011","Wiltshire 044C","E01032109","Total",1467,236,94,142,1231,80,194,301,240,73,124,219
"2011","Wiltshire 044D","E01032114","Total",1317,259,124,135,1058,108,156,204,234,53,115,188
"2011","Wiltshire 047A","E01032051","Total",1324,144,76,68,1180,26,264,287,258,60,110,175
"2011","Wiltshire 047B","E01032075","Total",1342,153,81,72,1189,60,256,242,236,60,132,203
"2011","Wiltshire 047C","E01032076","Total",1221,146,81,65,1075,36,220,229,206,44,131,209
"2011","Wiltshire 047D","E01032081","Total",1203,158,73,85,1045,32,210,188,232,55,118,210
"2011","Wiltshire 047E","E01032082","Total",1203,134,70,64,1069,34,198,221,238,55,92,231
"2011","East Devon 001A","E01019902","Total",1974,285,158,127,1689,57,496,375,274,81,203,203
"2011","East Devon 001B","E01019938","Total",2186,192,119,73,1994,48,448,309,360,155,223,451
"2011","East Devon 001C","E01019967","Total",1289,123,61,62,1166,27,274,220,204,78,162,201
"2011","East Devon 002A","E01019927","Total",1234,275,155,120,959,65,150,219,212,78,66,169
"2011","East Devon 002B","E01019932","Total",1612,354,178,176,1258,65,246,238,268,32,158,251
"2011","East Devon 002C","E01019933","Total",1208,239,125,114,969,51,212,227,210,67,56,146
"2011","East Devon 002D","E01019934","Total",1827,234,166,68,1593,59,446,247,278,78,163,322
"2011","East Devon 003A","E01019928","Total",1424,157,86,71,1267,100,160,273,246,84,154,250
"2011","East Devon 003B","E01019929","Total",1445,169,79,90,1276,82,182,349,262,82,95,224
"2011","East Devon 003C","E01019930","Total",1385,212,152,60,1173,55,312,281,238,59,46,182
"2011","East Devon 003D","E01019931","Total",1253,124,58,66,1129,22,256,281,198,36,155,181
"2011","East Devon 004A","E01019925","Total",1288,125,69,56,1163,36,164,344,192,68,121,238
"2011","East Devon 004D","E01019959","Total",1152,121,69,52,1031,39,220,228,186,83,100,175
"2011","East Devon 004E","E01019960","Total",1362,92,50,42,1270,41,192,266,262,117,150,242
"2011","East Devon 004F","E01019962","Total",2375,196,113,83,2179,65,366,521,416,96,289,426
"2011","East Devon 004G","E01032628","Total",2026,211,118,93,1815,70,346,400,336,130,190,343
"2011","East Devon 005A","E01019886","Total",2591,304,163,141,2287,116,474,435,374,204,281,403
"2011","East Devon 005B","E01019887","Total",1408,222,121,101,1186,103,232,243,232,83,140,153
"2011","East Devon 005C","E01019888","Total",1511,369,199,170,1142,54,268,211,298,30,90,191
"2011","East Devon 005D","E01019889","Total",1482,192,121,71,1290,39,344,234,190,103,151,229
"2011","East Devon 005E","E01019966","Total",1068,124,86,38,944,27,266,165,148,73,94,171
"2011","East Devon 006A","E01019891","Total",1429,125,62,63,1304,47,186,287,250,42,166,326
"2011","East Devon 006B","E01019892","Total",1515,161,78,83,1354,47,188,332,242,101,180,264
"2011","East Devon 006C","E01019893","Total",1810,165,76,89,1645,55,278,374,296,145,237,260
"2011","East Devon 006D","E01019903","Total",2039,253,139,114,1786,44,370,316,354,171,197,334
"2011","East Devon 007A","E01019899","Total",1335,220,141,79,1115,69,262,193,182,77,129,203
"2011","East Devon 007B","E01019900","Total",1789,220,161,59,1569,36,518,256,248,108,138,265
"2011","East Devon 007C","E01019935","Total",1235,153,104,49,1082,28,330,135,196,63,98,232
"2011","East Devon 007D","E01019936","Total",1095,149,93,56,946,38,270,145,180,58,110,145
"2011","East Devon 007E","E01019961","Total",2463,292,168,124,2171,63,532,399,416,119,231,411
"2011","East Devon 008A","E01019939","Total",1484,138,99,39,1346,35,366,276,210,104,143,212
"2011","East Devon 008B","E01019940","Total",1532,150,109,41,1382,21,422,245,212,87,199,196
"2011","East Devon 008C","E01019942","Total",1778,257,128,129,1521,99,302,380,238,123,127,252
"2011","East Devon 008D","E01019943","Total",1574,135,88,47,1439,53,292,303,198,97,206,290
"2011","East Devon 008E","E01019944","Total",1526,235,117,118,1291,67,204,333,218,114,145,210
"2011","East Devon 009A","E01019890","Total",1823,241,140,101,1582,46,364,259,296,89,164,364
"2011","East Devon 009B","E01019901","Total",1328,157,85,72,1171,19,304,210,190,100,150,198
"2011","East Devon 009C","E01019951","Total",2121,263,176,87,1858,35,630,288,334,68,206,297
"2011","East Devon 010A","E01019946","Total",1312,177,121,56,1135,28,478,177,194,15,75,168
"2011","East Devon 010B","E01019947","Total",1725,526,283,243,1199,60,336,195,242,63,116,187
"2011","East Devon 010C","E01019948","Total",1267,226,171,55,1041,32,390,171,176,47,67,158
"2011","East Devon 010D","E01019949","Total",1382,234,156,78,1148,49,424,173,236,56,74,136
"2011","East Devon 010E","E01019950","Total",1216,212,137,75,1004,39,334,199,162,62,80,128
"2011","East Devon 011A","E01019952","Total",1692,297,208,89,1395,95,432,255,224,35,87,267
"2011","East Devon 011B","E01019953","Total",1533,209,160,49,1324,40,500,195,186,73,79,251
"2011","East Devon 011C","E01019954","Total",1483,218,118,100,1265,134,272,264,212,83,74,226
"2011","East Devon 011D","E01019955","Total",1645,281,190,91,1364,52,348,284,202,79,134,265
"2011","East Devon 012A","E01019956","Total",1555,425,273,152,1130,47,350,194,264,46,82,147
"2011","East Devon 012B","E01019957","Total",1606,396,331,65,1210,12,674,120,164,27,46,167
"2011","East Devon 012C","E01019958","Total",1744,238,176,62,1506,35,512,249,210,117,154,229
"2011","East Devon 013A","E01019937","Total",2095,248,168,80,1847,67,460,344,336,108,196,336
"2011","East Devon 013B","E01019945","Total",1973,203,103,100,1770,85,312,304,362,153,154,400
"2011","East Devon 013C","E01019963","Total",1605,215,116,99,1390,79,252,347,254,163,90,205
"2011","East Devon 014A","E01019898","Total",2314,251,148,103,2063,57,522,360,396,92,204,432
"2011","East Devon 014B","E01019964","Total",1021,89,56,33,932,29,228,187,166,65,83,174
"2011","East Devon 014C","E01019965","Total",1753,221,139,82,1532,82,308,443,276,100,129,194
"2011","East Devon 015A","E01019904","Total",1348,193,113,80,1155,70,236,254,178,118,92,207
"2011","East Devon 015B","E01019905","Total",1944,112,61,51,1832,40,292,407,324,111,269,389
"2011","East Devon 015C","E01019906","Total",1446,192,99,93,1254,69,238,313,252,46,90,246
"2011","East Devon 015D","E01019907","Total",1495,181,131,50,1314,53,366,289,238,63,120,185
"2011","East Devon 016A","E01019908","Total",1751,160,40,120,1591,132,116,522,324,101,164,232
"2011","East Devon 016B","E01019909","Total",1790,243,174,69,1547,15,426,300,262,99,172,273
"2011","East Devon 016C","E01019910","Total",1602,155,92,63,1447,40,266,331,280,77,169,284
"2011","East Devon 016D","E01019911","Total",1527,283,194,89,1244,25,448,201,238,31,76,225
"2011","East Devon 017A","E01019894","Total",1403,325,243,82,1078,18,538,151,198,27,56,90
"2011","East Devon 017B","E01019895","Total",1357,198,148,50,1159,22,444,191,178,76,78,170
"2011","East Devon 017C","E01019896","Total",1531,269,192,77,1262,27,468,193,204,73,140,157
"2011","East Devon 017D","E01019897","Total",1553,242,146,96,1311,113,198,386,212,81,101,220
"2011","East Devon 018A","E01019920","Total",1449,173,68,105,1276,118,158,286,244,85,106,279
"2011","East Devon 018B","E01019921","Total",1546,133,85,48,1413,62,262,332,260,94,141,262
"2011","East Devon 018C","E01019922","Total",1432,240,144,96,1192,73,208,234,164,88,167,258
"2011","East Devon 018D","E01019923","Total",1224,152,83,69,1072,76,206,204,194,67,138,187
"2011","East Devon 018E","E01019924","Total",1515,128,46,82,1387,133,120,327,270,90,167,280
"2011","East Devon 019A","E01019916","Total",1891,404,146,258,1487,179,98,344,442,97,99,228
"2011","East Devon 019B","E01019917","Total",1515,194,90,104,1321,79,132,370,268,53,163,256
"2011","East Devon 019C","E01019918","Total",1803,430,111,319,1373,101,222,262,374,55,117,242
"2011","East Devon 019D","E01019919","Total",1717,261,117,144,1456,150,156,334,324,52,171,269
"2011","East Devon 020A","E01019912","Total",1626,385,228,157,1241,60,296,266,258,37,96,228
"2011","East Devon 020B","E01019913","Total",1421,351,256,95,1070,10,496,102,194,40,92,136
"2011","East Devon 020C","E01019914","Total",2157,302,175,127,1855,138,302,304,336,188,245,342
"2011","East Devon 020D","E01019915","Total",1588,263,182,81,1325,37,394,240,196,67,166,225
"2011","Exeter 001C","E01019998","Total",1423,165,78,87,1258,39,166,327,298,75,134,219
"2011","Exeter 001D","E01019999","Total",1302,128,66,62,1174,18,174,191,180,86,137,388
"2011","Exeter 001E","E01020001","Total",1302,173,64,109,1129,29,212,210,296,30,113,239
"2011","Exeter 001F","E01033233","Total",2150,275,131,144,1875,46,484,270,342,67,140,526
"2011","Exeter 002A","E01019990","Total",1344,208,64,144,1136,199,116,265,196,68,59,233
"2011","Exeter 002B","E01019991","Total",1498,179,65,114,1319,171,126,355,192,78,163,234
"2011","Exeter 002C","E01019993","Total",1174,118,41,77,1056,35,150,242,232,15,111,271
"2011","Exeter 002D","E01020000","Total",1312,238,114,124,1074,59,144,231,180,91,141,228
"2011","Exeter 002E","E01020007","Total",1488,142,24,118,1346,32,30,168,138,23,76,879
"2011","Exeter 003A","E01019992","Total",1484,163,81,82,1321,66,180,308,246,93,131,297
"2011","Exeter 003B","E01020002","Total",1482,184,95,89,1298,141,198,302,194,67,125,271
"2011","Exeter 003C","E01020003","Total",1629,178,126,52,1451,83,336,301,220,91,145,275
"2011","Exeter 003D","E01020004","Total",1469,164,88,76,1305,59,202,367,268,40,121,248
"2011","Exeter 003E","E01020005","Total",1861,169,83,86,1692,163,230,325,224,178,293,279
"2011","Exeter 004A","E01019997","Total",1528,224,42,182,1304,34,42,167,254,25,49,733
"2011","Exeter 004B","E01020019","Total",1711,194,76,118,1517,24,54,43,158,25,75,1138
"2011","Exeter 004C","E01020020","Total",1491,246,31,215,1245,30,56,143,216,21,59,720
"2011","Exeter 004D","E01020021","Total",1373,152,33,119,1221,37,120,127,214,40,51,632
"2011","Exeter 004E","E01020022","Total",1623,292,53,239,1331,70,42,142,248,28,61,740
"2011","Exeter 005A","E01019980","Total",1681,226,55,171,1455,163,80,385,366,83,169,209
"2011","Exeter 005B","E01019982","Total",1628,222,27,195,1406,144,56,353,438,103,135,177
"2011","Exeter 005C","E01019983","Total",1445,166,84,82,1279,74,238,252,246,74,137,258
"2011","Exeter 005D","E01019984","Total",1363,112,36,76,1251,44,130,344,276,61,115,281
"2011","Exeter 005E","E01019985","Total",1405,167,68,99,1238,183,86,307,194,120,113,235
"2011","Exeter 006A","E01019987","Total",1342,276,102,174,1066,44,128,246,228,32,98,290
"2011","Exeter 006B","E01019989","Total",1172,175,76,99,997,75,80,288,250,57,68,179
"2011","Exeter 006C","E01020006","Total",2041,194,76,118,1847,108,130,355,326,132,207,589
"2011","Exeter 006D","E01020008","Total",1767,170,41,129,1597,46,40,205,184,30,116,976
"2011","Exeter 006E","E01020009","Total",1476,189,48,141,1287,28,98,369,250,90,97,355
"2011","Exeter 007A","E01019986","Total",1505,175,93,82,1330,35,182,342,250,95,126,300
"2011","Exeter 007B","E01020036","Total",1485,232,136,96,1253,86,160,324,194,99,114,276
"2011","Exeter 007C","E01020037","Total",1369,193,97,96,1176,166,158,236,186,97,123,210
"2011","Exeter 007D","E01020039","Total",1868,284,164,120,1584,166,214,454,256,82,140,272
"2011","Exeter 007E","E01020040","Total",1306,195,92,103,1111,48,160,294,202,40,120,247
"2011","Exeter 008A","E01019994","Total",1436,293,88,205,1143,69,54,174,242,52,53,499
"2011","Exeter 008B","E01019995","Total",1397,495,183,312,902,121,76,113,216,26,60,290
"2011","Exeter 008C","E01020016","Total",1868,682,151,531,1186,96,138,178,480,15,49,230
"2011","Exeter 008D","E01020017","Total",2007,464,70,394,1543,152,72,255,460,42,80,482
"2011","Exeter 008E","E01020018","Total",1907,604,184,420,1303,105,124,130,530,20,70,324
"2011","Exeter 009A","E01019996","Total",1087,280,69,211,807,42,72,132,238,41,62,220
"2011","Exeter 009B","E01020023","Total",2200,350,136,214,1850,93,252,550,394,102,138,321
"2011","Exeter 009C","E01020024","Total",1468,237,113,124,1231,43,200,361,230,103,94,200
"2011","Exeter 009D","E01020025","Total",1427,339,84,255,1088,69,66,274,402,35,62,180
"2011","Exeter 010A","E01019975","Total",1369,108,55,53,1261,131,108,279,170,124,181,268
"2011","Exeter 010B","E01020029","Total",1601,182,73,109,1419,52,138,372,260,77,167,353
"2011","Exeter 010C","E01020030","Total",1812,349,124,225,1463,140,102,388,402,54,80,297
"2011","Exeter 010D","E01020031","Total",1585,159,67,92,1426,89,158,367,278,76,173,285
"2011","Exeter 010E","E01020032","Total",1405,220,61,159,1185,44,122,214,266,67,166,306
"2011","Exeter 011A","E01020026","Total",1736,179,111,68,1557,50,288,383,324,30,167,315
"2011","Exeter 011B","E01020027","Total",1574,214,86,128,1360,93,160,300,294,72,96,345
"2011","Exeter 011D","E01020035","Total",1552,160,83,77,1392,92,200,370,326,76,117,211
"2011","Exeter 011E","E01020038","Total",1436,150,72,78,1286,46,184,287,266,60,153,290
"2011","Exeter 011F","E01033232","Total",1462,155,24,131,1307,101,68,456,356,45,129,152
"2011","Exeter 011G","E01033234","Total",1472,160,35,125,1312,115,110,371,300,103,116,197
"2011","Exeter 012A","E01019973","Total",1430,182,101,81,1248,68,232,250,188,72,161,277
"2011","Exeter 012B","E01019974","Total",1422,208,101,107,1214,39,238,265,248,78,91,255
"2011","Exeter 012C","E01019976","Total",1264,161,104,57,1103,28,264,247,184,58,108,214
"2011","Exeter 012D","E01019977","Total",1462,173,106,67,1289,65,196,279,218,68,186,277
"2011","Exeter 012E","E01019981","Total",1443,162,57,105,1281,142,128,304,224,82,151,250
"2011","Exeter 013A","E01019988","Total",1439,233,146,87,1206,58,210,323,154,86,109,266
"2011","Exeter 013B","E01020010","Total",1825,217,94,123,1608,138,142,380,270,235,208,235
"2011","Exeter 013C","E01020013","Total",1264,176,62,114,1088,58,146,216,256,73,126,213
"2011","Exeter 013D","E01020014","Total",1568,216,89,127,1352,158,98,253,210,105,216,312
"2011","Exeter 013E","E01020015","Total",1819,200,65,135,1619,216,92,331,264,186,227,303
"2011","Exeter 014A","E01019968","Total",1516,219,141,78,1297,55,284,309,266,58,69,256
"2011","Exeter 014B","E01019969","Total",1286,236,102,134,1050,34,162,199,250,84,111,210
"2011","Exeter 014C","E01019970","Total",1267,141,66,75,1126,72,110,351,220,54,114,205
"2011","Exeter 014D","E01019971","Total",1547,317,66,251,1230,98,88,223,488,40,78,215
"2011","Exeter 014E","E01019972","Total",1391,182,39,143,1209,135,90,296,274,52,139,223
"2011","Exeter 015A","E01020011","Total",1219,127,81,46,1092,31,214,179,190,65,137,276
"2011","Exeter 015B","E01020012","Total",1468,192,83,109,1276,132,114,256,236,76,185,277
"2011","Exeter 015C","E01020033","Total",1632,248,175,73,1384,67,364,258,196,125,171,203
"2011","Exeter 015E","E01033235","Total",1232,367,233,134,865,37,206,220,230,26,41,105
"2011","Exeter 015F","E01033236","Total",1016,250,138,112,766,25,230,124,200,47,50,90
"2011","Mid Devon 001A","E01020046","Total",1560,130,60,70,1430,53,214,306,278,120,162,297
"2011","Mid Devon 001B","E01020049","Total",1307,115,62,53,1192,28,254,213,250,74,107,266
"2011","Mid Devon 001C","E01020050","Total",2059,265,140,125,1794,75,444,361,424,80,145,265
"2011","Mid Devon 001D","E01020077","Total",1603,117,64,53,1486,32,240,354,234,101,201,324
"2011","Mid Devon 002A","E01020047","Total",2089,292,179,113,1797,90,372,407,376,115,150,287
"2011","Mid Devon 002B","E01020051","Total",1800,217,137,80,1583,37,478,269,316,77,154,252
"2011","Mid Devon 002C","E01020066","Total",2835,232,86,146,2603,169,312,741,490,213,324,354
"2011","Mid Devon 002D","E01020080","Total",1266,125,78,47,1141,45,278,172,202,77,128,239
"2011","Mid Devon 003A","E01020063","Total",2439,309,193,116,2130,85,326,576,390,142,235,376
"2011","Mid Devon 003B","E01020074","Total",2135,201,96,105,1934,56,328,449,354,149,225,373
"2011","Mid Devon 003C","E01020075","Total",1902,198,100,98,1704,102,312,367,282,93,242,306
"2011","Mid Devon 004A","E01020052","Total",1762,365,146,219,1397,110,206,352,322,103,145,159
"2011","Mid Devon 004B","E01020053","Total",1463,161,80,81,1302,85,220,264,220,180,130,203
"2011","Mid Devon 004C","E01020065","Total",1780,216,82,134,1564,139,204,397,296,151,111,266
"2011","Mid Devon 004D","E01020067","Total",1972,218,97,121,1754,188,168,434,266,243,224,231
"2011","Mid Devon 005A","E01020048","Total",2056,361,116,245,1695,160,164,408,406,79,158,320
"2011","Mid Devon 005B","E01020078","Total",1361,290,149,141,1071,77,124,239,188,93,132,218
"2011","Mid Devon 005C","E01020079","Total",1345,209,118,91,1136,79,172,308,216,100,101,160
"2011","Mid Devon 005D","E01020081","Total",1278,107,67,40,1171,69,222,258,174,121,112,215
"2011","Mid Devon 006A","E01020045","Total",1642,138,91,47,1504,73,248,326,294,89,178,296
"2011","Mid Devon 006B","E01020059","Total",2093,185,92,93,1908,57,290,467,318,207,229,340
"2011","Mid Devon 006C","E01020062","Total",1547,141,85,56,1406,51,276,287,264,76,185,267
"2011","Mid Devon 006D","E01020064","Total",1783,193,93,100,1590,63,204,459,258,114,220,272
"2011","Mid Devon 007A","E01020054","Total",2075,183,74,109,1892,74,244,569,360,101,193,351
"2011","Mid Devon 007B","E01020055","Total",1836,252,128,124,1584,105,176,353,312,135,169,334
"2011","Mid Devon 007C","E01020057","Total",1711,250,116,134,1461,85,180,365,280,102,161,288
"2011","Mid Devon 007D","E01020058","Total",1900,237,100,137,1663,54,296,457,338,69,214,235
"2011","Mid Devon 008A","E01020043","Total",2020,219,96,123,1801,141,264,459,304,188,190,255
"2011","Mid Devon 008B","E01020044","Total",1599,175,105,70,1424,31,244,323,268,126,157,275
"2011","Mid Devon 008C","E01020056","Total",1998,184,97,87,1814,39,286,452,308,138,198,393
"2011","Mid Devon 008D","E01020071","Total",1875,261,143,118,1614,76,294,365,302,153,125,299
"2011","Mid Devon 009A","E01020072","Total",1660,145,71,74,1515,69,274,283,308,120,169,292
"2011","Mid Devon 009B","E01020073","Total",1605,206,128,78,1399,38,306,203,266,89,158,339
"2011","Mid Devon 009C","E01020076","Total",1688,178,91,87,1510,55,226,329,316,127,168,289
"2011","Mid Devon 009D","E01020082","Total",1146,117,62,55,1029,54,178,176,204,61,117,239
"2011","Mid Devon 010A","E01020068","Total",1496,180,85,95,1316,30,276,279,254,101,107,269
"2011","Mid Devon 010B","E01020069","Total",1523,133,66,67,1390,41,204,277,248,149,178,293
"2011","Mid Devon 010C","E01020070","Total",1878,170,93,77,1708,45,332,304,294,165,215,353
"2011","Mid Devon 010D","E01020083","Total",2315,185,83,102,2130,86,294,550,382,139,316,363
"2011","Mid Devon 011A","E01020041","Total",2126,267,82,185,1859,147,218,445,358,151,173,367
"2011","Mid Devon 011B","E01020042","Total",1648,207,99,108,1441,57,282,334,266,80,122,300
"2011","Mid Devon 011C","E01020060","Total",1665,416,223,193,1249,94,238,264,322,63,83,185
"2011","Mid Devon 011D","E01020061","Total",2025,245,121,124,1780,116,274,452,308,99,179,352
"2011","North Devon 001A","E01020111","Total",1428,262,111,151,1166,163,150,235,206,66,151,195
"2011","North Devon 001B","E01020112","Total",1499,397,129,268,1102,106,122,275,286,52,130,131
"2011","North Devon 001C","E01020114","Total",1200,144,57,87,1056,62,140,266,190,59,147,192
"2011","North Devon 001D","E01020115","Total",1185,141,76,65,1044,49,214,230,204,41,97,209
"2011","North Devon 002A","E01020099","Total",1364,146,102,44,1218,48,302,173,260,64,173,198
"2011","North Devon 002B","E01020100","Total",1069,137,82,55,932,28,210,164,142,28,149,211
"2011","North Devon 002C","E01020101","Total",1462,207,103,104,1255,62,236,222,194,90,167,284
"2011","North Devon 002D","E01020126","Total",1450,240,114,126,1210,40,314,231,298,42,130,155
"2011","North Devon 003A","E01020113","Total",1326,272,87,185,1054,135,160,201,184,80,134,160
"2011","North Devon 003B","E01020116","Total",1614,208,99,109,1406,72,184,297,252,93,199,309
"2011","North Devon 003C","E01020117","Total",1498,180,99,81,1318,44,270,263,294,70,120,257
"2011","North Devon 003D","E01020118","Total",1359,140,54,86,1219,117,126,291,194,117,176,198
"2011","North Devon 004A","E01020090","Total",1657,137,85,52,1520,37,314,283,252,128,131,375
"2011","North Devon 004B","E01020108","Total",2253,264,113,151,1989,85,414,373,346,145,255,371
"2011","North Devon 004C","E01020109","Total",1432,189,95,94,1243,33,226,292,218,66,183,225
"2011","North Devon 005A","E01020089","Total",2249,236,129,107,2013,99,346,537,372,76,178,405
"2011","North Devon 005B","E01020091","Total",1296,172,97,75,1124,31,234,268,182,70,97,242
"2011","North Devon 005C","E01020092","Total",1402,173,134,39,1229,28,386,226,184,36,133,236
"2011","North Devon 005D","E01020093","Total",1409,312,175,137,1097,67,192,258,202,101,90,187
"2011","North Devon 005E","E01020110","Total",2164,176,109,67,1988,84,226,686,350,261,160,221
"2011","North Devon 006A","E01020088","Total",2048,172,85,87,1876,66,328,383,324,182,219,374
"2011","North Devon 006B","E01020120","Total",1877,155,84,71,1722,46,308,414,264,121,253,316
"2011","North Devon 006C","E01020127","Total",1870,136,61,75,1734,31,296,284,308,127,328,360
"2011","North Devon 007A","E01020132","Total",1802,283,170,113,1519,62,268,335,314,107,158,275
"2011","North Devon 007B","E01020133","Total",1472,158,66,92,1314,58,188,301,294,110,134,229
"2011","North Devon 007C","E01020134","Total",1128,161,67,94,967,75,112,229,182,79,119,171
"2011","North Devon 007D","E01020139","Total",1392,219,119,100,1173,74,148,221,218,96,95,321
"2011","North Devon 008A","E01020094","Total",1688,621,261,360,1067,89,158,159,274,60,118,209
"2011","North Devon 008B","E01020095","Total",1515,229,85,144,1286,142,136,274,242,89,172,231
"2011","North Devon 008C","E01020140","Total",1187,150,91,59,1037,39,226,209,142,46,112,263
"2011","North Devon 008D","E01020141","Total",1786,171,57,114,1615,279,132,325,286,138,198,257
"2011","North Devon 009A","E01020096","Total",1649,427,163,264,1222,131,182,211,240,85,108,265
"2011","North Devon 009B","E01020123","Total",1445,161,114,47,1284,68,244,204,186,68,230,284
"2011","North Devon 009C","E01020124","Total",1326,185,94,91,1141,38,236,169,198,67,145,288
"2011","North Devon 009D","E01020125","Total",1286,156,99,57,1130,32,338,203,238,32,82,205
"2011","North Devon 010A","E01020102","Total",1681,125,46,79,1556,112,130,442,308,92,215,257
"2011","North Devon 010B","E01020103","Total",1497,146,66,80,1351,152,114,322,154,134,221,254
"2011","North Devon 010C","E01020104","Total",1406,142,28,114,1264,215,56,278,262,98,170,185
"2011","North Devon 010D","E01020128","Total",1259,111,59,52,1148,24,272,226,194,94,101,237
"2011","North Devon 010E","E01020129","Total",1179,170,80,90,1009,85,146,208,170,58,143,199
"2011","North Devon 010F","E01020130","Total",1530,249,68,181,1281,87,90,341,282,119,130,232
"2011","North Devon 011A","E01020105","Total",1505,144,83,61,1361,92,256,249,208,105,182,269
"2011","North Devon 011B","E01020106","Total",1126,129,100,29,997,22,314,154,178,30,71,228
"2011","North Devon 011C","E01020107","Total",1617,186,132,54,1431,27,384,260,244,99,139,278
"2011","North Devon 011D","E01020119","Total",1476,194,120,74,1282,46,302,222,268,52,115,277
"2011","North Devon 012A","E01020084","Total",1502,190,108,82,1312,101,274,305,248,75,130,179
"2011","North Devon 012B","E01020085","Total",1549,144,54,90,1405,78,140,485,286,119,112,185
"2011","North Devon 012C","E01020086","Total",1505,141,85,56,1364,40,328,303,232,76,126,259
"2011","North Devon 012D","E01020121","Total",1938,195,95,100,1743,75,284,379,306,127,251,321
"2011","North Devon 012E","E01020122","Total",1707,139,73,66,1568,50,328,288,284,58,235,325
"2011","North Devon 013A","E01020097","Total",2232,205,111,94,2027,51,418,395,348,122,253,440
"2011","North Devon 013B","E01020131","Total",2092,226,112,114,1866,82,326,329,378,138,244,369
"2011","North Devon 013C","E01020135","Total",1568,224,128,96,1344,89,212,375,240,93,105,230
"2011","North Devon 013D","E01020136","Total",1715,223,128,95,1492,82,318,323,296,90,147,236
"2011","North Devon 013E","E01020137","Total",1497,263,131,132,1234,77,158,257,260,76,135,271
"2011","North Devon 014A","E01020087","Total",1869,236,151,85,1633,46,402,253,330,112,178,312
"2011","North Devon 014B","E01020098","Total",2072,256,142,114,1816,78,412,291,356,100,261,318
"2011","North Devon 014C","E01020138","Total",2283,291,154,137,1992,55,414,367,330,167,286,373
"2011","South Hams 001A","E01020144","Total",1538,124,23,101,1414,83,80,475,332,61,132,251
"2011","South Hams 001B","E01020145","Total",1805,174,74,100,1631,63,256,334,336,86,162,394
"2011","South Hams 001C","E01020146","Total",1118,175,37,138,943,47,86,240,298,48,93,131
"2011","South Hams 001D","E01020149","Total",1202,134,74,60,1068,80,172,208,268,43,121,176
"2011","South Hams 002A","E01020148","Total",1119,137,68,69,982,40,166,230,194,54,120,178
"2011","South Hams 002B","E01020157","Total",2259,240,115,125,2019,50,358,408,384,140,304,375
"2011","South Hams 002C","E01020160","Total",1882,161,80,81,1721,79,246,405,342,124,205,320
"2011","South Hams 002D","E01020176","Total",1113,160,85,75,953,32,184,164,204,69,120,180
"2011","South Hams 002E","E01020177","Total",1368,199,116,83,1169,58,204,220,184,116,122,265
"2011","South Hams 003A","E01020180","Total",1865,278,142,136,1587,127,242,304,276,129,172,337
"2011","South Hams 003B","E01020181","Total",1693,263,175,88,1430,86,286,297,248,95,161,257
"2011","South Hams 003C","E01020182","Total",1474,176,73,103,1298,135,128,298,262,79,133,263
"2011","South Hams 003D","E01020183","Total",1383,388,164,224,995,80,170,217,242,37,72,177
"2011","South Hams 003E","E01020184","Total",1609,400,201,199,1209,77,196,264,270,40,162,200
"2011","South Hams 004A","E01020153","Total",1215,213,115,98,1002,27,294,121,270,46,86,158
"2011","South Hams 004B","E01020156","Total",1877,234,143,91,1643,51,410,320,302,130,150,280
"2011","South Hams 004C","E01020170","Total",2114,254,175,79,1860,57,398,412,362,56,191,384
"2011","South Hams 004D","E01020188","Total",1937,220,104,116,1717,52,326,279,374,107,242,337
"2011","South Hams 005A","E01020161","Total",2384,369,234,135,2015,115,336,535,344,133,230,322
"2011","South Hams 005B","E01020162","Total",1655,121,45,76,1534,96,162,436,270,71,143,356
"2011","South Hams 005C","E01020163","Total",1797,128,64,64,1669,82,180,503,258,108,199,339
"2011","South Hams 005D","E01020164","Total",1530,181,89,92,1349,73,146,365,258,84,154,269
"2011","South Hams 005E","E01020165","Total",1535,146,47,99,1389,123,116,411,272,93,106,268
"2011","South Hams 005F","E01020166","Total",1416,118,58,60,1298,43,198,351,248,54,134,270
"2011","South Hams 005G","E01020167","Total",1386,85,48,37,1301,59,132,362,188,100,167,293
"2011","South Hams 006A","E01020142","Total",2265,270,135,135,1995,57,362,454,408,183,196,335
"2011","South Hams 006B","E01020143","Total",2213,240,106,134,1973,79,288,378,420,148,218,442
"2011","South Hams 006C","E01020150","Total",1685,239,119,120,1446,52,274,316,240,94,173,297
"2011","South Hams 007A","E01020151","Total",1562,269,157,112,1293,28,410,209,338,42,56,210
"2011","South Hams 007B","E01020152","Total",1424,427,235,192,997,45,316,109,342,11,38,136
"2011","South Hams 007C","E01020154","Total",1291,103,51,52,1188,102,124,283,172,84,167,256
"2011","South Hams 007D","E01020155","Total",1038,184,66,118,854,77,134,166,154,75,108,140
"2011","South Hams 008A","E01020147","Total",1918,241,115,126,1677,28,382,312,388,69,135,363
"2011","South Hams 008B","E01020158","Total",1677,219,129,90,1458,53,280,364,276,83,149,253
"2011","South Hams 008C","E01020159","Total",1408,164,74,90,1244,39,212,239,232,125,152,245
"2011","South Hams 008D","E01020190","Total",2031,256,153,103,1775,69,402,380,314,141,196,273
"2011","South Hams 009A","E01020171","Total",1803,256,143,113,1547,36,488,215,302,98,139,269
"2011","South Hams 009B","E01020185","Total",1315,160,102,58,1155,24,306,256,226,37,96,210
"2011","South Hams 009C","E01020186","Total",1420,187,124,63,1233,32,440,155,286,41,85,194
"2011","South Hams 009D","E01020187","Total",1691,203,96,107,1488,75,272,392,270,109,122,248
"2011","South Hams 010A","E01020168","Total",2025,271,179,92,1754,79,462,382,296,84,138,313
"2011","South Hams 010B","E01020169","Total",2307,369,171,198,1938,135,280,503,426,96,173,325
"2011","South Hams 010C","E01020189","Total",2009,417,219,198,1592,100,296,296,300,81,253,266
"2011","South Hams 011A","E01020174","Total",1529,232,135,97,1297,38,370,194,270,65,150,210
"2011","South Hams 011B","E01020175","Total",1927,294,195,99,1633,46,562,212,298,89,193,233
"2011","South Hams 011C","E01020178","Total",1894,260,174,86,1634,73,544,235,288,94,124,276
"2011","South Hams 012A","E01020172","Total",1751,294,173,121,1457,50,388,267,346,63,136,207
"2011","South Hams 012B","E01020173","Total",1502,334,188,146,1168,59,368,133,264,68,85,191
"2011","South Hams 012C","E01020179","Total",1846,275,185,90,1571,47,480,232,324,75,172,241
"2011","Teignbridge 001A","E01020243","Total",1193,125,68,57,1068,36,174,211,234,66,139,208
"2011","Teignbridge 001B","E01020262","Total",1179,119,58,61,1060,15,240,154,208,46,142,255
"2011","Teignbridge 001C","E01020263","Total",1472,212,142,70,1260,26,412,178,216,89,120,219
"2011","Teignbridge 001D","E01020274","Total",1277,129,46,83,1148,15,212,230,228,104,135,224
"2011","Teignbridge 002A","E01020240","Total",1494,208,135,73,1286,41,218,320,276,73,110,248
"2011","Teignbridge 002B","E01020241","Total",1740,185,74,111,1555,65,232,389,358,122,147,242
"2011","Teignbridge 002C","E01020242","Total",1421,132,62,70,1289,50,190,461,242,51,115,180
"2011","Teignbridge 002D","E01020244","Total",1410,224,133,91,1186,69,170,275,248,89,163,172
"2011","Teignbridge 002E","E01020245","Total",1612,178,92,86,1434,40,246,333,312,56,161,286
"2011","Teignbridge 003A","E01020205","Total",1380,150,77,73,1230,15,300,239,278,67,139,192
"2011","Teignbridge 003B","E01020258","Total",1658,209,107,102,1449,59,266,309,260,69,139,347
"2011","Teignbridge 003C","E01020259","Total",1099,135,62,73,964,24,208,166,226,43,109,188
"2011","Teignbridge 003D","E01020273","Total",1382,146,80,66,1236,36,264,267,246,107,124,192
"2011","Teignbridge 004A","E01020203","Total",1649,272,195,77,1377,18,422,334,236,109,53,205
"2011","Teignbridge 004B","E01020206","Total",1524,237,129,108,1287,75,228,326,292,83,114,169
"2011","Teignbridge 004C","E01020220","Total",1324,144,75,69,1180,65,158,270,212,69,130,276
"2011","Teignbridge 004D","E01020221","Total",1743,168,65,103,1575,67,210,393,296,137,134,338
"2011","Teignbridge 004E","E01020222","Total",1245,161,62,99,1084,42,152,334,198,73,85,200
"2011","Teignbridge 004F","E01020223","Total",1742,191,81,110,1551,46,282,355,324,102,188,254
"2011","Teignbridge 005A","E01020229","Total",1595,223,129,94,1372,50,386,205,248,56,134,293
"2011","Teignbridge 005B","E01020230","Total",1645,227,110,117,1418,60,258,238,314,76,127,345
"2011","Teignbridge 005C","E01020231","Total",1454,192,124,68,1262,43,292,291,202,67,164,203
"2011","Teignbridge 005D","E01020232","Total",1607,152,82,70,1455,77,164,356,216,140,248,254
"2011","Teignbridge 006A","E01020228","Total",1619,488,255,233,1131,90,290,161,294,45,82,169
"2011","Teignbridge 006B","E01020233","Total",1672,261,167,94,1411,38,486,208,298,35,109,237
"2011","Teignbridge 006C","E01020234","Total",1444,166,84,82,1278,86,194,247,194,92,159,306
"2011","Teignbridge 006D","E01020235","Total",1715,326,181,145,1389,95,352,256,226,50,148,262
"2011","Teignbridge 007A","E01020202","Total",1527,231,163,68,1296,38,480,198,212,100,83,185
"2011","Teignbridge 007B","E01020204","Total",1555,143,33,110,1412,103,104,473,292,95,129,216
"2011","Teignbridge 007C","E01020236","Total",1289,133,91,42,1156,18,256,214,210,73,175,210
"2011","Teignbridge 007D","E01020237","Total",1572,138,78,60,1434,64,230,337,256,76,159,312
"2011","Teignbridge 008A","E01020265","Total",1698,176,109,67,1522,61,368,326,298,53,114,302
"2011","Teignbridge 008B","E01020266","Total",1618,155,77,78,1463,48,248,321,284,102,145,315
"2011","Teignbridge 008C","E01020267","Total",1438,188,94,94,1250,45,264,249,264,72,155,201
"2011","Teignbridge 008D","E01020268","Total",1362,167,114,53,1195,27,422,195,228,32,100,191
"2011","Teignbridge 008E","E01020270","Total",1608,200,92,108,1408,82,276,301,280,104,107,258
"2011","Teignbridge 009A","E01020250","Total",1580,205,136,69,1375,39,256,316,252,56,143,313
"2011","Teignbridge 009B","E01020252","Total",1332,221,100,121,1111,96,176,305,256,61,66,151
"2011","Teignbridge 009C","E01020253","Total",1508,138,41,97,1370,91,122,507,204,67,156,223
"2011","Teignbridge 009D","E01020254","Total",1316,144,84,60,1172,100,170,196,228,73,163,242
"2011","Teignbridge 009E","E01020255","Total",1302,158,98,60,1144,69,216,252,194,65,116,232
"2011","Teignbridge 009F","E01020257","Total",1215,117,65,52,1098,34,194,242,190,66,118,254
"2011","Teignbridge 010A","E01020264","Total",1301,298,143,155,1003,79,194,143,240,44,105,198
"2011","Teignbridge 010B","E01020269","Total",1835,682,332,350,1153,92,340,183,288,20,51,179
"2011","Teignbridge 010C","E01020271","Total",1509,240,120,120,1269,131,128,252,232,104,170,252
"2011","Teignbridge 010D","E01020272","Total",1881,202,81,121,1679,176,174,415,230,170,210,304
"2011","Teignbridge 011A","E01020200","Total",1085,161,85,76,924,27,250,154,208,30,46,209
"2011","Teignbridge 011B","E01020201","Total",1415,218,125,93,1197,40,380,165,280,112,45,175
"2011","Teignbridge 011C","E01020251","Total",1434,127,44,83,1307,44,186,301,250,91,173,262
"2011","Teignbridge 011D","E01020260","Total",1243,219,125,94,1024,60,346,141,214,72,67,124
"2011","Teignbridge 011E","E01020261","Total",1186,145,84,61,1041,29,234,200,218,65,143,152
"2011","Teignbridge 012A","E01020208","Total",1241,152,90,62,1089,91,138,234,164,102,114,246
"2011","Teignbridge 012B","E01020209","Total",1442,183,97,86,1259,92,170,354,252,31,150,210
"2011","Teignbridge 012C","E01020210","Total",1165,109,66,43,1056,17,204,173,230,36,105,291
"2011","Teignbridge 012D","E01020219","Total",2033,219,82,137,1814,123,194,445,352,118,224,358
"2011","Teignbridge 013A","E01020191","Total",952,115,51,64,837,21,158,181,210,25,96,146
"2011","Teignbridge 013B","E01020194","Total",1454,122,60,62,1332,74,212,343,218,37,141,307
"2011","Teignbridge 013C","E01020207","Total",1061,89,41,48,972,77,122,226,186,43,118,200
"2011","Teignbridge 013D","E01020256","Total",1325,169,81,88,1156,67,222,321,266,55,86,139
"2011","Teignbridge 014A","E01020211","Total",1527,244,115,129,1283,133,104,316,228,114,137,251
"2011","Teignbridge 014B","E01020217","Total",1649,431,202,229,1218,125,164,306,278,38,92,215
"2011","Teignbridge 014C","E01020218","Total",1479,330,127,203,1149,104,100,278,280,42,132,213
"2011","Teignbridge 014D","E01020224","Total",1251,149,48,101,1102,97,74,316,216,95,84,220
"2011","Teignbridge 015A","E01020216","Total",1636,206,88,118,1430,161,134,312,210,141,205,267
"2011","Teignbridge 015B","E01020225","Total",1254,256,85,171,998,104,80,239,200,76,117,182
"2011","Teignbridge 015C","E01020226","Total",1134,112,54,58,1022,23,186,204,182,60,132,235
"2011","Teignbridge 015D","E01020227","Total",1383,243,159,84,1140,64,188,263,186,68,126,245
"2011","Teignbridge 016A","E01020212","Total",1216,127,60,67,1089,71,148,243,188,84,155,200
"2011","Teignbridge 016B","E01020213","Total",1417,175,92,83,1242,79,242,235,266,58,132,230
"2011","Teignbridge 016C","E01020214","Total",1553,181,122,59,1372,32,272,259,260,91,145,313
"2011","Teignbridge 016D","E01020215","Total",1376,120,77,43,1256,10,332,226,204,45,157,282
"2011","Teignbridge 017A","E01020195","Total",1745,184,92,92,1561,79,280,274,244,119,258,307
"2011","Teignbridge 017B","E01020196","Total",1660,301,125,176,1359,108,232,292,272,89,131,235
"2011","Teignbridge 017C","E01020197","Total",1218,140,87,53,1078,27,242,200,222,52,83,252
"2011","Teignbridge 017D","E01020198","Total",1387,208,88,120,1179,136,134,287,196,84,121,221
"2011","Teignbridge 017E","E01020199","Total",1597,223,88,135,1374,110,196,332,260,131,119,226
"2011","Teignbridge 018A","E01020246","Total",1097,108,47,61,989,41,148,239,210,41,74,236
"2011","Teignbridge 018B","E01020247","Total",1604,219,123,96,1385,80,250,240,202,130,183,300
"2011","Teignbridge 018C","E01020248","Total",1616,171,88,83,1445,34,316,320,298,69,143,265
"2011","Teignbridge 018D","E01020249","Total",1342,185,124,61,1157,31,298,212,208,55,129,224
"2011","Teignbridge 019A","E01020192","Total",1534,147,84,63,1387,27,340,288,246,104,150,232
"2011","Teignbridge 019B","E01020193","Total",1435,135,66,69,1300,38,202,302,206,111,186,255
"2011","Teignbridge 019C","E01020238","Total",1197,174,96,78,1023,38,208,240,174,77,96,190
"2011","Teignbridge 019D","E01020239","Total",1253,129,87,42,1124,37,274,224,210,83,97,199
"2011","Torridge 001A","E01020275","Total",1307,273,143,130,1034,89,198,184,252,47,70,194
"2011","Torridge 001B","E01020276","Total",1496,190,118,72,1306,37,368,251,232,108,90,220
"2011","Torridge 001C","E01020297","Total",1558,292,173,119,1266,138,246,305,242,56,106,173
"2011","Torridge 001D","E01020299","Total",1784,336,165,171,1448,55,398,260,346,37,98,254
"2011","Torridge 002A","E01020298","Total",1953,305,206,99,1648,69,514,352,300,63,115,235
"2011","Torridge 002B","E01020300","Total",1625,183,103,80,1442,57,374,225,308,43,122,313
"2011","Torridge 002C","E01020310","Total",2030,446,187,259,1584,79,512,223,354,46,106,264
"2011","Torridge 003A","E01020280","Total",2158,581,142,439,1577,183,150,418,426,62,150,188
"2011","Torridge 003B","E01020281","Total",1869,187,103,84,1682,65,308,384,338,66,177,344
"2011","Torridge 003C","E01020282","Total",1614,359,196,163,1255,96,228,257,214,100,115,245
"2011","Torridge 004A","E01020277","Total",2011,287,134,153,1724,180,216,371,262,223,214,258
"2011","Torridge 004B","E01020278","Total",1616,117,53,64,1499,48,216,364,288,54,178,351
"2011","Torridge 004C","E01020279","Total",2305,260,86,174,2045,163,244,463,484,164,219,308
"2011","Torridge 004D","E01020283","Total",1387,211,112,99,1176,81,270,212,236,44,124,209
"2011","Torridge 004E","E01020284","Total",1931,252,73,179,1679,128,206,437,304,129,188,287
"2011","Torridge 004F","E01020285","Total",2009,230,106,124,1779,186,178,433,290,127,233,332
"2011","Torridge 005A","E01020288","Total",1627,205,86,119,1422,54,304,223,258,124,159,300
"2011","Torridge 005B","E01020292","Total",1444,198,109,89,1246,45,262,232,228,71,166,242
"2011","Torridge 005C","E01020295","Total",1623,157,102,55,1466,34,312,266,244,96,219,295
"2011","Torridge 005D","E01020296","Total",1488,131,66,65,1357,47,300,227,242,107,181,253
"2011","Torridge 006A","E01020304","Total",1693,233,130,103,1460,89,248,317,236,93,190,287
"2011","Torridge 006B","E01020305","Total",1058,217,81,136,841,76,132,171,184,36,107,135
"2011","Torridge 006C","E01020306","Total",1249,133,74,59,1116,52,186,311,190,72,98,207
"2011","Torridge 006D","E01020307","Total",1619,177,91,86,1442,125,188,359,178,152,178,262
"2011","Torridge 007A","E01020287","Total",1484,175,83,92,1309,38,298,189,244,45,177,318
"2011","Torridge 007B","E01020303","Total",1639,230,138,92,1409,49,342,216,308,80,168,246
"2011","Torridge 007C","E01020308","Total",1668,159,85,74,1509,22,288,277,324,62,205,331
"2011","Torridge 007D","E01020311","Total",2061,271,140,131,1790,44,412,382,410,119,165,258
"2011","Torridge 008A","E01020291","Total",1560,167,70,97,1393,51,250,255,204,83,202,348
"2011","Torridge 008B","E01020293","Total",2192,263,121,142,1929,81,324,402,368,132,258,364
"2011","Torridge 008C","E01020294","Total",1664,244,156,88,1420,78,290,363,274,75,116,224
"2011","Torridge 008D","E01020302","Total",1715,140,69,71,1575,56,292,246,264,149,197,371
"2011","Torridge 008E","E01020309","Total",1678,122,75,47,1556,28,288,248,280,102,232,378
"2011","Torridge 009A","E01020286","Total",1645,162,77,85,1483,40,288,296,236,139,171,313
"2011","Torridge 009B","E01020289","Total",1521,151,86,65,1370,23,324,172,304,64,180,303
"2011","Torridge 009C","E01020290","Total",1673,182,100,82,1491,35,314,256,294,94,217,281
"2011","Torridge 009D","E01020301","Total",1933,176,88,88,1757,37,350,287,322,148,264,349
"2011","West Devon 001A","E01020320","Total",1661,171,94,77,1490,33,372,191,272,109,178,335
"2011","West Devon 001B","E01020321","Total",2115,240,114,126,1875,63,320,394,382,150,236,330
"2011","West Devon 001C","E01020322","Total",1996,148,78,70,1848,35,396,258,332,142,312,373
"2011","West Devon 001D","E01020326","Total",2026,237,132,105,1789,86,244,432,380,125,181,341
"2011","West Devon 002A","E01020327","Total",1791,216,102,114,1575,58,348,409,336,109,110,205
"2011","West Devon 002B","E01020328","Total",2277,251,93,158,2026,161,182,608,370,168,220,317
"2011","West Devon 002C","E01020329","Total",1512,197,105,92,1315,41,276,198,284,75,176,265
"2011","West Devon 002D","E01020330","Total",1802,322,164,158,1480,95,254,320,226,123,195,267
"2011","West Devon 003A","E01020318","Total",1436,231,128,103,1205,49,322,260,214,63,100,197
"2011","West Devon 003B","E01020319","Total",1589,167,89,78,1422,55,254,266,296,79,170,302
"2011","West Devon 003C","E01020323","Total",1544,146,86,60,1398,51,182,274,334,132,119,306
"2011","West Devon 003D","E01020339","Total",1659,173,94,79,1486,60,248,283,320,74,217,284
"2011","West Devon 004A","E01020314","Total",1576,153,81,72,1423,36,322,269,274,78,215,229
"2011","West Devon 004B","E01020325","Total",1616,125,55,70,1491,54,256,303,262,112,168,336
"2011","West Devon 004C","E01020331","Total",1547,150,77,73,1397,69,222,267,266,120,193,260
"2011","West Devon 004D","E01020340","Total",1679,178,92,86,1501,43,288,279,276,95,208,312
"2011","West Devon 005A","E01020332","Total",1784,442,170,272,1342,56,208,213,336,104,171,254
"2011","West Devon 005B","E01020333","Total",1907,191,107,84,1716,82,336,380,352,109,155,302
"2011","West Devon 005C","E01020334","Total",1839,277,123,154,1562,115,248,318,354,104,190,233
"2011","West Devon 005D","E01020335","Total",1467,206,135,71,1261,40,366,186,176,88,127,278
"2011","West Devon 005E","E01020336","Total",1360,145,102,43,1215,14,378,195,216,67,132,213
"2011","West Devon 005F","E01020337","Total",1185,243,128,115,942,49,160,243,184,48,100,158
"2011","West Devon 005G","E01020338","Total",2334,319,154,165,2015,159,280,596,370,124,163,323
"2011","West Devon 006A","E01020317","Total",1426,162,91,71,1264,36,342,252,270,71,76,217
"2011","West Devon 006B","E01020324","Total",1499,188,113,75,1311,33,274,214,272,58,158,302
"2011","West Devon 006C","E01020341","Total",1560,146,79,67,1414,32,346,251,290,77,149,269
"2011","West Devon 006D","E01020342","Total",1498,191,89,102,1307,73,192,313,258,105,147,219
"2011","West Devon 007A","E01020312","Total",1537,184,112,72,1353,34,346,206,354,64,113,236
"2011","West Devon 007B","E01020313","Total",1401,203,94,109,1198,71,204,279,236,83,115,210
"2011","West Devon 007C","E01020315","Total",1453,219,109,110,1234,61,200,266,232,124,127,224
"2011","West Devon 007D","E01020316","Total",1838,193,118,75,1645,45,332,376,278,123,175,316
"2011","Christchurch 001A","E01020343","Total",1505,170,113,57,1335,22,274,234,222,63,151,369
"2011","Christchurch 001B","E01020344","Total",1460,123,37,86,1337,69,120,368,226,113,174,267
"2011","Christchurch 001C","E01020345","Total",1189,136,79,57,1053,40,228,198,216,26,102,243
"2011","Christchurch 001D","E01020365","Total",1569,201,143,58,1368,28,396,252,218,45,150,279
"2011","Christchurch 002A","E01020351","Total",1309,106,66,40,1203,28,222,300,170,90,178,215
"2011","Christchurch 002B","E01020352","Total",1323,120,84,36,1203,43,196,310,144,102,159,249
"2011","Christchurch 002C","E01020353","Total",1640,196,123,73,1444,91,240,317,180,97,258,261
"2011","Christchurch 002D","E01020359","Total",1292,109,56,53,1183,61,134,333,176,99,158,222
"2011","Christchurch 002E","E01020366","Total",2124,240,166,74,1884,11,502,419,240,126,240,346
"2011","Christchurch 003A","E01020349","Total",1694,568,457,111,1126,28,544,124,194,31,65,140
"2011","Christchurch 003B","E01020350","Total",1692,342,285,57,1350,24,698,118,218,45,90,157
"2011","Christchurch 003C","E01020357","Total",2104,206,128,78,1898,72,400,368,262,115,254,427
"2011","Christchurch 003D","E01020358","Total",1525,166,130,36,1359,25,450,251,172,61,155,245
"2011","Christchurch 004A","E01020369","Total",1283,217,163,54,1066,47,328,145,192,56,83,215
"2011","Christchurch 004B","E01020370","Total",1493,193,99,94,1300,42,220,360,222,62,133,261
"2011","Christchurch 004C","E01020371","Total",1543,224,182,42,1319,15,542,165,170,70,103,254
"2011","Christchurch 004D","E01020372","Total",1233,206,131,75,1027,27,356,171,176,51,102,144
"2011","Christchurch 005A","E01020346","Total",1590,251,146,105,1339,78,202,295,194,110,152,308
"2011","Christchurch 005B","E01020347","Total",1607,287,97,190,1320,113,118,290,258,100,187,254
"2011","Christchurch 005C","E01020348","Total",1673,166,81,85,1507,103,154,276,192,181,255,346
"2011","Christchurch 005D","E01020363","Total",1202,143,47,96,1059,74,102,273,224,73,164,149
"2011","Christchurch 006A","E01020360","Total",1537,212,128,84,1325,61,178,367,210,117,167,225
"2011","Christchurch 006B","E01020361","Total",1593,153,66,87,1440,82,186,439,260,94,178,201
"2011","Christchurch 006C","E01020364","Total",1597,292,150,142,1305,76,264,340,256,35,132,202
"2011","Christchurch 006D","E01020367","Total",1849,332,190,142,1517,72,404,295,288,62,132,264
"2011","Christchurch 006E","E01020368","Total",2349,479,306,173,1870,77,348,438,342,111,188,366
"2011","Christchurch 007A","E01020354","Total",1483,266,148,118,1217,69,288,276,204,63,76,241
"2011","Christchurch 007B","E01020355","Total",1871,270,208,62,1601,18,652,225,276,68,119,243
"2011","Christchurch 007C","E01020356","Total",1529,276,201,75,1253,27,468,208,242,30,84,194
"2011","Christchurch 007D","E01020362","Total",1440,206,154,52,1234,30,386,207,202,36,138,235
"2011","East Dorset 001A","E01020373","Total",1324,93,51,42,1231,66,122,354,212,147,131,199
"2011","East Dorset 001B","E01020374","Total",1517,132,96,36,1385,39,306,317,288,62,116,257
"2011","East Dorset 001C","E01020389","Total",2134,179,96,83,1955,43,292,396,354,163,269,438
"2011","East Dorset 001D","E01020397","Total",1428,163,97,66,1265,24,214,319,272,72,109,255
"2011","East Dorset 002A","E01020416","Total",1493,217,65,152,1276,127,142,420,286,51,87,163
"2011","East Dorset 002B","E01020417","Total",1074,98,58,40,976,31,180,251,192,44,99,179
"2011","East Dorset 002C","E01020418","Total",1455,173,147,26,1282,9,468,244,200,42,106,213
"2011","East Dorset 002D","E01020419","Total",1865,146,100,46,1719,52,382,485,318,73,155,254
"2011","East Dorset 002E","E01020420","Total",1320,102,60,42,1218,33,256,327,176,101,128,197
"2011","East Dorset 003A","E01020411","Total",1090,76,40,36,1014,70,174,213,158,100,96,203
"2011","East Dorset 003B","E01020412","Total",1493,126,69,57,1367,111,134,316,228,150,211,217
"2011","East Dorset 003C","E01020413","Total",1458,93,63,30,1365,23,286,460,184,68,137,207
"2011","East Dorset 003D","E01020414","Total",1992,192,120,72,1800,74,332,535,242,112,194,311
"2011","East Dorset 003E","E01020415","Total",1529,95,64,31,1434,29,296,349,206,76,132,346
"2011","East Dorset 004A","E01020403","Total",1439,148,96,52,1291,12,366,142,242,62,182,285
"2011","East Dorset 004B","E01020404","Total",1518,149,102,47,1369,34,452,196,270,41,115,261
"2011","East Dorset 004C","E01020405","Total",1457,172,108,64,1285,12,410,193,266,20,142,242
"2011","East Dorset 004D","E01020406","Total",2246,220,160,60,2026,18,820,220,368,78,103,419
"2011","East Dorset 005A","E01020396","Total",1063,93,44,49,970,23,202,225,202,60,60,198
"2011","East Dorset 005B","E01020398","Total",2263,174,101,73,2089,26,436,369,374,160,232,492
"2011","East Dorset 005C","E01020409","Total",1240,91,48,43,1149,18,162,241,236,103,137,252
"2011","East Dorset 005D","E01020410","Total",1311,132,76,56,1179,52,150,231,226,99,153,268
"2011","East Dorset 006A","E01020421","Total",1316,98,74,24,1218,51,276,288,186,68,115,234
"2011","East Dorset 006B","E01020422","Total",1600,358,274,84,1242,46,500,199,224,39,29,205
"2011","East Dorset 006C","E01020423","Total",1434,146,103,43,1288,48,390,219,202,27,109,293
"2011","East Dorset 006D","E01020424","Total",1392,171,117,54,1221,47,370,212,230,28,111,223
"2011","East Dorset 006E","E01020425","Total",1672,268,197,71,1404,56,506,270,212,58,73,229
"2011","East Dorset 007A","E01020377","Total",1634,104,58,46,1530,38,262,414,238,77,153,348
"2011","East Dorset 007B","E01020379","Total",1458,172,108,64,1286,50,310,240,230,92,127,237
"2011","East Dorset 007C","E01020380","Total",1084,95,57,38,989,7,198,209,194,59,112,210
"2011","East Dorset 007D","E01020381","Total",1217,94,65,29,1123,15,274,218,204,56,148,208
"2011","East Dorset 008A","E01020390","Total",1355,280,212,68,1075,38,472,119,202,41,34,169
"2011","East Dorset 008B","E01020391","Total",1433,169,122,47,1264,18,448,178,238,51,85,246
"2011","East Dorset 008C","E01020392","Total",1473,360,264,96,1113,23,378,182,182,25,131,192
"2011","East Dorset 008D","E01020393","Total",1571,115,28,87,1456,137,58,353,188,193,205,322
"2011","East Dorset 008E","E01020394","Total",1715,272,206,66,1443,73,444,186,250,102,138,250
"2011","East Dorset 009A","E01020375","Total",1370,197,122,75,1173,28,288,282,224,32,70,249
"2011","East Dorset 009B","E01020376","Total",1087,121,87,34,966,40,256,134,166,33,85,252
"2011","East Dorset 009C","E01020378","Total",1534,142,74,68,1392,63,258,313,236,77,103,342
"2011","East Dorset 009D","E01020407","Total",1187,119,90,29,1068,26,302,195,182,71,78,214
"2011","East Dorset 009E","E01020408","Total",1099,114,72,42,985,37,224,140,212,36,111,225
"2011","East Dorset 010A","E01020426","Total",1737,247,155,92,1490,87,396,317,260,63,146,221
"2011","East Dorset 010B","E01020427","Total",1623,246,143,103,1377,88,242,348,188,138,105,268
"2011","East Dorset 010C","E01020428","Total",1894,561,341,220,1333,80,322,273,350,50,91,167
"2011","East Dorset 010D","E01020429","Total",1657,334,167,167,1323,83,164,340,262,102,117,255
"2011","East Dorset 011A","E01020395","Total",1743,325,250,75,1418,16,598,147,242,40,81,294
"2011","East Dorset 011B","E01020399","Total",2446,235,148,87,2211,62,428,562,350,114,245,450
"2011","East Dorset 011C","E01020400","Total",1587,145,103,42,1442,13,422,204,214,41,224,324
"2011","East Dorset 011D","E01020401","Total",1511,221,172,49,1290,11,508,187,156,46,134,248
"2011","East Dorset 011E","E01020402","Total",1529,129,87,42,1400,22,338,272,212,90,117,349
"2011","East Dorset 012A","E01020382","Total",1525,152,69,83,1373,65,188,315,268,70,171,296
"2011","East Dorset 012B","E01020383","Total",1756,169,109,60,1587,24,396,324,222,85,190,346
"2011","East Dorset 012C","E01020384","Total",1757,105,51,54,1652,96,160,507,210,104,213,362
"2011","East Dorset 012D","E01020385","Total",1248,112,47,65,1136,56,144,260,154,125,121,276
"2011","East Dorset 012E","E01020386","Total",1202,91,53,38,1111,37,200,255,194,84,110,231
"2011","East Dorset 012F","E01020387","Total",1123,102,80,22,1021,10,240,209,180,62,100,220
"2011","East Dorset 012G","E01020388","Total",1515,187,87,100,1328,107,178,331,210,97,154,251
"2011","North Dorset 001A","E01020443","Total",2483,373,140,233,2110,156,192,477,492,186,208,399
"2011","North Dorset 001B","E01020447","Total",1743,310,218,92,1433,50,392,277,252,72,108,282
"2011","North Dorset 001C","E01020463","Total",1674,246,141,105,1428,42,298,332,260,122,138,236
"2011","North Dorset 001D","E01020464","Total",1478,219,133,86,1259,46,334,295,228,69,98,189
"2011","North Dorset 002A","E01020440","Total",1901,187,103,84,1714,37,418,282,366,100,163,348
"2011","North Dorset 002B","E01020450","Total",2297,226,116,110,2071,110,312,548,420,154,186,341
"2011","North Dorset 002D","E01020462","Total",1786,193,102,91,1593,29,382,270,298,110,228,276
"2011","North Dorset 002E","E01033156","Total",1730,126,45,81,1604,81,160,531,296,189,137,210
"2011","North Dorset 002F","E01033158","Total",1313,154,91,63,1159,35,238,293,196,68,114,215
"2011","North Dorset 003A","E01020454","Total",2045,400,225,175,1645,100,256,354,292,127,217,299
"2011","North Dorset 003B","E01020455","Total",1884,203,89,114,1681,75,236,520,300,121,163,266
"2011","North Dorset 003C","E01020456","Total",1780,218,68,150,1562,94,198,382,316,144,142,286
"2011","North Dorset 003D","E01020457","Total",1430,273,161,112,1157,38,318,239,254,43,64,201
"2011","North Dorset 004A","E01020433","Total",1775,177,83,94,1598,68,330,359,266,83,156,336
"2011","North Dorset 004B","E01020434","Total",1751,246,165,81,1505,70,338,298,238,119,131,311
"2011","North Dorset 004C","E01020449","Total",1973,268,182,86,1705,34,496,252,282,158,147,336
"2011","North Dorset 004D","E01020458","Total",2159,239,135,104,1920,72,420,374,400,125,208,321
"2011","North Dorset 004E","E01020459","Total",2577,396,203,193,2181,142,376,474,422,180,255,332
"2011","North Dorset 005A","E01020444","Total",1731,196,102,94,1535,86,280,284,312,115,110,348
"2011","North Dorset 005B","E01020445","Total",1130,156,88,68,974,30,244,225,178,93,82,122
"2011","North Dorset 005C","E01020446","Total",1443,177,116,61,1266,44,342,236,244,78,107,215
"2011","North Dorset 005D","E01020460","Total",1953,207,120,87,1746,36,428,300,320,113,186,363
"2011","North Dorset 006A","E01020442","Total",1993,224,111,113,1769,55,398,398,372,94,113,339
"2011","North Dorset 006B","E01020452","Total",1922,239,108,131,1683,56,248,392,332,168,158,329
"2011","North Dorset 006C","E01020453","Total",1691,159,82,77,1532,54,298,335,322,58,181,284
"2011","North Dorset 006E","E01033154","Total",1475,27,6,21,1448,38,28,775,222,197,85,103
"2011","North Dorset 006F","E01033159","Total",1097,74,41,33,1023,25,142,284,224,117,76,155
"2011","North Dorset 007A","E01020435","Total",1764,219,89,130,1545,47,178,347,414,82,125,352
"2011","North Dorset 007B","E01020436","Total",2062,164,47,117,1898,75,204,509,400,149,277,284
"2011","North Dorset 007C","E01020437","Total",1876,178,101,77,1698,87,304,317,314,124,196,356
"2011","North Dorset 007D","E01020438","Total",1904,563,248,315,1341,109,266,277,360,43,82,204
"2011","North Dorset 007E","E01020439","Total",2228,327,155,172,1901,88,238,535,370,145,154,371
"2011","North Dorset 008A","E01020430","Total",1439,140,75,65,1299,36,300,241,276,103,145,198
"2011","North Dorset 008B","E01020431","Total",1042,109,52,57,933,25,170,202,200,82,112,142
"2011","North Dorset 008C","E01020432","Total",1226,139,68,71,1087,25,222,229,234,63,114,200
"2011","North Dorset 008D","E01020441","Total",1850,176,90,86,1674,55,310,352,362,115,151,329
"2011","North Dorset 008E","E01020448","Total",1967,167,83,84,1800,76,366,346,380,109,193,330
"2011","Purbeck 001A","E01020465","Total",1945,262,144,118,1683,77,296,374,396,75,139,326
"2011","Purbeck 001B","E01020469","Total",1931,269,149,120,1662,93,236,393,298,157,193,292
"2011","Purbeck 001C","E01020470","Total",1797,129,81,48,1668,30,382,334,352,76,192,302
"2011","Purbeck 002A","E01020471","Total",1398,123,50,73,1275,88,100,332,198,164,180,213
"2011","Purbeck 002B","E01020472","Total",1387,172,104,68,1215,101,190,275,212,53,136,248
"2011","Purbeck 002C","E01020473","Total",1459,160,84,76,1299,81,238,247,288,68,102,275
"2011","Purbeck 002D","E01020474","Total",1690,198,123,75,1492,33,346,289,284,76,137,327
"2011","Purbeck 002E","E01020475","Total",2049,210,122,88,1839,74,302,470,278,102,179,434
"2011","Purbeck 003A","E01020476","Total",1227,137,81,56,1090,24,260,211,218,28,120,229
"2011","Purbeck 003B","E01020477","Total",1539,108,67,41,1431,68,224,316,184,109,170,360
"2011","Purbeck 003C","E01020485","Total",1409,310,205,105,1099,80,288,161,246,10,101,213
"2011","Purbeck 003D","E01020486","Total",1306,235,144,91,1071,40,288,221,200,31,97,194
"2011","Purbeck 003E","E01020487","Total",1287,113,53,60,1174,38,182,201,198,95,180,280
"2011","Purbeck 003F","E01020488","Total",1459,202,111,91,1257,46,236,311,252,65,113,234
"2011","Purbeck 004A","E01020489","Total",1391,157,73,84,1234,20,226,299,198,85,150,256
"2011","Purbeck 004B","E01020490","Total",1602,205,108,97,1397,42,290,267,294,100,113,291
"2011","Purbeck 004C","E01020491","Total",1571,179,87,92,1392,70,240,307,262,102,130,281
"2011","Purbeck 004D","E01020492","Total",1153,176,122,54,977,40,234,183,190,37,85,208
"2011","Purbeck 004E","E01020493","Total",2338,124,40,84,2214,147,100,730,342,330,267,298
"2011","Purbeck 005A","E01020466","Total",1758,241,151,90,1517,34,382,237,264,111,161,328
"2011","Purbeck 005B","E01020467","Total",1761,205,112,93,1556,54,368,310,314,99,146,265
"2011","Purbeck 005C","E01020468","Total",1459,183,101,82,1276,35,378,151,256,103,108,245
"2011","Purbeck 006A","E01020478","Total",1069,149,99,50,920,33,192,206,172,45,112,160
"2011","Purbeck 006B","E01020479","Total",1126,317,210,107,809,21,290,134,178,36,38,112
"2011","Purbeck 006C","E01020480","Total",1430,262,179,83,1168,17,472,129,200,51,107,192
"2011","Purbeck 006D","E01020481","Total",1488,281,118,163,1207,35,292,190,312,35,134,209
"2011","Purbeck 006E","E01020482","Total",1606,297,169,128,1309,56,242,280,280,71,129,251
"2011","Purbeck 006F","E01020483","Total",1274,114,52,62,1160,56,172,225,176,110,132,289
"2011","Purbeck 006G","E01020484","Total",1425,181,114,67,1244,65,272,221,202,78,148,258
"2011","West Dorset 001A","E01020542","Total",1291,264,163,101,1027,36,292,218,216,15,86,164
"2011","West Dorset 001B","E01020543","Total",1452,182,97,85,1270,150,208,315,190,99,127,181
"2011","West Dorset 001C","E01020544","Total",1438,436,276,160,1002,49,288,190,180,79,64,152
"2011","West Dorset 001E","E01020546","Total",997,321,164,157,676,34,176,123,154,32,66,91
"2011","West Dorset 001F","E01020547","Total",1117,169,90,79,948,53,150,240,180,58,99,168
"2011","West Dorset 001H","E01032642","Total",2125,342,224,118,1783,57,542,323,308,71,204,278
"2011","West Dorset 002A","E01020497","Total",1914,198,132,66,1716,38,390,364,290,123,193,318
"2011","West Dorset 002B","E01020508","Total",1883,208,117,91,1675,43,452,286,310,71,173,340
"2011","West Dorset 002C","E01020541","Total",2010,214,114,100,1796,39,418,377,320,156,154,332
"2011","West Dorset 002D","E01020550","Total",1564,202,131,71,1362,32,348,255,264,71,112,280
"2011","West Dorset 003A","E01020494","Total",1150,126,79,47,1024,29,212,239,186,76,117,165
"2011","West Dorset 003B","E01020495","Total",1387,214,126,88,1173,59,340,237,204,71,76,186
"2011","West Dorset 003C","E01020496","Total",1561,327,207,120,1234,74,362,172,198,118,112,198
"2011","West Dorset 003D","E01020506","Total",1687,220,124,96,1467,38,382,257,302,58,188,242
"2011","West Dorset 003E","E01020530","Total",1807,188,97,91,1619,37,388,274,346,100,163,311
"2011","West Dorset 003F","E01020534","Total",2066,239,114,125,1827,78,322,362,460,165,156,284
"2011","West Dorset 004A","E01020509","Total",2737,273,166,107,2464,75,530,597,408,163,285,406
"2011","West Dorset 004B","E01020510","Total",1943,309,160,149,1634,99,340,320,292,129,128,326
"2011","West Dorset 004C","E01020529","Total",2210,260,109,151,1950,70,420,440,386,127,172,335
"2011","West Dorset 004D","E01020539","Total",1988,226,115,111,1762,37,310,414,376,110,170,345
"2011","West Dorset 004E","E01020540","Total",2437,261,149,112,2176,68,404,553,456,108,246,341
"2011","West Dorset 005A","E01020511","Total",1646,296,189,107,1350,55,446,245,224,68,133,179
"2011","West Dorset 005B","E01020532","Total",1536,342,195,147,1194,52,442,175,278,25,75,147
"2011","West Dorset 005C","E01020533","Total",1997,321,202,119,1676,110,378,322,286,117,200,263
"2011","West Dorset 005D","E01020535","Total",1714,203,114,89,1511,26,366,268,296,120,164,271
"2011","West Dorset 006A","E01020498","Total",2004,303,174,129,1701,65,418,342,334,120,124,298
"2011","West Dorset 006B","E01020499","Total",1394,222,104,118,1172,92,138,261,210,152,116,203
"2011","West Dorset 006C","E01020500","Total",1622,403,192,211,1219,65,276,242,230,55,99,252
"2011","West Dorset 006D","E01020501","Total",1363,163,95,68,1200,44,288,216,206,78,153,215
"2011","West Dorset 007A","E01020507","Total",1892,279,182,97,1613,40,508,215,362,99,132,257
"2011","West Dorset 007B","E01020517","Total",1740,228,131,97,1512,50,440,216,294,94,102,316
"2011","West Dorset 007C","E01020531","Total",1675,229,129,100,1446,49,304,268,312,110,102,301
"2011","West Dorset 007D","E01020536","Total",2079,228,118,110,1851,66,342,398,348,188,203,306
"2011","West Dorset 008A","E01020502","Total",1657,333,153,180,1324,119,204,337,284,41,126,213
"2011","West Dorset 008B","E01020503","Total",1742,401,226,175,1341,86,284,316,282,51,68,254
"2011","West Dorset 008C","E01020504","Total",2169,365,205,160,1804,35,640,231,376,53,86,383
"2011","West Dorset 009C","E01020526","Total",1281,115,71,44,1166,47,208,214,166,132,147,252
"2011","West Dorset 009D","E01020527","Total",1427,174,50,124,1253,74,130,278,190,105,188,288
"2011","West Dorset 009E","E01020528","Total",1953,268,124,144,1685,117,272,412,268,132,156,328
"2011","West Dorset 009F","E01032641","Total",1557,210,62,148,1347,107,208,297,286,87,165,197
"2011","West Dorset 009G","E01032643","Total",1519,246,92,154,1273,84,160,338,286,57,136,212
"2011","West Dorset 009H","E01032644","Total",1010,415,241,174,595,51,150,60,208,21,13,92
"2011","West Dorset 009I","E01032645","Total",992,298,177,121,694,38,118,169,182,31,49,107
"2011","West Dorset 010A","E01020518","Total",1522,319,167,152,1203,84,150,277,278,79,140,195
"2011","West Dorset 010B","E01020519","Total",1805,289,153,136,1516,106,210,394,280,158,161,207
"2011","West Dorset 010C","E01020520","Total",1390,221,131,90,1169,25,252,262,248,60,88,234
"2011","West Dorset 010D","E01020523","Total",1254,124,54,70,1130,28,148,277,216,69,153,239
"2011","West Dorset 010E","E01020524","Total",1460,157,103,54,1303,29,308,261,212,114,95,284
"2011","West Dorset 010F","E01020525","Total",1319,94,69,25,1225,40,248,278,188,66,172,233
"2011","West Dorset 011A","E01020505","Total",1854,187,110,77,1667,40,362,344,340,94,144,343
"2011","West Dorset 011B","E01020537","Total",1828,200,112,88,1628,69,362,334,330,94,122,317
"2011","West Dorset 011C","E01020538","Total",1851,206,102,104,1645,62,340,404,326,84,148,281
"2011","West Dorset 011D","E01020549","Total",2006,243,129,114,1763,86,326,337,440,98,149,327
"2011","West Dorset 012A","E01020512","Total",2090,249,126,123,1841,56,456,335,388,112,173,321
"2011","West Dorset 012B","E01020513","Total",1542,208,127,81,1334,53,286,296,182,158,115,244
"2011","West Dorset 012C","E01020514","Total",1252,124,55,69,1128,42,192,280,252,94,66,202
"2011","West Dorset 012D","E01020515","Total",1183,127,72,55,1056,66,214,206,202,106,101,161
"2011","West Dorset 012E","E01020516","Total",1507,192,109,83,1315,80,284,244,232,65,97,313
"2011","Weymouth and Portland 001A","E01020551","Total",1883,287,88,199,1596,176,154,391,306,90,218,261
"2011","Weymouth and Portland 001B","E01020552","Total",1805,225,84,141,1580,202,138,305,214,212,219,290
"2011","Weymouth and Portland 001C","E01020570","Total",1572,207,102,105,1365,34,294,271,282,64,124,296
"2011","Weymouth and Portland 001D","E01020571","Total",2035,288,107,181,1747,147,180,466,348,116,199,291
"2011","Weymouth and Portland 002A","E01020557","Total",1509,230,166,64,1279,29,482,201,272,31,48,216
"2011","Weymouth and Portland 002B","E01020558","Total",1720,206,127,79,1514,44,410,257,318,88,116,281
"2011","Weymouth and Portland 002C","E01020559","Total",1575,178,140,38,1397,18,488,178,306,57,77,273
"2011","Weymouth and Portland 002D","E01020560","Total",1923,179,90,89,1744,35,376,428,324,52,139,390
"2011","Weymouth and Portland 002E","E01020561","Total",1727,327,176,151,1400,86,176,326,284,129,168,231
"2011","Weymouth and Portland 003A","E01020574","Total",1892,179,90,89,1713,128,268,351,278,61,275,352
"2011","Weymouth and Portland 003B","E01020575","Total",1662,286,138,148,1376,129,156,263,192,145,240,251
"2011","Weymouth and Portland 003C","E01020576","Total",1711,221,162,59,1490,69,394,284,268,60,110,305
"2011","Weymouth and Portland 003D","E01020579","Total",1911,220,132,88,1691,43,360,299,332,110,215,332
"2011","Weymouth and Portland 003E","E01020580","Total",1406,141,86,55,1265,54,246,249,276,36,179,225
"2011","Weymouth and Portland 004A","E01020553","Total",1213,230,61,169,983,73,104,192,238,50,97,229
"2011","Weymouth and Portland 004B","E01020554","Total",1715,520,157,363,1195,120,178,223,362,43,66,203
"2011","Weymouth and Portland 004C","E01020555","Total",1340,271,74,197,1069,90,120,220,294,51,57,237
"2011","Weymouth and Portland 004D","E01020556","Total",1331,381,142,239,950,48,184,134,266,43,62,213
"2011","Weymouth and Portland 004E","E01020581","Total",1949,392,180,212,1557,83,422,240,308,79,119,306
"2011","Weymouth and Portland 004F","E01020582","Total",1573,326,140,186,1247,134,160,234,258,103,135,223
"2011","Weymouth and Portland 005A","E01020572","Total",1950,267,77,190,1683,133,184,386,330,97,173,380
"2011","Weymouth and Portland 005B","E01020573","Total",1784,355,164,191,1429,101,208,281,294,68,165,312
"2011","Weymouth and Portland 005C","E01020577","Total",1600,146,72,74,1454,100,184,339,232,108,158,333
"2011","Weymouth and Portland 005D","E01020578","Total",2024,324,201,123,1700,112,346,343,298,89,139,373
"2011","Weymouth and Portland 006A","E01020583","Total",1900,184,95,89,1716,64,322,294,378,136,192,330
"2011","Weymouth and Portland 006B","E01020584","Total",1681,222,70,152,1459,39,188,370,274,130,137,321
"2011","Weymouth and Portland 006C","E01020585","Total",1559,122,69,53,1437,137,172,348,216,86,181,297
"2011","Weymouth and Portland 007A","E01020586","Total",1273,138,75,63,1135,58,200,211,188,47,178,253
"2011","Weymouth and Portland 007B","E01020587","Total",1490,243,113,130,1247,143,194,297,204,131,105,173
"2011","Weymouth and Portland 007C","E01020588","Total",1310,122,64,58,1188,51,218,246,224,101,125,223
"2011","Weymouth and Portland 007D","E01020589","Total",1487,183,94,89,1304,93,184,316,260,87,98,266
"2011","Weymouth and Portland 008A","E01020563","Total",1204,149,87,62,1055,66,146,217,228,112,112,174
"2011","Weymouth and Portland 008D","E01020569","Total",1456,227,100,127,1229,189,110,227,212,84,188,219
"2011","Weymouth and Portland 008E","E01033200","Total",2014,336,101,235,1678,139,240,285,362,102,239,311
"2011","Weymouth and Portland 009A","E01020562","Total",2016,285,136,149,1731,84,236,358,284,147,211,411
"2011","Weymouth and Portland 009B","E01020564","Total",1621,163,60,103,1458,171,160,359,236,157,119,256
"2011","Weymouth and Portland 009C","E01020565","Total",1462,169,82,87,1293,97,216,265,280,65,131,239
"2011","Weymouth and Portland 009D","E01020566","Total",2090,209,96,113,1881,72,378,349,422,132,189,339
"2011","Cheltenham 001A","E01022163","Total",1494,137,38,99,1357,75,128,262,270,87,159,376
"2011","Cheltenham 001B","E01022164","Total",1394,197,60,137,1197,101,86,278,266,94,116,256
"2011","Cheltenham 001C","E01022165","Total",1485,244,65,179,1241,33,208,337,334,27,118,184
"2011","Cheltenham 001D","E01022166","Total",1320,126,53,73,1194,56,146,304,226,44,121,297
"2011","Cheltenham 002A","E01022143","Total",1458,187,114,73,1271,28,304,288,278,52,109,212
"2011","Cheltenham 002B","E01022144","Total",1125,183,124,59,942,17,234,234,188,26,49,194
"2011","Cheltenham 002C","E01022145","Total",1213,133,83,50,1080,31,190,300,184,66,108,201
"2011","Cheltenham 002D","E01022146","Total",1305,193,111,82,1112,16,298,230,262,46,84,176
"2011","Cheltenham 003A","E01022122","Total",1303,209,81,128,1094,161,100,291,188,109,140,105
"2011","Cheltenham 003B","E01022160","Total",2058,287,119,168,1771,242,60,463,376,169,131,330
"2011","Cheltenham 003C","E01022161","Total",1416,186,37,149,1230,113,110,288,308,90,126,195
"2011","Cheltenham 003D","E01022162","Total",1543,208,101,107,1335,86,246,265,236,71,86,345
"2011","Cheltenham 004A","E01022139","Total",1099,165,93,72,934,26,250,166,200,15,57,220
"2011","Cheltenham 004B","E01022151","Total",1566,209,43,166,1357,93,74,158,316,23,56,637
"2011","Cheltenham 004C","E01022152","Total",1038,178,73,105,860,83,64,153,104,53,114,289
"2011","Cheltenham 004D","E01022153","Total",1590,237,14,223,1353,41,32,180,334,39,107,620
"2011","Cheltenham 004E","E01022154","Total",1909,183,43,140,1726,65,70,207,300,49,87,948
"2011","Cheltenham 005A","E01022120","Total",1548,269,67,202,1279,169,116,315,186,122,147,224
"2011","Cheltenham 005B","E01022121","Total",1775,233,51,182,1542,202,102,408,242,203,159,226
"2011","Cheltenham 005C","E01022147","Total",1614,333,64,269,1281,219,112,272,238,81,133,226
"2011","Cheltenham 005D","E01022157","Total",1534,189,54,135,1345,149,102,417,242,75,103,257
"2011","Cheltenham 005E","E01022159","Total",1475,169,56,113,1306,117,142,300,200,105,200,242
"2011","Cheltenham 006A","E01022131","Total",1252,214,111,103,1038,100,126,248,176,96,90,202
"2011","Cheltenham 006B","E01022132","Total",1425,187,89,98,1238,93,146,291,194,105,174,235
"2011","Cheltenham 006C","E01022133","Total",1484,109,33,76,1375,113,76,241,182,168,311,284
"2011","Cheltenham 006D","E01022134","Total",1556,331,133,198,1225,102,166,240,286,43,116,272
"2011","Cheltenham 007A","E01022148","Total",1505,194,101,93,1311,33,166,308,284,103,136,281
"2011","Cheltenham 007B","E01022149","Total",1400,131,55,76,1269,69,94,194,208,130,243,331
"2011","Cheltenham 007C","E01022150","Total",1490,208,64,144,1282,101,120,248,326,75,135,277
"2011","Cheltenham 007D","E01022155","Total",1503,183,69,114,1320,57,196,280,198,72,114,403
"2011","Cheltenham 007E","E01022156","Total",1515,244,46,198,1271,100,70,303,248,104,104,342
"2011","Cheltenham 007F","E01022158","Total",2184,396,73,323,1788,53,76,376,638,31,52,562
"2011","Cheltenham 008A","E01022100","Total",1756,243,62,181,1513,37,162,451,336,82,107,338
"2011","Cheltenham 008B","E01022101","Total",1801,333,100,233,1468,53,122,399,414,51,92,337
"2011","Cheltenham 008C","E01022102","Total",1776,571,59,512,1205,51,32,184,566,25,77,270
"2011","Cheltenham 008D","E01022140","Total",1166,216,108,108,950,23,176,228,238,67,73,145
"2011","Cheltenham 008E","E01022141","Total",1383,379,66,313,1004,20,150,185,426,35,42,146
"2011","Cheltenham 008F","E01022142","Total",1478,355,107,248,1123,33,68,196,438,53,42,293
"2011","Cheltenham 009A","E01022116","Total",1032,263,81,182,769,32,94,149,260,30,53,151
"2011","Cheltenham 009B","E01022117","Total",1580,521,97,424,1059,22,160,101,532,5,35,204
"2011","Cheltenham 009C","E01022119","Total",1305,185,57,128,1120,42,84,365,278,25,98,228
"2011","Cheltenham 009D","E01022124","Total",1142,477,128,349,665,22,88,70,344,31,15,95
"2011","Cheltenham 009E","E01022125","Total",1208,230,82,148,978,31,156,201,290,51,77,172
"2011","Cheltenham 009F","E01022126","Total",1419,565,96,469,854,26,104,65,502,5,20,132
"2011","Cheltenham 009G","E01022127","Total",1204,357,70,287,847,10,60,104,366,46,62,199
"2011","Cheltenham 010A","E01022106","Total",1737,189,93,96,1548,44,282,430,312,77,117,286
"2011","Cheltenham 010B","E01022107","Total",1527,175,79,96,1352,45,226,364,260,71,148,238
"2011","Cheltenham 010C","E01022108","Total",1786,180,88,92,1606,51,280,394,236,95,167,383
"2011","Cheltenham 010D","E01022123","Total",2201,316,83,233,1885,105,210,461,460,85,177,387
"2011","Cheltenham 011A","E01022135","Total",1369,209,126,83,1160,35,208,298,234,102,87,196
"2011","Cheltenham 011B","E01022136","Total",1384,344,179,165,1040,41,172,236,310,80,66,135
"2011","Cheltenham 011C","E01022137","Total",1668,396,151,245,1272,59,152,242,454,66,71,228
"2011","Cheltenham 011D","E01022138","Total",1571,292,106,186,1279,41,224,304,364,91,72,183
"2011","Cheltenham 011E","E01022174","Total",1347,182,101,81,1165,34,240,298,188,67,116,222
"2011","Cheltenham 012A","E01022103","Total",2380,250,79,171,2130,95,264,599,506,175,152,339
"2011","Cheltenham 012B","E01022104","Total",1634,225,92,133,1409,98,184,342,308,119,151,207
"2011","Cheltenham 012C","E01022105","Total",1431,142,82,60,1289,39,240,385,176,106,114,229
"2011","Cheltenham 012D","E01022109","Total",1476,149,94,55,1327,32,250,379,188,76,149,253
"2011","Cheltenham 012E","E01022110","Total",1371,229,130,99,1142,83,110,399,200,96,103,151
"2011","Cheltenham 012F","E01022111","Total",1416,178,92,86,1238,46,164,375,204,154,151,144
"2011","Cheltenham 012G","E01022112","Total",1229,97,47,50,1132,44,144,338,156,60,170,220
"2011","Cheltenham 013A","E01022167","Total",1223,103,73,30,1120,34,234,313,204,56,102,177
"2011","Cheltenham 013B","E01022168","Total",1104,130,80,50,974,31,200,271,160,35,128,149
"2011","Cheltenham 013C","E01022169","Total",1506,228,112,116,1278,70,130,386,262,87,130,213
"2011","Cheltenham 013D","E01022170","Total",1483,200,83,117,1283,57,128,360,238,94,194,212
"2011","Cheltenham 013E","E01022171","Total",1350,137,30,107,1213,50,56,443,292,55,115,202
"2011","Cheltenham 013F","E01022172","Total",1427,249,158,91,1178,47,334,276,252,25,71,173
"2011","Cheltenham 013G","E01022173","Total",1326,207,94,113,1119,100,206,217,226,64,93,213
"2011","Cheltenham 014A","E01022113","Total",1640,207,157,50,1433,20,344,374,194,98,157,246
"2011","Cheltenham 014B","E01022114","Total",1503,179,113,66,1324,30,306,363,240,102,138,145
"2011","Cheltenham 014C","E01022115","Total",1619,337,133,204,1282,46,218,319,308,83,95,213
"2011","Cheltenham 014D","E01022118","Total",1413,159,86,73,1254,46,136,431,184,83,156,218
"2011","Cheltenham 015A","E01022128","Total",1595,175,107,68,1420,20,266,427,242,131,139,195
"2011","Cheltenham 015B","E01022129","Total",2051,250,144,106,1801,51,330,527,302,192,186,213
"2011","Cheltenham 015C","E01022130","Total",1555,274,122,152,1281,33,142,434,332,76,95,169
"2011","Cotswold 001A","E01022179","Total",2034,277,135,142,1757,72,356,424,328,143,161,273
"2011","Cotswold 001B","E01022182","Total",1495,188,126,62,1307,51,372,245,260,66,97,216
"2011","Cotswold 001C","E01022183","Total",1445,236,141,95,1209,33,334,232,226,86,97,201
"2011","Cotswold 001D","E01022184","Total",1445,207,122,85,1238,28,328,227,244,87,102,222
"2011","Cotswold 001E","E01022185","Total",1414,174,111,63,1240,44,298,310,210,64,120,194
"2011","Cotswold 002A","E01022177","Total",1983,373,231,142,1610,50,362,280,328,100,175,315
"2011","Cotswold 002B","E01022178","Total",1319,185,96,89,1134,36,238,243,224,86,135,172
"2011","Cotswold 002C","E01022205","Total",1783,277,156,121,1506,38,318,341,338,111,101,259
"2011","Cotswold 002D","E01022211","Total",1807,406,209,197,1401,66,326,351,284,93,104,177
"2011","Cotswold 002E","E01022212","Total",1648,199,118,81,1449,39,296,351,280,82,147,254
"2011","Cotswold 003A","E01022180","Total",2050,289,162,127,1761,82,318,455,340,81,194,291
"2011","Cotswold 003B","E01022181","Total",1574,280,193,87,1294,13,372,243,282,79,72,233
"2011","Cotswold 003C","E01022214","Total",2098,196,64,132,1902,73,242,573,362,143,231,278
"2011","Cotswold 003D","E01022222","Total",1885,270,116,154,1615,26,386,342,340,97,133,291
"2011","Cotswold 004A","E01022186","Total",1703,187,84,103,1516,38,270,376,292,122,139,279
"2011","Cotswold 004B","E01022187","Total",1781,167,94,73,1614,32,282,320,328,161,191,300
"2011","Cotswold 004C","E01022201","Total",1789,178,80,98,1611,32,274,324,332,118,176,355
"2011","Cotswold 004D","E01022216","Total",1826,201,82,119,1625,38,256,426,376,135,122,272
"2011","Cotswold 005A","E01022175","Total",1863,224,104,120,1639,40,308,324,386,98,166,317
"2011","Cotswold 005B","E01022207","Total",1789,182,99,83,1607,27,274,366,332,149,138,321
"2011","Cotswold 005C","E01022213","Total",1804,229,122,107,1575,56,282,428,318,102,140,249
"2011","Cotswold 005D","E01022215","Total",1762,257,103,154,1505,29,288,292,376,154,92,274
"2011","Cotswold 006A","E01022188","Total",1352,215,84,131,1137,74,136,271,194,93,128,241
"2011","Cotswold 006B","E01022189","Total",1341,105,60,45,1236,16,152,258,202,110,186,312
"2011","Cotswold 006C","E01022190","Total",1379,107,40,67,1272,78,96,320,234,55,134,355
"2011","Cotswold 006D","E01022196","Total",1750,198,107,91,1552,58,242,383,256,129,201,283
"2011","Cotswold 006E","E01022197","Total",1863,179,98,81,1684,46,288,405,344,99,181,321
"2011","Cotswold 007A","E01022194","Total",1637,583,329,254,1054,56,232,160,278,47,69,212
"2011","Cotswold 007B","E01022195","Total",1298,241,138,103,1057,60,230,224,250,52,57,184
"2011","Cotswold 007C","E01022199","Total",1702,359,156,203,1343,42,212,314,360,41,121,253
"2011","Cotswold 007D","E01022200","Total",1194,271,100,171,923,90,112,279,194,76,36,136
"2011","Cotswold 008A","E01022191","Total",1376,231,88,143,1145,86,122,326,302,38,66,205
"2011","Cotswold 008B","E01022192","Total",1320,162,75,87,1158,60,104,178,206,146,187,277
"2011","Cotswold 008C","E01022193","Total",1027,81,50,31,946,15,188,203,170,46,137,187
"2011","Cotswold 008D","E01022198","Total",1306,166,67,99,1140,28,132,236,280,90,152,222
"2011","Cotswold 008E","E01022225","Total",1524,161,89,72,1363,39,228,409,224,98,130,235
"2011","Cotswold 009A","E01022202","Total",1065,83,47,36,982,13,154,276,194,66,99,180
"2011","Cotswold 009B","E01022203","Total",1400,212,151,61,1188,35,300,208,194,84,113,254
"2011","Cotswold 009C","E01022204","Total",1458,168,95,73,1290,72,148,314,256,85,164,251
"2011","Cotswold 009D","E01022208","Total",1573,162,84,78,1411,40,308,299,258,101,189,216
"2011","Cotswold 009E","E01022209","Total",1123,81,39,42,1042,29,116,305,238,46,78,230
"2011","Cotswold 009F","E01022210","Total",1275,257,139,118,1018,66,282,189,194,31,68,188
"2011","Cotswold 010A","E01022221","Total",1953,180,80,100,1773,81,266,430,278,151,202,365
"2011","Cotswold 010B","E01022223","Total",2372,278,121,157,2094,96,328,503,450,132,261,324
"2011","Cotswold 010C","E01022224","Total",1547,175,86,89,1372,26,294,302,306,51,133,260
"2011","Cotswold 011A","E01022176","Total",1925,222,79,143,1703,46,254,434,338,122,160,349
"2011","Cotswold 011B","E01022206","Total",1856,204,87,117,1652,34,302,356,358,132,158,312
"2011","Cotswold 011C","E01022217","Total",1294,156,77,79,1138,40,194,312,234,62,112,184
"2011","Cotswold 011D","E01022218","Total",1314,123,64,59,1191,69,168,284,200,131,117,222
"2011","Cotswold 011E","E01022219","Total",1226,125,69,56,1101,14,210,327,220,56,91,183
"2011","Cotswold 011F","E01022220","Total",1572,292,161,131,1280,36,322,324,332,52,65,149
"2011","Forest of Dean 001A","E01022233","Total",1876,195,100,95,1681,26,314,326,310,104,227,374
"2011","Forest of Dean 001B","E01022235","Total",1733,184,114,70,1549,43,346,292,290,99,187,292
"2011","Forest of Dean 001C","E01022247","Total",1638,156,87,69,1482,49,276,252,260,88,204,353
"2011","Forest of Dean 001D","E01022270","Total",1832,159,91,68,1673,57,294,364,326,126,202,304
"2011","Forest of Dean 001E","E01022271","Total",1657,162,77,85,1495,19,316,267,324,105,146,318
"2011","Forest of Dean 002A","E01022261","Total",1941,186,102,84,1755,78,288,406,288,147,226,322
"2011","Forest of Dean 002B","E01022262","Total",1820,318,163,155,1502,91,186,287,382,113,151,292
"2011","Forest of Dean 002C","E01022267","Total",1515,173,103,70,1342,27,292,188,274,66,172,323
"2011","Forest of Dean 003A","E01022251","Total",1431,191,107,84,1240,66,184,237,268,89,184,212
"2011","Forest of Dean 003B","E01022252","Total",1719,172,93,79,1547,23,260,327,296,107,189,345
"2011","Forest of Dean 003C","E01022258","Total",1107,147,65,82,960,66,120,238,142,72,118,204
"2011","Forest of Dean 003D","E01022259","Total",1596,124,63,61,1472,46,224,337,288,73,183,321
"2011","Forest of Dean 003E","E01022260","Total",1794,195,85,110,1599,77,216,383,314,106,175,328
"2011","Forest of Dean 004A","E01022236","Total",2043,257,114,143,1786,72,256,392,410,116,216,324
"2011","Forest of Dean 004B","E01022237","Total",1495,186,92,94,1309,110,148,272,228,98,169,284
"2011","Forest of Dean 004C","E01022238","Total",1276,231,125,106,1045,128,164,251,194,78,91,139
"2011","Forest of Dean 004D","E01022239","Total",1620,188,95,93,1432,54,226,313,284,94,177,284
"2011","Forest of Dean 004E","E01022240","Total",2022,327,134,193,1695,112,214,372,398,96,215,288
"2011","Forest of Dean 004F","E01022249","Total",1955,190,99,91,1765,34,322,365,350,124,228,342
"2011","Forest of Dean 004G","E01022250","Total",1790,188,100,88,1602,95,234,349,372,124,139,289
"2011","Forest of Dean 005A","E01022228","Total",1672,163,83,80,1509,41,264,258,298,91,257,300
"2011","Forest of Dean 005B","E01022230","Total",1682,154,87,67,1528,30,292,328,278,125,148,327
"2011","Forest of Dean 005C","E01022265","Total",1602,223,105,118,1379,40,254,277,258,112,177,261
"2011","Forest of Dean 005D","E01022266","Total",1351,105,58,47,1246,24,216,268,204,59,182,293
"2011","Forest of Dean 006A","E01022234","Total",1490,159,78,81,1331,14,290,212,254,82,163,316
"2011","Forest of Dean 006B","E01022253","Total",1650,188,80,108,1462,57,248,333,314,126,160,224
"2011","Forest of Dean 006C","E01022263","Total",1804,189,90,99,1615,50,316,299,352,95,186,317
"2011","Forest of Dean 007A","E01022229","Total",1652,166,103,63,1486,61,256,311,238,123,153,344
"2011","Forest of Dean 007B","E01022241","Total",1581,362,183,179,1219,23,278,272,278,72,116,180
"2011","Forest of Dean 007C","E01022242","Total",1437,163,79,84,1274,50,204,280,204,121,183,232
"2011","Forest of Dean 007D","E01022243","Total",1224,160,72,88,1064,69,152,276,172,81,107,207
"2011","Forest of Dean 007E","E01022244","Total",1459,158,88,70,1301,81,182,321,272,74,151,220
"2011","Forest of Dean 007F","E01022245","Total",1314,184,65,119,1130,95,154,226,242,72,95,246
"2011","Forest of Dean 007G","E01022246","Total",1290,122,63,59,1168,44,200,265,216,104,102,237
"2011","Forest of Dean 008A","E01022231","Total",1639,201,99,102,1438,48,188,356,268,127,176,275
"2011","Forest of Dean 008B","E01022232","Total",1529,160,65,95,1369,74,232,317,256,80,179,231
"2011","Forest of Dean 008C","E01022264","Total",1467,148,66,82,1319,32,222,288,244,85,130,318
"2011","Forest of Dean 008D","E01022268","Total",1575,166,102,64,1409,43,250,318,292,62,136,308
"2011","Forest of Dean 008E","E01022269","Total",1934,162,78,84,1772,61,340,390,364,103,199,315
"2011","Forest of Dean 009A","E01022226","Total",1548,228,115,113,1320,93,222,336,212,101,141,215
"2011","Forest of Dean 009B","E01022227","Total",1546,201,105,96,1345,24,296,286,232,73,164,270
"2011","Forest of Dean 009C","E01022254","Total",1851,216,102,114,1635,98,172,363,278,144,227,353
"2011","Forest of Dean 009D","E01022255","Total",1551,152,65,87,1399,35,186,396,236,71,202,273
"2011","Forest of Dean 009E","E01022256","Total",1572,293,158,135,1279,90,236,230,220,89,178,236
"2011","Forest of Dean 009F","E01022257","Total",1851,180,107,73,1671,57,302,369,302,76,221,344
"2011","Forest of Dean 010A","E01022248","Total",1690,158,78,80,1532,38,308,292,304,97,148,345
"2011","Forest of Dean 010B","E01022272","Total",1263,160,105,55,1103,63,204,266,212,40,97,221
"2011","Forest of Dean 010C","E01022273","Total",1245,72,48,24,1173,46,150,383,184,141,152,117
"2011","Forest of Dean 010D","E01022274","Total",1173,113,48,65,1060,29,184,250,236,45,114,202
"2011","Forest of Dean 010E","E01022275","Total",1538,191,116,75,1347,22,258,357,274,108,106,222
"2011","Gloucester 001A","E01022313","Total",1689,185,71,114,1504,76,188,379,286,126,146,303
"2011","Gloucester 001B","E01022315","Total",1500,150,85,65,1350,39,232,318,238,78,137,308
"2011","Gloucester 001C","E01022316","Total",1581,194,84,110,1387,67,138,407,290,45,150,290
"2011","Gloucester 001D","E01022317","Total",1564,130,79,51,1434,41,186,355,226,100,213,313
"2011","Gloucester 001E","E01022318","Total",1548,160,117,43,1388,32,268,321,246,66,130,325
"2011","Gloucester 002A","E01022309","Total",1470,204,85,119,1266,58,150,261,214,71,213,299
"2011","Gloucester 002B","E01022310","Total",1693,246,98,148,1447,87,178,267,298,55,171,391
"2011","Gloucester 002C","E01022311","Total",1704,591,207,384,1113,88,106,251,292,35,114,227
"2011","Gloucester 002D","E01022312","Total",2043,362,107,255,1681,71,132,370,476,91,188,353
"2011","Gloucester 002E","E01022314","Total",1451,164,111,53,1287,25,332,244,260,73,123,230
"2011","Gloucester 003A","E01022295","Total",1430,144,100,44,1286,58,246,306,182,76,153,265
"2011","Gloucester 003B","E01022296","Total",1450,171,74,97,1279,114,114,380,202,98,130,241
"2011","Gloucester 003C","E01022297","Total",1263,85,55,30,1178,21,180,243,244,90,152,248
"2011","Gloucester 003D","E01022298","Total",1527,135,55,80,1392,49,104,359,290,79,186,325
"2011","Gloucester 004A","E01022332","Total",1562,247,61,186,1315,69,80,278,262,72,242,312
"2011","Gloucester 004B","E01022347","Total",1630,501,39,462,1129,83,54,123,448,26,114,281
"2011","Gloucester 004C","E01022348","Total",2609,333,84,249,2276,136,244,525,526,202,239,404
"2011","Gloucester 004E","E01032932","Total",1047,373,198,175,674,14,160,114,158,42,70,116
"2011","Gloucester 004F","E01032937","Total",994,374,72,302,620,27,42,78,208,10,89,166
"2011","Gloucester 005A","E01022288","Total",1739,228,62,166,1511,179,72,423,232,172,219,214
"2011","Gloucester 005B","E01022289","Total",1582,213,89,124,1369,109,92,250,174,189,250,305
"2011","Gloucester 005C","E01022290","Total",1374,148,55,93,1226,109,108,341,162,154,167,185
"2011","Gloucester 005D","E01022291","Total",1722,181,45,136,1541,158,72,325,190,162,389,245
"2011","Gloucester 005E","E01022292","Total",1411,139,41,98,1272,44,70,203,148,133,371,303
"2011","Gloucester 006A","E01022283","Total",1482,161,91,70,1321,26,262,317,236,55,142,283
"2011","Gloucester 006B","E01022303","Total",1406,204,122,82,1202,68,216,235,200,93,160,230
"2011","Gloucester 006C","E01022304","Total",1543,281,172,109,1262,46,324,305,260,37,96,194
"2011","Gloucester 006D","E01022305","Total",1391,165,105,60,1226,36,258,306,170,51,126,279
"2011","Gloucester 006E","E01022308","Total",1413,180,119,61,1233,40,316,288,242,20,94,233
"2011","Gloucester 007A","E01022278","Total",1588,132,44,88,1456,76,172,402,292,57,160,297
"2011","Gloucester 007B","E01022279","Total",1480,106,57,49,1374,56,152,428,230,74,146,288
"2011","Gloucester 007C","E01022282","Total",2851,193,28,165,2658,158,166,967,432,193,326,416
"2011","Gloucester 007D","E01022284","Total",1277,134,52,82,1143,90,110,277,190,65,177,234
"2011","Gloucester 007E","E01022285","Total",1409,107,47,60,1302,137,124,209,136,168,247,281
"2011","Gloucester 007F","E01022286","Total",1579,156,52,104,1423,124,98,319,232,99,227,324
"2011","Gloucester 007G","E01022287","Total",1669,220,106,114,1449,59,208,348,252,127,174,281
"2011","Gloucester 008A","E01022293","Total",1555,213,46,167,1342,86,104,207,204,142,252,347
"2011","Gloucester 008B","E01022294","Total",1526,183,56,127,1343,127,88,326,270,125,137,270
"2011","Gloucester 008C","E01022323","Total",1777,126,47,79,1651,213,100,323,208,219,271,317
"2011","Gloucester 008D","E01022328","Total",1328,123,72,51,1205,70,102,247,174,106,204,302
"2011","Gloucester 008E","E01022329","Total",1585,161,56,105,1424,135,88,287,216,257,199,242
"2011","Gloucester 009A","E01022326","Total",1307,154,35,119,1153,141,86,279,252,81,143,171
"2011","Gloucester 009B","E01022327","Total",1561,149,56,93,1412,78,128,329,280,123,194,280
"2011","Gloucester 009C","E01022330","Total",1443,154,41,113,1289,71,94,370,268,106,179,201
"2011","Gloucester 009D","E01022331","Total",1362,117,56,61,1245,41,96,273,144,144,200,347
"2011","Gloucester 009E","E01022333","Total",1393,254,82,172,1139,177,142,176,170,72,172,230
"2011","Gloucester 009F","E01022334","Total",1586,172,110,62,1414,30,242,285,220,149,149,339
"2011","Gloucester 010A","E01022276","Total",1627,162,93,69,1465,48,248,341,278,66,153,331
"2011","Gloucester 010B","E01022277","Total",1484,206,104,102,1278,45,186,305,264,89,113,276
"2011","Gloucester 010C","E01022280","Total",1527,201,21,180,1326,100,60,409,384,44,89,240
"2011","Gloucester 010D","E01022281","Total",1770,125,47,78,1645,65,162,490,330,88,182,328
"2011","Gloucester 010E","E01022306","Total",1404,155,47,108,1249,58,126,391,270,53,143,208
"2011","Gloucester 010F","E01022307","Total",1659,128,29,99,1531,107,94,484,314,106,150,276
"2011","Gloucester 011A","E01022319","Total",1419,305,70,235,1114,255,114,280,190,75,75,125
"2011","Gloucester 011B","E01022320","Total",1437,198,74,124,1239,103,150,307,192,58,139,290
"2011","Gloucester 011C","E01022321","Total",1510,161,63,98,1349,83,150,276,242,128,199,271
"2011","Gloucester 011D","E01022322","Total",1290,243,126,117,1047,96,158,212,176,57,127,221
"2011","Gloucester 011E","E01022324","Total",1446,199,95,104,1247,151,146,245,260,47,126,272
"2011","Gloucester 011F","E01022325","Total",1334,190,96,94,1144,55,178,173,194,104,126,314
"2011","Gloucester 012A","E01022343","Total",1237,121,65,56,1116,41,224,213,198,80,161,199
"2011","Gloucester 012B","E01022344","Total",1522,164,99,65,1358,65,214,212,262,113,224,268
"2011","Gloucester 012C","E01022345","Total",1470,167,94,73,1303,45,250,229,238,82,172,287
"2011","Gloucester 012D","E01022346","Total",1520,226,91,135,1294,143,116,272,238,155,153,217
"2011","Gloucester 013A","E01022299","Total",1392,165,84,81,1227,80,284,234,246,50,103,230
"2011","Gloucester 013B","E01022300","Total",1355,181,102,79,1174,41,330,223,230,62,69,219
"2011","Gloucester 013C","E01022301","Total",1544,204,96,108,1340,109,180,307,228,158,153,205
"2011","Gloucester 013D","E01022302","Total",1538,136,84,52,1402,65,256,311,196,69,196,309
"2011","Gloucester 014A","E01022339","Total",1720,110,33,77,1610,103,114,553,374,107,134,225
"2011","Gloucester 014B","E01022340","Total",1459,184,22,162,1275,103,42,384,326,72,135,213
"2011","Gloucester 014C","E01022341","Total",2103,213,56,157,1890,112,124,553,402,127,228,344
"2011","Gloucester 014D","E01022342","Total",1708,156,13,143,1552,91,56,592,354,85,176,198
"2011","Gloucester 015A","E01022335","Total",1500,160,82,78,1340,60,152,294,248,108,170,308
"2011","Gloucester 015B","E01022336","Total",1167,124,63,61,1043,59,176,273,196,37,115,187
"2011","Gloucester 015D","E01022338","Total",1348,216,43,173,1132,121,54,399,334,73,62,89
"2011","Gloucester 015E","E01032933","Total",1505,83,7,76,1422,110,14,529,282,145,183,159
"2011","Gloucester 015F","E01032934","Total",1410,153,53,100,1257,75,108,318,236,74,154,292
"2011","Gloucester 015G","E01032935","Total",1586,72,4,68,1514,73,22,649,290,131,173,176
"2011","Gloucester 015H","E01032936","Total",1870,84,3,81,1786,186,12,635,270,321,220,142
"2011","Stroud 001A","E01022378","Total",1822,155,38,117,1667,56,162,509,398,90,163,289
"2011","Stroud 001B","E01022379","Total",1436,237,67,170,1199,103,90,298,318,57,147,186
"2011","Stroud 001C","E01022380","Total",1525,124,59,65,1401,52,238,275,264,114,204,254
"2011","Stroud 001D","E01022412","Total",2803,261,139,122,2542,123,406,514,550,179,294,476
"2011","Stroud 002A","E01022354","Total",2142,234,131,103,1908,23,450,441,370,97,170,357
"2011","Stroud 002B","E01022390","Total",1202,230,165,65,972,55,244,253,176,63,48,133
"2011","Stroud 002C","E01022391","Total",1424,154,100,54,1270,40,358,228,262,70,138,174
"2011","Stroud 002D","E01022392","Total",1531,168,88,80,1363,29,314,225,254,124,153,264
"2011","Stroud 003A","E01022376","Total",1769,198,118,80,1571,47,222,365,308,96,182,351
"2011","Stroud 003B","E01022396","Total",1676,134,63,71,1542,32,230,400,292,104,161,323
"2011","Stroud 003C","E01022397","Total",1891,140,71,69,1751,34,222,416,304,195,206,374
"2011","Stroud 003D","E01022398","Total",1121,92,52,40,1029,29,200,184,166,71,157,222
"2011","Stroud 004A","E01022355","Total",1675,143,69,74,1532,78,202,354,226,155,181,336
"2011","Stroud 004B","E01022356","Total",2240,296,122,174,1944,123,140,511,412,174,156,428
"2011","Stroud 004C","E01022357","Total",1771,216,107,109,1555,54,276,402,320,88,173,242
"2011","Stroud 004D","E01022358","Total",1589,210,136,74,1379,47,212,305,194,166,200,255
"2011","Stroud 004E","E01022377","Total",2137,345,139,206,1792,120,316,433,332,93,193,305
"2011","Stroud 004F","E01022389","Total",1747,142,76,66,1605,39,310,409,328,72,175,272
"2011","Stroud 005A","E01022400","Total",1816,230,120,110,1586,48,234,400,350,92,170,292
"2011","Stroud 005B","E01022401","Total",1410,168,68,100,1242,57,164,300,248,110,125,238
"2011","Stroud 005C","E01022402","Total",1579,170,69,101,1409,64,108,340,288,110,156,343
"2011","Stroud 005D","E01022403","Total",1377,209,130,79,1168,65,206,199,194,121,159,224
"2011","Stroud 005E","E01022404","Total",1240,158,62,96,1082,38,158,216,260,42,100,268
"2011","Stroud 006A","E01022365","Total",2067,421,146,275,1646,76,182,372,404,117,141,354
"2011","Stroud 006B","E01022399","Total",2131,307,83,224,1824,120,172,401,354,157,272,348
"2011","Stroud 006C","E01022410","Total",2114,369,129,240,1745,158,170,431,386,91,174,335
"2011","Stroud 006D","E01022411","Total",2178,315,158,157,1863,72,218,478,356,98,256,385
"2011","Stroud 006E","E01022414","Total",2427,386,92,294,2041,103,196,555,488,131,209,359
"2011","Stroud 007A","E01022393","Total",1454,155,86,69,1299,17,302,326,226,93,132,203
"2011","Stroud 007B","E01022394","Total",1553,216,55,161,1337,52,94,373,328,115,146,229
"2011","Stroud 007C","E01022395","Total",1524,145,76,69,1379,39,254,347,256,72,111,300
"2011","Stroud 007D","E01022408","Total",1071,93,36,57,978,8,144,252,200,92,100,182
"2011","Stroud 007E","E01022409","Total",1256,104,35,69,1152,39,156,307,208,69,141,232
"2011","Stroud 008A","E01022366","Total",1784,122,72,50,1662,45,234,524,274,194,180,211
"2011","Stroud 008B","E01022367","Total",1655,151,86,65,1504,35,274,439,252,107,166,231
"2011","Stroud 008C","E01022368","Total",1385,143,92,51,1242,7,236,283,264,73,134,245
"2011","Stroud 008D","E01022369","Total",1674,246,76,170,1428,139,92,456,314,107,139,181
"2011","Stroud 009A","E01022370","Total",1240,132,70,62,1108,38,186,267,238,63,108,208
"2011","Stroud 009B","E01022371","Total",1056,68,35,33,988,19,206,154,174,53,142,240
"2011","Stroud 009C","E01022405","Total",1424,200,124,76,1224,63,230,308,190,82,118,233
"2011","Stroud 009D","E01022406","Total",1207,135,78,57,1072,21,180,229,252,62,110,218
"2011","Stroud 009E","E01022407","Total",1304,134,80,54,1170,26,226,187,224,72,165,270
"2011","Stroud 010A","E01022350","Total",2099,203,136,67,1896,45,478,379,300,148,237,309
"2011","Stroud 010B","E01022382","Total",1523,159,120,39,1364,28,356,278,248,110,105,239
"2011","Stroud 010C","E01022383","Total",1306,208,146,62,1098,63,250,206,160,113,110,196
"2011","Stroud 010D","E01022384","Total",1378,172,92,80,1206,36,290,238,254,78,117,193
"2011","Stroud 011A","E01022359","Total",1492,177,112,65,1315,40,224,295,234,88,164,270
"2011","Stroud 011B","E01022360","Total",1394,103,52,51,1291,17,256,323,288,51,141,215
"2011","Stroud 011C","E01022361","Total",1248,249,149,100,999,30,184,281,178,57,67,202
"2011","Stroud 011D","E01022362","Total",1159,146,97,49,1013,20,208,213,204,48,127,193
"2011","Stroud 011E","E01022363","Total",1755,217,93,124,1538,71,230,394,326,72,126,319
"2011","Stroud 011F","E01022364","Total",1114,150,89,61,964,72,144,183,196,68,134,167
"2011","Stroud 012A","E01022351","Total",1412,155,81,74,1257,37,160,265,270,109,112,304
"2011","Stroud 012B","E01022352","Total",1320,181,96,85,1139,26,192,231,226,104,130,230
"2011","Stroud 012C","E01022353","Total",1410,203,95,108,1207,42,184,287,278,81,112,223
"2011","Stroud 012D","E01022413","Total",1836,151,75,76,1685,34,288,344,288,116,252,363
"2011","Stroud 013A","E01022385","Total",1616,183,103,80,1433,73,208,308,232,125,188,299
"2011","Stroud 013B","E01022386","Total",1550,275,152,123,1275,23,228,228,342,88,148,218
"2011","Stroud 013C","E01022387","Total",1605,237,96,141,1368,110,140,324,310,73,149,262
"2011","Stroud 013D","E01022388","Total",1747,172,68,104,1575,74,208,474,242,119,175,283
"2011","Stroud 014A","E01022372","Total",1730,228,79,149,1502,39,240,410,310,120,133,250
"2011","Stroud 014B","E01022373","Total",1701,209,79,130,1492,70,210,430,296,88,135,263
"2011","Stroud 014C","E01022374","Total",1913,357,153,204,1556,112,248,387,358,126,83,242
"2011","Stroud 014D","E01022375","Total",1261,111,28,83,1150,147,56,275,178,133,134,227
"2011","Stroud 015A","E01022381","Total",2061,155,68,87,1906,66,240,541,308,198,207,346
"2011","Stroud 015B","E01022415","Total",1560,140,66,74,1420,38,274,262,260,111,216,259
"2011","Stroud 015C","E01022416","Total",1453,153,74,79,1300,45,154,360,214,126,168,233
"2011","Stroud 015D","E01022417","Total",1714,195,110,85,1519,63,234,342,292,89,150,349
"2011","Stroud 015E","E01022418","Total",1719,327,181,146,1392,51,228,366,276,121,89,261
"2011","Tewkesbury 001B","E01022450","Total",2044,287,100,187,1757,111,146,527,382,113,224,254
"2011","Tewkesbury 001C","E01022451","Total",1515,154,71,83,1361,54,166,305,334,142,122,238
"2011","Tewkesbury 001D","E01022452","Total",1448,87,22,65,1361,42,124,371,250,108,183,283
"2011","Tewkesbury 001E","E01022455","Total",1966,163,86,77,1803,32,342,335,374,88,197,435
"2011","Tewkesbury 001F","E01032938","Total",1475,137,38,99,1338,70,96,439,348,66,145,174
"2011","Tewkesbury 001G","E01032939","Total",1610,93,20,73,1517,86,84,577,262,127,178,203
"2011","Tewkesbury 001H","E01032940","Total",1406,96,12,84,1310,75,40,573,328,101,96,97
"2011","Tewkesbury 002A","E01022456","Total",1303,121,50,71,1182,34,176,293,248,96,121,214
"2011","Tewkesbury 002B","E01022457","Total",1359,213,95,118,1146,73,162,236,180,71,131,293
"2011","Tewkesbury 002C","E01022458","Total",1413,279,114,165,1134,124,106,335,202,105,115,147
"2011","Tewkesbury 002D","E01022459","Total",1450,442,181,261,1008,37,166,139,394,29,43,200
"2011","Tewkesbury 002E","E01022460","Total",1700,327,164,163,1373,38,202,345,352,79,88,269
"2011","Tewkesbury 002F","E01022461","Total",1380,202,122,80,1178,35,310,265,188,52,124,204
"2011","Tewkesbury 002G","E01022462","Total",1639,137,81,56,1502,23,344,308,330,78,137,282
"2011","Tewkesbury 003A","E01022449","Total",1947,198,107,91,1749,34,398,346,390,112,198,271
"2011","Tewkesbury 003B","E01022463","Total",1468,255,129,126,1213,32,310,215,268,65,104,219
"2011","Tewkesbury 003C","E01022464","Total",1580,266,172,94,1314,73,308,301,220,90,113,209
"2011","Tewkesbury 003D","E01022465","Total",1526,126,72,54,1400,35,284,338,256,70,176,241
"2011","Tewkesbury 003E","E01022466","Total",1721,199,112,87,1522,50,320,394,282,112,141,223
"2011","Tewkesbury 004A","E01022434","Total",2061,178,122,56,1883,22,396,482,350,126,178,329
"2011","Tewkesbury 004B","E01022441","Total",1496,170,47,123,1326,54,222,253,348,68,99,282
"2011","Tewkesbury 004C","E01022445","Total",1367,110,56,54,1257,22,226,264,290,79,121,255
"2011","Tewkesbury 004D","E01022453","Total",1592,125,80,45,1467,17,368,360,204,36,175,307
"2011","Tewkesbury 005A","E01022432","Total",2009,331,179,152,1678,59,386,392,300,109,133,299
"2011","Tewkesbury 005B","E01022433","Total",2081,166,98,68,1915,80,388,426,358,199,151,313
"2011","Tewkesbury 005C","E01022435","Total",2327,259,176,83,2068,141,340,469,296,154,244,424
"2011","Tewkesbury 005D","E01022436","Total",1921,321,207,114,1600,70,360,389,324,100,138,219
"2011","Tewkesbury 005E","E01022437","Total",1402,172,92,80,1230,47,152,361,206,129,106,229
"2011","Tewkesbury 005F","E01022438","Total",1352,180,59,121,1172,53,116,417,292,37,75,182
"2011","Tewkesbury 005G","E01022439","Total",1555,249,67,182,1306,96,104,497,290,66,97,156
"2011","Tewkesbury 006A","E01022440","Total",1524,274,106,168,1250,44,208,242,310,76,122,248
"2011","Tewkesbury 006B","E01022442","Total",1498,121,52,69,1377,11,252,290,304,16,187,317
"2011","Tewkesbury 006C","E01022443","Total",1334,115,64,51,1219,23,202,288,252,58,138,258
"2011","Tewkesbury 006D","E01022444","Total",1446,107,60,47,1339,21,240,251,278,136,140,273
"2011","Tewkesbury 007A","E01022425","Total",1215,124,67,57,1091,15,176,278,196,61,155,210
"2011","Tewkesbury 007B","E01022426","Total",1433,169,130,39,1264,19,372,228,196,67,133,249
"2011","Tewkesbury 007C","E01022427","Total",1414,216,120,96,1198,56,186,291,248,76,105,236
"2011","Tewkesbury 007D","E01022428","Total",1839,271,103,168,1568,124,166,428,266,157,195,232
"2011","Tewkesbury 007E","E01022429","Total",1561,196,77,119,1365,52,212,347,248,65,177,264
"2011","Tewkesbury 007F","E01022430","Total",1440,169,107,62,1271,30,284,259,242,85,96,275
"2011","Tewkesbury 007G","E01022431","Total",2046,281,70,211,1765,44,154,572,402,87,205,301
"2011","Tewkesbury 007H","E01022447","Total",1301,73,22,51,1228,41,30,597,246,123,80,111
"2011","Tewkesbury 008A","E01022420","Total",2071,274,152,122,1797,29,428,285,294,119,257,385
"2011","Tewkesbury 008B","E01022448","Total",1342,158,108,50,1184,65,256,233,198,69,162,201
"2011","Tewkesbury 008C","E01022454","Total",1910,271,179,92,1639,82,344,350,292,97,160,314
"2011","Tewkesbury 009A","E01022421","Total",1677,227,80,147,1450,105,192,337,302,97,160,257
"2011","Tewkesbury 009B","E01022422","Total",1639,130,40,90,1509,36,170,420,306,109,181,287
"2011","Tewkesbury 009C","E01022423","Total",1911,235,123,112,1676,78,300,359,336,61,213,329
"2011","Tewkesbury 009D","E01022424","Total",1611,174,80,94,1437,129,208,296,222,104,204,274
"2011","Tewkesbury 009E","E01022446","Total",1728,230,102,128,1498,77,174,468,376,124,91,188
"2011","Mendip 001A","E01029022","Total",1337,175,92,83,1162,37,202,271,222,115,119,196
"2011","Mendip 001B","E01029023","Total",1191,110,53,57,1081,25,194,229,190,109,142,192
"2011","Mendip 001C","E01029044","Total",1333,173,47,126,1160,117,90,328,234,56,125,210
"2011","Mendip 001D","E01029053","Total",2262,250,104,146,2012,88,346,369,378,149,305,377
"2011","Mendip 001E","E01029057","Total",2040,186,96,90,1854,74,332,424,332,179,165,348
"2011","Mendip 002A","E01029024","Total",2062,187,85,102,1875,58,280,461,298,141,205,432
"2011","Mendip 002B","E01029025","Total",1314,156,76,80,1158,35,156,266,198,85,152,266
"2011","Mendip 002C","E01029026","Total",967,106,49,57,861,48,148,197,184,36,96,152
"2011","Mendip 002D","E01029068","Total",1161,127,59,68,1034,67,176,237,168,73,132,181
"2011","Mendip 002E","E01029069","Total",1060,110,57,53,950,22,156,190,222,51,157,152
"2011","Mendip 003A","E01029030","Total",1939,166,66,100,1773,80,218,483,372,118,123,379
"2011","Mendip 003B","E01029031","Total",1605,162,92,70,1443,84,256,343,268,75,151,266
"2011","Mendip 003C","E01029032","Total",1018,144,107,37,874,15,308,160,176,30,37,148
"2011","Mendip 003D","E01029033","Total",1433,176,75,101,1257,92,136,340,292,80,106,211
"2011","Mendip 003E","E01029034","Total",1328,178,58,120,1150,69,142,261,250,82,86,260
"2011","Mendip 004A","E01029036","Total",1595,265,74,191,1330,93,114,308,266,139,168,242
"2011","Mendip 004B","E01029041","Total",1963,414,173,241,1549,144,188,373,320,118,166,240
"2011","Mendip 004C","E01029042","Total",1490,250,86,164,1240,132,114,301,230,118,148,197
"2011","Mendip 004D","E01029043","Total",1504,169,51,118,1335,107,132,337,268,68,158,265
"2011","Mendip 004E","E01029045","Total",1553,184,76,108,1369,72,176,291,272,115,139,304
"2011","Mendip 005A","E01029052","Total",2027,219,119,100,1808,55,372,353,322,145,183,378
"2011","Mendip 005B","E01029060","Total",1906,164,86,78,1742,64,330,334,314,194,192,314
"2011","Mendip 005C","E01029061","Total",2226,250,126,124,1976,75,358,462,336,128,285,332
"2011","Mendip 005D","E01029083","Total",1149,179,133,46,970,25,280,154,176,77,74,184
"2011","Mendip 006A","E01029018","Total",2283,210,115,95,2073,74,320,504,386,141,248,400
"2011","Mendip 006B","E01029056","Total",2238,269,114,155,1969,71,306,445,418,160,198,371
"2011","Mendip 006C","E01029064","Total",1407,204,79,125,1203,54,168,355,284,46,125,171
"2011","Mendip 006D","E01029084","Total",1494,224,127,97,1270,82,234,266,202,78,127,281
"2011","Mendip 007A","E01029029","Total",1646,223,113,110,1423,153,192,328,210,101,138,301
"2011","Mendip 007B","E01029035","Total",1527,163,64,99,1364,57,128,421,274,128,159,197
"2011","Mendip 007C","E01029037","Total",1376,199,66,133,1177,65,106,292,244,132,129,209
"2011","Mendip 007D","E01029038","Total",1385,145,49,96,1240,142,96,271,258,100,192,181
"2011","Mendip 007E","E01029039","Total",1479,179,112,67,1300,54,236,289,220,61,151,289
"2011","Mendip 007F","E01029040","Total",1640,218,91,127,1422,115,198,396,268,85,88,272
"2011","Mendip 008A","E01029078","Total",1731,441,274,167,1290,59,314,251,274,97,97,198
"2011","Mendip 008B","E01029079","Total",1505,315,141,174,1190,90,192,222,294,57,138,197
"2011","Mendip 008C","E01029080","Total",1469,191,107,84,1278,67,230,244,202,80,169,286
"2011","Mendip 008D","E01029081","Total",1499,276,150,126,1223,65,198,253,284,62,131,230
"2011","Mendip 008E","E01029082","Total",1339,223,142,81,1116,49,322,246,182,56,72,189
"2011","Mendip 009A","E01029062","Total",1414,303,44,259,1111,160,52,261,266,85,144,143
"2011","Mendip 009B","E01029063","Total",2445,215,60,155,2230,148,204,616,522,174,193,373
"2011","Mendip 009C","E01029065","Total",1656,155,57,98,1501,59,160,410,268,88,183,333
"2011","Mendip 009D","E01029066","Total",1737,225,94,131,1512,91,180,284,300,133,199,325
"2011","Mendip 009E","E01029067","Total",1456,230,128,102,1226,75,226,258,220,61,141,245
"2011","Mendip 010A","E01029020","Total",1409,159,78,81,1250,66,184,269,258,105,168,200
"2011","Mendip 010B","E01029021","Total",1233,102,61,41,1131,23,160,231,224,127,134,232
"2011","Mendip 010C","E01029027","Total",1145,133,69,64,1012,38,218,178,182,48,179,169
"2011","Mendip 010D","E01029028","Total",1139,212,116,96,927,26,170,252,204,51,68,156
"2011","Mendip 010E","E01029058","Total",2274,244,140,104,2030,97,334,433,386,203,206,371
"2011","Mendip 011A","E01029046","Total",1323,449,136,313,874,92,92,215,244,58,97,76
"2011","Mendip 011D","E01029050","Total",2216,276,115,161,1940,122,290,403,382,103,258,382
"2011","Mendip 011E","E01029051","Total",1550,215,100,115,1335,59,256,201,298,81,133,307
"2011","Mendip 011F","E01032627","Total",2063,331,135,196,1732,139,310,335,354,89,175,330
"2011","Mendip 012A","E01029047","Total",1434,170,52,118,1264,99,168,261,274,76,145,241
"2011","Mendip 012B","E01029054","Total",1539,140,68,72,1399,66,208,299,254,139,127,306
"2011","Mendip 012C","E01029055","Total",1236,103,50,53,1133,50,182,322,214,109,91,165
"2011","Mendip 012D","E01029074","Total",1272,109,65,44,1163,40,236,247,174,62,163,241
"2011","Mendip 012E","E01029076","Total",2059,167,96,71,1892,64,300,455,346,159,217,351
"2011","Mendip 013A","E01029019","Total",2299,258,147,111,2041,82,358,421,374,155,239,412
"2011","Mendip 013B","E01029059","Total",2070,216,103,113,1854,56,350,343,344,139,244,378
"2011","Mendip 013C","E01029077","Total",2039,163,73,90,1876,42,368,375,340,132,232,387
"2011","Mendip 014A","E01029070","Total",1815,305,107,198,1510,101,144,375,362,164,168,196
"2011","Mendip 014B","E01029071","Total",1528,231,96,135,1297,166,166,318,224,83,132,208
"2011","Mendip 014C","E01029072","Total",1639,303,142,161,1336,170,162,317,238,73,162,214
"2011","Mendip 014D","E01029073","Total",1245,198,113,85,1047,88,142,273,146,83,133,182
"2011","Mendip 014E","E01029075","Total",1315,217,125,92,1098,55,248,218,178,71,89,239
"2011","Sedgemoor 001A","E01029085","Total",2001,263,115,148,1738,90,234,476,386,81,166,305
"2011","Sedgemoor 001B","E01029126","Total",1515,184,95,89,1331,38,204,329,286,75,83,316
"2011","Sedgemoor 001C","E01029127","Total",1478,359,226,133,1119,86,260,220,212,76,88,177
"2011","Sedgemoor 001D","E01029128","Total",1864,174,99,75,1690,32,274,433,304,120,205,322
"2011","Sedgemoor 001E","E01029129","Total",1895,133,73,60,1762,39,282,467,258,114,271,331
"2011","Sedgemoor 002C","E01029089","Total",2241,142,81,61,2099,87,306,511,324,147,285,439
"2011","Sedgemoor 002D","E01029113","Total",1591,228,171,57,1363,51,396,239,234,70,162,211
"2011","Sedgemoor 002E","E01029115","Total",1665,197,136,61,1468,45,346,363,260,76,121,257
"2011","Sedgemoor 002F","E01029140","Total",2842,235,110,125,2607,96,414,579,478,215,281,544
"2011","Sedgemoor 002G","E01032633","Total",2096,276,152,124,1820,60,480,252,396,75,189,368
"2011","Sedgemoor 003A","E01029086","Total",2204,149,79,70,2055,57,406,410,344,149,266,423
"2011","Sedgemoor 003B","E01029147","Total",1736,128,79,49,1608,32,306,353,260,123,210,324
"2011","Sedgemoor 003C","E01029148","Total",1582,183,107,76,1399,44,240,303,202,114,212,284
"2011","Sedgemoor 003D","E01029149","Total",1417,136,86,50,1281,29,178,291,200,87,228,268
"2011","Sedgemoor 004A","E01029114","Total",1448,229,157,72,1219,23,428,171,224,38,127,208
"2011","Sedgemoor 004B","E01029116","Total",1470,409,187,222,1061,64,256,165,252,31,117,176
"2011","Sedgemoor 004C","E01029117","Total",1533,341,164,177,1192,81,250,204,256,41,115,245
"2011","Sedgemoor 004D","E01029119","Total",1529,324,227,97,1205,83,218,231,246,70,131,226
"2011","Sedgemoor 004E","E01029120","Total",1509,172,92,80,1337,124,206,358,280,53,121,195
"2011","Sedgemoor 005A","E01029118","Total",1795,156,96,60,1639,71,258,399,276,152,206,277
"2011","Sedgemoor 005B","E01029131","Total",2014,336,92,244,1678,253,140,425,388,111,153,208
"2011","Sedgemoor 005C","E01029132","Total",1459,216,116,100,1243,134,140,250,182,129,148,260
"2011","Sedgemoor 005D","E01029133","Total",1285,193,122,71,1092,17,258,220,210,53,112,222
"2011","Sedgemoor 005E","E01029134","Total",1868,249,147,102,1619,93,396,248,326,55,174,327
"2011","Sedgemoor 006A","E01029135","Total",1622,178,115,63,1444,34,326,236,322,78,166,282
"2011","Sedgemoor 006B","E01029136","Total",1968,191,109,82,1777,63,280,398,326,102,212,396
"2011","Sedgemoor 006C","E01029145","Total",1964,209,127,82,1755,58,344,390,352,137,178,296
"2011","Sedgemoor 006D","E01029152","Total",2115,281,174,107,1834,108,376,364,352,127,133,374
"2011","Sedgemoor 007A","E01029121","Total",1270,112,58,54,1158,30,226,207,268,62,156,209
"2011","Sedgemoor 007B","E01029122","Total",1397,129,72,57,1268,54,254,267,240,63,112,278
"2011","Sedgemoor 007C","E01029123","Total",1062,173,117,56,889,33,162,201,162,87,85,159
"2011","Sedgemoor 007D","E01029124","Total",1723,242,153,89,1481,58,342,296,302,116,112,255
"2011","Sedgemoor 007E","E01029125","Total",1367,130,69,61,1237,26,248,274,232,79,137,241
"2011","Sedgemoor 008A","E01029093","Total",1597,236,73,163,1361,152,120,405,318,71,104,191
"2011","Sedgemoor 008B","E01029096","Total",1435,155,61,94,1280,114,118,352,250,60,140,246
"2011","Sedgemoor 008C","E01029106","Total",1579,152,57,95,1427,193,156,197,220,190,232,239
"2011","Sedgemoor 008D","E01029107","Total",1502,177,99,78,1325,109,210,258,210,120,151,267
"2011","Sedgemoor 008E","E01029109","Total",1405,120,54,66,1285,126,94,277,178,151,217,242
"2011","Sedgemoor 009A","E01029094","Total",1617,230,52,178,1387,130,134,321,324,86,155,237
"2011","Sedgemoor 009B","E01029095","Total",1539,305,95,210,1234,124,98,277,304,59,113,259
"2011","Sedgemoor 009C","E01029110","Total",2151,381,104,277,1770,135,152,440,420,145,155,323
"2011","Sedgemoor 009D","E01029111","Total",2520,216,75,141,2304,184,168,662,426,227,300,337
"2011","Sedgemoor 009E","E01029112","Total",1828,492,191,301,1336,87,210,220,380,36,97,306
"2011","Sedgemoor 010A","E01029090","Total",1525,179,92,87,1346,68,190,320,286,83,153,246
"2011","Sedgemoor 010B","E01029091","Total",1627,239,60,179,1388,82,112,432,390,72,102,198
"2011","Sedgemoor 010C","E01029092","Total",1546,145,36,109,1401,75,114,338,280,100,205,289
"2011","Sedgemoor 010D","E01029108","Total",2074,283,136,147,1791,97,350,391,404,87,146,316
"2011","Sedgemoor 011A","E01029102","Total",1476,186,89,97,1290,76,164,284,246,61,182,277
"2011","Sedgemoor 011B","E01029103","Total",1476,153,106,47,1323,33,302,299,226,64,136,263
"2011","Sedgemoor 011C","E01029104","Total",1523,148,98,50,1375,33,226,333,218,91,167,307
"2011","Sedgemoor 011E","E01032631","Total",1351,124,30,94,1227,119,80,404,250,111,120,143
"2011","Sedgemoor 011F","E01032632","Total",1265,93,52,41,1172,33,142,299,232,93,135,238
"2011","Sedgemoor 011G","E01032634","Total",1221,110,60,50,1111,15,230,224,206,71,154,211
"2011","Sedgemoor 012A","E01029130","Total",2050,193,103,90,1857,48,350,402,384,97,150,426
"2011","Sedgemoor 012B","E01029137","Total",1548,125,70,55,1423,25,284,254,284,99,176,301
"2011","Sedgemoor 012C","E01029138","Total",1425,141,85,56,1284,52,212,313,234,82,154,237
"2011","Sedgemoor 012D","E01029139","Total",1482,141,80,61,1341,37,262,274,212,93,203,260
"2011","Sedgemoor 012E","E01029150","Total",1266,92,51,41,1174,20,228,227,244,64,148,243
"2011","Sedgemoor 012F","E01029151","Total",1262,140,87,53,1122,46,304,214,198,55,91,214
"2011","Sedgemoor 013A","E01029097","Total",1430,173,57,116,1257,167,100,355,222,95,142,176
"2011","Sedgemoor 013B","E01029098","Total",1379,251,75,176,1128,68,130,248,236,72,142,232
"2011","Sedgemoor 013C","E01029099","Total",1281,137,74,63,1144,51,140,247,192,155,146,213
"2011","Sedgemoor 013D","E01029100","Total",1362,102,36,66,1260,122,84,214,194,183,232,231
"2011","Sedgemoor 013E","E01029105","Total",1453,338,210,128,1115,92,170,248,194,118,104,189
"2011","Sedgemoor 014A","E01029101","Total",1137,109,47,62,1028,82,148,234,176,95,101,192
"2011","Sedgemoor 014C","E01029142","Total",1469,169,97,72,1300,47,300,270,226,115,94,248
"2011","Sedgemoor 014D","E01029143","Total",1383,204,127,77,1179,85,232,226,218,77,128,213
"2011","Sedgemoor 014E","E01029144","Total",1255,108,53,55,1147,24,176,245,194,72,158,278
"2011","Sedgemoor 014F","E01032629","Total",1498,134,60,74,1364,94,168,305,338,114,82,263
"2011","Sedgemoor 014G","E01032630","Total",1594,106,19,87,1488,87,88,474,362,117,158,202
"2011","South Somerset 001A","E01029157","Total",1188,227,128,99,961,70,156,222,224,61,103,125
"2011","South Somerset 001B","E01029158","Total",1325,101,39,62,1224,76,176,322,170,133,172,175
"2011","South Somerset 001C","E01029221","Total",2331,271,134,137,2060,75,424,423,426,147,214,351
"2011","South Somerset 002A","E01029166","Total",2268,236,125,111,2032,60,408,373,368,167,267,389
"2011","South Somerset 002B","E01029167","Total",1535,303,166,137,1232,107,202,249,222,113,106,233
"2011","South Somerset 002C","E01029168","Total",1581,254,158,96,1327,76,302,282,242,91,106,228
"2011","South Somerset 002D","E01029210","Total",1581,134,71,63,1447,46,230,330,258,99,161,323
"2011","South Somerset 002E","E01029211","Total",1376,138,80,58,1238,35,252,279,264,86,87,235
"2011","South Somerset 003A","E01029224","Total",1604,178,105,73,1426,31,328,230,286,77,168,306
"2011","South Somerset 003B","E01029225","Total",2107,258,139,119,1849,108,394,394,332,124,169,328
"2011","South Somerset 003C","E01029226","Total",1643,324,181,143,1319,103,298,270,226,89,125,208
"2011","South Somerset 004A","E01029200","Total",1365,237,104,133,1128,58,182,240,236,64,166,182
"2011","South Somerset 004B","E01029201","Total",1382,175,89,86,1207,76,264,200,206,67,140,254
"2011","South Somerset 004C","E01029222","Total",1621,138,86,52,1483,54,230,315,290,156,165,273
"2011","South Somerset 004D","E01029223","Total",1204,114,65,49,1090,36,258,211,196,68,91,230
"2011","South Somerset 005A","E01029155","Total",1726,199,110,89,1527,18,436,265,344,57,123,284
"2011","South Somerset 005B","E01029227","Total",1565,173,103,70,1392,78,204,298,278,120,175,239
"2011","South Somerset 005C","E01029228","Total",1642,183,114,69,1459,92,246,363,360,97,128,173
"2011","South Somerset 005D","E01029229","Total",1992,369,179,190,1623,95,214,381,400,97,205,231
"2011","South Somerset 006A","E01029164","Total",1416,187,121,66,1229,29,254,255,198,116,167,210
"2011","South Somerset 006B","E01029165","Total",1197,125,74,51,1072,44,274,193,222,70,115,154
"2011","South Somerset 006C","E01029198","Total",1306,90,28,62,1216,65,52,489,250,136,142,82
"2011","South Somerset 006D","E01029199","Total",1990,249,116,133,1741,98,302,327,358,73,118,465
"2011","South Somerset 007A","E01029187","Total",1005,120,80,40,885,56,180,196,168,53,73,159
"2011","South Somerset 007B","E01029188","Total",1501,160,117,43,1341,36,336,282,246,82,124,235
"2011","South Somerset 007C","E01029196","Total",1499,145,90,55,1354,65,248,296,238,107,116,284
"2011","South Somerset 007D","E01029197","Total",1273,135,82,53,1138,29,198,262,232,73,118,226
"2011","South Somerset 008A","E01029154","Total",1814,192,70,122,1622,79,288,359,314,112,149,321
"2011","South Somerset 008B","E01029156","Total",1834,235,107,128,1599,93,286,359,346,114,126,275
"2011","South Somerset 008C","E01029206","Total",1462,213,125,88,1249,67,198,224,232,87,153,288
"2011","South Somerset 008D","E01029207","Total",1340,192,87,105,1148,48,226,218,252,92,110,202
"2011","South Somerset 009A","E01029202","Total",1177,203,115,88,974,49,180,188,210,41,142,164
"2011","South Somerset 009B","E01029203","Total",1515,155,77,78,1360,32,254,279,286,110,126,273
"2011","South Somerset 009C","E01029204","Total",1204,144,76,68,1060,39,250,258,198,65,84,166
"2011","South Somerset 009D","E01029205","Total",1781,217,97,120,1564,88,224,367,278,128,188,291
"2011","South Somerset 010A","E01029163","Total",2211,238,130,108,1973,81,370,352,404,120,220,426
"2011","South Somerset 010B","E01029216","Total",1448,194,115,79,1254,36,314,202,256,108,137,201
"2011","South Somerset 010C","E01029217","Total",1514,194,105,89,1320,12,290,304,280,76,141,217
"2011","South Somerset 010D","E01029218","Total",1871,295,193,102,1576,134,342,357,310,103,107,223
"2011","South Somerset 011A","E01029238","Total",1542,181,79,102,1361,149,152,325,252,96,126,261
"2011","South Somerset 011B","E01029252","Total",1423,139,61,78,1284,42,190,371,264,71,102,244
"2011","South Somerset 011C","E01029253","Total",1525,216,85,131,1309,120,174,356,314,39,104,202
"2011","South Somerset 011D","E01029254","Total",1385,139,97,42,1246,29,320,234,220,85,127,231
"2011","South Somerset 012A","E01029160","Total",2590,171,27,144,2419,116,136,888,472,206,266,335
"2011","South Somerset 012B","E01029248","Total",1584,165,82,83,1419,105,144,345,252,127,183,263
"2011","South Somerset 012C","E01029250","Total",1300,131,72,59,1169,20,264,215,204,79,132,255
"2011","South Somerset 012D","E01029251","Total",1290,135,79,56,1155,23,286,224,212,49,137,224
"2011","South Somerset 013A","E01029161","Total",1597,166,34,132,1431,110,76,398,326,86,161,274
"2011","South Somerset 013B","E01029162","Total",1438,324,108,216,1114,43,150,293,368,51,64,145
"2011","South Somerset 013C","E01029247","Total",1627,174,66,108,1453,183,98,372,168,205,197,230
"2011","South Somerset 013D","E01029255","Total",1395,151,84,67,1244,55,210,365,240,55,99,220
"2011","South Somerset 014A","E01029231","Total",1553,217,92,125,1336,87,176,302,250,116,113,292
"2011","South Somerset 014B","E01029233","Total",1388,174,67,107,1214,104,130,294,168,127,156,235
"2011","South Somerset 014C","E01029235","Total",1405,206,96,110,1199,83,210,243,198,111,157,197
"2011","South Somerset 014D","E01029236","Total",1519,197,77,120,1322,162,138,290,164,161,191,216
"2011","South Somerset 014E","E01029237","Total",1465,227,107,120,1238,155,140,299,228,52,138,226
"2011","South Somerset 015A","E01029232","Total",1493,193,43,150,1300,98,60,402,260,47,180,253
"2011","South Somerset 015B","E01029234","Total",1743,536,176,360,1207,64,180,248,368,72,110,165
"2011","South Somerset 015C","E01029239","Total",1452,310,104,206,1142,110,128,276,200,108,117,203
"2011","South Somerset 015D","E01029240","Total",1515,173,48,125,1342,62,108,407,284,101,149,231
"2011","South Somerset 016A","E01029241","Total",1885,251,75,176,1634,135,120,533,362,114,140,230
"2011","South Somerset 016B","E01029245","Total",2206,238,87,151,1968,86,262,549,398,140,191,342
"2011","South Somerset 016C","E01029246","Total",1396,180,89,91,1216,28,234,252,228,79,124,271
"2011","South Somerset 016D","E01029249","Total",1351,224,129,95,1127,113,196,244,186,40,120,228
"2011","South Somerset 017A","E01029189","Total",1150,140,87,53,1010,57,166,241,146,79,123,198
"2011","South Somerset 017B","E01029190","Total",1242,187,104,83,1055,18,264,257,220,52,73,171
"2011","South Somerset 017C","E01029191","Total",1249,167,102,65,1082,60,214,276,180,59,114,179
"2011","South Somerset 017D","E01029192","Total",1462,180,77,103,1282,64,206,262,238,117,164,231
"2011","South Somerset 017E","E01029212","Total",1045,134,74,60,911,23,236,174,192,37,99,150
"2011","South Somerset 017F","E01029213","Total",1274,148,92,56,1126,27,248,269,194,76,128,184
"2011","South Somerset 017G","E01029214","Total",1154,110,52,58,1044,44,200,183,216,74,116,211
"2011","South Somerset 017H","E01029215","Total",1139,167,98,69,972,64,186,204,164,85,95,174
"2011","South Somerset 018A","E01029159","Total",1534,163,36,127,1371,37,112,468,324,66,179,185
"2011","South Somerset 018B","E01029242","Total",1488,174,52,122,1314,75,146,336,282,58,138,279
"2011","South Somerset 018C","E01029243","Total",1574,281,184,97,1293,34,354,203,256,56,116,274
"2011","South Somerset 018D","E01029244","Total",1507,130,54,76,1377,21,236,339,284,111,88,298
"2011","South Somerset 019A","E01029193","Total",1944,326,164,162,1618,148,302,345,330,115,136,242
"2011","South Somerset 019B","E01029194","Total",2475,291,150,141,2184,151,418,567,404,144,162,338
"2011","South Somerset 019C","E01029195","Total",1525,247,145,102,1278,70,272,316,212,53,108,247
"2011","South Somerset 019D","E01029208","Total",1089,140,97,43,949,57,194,199,210,45,78,166
"2011","South Somerset 019E","E01029209","Total",1298,126,80,46,1172,50,310,227,218,41,118,208
"2011","South Somerset 020A","E01029178","Total",1470,159,94,65,1311,21,324,255,250,82,116,263
"2011","South Somerset 020B","E01029179","Total",1115,147,73,74,968,50,202,203,202,76,94,141
"2011","South Somerset 020C","E01029180","Total",1404,125,78,47,1279,36,248,294,254,46,136,265
"2011","South Somerset 020D","E01029181","Total",1311,193,100,93,1118,49,268,210,260,62,89,180
"2011","South Somerset 021A","E01029182","Total",1460,144,85,59,1316,35,286,260,240,78,163,254
"2011","South Somerset 021B","E01029183","Total",1467,147,78,69,1320,72,208,293,238,106,201,202
"2011","South Somerset 021C","E01029184","Total",1773,243,121,122,1530,72,410,305,328,85,108,222
"2011","South Somerset 021D","E01029185","Total",1649,318,120,198,1331,77,236,327,338,58,147,148
"2011","South Somerset 021E","E01029186","Total",1433,320,192,128,1113,84,200,212,216,47,122,232
"2011","South Somerset 022A","E01029169","Total",1518,128,62,66,1390,93,222,308,278,94,165,230
"2011","South Somerset 022B","E01029172","Total",1496,146,89,57,1350,43,268,311,252,93,168,215
"2011","South Somerset 022C","E01029173","Total",1247,136,54,82,1111,111,128,320,212,62,139,139
"2011","South Somerset 022D","E01029176","Total",1239,163,84,79,1076,20,218,235,222,63,99,219
"2011","South Somerset 022E","E01029177","Total",1150,199,102,97,951,78,126,225,178,111,66,167
"2011","South Somerset 023A","E01029170","Total",1091,170,68,102,921,74,136,239,156,72,101,143
"2011","South Somerset 023B","E01029171","Total",2028,396,207,189,1632,64,322,359,320,61,126,380
"2011","South Somerset 023C","E01029174","Total",1067,157,107,50,910,36,252,123,168,56,77,198
"2011","South Somerset 023D","E01029175","Total",2097,356,175,181,1741,158,234,444,276,164,219,246
"2011","South Somerset 024A","E01029153","Total",2329,311,168,143,2018,59,470,376,438,132,137,406
"2011","South Somerset 024B","E01029219","Total",1443,122,71,51,1321,24,304,171,220,113,207,282
"2011","South Somerset 024C","E01029220","Total",1213,152,104,48,1061,32,214,204,190,77,134,210
"2011","South Somerset 024D","E01029230","Total",2293,235,138,97,2058,39,482,351,400,110,247,429
"2011","Taunton Deane 001A","E01029258","Total",1464,144,69,75,1320,68,212,336,238,65,138,263
"2011","Taunton Deane 001B","E01029259","Total",1426,190,108,82,1236,63,200,326,184,95,134,234
"2011","Taunton Deane 001C","E01029260","Total",2309,174,56,118,2135,166,142,795,334,255,187,256
"2011","Taunton Deane 001D","E01029268","Total",1566,153,72,81,1413,54,288,324,252,94,158,243
"2011","Taunton Deane 002A","E01029276","Total",1273,200,105,95,1073,15,200,246,214,73,126,199
"2011","Taunton Deane 002B","E01029278","Total",1299,127,67,60,1172,25,254,220,198,85,163,227
"2011","Taunton Deane 002C","E01029290","Total",1415,192,80,112,1223,70,170,276,278,55,149,225
"2011","Taunton Deane 002D","E01029306","Total",1490,146,102,44,1344,31,266,291,246,62,216,232
"2011","Taunton Deane 002E","E01029319","Total",1517,98,18,80,1419,99,64,490,338,84,147,197
"2011","Taunton Deane 003A","E01029267","Total",1696,243,134,109,1453,76,288,318,186,127,189,269
"2011","Taunton Deane 003B","E01029320","Total",1532,238,109,129,1294,104,204,273,264,103,129,217
"2011","Taunton Deane 003C","E01029321","Total",2291,253,132,121,2038,94,388,408,356,140,237,415
"2011","Taunton Deane 004A","E01029297","Total",1266,243,124,119,1023,104,128,172,218,42,172,187
"2011","Taunton Deane 004B","E01029298","Total",1498,168,92,76,1330,113,154,335,192,129,167,240
"2011","Taunton Deane 004C","E01029304","Total",1516,227,125,102,1289,118,150,226,216,134,179,266
"2011","Taunton Deane 004D","E01029305","Total",1389,171,83,88,1218,81,196,288,184,57,123,289
"2011","Taunton Deane 004E","E01029307","Total",1456,211,110,101,1245,110,160,303,128,156,165,223
"2011","Taunton Deane 005A","E01029271","Total",1756,218,128,90,1538,38,310,381,306,68,159,276
"2011","Taunton Deane 005B","E01029273","Total",1243,123,76,47,1120,65,196,276,152,142,114,175
"2011","Taunton Deane 005C","E01029274","Total",1492,159,105,54,1333,42,308,255,258,61,139,270
"2011","Taunton Deane 005D","E01029275","Total",1228,175,117,58,1053,46,266,175,186,51,125,204
"2011","Taunton Deane 005E","E01029279","Total",1445,143,81,62,1302,63,220,372,230,68,120,229
"2011","Taunton Deane 006A","E01029282","Total",1385,208,44,164,1177,77,66,398,352,43,76,165
"2011","Taunton Deane 006B","E01029291","Total",1559,285,104,181,1274,151,208,212,310,85,75,233
"2011","Taunton Deane 006C","E01029294","Total",1766,170,59,111,1596,116,138,492,310,67,161,312
"2011","Taunton Deane 006D","E01029317","Total",1263,146,81,65,1117,53,154,313,168,72,133,224
"2011","Taunton Deane 006E","E01029318","Total",1479,150,88,62,1329,26,284,307,234,44,132,302
"2011","Taunton Deane 007A","E01029285","Total",2339,350,86,264,1989,107,124,497,602,81,141,437
"2011","Taunton Deane 007B","E01029287","Total",1503,219,34,185,1284,95,58,350,374,20,141,246
"2011","Taunton Deane 007C","E01029288","Total",1493,208,74,134,1285,63,162,419,254,75,104,208
"2011","Taunton Deane 007D","E01029289","Total",1845,370,139,231,1475,76,144,367,378,130,95,285
"2011","Taunton Deane 007E","E01029299","Total",1443,319,149,170,1124,74,160,213,262,62,124,229
"2011","Taunton Deane 007F","E01029300","Total",1550,177,56,121,1373,104,114,394,364,48,136,213
"2011","Taunton Deane 008A","E01029256","Total",1373,193,118,75,1180,31,276,227,228,72,131,215
"2011","Taunton Deane 008B","E01029257","Total",2065,230,133,97,1835,142,274,412,318,116,212,361
"2011","Taunton Deane 008D","E01029277","Total",1038,148,49,99,890,84,94,292,210,21,59,130
"2011","Taunton Deane 008E","E01032651","Total",1264,109,33,76,1155,39,154,277,324,56,94,211
"2011","Taunton Deane 008F","E01032652","Total",1160,122,44,78,1038,76,160,270,212,64,105,151
"2011","Taunton Deane 009A","E01029280","Total",1613,230,109,121,1383,132,166,314,230,91,179,271
"2011","Taunton Deane 009B","E01029281","Total",1636,275,93,182,1361,93,170,320,292,42,190,254
"2011","Taunton Deane 009C","E01029283","Total",1776,208,82,126,1568,110,178,369,366,80,149,316
"2011","Taunton Deane 009D","E01029292","Total",1391,234,90,144,1157,186,114,204,210,86,142,215
"2011","Taunton Deane 009E","E01029293","Total",1648,146,59,87,1502,332,64,380,146,239,163,178
"2011","Taunton Deane 010A","E01029266","Total",1167,231,134,97,936,69,202,188,222,21,65,169
"2011","Taunton Deane 010B","E01029284","Total",1473,473,188,285,1000,49,156,143,386,20,41,205
"2011","Taunton Deane 010C","E01029286","Total",1550,253,82,171,1297,113,72,392,334,38,146,202
"2011","Taunton Deane 010D","E01029301","Total",1874,493,273,220,1381,61,324,308,320,66,109,193
"2011","Taunton Deane 010E","E01029303","Total",1834,242,176,66,1592,46,446,378,262,94,115,251
"2011","Taunton Deane 011A","E01029263","Total",1404,156,65,91,1248,67,154,385,244,60,123,215
"2011","Taunton Deane 011B","E01029264","Total",1294,153,109,44,1141,28,290,233,204,88,101,197
"2011","Taunton Deane 011C","E01029265","Total",1390,164,90,74,1226,27,288,233,198,71,113,296
"2011","Taunton Deane 011D","E01029302","Total",1641,229,168,61,1412,35,312,321,182,118,148,296
"2011","Taunton Deane 011E","E01029308","Total",1988,251,176,75,1737,50,414,423,238,148,205,259
"2011","Taunton Deane 012A","E01029309","Total",1996,311,139,172,1685,179,202,400,334,134,134,302
"2011","Taunton Deane 012B","E01029311","Total",1406,194,108,86,1212,109,172,242,180,77,207,225
"2011","Taunton Deane 012C","E01029312","Total",1420,181,109,72,1239,62,150,309,222,108,139,249
"2011","Taunton Deane 012D","E01029313","Total",1346,168,51,117,1178,65,118,369,214,102,136,174
"2011","Taunton Deane 012E","E01029316","Total",1562,337,178,159,1225,88,202,329,244,62,99,201
"2011","Taunton Deane 013A","E01029262","Total",2309,222,134,88,2087,41,380,402,454,122,279,409
"2011","Taunton Deane 013B","E01029269","Total",2019,202,98,104,1817,50,318,378,414,105,197,355
"2011","Taunton Deane 013C","E01029310","Total",1761,197,139,58,1564,37,438,317,274,73,131,294
"2011","Taunton Deane 013D","E01029314","Total",2575,279,118,161,2296,198,306,561,376,200,251,404
"2011","Taunton Deane 013E","E01029315","Total",1452,179,130,49,1273,51,322,291,196,83,118,212
"2011","Taunton Deane 014A","E01029261","Total",2063,181,95,86,1882,28,356,357,372,139,244,386
"2011","Taunton Deane 014B","E01029270","Total",2104,234,122,112,1870,44,380,348,420,127,210,341
"2011","Taunton Deane 014C","E01029295","Total",1628,176,68,108,1452,40,242,343,318,58,189,262
"2011","Taunton Deane 014D","E01029296","Total",1440,182,121,61,1258,16,248,315,216,73,134,256
"2011","West Somerset 001B","E01029324","Total",1603,216,124,92,1387,74,202,310,246,144,143,268
"2011","West Somerset 001C","E01029329","Total",1551,315,185,130,1236,52,238,249,162,79,209,247
"2011","West Somerset 001D","E01029330","Total",1875,405,219,186,1470,58,478,171,322,73,126,242
"2011","West Somerset 001F","E01032636","Total",1898,360,221,139,1538,77,340,306,310,97,160,248
"2011","West Somerset 002A","E01029322","Total",1326,214,118,96,1112,72,258,197,226,101,128,130
"2011","West Somerset 002B","E01029331","Total",1410,241,179,62,1169,37,488,142,196,37,87,182
"2011","West Somerset 002C","E01029333","Total",1171,204,102,102,967,62,224,253,158,66,66,138
"2011","West Somerset 002D","E01029336","Total",2026,329,215,114,1697,43,492,289,354,115,126,278
"2011","West Somerset 003A","E01029326","Total",1158,174,112,62,984,21,260,138,196,42,117,210
"2011","West Somerset 003B","E01029334","Total",1111,182,100,82,929,37,260,140,186,62,92,152
"2011","West Somerset 003C","E01029339","Total",1498,232,116,116,1266,92,176,227,254,119,153,245
"2011","West Somerset 003E","E01029341","Total",1291,235,111,124,1056,55,232,224,188,39,128,190
"2011","West Somerset 003G","E01032635","Total",2096,251,141,110,1845,84,360,366,294,126,229,386
"2011","West Somerset 004A","E01029327","Total",2022,212,118,94,1810,33,414,303,414,163,177,306
"2011","West Somerset 004B","E01029335","Total",1085,134,71,63,951,52,220,158,230,25,73,193
"2011","West Somerset 004C","E01029337","Total",2116,242,144,98,1874,59,444,295,388,140,223,325
"2011","West Somerset 004D","E01029342","Total",1080,170,106,64,910,2,332,140,164,42,65,165
"2011","West Somerset 004E","E01029343","Total",1502,213,134,79,1289,53,284,204,274,114,146,214
"2011","West Somerset 005A","E01029325","Total",1811,301,181,120,1510,22,450,224,318,69,161,266
"2011","West Somerset 005B","E01029328","Total",1917,387,252,135,1530,61,422,270,308,62,138,269
"2011","West Somerset 005C","E01029338","Total",1735,195,92,103,1540,54,352,222,308,95,153,356
"2011","Isle of Anglesey 001A","W01000003","Total",2478,430,193,237,2048,130,294,432,316,156,260,460
"2011","Isle of Anglesey 001B","W01000004","Total",1282,154,94,60,1128,63,266,172,166,72,179,210
"2011","Isle of Anglesey 001C","W01000018","Total",1357,235,120,115,1122,89,252,208,188,66,121,198
"2011","Isle of Anglesey 001D","W01000028","Total",1937,220,91,129,1717,87,246,366,306,135,215,362
"2011","Isle of Anglesey 001E","W01000031","Total",1543,195,90,105,1348,47,226,299,212,104,114,346
"2011","Isle of Anglesey 002A","W01000010","Total",1866,318,186,132,1548,65,430,267,266,77,158,285
"2011","Isle of Anglesey 002B","W01000020","Total",1313,156,98,58,1157,27,222,153,200,94,158,303
"2011","Isle of Anglesey 002C","W01000021","Total",2237,273,153,120,1964,63,392,357,332,84,273,463
"2011","Isle of Anglesey 002D","W01000032","Total",1064,161,98,63,903,49,234,122,148,62,111,177
"2011","Isle of Anglesey 003A","W01000016","Total",1203,259,60,199,944,116,90,201,166,65,133,173
"2011","Isle of Anglesey 003B","W01000017","Total",1525,193,73,120,1332,92,152,281,236,112,190,269
"2011","Isle of Anglesey 003C","W01000029","Total",1493,296,135,161,1197,140,146,273,222,131,66,219
"2011","Isle of Anglesey 003D","W01000030","Total",2258,347,121,226,1911,253,218,453,294,104,225,364
"2011","Isle of Anglesey 003E","W01000033","Total",1490,284,122,162,1206,132,164,259,192,69,173,217
"2011","Isle of Anglesey 003F","W01000036","Total",1088,232,85,147,856,92,90,176,140,62,134,162
"2011","Isle of Anglesey 003G","W01000037","Total",1150,190,73,117,960,35,162,217,132,89,123,202
"2011","Isle of Anglesey 004A","W01000022","Total",1648,183,103,80,1465,47,264,221,286,163,198,286
"2011","Isle of Anglesey 004B","W01000034","Total",1154,156,78,78,998,57,190,250,182,51,77,191
"2011","Isle of Anglesey 004C","W01000039","Total",1034,142,85,57,892,24,224,182,154,40,58,210
"2011","Isle of Anglesey 004D","W01000040","Total",1130,178,101,77,952,42,264,137,174,36,125,174
"2011","Isle of Anglesey 004E","W01000043","Total",1205,172,91,81,1033,66,178,217,158,92,119,203
"2011","Isle of Anglesey 004F","W01000044","Total",1144,133,67,66,1011,22,224,181,178,71,146,189
"2011","Isle of Anglesey 005A","W01000005","Total",1936,387,189,198,1549,93,396,260,334,112,116,238
"2011","Isle of Anglesey 005B","W01000013","Total",2230,237,136,101,1993,70,396,407,322,171,174,453
"2011","Isle of Anglesey 005C","W01000019","Total",1454,219,120,99,1235,38,394,147,220,59,171,206
"2011","Isle of Anglesey 005D","W01000026","Total",1192,207,116,91,985,28,266,173,190,56,71,201
"2011","Isle of Anglesey 005E","W01000035","Total",1854,245,116,129,1609,43,274,365,278,120,188,341
"2011","Isle of Anglesey 006A","W01000006","Total",1534,186,86,100,1348,46,214,236,232,114,128,378
"2011","Isle of Anglesey 006B","W01000012","Total",1484,212,128,84,1272,37,262,301,216,83,94,279
"2011","Isle of Anglesey 006C","W01000014","Total",2040,276,146,130,1764,101,222,504,328,110,172,327
"2011","Isle of Anglesey 006D","W01000041","Total",1561,199,97,102,1362,232,100,264,176,183,146,261
"2011","Isle of Anglesey 007A","W01000001","Total",1099,229,119,110,870,37,210,149,172,34,73,195
"2011","Isle of Anglesey 007B","W01000002","Total",1263,182,88,94,1081,42,190,227,176,76,139,231
"2011","Isle of Anglesey 007C","W01000009","Total",1871,219,103,116,1652,94,232,281,284,158,270,333
"2011","Isle of Anglesey 007D","W01000023","Total",1405,176,85,91,1229,61,178,254,216,93,119,308
"2011","Isle of Anglesey 007E","W01000024","Total",1373,104,29,75,1269,92,66,501,206,176,126,102
"2011","Isle of Anglesey 008A","W01000008","Total",1461,169,81,88,1292,53,226,345,196,56,132,284
"2011","Isle of Anglesey 008B","W01000011","Total",1221,263,145,118,958,45,134,152,220,16,88,303
"2011","Isle of Anglesey 008C","W01000015","Total",1518,173,103,70,1345,63,266,245,230,81,160,300
"2011","Isle of Anglesey 008D","W01000042","Total",2140,286,135,151,1854,82,232,467,292,137,185,459
"2011","Isle of Anglesey 009A","W01000007","Total",1666,212,92,120,1454,62,238,275,262,82,176,359
"2011","Isle of Anglesey 009B","W01000025","Total",2016,239,112,127,1777,75,272,425,320,89,192,404
"2011","Isle of Anglesey 009C","W01000027","Total",1798,245,92,153,1553,67,240,381,246,116,151,352
"2011","Isle of Anglesey 009D","W01000038","Total",2226,316,167,149,1910,103,354,355,308,138,226,426
"2011","Gwynedd 001A","W01000062","Total",1492,185,45,140,1307,24,40,82,216,124,59,762
"2011","Gwynedd 001B","W01000076","Total",1044,165,60,105,879,27,98,107,138,47,95,367
"2011","Gwynedd 001C","W01000077","Total",1387,216,92,124,1171,77,108,139,182,38,76,551
"2011","Gwynedd 001D","W01000091","Total",1140,208,51,157,932,137,70,157,142,79,104,243
"2011","Gwynedd 001E","W01000092","Total",2147,212,77,135,1935,7,80,89,192,33,154,1380
"2011","Gwynedd 002A","W01000064","Total",1849,152,77,75,1697,86,190,358,220,211,234,398
"2011","Gwynedd 002B","W01000072","Total",1777,199,107,92,1578,72,228,263,186,98,277,454
"2011","Gwynedd 002C","W01000075","Total",1490,200,94,106,1290,107,100,261,212,45,138,427
"2011","Gwynedd 002D","W01000090","Total",1399,125,59,66,1274,183,110,246,142,137,210,246
"2011","Gwynedd 002E","W01000102","Total",1150,156,62,94,994,15,124,258,140,92,130,235
"2011","Gwynedd 003A","W01000050","Total",1386,166,83,83,1220,71,152,234,238,131,166,228
"2011","Gwynedd 003B","W01000071","Total",2380,361,110,251,2019,145,158,545,336,189,250,396
"2011","Gwynedd 003C","W01000096","Total",1222,145,67,78,1077,94,138,293,162,75,102,213
"2011","Gwynedd 003D","W01000097","Total",1110,204,68,136,906,71,104,194,222,64,65,186
"2011","Gwynedd 003E","W01000115","Total",2214,237,98,139,1977,108,268,458,346,167,230,400
"2011","Gwynedd 004A","W01000052","Total",1171,106,56,50,1065,55,138,244,168,81,158,221
"2011","Gwynedd 004B","W01000053","Total",1215,150,53,97,1065,40,124,203,174,117,159,248
"2011","Gwynedd 004C","W01000087","Total",1901,197,108,89,1704,101,196,424,262,174,204,343
"2011","Gwynedd 004D","W01000119","Total",2212,358,133,225,1854,75,216,471,410,124,184,374
"2011","Gwynedd 005A","W01000063","Total",1899,259,113,146,1640,153,146,424,266,157,187,307
"2011","Gwynedd 005B","W01000081","Total",1965,332,157,175,1633,65,226,418,298,67,221,338
"2011","Gwynedd 005C","W01000099","Total",1768,207,91,116,1561,78,170,360,270,113,224,346
"2011","Gwynedd 005D","W01000103","Total",1233,167,71,96,1066,44,138,216,202,93,135,238
"2011","Gwynedd 006A","W01000059","Total",2036,393,149,244,1643,197,248,328,208,126,202,334
"2011","Gwynedd 006B","W01000093","Total",2135,417,199,218,1718,55,368,295,312,126,191,371
"2011","Gwynedd 006C","W01000098","Total",2316,276,102,174,2040,336,172,423,258,210,290,351
"2011","Gwynedd 006D","W01000110","Total",1506,136,66,70,1370,85,136,284,236,116,187,326
"2011","Gwynedd 007A","W01000054","Total",1117,136,73,63,981,47,172,227,144,51,139,201
"2011","Gwynedd 007B","W01000088","Total",1992,230,132,98,1762,89,238,451,280,152,191,361
"2011","Gwynedd 007C","W01000111","Total",1530,346,156,190,1184,118,140,279,220,63,141,223
"2011","Gwynedd 007D","W01000118","Total",1671,225,98,127,1446,83,200,296,252,175,162,278
"2011","Gwynedd 008A","W01000073","Total",1680,227,125,102,1453,55,236,354,264,79,164,301
"2011","Gwynedd 008B","W01000086","Total",2249,287,139,148,1962,127,304,346,334,214,243,394
"2011","Gwynedd 008C","W01000104","Total",1770,278,117,161,1492,139,248,252,220,135,197,301
"2011","Gwynedd 008D","W01000112","Total",1930,307,132,175,1623,122,218,348,324,178,199,234
"2011","Gwynedd 009A","W01000056","Total",1875,356,141,215,1519,135,190,331,250,108,217,288
"2011","Gwynedd 009B","W01000065","Total",1122,271,109,162,851,68,128,143,220,67,120,105
"2011","Gwynedd 009C","W01000113","Total",1851,304,138,166,1547,128,246,298,230,120,201,324
"2011","Gwynedd 009D","W01000114","Total",1594,244,118,126,1350,73,286,228,222,141,147,253
"2011","Gwynedd 010A","W01000066","Total",1204,155,81,74,1049,46,208,158,170,111,126,230
"2011","Gwynedd 010B","W01000100","Total",1046,162,72,90,884,56,164,158,130,89,114,173
"2011","Gwynedd 010C","W01000105","Total",1740,297,126,171,1443,124,216,271,208,185,154,285
"2011","Gwynedd 010D","W01000106","Total",1670,368,189,179,1302,26,410,236,242,46,112,230
"2011","Gwynedd 010E","W01000107","Total",1228,226,125,101,1002,62,194,222,164,37,113,210
"2011","Gwynedd 011A","W01000047","Total",1354,198,111,87,1156,50,192,212,178,138,138,248
"2011","Gwynedd 011B","W01000061","Total",1696,300,167,133,1396,47,354,220,212,123,159,281
"2011","Gwynedd 011C","W01000078","Total",1683,250,130,120,1433,86,178,298,226,95,212,338
"2011","Gwynedd 011D","W01000089","Total",2080,243,131,112,1837,55,294,319,288,241,285,355
"2011","Gwynedd 012A","W01000070","Total",1275,164,79,85,1111,19,210,194,164,121,134,269
"2011","Gwynedd 012B","W01000094","Total",1213,221,124,97,992,43,204,207,164,69,107,198
"2011","Gwynedd 012C","W01000095","Total",1372,225,111,114,1147,69,222,253,154,107,172,170
"2011","Gwynedd 012D","W01000108","Total",2185,432,178,254,1753,133,258,450,312,171,155,274
"2011","Gwynedd 012E","W01000109","Total",1851,349,166,183,1502,94,264,311,228,120,186,299
"2011","Gwynedd 013A","W01000069","Total",1515,292,184,108,1223,51,324,192,230,51,136,239
"2011","Gwynedd 013B","W01000074","Total",1929,363,177,186,1566,71,386,229,326,123,141,290
"2011","Gwynedd 013C","W01000079","Total",1079,208,124,84,871,36,240,137,150,61,124,123
"2011","Gwynedd 013D","W01000101","Total",1518,227,131,96,1291,116,192,262,200,130,177,214
"2011","Gwynedd 014C","W01000080","Total",1761,395,232,163,1366,67,388,225,276,51,158,201
"2011","Gwynedd 014D","W01000084","Total",1206,205,119,86,1001,55,220,153,162,78,132,201
"2011","Gwynedd 014E","W01001932","Total",2931,409,215,194,2522,83,374,429,380,278,412,566
"2011","Gwynedd 015A","W01000051","Total",1966,385,192,193,1581,108,250,331,266,114,189,323
"2011","Gwynedd 015B","W01000060","Total",1337,220,91,129,1117,95,182,236,240,62,125,177
"2011","Gwynedd 015C","W01000082","Total",1070,109,48,61,961,59,130,183,180,98,90,221
"2011","Gwynedd 015D","W01000083","Total",1286,184,77,107,1102,33,200,185,178,135,123,248
"2011","Gwynedd 016A","W01000048","Total",1348,233,139,94,1115,91,198,220,184,60,159,203
"2011","Gwynedd 016B","W01000049","Total",1122,327,105,222,795,94,112,143,190,80,70,106
"2011","Gwynedd 016C","W01000057","Total",1426,216,115,101,1210,28,240,203,208,89,156,286
"2011","Gwynedd 016D","W01000067","Total",1148,263,95,168,885,45,188,183,186,42,70,171
"2011","Gwynedd 016E","W01000068","Total",1440,289,162,127,1151,96,168,248,220,110,132,177
"2011","Gwynedd 017C","W01000085","Total",1981,368,176,192,1613,69,444,215,312,133,139,301
"2011","Gwynedd 017D","W01000116","Total",1639,357,211,146,1282,50,476,193,220,71,94,178
"2011","Gwynedd 017E","W01000117","Total",1523,297,152,145,1226,114,210,232,242,118,102,208
"2011","Gwynedd 017F","W01001933","Total",2227,471,240,231,1756,27,500,325,376,76,156,296
"2011","Conwy 001A","W01000132","Total",1397,311,113,198,1086,81,206,156,200,76,97,270
"2011","Conwy 001B","W01000146","Total",1945,465,117,348,1480,103,210,244,390,53,154,326
"2011","Conwy 001C","W01000147","Total",1436,336,207,129,1100,44,310,191,208,45,111,191
"2011","Conwy 001D","W01000169","Total",1713,469,219,250,1244,88,182,200,296,43,130,305
"2011","Conwy 001E","W01000186","Total",1656,379,222,157,1277,143,206,207,218,83,194,226
"2011","Conwy 002A","W01000133","Total",1809,312,215,97,1497,33,486,226,212,93,162,285
"2011","Conwy 002B","W01000168","Total",1775,237,115,122,1538,133,200,346,242,113,223,281
"2011","Conwy 002C","W01000187","Total",1561,216,61,155,1345,249,90,256,144,187,196,223
"2011","Conwy 002D","W01000188","Total",1736,225,140,85,1511,65,364,316,246,81,131,308
"2011","Conwy 003A","W01000154","Total",1331,194,121,73,1137,46,262,255,200,60,95,219
"2011","Conwy 003B","W01000173","Total",1425,205,100,105,1220,75,172,357,288,61,89,178
"2011","Conwy 003C","W01000174","Total",1694,216,137,79,1478,60,306,341,254,104,167,246
"2011","Conwy 003D","W01000175","Total",1632,248,185,63,1384,53,510,221,228,61,73,238
"2011","Conwy 004A","W01000155","Total",1390,256,152,104,1134,44,310,187,192,64,151,186
"2011","Conwy 004B","W01000156","Total",1496,386,251,135,1110,34,334,186,236,40,66,214
"2011","Conwy 004C","W01000157","Total",1465,335,159,176,1130,77,178,260,190,107,99,219
"2011","Conwy 004D","W01000158","Total",1571,272,199,73,1299,63,482,183,186,59,73,253
"2011","Conwy 005A","W01000149","Total",1474,206,125,81,1268,83,280,211,248,59,147,240
"2011","Conwy 005B","W01000150","Total",1509,161,91,70,1348,54,268,267,204,134,157,264
"2011","Conwy 005C","W01000151","Total",1589,148,69,79,1441,139,174,336,210,151,202,229
"2011","Conwy 005D","W01000152","Total",1446,167,93,74,1279,77,238,283,198,96,148,239
"2011","Conwy 005E","W01000184","Total",2322,323,177,146,1999,132,484,262,368,107,203,443
"2011","Conwy 006A","W01000135","Total",2042,343,232,111,1699,48,606,308,266,46,129,296
"2011","Conwy 006B","W01000136","Total",1810,321,154,167,1489,61,316,302,268,127,142,273
"2011","Conwy 006C","W01000165","Total",1927,254,161,93,1673,77,398,303,272,80,191,352
"2011","Conwy 006D","W01000166","Total",1911,237,123,114,1674,133,258,405,254,124,206,294
"2011","Conwy 007A","W01000139","Total",1680,215,115,100,1465,85,192,373,186,111,230,288
"2011","Conwy 007B","W01000143","Total",1543,198,79,119,1345,114,134,302,228,75,200,292
"2011","Conwy 007C","W01000144","Total",1482,331,79,252,1151,128,74,232,240,133,133,211
"2011","Conwy 007D","W01000182","Total",1724,489,222,267,1235,104,278,207,250,73,144,179
"2011","Conwy 008A","W01000138","Total",1826,349,186,163,1477,119,300,295,274,110,137,242
"2011","Conwy 008B","W01000145","Total",1256,193,84,109,1063,110,154,268,218,81,75,157
"2011","Conwy 008C","W01000180","Total",1598,116,57,59,1482,62,220,301,182,106,281,330
"2011","Conwy 008D","W01000181","Total",1556,132,43,89,1424,86,118,393,272,121,169,265
"2011","Conwy 008E","W01000183","Total",1263,228,124,104,1035,58,216,195,136,58,174,198
"2011","Conwy 009A","W01000126","Total",1695,224,95,129,1471,91,198,352,296,76,179,279
"2011","Conwy 009B","W01000127","Total",1354,162,64,98,1192,121,220,227,184,120,112,208
"2011","Conwy 009C","W01000128","Total",1463,272,132,140,1191,79,192,222,186,65,169,278
"2011","Conwy 009D","W01000153","Total",1537,222,112,110,1315,46,258,310,296,56,119,230
"2011","Conwy 009E","W01000163","Total",1337,115,32,83,1222,162,110,251,170,161,158,210
"2011","Conwy 009F","W01000164","Total",1406,126,43,83,1280,116,110,280,224,124,181,245
"2011","Conwy 010B","W01000140","Total",1464,215,115,100,1249,88,204,279,208,87,144,239
"2011","Conwy 010C","W01000141","Total",1534,285,222,63,1249,47,500,184,238,65,40,175
"2011","Conwy 010D","W01000142","Total",1583,189,135,54,1394,32,428,214,222,56,152,290
"2011","Conwy 010E","W01000178","Total",1847,318,155,163,1529,202,234,271,208,104,248,262
"2011","Conwy 010F","W01000179","Total",1584,262,168,94,1322,32,418,197,244,47,146,238
"2011","Conwy 010G","W01001927","Total",1317,151,87,64,1166,71,288,230,196,95,111,175
"2011","Conwy 010H","W01001928","Total",1115,275,107,168,840,60,228,131,248,41,29,103
"2011","Conwy 011C","W01000167","Total",1921,240,125,115,1681,143,256,359,284,156,168,315
"2011","Conwy 011D","W01000176","Total",1606,263,114,149,1343,116,132,351,212,81,173,278
"2011","Conwy 011E","W01000177","Total",1237,95,58,37,1142,79,194,208,168,65,125,303
"2011","Conwy 011F","W01001926","Total",2191,301,139,162,1890,87,432,364,364,93,173,377
"2011","Conwy 012A","W01000124","Total",2001,265,150,115,1736,57,386,346,288,97,195,367
"2011","Conwy 012B","W01000129","Total",1056,185,83,102,871,58,142,185,168,54,93,171
"2011","Conwy 012C","W01000130","Total",1527,311,131,180,1216,72,256,263,242,45,93,245
"2011","Conwy 012D","W01000131","Total",1458,168,90,78,1290,86,194,254,202,63,213,278
"2011","Conwy 013A","W01000123","Total",1702,252,115,137,1450,64,198,300,288,126,204,270
"2011","Conwy 013B","W01000125","Total",1481,236,151,85,1245,45,228,263,260,51,117,281
"2011","Conwy 013C","W01000170","Total",1811,221,104,117,1590,75,278,382,276,69,154,356
"2011","Conwy 013D","W01000171","Total",1546,248,97,151,1298,52,200,314,220,36,221,255
"2011","Conwy 013E","W01000172","Total",1283,212,73,139,1071,133,100,245,226,51,116,200
"2011","Conwy 014A","W01000122","Total",2093,245,115,130,1848,55,294,326,350,100,275,448
"2011","Conwy 014B","W01000159","Total",1391,144,64,80,1247,15,196,266,210,84,181,295
"2011","Conwy 014C","W01000162","Total",1925,198,88,110,1727,15,250,321,300,219,243,379
"2011","Conwy 014D","W01000190","Total",1386,178,86,92,1208,8,202,255,238,110,135,260
"2011","Conwy 015A","W01000121","Total",1202,187,81,106,1015,58,188,233,192,57,98,189
"2011","Conwy 015B","W01000134","Total",2065,373,204,169,1692,178,302,325,324,112,178,273
"2011","Conwy 015C","W01000137","Total",1532,162,76,86,1370,32,242,265,212,96,217,306
"2011","Conwy 015D","W01000148","Total",1203,126,48,78,1077,113,114,201,164,84,171,230
"2011","Conwy 015E","W01000185","Total",1228,188,85,103,1040,46,200,178,218,81,118,199
"2011","Conwy 015F","W01000189","Total",1460,210,77,133,1250,29,178,210,264,72,161,336
"2011","Denbighshire 001A","W01000218","Total",1536,242,128,114,1294,74,198,267,210,73,177,295
"2011","Denbighshire 001B","W01000219","Total",2566,287,149,138,2279,196,286,614,370,212,252,349
"2011","Denbighshire 001C","W01000220","Total",1604,341,235,106,1263,40,538,138,260,0,60,227
"2011","Denbighshire 002A","W01000213","Total",1343,210,127,83,1133,169,156,145,142,112,182,227
"2011","Denbighshire 002B","W01000214","Total",1170,131,66,65,1039,96,150,232,148,84,158,171
"2011","Denbighshire 002C","W01000215","Total",1423,139,98,41,1284,28,284,255,166,84,190,277
"2011","Denbighshire 002D","W01000216","Total",1381,163,64,99,1218,80,138,310,188,76,155,271
"2011","Denbighshire 003A","W01000212","Total",2164,242,155,87,1922,72,404,378,302,103,254,409
"2011","Denbighshire 003B","W01000221","Total",1348,254,126,128,1094,119,238,210,216,60,66,185
"2011","Denbighshire 003C","W01000222","Total",1660,286,184,102,1374,51,352,234,250,62,156,269
"2011","Denbighshire 004A","W01000226","Total",1515,234,136,98,1281,63,344,180,220,73,186,215
"2011","Denbighshire 004B","W01000227","Total",1556,288,187,101,1268,75,290,223,174,65,178,263
"2011","Denbighshire 004C","W01000228","Total",1116,220,82,138,896,79,172,100,154,92,121,178
"2011","Denbighshire 004D","W01000239","Total",1780,473,109,364,1307,131,130,262,226,125,227,206
"2011","Denbighshire 004E","W01000240","Total",1274,429,89,340,845,130,52,113,208,65,152,125
"2011","Denbighshire 004F","W01000241","Total",1289,146,46,100,1143,129,90,176,144,127,281,196
"2011","Denbighshire 006A","W01000236","Total",1875,261,113,148,1614,234,138,277,226,156,277,306
"2011","Denbighshire 006B","W01000237","Total",1806,146,78,68,1660,254,98,270,190,275,297,276
"2011","Denbighshire 006C","W01000238","Total",1702,157,68,89,1545,104,140,315,236,146,267,337
"2011","Denbighshire 008A","W01000200","Total",1275,124,63,61,1151,50,164,271,224,83,135,224
"2011","Denbighshire 008B","W01000201","Total",1495,211,80,131,1284,121,166,392,204,109,102,190
"2011","Denbighshire 008C","W01000217","Total",2057,238,125,113,1819,152,302,337,294,204,211,319
"2011","Denbighshire 008D","W01000248","Total",1622,159,64,95,1463,35,218,318,298,103,191,300
"2011","Denbighshire 009A","W01000191","Total",2129,202,75,127,1927,142,260,474,386,157,165,343
"2011","Denbighshire 009B","W01000223","Total",1323,156,86,70,1167,47,218,256,230,36,145,235
"2011","Denbighshire 009C","W01000224","Total",1402,202,127,75,1200,56,224,192,176,100,166,286
"2011","Denbighshire 009D","W01000225","Total",1528,245,101,144,1283,113,234,352,228,52,104,200
"2011","Denbighshire 010A","W01000245","Total",1640,235,135,100,1405,57,260,336,266,92,130,264
"2011","Denbighshire 010B","W01000246","Total",1623,220,98,122,1403,58,232,327,270,104,170,242
"2011","Denbighshire 010C","W01000247","Total",1848,242,121,121,1606,77,324,300,270,126,173,336
"2011","Denbighshire 011A","W01000194","Total",1973,365,94,271,1608,160,188,371,354,76,156,303
"2011","Denbighshire 011B","W01000198","Total",1472,209,98,111,1263,182,130,265,218,160,85,223
"2011","Denbighshire 011C","W01000199","Total",1677,218,98,120,1459,90,194,283,260,100,168,364
"2011","Denbighshire 012A","W01000195","Total",1378,193,121,72,1185,40,266,256,192,53,133,245
"2011","Denbighshire 012B","W01000196","Total",1458,111,41,70,1347,59,94,321,290,116,186,281
"2011","Denbighshire 012C","W01000197","Total",1653,215,115,100,1438,45,174,359,240,144,170,306
"2011","Denbighshire 012D","W01000211","Total",1832,178,96,82,1654,42,276,320,302,135,212,367
"2011","Denbighshire 013A","W01000203","Total",2354,236,124,112,2118,46,358,451,436,170,265,392
"2011","Denbighshire 013B","W01000204","Total",1391,181,79,102,1210,23,270,202,228,73,137,277
"2011","Denbighshire 013C","W01000206","Total",2084,210,112,98,1874,58,308,440,324,174,218,352
"2011","Denbighshire 014A","W01000242","Total",1875,347,170,177,1528,137,222,339,278,94,233,225
"2011","Denbighshire 014B","W01000243","Total",1675,299,145,154,1376,105,234,332,272,83,112,238
"2011","Denbighshire 014C","W01000244","Total",1732,191,127,64,1541,42,302,430,254,100,130,283
"2011","Denbighshire 015A","W01000193","Total",1310,190,79,111,1120,60,134,229,208,84,142,263
"2011","Denbighshire 015B","W01000202","Total",1686,144,74,70,1542,45,222,369,248,176,163,319
"2011","Denbighshire 015C","W01000207","Total",2223,250,111,139,1973,57,324,396,408,103,248,437
"2011","Denbighshire 016A","W01000192","Total",980,142,66,76,838,38,172,171,168,37,58,194
"2011","Denbighshire 016B","W01000205","Total",1114,148,79,69,966,39,172,161,198,63,109,224
"2011","Denbighshire 016C","W01000208","Total",1160,229,74,155,931,42,154,169,206,30,130,200
"2011","Denbighshire 016D","W01000209","Total",1494,235,130,105,1259,75,222,198,228,96,173,267
"2011","Denbighshire 016E","W01000210","Total",1295,191,79,112,1104,55,260,216,214,41,84,234
"2011","Denbighshire 017E","W01000229","Total",1606,255,147,108,1351,98,326,197,302,106,58,264
"2011","Denbighshire 017F","W01000230","Total",1963,262,144,118,1701,71,400,351,274,42,176,387
"2011","Denbighshire 017A","W01000231","Total",1432,181,113,68,1251,75,192,272,204,76,171,261
"2011","Denbighshire 017B","W01000232","Total",1605,182,97,85,1423,79,210,317,262,120,153,282
"2011","Denbighshire 017C","W01000233","Total",1276,161,86,75,1115,49,206,233,230,40,143,214
"2011","Denbighshire 017G","W01000234","Total",1405,150,77,73,1255,174,114,280,186,82,182,237
"2011","Denbighshire 017D","W01000235","Total",1330,158,56,102,1172,80,130,316,202,51,157,236
"2011","Flintshire 001A","W01000287","Total",1794,294,143,151,1500,104,286,219,264,94,218,315
"2011","Flintshire 001B","W01000298","Total",1527,208,114,94,1319,56,238,236,244,156,140,249
"2011","Flintshire 001C","W01000338","Total",1838,212,116,96,1626,52,258,355,308,93,163,397
"2011","Flintshire 002A","W01000306","Total",2357,241,108,133,2116,159,268,400,408,188,284,409
"2011","Flintshire 002B","W01000320","Total",1827,210,124,86,1617,107,222,339,282,105,233,329
"2011","Flintshire 002C","W01000340","Total",2310,223,116,107,2087,82,342,459,400,136,198,470
"2011","Flintshire 003A","W01000253","Total",1941,196,94,102,1745,128,232,324,294,109,275,383
"2011","Flintshire 003B","W01000254","Total",2211,270,123,147,1941,231,222,422,308,117,258,383
"2011","Flintshire 003C","W01000296","Total",1490,214,87,127,1276,127,170,264,174,123,104,314
"2011","Flintshire 003D","W01000297","Total",1235,123,25,98,1112,137,56,319,204,98,88,210
"2011","Flintshire 003E","W01000304","Total",1963,364,178,186,1599,220,186,342,226,122,211,292
"2011","Flintshire 003F","W01000305","Total",1758,241,103,138,1517,103,186,339,260,98,176,355
"2011","Flintshire 004A","W01000288","Total",2264,402,192,210,1862,226,236,356,270,160,247,367
"2011","Flintshire 004B","W01000290","Total",1259,283,164,119,976,81,176,170,184,71,123,171
"2011","Flintshire 004C","W01000292","Total",1470,123,55,68,1347,157,104,273,166,131,225,291
"2011","Flintshire 004D","W01000293","Total",1568,193,73,120,1375,91,126,311,264,90,192,301
"2011","Flintshire 005A","W01000289","Total",1358,78,31,47,1280,64,122,279,176,66,223,350
"2011","Flintshire 005B","W01000291","Total",1401,131,38,93,1270,109,128,398,232,36,108,259
"2011","Flintshire 005C","W01000294","Total",1914,117,58,59,1797,54,192,425,294,118,198,516
"2011","Flintshire 005D","W01000295","Total",1582,137,73,64,1445,98,200,345,222,94,164,322
"2011","Flintshire 006A","W01000258","Total",2153,241,138,103,1912,60,340,347,376,105,252,432
"2011","Flintshire 006B","W01000270","Total",1286,113,52,61,1173,24,150,230,260,76,111,322
"2011","Flintshire 006C","W01000271","Total",1263,182,90,92,1081,51,178,238,218,84,86,226
"2011","Flintshire 006D","W01000272","Total",1852,157,88,69,1695,30,330,353,366,79,173,364
"2011","Flintshire 006E","W01000301","Total",1785,181,96,85,1604,68,214,318,308,72,211,413
"2011","Flintshire 007A","W01000273","Total",1585,163,76,87,1422,129,176,210,248,149,132,378
"2011","Flintshire 007B","W01000274","Total",1771,354,151,203,1417,173,148,292,236,164,165,239
"2011","Flintshire 007C","W01000275","Total",1253,116,52,64,1137,68,122,232,206,62,161,286
"2011","Flintshire 007D","W01000278","Total",1495,199,61,138,1296,193,74,288,190,116,173,262
"2011","Flintshire 008A","W01000276","Total",1393,84,8,76,1309,107,30,401,278,124,140,229
"2011","Flintshire 008B","W01000277","Total",1363,90,23,67,1273,60,84,381,278,85,126,259
"2011","Flintshire 008C","W01000279","Total",1231,121,69,52,1110,36,250,190,160,59,116,299
"2011","Flintshire 008D","W01000281","Total",1222,122,50,72,1100,67,162,241,236,36,141,217
"2011","Flintshire 008E","W01000283","Total",2259,237,106,131,2022,83,298,457,336,103,304,441
"2011","Flintshire 009A","W01000332","Total",1568,168,43,125,1400,87,136,336,314,120,154,253
"2011","Flintshire 009B","W01000333","Total",1428,206,99,107,1222,167,90,273,186,79,145,282
"2011","Flintshire 009C","W01000334","Total",1958,304,88,216,1654,122,208,328,296,97,222,381
"2011","Flintshire 009D","W01000335","Total",1084,189,103,86,895,61,126,139,148,88,140,193
"2011","Flintshire 009E","W01000336","Total",1465,169,94,75,1296,180,92,232,158,166,205,263
"2011","Flintshire 009F","W01000337","Total",2127,328,126,202,1799,107,228,405,344,102,216,397
"2011","Flintshire 010A","W01000252","Total",1619,170,107,63,1449,32,392,274,282,39,134,296
"2011","Flintshire 010B","W01000280","Total",1426,116,51,65,1310,53,164,308,268,59,161,297
"2011","Flintshire 010C","W01000282","Total",1742,42,7,35,1700,61,54,674,220,121,253,317
"2011","Flintshire 010D","W01000325","Total",1527,141,85,56,1386,48,236,291,300,74,149,288
"2011","Flintshire 011A","W01000311","Total",1782,222,123,99,1560,79,216,323,248,100,191,403
"2011","Flintshire 011B","W01000312","Total",1714,256,106,150,1458,109,236,345,276,72,177,243
"2011","Flintshire 011C","W01000328","Total",2109,310,121,189,1799,136,200,333,364,87,271,408
"2011","Flintshire 012A","W01000264","Total",1701,154,52,102,1547,92,136,396,230,184,219,290
"2011","Flintshire 012B","W01000265","Total",1312,173,82,91,1139,40,212,228,276,67,98,218
"2011","Flintshire 012C","W01000323","Total",1545,171,85,86,1374,59,246,322,258,105,84,300
"2011","Flintshire 012D","W01000324","Total",1504,126,60,66,1378,63,218,354,242,80,152,269
"2011","Flintshire 013A","W01000251","Total",1486,164,85,79,1322,105,122,296,192,83,203,321
"2011","Flintshire 013B","W01000268","Total",1767,141,85,56,1626,68,204,498,248,123,179,306
"2011","Flintshire 013C","W01000284","Total",1708,146,67,79,1562,43,188,479,258,99,198,297
"2011","Flintshire 013D","W01000285","Total",1464,112,56,56,1352,44,256,301,300,79,102,270
"2011","Flintshire 013E","W01000286","Total",2227,219,59,160,2008,60,148,735,386,148,231,300
"2011","Flintshire 013F","W01000302","Total",1860,242,154,88,1618,58,352,327,278,151,131,321
"2011","Flintshire 014A","W01000249","Total",1258,112,58,54,1146,68,148,274,230,46,123,257
"2011","Flintshire 014B","W01000250","Total",1578,148,86,62,1430,36,266,289,244,91,201,303
"2011","Flintshire 014C","W01000261","Total",1516,170,83,87,1346,69,202,266,250,90,137,332
"2011","Flintshire 014D","W01000321","Total",1659,141,69,72,1518,36,232,410,318,52,158,312
"2011","Flintshire 014E","W01000322","Total",1301,131,84,47,1170,46,232,257,256,72,102,205
"2011","Flintshire 015A","W01000255","Total",2292,234,126,108,2058,126,304,425,388,121,261,433
"2011","Flintshire 015B","W01000256","Total",1561,187,64,123,1374,121,104,358,310,84,163,234
"2011","Flintshire 015C","W01000257","Total",2121,212,86,126,1909,67,252,509,424,67,174,416
"2011","Flintshire 015D","W01000329","Total",1373,193,83,110,1180,173,104,271,226,73,121,212
"2011","Flintshire 015E","W01000330","Total",2150,286,125,161,1864,214,128,409,388,198,234,293
"2011","Flintshire 015F","W01000331","Total",1609,140,71,69,1469,58,120,320,312,32,262,365
"2011","Flintshire 016A","W01000313","Total",1566,181,97,84,1385,84,164,342,240,140,167,248
"2011","Flintshire 016B","W01000314","Total",1129,238,137,101,891,68,160,144,180,65,94,180
"2011","Flintshire 016C","W01000315","Total",1987,286,173,113,1701,146,340,315,296,98,207,299
"2011","Flintshire 016D","W01000316","Total",1282,116,68,48,1166,52,214,308,158,67,108,259
"2011","Flintshire 016E","W01000317","Total",1393,65,35,30,1328,27,164,374,216,112,121,314
"2011","Flintshire 016F","W01000318","Total",1172,124,71,53,1048,131,76,262,124,115,135,205
"2011","Flintshire 016G","W01000319","Total",1457,310,102,208,1147,41,180,316,260,68,121,161
"2011","Flintshire 017A","W01000259","Total",1581,293,136,157,1288,79,198,268,278,75,187,203
"2011","Flintshire 017B","W01000260","Total",1809,190,91,99,1619,94,240,387,306,55,222,315
"2011","Flintshire 017C","W01000262","Total",1490,210,79,131,1280,171,112,264,254,112,152,215
"2011","Flintshire 017D","W01000263","Total",1461,233,95,138,1228,115,102,228,198,129,164,292
"2011","Flintshire 017E","W01000266","Total",1320,186,84,102,1134,67,204,279,212,41,98,233
"2011","Flintshire 017F","W01000267","Total",1593,199,94,105,1394,76,224,376,264,94,108,252
"2011","Flintshire 018A","W01000303","Total",1697,126,63,63,1571,46,208,405,280,125,187,320
"2011","Flintshire 018B","W01000326","Total",1677,158,82,76,1519,53,222,367,286,89,171,331
"2011","Flintshire 018C","W01000327","Total",2177,192,81,111,1985,57,296,479,336,106,232,479
"2011","Flintshire 019A","W01000299","Total",1942,204,110,94,1738,54,392,339,330,94,185,344
"2011","Flintshire 019B","W01000300","Total",1718,200,98,102,1518,52,270,268,324,82,203,319
"2011","Flintshire 019C","W01000309","Total",2135,270,112,158,1865,133,226,433,330,107,263,373
"2011","Flintshire 019D","W01000339","Total",1627,172,83,89,1455,64,256,288,236,93,175,343
"2011","Flintshire 020A","W01000269","Total",1572,252,135,117,1320,120,218,256,252,53,143,278
"2011","Flintshire 020B","W01000307","Total",1313,108,49,59,1205,23,170,305,208,109,95,295
"2011","Flintshire 020C","W01000308","Total",1242,133,84,49,1109,62,148,270,176,67,140,246
"2011","Flintshire 020D","W01000310","Total",1820,188,93,95,1632,72,280,361,306,72,177,364
"2011","Wrexham 003A","W01000374","Total",1386,188,96,92,1198,76,168,239,212,103,164,236
"2011","Wrexham 003B","W01000375","Total",1997,222,73,149,1775,122,108,643,388,120,135,259
"2011","Wrexham 003C","W01000376","Total",1390,109,49,60,1281,64,172,349,230,45,136,285
"2011","Wrexham 003D","W01000391","Total",1425,153,71,82,1272,69,194,280,252,63,103,311
"2011","Wrexham 003E","W01000392","Total",1720,206,106,100,1514,150,142,357,212,187,196,270
"2011","Wrexham 004A","W01000377","Total",1520,133,46,87,1387,46,150,397,250,89,190,265
"2011","Wrexham 004B","W01000378","Total",1324,118,41,77,1206,186,108,290,190,116,166,150
"2011","Wrexham 004C","W01000379","Total",1589,250,105,145,1339,127,138,281,242,89,199,263
"2011","Wrexham 004D","W01000380","Total",1193,106,34,72,1087,28,88,285,260,49,144,233
"2011","Wrexham 005A","W01000351","Total",2140,217,94,123,1923,132,192,460,372,145,187,435
"2011","Wrexham 005B","W01000373","Total",1831,209,90,119,1622,194,166,394,214,98,223,333
"2011","Wrexham 005C","W01000400","Total",1657,240,91,149,1417,107,158,390,304,82,146,230
"2011","Wrexham 005D","W01000401","Total",1791,271,96,175,1520,118,136,437,292,110,221,206
"2011","Wrexham 006A","W01000347","Total",2480,282,61,221,2198,122,140,705,530,160,188,353
"2011","Wrexham 006B","W01000348","Total",1457,196,82,114,1261,180,132,299,182,108,170,190
"2011","Wrexham 006C","W01000362","Total",1529,164,74,90,1365,144,112,326,222,83,193,285
"2011","Wrexham 006D","W01000363","Total",1499,252,149,103,1247,80,178,321,218,66,107,277
"2011","Wrexham 006E","W01000364","Total",1626,195,75,120,1431,64,190,372,274,67,161,303
"2011","Wrexham 007A","W01000343","Total",1054,119,82,37,935,23,246,184,138,43,81,220
"2011","Wrexham 007B","W01000344","Total",1305,151,92,59,1154,22,306,257,214,35,87,233
"2011","Wrexham 007C","W01000415","Total",1484,213,123,90,1271,43,244,295,270,38,123,258
"2011","Wrexham 007D","W01000416","Total",1266,112,41,71,1154,23,106,271,246,72,141,295
"2011","Wrexham 008A","W01000368","Total",2036,267,151,116,1769,68,408,459,316,52,172,294
"2011","Wrexham 008B","W01000371","Total",1204,180,63,117,1024,49,88,238,214,55,91,289
"2011","Wrexham 008C","W01000372","Total",1198,263,93,170,935,59,98,179,232,56,62,249
"2011","Wrexham 008D","W01000387","Total",1257,103,56,47,1154,28,228,296,172,51,134,245
"2011","Wrexham 008E","W01000388","Total",1065,146,76,70,919,30,166,226,142,51,84,220
"2011","Wrexham 008F","W01000422","Total",2048,310,159,151,1738,100,334,377,316,54,184,373
"2011","Wrexham 009A","W01000341","Total",1582,213,116,97,1369,91,186,294,220,76,188,314
"2011","Wrexham 009B","W01000342","Total",1573,277,156,121,1296,127,180,279,212,70,160,268
"2011","Wrexham 009C","W01000393","Total",1950,237,135,102,1713,80,272,347,286,115,220,393
"2011","Wrexham 010A","W01000352","Total",944,116,56,60,828,76,128,159,118,27,140,180
"2011","Wrexham 010B","W01000353","Total",1386,178,55,123,1208,153,72,265,154,139,191,234
"2011","Wrexham 010C","W01000413","Total",1422,167,31,136,1255,319,68,252,100,201,168,147
"2011","Wrexham 010D","W01000414","Total",1263,134,51,83,1129,249,72,270,158,95,100,185
"2011","Wrexham 010E","W01000425","Total",2319,260,97,163,2059,347,158,444,210,213,280,407
"2011","Wrexham 011A","W01000349","Total",1840,290,89,201,1550,95,170,455,332,67,162,269
"2011","Wrexham 011B","W01000350","Total",1534,276,48,228,1258,112,66,257,290,42,111,380
"2011","Wrexham 011C","W01000365","Total",2097,178,87,91,1919,74,258,328,314,92,204,649
"2011","Wrexham 011D","W01000402","Total",2604,380,105,275,2224,134,156,459,474,79,221,701
"2011","Wrexham 012A","W01000381","Total",1126,234,118,116,892,49,124,184,146,32,140,217
"2011","Wrexham 012B","W01000382","Total",1075,267,72,195,808,94,62,174,158,71,67,182
"2011","Wrexham 012D","W01000423","Total",2232,240,48,192,1992,236,98,650,314,174,235,285
"2011","Wrexham 012E","W01000424","Total",1264,176,70,106,1088,67,106,231,232,56,108,288
"2011","Wrexham 012F","W01001929","Total",1285,226,81,145,1059,100,68,230,310,18,70,263
"2011","Wrexham 012G","W01001931","Total",1331,255,89,166,1076,96,114,194,254,27,127,264
"2011","Wrexham 013A","W01000398","Total",1314,174,68,106,1140,53,170,215,224,101,126,251
"2011","Wrexham 013B","W01000399","Total",1158,101,48,53,1057,10,158,240,216,78,155,200
"2011","Wrexham 013C","W01000406","Total",2205,230,93,137,1975,219,170,446,322,190,283,345
"2011","Wrexham 013D","W01000408","Total",1184,151,85,66,1033,67,124,258,204,96,119,165
"2011","Wrexham 014A","W01000366","Total",1454,195,94,101,1259,105,120,283,240,95,193,223
"2011","Wrexham 014B","W01000367","Total",1306,151,66,85,1155,43,106,349,222,77,115,243
"2011","Wrexham 014C","W01000385","Total",1750,174,76,98,1576,82,290,393,310,75,116,310
"2011","Wrexham 014D","W01000410","Total",1629,216,91,125,1413,84,214,377,278,85,118,257
"2011","Wrexham 015A","W01000386","Total",1516,233,87,146,1283,82,110,315,232,118,212,214
"2011","Wrexham 015B","W01000405","Total",2266,273,124,149,1993,263,174,450,296,193,275,342
"2011","Wrexham 015C","W01000411","Total",1582,357,169,188,1225,183,146,305,238,64,123,166
"2011","Wrexham 015D","W01000412","Total",1589,213,87,126,1376,79,166,378,288,44,162,259
"2011","Wrexham 016A","W01000394","Total",1275,113,42,71,1162,21,120,299,244,37,169,272
"2011","Wrexham 016B","W01000395","Total",1092,128,69,59,964,66,158,193,196,56,100,195
"2011","Wrexham 016C","W01000407","Total",1349,158,69,89,1191,31,196,330,280,66,96,192
"2011","Wrexham 016D","W01000419","Total",1511,189,78,111,1322,96,108,399,196,126,153,244
"2011","Wrexham 016E","W01000420","Total",1385,207,75,132,1178,88,154,291,246,64,104,231
"2011","Wrexham 017A","W01000354","Total",1712,177,89,88,1535,67,270,309,264,85,182,358
"2011","Wrexham 017B","W01000355","Total",1594,319,157,162,1275,100,186,226,246,126,139,252
"2011","Wrexham 017C","W01000356","Total",1709,136,64,72,1573,130,168,329,198,144,249,355
"2011","Wrexham 017D","W01000389","Total",2056,244,125,119,1812,89,276,490,310,103,208,336
"2011","Wrexham 017E","W01000409","Total",1977,253,89,164,1724,318,122,471,202,210,179,222
"2011","Wrexham 018A","W01000345","Total",1578,182,97,85,1396,60,260,321,256,60,143,296
"2011","Wrexham 018B","W01000346","Total",1594,118,72,46,1476,51,248,300,258,127,184,308
"2011","Wrexham 018C","W01000403","Total",1326,138,85,53,1188,45,198,254,232,41,149,269
"2011","Wrexham 018D","W01000404","Total",1986,228,117,111,1758,80,244,422,324,139,230,319
"2011","Wrexham 019C","W01000359","Total",1170,132,53,79,1038,63,136,262,238,41,113,185
"2011","Wrexham 019D","W01000360","Total",1255,173,94,79,1082,87,172,168,148,137,130,240
"2011","Wrexham 019E","W01000361","Total",2014,296,131,165,1718,107,222,390,330,155,201,313
"2011","Wrexham 019F","W01001930","Total",2141,249,122,127,1892,71,310,415,354,111,221,410
"2011","Wrexham 020F","W01000369","Total",1268,189,129,60,1079,40,272,240,202,50,90,185
"2011","Wrexham 020G","W01000370","Total",1361,219,102,117,1142,52,214,276,220,73,88,219
"2011","Wrexham 020A","W01000383","Total",2436,174,64,110,2262,70,176,706,422,180,293,415
"2011","Wrexham 020B","W01000384","Total",1087,155,98,57,932,15,172,206,168,80,78,213
"2011","Wrexham 020C","W01000390","Total",1607,175,89,86,1432,53,206,302,272,59,190,350
"2011","Wrexham 020H","W01000396","Total",1234,101,49,52,1133,39,184,287,202,76,97,248
"2011","Wrexham 020I","W01000397","Total",1045,65,33,32,980,19,188,242,174,61,86,210
"2011","Wrexham 020D","W01000417","Total",1568,138,71,67,1430,23,228,414,252,50,161,302
"2011","Wrexham 020E","W01000418","Total",1663,214,110,104,1449,56,248,362,276,120,121,266
"2011","Powys 001A","W01000461","Total",1501,224,100,124,1277,86,204,280,232,108,118,249
"2011","Powys 001D","W01000470","Total",1831,274,163,111,1557,61,304,263,318,97,196,318
"2011","Powys 001E","W01000475","Total",2368,234,123,111,2134,59,428,343,364,135,312,493
"2011","Powys 001F","W01001906","Total",1897,249,127,122,1648,40,358,283,316,125,224,302
"2011","Powys 001G","W01001907","Total",1415,144,80,64,1271,38,198,235,216,95,214,275
"2011","Powys 002A","W01000444","Total",2319,292,175,117,2027,75,410,421,360,118,291,352
"2011","Powys 002B","W01000457","Total",2191,182,94,88,2009,55,328,447,348,213,255,363
"2011","Powys 002C","W01000458","Total",1785,205,106,99,1580,65,292,392,304,109,129,289
"2011","Powys 003A","W01000498","Total",1538,322,141,181,1216,116,154,256,202,127,151,210
"2011","Powys 003B","W01000499","Total",1202,223,98,125,979,63,114,244,174,68,131,185
"2011","Powys 003C","W01000500","Total",1522,201,95,106,1321,71,172,289,230,86,161,312
"2011","Powys 003D","W01000501","Total",2194,362,202,160,1832,89,310,418,350,139,218,308
"2011","Powys 004A","W01000442","Total",2026,275,139,136,1751,50,288,368,354,140,181,370
"2011","Powys 004B","W01000452","Total",1930,205,105,100,1725,50,380,290,328,148,186,343
"2011","Powys 004C","W01000473","Total",2197,392,183,209,1805,134,262,436,378,117,174,304
"2011","Powys 005A","W01000428","Total",1326,175,108,67,1151,32,230,208,232,73,127,249
"2011","Powys 005B","W01000441","Total",1411,147,73,74,1264,45,272,321,220,78,163,165
"2011","Powys 005C","W01000476","Total",1295,218,115,103,1077,43,232,215,186,77,159,165
"2011","Powys 005D","W01000497","Total",1429,108,59,49,1321,76,222,304,220,101,166,232
"2011","Powys 006A","W01000433","Total",2316,312,167,145,2004,99,412,374,370,105,216,428
"2011","Powys 006B","W01000460","Total",1807,192,88,104,1615,111,232,325,250,116,254,327
"2011","Powys 006C","W01000488","Total",2170,200,99,101,1970,47,312,383,432,174,225,397
"2011","Powys 007A","W01000434","Total",1649,183,102,81,1466,42,300,296,244,140,143,301
"2011","Powys 007B","W01000439","Total",1961,194,92,102,1767,62,296,378,372,121,248,290
"2011","Powys 007C","W01000447","Total",2053,202,132,70,1851,71,340,339,318,155,252,376
"2011","Powys 008A","W01000480","Total",2008,376,138,238,1632,186,206,311,376,110,143,300
"2011","Powys 008B","W01000481","Total",2267,422,196,226,1845,91,324,415,416,109,166,324
"2011","Powys 008C","W01000482","Total",1834,278,119,159,1556,106,250,293,260,146,186,315
"2011","Powys 009A","W01000478","Total",1755,232,49,183,1523,217,102,379,220,226,150,229
"2011","Powys 009B","W01000479","Total",1476,181,87,94,1295,180,134,288,220,131,156,186
"2011","Powys 009C","W01000483","Total",1886,267,90,177,1619,227,172,377,192,190,219,242
"2011","Powys 010A","W01000429","Total",2272,237,109,128,2035,56,424,370,326,156,283,420
"2011","Powys 010B","W01000453","Total",1404,152,82,70,1252,18,230,248,230,113,132,281
"2011","Powys 010C","W01000466","Total",1393,194,125,69,1199,64,226,316,180,87,127,199
"2011","Powys 010D","W01000467","Total",1493,358,166,192,1135,96,202,200,278,40,91,228
"2011","Powys 011A","W01000427","Total",1403,161,91,70,1242,50,260,251,232,80,154,215
"2011","Powys 011B","W01000448","Total",1395,204,124,80,1191,95,214,265,208,63,110,236
"2011","Powys 011C","W01000449","Total",1580,270,113,157,1310,66,280,266,258,93,116,231
"2011","Powys 011D","W01000464","Total",1243,128,55,73,1115,23,268,186,222,92,98,226
"2011","Powys 011E","W01000484","Total",1533,172,97,75,1361,44,322,188,290,95,169,253
"2011","Powys 011F","W01000485","Total",1547,246,150,96,1301,37,372,203,230,42,165,252
"2011","Powys 011G","W01000486","Total",1151,153,82,71,998,86,154,220,168,87,118,165
"2011","Powys 012A","W01000438","Total",1236,198,125,73,1038,47,316,122,226,71,80,176
"2011","Powys 012B","W01000451","Total",1123,144,84,60,979,30,192,195,164,115,96,187
"2011","Powys 012C","W01000472","Total",1137,144,76,68,993,35,254,170,176,56,133,169
"2011","Powys 012D","W01000477","Total",1455,145,75,70,1310,48,314,175,238,115,155,265
"2011","Powys 012E","W01000487","Total",2001,380,195,185,1621,152,348,257,334,147,99,284
"2011","Powys 013A","W01000454","Total",1166,378,157,221,788,71,170,137,154,36,106,114
"2011","Powys 013B","W01000455","Total",2058,284,117,167,1774,123,286,438,314,152,189,272
"2011","Powys 013C","W01000456","Total",1987,418,201,217,1569,134,396,254,288,92,172,233
"2011","Powys 014A","W01000431","Total",1330,208,81,127,1122,100,92,262,218,103,160,187
"2011","Powys 014B","W01000432","Total",1210,168,98,70,1042,48,214,179,182,84,168,167
"2011","Powys 014C","W01000450","Total",1362,155,85,70,1207,64,254,226,254,67,157,185
"2011","Powys 014D","W01000459","Total",1201,146,73,73,1055,44,198,207,216,97,131,162
"2011","Powys 014E","W01000471","Total",1845,271,121,150,1574,107,350,231,270,118,157,341
"2011","Powys 015A","W01000430","Total",1256,165,82,83,1091,57,208,169,192,97,161,207
"2011","Powys 015B","W01000443","Total",2282,290,157,133,1992,54,416,409,394,135,208,376
"2011","Powys 015C","W01000445","Total",1501,163,74,89,1338,55,228,249,230,92,180,304
"2011","Powys 015D","W01000446","Total",1568,382,173,209,1186,131,194,229,264,72,76,220
"2011","Powys 015E","W01000494","Total",1686,236,118,118,1450,81,224,307,244,110,187,297
"2011","Powys 017A","W01000489","Total",1534,290,130,160,1244,92,176,362,254,51,120,189
"2011","Powys 017D","W01000492","Total",1546,395,172,223,1151,106,158,248,278,48,121,192
"2011","Powys 017E","W01000493","Total",1465,139,89,50,1326,60,234,361,206,81,177,207
"2011","Powys 017F","W01001901","Total",1930,310,199,111,1620,95,294,376,288,100,176,291
"2011","Powys 017G","W01001902","Total",1412,150,61,89,1262,168,128,273,226,143,110,214
"2011","Powys 018E","W01000465","Total",1013,98,59,39,915,24,198,166,176,53,101,197
"2011","Powys 018F","W01001903","Total",2054,317,191,126,1737,78,328,318,324,98,180,411
"2011","Powys 018G","W01001904","Total",1707,185,101,84,1522,79,278,340,300,125,144,256
"2011","Powys 018H","W01001905","Total",2071,223,106,117,1848,56,378,348,330,112,266,358
"2011","Powys 020A","W01000440","Total",1349,132,67,65,1217,22,220,233,184,93,174,291
"2011","Powys 020B","W01000474","Total",1697,225,104,121,1472,43,244,358,294,76,148,309
"2011","Powys 020C","W01000503","Total",1038,88,48,40,950,31,184,198,180,43,88,226
"2011","Powys 020D","W01001897","Total",1846,258,137,121,1588,60,290,379,342,86,163,268
"2011","Powys 021A","W01000426","Total",1424,211,104,107,1213,64,212,248,228,63,133,265
"2011","Powys 021B","W01000496","Total",2046,268,154,114,1778,94,302,339,308,88,248,399
"2011","Powys 021C","W01000502","Total",2038,337,192,145,1701,83,382,368,260,68,151,389
"2011","Powys 021D","W01000504","Total",1161,205,83,122,956,145,116,217,156,21,127,174
"2011","Powys 021E","W01000505","Total",1383,225,125,100,1158,73,188,228,216,45,138,270
"2011","Powys 021F","W01001899","Total",1956,282,148,134,1674,155,248,330,276,74,174,417
"2011","Ceredigion 001C","W01000523","Total",1909,244,107,137,1665,79,272,395,328,103,195,293
"2011","Ceredigion 001D","W01000548","Total",1818,217,110,107,1601,104,248,410,246,138,170,285
"2011","Ceredigion 001E","W01000549","Total",1764,221,98,123,1543,49,212,356,256,132,167,371
"2011","Ceredigion 001F","W01001937","Total",2062,327,133,194,1735,92,338,362,300,116,175,352
"2011","Ceredigion 002A","W01000512","Total",1385,231,89,142,1154,12,134,160,238,68,84,458
"2011","Ceredigion 002B","W01000513","Total",2465,437,55,382,2028,26,66,123,460,21,69,1263
"2011","Ceredigion 002D","W01000517","Total",1466,248,83,165,1218,11,52,84,210,48,58,755
"2011","Ceredigion 002F","W01001934","Total",2405,462,160,302,1943,61,268,231,348,79,96,860
"2011","Ceredigion 003A","W01000515","Total",1419,193,83,110,1226,104,122,308,206,72,154,260
"2011","Ceredigion 003B","W01000516","Total",1676,174,70,104,1502,112,178,340,232,138,193,309
"2011","Ceredigion 003C","W01000518","Total",1259,285,149,136,974,31,130,165,210,47,74,317
"2011","Ceredigion 003E","W01001935","Total",1095,160,62,98,935,40,82,178,186,61,92,296
"2011","Ceredigion 003F","W01001936","Total",1172,121,38,83,1051,63,154,157,158,86,81,352
"2011","Ceredigion 005A","W01000506","Total",1396,337,175,162,1059,30,272,209,214,52,89,193
"2011","Ceredigion 005B","W01000524","Total",1969,236,121,115,1733,68,294,359,286,100,222,404
"2011","Ceredigion 005C","W01000538","Total",1562,177,75,102,1385,41,222,299,254,90,215,264
"2011","Ceredigion 005D","W01000539","Total",1206,131,68,63,1075,48,206,168,176,50,149,278
"2011","Ceredigion 005E","W01000540","Total",1143,180,101,79,963,46,214,170,170,101,58,204
"2011","Ceredigion 007A","W01000529","Total",1611,176,90,86,1435,65,248,258,234,141,226,263
"2011","Ceredigion 007B","W01000532","Total",1974,216,123,93,1758,32,410,308,298,107,202,401
"2011","Ceredigion 007C","W01000544","Total",1071,206,100,106,865,74,164,144,180,76,74,153
"2011","Ceredigion 007D","W01000545","Total",2045,256,135,121,1789,50,410,236,338,81,264,410
"2011","Ceredigion 008A","W01000527","Total",1005,189,83,106,816,70,120,176,128,40,70,212
"2011","Ceredigion 008B","W01000528","Total",1440,206,100,106,1234,114,220,237,188,70,140,265
"2011","Ceredigion 008C","W01000535","Total",2037,257,140,117,1780,83,348,324,318,159,197,351
"2011","Ceredigion 008D","W01000537","Total",1484,216,107,109,1268,73,262,194,214,96,147,282
"2011","Ceredigion 008E","W01000541","Total",1821,225,102,123,1596,108,276,302,270,82,190,368
"2011","Ceredigion 009A","W01000507","Total",1191,180,112,68,1011,30,256,143,188,57,144,193
"2011","Ceredigion 009B","W01000508","Total",1178,181,95,86,997,74,172,212,190,42,109,198
"2011","Ceredigion 009C","W01000509","Total",1771,269,168,101,1502,81,334,259,218,122,166,322
"2011","Ceredigion 009D","W01000510","Total",1204,332,192,140,872,85,136,159,168,82,82,160
"2011","Ceredigion 009E","W01000511","Total",1174,267,54,213,907,101,66,197,136,91,140,176
"2011","Ceredigion 009F","W01000546","Total",1128,172,99,73,956,21,238,166,210,58,87,176
"2011","Ceredigion 009G","W01000547","Total",1177,186,90,96,991,39,202,178,176,82,123,191
"2011","Ceredigion 010A","W01000519","Total",1627,205,127,78,1422,54,298,205,272,107,109,377
"2011","Ceredigion 010B","W01000522","Total",1276,159,81,78,1117,19,226,193,190,58,156,275
"2011","Ceredigion 010C","W01000531","Total",1778,251,124,127,1527,74,276,296,294,128,162,297
"2011","Ceredigion 010D","W01000533","Total",1411,247,126,121,1164,80,200,217,218,113,134,202
"2011","Ceredigion 010E","W01000551","Total",1310,170,86,84,1140,58,222,176,220,86,128,250
"2011","Ceredigion 011A","W01000525","Total",1132,138,84,54,994,36,260,165,156,62,73,242
"2011","Ceredigion 011B","W01000534","Total",1533,186,97,89,1347,47,240,336,224,139,154,207
"2011","Ceredigion 011E","W01000536","Total",1459,215,102,113,1244,46,280,212,204,124,115,263
"2011","Ceredigion 011F","W01000542","Total",2195,271,135,136,1924,54,316,386,340,150,262,416
"2011","Ceredigion 011C","W01000543","Total",2019,257,120,137,1762,72,284,395,358,125,208,320
"2011","Ceredigion 011G","W01000550","Total",1198,224,121,103,974,65,178,178,150,67,131,205
"2011","Ceredigion 011D","W01000552","Total",2024,218,108,110,1806,71,254,430,312,167,241,331
"2011","Pembrokeshire 001A","W01000558","Total",2016,269,106,163,1747,135,288,379,306,125,191,323
"2011","Pembrokeshire 001B","W01000559","Total",1446,169,94,75,1277,32,230,179,250,119,182,285
"2011","Pembrokeshire 001C","W01000560","Total",1207,134,63,71,1073,61,200,177,206,57,134,238
"2011","Pembrokeshire 001D","W01000561","Total",1256,133,66,67,1123,53,172,228,140,93,162,275
"2011","Pembrokeshire 001E","W01000613","Total",2210,339,159,180,1871,133,384,259,344,165,190,396
"2011","Pembrokeshire 002A","W01000562","Total",1686,200,104,96,1486,72,318,212,264,110,151,359
"2011","Pembrokeshire 002B","W01000565","Total",1827,351,201,150,1476,107,342,246,276,100,159,246
"2011","Pembrokeshire 002C","W01000566","Total",1537,291,141,150,1246,110,264,210,194,97,149,222
"2011","Pembrokeshire 002D","W01000567","Total",1977,318,138,180,1659,135,260,323,292,149,213,287
"2011","Pembrokeshire 002E","W01000597","Total",1158,241,133,108,917,68,246,138,154,90,96,125
"2011","Pembrokeshire 002F","W01000617","Total",1464,183,91,92,1281,56,172,211,250,199,159,234
"2011","Pembrokeshire 003A","W01000579","Total",2324,267,141,126,2057,124,380,438,330,204,249,332
"2011","Pembrokeshire 003B","W01000581","Total",1450,179,89,90,1271,33,276,235,260,75,153,239
"2011","Pembrokeshire 003C","W01000612","Total",1783,317,175,142,1466,83,314,333,274,61,152,249
"2011","Pembrokeshire 003D","W01000618","Total",1526,173,83,90,1353,97,264,255,228,96,189,224
"2011","Pembrokeshire 004A","W01000582","Total",1659,201,95,106,1458,70,272,258,258,109,168,323
"2011","Pembrokeshire 004B","W01000583","Total",1440,149,81,68,1291,73,222,316,162,83,180,255
"2011","Pembrokeshire 004C","W01000611","Total",1662,180,106,74,1482,36,356,299,272,30,159,330
"2011","Pembrokeshire 004D","W01000623","Total",1917,177,98,79,1740,94,294,378,256,125,227,366
"2011","Pembrokeshire 005A","W01000568","Total",2299,574,156,418,1725,201,178,336,370,92,205,343
"2011","Pembrokeshire 005B","W01000569","Total",1327,134,65,69,1193,84,118,391,164,121,126,189
"2011","Pembrokeshire 005C","W01000570","Total",1474,155,25,130,1319,327,60,337,206,155,105,129
"2011","Pembrokeshire 005D","W01000572","Total",1801,278,148,130,1523,81,208,383,256,87,220,288
"2011","Pembrokeshire 006A","W01000571","Total",2228,345,205,140,1883,146,346,331,308,135,226,391
"2011","Pembrokeshire 006B","W01000573","Total",2483,361,159,202,2122,207,302,526,414,122,190,361
"2011","Pembrokeshire 006C","W01000586","Total",2185,229,117,112,1956,162,236,369,340,154,301,394
"2011","Pembrokeshire 007A","W01000577","Total",1584,151,86,65,1433,66,234,230,212,102,193,396
"2011","Pembrokeshire 007B","W01000585","Total",1344,119,57,62,1225,48,192,206,220,59,161,339
"2011","Pembrokeshire 007C","W01000595","Total",1900,355,191,164,1545,161,272,299,250,90,161,312
"2011","Pembrokeshire 007D","W01000596","Total",1459,159,83,76,1300,71,220,270,260,83,161,235
"2011","Pembrokeshire 008A","W01000555","Total",1384,139,71,68,1245,69,214,178,242,52,149,341
"2011","Pembrokeshire 008B","W01000556","Total",1136,142,89,53,994,48,236,157,188,37,98,230
"2011","Pembrokeshire 008C","W01000575","Total",2405,266,142,124,2139,125,298,443,366,176,280,451
"2011","Pembrokeshire 008D","W01000614","Total",1390,171,92,79,1219,70,236,193,244,65,133,278
"2011","Pembrokeshire 008E","W01000622","Total",1486,177,92,85,1309,87,222,225,254,136,139,246
"2011","Pembrokeshire 009A","W01000554","Total",1786,173,74,99,1613,63,302,332,336,110,204,266
"2011","Pembrokeshire 009B","W01000580","Total",2324,249,112,137,2075,92,350,483,346,129,319,356
"2011","Pembrokeshire 009C","W01000598","Total",2209,338,172,166,1871,156,324,412,360,94,156,369
"2011","Pembrokeshire 009D","W01000599","Total",2150,216,110,106,1934,172,308,392,340,161,195,366
"2011","Pembrokeshire 010A","W01000587","Total",2000,444,206,238,1556,110,276,334,284,60,183,309
"2011","Pembrokeshire 010B","W01000588","Total",2157,282,104,178,1875,218,232,491,290,151,190,303
"2011","Pembrokeshire 010C","W01000593","Total",2751,328,176,152,2423,153,386,452,400,259,248,525
"2011","Pembrokeshire 011A","W01000553","Total",1230,135,69,66,1095,44,248,159,228,42,119,255
"2011","Pembrokeshire 011B","W01000563","Total",1168,115,47,68,1053,82,178,155,190,79,120,249
"2011","Pembrokeshire 011C","W01000564","Total",1178,144,91,53,1034,68,222,202,164,42,94,242
"2011","Pembrokeshire 011D","W01000576","Total",2257,274,189,85,1983,94,432,325,286,181,323,342
"2011","Pembrokeshire 011E","W01000615","Total",1485,196,126,70,1289,68,330,230,204,68,150,239
"2011","Pembrokeshire 011F","W01000616","Total",1083,194,104,90,889,38,254,172,146,47,75,157
"2011","Pembrokeshire 012A","W01000589","Total",1152,185,103,82,967,114,130,229,160,68,91,175
"2011","Pembrokeshire 012B","W01000590","Total",1087,213,128,85,874,29,218,141,184,40,59,203
"2011","Pembrokeshire 012C","W01000591","Total",1187,128,59,69,1059,74,150,205,166,67,144,253
"2011","Pembrokeshire 012D","W01000592","Total",1304,107,51,56,1197,132,126,201,164,138,186,250
"2011","Pembrokeshire 012E","W01000594","Total",2228,327,127,200,1901,232,266,403,304,162,215,319
"2011","Pembrokeshire 013A","W01000600","Total",1635,338,132,206,1297,140,154,262,244,69,178,250
"2011","Pembrokeshire 013B","W01000601","Total",1544,184,79,105,1360,217,184,230,190,193,145,201
"2011","Pembrokeshire 013C","W01000602","Total",1268,187,72,115,1081,127,208,182,180,59,99,226
"2011","Pembrokeshire 013D","W01000603","Total",1877,273,99,174,1604,186,162,332,298,134,214,278
"2011","Pembrokeshire 013E","W01000604","Total",1514,157,67,90,1357,172,176,262,220,120,174,233
"2011","Pembrokeshire 013F","W01000605","Total",1834,171,71,100,1663,105,188,315,270,150,256,379
"2011","Pembrokeshire 014A","W01000557","Total",1532,144,72,72,1388,74,190,315,222,98,213,276
"2011","Pembrokeshire 014B","W01000578","Total",1669,216,127,89,1453,42,352,253,248,119,122,317
"2011","Pembrokeshire 014C","W01000584","Total",2068,232,102,130,1836,98,366,297,316,192,248,319
"2011","Pembrokeshire 014D","W01000609","Total",2390,291,176,115,2099,91,588,374,386,98,211,351
"2011","Pembrokeshire 015A","W01000574","Total",1871,210,100,110,1661,61,316,332,276,88,211,377
"2011","Pembrokeshire 015B","W01000606","Total",1650,214,82,132,1436,308,146,309,234,85,155,199
"2011","Pembrokeshire 015C","W01000607","Total",1966,275,126,149,1691,232,192,377,232,129,210,319
"2011","Pembrokeshire 015D","W01000608","Total",1421,280,100,180,1141,137,206,177,224,57,143,197
"2011","Pembrokeshire 016A","W01000610","Total",1619,231,122,109,1388,86,338,268,244,55,128,269
"2011","Pembrokeshire 016B","W01000619","Total",2059,340,193,147,1719,121,348,345,322,88,215,280
"2011","Pembrokeshire 016C","W01000620","Total",1013,327,137,190,686,64,144,115,184,10,77,92
"2011","Pembrokeshire 016D","W01000621","Total",1449,248,131,117,1201,143,188,233,234,64,98,241
"2011","Carmarthenshire 001A","W01000685","Total",1566,201,74,127,1365,125,206,235,256,101,154,288
"2011","Carmarthenshire 001B","W01000686","Total",1262,140,71,69,1122,61,214,198,182,99,100,268
"2011","Carmarthenshire 001C","W01000701","Total",1542,204,106,98,1338,116,230,324,232,83,160,193
"2011","Carmarthenshire 001D","W01000702","Total",1200,153,70,83,1047,104,150,209,140,90,108,246
"2011","Carmarthenshire 002A","W01000647","Total",1512,162,75,87,1350,53,270,209,238,108,207,265
"2011","Carmarthenshire 002B","W01000650","Total",1611,196,101,95,1415,77,258,202,330,69,153,326
"2011","Carmarthenshire 002C","W01000678","Total",1333,223,157,66,1110,66,234,182,180,62,138,248
"2011","Carmarthenshire 002D","W01000679","Total",1182,202,93,109,980,64,168,199,186,47,115,201
"2011","Carmarthenshire 003A","W01000646","Total",2134,290,134,156,1844,140,354,331,390,98,243,288
"2011","Carmarthenshire 003B","W01000688","Total",1808,231,129,102,1577,113,252,320,246,157,164,325
"2011","Carmarthenshire 003C","W01000689","Total",1619,188,100,88,1431,43,316,289,280,58,209,236
"2011","Carmarthenshire 003D","W01000728","Total",2067,192,102,90,1875,34,344,319,298,129,241,510
"2011","Carmarthenshire 004A","W01000676","Total",1513,222,113,109,1291,67,234,242,222,80,141,305
"2011","Carmarthenshire 004B","W01000677","Total",1391,321,148,173,1070,191,168,170,166,84,75,216
"2011","Carmarthenshire 004C","W01000687","Total",1895,246,146,100,1649,48,318,279,284,177,179,364
"2011","Carmarthenshire 004D","W01000709","Total",2220,206,109,97,2014,88,424,340,360,139,277,386
"2011","Carmarthenshire 005A","W01000624","Total",2299,234,133,101,2065,87,366,423,310,155,230,494
"2011","Carmarthenshire 005B","W01000682","Total",1381,148,88,60,1233,50,182,248,212,120,184,237
"2011","Carmarthenshire 005C","W01000683","Total",1054,113,49,64,941,37,162,145,206,55,113,223
"2011","Carmarthenshire 005D","W01000684","Total",1847,173,94,79,1674,106,302,267,328,132,192,347
"2011","Carmarthenshire 006A","W01000643","Total",1657,220,88,132,1437,142,160,345,228,126,219,217
"2011","Carmarthenshire 006B","W01000644","Total",1405,147,52,95,1258,131,116,342,210,107,131,221
"2011","Carmarthenshire 006C","W01000645","Total",1697,258,136,122,1439,141,176,300,218,123,174,307
"2011","Carmarthenshire 006D","W01000648","Total",1452,127,55,72,1325,18,222,239,208,102,230,306
"2011","Carmarthenshire 006E","W01000649","Total",1533,167,104,63,1366,18,274,243,240,104,144,343
"2011","Carmarthenshire 007A","W01000637","Total",1423,236,125,111,1187,132,128,253,194,88,157,235
"2011","Carmarthenshire 007B","W01000638","Total",1193,142,51,91,1051,135,84,248,160,102,121,201
"2011","Carmarthenshire 007C","W01000639","Total",1352,243,93,150,1109,98,172,215,204,56,138,226
"2011","Carmarthenshire 007D","W01000640","Total",1132,124,77,47,1008,34,214,180,232,35,74,239
"2011","Carmarthenshire 008A","W01000641","Total",2053,624,268,356,1429,131,230,254,338,86,85,305
"2011","Carmarthenshire 008B","W01000642","Total",1610,215,108,107,1395,72,240,287,244,70,100,382
"2011","Carmarthenshire 008C","W01000693","Total",1079,173,116,57,906,96,212,159,128,53,87,171
"2011","Carmarthenshire 008D","W01000694","Total",1283,131,62,69,1152,46,278,207,212,47,121,241
"2011","Carmarthenshire 010A","W01000656","Total",2117,264,104,160,1853,177,270,363,302,123,237,381
"2011","Carmarthenshire 010B","W01000657","Total",1073,173,98,75,900,89,142,166,186,25,96,196
"2011","Carmarthenshire 010C","W01000658","Total",1269,152,62,90,1117,96,154,252,194,64,129,228
"2011","Carmarthenshire 010D","W01000718","Total",1424,199,94,105,1225,129,154,214,228,83,173,244
"2011","Carmarthenshire 010E","W01000719","Total",1497,175,101,74,1322,80,188,248,238,92,182,294
"2011","Carmarthenshire 011A","W01000680","Total",2011,224,144,80,1787,104,326,381,316,87,226,347
"2011","Carmarthenshire 011B","W01000681","Total",1943,271,131,140,1672,171,236,361,270,150,146,338
"2011","Carmarthenshire 011C","W01000724","Total",1853,200,92,108,1653,101,240,420,246,132,176,338
"2011","Carmarthenshire 011D","W01000725","Total",2074,278,156,122,1796,69,304,400,328,114,196,385
"2011","Carmarthenshire 012A","W01000675","Total",1963,233,125,108,1730,49,320,307,324,115,224,391
"2011","Carmarthenshire 012B","W01000695","Total",1534,202,112,90,1332,87,200,247,280,74,165,279
"2011","Carmarthenshire 012C","W01000696","Total",1568,202,103,99,1366,72,228,247,210,68,187,354
"2011","Carmarthenshire 012D","W01000722","Total",1268,138,82,56,1130,23,254,190,180,37,125,321
"2011","Carmarthenshire 012E","W01000723","Total",1358,196,101,95,1162,47,228,216,236,46,184,205
"2011","Carmarthenshire 013A","W01000625","Total",1195,185,93,92,1010,136,124,253,96,32,147,222
"2011","Carmarthenshire 013B","W01000626","Total",1454,320,150,170,1134,96,204,288,194,77,95,180
"2011","Carmarthenshire 013C","W01000627","Total",2115,242,104,138,1873,162,272,417,328,159,192,343
"2011","Carmarthenshire 013D","W01000714","Total",1426,223,90,133,1203,95,172,267,226,76,145,222
"2011","Carmarthenshire 013E","W01000715","Total",1290,151,71,80,1139,54,214,236,194,66,139,236
"2011","Carmarthenshire 015A","W01000697","Total",1795,242,110,132,1553,107,254,337,294,71,173,317
"2011","Carmarthenshire 015B","W01000698","Total",1894,181,99,82,1713,110,234,382,280,153,188,366
"2011","Carmarthenshire 015C","W01000699","Total",1528,124,60,64,1404,31,194,357,236,66,158,362
"2011","Carmarthenshire 015D","W01000712","Total",1492,170,71,99,1322,81,186,349,254,77,150,225
"2011","Carmarthenshire 015E","W01000713","Total",1391,151,66,85,1240,85,178,287,190,67,164,269
"2011","Carmarthenshire 016A","W01000662","Total",2153,256,151,105,1897,113,284,418,340,63,232,447
"2011","Carmarthenshire 016B","W01000663","Total",2261,301,176,125,1960,94,324,448,370,91,182,451
"2011","Carmarthenshire 016C","W01000664","Total",1755,196,109,87,1559,68,254,384,250,66,196,341
"2011","Carmarthenshire 016D","W01000716","Total",1333,141,76,65,1192,58,200,209,164,95,159,307
"2011","Carmarthenshire 016E","W01000717","Total",1431,213,123,90,1218,61,182,261,240,103,131,240
"2011","Carmarthenshire 017A","W01000665","Total",1775,158,70,88,1617,41,222,413,326,75,125,415
"2011","Carmarthenshire 017B","W01000666","Total",1438,218,103,115,1220,109,134,324,222,91,89,251
"2011","Carmarthenshire 017C","W01000731","Total",2436,280,140,140,2156,143,278,506,446,92,235,456
"2011","Carmarthenshire 018A","W01000670","Total",1619,248,117,131,1371,149,214,253,240,67,187,261
"2011","Carmarthenshire 018B","W01000671","Total",1882,207,111,96,1675,111,276,384,246,133,211,314
"2011","Carmarthenshire 018C","W01000729","Total",1263,158,95,63,1105,79,142,210,208,81,128,257
"2011","Carmarthenshire 018D","W01000730","Total",1276,129,59,70,1147,44,172,186,210,108,157,270
"2011","Carmarthenshire 019A","W01000690","Total",1728,216,129,87,1512,95,242,355,278,82,172,288
"2011","Carmarthenshire 019B","W01000691","Total",1591,168,103,65,1423,73,282,286,244,82,142,314
"2011","Carmarthenshire 019C","W01000692","Total",1592,166,73,93,1426,87,170,418,252,140,135,224
"2011","Carmarthenshire 019D","W01000726","Total",1520,131,85,46,1389,35,226,278,278,60,162,350
"2011","Carmarthenshire 019E","W01000727","Total",1010,140,80,60,870,46,240,182,174,11,68,149
"2011","Carmarthenshire 020A","W01000651","Total",1588,223,98,125,1365,99,178,316,228,95,135,314
"2011","Carmarthenshire 020B","W01000652","Total",1908,236,126,110,1672,232,216,307,222,153,223,319
"2011","Carmarthenshire 020C","W01000655","Total",2017,233,106,127,1784,205,214,371,256,149,275,314
"2011","Carmarthenshire 021A","W01000632","Total",1457,180,88,92,1277,109,216,278,176,100,127,271
"2011","Carmarthenshire 021B","W01000633","Total",1412,296,172,124,1116,98,210,182,218,42,170,196
"2011","Carmarthenshire 021C","W01000634","Total",1377,217,150,67,1160,59,320,212,182,37,116,234
"2011","Carmarthenshire 021D","W01000710","Total",2236,193,105,88,2043,91,386,527,272,156,190,421
"2011","Carmarthenshire 021E","W01000711","Total",2026,291,155,136,1735,171,314,262,300,131,188,369
"2011","Carmarthenshire 022A","W01000703","Total",1823,305,120,185,1518,209,150,340,212,83,226,298
"2011","Carmarthenshire 022B","W01000704","Total",1627,225,129,96,1402,59,278,303,194,83,153,332
"2011","Carmarthenshire 022C","W01000705","Total",1946,267,137,130,1679,246,214,275,240,111,265,328
"2011","Carmarthenshire 023A","W01000653","Total",1421,207,109,98,1214,72,226,261,196,56,126,277
"2011","Carmarthenshire 023B","W01000654","Total",1705,299,120,179,1406,128,170,305,254,71,155,323
"2011","Carmarthenshire 023C","W01000667","Total",1412,182,105,77,1230,73,226,332,204,68,100,227
"2011","Carmarthenshire 023F","W01001925","Total",2292,262,118,144,2030,150,338,375,370,124,232,441
"2011","Carmarthenshire 024A","W01000628","Total",1490,161,75,86,1329,65,176,288,212,57,201,330
"2011","Carmarthenshire 024B","W01000629","Total",1731,254,118,136,1477,169,188,273,246,87,195,319
"2011","Carmarthenshire 024C","W01000630","Total",1629,182,70,112,1447,151,146,319,232,89,184,326
"2011","Carmarthenshire 024D","W01000631","Total",1776,261,114,147,1515,238,182,333,194,106,140,322
"2011","Carmarthenshire 025A","W01000635","Total",2240,230,87,143,2010,104,208,520,394,102,298,384
"2011","Carmarthenshire 025B","W01000636","Total",1907,204,107,97,1703,184,200,406,268,113,196,336
"2011","Carmarthenshire 025C","W01000706","Total",1647,170,72,98,1477,159,176,321,262,109,173,277
"2011","Carmarthenshire 025D","W01000707","Total",1473,177,72,105,1296,181,154,269,184,128,146,234
"2011","Carmarthenshire 025E","W01000708","Total",1383,203,77,126,1180,203,134,216,174,92,157,204
"2011","Carmarthenshire 026A","W01000659","Total",1542,206,76,130,1336,184,124,274,184,107,192,271
"2011","Carmarthenshire 026B","W01000660","Total",1532,311,119,192,1221,147,172,190,238,105,147,222
"2011","Carmarthenshire 026D","W01000732","Total",1362,214,89,125,1148,118,138,172,240,48,143,289
"2011","Carmarthenshire 026E","W01000733","Total",1253,329,121,208,924,122,94,169,174,73,97,195
"2011","Carmarthenshire 026F","W01000734","Total",1433,255,81,174,1178,191,84,241,212,91,171,188
"2011","Carmarthenshire 026G","W01001923","Total",1254,232,51,181,1022,93,86,207,276,76,97,187
"2011","Carmarthenshire 026H","W01001924","Total",1333,263,104,159,1070,182,102,199,176,82,177,152
"2011","Carmarthenshire 027E","W01000672","Total",1629,179,87,92,1450,49,242,262,288,86,189,334
"2011","Carmarthenshire 027F","W01000673","Total",1220,170,82,88,1050,74,198,193,188,65,103,229
"2011","Carmarthenshire 027A","W01000674","Total",2067,191,97,94,1876,78,302,304,304,104,287,497
"2011","Carmarthenshire 027G","W01000700","Total",2001,250,131,119,1751,59,352,328,334,57,220,401
"2011","Carmarthenshire 027B","W01000720","Total",1564,233,113,120,1331,29,208,255,260,89,138,352
"2011","Carmarthenshire 027C","W01000721","Total",1342,127,78,49,1215,72,162,274,188,93,158,268
"2011","Carmarthenshire 027D","W01000735","Total",2272,278,147,131,1994,103,340,400,360,169,260,362
"2011","Swansea 001A","W01000845","Total",2024,196,83,113,1828,98,230,537,306,95,207,355
"2011","Swansea 001B","W01000846","Total",1730,326,117,209,1404,143,138,371,282,81,195,194
"2011","Swansea 001C","W01000847","Total",1266,135,76,59,1131,74,184,222,150,75,143,283
"2011","Swansea 001D","W01000848","Total",1197,148,80,68,1049,104,134,218,168,132,107,186
"2011","Swansea 002A","W01000750","Total",1545,270,147,123,1275,94,194,242,226,91,188,240
"2011","Swansea 002B","W01000751","Total",1407,169,83,86,1238,43,286,268,228,49,66,298
"2011","Swansea 002C","W01000752","Total",1518,193,62,131,1325,204,112,273,220,78,226,212
"2011","Swansea 002D","W01000753","Total",1420,186,75,111,1234,141,124,281,192,83,118,295
"2011","Swansea 002E","W01000754","Total",1576,221,94,127,1355,102,168,291,218,102,186,288
"2011","Swansea 002F","W01000803","Total",1850,212,93,119,1638,59,240,351,256,117,196,419
"2011","Swansea 003A","W01000806","Total",1514,155,73,82,1359,102,216,312,204,63,155,307
"2011","Swansea 003B","W01000807","Total",1421,117,38,79,1304,58,130,237,254,50,137,438
"2011","Swansea 003C","W01000808","Total",1436,176,97,79,1260,68,262,231,180,38,136,345
"2011","Swansea 003D","W01000810","Total",1376,306,131,175,1070,180,112,189,150,95,153,191
"2011","Swansea 003E","W01000815","Total",1592,159,70,89,1433,60,246,299,276,68,105,379
"2011","Swansea 003F","W01000816","Total",1734,186,52,134,1548,90,168,462,262,71,175,320
"2011","Swansea 004A","W01000791","Total",1504,186,44,142,1318,70,102,432,254,66,122,272
"2011","Swansea 004B","W01000792","Total",1645,177,72,105,1468,58,242,404,212,47,172,333
"2011","Swansea 004C","W01000793","Total",1887,195,53,142,1692,86,122,670,332,91,139,252
"2011","Swansea 004D","W01000837","Total",1610,132,54,78,1478,37,214,419,262,127,142,277
"2011","Swansea 004E","W01000838","Total",1244,188,84,104,1056,124,140,242,172,80,101,197
"2011","Swansea 005A","W01000773","Total",2663,425,150,275,2238,199,174,648,442,230,205,340
"2011","Swansea 005B","W01000774","Total",1614,267,158,109,1347,101,204,316,222,96,133,275
"2011","Swansea 005C","W01000841","Total",1479,200,104,96,1279,54,192,284,198,80,121,350
"2011","Swansea 005D","W01000842","Total",1379,180,86,94,1199,56,176,245,186,60,151,325
"2011","Swansea 005E","W01000843","Total",1377,136,54,82,1241,89,170,300,188,80,117,297
"2011","Swansea 005F","W01000844","Total",1188,131,51,80,1057,146,112,216,158,95,104,226
"2011","Swansea 006A","W01000795","Total",1617,180,59,121,1437,82,152,435,326,92,135,215
"2011","Swansea 006B","W01000796","Total",2720,222,48,174,2498,187,146,839,522,151,271,382
"2011","Swansea 006C","W01000800","Total",1460,136,63,73,1324,46,154,356,278,51,166,273
"2011","Swansea 006D","W01000801","Total",1548,197,76,121,1351,153,144,258,178,117,173,328
"2011","Swansea 007A","W01000784","Total",1317,189,116,73,1128,79,160,243,212,76,98,260
"2011","Swansea 007B","W01000785","Total",1316,117,68,49,1199,34,196,280,172,55,143,319
"2011","Swansea 007C","W01000786","Total",1346,144,74,70,1202,49,204,223,226,68,126,306
"2011","Swansea 007D","W01000802","Total",2355,313,114,199,2042,157,220,514,366,124,252,409
"2011","Swansea 007E","W01000877","Total",1548,157,70,87,1391,61,240,305,220,93,131,341
"2011","Swansea 007F","W01000878","Total",1223,157,93,64,1066,85,172,216,156,42,129,266
"2011","Swansea 008A","W01000809","Total",1571,235,59,176,1336,152,112,291,266,96,155,264
"2011","Swansea 008B","W01000811","Total",1590,203,55,148,1387,219,154,259,222,82,122,329
"2011","Swansea 008C","W01000812","Total",1416,303,116,187,1113,132,106,220,206,78,131,240
"2011","Swansea 008D","W01000813","Total",1618,178,78,100,1440,81,240,330,206,72,164,347
"2011","Swansea 008E","W01000814","Total",1499,231,56,175,1268,213,100,277,236,97,123,222
"2011","Swansea 009A","W01000817","Total",1769,360,112,248,1409,227,142,266,224,154,127,269
"2011","Swansea 009B","W01000818","Total",1536,185,86,99,1351,167,222,256,218,95,139,254
"2011","Swansea 009C","W01000819","Total",1437,154,93,61,1283,22,312,259,214,20,129,327
"2011","Swansea 009D","W01000820","Total",1363,195,79,116,1168,66,184,228,204,48,165,273
"2011","Swansea 009E","W01000821","Total",1461,236,104,132,1225,94,174,262,222,58,115,300
"2011","Swansea 009F","W01000822","Total",1236,193,118,75,1043,40,278,154,200,52,64,255
"2011","Swansea 010A","W01000794","Total",2172,263,57,206,1909,151,132,587,420,91,203,325
"2011","Swansea 010B","W01000797","Total",1509,168,72,96,1341,78,248,250,258,86,139,282
"2011","Swansea 010C","W01000798","Total",1416,171,88,83,1245,43,266,235,234,50,126,291
"2011","Swansea 010D","W01000799","Total",1935,200,52,148,1735,303,90,435,296,157,177,277
"2011","Swansea 011A","W01000830","Total",1693,221,52,169,1472,315,82,294,184,170,238,189
"2011","Swansea 011B","W01000832","Total",1604,353,101,252,1251,142,108,274,166,121,176,264
"2011","Swansea 011C","W01000833","Total",1750,274,79,195,1476,305,118,306,190,181,138,238
"2011","Swansea 011D","W01000834","Total",1545,160,79,81,1385,223,142,256,152,159,184,269
"2011","Swansea 011E","W01000836","Total",2263,264,39,225,1999,280,104,598,324,221,194,278
"2011","Swansea 012A","W01000759","Total",1476,188,110,78,1288,36,220,318,284,47,113,270
"2011","Swansea 012B","W01000777","Total",1782,227,124,103,1555,86,284,380,270,55,158,322
"2011","Swansea 012C","W01000778","Total",1879,196,68,128,1683,135,178,500,264,54,209,343
"2011","Swansea 012D","W01000779","Total",1540,140,68,72,1400,103,152,316,202,127,202,298
"2011","Swansea 013A","W01000760","Total",1670,214,77,137,1456,140,164,370,286,68,141,287
"2011","Swansea 013B","W01000761","Total",1569,189,71,118,1380,116,138,327,256,125,167,251
"2011","Swansea 013C","W01000762","Total",1594,162,58,104,1432,146,152,244,166,136,183,405
"2011","Swansea 013D","W01000831","Total",1806,274,108,166,1532,322,186,351,198,53,135,287
"2011","Swansea 013E","W01000835","Total",1420,185,84,101,1235,174,164,228,142,168,104,255
"2011","Swansea 014A","W01000738","Total",1768,241,90,151,1527,194,152,295,244,160,174,308
"2011","Swansea 014B","W01000739","Total",1840,344,55,289,1496,163,100,285,372,111,206,259
"2011","Swansea 014C","W01000740","Total",1557,157,82,75,1400,44,260,279,268,51,199,299
"2011","Swansea 014D","W01000741","Total",1567,244,143,101,1323,163,204,241,198,77,150,290
"2011","Swansea 015A","W01000763","Total",1524,167,62,105,1357,159,120,291,210,98,157,322
"2011","Swansea 015B","W01000764","Total",1649,190,66,124,1459,122,140,339,260,109,160,329
"2011","Swansea 015C","W01000765","Total",1658,247,111,136,1411,129,184,305,280,61,143,309
"2011","Swansea 015D","W01000766","Total",1576,164,72,92,1412,144,154,310,222,83,192,307
"2011","Swansea 015E","W01000767","Total",1519,355,173,182,1164,108,170,204,192,82,145,263
"2011","Swansea 016A","W01000742","Total",1547,400,105,295,1147,172,120,246,210,66,133,200
"2011","Swansea 016B","W01000744","Total",1492,303,78,225,1189,174,112,205,334,30,70,264
"2011","Swansea 016C","W01000787","Total",1521,209,50,159,1312,142,134,319,272,36,121,288
"2011","Swansea 016D","W01000788","Total",1440,226,80,146,1214,165,110,276,242,41,96,284
"2011","Swansea 016E","W01000789","Total",1423,216,56,160,1207,164,104,267,232,57,121,262
"2011","Swansea 016F","W01000790","Total",1732,255,81,174,1477,150,154,246,258,123,253,293
"2011","Swansea 017A","W01000755","Total",1957,285,112,173,1672,152,242,405,250,102,178,343
"2011","Swansea 017B","W01000756","Total",1591,313,78,235,1278,138,134,307,212,83,181,223
"2011","Swansea 017C","W01000757","Total",1485,266,160,106,1219,63,258,258,226,36,102,276
"2011","Swansea 017D","W01000758","Total",1894,272,104,168,1622,91,222,422,294,115,147,331
"2011","Swansea 018A","W01000772","Total",1583,135,77,58,1448,59,204,305,202,137,168,373
"2011","Swansea 018B","W01000828","Total",1722,184,112,72,1538,34,312,331,248,97,129,387
"2011","Swansea 018C","W01000829","Total",1885,255,127,128,1630,87,240,342,302,90,172,397
"2011","Swansea 019A","W01000862","Total",1599,241,45,196,1358,375,32,382,168,67,154,180
"2011","Swansea 019B","W01000863","Total",1586,301,118,183,1285,306,104,277,194,86,134,184
"2011","Swansea 019C","W01000864","Total",1651,227,61,166,1424,318,80,358,170,122,171,205
"2011","Swansea 019D","W01000865","Total",1352,197,97,100,1155,156,142,181,174,90,165,247
"2011","Swansea 019E","W01000866","Total",1209,159,76,83,1050,201,98,183,174,87,111,196
"2011","Swansea 019F","W01000867","Total",1299,181,66,115,1118,172,106,205,204,80,127,224
"2011","Swansea 020A","W01000768","Total",1393,184,88,96,1209,56,222,283,192,68,130,258
"2011","Swansea 020B","W01000769","Total",1412,149,84,65,1263,51,258,279,194,118,112,251
"2011","Swansea 020C","W01000770","Total",1576,125,67,58,1451,58,274,349,232,94,130,314
"2011","Swansea 020D","W01000771","Total",1331,116,68,48,1215,54,236,271,158,55,156,285
"2011","Swansea 021A","W01000849","Total",1872,246,105,141,1626,250,150,420,256,56,182,312
"2011","Swansea 021B","W01000850","Total",2260,553,147,406,1707,142,204,250,510,84,176,341
"2011","Swansea 021C","W01000851","Total",1544,211,76,135,1333,131,144,270,268,52,154,314
"2011","Swansea 021D","W01000852","Total",1511,190,85,105,1321,102,154,268,220,63,218,296
"2011","Swansea 022A","W01000853","Total",1450,156,75,81,1294,45,220,317,208,82,124,298
"2011","Swansea 022B","W01000854","Total",1310,125,47,78,1185,50,110,336,234,65,127,263
"2011","Swansea 022C","W01000855","Total",1484,175,100,75,1309,28,292,306,208,62,116,297
"2011","Swansea 022D","W01000856","Total",1726,589,247,342,1137,121,188,219,198,93,118,200
"2011","Swansea 022E","W01000857","Total",1752,431,278,153,1321,58,266,278,216,92,148,263
"2011","Swansea 023B","W01000781","Total",1701,174,124,50,1527,45,360,321,208,101,203,289
"2011","Swansea 023C","W01000782","Total",1080,167,99,68,913,40,222,183,188,42,48,190
"2011","Swansea 023E","W01001956","Total",1780,276,122,154,1504,77,226,320,262,60,166,393
"2011","Swansea 024A","W01000747","Total",1870,311,67,244,1559,36,54,153,236,60,183,837
"2011","Swansea 024B","W01000868","Total",1118,113,52,61,1005,29,154,258,246,37,89,192
"2011","Swansea 024C","W01000869","Total",1543,332,82,250,1211,42,142,142,266,59,141,419
"2011","Swansea 024D","W01000870","Total",1524,239,47,192,1285,61,92,215,248,37,81,551
"2011","Swansea 024E","W01000872","Total",1384,197,106,91,1187,53,162,290,246,92,82,262
"2011","Swansea 024F","W01000874","Total",2085,212,94,118,1873,31,108,194,192,26,164,1158
"2011","Swansea 025B","W01000745","Total",2213,532,78,454,1681,72,112,189,386,68,181,673
"2011","Swansea 025C","W01000746","Total",1659,340,75,265,1319,82,104,112,356,37,78,550
"2011","Swansea 025E","W01001938","Total",1154,517,75,442,637,8,80,60,400,0,4,85
"2011","Swansea 025F","W01001955","Total",1501,888,205,683,613,18,94,64,322,0,11,104
"2011","Swansea 025G","W01001957","Total",800,197,60,137,603,37,86,103,134,29,55,159
"2011","Swansea 025H","W01001958","Total",1282,499,95,404,783,14,72,108,444,10,12,123
"2011","Swansea 026A","W01000749","Total",1853,419,231,188,1434,75,186,219,232,67,139,516
"2011","Swansea 026B","W01000871","Total",1765,277,55,222,1488,35,86,87,278,53,117,832
"2011","Swansea 026C","W01000873","Total",1713,198,29,169,1515,22,54,39,282,13,130,975
"2011","Swansea 026D","W01000875","Total",2015,310,93,217,1705,21,90,91,230,53,78,1142
"2011","Swansea 026E","W01000876","Total",2050,148,41,107,1902,33,90,154,182,35,109,1299
"2011","Swansea 027A","W01000858","Total",1629,190,83,107,1439,27,170,293,316,79,127,427
"2011","Swansea 027B","W01000859","Total",1415,233,145,88,1182,6,384,200,172,21,124,275
"2011","Swansea 027C","W01000860","Total",1461,152,101,51,1309,23,340,211,218,66,133,318
"2011","Swansea 027D","W01000861","Total",905,193,119,74,712,13,152,151,138,18,61,179
"2011","Swansea 028A","W01000736","Total",1715,216,147,69,1499,62,364,370,216,71,95,321
"2011","Swansea 028B","W01000737","Total",1466,249,144,105,1217,52,292,262,216,70,93,232
"2011","Swansea 028C","W01000804","Total",1480,290,185,105,1190,31,334,304,198,79,108,136
"2011","Swansea 028D","W01000805","Total",1193,97,65,32,1096,25,224,236,176,50,195,190
"2011","Swansea 029A","W01000879","Total",1758,212,111,101,1546,35,344,369,268,65,182,283
"2011","Swansea 029B","W01000880","Total",1572,279,187,92,1293,50,334,267,212,61,68,301
"2011","Swansea 029C","W01000881","Total",1331,350,167,183,981,82,174,167,208,92,76,182
"2011","Swansea 029D","W01000882","Total",1729,302,164,138,1427,206,248,334,206,64,113,256
"2011","Swansea 030A","W01000775","Total",1811,178,94,84,1633,80,276,328,254,90,221,384
"2011","Swansea 030B","W01000776","Total",1773,175,94,81,1598,39,320,349,266,134,178,312
"2011","Swansea 030C","W01000839","Total",1010,148,91,57,862,36,234,217,96,70,93,116
"2011","Swansea 030D","W01000840","Total",1655,169,104,65,1486,31,410,336,194,104,113,298
"2011","Swansea 031A","W01000823","Total",1712,188,132,56,1524,17,386,319,238,111,162,291
"2011","Swansea 031B","W01000824","Total",1504,313,155,158,1191,69,292,248,248,77,86,171
"2011","Swansea 031C","W01000825","Total",1436,275,120,155,1161,61,224,235,270,35,103,233
"2011","Swansea 031D","W01000826","Total",1350,232,121,111,1118,34,270,229,190,72,74,249
"2011","Swansea 031E","W01000827","Total",1356,208,99,109,1148,38,190,248,234,100,87,251
"2011","Neath Port Talbot 002A","W01000918","Total",1906,273,138,135,1633,97,212,406,280,54,168,416
"2011","Neath Port Talbot 002B","W01000944","Total",1191,158,77,81,1033,69,170,232,178,59,80,245
"2011","Neath Port Talbot 002C","W01000965","Total",2094,228,123,105,1866,138,260,417,280,111,190,470
"2011","Neath Port Talbot 003A","W01000893","Total",1989,203,106,97,1786,122,250,352,284,61,250,467
"2011","Neath Port Talbot 003B","W01000925","Total",1536,201,99,102,1335,114,170,242,196,159,146,308
"2011","Neath Port Talbot 003C","W01000926","Total",1859,268,136,132,1591,116,346,326,266,45,132,360
"2011","Neath Port Talbot 004A","W01000888","Total",2295,228,105,123,2067,125,202,556,388,68,246,482
"2011","Neath Port Talbot 004B","W01000946","Total",1522,157,77,80,1365,82,176,290,206,73,191,347
"2011","Neath Port Talbot 004C","W01000947","Total",2033,255,104,151,1778,209,178,387,292,153,187,372
"2011","Neath Port Talbot 004D","W01000948","Total",1765,331,151,180,1434,76,208,303,292,35,181,339
"2011","Neath Port Talbot 004E","W01000955","Total",1261,140,75,65,1121,54,184,268,156,61,132,266
"2011","Neath Port Talbot 004F","W01000956","Total",1180,136,98,38,1044,27,210,231,216,45,62,253
"2011","Neath Port Talbot 004G","W01000971","Total",1398,165,80,85,1233,91,154,253,228,61,141,305
"2011","Neath Port Talbot 005A","W01000887","Total",2400,211,84,127,2189,155,240,622,372,117,242,441
"2011","Neath Port Talbot 005B","W01000953","Total",1720,207,98,109,1513,85,214,324,248,98,205,339
"2011","Neath Port Talbot 005C","W01000954","Total",1415,198,101,97,1217,92,178,239,248,42,144,274
"2011","Neath Port Talbot 005D","W01000970","Total",1157,158,92,66,999,52,120,230,166,56,109,266
"2011","Neath Port Talbot 006A","W01000902","Total",1018,108,66,42,910,37,210,163,150,36,85,229
"2011","Neath Port Talbot 006B","W01000903","Total",1116,123,81,42,993,15,208,188,206,37,86,253
"2011","Neath Port Talbot 006C","W01000904","Total",1529,139,50,89,1390,75,182,456,304,75,108,190
"2011","Neath Port Talbot 006D","W01000905","Total",1556,148,60,88,1408,133,146,360,224,83,155,307
"2011","Neath Port Talbot 006E","W01000908","Total",1681,226,135,91,1455,37,308,352,220,82,150,306
"2011","Neath Port Talbot 007A","W01000906","Total",1035,107,63,44,928,25,250,126,160,17,92,258
"2011","Neath Port Talbot 007B","W01000907","Total",1750,245,114,131,1505,156,222,385,194,73,188,287
"2011","Neath Port Talbot 007C","W01000922","Total",1670,234,108,126,1436,115,174,351,226,81,172,317
"2011","Neath Port Talbot 007D","W01000923","Total",1472,171,86,85,1301,77,246,225,268,71,112,302
"2011","Neath Port Talbot 008A","W01000934","Total",1263,248,81,167,1015,93,132,240,234,62,68,186
"2011","Neath Port Talbot 008B","W01000935","Total",1580,411,144,267,1169,94,198,174,240,30,130,303
"2011","Neath Port Talbot 008C","W01000938","Total",1324,219,137,82,1105,25,238,206,152,51,109,324
"2011","Neath Port Talbot 008D","W01000939","Total",1222,373,160,213,849,65,144,166,214,20,85,155
"2011","Neath Port Talbot 008E","W01000940","Total",1284,201,91,110,1083,131,138,244,220,73,61,216
"2011","Neath Port Talbot 009A","W01000909","Total",1151,131,66,65,1020,61,170,171,194,53,116,255
"2011","Neath Port Talbot 009B","W01000910","Total",1470,165,75,90,1305,29,204,277,306,53,108,328
"2011","Neath Port Talbot 009C","W01000911","Total",1254,82,42,40,1172,26,148,330,226,31,120,291
"2011","Neath Port Talbot 009D","W01000969","Total",1260,119,58,61,1141,31,164,256,180,35,145,330
"2011","Neath Port Talbot 010A","W01000912","Total",1162,187,102,85,975,75,142,195,180,30,107,246
"2011","Neath Port Talbot 010B","W01000913","Total",1158,188,86,102,970,47,144,177,196,58,126,222
"2011","Neath Port Talbot 010C","W01000914","Total",1563,182,70,112,1381,121,136,333,228,95,168,300
"2011","Neath Port Talbot 010D","W01000915","Total",1205,116,55,61,1089,64,160,278,172,82,93,240
"2011","Neath Port Talbot 010E","W01000916","Total",1162,120,56,64,1042,49,122,291,192,71,109,208
"2011","Neath Port Talbot 010F","W01000917","Total",2650,241,114,127,2409,110,262,609,530,89,262,547
"2011","Neath Port Talbot 011A","W01000920","Total",1256,141,62,79,1115,74,140,221,162,78,134,306
"2011","Neath Port Talbot 011B","W01000921","Total",1544,215,93,122,1329,166,184,204,202,92,226,255
"2011","Neath Port Talbot 011C","W01000924","Total",1096,127,60,67,969,93,146,166,138,47,135,244
"2011","Neath Port Talbot 011D","W01000930","Total",1362,213,106,107,1149,128,154,200,184,70,126,287
"2011","Neath Port Talbot 012A","W01000936","Total",1518,171,64,107,1347,142,104,313,250,116,134,288
"2011","Neath Port Talbot 012B","W01000941","Total",1522,207,79,128,1315,119,122,310,208,115,180,261
"2011","Neath Port Talbot 012C","W01000942","Total",1887,235,98,137,1652,171,144,432,232,111,203,359
"2011","Neath Port Talbot 012D","W01000943","Total",1547,125,71,54,1422,45,238,399,210,67,164,299
"2011","Neath Port Talbot 013A","W01000894","Total",1355,205,115,90,1150,66,216,215,194,71,149,239
"2011","Neath Port Talbot 013B","W01000895","Total",1539,349,136,213,1190,110,134,310,288,46,82,220
"2011","Neath Port Talbot 013C","W01000896","Total",1686,125,53,72,1561,189,168,307,222,110,233,332
"2011","Neath Port Talbot 013D","W01000897","Total",1316,188,91,97,1128,55,192,249,218,70,102,242
"2011","Neath Port Talbot 013E","W01000937","Total",2025,372,109,263,1653,122,176,398,326,134,185,312
"2011","Neath Port Talbot 014A","W01000898","Total",1468,187,85,102,1281,76,168,317,234,72,131,283
"2011","Neath Port Talbot 014B","W01000899","Total",1679,161,77,84,1518,58,214,396,278,71,180,321
"2011","Neath Port Talbot 014C","W01000900","Total",1674,294,128,166,1380,139,190,286,262,41,145,317
"2011","Neath Port Talbot 014D","W01000901","Total",1680,206,96,110,1474,133,206,337,268,63,147,320
"2011","Neath Port Talbot 014E","W01000945","Total",1152,137,66,71,1015,59,118,239,202,72,76,249
"2011","Neath Port Talbot 015A","W01000889","Total",1789,238,102,136,1551,50,278,341,292,72,131,387
"2011","Neath Port Talbot 015B","W01000890","Total",1656,141,79,62,1515,31,256,382,258,56,162,370
"2011","Neath Port Talbot 015C","W01000891","Total",1465,207,115,92,1258,131,144,234,186,76,180,307
"2011","Neath Port Talbot 015D","W01000892","Total",1859,205,116,89,1654,51,366,385,294,47,156,355
"2011","Neath Port Talbot 016A","W01000883","Total",1404,162,68,94,1242,50,174,213,292,25,107,381
"2011","Neath Port Talbot 016B","W01000958","Total",1605,176,78,98,1429,177,126,240,218,123,215,330
"2011","Neath Port Talbot 016C","W01000961","Total",1611,237,139,98,1374,158,232,219,188,93,146,338
"2011","Neath Port Talbot 016D","W01000962","Total",1577,139,64,75,1438,194,112,254,204,106,206,362
"2011","Neath Port Talbot 016E","W01000963","Total",1789,269,162,107,1520,165,200,255,212,89,262,337
"2011","Neath Port Talbot 016F","W01000964","Total",1736,243,125,118,1493,167,252,240,244,93,165,332
"2011","Neath Port Talbot 017A","W01000884","Total",1244,160,60,100,1084,103,124,233,162,92,101,269
"2011","Neath Port Talbot 017B","W01000885","Total",1320,256,115,141,1064,90,132,246,174,116,80,226
"2011","Neath Port Talbot 017C","W01000886","Total",1478,265,69,196,1213,94,116,265,242,102,115,279
"2011","Neath Port Talbot 017D","W01000957","Total",1642,375,175,200,1267,123,238,216,218,26,123,323
"2011","Neath Port Talbot 017E","W01000959","Total",1818,215,87,128,1603,95,202,366,268,61,197,414
"2011","Neath Port Talbot 017F","W01000960","Total",1722,277,123,154,1445,138,180,302,262,42,171,350
"2011","Neath Port Talbot 018A","W01000949","Total",1337,149,70,79,1188,58,198,221,216,31,153,311
"2011","Neath Port Talbot 018B","W01000950","Total",1550,213,86,127,1337,89,136,289,258,86,145,334
"2011","Neath Port Talbot 018C","W01000951","Total",1538,219,74,145,1319,66,120,258,206,111,184,374
"2011","Neath Port Talbot 018D","W01000952","Total",1171,145,71,74,1026,27,98,238,196,63,149,255
"2011","Neath Port Talbot 018E","W01000966","Total",1413,196,98,98,1217,73,208,264,222,49,115,286
"2011","Neath Port Talbot 019A","W01000932","Total",1043,183,78,105,860,57,162,145,146,20,116,214
"2011","Neath Port Talbot 019B","W01000933","Total",1973,124,41,83,1849,65,192,620,320,104,250,298
"2011","Neath Port Talbot 019C","W01000967","Total",1470,253,89,164,1217,133,158,222,212,78,128,286
"2011","Neath Port Talbot 019D","W01000968","Total",1897,181,73,108,1716,135,242,402,338,79,148,372
"2011","Neath Port Talbot 020A","W01000919","Total",1170,141,63,78,1029,42,144,257,214,56,97,219
"2011","Neath Port Talbot 020B","W01000927","Total",1644,198,64,134,1446,104,164,340,290,106,135,307
"2011","Neath Port Talbot 020C","W01000928","Total",1566,226,105,121,1340,102,184,282,240,47,190,295
"2011","Neath Port Talbot 020D","W01000929","Total",1307,169,72,97,1138,100,144,242,196,95,126,235
"2011","Neath Port Talbot 020E","W01000931","Total",1330,161,74,87,1169,66,152,263,208,105,160,215
"2011","Neath Port Talbot 020F","W01000973","Total",1457,264,138,126,1193,97,160,253,210,88,138,247
"2011","Neath Port Talbot 020G","W01001900","Total",1539,213,90,123,1326,146,170,299,258,81,142,230
"2011","Bridgend 001A","W01000991","Total",1131,135,58,77,996,129,108,153,162,86,147,211
"2011","Bridgend 001B","W01000992","Total",1505,193,89,104,1312,171,132,257,182,68,191,311
"2011","Bridgend 001C","W01000993","Total",1525,166,72,94,1359,166,128,319,212,77,173,284
"2011","Bridgend 001D","W01000994","Total",1398,149,52,97,1249,148,140,248,200,105,139,269
"2011","Bridgend 001E","W01000995","Total",1436,211,101,110,1225,108,194,266,220,56,125,256
"2011","Bridgend 002A","W01001014","Total",1640,303,154,149,1337,98,178,334,252,49,135,291
"2011","Bridgend 002B","W01001015","Total",1473,147,72,75,1326,112,152,258,220,94,179,311
"2011","Bridgend 002C","W01001017","Total",1477,154,83,71,1323,60,168,326,202,72,168,327
"2011","Bridgend 002D","W01001018","Total",1387,209,74,135,1178,84,140,265,270,46,128,245
"2011","Bridgend 002E","W01001020","Total",1436,180,55,125,1256,125,122,259,224,99,142,285
"2011","Bridgend 003A","W01000976","Total",1105,106,52,54,999,95,112,217,166,72,113,224
"2011","Bridgend 003B","W01000977","Total",1388,145,71,74,1243,64,160,229,258,112,134,286
"2011","Bridgend 003C","W01001024","Total",1144,161,66,95,983,85,120,204,180,43,125,226
"2011","Bridgend 003D","W01001025","Total",1200,156,68,88,1044,82,132,216,184,47,145,238
"2011","Bridgend 003E","W01001033","Total",1738,214,99,115,1524,121,194,409,250,86,186,278
"2011","Bridgend 003F","W01001034","Total",1379,257,104,153,1122,80,136,240,242,40,140,244
"2011","Bridgend 004A","W01000975","Total",2253,207,100,107,2046,211,214,434,324,190,259,414
"2011","Bridgend 004B","W01000978","Total",1789,242,119,123,1547,121,170,349,284,106,193,324
"2011","Bridgend 004C","W01001009","Total",1243,107,36,71,1136,54,156,208,208,98,149,263
"2011","Bridgend 004D","W01001042","Total",1338,166,63,103,1172,105,128,320,220,63,135,201
"2011","Bridgend 004E","W01001043","Total",1161,145,63,82,1016,51,134,271,190,59,102,209
"2011","Bridgend 005A","W01001012","Total",1563,103,37,66,1460,45,166,423,212,100,220,294
"2011","Bridgend 005B","W01001013","Total",1469,183,113,70,1286,84,206,257,216,48,127,348
"2011","Bridgend 005C","W01001016","Total",1658,204,115,89,1454,84,338,259,246,36,155,336
"2011","Bridgend 005D","W01001019","Total",1511,171,90,81,1340,107,176,260,196,75,173,353
"2011","Bridgend 006A","W01000974","Total",2039,259,110,149,1780,155,216,375,384,62,141,447
"2011","Bridgend 006B","W01001057","Total",1415,225,73,152,1190,106,138,293,270,51,98,234
"2011","Bridgend 006C","W01001058","Total",1903,177,78,99,1726,125,188,474,318,69,232,320
"2011","Bridgend 007A","W01000986","Total",1319,163,49,114,1156,100,90,332,254,30,130,220
"2011","Bridgend 007B","W01000987","Total",2252,263,102,161,1989,235,218,459,374,129,247,327
"2011","Bridgend 007C","W01001055","Total",1225,156,67,89,1069,101,146,167,156,117,125,257
"2011","Bridgend 007D","W01001056","Total",1218,132,74,58,1086,39,176,158,164,37,154,358
"2011","Bridgend 008A","W01000996","Total",1481,181,89,92,1300,69,204,268,222,56,119,362
"2011","Bridgend 008B","W01001048","Total",1401,174,67,107,1227,72,162,297,248,50,118,280
"2011","Bridgend 008C","W01001049","Total",1315,141,70,71,1174,116,148,205,144,87,173,301
"2011","Bridgend 008D","W01001050","Total",1539,198,104,94,1341,129,144,237,266,46,179,340
"2011","Bridgend 008E","W01001051","Total",1782,179,60,119,1603,193,158,409,232,96,204,311
"2011","Bridgend 008F","W01001052","Total",1354,224,110,114,1130,94,134,231,198,93,117,263
"2011","Bridgend 009A","W01001004","Total",1086,162,79,83,924,45,162,178,162,61,109,207
"2011","Bridgend 009B","W01001005","Total",1657,214,118,96,1443,81,232,316,318,78,148,270
"2011","Bridgend 009C","W01001006","Total",2377,171,97,74,2206,87,380,466,388,109,300,476
"2011","Bridgend 009D","W01001007","Total",1748,147,73,74,1601,138,178,389,316,126,124,330
"2011","Bridgend 009E","W01001039","Total",1664,174,64,110,1490,46,186,350,256,118,185,349
"2011","Bridgend 009F","W01001040","Total",1491,140,65,75,1351,49,186,302,276,111,167,260
"2011","Bridgend 010A","W01000999","Total",1381,180,105,75,1201,121,210,202,204,83,95,286
"2011","Bridgend 010B","W01001000","Total",1713,196,93,103,1517,92,194,348,306,88,155,334
"2011","Bridgend 010C","W01001001","Total",1449,165,82,83,1284,126,236,262,214,83,106,257
"2011","Bridgend 010D","W01001002","Total",2449,323,73,250,2126,321,134,509,466,164,203,329
"2011","Bridgend 011A","W01000998","Total",1215,110,38,72,1105,57,154,292,258,45,101,198
"2011","Bridgend 011B","W01001008","Total",2147,197,119,78,1950,61,424,432,330,57,190,456
"2011","Bridgend 011C","W01001038","Total",2166,286,156,130,1880,120,250,464,326,168,202,350
"2011","Bridgend 012A","W01000997","Total",1537,188,110,78,1349,45,332,237,252,61,168,254
"2011","Bridgend 012B","W01001010","Total",1219,149,45,104,1070,124,82,179,198,93,142,252
"2011","Bridgend 012C","W01001011","Total",1384,157,64,93,1227,63,130,328,224,90,121,271
"2011","Bridgend 012D","W01001026","Total",1967,272,161,111,1695,120,206,311,262,108,293,395
"2011","Bridgend 013A","W01000989","Total",1413,126,72,54,1287,38,226,257,212,64,182,308
"2011","Bridgend 013B","W01001037","Total",1539,183,109,74,1356,42,266,288,250,51,150,309
"2011","Bridgend 013C","W01001041","Total",2336,152,83,69,2184,100,364,515,384,81,256,484
"2011","Bridgend 014A","W01001021","Total",1594,315,140,175,1279,48,162,359,274,48,120,268
"2011","Bridgend 014B","W01001022","Total",1393,222,98,124,1171,167,164,168,194,130,126,222
"2011","Bridgend 014C","W01001023","Total",1696,326,141,185,1370,88,178,222,294,54,178,356
"2011","Bridgend 014D","W01001028","Total",1846,239,102,137,1607,53,290,336,334,62,157,375
"2011","Bridgend 014E","W01001035","Total",1608,274,116,158,1334,143,138,286,276,78,131,282
"2011","Bridgend 015A","W01000979","Total",1702,166,38,128,1536,171,90,371,324,125,166,289
"2011","Bridgend 015B","W01000983","Total",1539,150,34,116,1389,101,88,449,322,62,120,247
"2011","Bridgend 015C","W01000985","Total",1399,87,17,70,1312,40,66,378,228,52,216,332
"2011","Bridgend 015D","W01001003","Total",1278,148,92,56,1130,18,318,159,230,40,128,237
"2011","Bridgend 016A","W01000980","Total",1383,123,39,84,1260,95,100,245,256,65,153,346
"2011","Bridgend 016B","W01000981","Total",1186,145,38,107,1041,200,46,248,162,86,114,185
"2011","Bridgend 016C","W01000982","Total",1459,154,64,90,1305,86,192,262,260,32,105,368
"2011","Bridgend 016D","W01000984","Total",2157,264,66,198,1893,187,138,494,440,120,200,314
"2011","Bridgend 017B","W01000990","Total",1519,221,106,115,1298,131,168,240,180,108,168,303
"2011","Bridgend 017C","W01001027","Total",1571,232,156,76,1339,69,296,274,214,74,111,301
"2011","Bridgend 017D","W01001036","Total",1541,174,114,60,1367,45,202,281,228,52,160,399
"2011","Bridgend 017E","W01001918","Total",1593,61,8,53,1532,60,56,695,218,138,200,165
"2011","Bridgend 017F","W01001919","Total",1405,90,11,79,1315,69,62,521,280,108,104,171
"2011","Bridgend 017G","W01001920","Total",1206,64,13,51,1142,41,68,395,216,87,144,191
"2011","Bridgend 017H","W01001921","Total",1577,105,14,91,1472,140,74,542,210,132,190,184
"2011","Bridgend 018A","W01001031","Total",1445,156,97,59,1289,26,276,278,226,51,125,307
"2011","Bridgend 018B","W01001032","Total",1769,268,195,73,1501,79,350,321,224,84,130,313
"2011","Bridgend 018C","W01001046","Total",1727,381,213,168,1346,137,228,210,258,56,150,307
"2011","Bridgend 018D","W01001047","Total",1669,264,138,126,1405,53,304,302,204,88,184,270
"2011","Bridgend 018E","W01001053","Total",1010,142,98,44,868,22,244,150,128,36,91,197
"2011","Bridgend 018F","W01001054","Total",1181,161,107,54,1020,5,304,167,128,56,133,227
"2011","Bridgend 019A","W01001029","Total",1717,247,144,103,1470,47,312,291,318,66,122,314
"2011","Bridgend 019B","W01001030","Total",1763,206,131,75,1557,50,296,361,286,98,138,328
"2011","Bridgend 019C","W01001044","Total",1663,276,160,116,1387,110,254,253,218,93,136,323
"2011","Bridgend 019D","W01001045","Total",1718,233,104,129,1485,97,190,309,256,91,180,362
"2011","The Vale of Glamorgan 001A","W01001105","Total",2643,188,113,75,2455,58,412,617,370,165,309,524
"2011","The Vale of Glamorgan 001B","W01001127","Total",1199,134,71,63,1065,43,234,230,254,40,84,180
"2011","The Vale of Glamorgan 001C","W01001128","Total",1439,139,76,63,1300,33,222,269,234,83,117,342
"2011","The Vale of Glamorgan 002A","W01001082","Total",1500,285,177,108,1215,48,350,202,248,47,110,210
"2011","The Vale of Glamorgan 002B","W01001083","Total",1592,134,86,48,1458,16,324,293,264,116,152,293
"2011","The Vale of Glamorgan 002C","W01001084","Total",1534,233,129,104,1301,52,310,283,258,66,104,228
"2011","The Vale of Glamorgan 002D","W01001085","Total",1506,111,52,59,1395,13,224,405,206,78,151,318
"2011","The Vale of Glamorgan 003A","W01001113","Total",2272,203,98,105,2069,51,374,537,318,193,268,328
"2011","The Vale of Glamorgan 003B","W01001119","Total",1725,141,61,80,1584,56,208,382,288,139,204,307
"2011","The Vale of Glamorgan 003C","W01001135","Total",1494,123,66,57,1371,28,258,317,234,102,142,290
"2011","The Vale of Glamorgan 003D","W01001136","Total",1140,125,76,49,1015,27,240,209,180,51,91,217
"2011","The Vale of Glamorgan 004A","W01001075","Total",1197,140,72,68,1057,47,134,307,164,61,137,207
"2011","The Vale of Glamorgan 004B","W01001076","Total",1461,184,57,127,1277,147,100,319,256,83,104,268
"2011","The Vale of Glamorgan 004C","W01001077","Total",1391,202,116,86,1189,67,222,217,164,81,140,298
"2011","The Vale of Glamorgan 004D","W01001078","Total",1263,127,79,48,1136,67,150,310,158,56,140,255
"2011","The Vale of Glamorgan 004E","W01001104","Total",1950,245,116,129,1705,83,312,373,342,45,220,330
"2011","The Vale of Glamorgan 004F","W01001129","Total",1384,120,83,37,1264,72,142,283,138,112,201,316
"2011","The Vale of Glamorgan 005A","W01001116","Total",1876,286,169,117,1590,41,292,374,256,118,195,314
"2011","The Vale of Glamorgan 005B","W01001123","Total",1598,391,152,239,1207,68,228,247,310,35,95,224
"2011","The Vale of Glamorgan 005C","W01001124","Total",1463,278,69,209,1185,76,116,291,224,81,146,251
"2011","The Vale of Glamorgan 005D","W01001125","Total",1417,221,103,118,1196,82,134,322,172,113,111,262
"2011","The Vale of Glamorgan 005E","W01001126","Total",1908,450,74,376,1458,93,154,256,604,52,105,194
"2011","The Vale of Glamorgan 005F","W01001130","Total",1279,161,73,88,1118,50,126,328,174,92,113,235
"2011","The Vale of Glamorgan 006A","W01001086","Total",1485,168,95,73,1317,44,276,277,238,85,98,299
"2011","The Vale of Glamorgan 006B","W01001087","Total",1543,177,114,63,1366,76,294,251,186,81,149,329
"2011","The Vale of Glamorgan 006C","W01001088","Total",1826,261,173,88,1565,141,304,245,240,119,197,319
"2011","The Vale of Glamorgan 006D","W01001089","Total",1427,155,90,65,1272,49,216,278,208,66,142,313
"2011","The Vale of Glamorgan 006E","W01001090","Total",1470,142,88,54,1328,71,260,287,220,72,133,285
"2011","The Vale of Glamorgan 007A","W01001081","Total",1532,227,87,140,1305,200,140,275,184,89,195,222
"2011","The Vale of Glamorgan 007B","W01001092","Total",1677,173,79,94,1504,149,186,302,192,101,224,350
"2011","The Vale of Glamorgan 007C","W01001094","Total",1333,116,36,80,1217,189,112,289,192,78,148,209
"2011","The Vale of Glamorgan 007D","W01001095","Total",1509,243,95,148,1266,215,100,273,190,152,139,197
"2011","The Vale of Glamorgan 007E","W01001096","Total",1372,218,123,95,1154,65,198,249,212,62,128,240
"2011","The Vale of Glamorgan 007F","W01001097","Total",1674,129,58,71,1545,222,130,221,168,151,358,295
"2011","The Vale of Glamorgan 008A","W01001114","Total",1565,171,132,39,1394,19,302,326,208,84,161,294
"2011","The Vale of Glamorgan 008B","W01001115","Total",2170,235,154,81,1935,88,298,562,222,185,234,346
"2011","The Vale of Glamorgan 008C","W01001131","Total",1720,260,127,133,1460,114,162,433,254,77,219,201
"2011","The Vale of Glamorgan 008D","W01001132","Total",1370,172,78,94,1198,63,130,319,236,68,138,244
"2011","The Vale of Glamorgan 008E","W01001133","Total",1996,271,125,146,1725,37,426,308,308,108,165,373
"2011","The Vale of Glamorgan 008F","W01001134","Total",1144,187,82,105,957,38,166,247,218,44,89,155
"2011","The Vale of Glamorgan 009A","W01001067","Total",1364,266,123,143,1098,96,154,228,194,71,133,222
"2011","The Vale of Glamorgan 009B","W01001068","Total",1767,200,39,161,1567,157,96,458,318,99,172,267
"2011","The Vale of Glamorgan 009C","W01001070","Total",1143,222,34,188,921,101,46,224,230,95,103,122
"2011","The Vale of Glamorgan 009D","W01001071","Total",1577,190,77,113,1387,143,142,343,240,78,144,297
"2011","The Vale of Glamorgan 009E","W01001072","Total",2676,157,41,116,2519,144,206,781,448,119,315,506
"2011","The Vale of Glamorgan 010A","W01001091","Total",1662,187,107,80,1475,58,292,264,254,40,172,395
"2011","The Vale of Glamorgan 010B","W01001098","Total",1071,112,66,46,959,31,192,175,200,29,101,231
"2011","The Vale of Glamorgan 010C","W01001100","Total",1500,173,117,56,1327,38,206,301,238,83,140,321
"2011","The Vale of Glamorgan 010D","W01001103","Total",1244,125,56,69,1119,57,180,216,206,71,147,242
"2011","The Vale of Glamorgan 011A","W01001106","Total",1423,125,78,47,1298,41,236,247,202,66,116,390
"2011","The Vale of Glamorgan 011B","W01001107","Total",1547,215,140,75,1332,53,346,227,234,46,125,301
"2011","The Vale of Glamorgan 011C","W01001109","Total",1473,177,115,62,1296,57,250,283,194,73,176,263
"2011","The Vale of Glamorgan 011D","W01001110","Total",1231,148,66,82,1083,51,194,222,206,83,139,188
"2011","The Vale of Glamorgan 011E","W01001111","Total",1482,142,73,69,1340,137,202,238,176,118,161,308
"2011","The Vale of Glamorgan 011F","W01001112","Total",1441,141,41,100,1300,97,138,433,240,72,118,202
"2011","The Vale of Glamorgan 012A","W01001063","Total",1737,192,54,138,1545,176,124,353,264,130,159,339
"2011","The Vale of Glamorgan 012B","W01001065","Total",1592,180,91,89,1412,147,132,283,228,118,230,274
"2011","The Vale of Glamorgan 012C","W01001069","Total",1459,269,64,205,1190,185,102,275,212,107,93,216
"2011","The Vale of Glamorgan 012E","W01001079","Total",1615,222,65,157,1393,226,108,349,226,111,127,246
"2011","The Vale of Glamorgan 012F","W01001080","Total",1576,171,75,96,1405,155,112,295,262,99,187,295
"2011","The Vale of Glamorgan 012G","W01001910","Total",1648,267,36,231,1381,201,54,383,266,91,159,227
"2011","The Vale of Glamorgan 012H","W01001911","Total",1195,154,49,105,1041,161,84,214,186,113,79,204
"2011","The Vale of Glamorgan 013A","W01001062","Total",1341,168,64,104,1173,56,132,294,148,87,176,280
"2011","The Vale of Glamorgan 013B","W01001064","Total",1326,266,90,176,1060,175,118,211,188,66,117,185
"2011","The Vale of Glamorgan 013C","W01001093","Total",1720,288,141,147,1432,160,152,249,282,127,139,323
"2011","The Vale of Glamorgan 013D","W01001099","Total",1341,226,131,95,1115,97,124,289,168,98,131,208
"2011","The Vale of Glamorgan 013E","W01001101","Total",1500,259,72,187,1241,153,116,308,252,110,119,183
"2011","The Vale of Glamorgan 013F","W01001102","Total",1505,229,71,158,1276,161,98,366,238,101,138,174
"2011","The Vale of Glamorgan 014A","W01001108","Total",1684,202,50,152,1482,105,140,446,350,118,111,212
"2011","The Vale of Glamorgan 014B","W01001117","Total",1416,124,68,56,1292,53,210,313,252,52,125,287
"2011","The Vale of Glamorgan 014C","W01001118","Total",2380,251,101,150,2129,102,234,544,366,151,337,395
"2011","The Vale of Glamorgan 014D","W01001120","Total",1380,145,61,84,1235,59,176,285,276,48,125,266
"2011","The Vale of Glamorgan 014E","W01001121","Total",1508,189,93,96,1319,65,222,247,242,112,203,228
"2011","The Vale of Glamorgan 014F","W01001122","Total",2267,154,37,117,2113,195,84,720,276,270,264,304
"2011","The Vale of Glamorgan 015A","W01001059","Total",1312,212,126,86,1100,28,206,220,238,47,141,220
"2011","The Vale of Glamorgan 015B","W01001060","Total",1436,201,131,70,1235,37,278,262,236,46,112,264
"2011","The Vale of Glamorgan 015C","W01001061","Total",2100,305,91,214,1795,192,166,393,368,130,231,315
"2011","The Vale of Glamorgan 015D","W01001066","Total",1575,221,88,133,1354,153,122,332,256,91,173,227
"2011","The Vale of Glamorgan 015E","W01001073","Total",2001,450,131,319,1551,192,110,333,400,116,157,243
"2011","Cardiff 001A","W01001777","Total",1496,145,93,52,1351,22,308,284,172,101,173,291
"2011","Cardiff 001B","W01001778","Total",1873,98,57,41,1775,33,344,387,242,107,284,378
"2011","Cardiff 001C","W01001794","Total",1420,186,51,135,1234,110,86,355,298,71,99,215
"2011","Cardiff 001D","W01001799","Total",1176,165,100,65,1011,17,248,216,160,87,141,142
"2011","Cardiff 002A","W01001793","Total",1427,125,16,109,1302,86,74,387,276,88,150,241
"2011","Cardiff 002B","W01001795","Total",1547,179,41,138,1368,70,98,445,274,91,144,246
"2011","Cardiff 002C","W01001796","Total",1491,186,64,122,1305,83,160,308,296,55,141,262
"2011","Cardiff 002D","W01001798","Total",1481,188,76,112,1293,54,166,343,194,71,168,297
"2011","Cardiff 003A","W01001841","Total",2025,133,30,103,1892,124,96,543,318,135,283,393
"2011","Cardiff 003B","W01001842","Total",1748,172,28,144,1576,102,74,574,394,98,132,202
"2011","Cardiff 003C","W01001843","Total",2167,145,25,120,2022,72,98,717,390,173,226,346
"2011","Cardiff 003D","W01001844","Total",2028,213,36,177,1815,158,120,529,414,105,256,233
"2011","Cardiff 004A","W01001849","Total",1558,162,92,70,1396,24,278,282,214,88,192,318
"2011","Cardiff 004B","W01001852","Total",1817,169,112,57,1648,21,288,434,226,112,231,336
"2011","Cardiff 004C","W01001853","Total",1562,257,192,65,1305,48,384,263,214,30,137,229
"2011","Cardiff 004D","W01001854","Total",1572,358,261,97,1214,35,380,281,222,58,70,168
"2011","Cardiff 005A","W01001791","Total",1625,257,139,118,1368,100,248,253,232,125,172,238
"2011","Cardiff 005B","W01001792","Total",1654,254,84,170,1400,124,132,274,224,178,203,265
"2011","Cardiff 005C","W01001797","Total",1439,166,109,57,1273,48,176,280,226,87,112,344
"2011","Cardiff 005D","W01001800","Total",1535,235,136,99,1300,152,136,285,186,99,199,243
"2011","Cardiff 005F","W01001949","Total",1281,264,63,201,1017,78,58,339,310,50,70,112
"2011","Cardiff 005G","W01001953","Total",1499,219,97,122,1280,96,122,336,208,70,132,316
"2011","Cardiff 006A","W01001820","Total",1196,147,51,96,1049,79,112,305,192,53,123,185
"2011","Cardiff 006C","W01001846","Total",1727,116,51,65,1611,109,96,579,264,112,169,282
"2011","Cardiff 006D","W01001847","Total",1529,118,85,33,1411,36,326,263,250,77,126,333
"2011","Cardiff 006E","W01001948","Total",1618,110,26,84,1508,132,66,559,354,53,154,190
"2011","Cardiff 006F","W01001954","Total",1505,187,121,66,1318,21,214,350,200,70,161,302
"2011","Cardiff 007A","W01001802","Total",1588,213,124,89,1375,86,204,212,212,86,193,382
"2011","Cardiff 007B","W01001807","Total",1567,155,60,95,1412,247,104,257,144,156,223,281
"2011","Cardiff 007C","W01001808","Total",1634,175,74,101,1459,324,94,295,160,110,214,262
"2011","Cardiff 007D","W01001840","Total",1752,219,82,137,1533,83,142,309,352,101,185,361
"2011","Cardiff 008A","W01001730","Total",1489,193,137,56,1296,12,286,248,200,100,176,274
"2011","Cardiff 008B","W01001731","Total",1446,102,60,42,1344,40,200,354,154,85,234,277
"2011","Cardiff 008C","W01001736","Total",1395,169,121,48,1226,21,246,296,200,94,123,246
"2011","Cardiff 008D","W01001815","Total",1353,94,40,54,1259,65,122,299,224,82,190,277
"2011","Cardiff 009A","W01001811","Total",1503,120,27,93,1383,259,94,275,176,198,189,192
"2011","Cardiff 009B","W01001816","Total",2521,320,32,288,2201,316,100,639,458,161,269,258
"2011","Cardiff 009C","W01001817","Total",1402,136,62,74,1266,108,110,261,206,71,202,308
"2011","Cardiff 009D","W01001818","Total",1528,186,46,140,1342,143,92,333,252,121,159,242
"2011","Cardiff 010A","W01001888","Total",1686,186,65,121,1500,93,150,397,286,127,180,267
"2011","Cardiff 010B","W01001893","Total",1871,242,89,153,1629,125,142,415,296,66,223,362
"2011","Cardiff 010C","W01001894","Total",1589,172,94,78,1417,39,210,392,200,82,166,328
"2011","Cardiff 010D","W01001895","Total",1546,469,201,268,1077,93,154,292,208,75,80,175
"2011","Cardiff 011A","W01001877","Total",1710,186,52,134,1524,84,128,419,356,74,165,298
"2011","Cardiff 011B","W01001878","Total",1494,185,40,145,1309,146,90,328,274,92,139,240
"2011","Cardiff 011C","W01001882","Total",1824,173,44,129,1651,189,86,470,384,97,199,226
"2011","Cardiff 011D","W01001885","Total",2017,210,43,167,1807,235,98,466,282,223,242,261
"2011","Cardiff 012A","W01001773","Total",2517,263,98,165,2254,103,210,680,364,210,263,424
"2011","Cardiff 012B","W01001848","Total",1447,160,99,61,1287,48,200,419,248,58,77,237
"2011","Cardiff 012C","W01001850","Total",1931,188,126,62,1743,24,342,448,246,116,190,377
"2011","Cardiff 012D","W01001851","Total",1482,271,136,135,1211,31,254,304,190,87,105,240
"2011","Cardiff 013A","W01001879","Total",1904,280,105,175,1624,258,126,442,244,153,213,188
"2011","Cardiff 013B","W01001880","Total",1554,130,20,110,1424,313,48,340,188,183,188,164
"2011","Cardiff 013C","W01001881","Total",1438,229,78,151,1209,170,100,256,240,75,150,218
"2011","Cardiff 013D","W01001884","Total",1374,117,16,101,1257,395,30,222,152,153,155,150
"2011","Cardiff 014A","W01001727","Total",1109,112,46,66,997,51,146,229,184,50,120,217
"2011","Cardiff 014B","W01001728","Total",1478,110,45,65,1368,54,214,381,206,82,133,298
"2011","Cardiff 014C","W01001729","Total",2140,141,42,99,1999,119,168,563,352,128,237,432
"2011","Cardiff 014D","W01001819","Total",2272,184,76,108,2088,66,324,534,352,93,260,459
"2011","Cardiff 015A","W01001803","Total",1573,280,163,117,1293,136,150,221,186,86,186,328
"2011","Cardiff 015B","W01001804","Total",1566,194,80,114,1372,146,148,241,202,112,230,293
"2011","Cardiff 015C","W01001805","Total",1490,233,75,158,1257,190,104,257,176,90,132,308
"2011","Cardiff 015D","W01001806","Total",1642,322,140,182,1320,82,260,246,212,62,153,305
"2011","Cardiff 016A","W01001866","Total",1388,219,115,104,1169,118,140,234,162,57,204,254
"2011","Cardiff 016B","W01001867","Total",1429,143,60,83,1286,191,102,193,152,189,220,239
"2011","Cardiff 016C","W01001883","Total",1600,246,72,174,1354,177,164,201,136,125,287,264
"2011","Cardiff 016D","W01001886","Total",1199,174,40,134,1025,173,92,206,116,80,130,228
"2011","Cardiff 017A","W01001809","Total",1309,159,52,107,1150,51,132,247,176,80,185,279
"2011","Cardiff 017B","W01001810","Total",1678,165,43,122,1513,165,118,339,216,179,269,227
"2011","Cardiff 017C","W01001812","Total",1292,98,41,57,1194,143,126,216,144,80,231,254
"2011","Cardiff 017D","W01001813","Total",1519,299,84,215,1220,160,108,285,142,108,179,238
"2011","Cardiff 017E","W01001814","Total",1421,260,68,192,1161,90,146,270,230,74,126,225
"2011","Cardiff 018A","W01001769","Total",1602,130,88,42,1472,20,176,437,226,82,174,357
"2011","Cardiff 018B","W01001770","Total",990,193,102,91,797,13,140,166,154,30,89,205
"2011","Cardiff 018C","W01001771","Total",1645,171,75,96,1474,50,208,438,300,67,172,239
"2011","Cardiff 018D","W01001774","Total",1399,113,70,43,1286,10,182,419,204,91,121,259
"2011","Cardiff 019A","W01001732","Total",1591,187,109,78,1404,45,232,361,220,88,190,268
"2011","Cardiff 019B","W01001733","Total",1379,205,109,96,1174,50,178,192,170,93,201,290
"2011","Cardiff 019C","W01001734","Total",1526,139,85,54,1387,17,230,335,188,96,227,294
"2011","Cardiff 019D","W01001735","Total",1543,155,101,54,1388,56,188,342,172,78,205,347
"2011","Cardiff 020A","W01001887","Total",1573,150,73,77,1423,16,192,405,188,107,173,342
"2011","Cardiff 020B","W01001889","Total",1538,297,144,153,1241,70,230,279,238,59,110,255
"2011","Cardiff 020C","W01001891","Total",1659,284,153,131,1375,85,228,309,204,93,124,332
"2011","Cardiff 020D","W01001892","Total",1437,164,107,57,1273,40,230,256,172,60,171,344
"2011","Cardiff 020E","W01001896","Total",1533,166,99,67,1367,25,186,433,226,56,149,292
"2011","Cardiff 021A","W01001772","Total",1409,157,102,55,1252,34,258,337,190,42,127,264
"2011","Cardiff 021B","W01001775","Total",1592,226,75,151,1366,45,134,366,270,71,161,319
"2011","Cardiff 021C","W01001776","Total",1339,116,66,50,1223,23,142,339,166,73,155,325
"2011","Cardiff 021D","W01001890","Total",1385,171,72,99,1214,62,176,253,252,65,128,278
"2011","Cardiff 022A","W01001863","Total",1564,174,89,85,1390,92,148,285,236,76,208,345
"2011","Cardiff 022B","W01001864","Total",1502,160,107,53,1342,54,212,269,214,64,176,353
"2011","Cardiff 022C","W01001865","Total",1297,118,67,51,1179,56,116,246,206,61,158,336
"2011","Cardiff 022D","W01001868","Total",1479,177,89,88,1302,172,142,212,212,101,205,258
"2011","Cardiff 023A","W01001785","Total",1183,146,77,69,1037,139,100,204,148,95,173,178
"2011","Cardiff 023B","W01001786","Total",1555,157,75,82,1398,124,138,304,266,110,175,281
"2011","Cardiff 023C","W01001787","Total",1461,127,46,81,1334,108,132,219,210,82,257,326
"2011","Cardiff 023D","W01001788","Total",1404,236,79,157,1168,93,122,233,156,101,248,215
"2011","Cardiff 023E","W01001789","Total",1527,270,81,189,1257,104,118,329,352,67,117,170
"2011","Cardiff 023F","W01001790","Total",1187,152,84,68,1035,105,116,226,148,68,136,236
"2011","Cardiff 024A","W01001821","Total",1163,234,142,92,929,35,150,172,184,88,144,156
"2011","Cardiff 024B","W01001826","Total",1353,133,88,45,1220,39,262,194,194,68,186,277
"2011","Cardiff 024C","W01001827","Total",1583,134,76,58,1449,55,248,294,212,122,239,279
"2011","Cardiff 024D","W01001828","Total",1535,153,106,47,1382,15,246,216,264,66,227,348
"2011","Cardiff 025A","W01001755","Total",1432,124,35,89,1308,26,60,205,234,67,73,643
"2011","Cardiff 025B","W01001756","Total",1750,197,63,134,1553,77,100,258,238,112,171,597
"2011","Cardiff 025C","W01001757","Total",1493,168,58,110,1325,43,56,250,220,106,182,468
"2011","Cardiff 025D","W01001758","Total",1784,160,55,105,1624,32,78,156,276,63,161,858
"2011","Cardiff 026A","W01001779","Total",1430,222,106,116,1208,39,210,268,210,50,117,314
"2011","Cardiff 026B","W01001780","Total",1402,196,90,106,1206,47,142,302,294,64,118,239
"2011","Cardiff 026C","W01001781","Total",1693,372,165,207,1321,37,188,351,278,96,167,204
"2011","Cardiff 026D","W01001782","Total",1427,158,74,84,1269,42,188,304,212,93,111,319
"2011","Cardiff 026E","W01001783","Total",1263,129,52,77,1134,47,102,327,198,61,147,252
"2011","Cardiff 026F","W01001784","Total",1340,192,72,120,1148,33,160,260,174,61,123,337
"2011","Cardiff 027A","W01001747","Total",1624,336,109,227,1288,81,148,319,328,65,111,236
"2011","Cardiff 027B","W01001748","Total",1569,212,107,105,1357,174,126,295,190,104,176,292
"2011","Cardiff 027C","W01001749","Total",1481,270,127,143,1211,113,156,269,216,66,130,261
"2011","Cardiff 027D","W01001751","Total",1661,345,83,262,1316,276,122,234,196,80,152,256
"2011","Cardiff 028A","W01001718","Total",1680,152,33,119,1528,35,26,123,190,48,82,1024
"2011","Cardiff 028B","W01001719","Total",1565,116,47,69,1449,27,96,144,184,51,99,848
"2011","Cardiff 028C","W01001720","Total",1854,133,33,100,1721,17,42,60,214,32,64,1292
"2011","Cardiff 028D","W01001722","Total",1565,134,30,104,1431,31,22,75,146,17,60,1080
"2011","Cardiff 028E","W01001726","Total",1660,117,25,92,1543,15,34,59,184,22,130,1099
"2011","Cardiff 029A","W01001822","Total",1647,246,101,145,1401,72,180,276,318,102,117,336
"2011","Cardiff 029B","W01001823","Total",1331,139,49,90,1192,34,88,379,188,73,137,293
"2011","Cardiff 029C","W01001824","Total",1537,293,45,248,1244,29,58,235,300,76,186,360
"2011","Cardiff 029D","W01001825","Total",1704,274,69,205,1430,83,116,376,364,78,169,244
"2011","Cardiff 030A","W01001831","Total",1565,179,36,143,1386,55,40,191,300,32,92,676
"2011","Cardiff 030B","W01001836","Total",1562,177,17,160,1385,60,40,189,276,72,277,471
"2011","Cardiff 030C","W01001837","Total",1373,187,36,151,1186,57,50,88,140,26,96,729
"2011","Cardiff 030D","W01001838","Total",1782,164,34,130,1618,32,44,190,282,109,175,786
"2011","Cardiff 030E","W01001839","Total",1609,180,50,130,1429,58,50,142,256,50,130,743
"2011","Cardiff 031A","W01001750","Total",1650,432,217,215,1218,142,162,223,188,62,143,298
"2011","Cardiff 031B","W01001752","Total",1625,167,94,73,1458,65,206,316,258,82,161,370
"2011","Cardiff 031C","W01001753","Total",1653,173,41,132,1480,213,138,302,180,155,240,252
"2011","Cardiff 031D","W01001754","Total",1711,350,170,180,1361,64,194,306,270,56,228,243
"2011","Cardiff 032A","W01001721","Total",1553,239,65,174,1314,41,58,45,212,30,70,858
"2011","Cardiff 032C","W01001724","Total",1982,89,21,68,1893,19,40,40,150,7,21,1616
"2011","Cardiff 032D","W01001725","Total",2158,150,10,140,2008,17,26,44,144,29,44,1704
"2011","Cardiff 032E","W01001922","Total",1387,123,10,113,1264,28,16,23,114,5,47,1031
"2011","Cardiff 032F","W01001939","Total",1020,358,22,336,662,3,22,143,350,23,13,108
"2011","Cardiff 032G","W01001941","Total",1098,364,7,357,734,4,6,111,444,45,0,124
"2011","Cardiff 033A","W01001829","Total",1807,201,27,174,1606,38,48,156,284,55,146,879
"2011","Cardiff 033B","W01001830","Total",1628,458,21,437,1170,58,30,125,478,33,94,352
"2011","Cardiff 033C","W01001832","Total",1698,278,13,265,1420,33,22,50,478,10,23,804
"2011","Cardiff 033D","W01001833","Total",1543,280,49,231,1263,87,78,293,310,41,139,315
"2011","Cardiff 033E","W01001834","Total",1604,240,47,193,1364,62,82,172,266,54,116,612
"2011","Cardiff 033F","W01001835","Total",1490,580,140,440,910,31,72,111,304,20,41,331
"2011","Cardiff 034A","W01001858","Total",1642,412,94,318,1230,43,90,283,430,42,113,229
"2011","Cardiff 034B","W01001859","Total",1387,332,58,274,1055,53,56,220,374,73,61,218
"2011","Cardiff 034C","W01001860","Total",1699,296,78,218,1403,51,110,307,428,67,158,282
"2011","Cardiff 034D","W01001861","Total",1609,294,43,251,1315,21,56,304,438,103,131,262
"2011","Cardiff 035A","W01001714","Total",1522,174,75,99,1348,35,158,394,190,128,157,286
"2011","Cardiff 035B","W01001715","Total",1567,330,102,228,1237,43,94,291,354,79,123,253
"2011","Cardiff 035C","W01001716","Total",1270,159,61,98,1111,76,118,334,198,62,67,256
"2011","Cardiff 035D","W01001717","Total",1574,304,98,206,1270,98,120,257,338,64,123,270
"2011","Cardiff 036A","W01001694","Total",1961,375,61,314,1586,141,58,322,334,165,252,314
"2011","Cardiff 036B","W01001695","Total",1654,433,48,385,1221,165,36,227,330,115,129,219
"2011","Cardiff 036C","W01001696","Total",1533,261,61,200,1272,209,72,163,262,93,179,294
"2011","Cardiff 036D","W01001697","Total",1644,315,76,239,1329,76,86,229,328,84,168,358
"2011","Cardiff 036E","W01001698","Total",1861,408,25,383,1453,119,56,229,416,99,177,357
"2011","Cardiff 037A","W01001870","Total",1377,168,54,114,1209,99,78,267,272,71,155,267
"2011","Cardiff 037B","W01001871","Total",1594,233,89,144,1361,236,92,271,214,158,182,208
"2011","Cardiff 037C","W01001875","Total",2695,374,46,328,2321,349,62,585,498,227,229,371
"2011","Cardiff 037D","W01001876","Total",1547,244,96,148,1303,225,110,292,186,112,148,230
"2011","Cardiff 038A","W01001869","Total",1352,223,66,157,1129,100,92,212,284,33,137,271
"2011","Cardiff 038B","W01001872","Total",1524,242,85,157,1282,111,94,223,228,71,232,323
"2011","Cardiff 038C","W01001873","Total",1692,310,82,228,1382,141,90,305,300,83,187,276
"2011","Cardiff 038D","W01001874","Total",1429,364,82,282,1065,203,52,235,188,91,132,164
"2011","Cardiff 039A","W01001737","Total",1585,225,93,132,1360,239,94,227,152,159,253,236
"2011","Cardiff 039B","W01001738","Total",1421,114,39,75,1307,301,92,257,144,200,133,180
"2011","Cardiff 039C","W01001739","Total",1361,119,30,89,1242,254,86,240,136,158,145,223
"2011","Cardiff 039D","W01001740","Total",1521,249,102,147,1272,268,128,217,158,73,168,260
"2011","Cardiff 039E","W01001741","Total",1619,136,47,89,1483,434,78,295,126,142,179,229
"2011","Cardiff 040A","W01001709","Total",1861,190,51,139,1671,117,88,356,316,146,219,429
"2011","Cardiff 040B","W01001710","Total",1593,245,56,189,1348,76,134,330,274,62,170,302
"2011","Cardiff 040C","W01001711","Total",1632,248,107,141,1384,156,172,253,242,121,166,274
"2011","Cardiff 040D","W01001712","Total",1417,273,69,204,1144,57,72,266,324,72,81,272
"2011","Cardiff 040E","W01001713","Total",1724,254,65,189,1470,82,94,319,362,94,210,309
"2011","Cardiff 041A","W01001704","Total",1550,209,94,115,1341,253,102,247,172,135,213,219
"2011","Cardiff 041B","W01001706","Total",1232,183,63,120,1049,123,150,170,152,59,150,245
"2011","Cardiff 041C","W01001707","Total",2052,227,84,143,1825,339,142,299,238,215,258,334
"2011","Cardiff 041D","W01001746","Total",1465,217,66,151,1248,197,120,300,254,73,129,175
"2011","Cardiff 042A","W01001855","Total",1799,229,51,178,1570,124,90,269,232,186,390,279
"2011","Cardiff 042B","W01001856","Total",1825,379,48,331,1446,24,36,179,298,122,458,329
"2011","Cardiff 042C","W01001857","Total",1790,389,118,271,1401,129,112,237,276,213,202,232
"2011","Cardiff 042D","W01001862","Total",1722,307,47,260,1415,58,60,198,228,147,368,356
"2011","Cardiff 043A","W01001742","Total",1515,192,69,123,1323,350,118,268,162,97,171,157
"2011","Cardiff 043B","W01001743","Total",1424,158,65,93,1266,62,210,260,222,70,138,304
"2011","Cardiff 043C","W01001744","Total",1592,288,147,141,1304,281,134,265,200,53,142,229
"2011","Cardiff 043D","W01001745","Total",1355,150,67,83,1205,75,182,280,182,87,167,232
"2011","Cardiff 044A","W01001764","Total",1717,179,50,129,1538,137,60,234,176,236,343,352
"2011","Cardiff 044B","W01001765","Total",1413,172,42,130,1241,77,82,221,142,150,339,230
"2011","Cardiff 044C","W01001766","Total",1659,245,67,178,1414,171,100,260,196,234,224,229
"2011","Cardiff 044D","W01001767","Total",1658,224,59,165,1434,170,66,311,332,108,220,227
"2011","Cardiff 044E","W01001768","Total",1686,156,30,126,1530,100,68,225,144,295,449,249
"2011","Cardiff 045A","W01001702","Total",1847,207,65,142,1640,173,118,367,274,123,288,297
"2011","Cardiff 045B","W01001703","Total",1266,134,42,92,1132,156,88,215,164,96,190,223
"2011","Cardiff 045C","W01001705","Total",1736,209,56,153,1527,258,140,304,250,117,193,265
"2011","Cardiff 045D","W01001708","Total",1537,337,69,268,1200,235,94,228,198,75,176,194
"2011","Cardiff 046A","W01001759","Total",1588,212,48,164,1376,90,122,286,314,112,191,261
"2011","Cardiff 046B","W01001760","Total",1687,206,73,133,1481,90,138,295,226,115,316,301
"2011","Cardiff 046C","W01001761","Total",1755,284,76,208,1471,128,120,269,198,158,317,281
"2011","Cardiff 046D","W01001762","Total",1745,303,60,243,1442,132,66,257,222,189,288,288
"2011","Cardiff 048A","W01001940","Total",1111,416,14,402,695,11,28,136,472,5,0,43
"2011","Cardiff 048B","W01001943","Total",1098,304,21,283,794,31,20,113,490,23,60,57
"2011","Cardiff 048C","W01001944","Total",1027,236,6,230,791,25,14,88,554,27,48,35
"2011","Cardiff 048D","W01001945","Total",1303,453,11,442,850,25,18,114,602,0,8,83
"2011","Cardiff 048E","W01001947","Total",1504,416,14,402,1088,54,24,246,600,25,18,121
"2011","Cardiff 049A","W01001699","Total",2177,500,144,356,1677,123,104,172,366,300,395,217
"2011","Cardiff 049B","W01001942","Total",1306,307,50,257,999,65,66,149,288,72,167,192
"2011","Cardiff 049C","W01001946","Total",1339,356,67,289,983,114,54,183,294,67,106,165
"2011","Cardiff 049D","W01001950","Total",1082,268,36,232,814,4,46,157,448,21,30,108
"2011","Cardiff 049E","W01001951","Total",1016,230,11,219,786,39,12,123,408,27,35,142
"2011","Cardiff 049F","W01001952","Total",1120,270,27,243,850,48,22,95,496,32,79,78
"2011","Rhondda Cynon Taf 001A","W01001186","Total",1753,125,48,77,1628,119,164,477,316,88,199,265
"2011","Rhondda Cynon Taf 001B","W01001187","Total",1389,149,62,87,1240,79,168,241,228,81,133,310
"2011","Rhondda Cynon Taf 001C","W01001188","Total",1038,188,103,85,850,89,138,145,144,42,88,204
"2011","Rhondda Cynon Taf 001D","W01001221","Total",1461,160,80,80,1301,164,176,213,182,141,151,274
"2011","Rhondda Cynon Taf 001E","W01001222","Total",1596,209,96,113,1387,220,106,248,174,136,178,325
"2011","Rhondda Cynon Taf 001F","W01001233","Total",1699,205,110,95,1494,84,256,268,282,57,217,330
"2011","Rhondda Cynon Taf 002A","W01001148","Total",1662,261,122,139,1401,129,168,377,240,57,181,249
"2011","Rhondda Cynon Taf 002B","W01001152","Total",1584,170,87,83,1414,110,260,298,228,70,155,293
"2011","Rhondda Cynon Taf 002C","W01001153","Total",1450,195,86,109,1255,147,174,294,178,65,124,273
"2011","Rhondda Cynon Taf 002D","W01001155","Total",1442,234,103,131,1208,127,174,228,228,32,145,274
"2011","Rhondda Cynon Taf 003A","W01001149","Total",1428,194,100,94,1234,94,138,228,214,77,158,325
"2011","Rhondda Cynon Taf 003B","W01001150","Total",1624,321,112,209,1303,144,168,278,298,62,145,208
"2011","Rhondda Cynon Taf 003C","W01001151","Total",1629,188,112,76,1441,43,320,335,236,61,145,301
"2011","Rhondda Cynon Taf 003D","W01001154","Total",1405,268,105,163,1137,158,168,225,186,50,91,259
"2011","Rhondda Cynon Taf 003E","W01001156","Total",1546,75,25,50,1471,40,94,470,222,83,188,374
"2011","Rhondda Cynon Taf 004A","W01001147","Total",1755,265,133,132,1490,95,222,363,250,68,136,356
"2011","Rhondda Cynon Taf 004B","W01001168","Total",1457,197,111,86,1260,102,212,257,210,91,137,251
"2011","Rhondda Cynon Taf 004C","W01001169","Total",1726,267,78,189,1459,186,126,343,244,127,166,267
"2011","Rhondda Cynon Taf 004D","W01001170","Total",1218,139,74,65,1079,35,210,228,190,35,140,241
"2011","Rhondda Cynon Taf 005A","W01001137","Total",2358,349,142,207,2009,194,256,457,398,94,221,389
"2011","Rhondda Cynon Taf 005B","W01001138","Total",1362,246,103,143,1116,136,116,254,184,71,145,210
"2011","Rhondda Cynon Taf 005C","W01001139","Total",1470,175,77,98,1295,92,142,383,178,45,163,292
"2011","Rhondda Cynon Taf 005D","W01001140","Total",1432,208,86,122,1224,133,178,239,194,53,155,272
"2011","Rhondda Cynon Taf 005E","W01001141","Total",1584,218,93,125,1366,164,172,304,170,70,171,315
"2011","Rhondda Cynon Taf 005F","W01001142","Total",1592,254,116,138,1338,156,164,266,192,89,227,244
"2011","Rhondda Cynon Taf 006A","W01001204","Total",1321,177,72,105,1144,134,138,286,212,55,87,232
"2011","Rhondda Cynon Taf 006B","W01001205","Total",1563,245,120,125,1318,136,194,246,270,45,159,268
"2011","Rhondda Cynon Taf 006C","W01001206","Total",1433,225,120,105,1208,100,168,240,180,76,163,281
"2011","Rhondda Cynon Taf 006D","W01001207","Total",1387,180,57,123,1207,128,128,230,192,90,134,305
"2011","Rhondda Cynon Taf 006E","W01001208","Total",1585,285,121,164,1300,152,208,265,202,66,145,262
"2011","Rhondda Cynon Taf 007A","W01001265","Total",1535,228,112,116,1307,104,166,256,190,81,199,311
"2011","Rhondda Cynon Taf 007B","W01001266","Total",1295,264,121,143,1031,128,150,228,184,38,121,182
"2011","Rhondda Cynon Taf 007C","W01001267","Total",1423,206,106,100,1217,88,184,223,218,96,147,261
"2011","Rhondda Cynon Taf 007D","W01001268","Total",1426,217,108,109,1209,136,170,201,178,61,172,291
"2011","Rhondda Cynon Taf 008A","W01001209","Total",1403,165,61,104,1238,193,118,235,166,102,208,216
"2011","Rhondda Cynon Taf 008B","W01001210","Total",1449,184,110,74,1265,142,156,239,200,70,128,330
"2011","Rhondda Cynon Taf 008C","W01001211","Total",1552,184,81,103,1368,118,162,311,220,87,187,283
"2011","Rhondda Cynon Taf 008D","W01001212","Total",1342,183,79,104,1159,134,118,235,184,72,151,265
"2011","Rhondda Cynon Taf 009A","W01001175","Total",1408,204,117,87,1204,71,154,285,206,61,138,289
"2011","Rhondda Cynon Taf 009B","W01001177","Total",1279,208,83,125,1071,113,132,259,182,20,123,242
"2011","Rhondda Cynon Taf 009C","W01001202","Total",1780,317,150,167,1463,180,206,294,252,69,143,319
"2011","Rhondda Cynon Taf 009D","W01001203","Total",1380,176,75,101,1204,159,152,225,184,92,107,285
"2011","Rhondda Cynon Taf 010A","W01001269","Total",1382,221,113,108,1161,94,194,209,156,69,149,290
"2011","Rhondda Cynon Taf 010B","W01001270","Total",1366,211,101,110,1155,80,180,222,194,55,122,302
"2011","Rhondda Cynon Taf 010C","W01001271","Total",1620,248,100,148,1372,175,136,223,278,103,195,262
"2011","Rhondda Cynon Taf 010D","W01001272","Total",1545,166,81,85,1379,149,198,293,152,89,165,333
"2011","Rhondda Cynon Taf 010E","W01001273","Total",1668,251,137,114,1417,124,220,238,256,75,157,347
"2011","Rhondda Cynon Taf 011A","W01001213","Total",1361,209,111,98,1152,128,180,251,204,52,141,196
"2011","Rhondda Cynon Taf 011B","W01001214","Total",1299,121,71,50,1178,64,168,236,194,85,125,306
"2011","Rhondda Cynon Taf 011C","W01001215","Total",1036,243,88,155,793,72,120,173,130,64,71,163
"2011","Rhondda Cynon Taf 011D","W01001216","Total",1509,200,81,119,1309,121,150,282,228,50,158,320
"2011","Rhondda Cynon Taf 012A","W01001143","Total",1588,146,74,72,1442,98,172,340,212,74,166,380
"2011","Rhondda Cynon Taf 012B","W01001144","Total",1605,191,75,116,1414,186,128,259,240,160,164,277
"2011","Rhondda Cynon Taf 012C","W01001145","Total",1765,232,112,120,1533,141,158,365,252,102,205,310
"2011","Rhondda Cynon Taf 012D","W01001146","Total",1419,217,102,115,1202,104,146,272,232,71,117,260
"2011","Rhondda Cynon Taf 013A","W01001176","Total",1453,174,72,102,1279,99,182,341,182,50,139,286
"2011","Rhondda Cynon Taf 013B","W01001274","Total",1344,208,61,147,1136,243,112,193,130,80,155,223
"2011","Rhondda Cynon Taf 013C","W01001275","Total",1807,254,121,133,1553,207,206,270,254,136,163,317
"2011","Rhondda Cynon Taf 013D","W01001276","Total",1385,280,99,181,1105,120,150,199,190,49,164,233
"2011","Rhondda Cynon Taf 014A","W01001200","Total",991,117,61,56,874,66,106,170,138,48,116,230
"2011","Rhondda Cynon Taf 014B","W01001201","Total",1215,200,98,102,1015,84,134,191,142,83,162,219
"2011","Rhondda Cynon Taf 014C","W01001260","Total",1091,146,70,76,945,126,118,195,162,51,99,194
"2011","Rhondda Cynon Taf 014D","W01001285","Total",1332,206,103,103,1126,48,164,226,214,25,188,261
"2011","Rhondda Cynon Taf 014E","W01001286","Total",1527,170,88,82,1357,143,188,229,242,66,178,311
"2011","Rhondda Cynon Taf 014F","W01001287","Total",1456,183,79,104,1273,94,168,247,212,72,178,302
"2011","Rhondda Cynon Taf 014G","W01001288","Total",1412,228,90,138,1184,128,120,218,218,45,179,276
"2011","Rhondda Cynon Taf 015A","W01001180","Total",1463,218,73,145,1245,181,106,279,212,97,129,241
"2011","Rhondda Cynon Taf 015B","W01001181","Total",1396,184,76,108,1212,84,134,285,228,41,156,284
"2011","Rhondda Cynon Taf 015C","W01001282","Total",2000,274,141,133,1726,175,222,383,254,115,193,384
"2011","Rhondda Cynon Taf 015D","W01001283","Total",1503,177,91,86,1326,97,194,272,218,57,181,307
"2011","Rhondda Cynon Taf 015E","W01001284","Total",1161,76,31,45,1085,47,64,326,150,87,153,258
"2011","Rhondda Cynon Taf 016A","W01001166","Total",1300,176,75,101,1124,106,134,209,154,72,160,289
"2011","Rhondda Cynon Taf 016B","W01001167","Total",1478,179,88,91,1299,182,188,253,196,90,148,242
"2011","Rhondda Cynon Taf 016C","W01001247","Total",1696,257,132,125,1439,109,188,383,228,74,148,309
"2011","Rhondda Cynon Taf 016D","W01001248","Total",2036,250,108,142,1786,145,204,440,286,96,196,419
"2011","Rhondda Cynon Taf 017A","W01001171","Total",1257,197,90,107,1060,92,150,222,208,30,101,257
"2011","Rhondda Cynon Taf 017B","W01001229","Total",1433,226,93,133,1207,93,130,269,208,70,123,314
"2011","Rhondda Cynon Taf 017C","W01001230","Total",1510,152,77,75,1358,72,176,381,214,52,177,286
"2011","Rhondda Cynon Taf 017D","W01001231","Total",1540,245,101,144,1295,140,164,267,188,51,168,317
"2011","Rhondda Cynon Taf 017E","W01001280","Total",1631,290,123,167,1341,129,188,295,190,72,134,333
"2011","Rhondda Cynon Taf 017F","W01001281","Total",1689,223,99,124,1466,117,252,307,240,93,134,323
"2011","Rhondda Cynon Taf 018A","W01001217","Total",1202,138,65,73,1064,84,94,217,146,97,164,262
"2011","Rhondda Cynon Taf 018B","W01001218","Total",1541,184,77,107,1357,125,132,305,226,42,181,346
"2011","Rhondda Cynon Taf 018C","W01001219","Total",1299,266,146,120,1033,138,104,210,170,21,126,264
"2011","Rhondda Cynon Taf 018D","W01001220","Total",1479,173,90,83,1306,117,166,269,202,95,167,290
"2011","Rhondda Cynon Taf 018E","W01001259","Total",1651,186,109,77,1465,117,184,362,226,83,187,306
"2011","Rhondda Cynon Taf 018F","W01001261","Total",1258,157,69,88,1101,76,154,248,176,42,97,308
"2011","Rhondda Cynon Taf 019A","W01001164","Total",1551,186,66,120,1365,146,156,326,228,98,158,253
"2011","Rhondda Cynon Taf 019B","W01001165","Total",1304,147,63,84,1157,115,114,266,224,66,109,263
"2011","Rhondda Cynon Taf 019C","W01001256","Total",1191,153,62,91,1038,110,134,210,220,68,96,200
"2011","Rhondda Cynon Taf 019D","W01001257","Total",1225,129,57,72,1096,59,180,215,196,36,123,287
"2011","Rhondda Cynon Taf 019E","W01001258","Total",1265,278,111,167,987,78,138,242,208,56,99,166
"2011","Rhondda Cynon Taf 020A","W01001172","Total",1492,204,99,105,1288,130,154,264,200,94,167,279
"2011","Rhondda Cynon Taf 020B","W01001173","Total",1368,208,78,130,1160,127,164,167,166,61,193,282
"2011","Rhondda Cynon Taf 020C","W01001174","Total",1385,203,90,113,1182,183,138,238,184,87,97,255
"2011","Rhondda Cynon Taf 020D","W01001232","Total",1362,206,66,140,1156,78,132,238,216,40,164,288
"2011","Rhondda Cynon Taf 021A","W01001182","Total",1472,156,60,96,1316,121,128,300,220,112,155,280
"2011","Rhondda Cynon Taf 021B","W01001183","Total",1010,229,84,145,781,67,50,158,188,42,53,223
"2011","Rhondda Cynon Taf 021C","W01001227","Total",1331,121,54,67,1210,65,184,253,214,72,127,295
"2011","Rhondda Cynon Taf 021D","W01001228","Total",1489,208,114,94,1281,32,236,250,242,56,179,286
"2011","Rhondda Cynon Taf 021E","W01001234","Total",1456,176,71,105,1280,72,164,290,274,53,119,308
"2011","Rhondda Cynon Taf 021F","W01001235","Total",1575,256,130,126,1319,131,158,305,242,109,129,245
"2011","Rhondda Cynon Taf 021G","W01001236","Total",1513,180,99,81,1333,120,206,346,210,79,99,273
"2011","Rhondda Cynon Taf 022A","W01001185","Total",1625,283,122,161,1342,136,180,294,240,63,151,278
"2011","Rhondda Cynon Taf 022B","W01001237","Total",1467,215,123,92,1252,120,152,265,178,93,167,277
"2011","Rhondda Cynon Taf 022C","W01001238","Total",1673,190,53,137,1483,309,116,234,170,134,227,293
"2011","Rhondda Cynon Taf 022D","W01001262","Total",1356,156,44,112,1200,84,80,168,244,48,103,473
"2011","Rhondda Cynon Taf 022E","W01001263","Total",1711,134,55,79,1577,48,90,96,180,54,110,999
"2011","Rhondda Cynon Taf 022F","W01001264","Total",1394,138,43,95,1256,27,72,124,176,32,58,767
"2011","Rhondda Cynon Taf 023A","W01001178","Total",1709,226,108,118,1483,130,160,313,222,93,240,325
"2011","Rhondda Cynon Taf 023B","W01001179","Total",1727,203,97,106,1524,210,170,263,234,38,247,362
"2011","Rhondda Cynon Taf 023C","W01001253","Total",1428,175,73,102,1253,122,130,289,190,67,177,278
"2011","Rhondda Cynon Taf 023E","W01001255","Total",1598,198,80,118,1400,171,148,271,268,107,183,252
"2011","Rhondda Cynon Taf 023F","W01001914","Total",1749,55,12,43,1694,60,70,694,198,116,216,340
"2011","Rhondda Cynon Taf 023G","W01001917","Total",1492,156,93,63,1336,101,176,269,190,104,183,313
"2011","Rhondda Cynon Taf 024A","W01001249","Total",1389,228,114,114,1161,93,160,212,222,46,134,294
"2011","Rhondda Cynon Taf 024B","W01001250","Total",1413,121,68,53,1292,73,208,223,194,80,188,326
"2011","Rhondda Cynon Taf 024C","W01001251","Total",1557,203,78,125,1354,239,128,295,228,99,142,223
"2011","Rhondda Cynon Taf 024D","W01001252","Total",1523,137,56,81,1386,69,148,344,274,47,191,313
"2011","Rhondda Cynon Taf 025A","W01001162","Total",1718,266,104,162,1452,183,170,341,226,96,177,259
"2011","Rhondda Cynon Taf 025B","W01001244","Total",1364,161,106,55,1203,36,314,201,210,46,104,292
"2011","Rhondda Cynon Taf 025C","W01001245","Total",1286,92,52,40,1194,37,212,225,228,71,119,302
"2011","Rhondda Cynon Taf 025D","W01001246","Total",1381,177,108,69,1204,70,282,211,218,61,98,264
"2011","Rhondda Cynon Taf 026A","W01001184","Total",1932,265,137,128,1667,86,284,312,326,85,203,371
"2011","Rhondda Cynon Taf 026B","W01001239","Total",1365,225,102,123,1140,142,152,214,196,77,138,221
"2011","Rhondda Cynon Taf 026C","W01001240","Total",1867,268,72,196,1599,84,204,371,378,41,209,312
"2011","Rhondda Cynon Taf 026D","W01001241","Total",1727,240,82,158,1487,101,180,322,312,89,203,280
"2011","Rhondda Cynon Taf 027B","W01001196","Total",1558,129,30,99,1429,107,128,334,312,68,169,311
"2011","Rhondda Cynon Taf 027C","W01001197","Total",1247,81,49,32,1166,14,184,295,192,78,115,288
"2011","Rhondda Cynon Taf 027D","W01001198","Total",1556,156,49,107,1400,79,152,371,346,68,124,260
"2011","Rhondda Cynon Taf 027E","W01001199","Total",1710,139,58,81,1571,89,190,429,332,95,178,258
"2011","Rhondda Cynon Taf 027F","W01001915","Total",1746,109,38,71,1637,56,78,629,206,179,196,293
"2011","Rhondda Cynon Taf 027G","W01001916","Total",1525,85,6,79,1440,93,62,572,242,83,172,216
"2011","Rhondda Cynon Taf 028A","W01001157","Total",1386,151,51,100,1235,87,140,318,262,36,98,294
"2011","Rhondda Cynon Taf 028B","W01001158","Total",1448,167,58,109,1281,75,142,282,254,71,150,307
"2011","Rhondda Cynon Taf 028C","W01001159","Total",1279,124,17,107,1155,95,62,328,216,55,159,240
"2011","Rhondda Cynon Taf 028D","W01001277","Total",1211,69,22,47,1142,48,140,277,212,69,124,272
"2011","Rhondda Cynon Taf 028E","W01001278","Total",1154,137,54,83,1017,115,112,221,118,116,182,153
"2011","Rhondda Cynon Taf 028F","W01001279","Total",1182,172,98,74,1010,179,134,153,168,72,107,197
"2011","Rhondda Cynon Taf 029A","W01001160","Total",1594,140,67,73,1454,68,212,326,330,66,120,332
"2011","Rhondda Cynon Taf 029B","W01001161","Total",2224,235,86,149,1989,110,160,538,386,151,266,378
"2011","Rhondda Cynon Taf 029C","W01001189","Total",1663,186,71,115,1477,197,122,393,256,111,120,278
"2011","Rhondda Cynon Taf 029D","W01001190","Total",2531,241,83,158,2290,113,226,664,430,121,306,430
"2011","Rhondda Cynon Taf 030A","W01001193","Total",1213,111,55,56,1102,30,186,259,162,61,114,290
"2011","Rhondda Cynon Taf 030B","W01001194","Total",2165,184,61,123,1981,77,226,732,396,71,143,336
"2011","Rhondda Cynon Taf 030C","W01001195","Total",1489,230,89,141,1259,100,164,302,254,71,87,281
"2011","Rhondda Cynon Taf 030D","W01001242","Total",1310,158,91,67,1152,36,256,279,166,59,98,258
"2011","Rhondda Cynon Taf 030E","W01001243","Total",1349,278,121,157,1071,137,156,242,208,43,89,196
"2011","Rhondda Cynon Taf 031A","W01001191","Total",2482,229,62,167,2253,88,182,796,500,135,209,343
"2011","Rhondda Cynon Taf 031B","W01001192","Total",1491,178,85,93,1313,159,162,321,190,81,147,253
"2011","Rhondda Cynon Taf 031C","W01001223","Total",1592,192,85,107,1400,57,286,360,258,63,138,238
"2011","Rhondda Cynon Taf 031D","W01001224","Total",2129,133,50,83,1996,66,142,887,328,139,188,246
"2011","Rhondda Cynon Taf 031E","W01001225","Total",1572,139,57,82,1433,38,250,407,294,68,136,240
"2011","Rhondda Cynon Taf 031F","W01001226","Total",1719,212,95,117,1507,121,152,411,280,160,112,271
"2011","Merthyr Tydfil 002A","W01001295","Total",1574,204,109,95,1370,191,140,263,220,73,142,341
"2011","Merthyr Tydfil 002B","W01001296","Total",1677,119,46,73,1558,77,196,288,252,62,242,441
"2011","Merthyr Tydfil 002C","W01001297","Total",1888,201,68,133,1687,156,128,365,284,97,225,432
"2011","Merthyr Tydfil 002D","W01001298","Total",1763,239,112,127,1524,176,166,313,290,45,198,336
"2011","Merthyr Tydfil 002E","W01001310","Total",1630,166,87,79,1464,100,174,319,222,91,136,422
"2011","Merthyr Tydfil 002F","W01001311","Total",1192,149,72,77,1043,126,92,247,136,31,137,274
"2011","Merthyr Tydfil 003A","W01001291","Total",1797,130,41,89,1667,122,102,425,320,118,208,372
"2011","Merthyr Tydfil 003B","W01001294","Total",1638,101,50,51,1537,40,262,321,294,57,214,349
"2011","Merthyr Tydfil 003C","W01001305","Total",1262,108,61,47,1154,68,176,166,214,52,151,327
"2011","Merthyr Tydfil 003D","W01001306","Total",1549,166,82,84,1383,65,136,304,276,68,151,383
"2011","Merthyr Tydfil 003E","W01001324","Total",1986,292,133,159,1694,83,296,327,310,114,170,394
"2011","Merthyr Tydfil 004A","W01001292","Total",1730,165,75,90,1565,194,114,288,274,113,229,353
"2011","Merthyr Tydfil 004B","W01001293","Total",1650,225,129,96,1425,126,204,278,280,21,205,311
"2011","Merthyr Tydfil 004C","W01001307","Total",1448,333,164,169,1115,86,158,192,224,38,155,262
"2011","Merthyr Tydfil 004D","W01001315","Total",1672,340,137,203,1332,147,164,186,222,35,197,381
"2011","Merthyr Tydfil 005A","W01001314","Total",2179,237,110,127,1942,153,254,505,294,114,235,387
"2011","Merthyr Tydfil 005B","W01001316","Total",2848,312,102,210,2536,117,234,697,434,153,297,604
"2011","Merthyr Tydfil 005C","W01001317","Total",1599,188,91,97,1411,84,224,248,196,91,132,436
"2011","Merthyr Tydfil 005D","W01001318","Total",1501,182,82,100,1319,63,192,283,226,66,158,331
"2011","Merthyr Tydfil 006A","W01001289","Total",1392,202,97,105,1190,51,142,224,252,87,155,279
"2011","Merthyr Tydfil 006B","W01001302","Total",1124,137,60,77,987,110,90,168,154,53,134,278
"2011","Merthyr Tydfil 006C","W01001303","Total",1198,158,57,101,1040,172,84,143,140,59,171,271
"2011","Merthyr Tydfil 006D","W01001304","Total",1507,157,78,79,1350,107,174,285,176,61,161,386
"2011","Merthyr Tydfil 006E","W01001312","Total",1427,222,126,96,1205,124,174,218,202,37,209,241
"2011","Merthyr Tydfil 006F","W01001313","Total",1551,196,81,115,1355,99,162,277,214,49,203,351
"2011","Merthyr Tydfil 007A","W01001290","Total",1874,190,86,104,1684,162,174,323,280,84,225,436
"2011","Merthyr Tydfil 007B","W01001319","Total",1643,117,55,62,1526,51,186,343,300,89,153,404
"2011","Merthyr Tydfil 007C","W01001320","Total",1536,118,53,65,1418,82,158,316,244,72,180,366
"2011","Merthyr Tydfil 007D","W01001321","Total",1564,159,78,81,1405,158,154,290,198,89,210,306
"2011","Merthyr Tydfil 007E","W01001322","Total",1570,186,69,117,1384,97,148,328,266,63,168,314
"2011","Merthyr Tydfil 008A","W01001299","Total",1616,201,95,106,1415,226,122,253,226,120,196,272
"2011","Merthyr Tydfil 008B","W01001300","Total",1723,141,63,78,1582,186,156,284,176,160,239,381
"2011","Merthyr Tydfil 008C","W01001301","Total",1911,169,95,74,1742,248,208,393,190,101,204,398
"2011","Merthyr Tydfil 008D","W01001308","Total",1320,76,31,45,1244,186,90,193,90,96,300,289
"2011","Merthyr Tydfil 008E","W01001309","Total",1277,115,60,55,1162,158,116,186,134,88,160,320
"2011","Merthyr Tydfil 008F","W01001898","Total",1518,158,91,67,1360,95,192,247,204,70,181,371
"2011","Caerphilly 001A","W01001374","Total",1462,150,72,78,1312,88,154,271,186,83,177,353
"2011","Caerphilly 001B","W01001375","Total",1457,257,107,150,1200,92,138,237,254,57,152,270
"2011","Caerphilly 001C","W01001376","Total",1513,214,101,113,1299,196,156,237,196,126,135,253
"2011","Caerphilly 001D","W01001406","Total",1893,265,99,166,1628,120,208,364,274,47,154,461
"2011","Caerphilly 001E","W01001428","Total",1297,147,57,90,1150,219,114,206,180,85,127,219
"2011","Caerphilly 001F","W01001429","Total",1157,172,72,100,985,64,128,255,216,46,78,198
"2011","Caerphilly 002A","W01001360","Total",1357,142,63,79,1215,67,160,269,182,83,214,240
"2011","Caerphilly 002B","W01001361","Total",1250,133,63,70,1117,94,116,217,128,77,196,289
"2011","Caerphilly 002C","W01001384","Total",1647,198,88,110,1449,122,154,394,240,56,143,340
"2011","Caerphilly 002D","W01001385","Total",1515,241,105,136,1274,142,186,286,200,30,186,244
"2011","Caerphilly 002E","W01001386","Total",1743,221,108,113,1522,159,162,334,204,169,219,275
"2011","Caerphilly 003A","W01001325","Total",1540,149,77,72,1391,128,152,308,248,92,195,268
"2011","Caerphilly 003B","W01001326","Total",2077,279,115,164,1798,238,150,349,296,110,229,426
"2011","Caerphilly 003C","W01001362","Total",2050,304,165,139,1746,123,272,363,288,72,194,434
"2011","Caerphilly 004A","W01001336","Total",1437,162,78,84,1275,73,194,251,214,46,159,338
"2011","Caerphilly 004B","W01001337","Total",1558,180,85,95,1378,111,154,310,246,51,204,302
"2011","Caerphilly 004C","W01001338","Total",1744,263,109,154,1481,161,142,286,272,91,175,354
"2011","Caerphilly 004D","W01001339","Total",1410,171,74,97,1239,213,114,250,190,95,114,263
"2011","Caerphilly 005A","W01001334","Total",1492,158,57,101,1334,140,148,261,162,143,206,274
"2011","Caerphilly 005B","W01001335","Total",1265,118,38,80,1147,74,152,234,216,82,134,255
"2011","Caerphilly 005C","W01001347","Total",1429,159,96,63,1270,74,204,280,212,42,173,285
"2011","Caerphilly 005D","W01001351","Total",1497,172,72,100,1325,23,228,274,270,65,103,362
"2011","Caerphilly 006A","W01001356","Total",1259,98,59,39,1161,52,180,254,150,69,184,272
"2011","Caerphilly 006B","W01001357","Total",1600,162,80,82,1438,71,184,316,250,64,198,355
"2011","Caerphilly 006C","W01001358","Total",1540,152,94,58,1388,191,194,237,240,81,131,314
"2011","Caerphilly 006D","W01001359","Total",1509,197,73,124,1312,70,156,325,236,67,135,323
"2011","Caerphilly 006E","W01001390","Total",1797,111,48,63,1686,93,146,517,290,99,201,340
"2011","Caerphilly 006F","W01001391","Total",1639,171,103,68,1468,97,188,334,238,95,195,321
"2011","Caerphilly 007A","W01001352","Total",1845,188,107,81,1657,158,174,340,278,85,254,368
"2011","Caerphilly 007B","W01001353","Total",1590,258,148,110,1332,105,224,199,268,79,155,302
"2011","Caerphilly 007C","W01001387","Total",1281,174,74,100,1107,79,144,212,164,121,135,252
"2011","Caerphilly 007D","W01001388","Total",1851,149,58,91,1702,224,158,419,228,121,210,342
"2011","Caerphilly 007E","W01001389","Total",1130,116,61,55,1014,52,136,308,132,62,109,215
"2011","Caerphilly 008A","W01001414","Total",1600,163,54,109,1437,132,142,321,254,136,164,288
"2011","Caerphilly 008B","W01001415","Total",1799,169,81,88,1630,127,170,337,280,138,244,334
"2011","Caerphilly 008C","W01001416","Total",1459,181,98,83,1278,46,246,249,236,40,152,309
"2011","Caerphilly 008D","W01001417","Total",1490,105,31,74,1385,89,146,329,238,83,166,334
"2011","Caerphilly 008E","W01001418","Total",1458,176,86,90,1282,103,164,267,230,79,148,291
"2011","Caerphilly 009A","W01001348","Total",1812,192,118,74,1620,161,164,411,238,151,191,304
"2011","Caerphilly 009B","W01001349","Total",1932,107,38,69,1825,68,112,606,242,143,285,369
"2011","Caerphilly 009C","W01001350","Total",1757,215,105,110,1542,134,218,332,268,52,180,358
"2011","Caerphilly 009D","W01001392","Total",1769,179,95,84,1590,72,260,430,288,62,122,356
"2011","Caerphilly 010A","W01001380","Total",1811,203,113,90,1608,115,206,381,310,88,168,340
"2011","Caerphilly 010B","W01001381","Total",1535,163,81,82,1372,128,140,276,224,118,196,290
"2011","Caerphilly 010C","W01001382","Total",1580,197,108,89,1383,40,254,296,250,114,123,306
"2011","Caerphilly 010D","W01001383","Total",1487,219,93,126,1268,124,192,263,212,82,140,255
"2011","Caerphilly 011A","W01001401","Total",1922,250,150,100,1672,109,256,339,310,76,174,408
"2011","Caerphilly 011B","W01001402","Total",1699,156,75,81,1543,207,170,327,224,150,155,310
"2011","Caerphilly 011C","W01001403","Total",1591,200,70,130,1391,71,150,421,258,69,159,263
"2011","Caerphilly 011D","W01001404","Total",1406,117,72,45,1289,27,258,286,226,56,71,365
"2011","Caerphilly 011E","W01001405","Total",1875,199,120,79,1676,151,168,422,222,123,215,375
"2011","Caerphilly 012A","W01001363","Total",1493,105,49,56,1388,102,118,322,234,87,190,335
"2011","Caerphilly 012B","W01001364","Total",1868,149,61,88,1719,151,124,332,242,238,301,331
"2011","Caerphilly 012C","W01001365","Total",2121,218,92,126,1903,156,164,397,314,132,326,414
"2011","Caerphilly 012D","W01001369","Total",2223,249,130,119,1974,96,290,443,360,120,205,460
"2011","Caerphilly 013A","W01001377","Total",1539,166,77,89,1373,83,258,291,268,47,131,295
"2011","Caerphilly 013B","W01001378","Total",1541,228,127,101,1313,99,206,276,186,81,173,292
"2011","Caerphilly 013C","W01001379","Total",1512,146,68,78,1366,84,198,421,242,77,100,244
"2011","Caerphilly 013D","W01001432","Total",2204,267,104,163,1937,168,194,521,432,92,231,299
"2011","Caerphilly 013E","W01001433","Total",1413,214,102,112,1199,79,210,279,202,79,100,250
"2011","Caerphilly 013F","W01001434","Total",1420,100,52,48,1320,45,138,414,240,61,170,252
"2011","Caerphilly 014A","W01001327","Total",2169,261,75,186,1908,112,200,513,448,95,139,401
"2011","Caerphilly 014B","W01001328","Total",1606,159,75,84,1447,121,158,341,242,147,169,269
"2011","Caerphilly 014C","W01001329","Total",1577,188,91,97,1389,119,182,255,216,115,224,278
"2011","Caerphilly 014D","W01001354","Total",1643,181,81,100,1462,82,168,384,334,86,138,270
"2011","Caerphilly 015A","W01001355","Total",1619,343,177,166,1276,77,250,268,246,50,126,259
"2011","Caerphilly 015B","W01001430","Total",2316,286,125,161,2030,182,198,482,388,131,235,414
"2011","Caerphilly 015C","W01001431","Total",1550,159,73,86,1391,65,172,304,272,72,196,310
"2011","Caerphilly 016A","W01001407","Total",1416,157,33,124,1259,100,150,294,278,36,105,296
"2011","Caerphilly 016B","W01001408","Total",1515,155,59,96,1360,177,144,241,214,169,196,219
"2011","Caerphilly 016C","W01001409","Total",1677,163,87,76,1514,74,228,324,248,91,173,376
"2011","Caerphilly 016D","W01001410","Total",1856,257,85,172,1599,106,234,347,298,71,178,365
"2011","Caerphilly 017A","W01001411","Total",1674,276,130,146,1398,61,242,309,300,31,156,299
"2011","Caerphilly 017B","W01001412","Total",1693,331,131,200,1362,73,186,283,336,67,146,271
"2011","Caerphilly 017C","W01001413","Total",1827,221,122,99,1606,88,190,334,216,92,241,445
"2011","Caerphilly 018A","W01001330","Total",1452,187,89,98,1265,84,160,314,212,104,139,252
"2011","Caerphilly 018B","W01001331","Total",1785,211,60,151,1574,160,116,356,292,126,256,268
"2011","Caerphilly 018C","W01001332","Total",1926,236,87,149,1690,212,166,366,234,141,196,375
"2011","Caerphilly 018D","W01001333","Total",1615,143,37,106,1472,179,104,342,244,99,206,298
"2011","Caerphilly 019A","W01001366","Total",1692,161,64,97,1531,92,190,330,310,101,179,329
"2011","Caerphilly 019B","W01001367","Total",1516,170,73,97,1346,149,140,288,236,53,167,313
"2011","Caerphilly 019C","W01001368","Total",1551,182,70,112,1369,142,130,285,210,98,222,282
"2011","Caerphilly 019D","W01001393","Total",1334,125,62,63,1209,115,184,276,194,53,122,265
"2011","Caerphilly 019E","W01001397","Total",1732,156,51,105,1576,102,148,398,252,104,205,367
"2011","Caerphilly 019F","W01001400","Total",1454,136,50,86,1318,217,96,305,170,97,164,269
"2011","Caerphilly 020A","W01001340","Total",1809,135,75,60,1674,48,188,376,284,114,249,415
"2011","Caerphilly 020B","W01001341","Total",1807,267,120,147,1540,124,210,305,250,104,189,358
"2011","Caerphilly 020C","W01001344","Total",1667,175,99,76,1492,94,230,261,226,99,194,388
"2011","Caerphilly 020D","W01001346","Total",1535,191,99,92,1344,113,240,314,196,82,168,231
"2011","Caerphilly 021A","W01001342","Total",1163,136,55,81,1027,41,160,294,176,56,110,190
"2011","Caerphilly 021B","W01001343","Total",1194,127,54,73,1067,39,156,249,214,87,141,181
"2011","Caerphilly 021C","W01001345","Total",1537,127,27,100,1410,287,102,305,188,172,179,177
"2011","Caerphilly 021D","W01001419","Total",1556,137,49,88,1419,72,178,313,320,83,191,262
"2011","Caerphilly 022A","W01001371","Total",1450,197,87,110,1253,154,102,255,224,84,158,276
"2011","Caerphilly 022B","W01001372","Total",1940,182,71,111,1758,131,220,460,370,116,205,256
"2011","Caerphilly 022C","W01001373","Total",1692,175,79,96,1517,116,166,365,300,67,157,346
"2011","Caerphilly 022D","W01001420","Total",1305,149,56,93,1156,91,144,285,236,41,144,215
"2011","Caerphilly 022E","W01001421","Total",1543,268,95,173,1275,298,98,191,206,151,131,200
"2011","Caerphilly 022F","W01001422","Total",1572,198,91,107,1374,197,248,203,170,97,190,269
"2011","Caerphilly 023A","W01001370","Total",1686,251,135,116,1435,83,252,260,286,72,134,348
"2011","Caerphilly 023B","W01001394","Total",1377,75,28,47,1302,56,112,379,216,92,142,305
"2011","Caerphilly 023C","W01001395","Total",1455,171,110,61,1284,80,208,228,208,88,168,304
"2011","Caerphilly 023D","W01001396","Total",1644,177,68,109,1467,201,132,363,198,119,222,232
"2011","Caerphilly 023E","W01001399","Total",1316,135,69,66,1181,52,174,209,224,112,111,299
"2011","Caerphilly 024A","W01001398","Total",2489,198,26,172,2291,137,92,837,530,177,216,302
"2011","Caerphilly 024B","W01001423","Total",1413,154,93,61,1259,39,286,258,270,48,94,264
"2011","Caerphilly 024C","W01001424","Total",1455,225,132,93,1230,91,200,251,206,36,174,272
"2011","Caerphilly 024D","W01001425","Total",1620,227,118,109,1393,54,204,320,254,105,133,323
"2011","Caerphilly 024E","W01001426","Total",1353,93,44,49,1260,22,216,332,200,62,148,280
"2011","Caerphilly 024F","W01001427","Total",1835,118,20,98,1717,87,62,664,352,132,173,247
"2011","Blaenau Gwent 001A","W01001440","Total",1380,181,90,91,1199,116,164,245,226,47,163,238
"2011","Blaenau Gwent 001B","W01001441","Total",1185,148,59,89,1037,99,100,203,194,95,112,234
"2011","Blaenau Gwent 001C","W01001442","Total",1232,115,52,63,1117,63,178,230,164,55,165,262
"2011","Blaenau Gwent 001D","W01001470","Total",1479,156,83,73,1323,77,266,280,188,34,141,337
"2011","Blaenau Gwent 001E","W01001471","Total",1752,252,103,149,1500,175,166,298,270,114,193,284
"2011","Blaenau Gwent 002A","W01001446","Total",1156,121,58,63,1035,38,140,258,200,35,109,255
"2011","Blaenau Gwent 002B","W01001447","Total",1570,157,46,111,1413,173,134,245,194,114,252,301
"2011","Blaenau Gwent 002C","W01001448","Total",1227,264,93,171,963,72,158,207,210,61,63,192
"2011","Blaenau Gwent 002D","W01001449","Total",1449,307,124,183,1142,93,178,279,214,40,104,234
"2011","Blaenau Gwent 003A","W01001472","Total",1473,189,113,76,1284,50,194,347,190,25,186,292
"2011","Blaenau Gwent 003B","W01001473","Total",1399,181,77,104,1218,195,148,181,184,102,163,245
"2011","Blaenau Gwent 003C","W01001474","Total",1546,207,98,109,1339,75,196,254,230,79,178,327
"2011","Blaenau Gwent 003D","W01001475","Total",1209,143,61,82,1066,58,130,262,182,45,135,254
"2011","Blaenau Gwent 003E","W01001480","Total",1471,186,109,77,1285,138,184,181,202,66,171,343
"2011","Blaenau Gwent 004A","W01001438","Total",1425,250,168,82,1175,67,178,200,204,54,142,330
"2011","Blaenau Gwent 004B","W01001439","Total",1685,145,82,63,1540,50,216,321,250,63,217,423
"2011","Blaenau Gwent 004C","W01001456","Total",1292,162,63,99,1130,86,158,236,194,72,135,249
"2011","Blaenau Gwent 004D","W01001457","Total",1707,251,103,148,1456,161,114,254,240,93,243,351
"2011","Blaenau Gwent 004E","W01001458","Total",1531,161,85,76,1370,65,176,324,214,65,174,352
"2011","Blaenau Gwent 005A","W01001443","Total",1342,253,117,136,1089,101,126,204,238,32,121,267
"2011","Blaenau Gwent 005B","W01001444","Total",1933,208,108,100,1725,129,208,334,290,161,217,386
"2011","Blaenau Gwent 005C","W01001445","Total",1506,174,96,78,1332,117,186,301,182,87,151,308
"2011","Blaenau Gwent 005D","W01001467","Total",1944,220,99,121,1724,140,214,341,296,171,256,306
"2011","Blaenau Gwent 005E","W01001468","Total",1374,160,61,99,1214,96,160,232,198,79,173,276
"2011","Blaenau Gwent 005F","W01001469","Total",1311,118,44,74,1193,108,110,222,164,117,186,286
"2011","Blaenau Gwent 006A","W01001462","Total",1518,219,118,101,1299,115,166,299,194,64,168,293
"2011","Blaenau Gwent 006B","W01001463","Total",1892,263,104,159,1629,136,258,399,342,45,139,310
"2011","Blaenau Gwent 006C","W01001478","Total",1462,205,95,110,1257,104,164,280,240,34,120,315
"2011","Blaenau Gwent 006D","W01001479","Total",1511,268,118,150,1243,196,150,248,196,61,143,249
"2011","Blaenau Gwent 006E","W01001481","Total",1517,356,124,232,1161,112,170,218,212,60,97,292
"2011","Blaenau Gwent 007A","W01001450","Total",1310,176,85,91,1134,75,154,255,184,35,146,285
"2011","Blaenau Gwent 007B","W01001451","Total",1424,239,116,123,1185,114,162,287,192,78,130,222
"2011","Blaenau Gwent 007C","W01001452","Total",1555,144,59,85,1411,45,122,367,288,95,173,321
"2011","Blaenau Gwent 007D","W01001459","Total",1111,129,52,77,982,116,88,199,156,93,156,174
"2011","Blaenau Gwent 007E","W01001460","Total",1683,266,76,190,1417,115,142,327,300,70,207,256
"2011","Blaenau Gwent 007F","W01001461","Total",1382,228,107,121,1154,89,132,270,204,71,115,273
"2011","Blaenau Gwent 008A","W01001435","Total",1442,187,63,124,1255,148,148,246,202,47,134,330
"2011","Blaenau Gwent 008B","W01001436","Total",1365,258,112,146,1107,92,150,246,182,74,112,251
"2011","Blaenau Gwent 008C","W01001437","Total",1558,179,74,105,1379,88,176,307,240,98,145,325
"2011","Blaenau Gwent 008D","W01001453","Total",1563,196,97,99,1367,110,152,253,214,144,206,288
"2011","Blaenau Gwent 008E","W01001454","Total",1404,183,84,99,1221,97,166,212,216,64,153,313
"2011","Blaenau Gwent 008F","W01001455","Total",1697,292,150,142,1405,115,196,395,220,42,113,324
"2011","Blaenau Gwent 009A","W01001464","Total",1532,249,109,140,1283,134,146,240,218,90,146,309
"2011","Blaenau Gwent 009B","W01001465","Total",1566,213,85,128,1353,101,192,323,256,79,101,301
"2011","Blaenau Gwent 009C","W01001466","Total",1687,274,122,152,1413,135,200,225,276,36,175,366
"2011","Blaenau Gwent 009D","W01001476","Total",1039,186,80,106,853,92,100,149,154,32,94,232
"2011","Blaenau Gwent 009E","W01001477","Total",1443,189,88,101,1254,73,148,303,270,67,133,260
"2011","Torfaen 001A","W01001487","Total",1550,213,99,114,1337,69,184,320,196,92,195,281
"2011","Torfaen 001B","W01001488","Total",1567,234,97,137,1333,106,168,334,206,117,173,229
"2011","Torfaen 001C","W01001489","Total",1612,224,113,111,1388,113,188,277,274,131,134,271
"2011","Torfaen 001D","W01001490","Total",1297,211,103,108,1086,75,164,290,196,63,120,178
"2011","Torfaen 002A","W01001482","Total",1212,122,57,65,1090,98,148,216,178,95,124,231
"2011","Torfaen 002B","W01001483","Total",1378,150,81,69,1228,139,138,319,172,112,124,224
"2011","Torfaen 002C","W01001484","Total",1729,155,74,81,1574,70,224,362,288,129,203,298
"2011","Torfaen 002D","W01001485","Total",1208,168,107,61,1040,96,140,262,162,63,114,203
"2011","Torfaen 002E","W01001486","Total",1502,206,77,129,1296,99,144,330,220,100,146,257
"2011","Torfaen 003A","W01001525","Total",1541,127,75,52,1414,110,188,238,220,86,262,310
"2011","Torfaen 003B","W01001529","Total",2004,327,118,209,1677,82,208,458,308,71,191,359
"2011","Torfaen 003C","W01001530","Total",1844,159,60,99,1685,241,126,333,220,177,255,333
"2011","Torfaen 003D","W01001531","Total",1755,201,102,99,1554,115,160,278,218,185,214,384
"2011","Torfaen 004A","W01001491","Total",1808,258,127,131,1550,152,192,401,302,77,179,247
"2011","Torfaen 004B","W01001496","Total",1438,142,69,73,1296,143,134,229,218,59,202,311
"2011","Torfaen 004C","W01001523","Total",1488,187,61,126,1301,81,150,298,232,45,159,336
"2011","Torfaen 004D","W01001524","Total",1798,288,135,153,1510,73,220,346,316,67,182,306
"2011","Torfaen 004E","W01001540","Total",1252,143,71,72,1109,41,114,272,228,67,132,255
"2011","Torfaen 004F","W01001541","Total",1112,108,45,63,1004,54,128,207,216,45,142,212
"2011","Torfaen 005A","W01001510","Total",1500,214,106,108,1286,98,218,303,206,62,152,247
"2011","Torfaen 005B","W01001511","Total",1604,227,109,118,1377,97,238,315,218,83,133,293
"2011","Torfaen 005C","W01001512","Total",1354,155,96,59,1199,33,284,233,230,32,94,293
"2011","Torfaen 005D","W01001513","Total",1503,150,78,72,1353,25,256,331,244,42,157,298
"2011","Torfaen 006A","W01001514","Total",1153,129,66,63,1024,46,166,229,190,71,67,255
"2011","Torfaen 006B","W01001515","Total",1472,183,64,119,1289,112,156,348,218,52,169,234
"2011","Torfaen 006C","W01001516","Total",1434,184,82,102,1250,64,194,284,196,68,157,287
"2011","Torfaen 006D","W01001517","Total",1953,245,83,162,1708,107,144,559,294,82,218,304
"2011","Torfaen 006E","W01001518","Total",1107,114,66,48,993,36,220,209,172,50,84,222
"2011","Torfaen 007A","W01001519","Total",1351,241,71,170,1110,124,120,238,170,62,134,262
"2011","Torfaen 007B","W01001520","Total",1765,177,68,109,1588,128,194,317,300,67,275,307
"2011","Torfaen 007C","W01001521","Total",1452,158,60,98,1294,126,172,259,238,66,132,301
"2011","Torfaen 007D","W01001522","Total",1701,284,168,116,1417,123,164,290,194,100,223,323
"2011","Torfaen 007E","W01001537","Total",1200,116,71,45,1084,35,174,217,204,36,137,281
"2011","Torfaen 008A","W01001493","Total",1941,316,147,169,1625,105,274,364,344,75,158,305
"2011","Torfaen 008B","W01001494","Total",1509,193,124,69,1316,66,280,219,186,97,150,318
"2011","Torfaen 008C","W01001495","Total",1796,301,211,90,1495,60,342,314,262,60,153,304
"2011","Torfaen 008D","W01001507","Total",2013,289,182,107,1724,134,332,418,274,59,187,320
"2011","Torfaen 009A","W01001501","Total",1344,101,33,68,1243,137,72,347,184,95,142,266
"2011","Torfaen 009B","W01001503","Total",1395,108,44,64,1287,147,110,306,156,109,231,228
"2011","Torfaen 009C","W01001536","Total",1199,129,33,96,1070,191,56,248,134,92,141,208
"2011","Torfaen 009D","W01001538","Total",1327,187,91,96,1140,154,122,248,156,76,144,240
"2011","Torfaen 009E","W01001539","Total",1472,150,68,82,1322,130,166,270,230,123,163,240
"2011","Torfaen 010A","W01001506","Total",1355,338,114,224,1017,70,140,186,196,28,216,181
"2011","Torfaen 010B","W01001526","Total",1341,171,65,106,1170,159,146,197,198,103,142,225
"2011","Torfaen 010C","W01001527","Total",1203,299,181,118,904,62,134,198,224,45,45,196
"2011","Torfaen 010D","W01001528","Total",1118,144,63,81,974,67,182,216,148,65,125,171
"2011","Torfaen 010E","W01001532","Total",1729,245,115,130,1484,150,170,326,248,110,222,258
"2011","Torfaen 011A","W01001497","Total",1492,173,98,75,1319,138,184,240,156,103,191,307
"2011","Torfaen 011B","W01001498","Total",1176,131,61,70,1045,117,154,190,146,73,156,209
"2011","Torfaen 011C","W01001499","Total",1203,136,35,101,1067,61,68,281,272,32,140,213
"2011","Torfaen 011D","W01001500","Total",1282,82,14,68,1200,37,86,325,270,20,183,279
"2011","Torfaen 011E","W01001502","Total",1329,86,30,56,1243,73,130,260,228,87,208,257
"2011","Torfaen 012A","W01001492","Total",2335,194,71,123,2141,116,262,532,376,127,302,426
"2011","Torfaen 012B","W01001533","Total",1637,98,32,66,1539,39,122,471,298,93,202,314
"2011","Torfaen 012C","W01001534","Total",1484,180,76,104,1304,56,170,321,266,83,129,279
"2011","Torfaen 012D","W01001535","Total",1335,142,50,92,1193,82,142,276,270,46,93,284
"2011","Torfaen 013A","W01001504","Total",2045,278,155,123,1767,111,242,372,262,161,260,359
"2011","Torfaen 013B","W01001505","Total",1995,183,94,89,1812,65,244,484,318,103,207,391
"2011","Torfaen 013C","W01001508","Total",1179,169,111,58,1010,26,240,134,148,44,178,240
"2011","Torfaen 013D","W01001509","Total",1482,140,92,48,1342,60,246,311,224,36,127,338
"2011","Monmouthshire 001A","W01001545","Total",1378,202,139,63,1176,29,310,189,198,69,126,255
"2011","Monmouthshire 001B","W01001548","Total",2121,194,97,97,1927,57,304,397,360,153,245,411
"2011","Monmouthshire 001C","W01001557","Total",1827,400,176,224,1427,118,194,325,304,70,160,256
"2011","Monmouthshire 001D","W01001571","Total",1238,115,67,48,1123,47,202,172,208,55,152,287
"2011","Monmouthshire 001E","W01001579","Total",1433,316,149,167,1117,64,268,221,230,31,76,227
"2011","Monmouthshire 002A","W01001546","Total",1521,219,98,121,1302,104,122,316,226,131,206,197
"2011","Monmouthshire 002C","W01001558","Total",1527,257,152,105,1270,68,228,303,186,55,134,296
"2011","Monmouthshire 002E","W01001580","Total",1784,278,144,134,1506,75,250,334,288,144,139,276
"2011","Monmouthshire 002F","W01001909","Total",2651,367,199,168,2284,185,326,511,388,168,281,425
"2011","Monmouthshire 003A","W01001561","Total",1405,172,107,65,1233,34,368,193,262,40,107,229
"2011","Monmouthshire 003B","W01001562","Total",1395,180,66,114,1215,74,150,270,234,51,127,309
"2011","Monmouthshire 003C","W01001563","Total",1013,168,95,73,845,71,136,136,130,42,108,222
"2011","Monmouthshire 003D","W01001564","Total",2307,295,173,122,2012,112,414,413,314,141,264,354
"2011","Monmouthshire 003E","W01001569","Total",1442,161,82,79,1281,56,278,244,206,76,116,305
"2011","Monmouthshire 004A","W01001552","Total",1564,128,90,38,1436,44,334,252,212,125,142,327
"2011","Monmouthshire 004B","W01001553","Total",2745,276,115,161,2469,142,322,738,422,162,326,357
"2011","Monmouthshire 004C","W01001554","Total",1399,316,154,162,1083,131,220,202,212,75,78,165
"2011","Monmouthshire 004D","W01001576","Total",1084,163,62,101,921,85,116,252,188,43,68,169
"2011","Monmouthshire 004E","W01001577","Total",1193,285,160,125,908,64,154,230,162,65,71,162
"2011","Monmouthshire 004F","W01001599","Total",2119,314,168,146,1805,102,354,359,326,121,198,345
"2011","Monmouthshire 005A","W01001566","Total",1187,97,48,49,1090,38,210,183,210,81,131,237
"2011","Monmouthshire 005B","W01001567","Total",981,117,60,57,864,29,164,129,186,20,137,199
"2011","Monmouthshire 005C","W01001568","Total",1748,136,70,66,1612,41,268,323,302,76,237,365
"2011","Monmouthshire 005D","W01001575","Total",1235,101,60,41,1134,13,198,208,226,130,105,254
"2011","Monmouthshire 005E","W01001581","Total",1927,254,178,76,1673,45,330,367,306,78,168,379
"2011","Monmouthshire 006A","W01001555","Total",1186,101,61,40,1085,23,210,220,186,45,162,239
"2011","Monmouthshire 006B","W01001556","Total",1184,146,75,71,1038,61,158,246,208,82,117,166
"2011","Monmouthshire 006C","W01001560","Total",1296,90,34,56,1206,51,228,193,218,41,182,293
"2011","Monmouthshire 006D","W01001565","Total",1818,159,79,80,1659,41,276,289,268,104,286,395
"2011","Monmouthshire 006E","W01001596","Total",941,220,156,64,721,78,182,153,140,30,50,88
"2011","Monmouthshire 006F","W01001597","Total",1497,211,89,122,1286,73,216,336,192,66,132,271
"2011","Monmouthshire 007A","W01001549","Total",1469,126,66,60,1343,20,254,245,262,82,228,252
"2011","Monmouthshire 007B","W01001583","Total",1618,139,85,54,1479,10,300,305,274,156,102,332
"2011","Monmouthshire 007C","W01001585","Total",1269,105,64,41,1164,19,200,366,186,66,104,223
"2011","Monmouthshire 007D","W01001586","Total",2473,181,79,102,2292,99,292,723,402,206,256,314
"2011","Monmouthshire 007E","W01001594","Total",1377,100,60,40,1277,39,190,243,258,120,180,247
"2011","Monmouthshire 007F","W01001595","Total",1299,103,60,43,1196,29,246,238,228,96,163,196
"2011","Monmouthshire 008A","W01001559","Total",1330,145,84,61,1185,51,260,240,170,94,134,236
"2011","Monmouthshire 008B","W01001584","Total",1891,193,95,98,1698,108,198,383,326,140,190,353
"2011","Monmouthshire 008C","W01001587","Total",1821,467,183,284,1354,130,126,322,370,77,115,214
"2011","Monmouthshire 008D","W01001592","Total",1713,191,78,113,1522,210,112,318,234,184,210,254
"2011","Monmouthshire 008E","W01001593","Total",1727,196,77,119,1531,112,172,344,304,93,192,314
"2011","Monmouthshire 009A","W01001542","Total",1759,169,77,92,1590,41,284,347,294,98,173,353
"2011","Monmouthshire 009B","W01001543","Total",1440,103,55,48,1337,32,192,311,220,118,167,297
"2011","Monmouthshire 009C","W01001578","Total",2126,215,145,70,1911,47,298,368,376,115,222,485
"2011","Monmouthshire 009D","W01001590","Total",2172,169,96,73,2003,37,364,450,338,74,274,466
"2011","Monmouthshire 010C","W01001551","Total",1179,112,81,31,1067,93,156,274,148,60,129,207
"2011","Monmouthshire 010D","W01001588","Total",1712,184,116,68,1528,18,330,329,266,61,175,349
"2011","Monmouthshire 010E","W01001589","Total",1464,209,77,132,1255,64,182,272,238,48,125,326
"2011","Monmouthshire 010F","W01001598","Total",1624,169,86,83,1455,117,188,316,234,83,196,321
"2011","Monmouthshire 010G","W01001908","Total",2141,265,172,93,1876,127,314,370,334,73,181,477
"2011","Monmouthshire 011A","W01001572","Total",1574,131,83,48,1443,55,204,427,200,121,161,275
"2011","Monmouthshire 011B","W01001573","Total",1503,87,50,37,1416,34,168,318,258,87,236,315
"2011","Monmouthshire 011C","W01001574","Total",1487,137,39,98,1350,55,148,417,320,42,127,241
"2011","Monmouthshire 011D","W01001582","Total",1813,156,80,76,1657,112,160,439,254,109,247,336
"2011","Monmouthshire 011E","W01001591","Total",1567,102,24,78,1465,52,124,512,254,104,157,262
"2011","Newport 001A","W01001623","Total",1416,227,107,120,1189,66,166,313,238,50,84,272
"2011","Newport 001B","W01001624","Total",1240,115,35,80,1125,93,118,335,198,72,110,199
"2011","Newport 001C","W01001625","Total",1277,156,80,76,1121,47,194,223,226,72,121,238
"2011","Newport 001D","W01001626","Total",1370,133,77,56,1237,74,240,221,194,37,146,325
"2011","Newport 001E","W01001627","Total",1553,140,71,69,1413,59,242,280,220,75,149,388
"2011","Newport 001F","W01001628","Total",1069,203,120,83,866,78,150,169,116,35,130,188
"2011","Newport 002A","W01001651","Total",1518,155,103,52,1363,36,256,281,232,58,160,340
"2011","Newport 002B","W01001652","Total",1742,312,129,183,1430,240,146,296,190,103,206,249
"2011","Newport 002C","W01001653","Total",1449,137,80,57,1312,60,264,321,210,73,106,278
"2011","Newport 002D","W01001654","Total",1629,162,81,81,1467,82,228,396,246,73,159,283
"2011","Newport 002E","W01001655","Total",1587,143,79,64,1444,65,216,312,274,79,169,329
"2011","Newport 003A","W01001617","Total",1289,205,76,129,1084,167,142,225,144,87,151,168
"2011","Newport 003B","W01001618","Total",1115,157,63,94,958,111,154,144,140,72,97,240
"2011","Newport 003C","W01001619","Total",1381,205,45,160,1176,173,136,225,156,89,181,216
"2011","Newport 003D","W01001620","Total",1162,139,60,79,1023,104,106,258,158,54,166,177
"2011","Newport 003E","W01001621","Total",1368,216,97,119,1152,118,154,223,186,57,183,231
"2011","Newport 003F","W01001622","Total",1241,164,35,129,1077,87,150,226,174,90,128,222
"2011","Newport 004A","W01001639","Total",1911,128,54,74,1783,74,182,568,320,105,275,259
"2011","Newport 004B","W01001640","Total",1140,123,87,36,1017,20,226,178,194,15,145,239
"2011","Newport 004C","W01001641","Total",1310,110,63,47,1200,12,230,273,248,57,135,245
"2011","Newport 004D","W01001649","Total",1470,144,76,68,1326,77,224,262,220,68,157,318
"2011","Newport 004E","W01001650","Total",1489,166,64,102,1323,106,128,253,268,143,151,274
"2011","Newport 005A","W01001614","Total",1496,387,195,192,1109,147,156,239,188,48,161,170
"2011","Newport 005B","W01001615","Total",1531,148,88,60,1383,137,142,335,210,130,173,256
"2011","Newport 005C","W01001616","Total",1436,191,97,94,1245,45,194,247,244,52,180,283
"2011","Newport 005D","W01001678","Total",1609,231,57,174,1378,117,150,293,244,109,185,280
"2011","Newport 006A","W01001601","Total",1463,215,42,173,1248,210,90,244,216,97,137,254
"2011","Newport 006B","W01001681","Total",1315,287,101,186,1028,180,100,174,216,50,102,206
"2011","Newport 006C","W01001682","Total",1271,218,119,99,1053,117,140,219,216,47,102,212
"2011","Newport 006D","W01001683","Total",1104,140,57,83,964,115,108,201,204,53,90,193
"2011","Newport 006E","W01001684","Total",1409,205,54,151,1204,94,78,279,320,82,88,263
"2011","Newport 007A","W01001675","Total",1550,182,61,121,1368,120,112,308,184,91,210,343
"2011","Newport 007B","W01001676","Total",1651,237,54,183,1414,179,106,359,274,100,141,255
"2011","Newport 007C","W01001677","Total",1461,194,96,98,1267,111,210,316,218,62,116,234
"2011","Newport 007D","W01001679","Total",1155,107,71,36,1048,50,132,192,174,61,186,253
"2011","Newport 007E","W01001680","Total",1242,125,55,70,1117,121,70,220,226,76,142,262
"2011","Newport 008A","W01001606","Total",1272,135,90,45,1137,50,180,231,152,67,159,298
"2011","Newport 008B","W01001608","Total",1541,166,80,86,1375,88,210,289,224,69,242,253
"2011","Newport 008C","W01001663","Total",1500,251,135,116,1249,131,260,160,160,64,187,287
"2011","Newport 008D","W01001665","Total",1605,257,149,108,1348,125,274,253,236,67,146,247
"2011","Newport 009A","W01001669","Total",1350,88,46,42,1262,14,194,275,230,78,152,319
"2011","Newport 009B","W01001670","Total",2341,146,55,91,2195,83,234,765,316,169,301,327
"2011","Newport 009C","W01001672","Total",1751,226,140,86,1525,108,170,435,234,158,160,260
"2011","Newport 009D","W01001673","Total",1449,171,95,76,1278,42,302,256,234,56,104,284
"2011","Newport 009E","W01001674","Total",1489,152,97,55,1337,101,222,281,208,62,190,273
"2011","Newport 010A","W01001664","Total",1425,248,137,111,1177,154,190,218,146,87,132,250
"2011","Newport 010B","W01001666","Total",1477,216,119,97,1261,156,158,261,142,131,185,228
"2011","Newport 010C","W01001667","Total",1347,130,60,70,1217,205,116,229,142,121,170,234
"2011","Newport 010D","W01001668","Total",1140,143,64,79,997,127,148,172,124,114,114,198
"2011","Newport 011A","W01001611","Total",1319,155,57,98,1164,101,102,314,168,76,189,214
"2011","Newport 011B","W01001612","Total",1537,214,96,118,1323,81,136,258,236,71,172,369
"2011","Newport 011C","W01001613","Total",1554,163,67,96,1391,64,154,358,208,97,248,262
"2011","Newport 011D","W01001691","Total",1443,244,80,164,1199,167,124,151,230,99,184,244
"2011","Newport 011E","W01001692","Total",1988,302,65,237,1686,158,112,370,276,107,303,360
"2011","Newport 012A","W01001600","Total",1558,185,101,84,1373,51,278,330,236,100,129,249
"2011","Newport 012B","W01001602","Total",1507,197,121,76,1310,24,264,356,262,72,99,233
"2011","Newport 012C","W01001603","Total",1336,218,61,157,1118,31,92,247,194,102,172,280
"2011","Newport 012D","W01001604","Total",1466,158,108,50,1308,40,274,334,184,95,123,258
"2011","Newport 013A","W01001642","Total",1691,291,89,202,1400,212,92,335,276,105,139,241
"2011","Newport 013B","W01001643","Total",1486,151,38,113,1335,240,58,304,164,154,219,196
"2011","Newport 013C","W01001644","Total",2681,331,54,277,2350,292,122,626,510,160,258,382
"2011","Newport 013D","W01001690","Total",2216,321,71,250,1895,207,116,458,332,142,329,311
"2011","Newport 013E","W01001693","Total",1718,260,41,219,1458,60,70,214,174,121,478,341
"2011","Newport 014A","W01001605","Total",1315,286,99,187,1029,65,114,204,188,61,134,263
"2011","Newport 014B","W01001685","Total",1650,330,97,233,1320,110,92,265,244,89,139,381
"2011","Newport 014C","W01001686","Total",1292,188,54,134,1104,58,92,206,236,89,196,227
"2011","Newport 014D","W01001687","Total",1712,453,80,373,1259,61,88,213,338,81,223,255
"2011","Newport 015A","W01001607","Total",1421,101,29,72,1320,213,46,287,142,175,235,222
"2011","Newport 015B","W01001609","Total",1467,142,49,93,1325,285,54,248,188,132,191,227
"2011","Newport 015C","W01001610","Total",1301,117,65,52,1184,66,138,263,192,107,189,229
"2011","Newport 015D","W01001645","Total",1363,94,45,49,1269,139,102,258,236,141,175,218
"2011","Newport 015E","W01001646","Total",1529,181,90,91,1348,195,184,210,160,131,216,252
"2011","Newport 015F","W01001647","Total",1483,167,96,71,1316,44,282,216,218,41,207,308
"2011","Newport 015G","W01001648","Total",1522,177,110,67,1345,126,194,289,202,72,186,276
"2011","Newport 016A","W01001635","Total",1348,203,81,122,1145,37,148,405,188,67,87,213
"2011","Newport 016B","W01001637","Total",1724,191,115,76,1533,111,202,393,230,106,245,246
"2011","Newport 016C","W01001638","Total",1190,98,61,37,1092,32,172,294,148,66,147,233
"2011","Newport 016D","W01001671","Total",1719,331,134,197,1388,141,188,359,274,60,100,266
"2011","Newport 017A","W01001629","Total",1342,207,125,82,1135,54,276,164,236,74,92,239
"2011","Newport 017B","W01001630","Total",1462,386,228,158,1076,121,222,158,216,57,94,208
"2011","Newport 017C","W01001631","Total",1399,179,77,102,1220,61,180,382,228,52,62,255
"2011","Newport 017D","W01001632","Total",1377,191,98,93,1186,139,112,260,178,72,145,280
"2011","Newport 018A","W01001659","Total",1790,366,127,239,1424,183,68,254,188,215,324,192
"2011","Newport 018B","W01001660","Total",1536,214,59,155,1322,110,100,253,190,102,307,260
"2011","Newport 018C","W01001661","Total",2599,310,57,253,2289,178,54,286,300,278,375,818
"2011","Newport 018D","W01001662","Total",1347,308,128,180,1039,87,72,161,162,127,293,137
"2011","Newport 019A","W01001633","Total",1535,177,68,109,1358,233,100,284,184,154,206,197
"2011","Newport 019B","W01001634","Total",1529,167,71,96,1362,148,134,264,182,160,196,278
"2011","Newport 019C","W01001688","Total",2648,276,33,243,2372,287,92,689,526,222,199,357
"2011","Newport 019D","W01001689","Total",1773,304,216,88,1469,276,164,252,168,156,250,203
"2011","Newport 020A","W01001636","Total",1897,126,39,87,1771,74,120,715,264,115,198,285
"2011","Newport 020C","W01001657","Total",1463,79,30,49,1384,36,138,461,252,62,174,261
"2011","Newport 020D","W01001658","Total",1848,139,72,67,1709,68,172,526,272,128,250,293
"2011","Newport 020E","W01001912","Total",1476,179,69,110,1297,54,214,314,294,68,131,222
"2011","Newport 020F","W01001913","Total",1440,156,15,141,1284,69,56,460,328,80,101,190
