"date","geography","geography code","Rural Urban","Household Spaces: All categories: Household spaces; measures: Value","Household Spaces: Household spaces with at least one usual resident; measures: Value","Household Spaces: Household spaces with no usual residents; measures: Value"
"2011","Darlington 001B","E01012334","Total",1019,962,57
"2011","Darlington 001C","E01012335","Total",635,620,15
"2011","Darlington 001D","E01012366","Total",908,860,48
"2011","Darlington 001E","E01033481","Total",588,554,34
"2011","Darlington 001F","E01033482","Total",666,650,16
"2011","Darlington 002C","E01012323","Total",676,657,19
"2011","Darlington 002D","E01012324","Total",657,627,30
"2011","Darlington 002E","E01032545","Total",542,525,17
"2011","Darlington 002F","E01032546","Total",721,702,19
"2011","Darlington 003A","E01012328","Total",786,768,18
"2011","Darlington 003B","E01012329","Total",798,776,22
"2011","Darlington 003C","E01012330","Total",461,458,3
"2011","Darlington 003D","E01012331","Total",522,505,17
"2011","Darlington 004A","E01012349","Total",873,798,75
"2011","Darlington 004B","E01012350","Total",822,775,47
"2011","Darlington 004C","E01012351","Total",568,556,12
"2011","Darlington 004D","E01012352","Total",848,804,44
"2011","Darlington 005A","E01012325","Total",681,657,24
"2011","Darlington 005B","E01012326","Total",509,502,7
"2011","Darlington 005C","E01012332","Total",607,592,15
"2011","Darlington 005D","E01012333","Total",596,592,4
"2011","Darlington 006A","E01012309","Total",770,760,10
"2011","Darlington 006B","E01012310","Total",899,864,35
"2011","Darlington 006C","E01012311","Total",643,633,10
"2011","Darlington 006D","E01012312","Total",652,625,27
"2011","Darlington 006E","E01012313","Total",703,664,39
"2011","Darlington 006F","E01012314","Total",606,591,15
"2011","Darlington 007A","E01012362","Total",768,703,65
"2011","Darlington 007B","E01012363","Total",717,684,33
"2011","Darlington 007C","E01012364","Total",795,740,55
"2011","Darlington 007D","E01012365","Total",553,540,13
"2011","Darlington 008B","E01012353","Total",836,780,56
"2011","Darlington 008C","E01012354","Total",853,737,116
"2011","Darlington 008D","E01012355","Total",740,710,30
"2011","Darlington 008E","E01033483","Total",610,552,58
"2011","Darlington 008F","E01033484","Total",770,696,74
"2011","Darlington 009A","E01012307","Total",912,878,34
"2011","Darlington 009B","E01012327","Total",641,625,16
"2011","Darlington 009C","E01012342","Total",842,819,23
"2011","Darlington 009D","E01012343","Total",909,887,22
"2011","Darlington 010A","E01012315","Total",703,688,15
"2011","Darlington 010B","E01012316","Total",1249,1163,86
"2011","Darlington 010C","E01012360","Total",829,783,46
"2011","Darlington 011A","E01012336","Total",734,725,9
"2011","Darlington 011B","E01012337","Total",734,709,25
"2011","Darlington 011C","E01012347","Total",780,765,15
"2011","Darlington 011D","E01012348","Total",943,915,28
"2011","Darlington 011E","E01012361","Total",813,798,15
"2011","Darlington 012A","E01012304","Total",692,649,43
"2011","Darlington 012B","E01012305","Total",655,622,33
"2011","Darlington 012C","E01012306","Total",641,601,40
"2011","Darlington 012D","E01012340","Total",1089,1053,36
"2011","Darlington 012E","E01012341","Total",819,798,21
"2011","Darlington 013A","E01012317","Total",649,624,25
"2011","Darlington 013B","E01012318","Total",1040,1015,25
"2011","Darlington 013C","E01012319","Total",1146,1119,27
"2011","Darlington 014A","E01012356","Total",799,742,57
"2011","Darlington 014B","E01012357","Total",660,606,54
"2011","Darlington 014C","E01012358","Total",731,708,23
"2011","Darlington 014D","E01012359","Total",744,671,73
"2011","Darlington 015A","E01012338","Total",876,848,28
"2011","Darlington 015B","E01012339","Total",784,756,28
"2011","Darlington 015C","E01012344","Total",635,605,30
"2011","Darlington 015D","E01012345","Total",603,580,23
"2011","Darlington 015E","E01012346","Total",711,699,12
"2011","County Durham 002A","E01020613","Total",551,545,6
"2011","County Durham 002B","E01020614","Total",680,670,10
"2011","County Durham 002C","E01020622","Total",697,677,20
"2011","County Durham 002D","E01020623","Total",632,626,6
"2011","County Durham 005A","E01020606","Total",792,750,42
"2011","County Durham 005B","E01020615","Total",775,755,20
"2011","County Durham 005C","E01020616","Total",806,780,26
"2011","County Durham 005D","E01020617","Total",861,846,15
"2011","County Durham 007A","E01020596","Total",773,758,15
"2011","County Durham 007B","E01020597","Total",677,662,15
"2011","County Durham 007C","E01020598","Total",871,839,32
"2011","County Durham 007D","E01020611","Total",600,582,18
"2011","County Durham 007E","E01020612","Total",692,682,10
"2011","County Durham 011A","E01020592","Total",668,655,13
"2011","County Durham 011B","E01020593","Total",690,638,52
"2011","County Durham 011C","E01020599","Total",891,871,20
"2011","County Durham 011D","E01020601","Total",660,650,10
"2011","County Durham 011E","E01020602","Total",902,890,12
"2011","County Durham 011F","E01020618","Total",742,708,34
"2011","County Durham 013A","E01020594","Total",831,788,43
"2011","County Durham 013B","E01020595","Total",811,773,38
"2011","County Durham 013C","E01020600","Total",669,652,17
"2011","County Durham 013D","E01020603","Total",678,671,7
"2011","County Durham 013E","E01020605","Total",796,771,25
"2011","County Durham 015A","E01020590","Total",586,570,16
"2011","County Durham 015B","E01020591","Total",666,645,21
"2011","County Durham 015C","E01020608","Total",768,749,19
"2011","County Durham 015D","E01020609","Total",619,609,10
"2011","County Durham 015E","E01020610","Total",649,640,9
"2011","County Durham 019A","E01020604","Total",649,632,17
"2011","County Durham 019B","E01020607","Total",736,703,33
"2011","County Durham 019C","E01020619","Total",698,677,21
"2011","County Durham 019D","E01020620","Total",695,658,37
"2011","County Durham 019E","E01020621","Total",887,859,28
"2011","County Durham 001A","E01020634","Total",685,666,19
"2011","County Durham 001B","E01020635","Total",631,615,16
"2011","County Durham 001C","E01020636","Total",838,811,27
"2011","County Durham 001D","E01020654","Total",781,759,22
"2011","County Durham 001E","E01020676","Total",726,699,27
"2011","County Durham 003A","E01020627","Total",729,703,26
"2011","County Durham 003B","E01020628","Total",784,728,56
"2011","County Durham 003C","E01020629","Total",636,623,13
"2011","County Durham 003D","E01020655","Total",864,835,29
"2011","County Durham 003E","E01020656","Total",705,678,27
"2011","County Durham 003F","E01020657","Total",630,611,19
"2011","County Durham 004A","E01020661","Total",868,818,50
"2011","County Durham 004B","E01020662","Total",808,782,26
"2011","County Durham 004C","E01020663","Total",872,842,30
"2011","County Durham 004D","E01020674","Total",772,738,34
"2011","County Durham 004E","E01020678","Total",593,578,15
"2011","County Durham 006A","E01020626","Total",782,758,24
"2011","County Durham 006B","E01020638","Total",746,706,40
"2011","County Durham 006C","E01020639","Total",697,664,33
"2011","County Durham 006D","E01020653","Total",718,692,26
"2011","County Durham 006E","E01020677","Total",689,671,18
"2011","County Durham 008A","E01020647","Total",878,857,21
"2011","County Durham 008B","E01020648","Total",801,778,23
"2011","County Durham 008C","E01020649","Total",730,688,42
"2011","County Durham 008D","E01020673","Total",823,791,32
"2011","County Durham 008E","E01020675","Total",826,799,27
"2011","County Durham 009A","E01020624","Total",780,710,70
"2011","County Durham 009B","E01020625","Total",729,684,45
"2011","County Durham 009C","E01020670","Total",797,753,44
"2011","County Durham 009D","E01020671","Total",694,612,82
"2011","County Durham 009E","E01020672","Total",844,771,73
"2011","County Durham 010A","E01020632","Total",863,812,51
"2011","County Durham 010B","E01020640","Total",1054,991,63
"2011","County Durham 010C","E01020641","Total",1017,968,49
"2011","County Durham 010D","E01020642","Total",658,626,32
"2011","County Durham 010E","E01020643","Total",1121,1051,70
"2011","County Durham 010F","E01020667","Total",835,805,30
"2011","County Durham 012A","E01020650","Total",972,927,45
"2011","County Durham 012B","E01020651","Total",829,801,28
"2011","County Durham 012C","E01020652","Total",877,849,28
"2011","County Durham 012D","E01020668","Total",715,683,32
"2011","County Durham 012E","E01020669","Total",671,636,35
"2011","County Durham 014A","E01020630","Total",608,597,11
"2011","County Durham 014B","E01020631","Total",805,782,23
"2011","County Durham 014C","E01020637","Total",774,730,44
"2011","County Durham 014D","E01020644","Total",1112,1054,58
"2011","County Durham 014E","E01020645","Total",717,653,64
"2011","County Durham 020A","E01020633","Total",731,707,24
"2011","County Durham 020B","E01020664","Total",724,679,45
"2011","County Durham 020C","E01020665","Total",667,652,15
"2011","County Durham 020D","E01020666","Total",651,643,8
"2011","County Durham 024A","E01020646","Total",721,688,33
"2011","County Durham 024B","E01020658","Total",872,828,44
"2011","County Durham 024C","E01020659","Total",696,668,28
"2011","County Durham 024D","E01020660","Total",735,694,41
"2011","County Durham 022A","E01020709","Total",604,584,20
"2011","County Durham 022B","E01020717","Total",778,765,13
"2011","County Durham 022C","E01020718","Total",645,619,26
"2011","County Durham 022D","E01020719","Total",542,533,9
"2011","County Durham 022E","E01020721","Total",494,486,8
"2011","County Durham 023A","E01020708","Total",560,535,25
"2011","County Durham 023B","E01020710","Total",770,746,24
"2011","County Durham 023C","E01020711","Total",810,789,21
"2011","County Durham 023D","E01020720","Total",716,699,17
"2011","County Durham 026A","E01020679","Total",750,714,36
"2011","County Durham 026B","E01020680","Total",707,677,30
"2011","County Durham 026C","E01020681","Total",703,693,10
"2011","County Durham 026D","E01020714","Total",716,695,21
"2011","County Durham 026E","E01020716","Total",809,747,62
"2011","County Durham 027A","E01020725","Total",683,657,26
"2011","County Durham 027B","E01020726","Total",559,538,21
"2011","County Durham 027C","E01020727","Total",558,538,20
"2011","County Durham 027D","E01020729","Total",990,943,47
"2011","County Durham 027E","E01020730","Total",835,808,27
"2011","County Durham 027F","E01020731","Total",653,634,19
"2011","County Durham 028A","E01020682","Total",845,834,11
"2011","County Durham 028B","E01020683","Total",685,664,21
"2011","County Durham 028C","E01020690","Total",654,635,19
"2011","County Durham 028D","E01020691","Total",631,617,14
"2011","County Durham 028E","E01020692","Total",681,659,22
"2011","County Durham 029A","E01020693","Total",669,629,40
"2011","County Durham 029B","E01020722","Total",913,882,31
"2011","County Durham 029C","E01020723","Total",813,772,41
"2011","County Durham 029D","E01020724","Total",691,674,17
"2011","County Durham 030A","E01020703","Total",729,695,34
"2011","County Durham 030D","E01033164","Total",467,436,31
"2011","County Durham 030E","E01033195","Total",425,411,14
"2011","County Durham 030F","E01033197","Total",452,401,51
"2011","County Durham 030G","E01033221","Total",448,420,28
"2011","County Durham 033A","E01020684","Total",1071,994,77
"2011","County Durham 033B","E01020702","Total",877,825,52
"2011","County Durham 033C","E01020704","Total",563,553,10
"2011","County Durham 033D","E01020712","Total",718,679,39
"2011","County Durham 033E","E01020713","Total",825,794,31
"2011","County Durham 031A","E01020705","Total",752,720,32
"2011","County Durham 031B","E01020706","Total",918,856,62
"2011","County Durham 031C","E01020715","Total",1142,1068,74
"2011","County Durham 038A","E01020685","Total",725,714,11
"2011","County Durham 038B","E01020686","Total",815,797,18
"2011","County Durham 038C","E01020687","Total",736,719,17
"2011","County Durham 038D","E01020688","Total",704,681,23
"2011","County Durham 038E","E01020689","Total",655,643,12
"2011","County Durham 041A","E01020694","Total",710,687,23
"2011","County Durham 041B","E01020696","Total",642,609,33
"2011","County Durham 041C","E01020697","Total",687,631,56
"2011","County Durham 041D","E01020732","Total",765,739,26
"2011","County Durham 044A","E01020695","Total",840,807,33
"2011","County Durham 044B","E01020698","Total",666,654,12
"2011","County Durham 044C","E01020699","Total",536,516,20
"2011","County Durham 044D","E01020700","Total",727,712,15
"2011","County Durham 044E","E01020701","Total",618,604,14
"2011","County Durham 016A","E01020750","Total",541,534,7
"2011","County Durham 016B","E01020781","Total",498,492,6
"2011","County Durham 016D","E01020786","Total",678,669,9
"2011","County Durham 016E","E01020787","Total",829,812,17
"2011","County Durham 016F","E01033163","Total",840,820,20
"2011","County Durham 016G","E01033202","Total",532,524,8
"2011","County Durham 017A","E01020740","Total",571,561,10
"2011","County Durham 017B","E01020741","Total",569,534,35
"2011","County Durham 017C","E01020742","Total",770,723,47
"2011","County Durham 017D","E01020782","Total",517,514,3
"2011","County Durham 017E","E01020783","Total",603,593,10
"2011","County Durham 017F","E01020784","Total",783,737,46
"2011","County Durham 018A","E01020743","Total",563,560,3
"2011","County Durham 018B","E01020747","Total",499,492,7
"2011","County Durham 018C","E01020748","Total",517,508,9
"2011","County Durham 018D","E01020749","Total",776,758,18
"2011","County Durham 018E","E01020773","Total",671,658,13
"2011","County Durham 018F","E01020775","Total",807,793,14
"2011","County Durham 021C","E01020776","Total",821,805,16
"2011","County Durham 021D","E01033161","Total",634,616,18
"2011","County Durham 021E","E01033198","Total",666,639,27
"2011","County Durham 021F","E01033205","Total",656,625,31
"2011","County Durham 021G","E01033206","Total",676,652,24
"2011","County Durham 025A","E01020751","Total",895,819,76
"2011","County Durham 025B","E01020752","Total",681,580,101
"2011","County Durham 025C","E01020754","Total",655,633,22
"2011","County Durham 025D","E01020756","Total",577,556,21
"2011","County Durham 032A","E01020745","Total",594,588,6
"2011","County Durham 032B","E01020753","Total",883,864,19
"2011","County Durham 032C","E01020757","Total",478,469,9
"2011","County Durham 032D","E01020758","Total",632,624,8
"2011","County Durham 032E","E01020759","Total",471,462,9
"2011","County Durham 032F","E01020765","Total",733,715,18
"2011","County Durham 034A","E01020760","Total",712,692,20
"2011","County Durham 034B","E01020761","Total",576,548,28
"2011","County Durham 034C","E01020762","Total",667,648,19
"2011","County Durham 034D","E01020763","Total",863,825,38
"2011","County Durham 036A","E01020764","Total",727,686,41
"2011","County Durham 036B","E01020766","Total",703,692,11
"2011","County Durham 036C","E01020767","Total",911,873,38
"2011","County Durham 036D","E01020768","Total",684,662,22
"2011","County Durham 035A","E01020733","Total",513,507,6
"2011","County Durham 035B","E01020734","Total",522,513,9
"2011","County Durham 035C","E01020735","Total",639,626,13
"2011","County Durham 035D","E01020770","Total",507,502,5
"2011","County Durham 035E","E01020771","Total",462,457,5
"2011","County Durham 035F","E01020780","Total",518,510,8
"2011","County Durham 037A","E01020746","Total",496,489,7
"2011","County Durham 037B","E01020769","Total",485,476,9
"2011","County Durham 037C","E01020777","Total",686,673,13
"2011","County Durham 037D","E01020778","Total",521,511,10
"2011","County Durham 037E","E01020779","Total",662,658,4
"2011","County Durham 039A","E01020736","Total",541,521,20
"2011","County Durham 039B","E01020737","Total",621,598,23
"2011","County Durham 039C","E01020738","Total",513,488,25
"2011","County Durham 039D","E01020739","Total",728,686,42
"2011","County Durham 039E","E01020744","Total",454,449,5
"2011","County Durham 040A","E01020788","Total",693,664,29
"2011","County Durham 040B","E01020789","Total",669,634,35
"2011","County Durham 040C","E01020790","Total",611,590,21
"2011","County Durham 040D","E01020791","Total",609,588,21
"2011","County Durham 040E","E01020792","Total",655,608,47
"2011","County Durham 043A","E01020772","Total",880,854,26
"2011","County Durham 043B","E01020793","Total",782,762,20
"2011","County Durham 043C","E01020794","Total",759,738,21
"2011","County Durham 043D","E01020795","Total",817,759,58
"2011","County Durham 047A","E01020817","Total",544,542,2
"2011","County Durham 047B","E01020818","Total",690,667,23
"2011","County Durham 047C","E01020819","Total",515,507,8
"2011","County Durham 047D","E01020837","Total",758,751,7
"2011","County Durham 047E","E01020843","Total",741,728,13
"2011","County Durham 048A","E01020809","Total",640,635,5
"2011","County Durham 048B","E01020810","Total",566,551,15
"2011","County Durham 048C","E01020811","Total",574,559,15
"2011","County Durham 048D","E01020812","Total",686,669,17
"2011","County Durham 048E","E01020827","Total",813,778,35
"2011","County Durham 049A","E01020806","Total",638,622,16
"2011","County Durham 049B","E01020807","Total",743,668,75
"2011","County Durham 049C","E01020820","Total",755,732,23
"2011","County Durham 049D","E01020842","Total",945,907,38
"2011","County Durham 050A","E01020797","Total",1286,1198,88
"2011","County Durham 050B","E01020798","Total",751,735,16
"2011","County Durham 050C","E01020799","Total",705,683,22
"2011","County Durham 050D","E01020808","Total",676,648,28
"2011","County Durham 052A","E01020821","Total",773,752,21
"2011","County Durham 052B","E01020822","Total",820,799,21
"2011","County Durham 052C","E01020823","Total",877,853,24
"2011","County Durham 052D","E01020835","Total",745,696,49
"2011","County Durham 052E","E01020836","Total",982,937,45
"2011","County Durham 053B","E01020803","Total",915,830,85
"2011","County Durham 053D","E01020805","Total",995,945,50
"2011","County Durham 053E","E01033203","Total",1339,1254,85
"2011","County Durham 054A","E01020796","Total",579,559,20
"2011","County Durham 054B","E01020828","Total",685,667,18
"2011","County Durham 054C","E01020829","Total",1059,1039,20
"2011","County Durham 054D","E01020830","Total",779,732,47
"2011","County Durham 059A","E01020801","Total",761,716,45
"2011","County Durham 059B","E01020802","Total",993,939,54
"2011","County Durham 059C","E01020838","Total",860,812,48
"2011","County Durham 059D","E01020839","Total",817,788,29
"2011","County Durham 059E","E01020840","Total",742,721,21
"2011","County Durham 059F","E01020841","Total",867,836,31
"2011","County Durham 060A","E01020813","Total",522,508,14
"2011","County Durham 060B","E01020814","Total",619,610,9
"2011","County Durham 060C","E01020815","Total",517,511,6
"2011","County Durham 060D","E01020848","Total",529,508,21
"2011","County Durham 060E","E01020850","Total",721,699,22
"2011","County Durham 060F","E01020851","Total",650,638,12
"2011","County Durham 061A","E01020816","Total",601,589,12
"2011","County Durham 061B","E01020844","Total",700,679,21
"2011","County Durham 061C","E01020847","Total",633,614,19
"2011","County Durham 061D","E01020849","Total",534,519,15
"2011","County Durham 062A","E01020825","Total",733,717,16
"2011","County Durham 062B","E01020831","Total",668,662,6
"2011","County Durham 062C","E01020833","Total",517,502,15
"2011","County Durham 062D","E01020834","Total",626,611,15
"2011","County Durham 063A","E01020824","Total",786,771,15
"2011","County Durham 063B","E01020826","Total",688,669,19
"2011","County Durham 063C","E01020832","Total",658,640,18
"2011","County Durham 063D","E01020845","Total",650,634,16
"2011","County Durham 063E","E01020846","Total",543,530,13
"2011","County Durham 064A","E01020856","Total",789,733,56
"2011","County Durham 064B","E01020858","Total",510,475,35
"2011","County Durham 064C","E01020859","Total",560,537,23
"2011","County Durham 064D","E01020860","Total",536,476,60
"2011","County Durham 064E","E01020861","Total",593,549,44
"2011","County Durham 064F","E01020862","Total",1161,1107,54
"2011","County Durham 064G","E01020864","Total",987,922,65
"2011","County Durham 064H","E01020867","Total",1027,956,71
"2011","County Durham 065A","E01020857","Total",718,641,77
"2011","County Durham 065B","E01020863","Total",665,589,76
"2011","County Durham 065C","E01020865","Total",761,642,119
"2011","County Durham 065D","E01020866","Total",529,472,57
"2011","County Durham 066A","E01020852","Total",874,817,57
"2011","County Durham 066B","E01020853","Total",664,649,15
"2011","County Durham 066C","E01020854","Total",1049,991,58
"2011","County Durham 066D","E01020855","Total",576,555,21
"2011","County Durham 042A","E01020889","Total",848,705,143
"2011","County Durham 042B","E01020890","Total",896,799,97
"2011","County Durham 042C","E01020891","Total",842,759,83
"2011","County Durham 042D","E01020905","Total",767,717,50
"2011","County Durham 042E","E01020906","Total",788,720,68
"2011","County Durham 045A","E01020876","Total",820,773,47
"2011","County Durham 045B","E01020878","Total",756,734,22
"2011","County Durham 045C","E01020887","Total",884,830,54
"2011","County Durham 045D","E01020892","Total",553,497,56
"2011","County Durham 045E","E01020894","Total",553,518,35
"2011","County Durham 045F","E01020898","Total",756,729,27
"2011","County Durham 046A","E01020877","Total",802,740,62
"2011","County Durham 046B","E01020879","Total",1006,983,23
"2011","County Durham 046C","E01020893","Total",837,741,96
"2011","County Durham 046D","E01020899","Total",670,640,30
"2011","County Durham 046E","E01020903","Total",532,512,20
"2011","County Durham 046F","E01020904","Total",807,762,45
"2011","County Durham 051A","E01020873","Total",707,678,29
"2011","County Durham 051B","E01020875","Total",596,570,26
"2011","County Durham 051C","E01020900","Total",596,582,14
"2011","County Durham 051D","E01020901","Total",670,648,22
"2011","County Durham 051E","E01020902","Total",683,657,26
"2011","County Durham 055A","E01020868","Total",946,875,71
"2011","County Durham 055B","E01020869","Total",668,631,37
"2011","County Durham 055C","E01020874","Total",710,643,67
"2011","County Durham 055D","E01020880","Total",777,679,98
"2011","County Durham 055E","E01020881","Total",620,581,39
"2011","County Durham 056A","E01020870","Total",615,605,10
"2011","County Durham 056B","E01020871","Total",679,638,41
"2011","County Durham 056C","E01020872","Total",859,816,43
"2011","County Durham 056D","E01020883","Total",707,692,15
"2011","County Durham 056E","E01020886","Total",606,562,44
"2011","County Durham 057A","E01020882","Total",670,645,25
"2011","County Durham 057B","E01020888","Total",883,844,39
"2011","County Durham 057C","E01020895","Total",740,697,43
"2011","County Durham 057D","E01020896","Total",645,624,21
"2011","County Durham 057E","E01020897","Total",1117,1081,36
"2011","County Durham 058A","E01020884","Total",660,642,18
"2011","County Durham 058B","E01020885","Total",560,543,17
"2011","County Durham 058C","E01020907","Total",747,708,39
"2011","County Durham 058D","E01020908","Total",621,601,20
"2011","County Durham 058E","E01020909","Total",772,753,19
"2011","Hartlepool 001A","E01011954","Total",969,948,21
"2011","Hartlepool 001B","E01011969","Total",620,601,19
"2011","Hartlepool 001C","E01011970","Total",487,458,29
"2011","Hartlepool 001D","E01011971","Total",530,526,4
"2011","Hartlepool 001F","E01033465","Total",732,699,33
"2011","Hartlepool 001G","E01033467","Total",687,615,72
"2011","Hartlepool 002A","E01011952","Total",722,690,32
"2011","Hartlepool 002B","E01011953","Total",840,803,37
"2011","Hartlepool 002C","E01011991","Total",839,810,29
"2011","Hartlepool 002D","E01011992","Total",746,712,34
"2011","Hartlepool 002E","E01011993","Total",892,854,38
"2011","Hartlepool 002F","E01011994","Total",709,684,25
"2011","Hartlepool 003A","E01011955","Total",628,601,27
"2011","Hartlepool 003C","E01011957","Total",603,570,33
"2011","Hartlepool 003G","E01032540","Total",448,441,7
"2011","Hartlepool 003H","E01032541","Total",1013,985,28
"2011","Hartlepool 003I","E01033466","Total",940,877,63
"2011","Hartlepool 005A","E01011973","Total",723,661,62
"2011","Hartlepool 005B","E01011974","Total",1043,933,110
"2011","Hartlepool 005C","E01011975","Total",741,681,60
"2011","Hartlepool 005D","E01011976","Total",530,490,40
"2011","Hartlepool 006A","E01011965","Total",650,635,15
"2011","Hartlepool 006B","E01011966","Total",662,641,21
"2011","Hartlepool 006C","E01011983","Total",649,629,20
"2011","Hartlepool 006D","E01012002","Total",645,607,38
"2011","Hartlepool 007A","E01011951","Total",780,694,86
"2011","Hartlepool 007B","E01011964","Total",567,535,32
"2011","Hartlepool 007C","E01011967","Total",565,548,17
"2011","Hartlepool 007D","E01011999","Total",1018,959,59
"2011","Hartlepool 007E","E01012000","Total",822,796,26
"2011","Hartlepool 008A","E01011950","Total",858,771,87
"2011","Hartlepool 008B","E01011986","Total",539,531,8
"2011","Hartlepool 008C","E01011987","Total",652,642,10
"2011","Hartlepool 008D","E01012001","Total",960,913,47
"2011","Hartlepool 009A","E01011949","Total",794,785,9
"2011","Hartlepool 009B","E01011980","Total",830,812,18
"2011","Hartlepool 009C","E01011981","Total",720,709,11
"2011","Hartlepool 009D","E01011984","Total",612,581,31
"2011","Hartlepool 010A","E01011985","Total",517,503,14
"2011","Hartlepool 010B","E01011988","Total",880,862,18
"2011","Hartlepool 010C","E01011989","Total",856,835,21
"2011","Hartlepool 010D","E01011990","Total",747,724,23
"2011","Hartlepool 011A","E01011995","Total",596,581,15
"2011","Hartlepool 011B","E01011996","Total",684,664,20
"2011","Hartlepool 011C","E01011997","Total",829,816,13
"2011","Hartlepool 011D","E01011998","Total",648,637,11
"2011","Hartlepool 012A","E01011961","Total",649,629,20
"2011","Hartlepool 012B","E01011962","Total",623,613,10
"2011","Hartlepool 012C","E01011977","Total",780,748,32
"2011","Hartlepool 012D","E01011978","Total",806,774,32
"2011","Hartlepool 012E","E01011979","Total",649,635,14
"2011","Hartlepool 014A","E01011959","Total",871,830,41
"2011","Hartlepool 014B","E01011960","Total",620,616,4
"2011","Hartlepool 014C","E01011963","Total",672,660,12
"2011","Hartlepool 014D","E01011968","Total",973,952,21
"2011","Hartlepool 014E","E01011982","Total",558,543,15
"2011","Hartlepool 014F","E01012003","Total",677,668,9
"2011","Hartlepool 014G","E01012005","Total",719,717,2
"2011","Middlesbrough 001A","E01012068","Total",888,804,84
"2011","Middlesbrough 001D","E01012092","Total",721,625,96
"2011","Middlesbrough 001E","E01012093","Total",778,711,67
"2011","Middlesbrough 001F","E01012094","Total",1021,956,65
"2011","Middlesbrough 001G","E01033468","Total",1420,1253,167
"2011","Middlesbrough 002A","E01012058","Total",885,774,111
"2011","Middlesbrough 002B","E01012059","Total",837,724,113
"2011","Middlesbrough 002C","E01012060","Total",704,698,6
"2011","Middlesbrough 002D","E01012061","Total",631,619,12
"2011","Middlesbrough 003A","E01012036","Total",796,608,188
"2011","Middlesbrough 003B","E01012037","Total",775,687,88
"2011","Middlesbrough 003C","E01012038","Total",687,661,26
"2011","Middlesbrough 003D","E01012039","Total",693,625,68
"2011","Middlesbrough 003E","E01012040","Total",717,626,91
"2011","Middlesbrough 003F","E01012041","Total",721,613,108
"2011","Middlesbrough 004A","E01012074","Total",660,634,26
"2011","Middlesbrough 004B","E01012075","Total",638,621,17
"2011","Middlesbrough 004C","E01012076","Total",634,615,19
"2011","Middlesbrough 004D","E01012077","Total",620,604,16
"2011","Middlesbrough 004E","E01012088","Total",538,531,7
"2011","Middlesbrough 005A","E01012078","Total",697,654,43
"2011","Middlesbrough 005B","E01012079","Total",527,503,24
"2011","Middlesbrough 005C","E01012080","Total",515,503,12
"2011","Middlesbrough 005D","E01012081","Total",702,679,23
"2011","Middlesbrough 006A","E01012026","Total",642,618,24
"2011","Middlesbrough 006B","E01012027","Total",832,799,33
"2011","Middlesbrough 006E","E01033469","Total",879,811,68
"2011","Middlesbrough 007A","E01012015","Total",746,710,36
"2011","Middlesbrough 007B","E01012016","Total",826,793,33
"2011","Middlesbrough 007C","E01012017","Total",750,727,23
"2011","Middlesbrough 007D","E01012089","Total",629,602,27
"2011","Middlesbrough 007E","E01012090","Total",742,718,24
"2011","Middlesbrough 007F","E01012091","Total",660,630,30
"2011","Middlesbrough 008A","E01012011","Total",795,770,25
"2011","Middlesbrough 008B","E01012012","Total",654,633,21
"2011","Middlesbrough 008C","E01012013","Total",577,547,30
"2011","Middlesbrough 008D","E01012014","Total",637,617,20
"2011","Middlesbrough 009A","E01012053","Total",650,621,29
"2011","Middlesbrough 009B","E01012054","Total",636,618,18
"2011","Middlesbrough 009C","E01012055","Total",788,734,54
"2011","Middlesbrough 009D","E01012056","Total",1016,987,29
"2011","Middlesbrough 009E","E01012057","Total",807,759,48
"2011","Middlesbrough 010A","E01012082","Total",661,629,32
"2011","Middlesbrough 010B","E01012083","Total",643,620,23
"2011","Middlesbrough 010C","E01012084","Total",717,698,19
"2011","Middlesbrough 010D","E01012085","Total",609,584,25
"2011","Middlesbrough 011A","E01012018","Total",810,676,134
"2011","Middlesbrough 011B","E01012019","Total",590,583,7
"2011","Middlesbrough 011C","E01012020","Total",636,623,13
"2011","Middlesbrough 011D","E01012021","Total",551,544,7
"2011","Middlesbrough 012A","E01012007","Total",682,665,17
"2011","Middlesbrough 012B","E01012008","Total",543,535,8
"2011","Middlesbrough 012C","E01012009","Total",789,760,29
"2011","Middlesbrough 012D","E01012010","Total",546,538,8
"2011","Middlesbrough 013A","E01012046","Total",842,815,27
"2011","Middlesbrough 013B","E01012047","Total",599,582,17
"2011","Middlesbrough 013C","E01012048","Total",744,721,23
"2011","Middlesbrough 014A","E01012049","Total",644,637,7
"2011","Middlesbrough 014B","E01012050","Total",647,630,17
"2011","Middlesbrough 014C","E01012051","Total",548,534,14
"2011","Middlesbrough 014D","E01012052","Total",553,542,11
"2011","Middlesbrough 015A","E01012022","Total",637,631,6
"2011","Middlesbrough 015B","E01012023","Total",715,691,24
"2011","Middlesbrough 015C","E01012024","Total",654,643,11
"2011","Middlesbrough 015D","E01012025","Total",527,517,10
"2011","Middlesbrough 017A","E01012065","Total",777,761,16
"2011","Middlesbrough 017B","E01012066","Total",728,715,13
"2011","Middlesbrough 017C","E01012067","Total",755,729,26
"2011","Middlesbrough 018A","E01012042","Total",738,730,8
"2011","Middlesbrough 018B","E01012043","Total",634,625,9
"2011","Middlesbrough 018C","E01012044","Total",663,637,26
"2011","Middlesbrough 018D","E01012045","Total",625,603,22
"2011","Middlesbrough 018G","E01032552","Total",646,631,15
"2011","Middlesbrough 018H","E01032553","Total",632,598,34
"2011","Middlesbrough 019A","E01012030","Total",634,625,9
"2011","Middlesbrough 019B","E01012031","Total",784,771,13
"2011","Middlesbrough 019C","E01012032","Total",627,612,15
"2011","Middlesbrough 019D","E01012033","Total",656,647,9
"2011","Middlesbrough 019E","E01012034","Total",555,548,7
"2011","Middlesbrough 019F","E01012035","Total",633,624,9
"2011","Middlesbrough 020A","E01012062","Total",626,614,12
"2011","Middlesbrough 020B","E01012063","Total",663,638,25
"2011","Middlesbrough 020C","E01012064","Total",889,776,113
"2011","Middlesbrough 020D","E01012071","Total",578,574,4
"2011","Middlesbrough 020E","E01012073","Total",609,597,12
"2011","Middlesbrough 020F","E01032593","Total",754,728,26
"2011","Northumberland 004A","E01027356","Total",986,795,191
"2011","Northumberland 004B","E01027357","Total",531,515,16
"2011","Northumberland 004C","E01027366","Total",1033,705,328
"2011","Northumberland 004D","E01027367","Total",738,675,63
"2011","Northumberland 005A","E01027358","Total",1091,1012,79
"2011","Northumberland 005B","E01027359","Total",1006,925,81
"2011","Northumberland 005D","E01033715","Total",659,577,82
"2011","Northumberland 005E","E01033717","Total",683,636,47
"2011","Northumberland 006A","E01027361","Total",1045,974,71
"2011","Northumberland 006B","E01027362","Total",615,584,31
"2011","Northumberland 006C","E01027363","Total",521,508,13
"2011","Northumberland 006D","E01027364","Total",951,908,43
"2011","Northumberland 006E","E01027370","Total",836,787,49
"2011","Northumberland 006F","E01027371","Total",824,762,62
"2011","Northumberland 006G","E01027372","Total",1183,985,198
"2011","Northumberland 007A","E01027365","Total",1099,972,127
"2011","Northumberland 007B","E01027368","Total",878,789,89
"2011","Northumberland 007C","E01027369","Total",815,742,73
"2011","Northumberland 007D","E01027373","Total",1107,904,203
"2011","Northumberland 001A","E01027376","Total",767,742,25
"2011","Northumberland 001B","E01027377","Total",1046,908,138
"2011","Northumberland 001C","E01027385","Total",502,491,11
"2011","Northumberland 001D","E01027387","Total",945,863,82
"2011","Northumberland 001E","E01027388","Total",646,633,13
"2011","Northumberland 001F","E01027389","Total",750,692,58
"2011","Northumberland 002A","E01027378","Total",515,454,61
"2011","Northumberland 002B","E01027379","Total",685,624,61
"2011","Northumberland 002C","E01027380","Total",851,656,195
"2011","Northumberland 002D","E01027382","Total",919,796,123
"2011","Northumberland 002E","E01027386","Total",608,593,15
"2011","Northumberland 003A","E01027374","Total",1359,976,383
"2011","Northumberland 003B","E01027375","Total",1061,812,249
"2011","Northumberland 003C","E01027381","Total",1075,852,223
"2011","Northumberland 003D","E01027383","Total",998,674,324
"2011","Northumberland 003E","E01027384","Total",1214,725,489
"2011","Northumberland 003F","E01027390","Total",1095,974,121
"2011","Northumberland 022A","E01027392","Total",818,781,37
"2011","Northumberland 022B","E01027393","Total",639,621,18
"2011","Northumberland 022C","E01027416","Total",809,759,50
"2011","Northumberland 022D","E01027424","Total",851,823,28
"2011","Northumberland 023A","E01027414","Total",708,649,59
"2011","Northumberland 023B","E01027415","Total",873,790,83
"2011","Northumberland 023C","E01027431","Total",949,897,52
"2011","Northumberland 023D","E01027441","Total",963,926,37
"2011","Northumberland 023E","E01027442","Total",845,805,40
"2011","Northumberland 024A","E01027391","Total",609,592,17
"2011","Northumberland 024B","E01027422","Total",857,845,12
"2011","Northumberland 024C","E01027423","Total",649,645,4
"2011","Northumberland 024D","E01027429","Total",899,886,13
"2011","Northumberland 024E","E01027430","Total",731,712,19
"2011","Northumberland 025A","E01027425","Total",953,922,31
"2011","Northumberland 025B","E01027426","Total",542,533,9
"2011","Northumberland 025C","E01027427","Total",860,827,33
"2011","Northumberland 025D","E01027428","Total",645,632,13
"2011","Northumberland 026A","E01027437","Total",771,760,11
"2011","Northumberland 026B","E01027438","Total",623,621,2
"2011","Northumberland 026C","E01027439","Total",765,759,6
"2011","Northumberland 026D","E01027440","Total",602,596,6
"2011","Northumberland 027A","E01027400","Total",490,488,2
"2011","Northumberland 027B","E01027401","Total",543,540,3
"2011","Northumberland 027C","E01027402","Total",498,491,7
"2011","Northumberland 027D","E01027403","Total",487,484,3
"2011","Northumberland 029A","E01027398","Total",916,894,22
"2011","Northumberland 029B","E01027409","Total",759,741,18
"2011","Northumberland 029C","E01027411","Total",640,624,16
"2011","Northumberland 029D","E01027412","Total",646,634,12
"2011","Northumberland 029E","E01027413","Total",843,821,22
"2011","Northumberland 028A","E01027395","Total",708,681,27
"2011","Northumberland 028B","E01027396","Total",579,568,11
"2011","Northumberland 028C","E01027397","Total",648,637,11
"2011","Northumberland 028D","E01027399","Total",603,595,8
"2011","Northumberland 028E","E01027404","Total",616,610,6
"2011","Northumberland 028F","E01027405","Total",647,641,6
"2011","Northumberland 030A","E01027417","Total",713,696,17
"2011","Northumberland 030B","E01027418","Total",809,788,21
"2011","Northumberland 030C","E01027419","Total",797,775,22
"2011","Northumberland 030D","E01027420","Total",618,611,7
"2011","Northumberland 030E","E01027421","Total",755,728,27
"2011","Northumberland 031A","E01027394","Total",555,536,19
"2011","Northumberland 031B","E01027406","Total",631,617,14
"2011","Northumberland 031C","E01027407","Total",636,618,18
"2011","Northumberland 031D","E01027408","Total",661,649,12
"2011","Northumberland 031E","E01027410","Total",671,665,6
"2011","Northumberland 032A","E01027432","Total",840,780,60
"2011","Northumberland 032B","E01027433","Total",783,773,10
"2011","Northumberland 032C","E01027434","Total",644,633,11
"2011","Northumberland 032D","E01027435","Total",689,671,18
"2011","Northumberland 032E","E01027436","Total",693,679,14
"2011","Northumberland 008A","E01027443","Total",695,675,20
"2011","Northumberland 008B","E01027444","Total",614,576,38
"2011","Northumberland 008C","E01027445","Total",724,682,42
"2011","Northumberland 008D","E01027446","Total",600,583,17
"2011","Northumberland 008E","E01027451","Total",877,814,63
"2011","Northumberland 008F","E01027474","Total",872,851,21
"2011","Northumberland 008G","E01027475","Total",669,641,28
"2011","Northumberland 011A","E01027457","Total",574,554,20
"2011","Northumberland 011B","E01027462","Total",913,883,30
"2011","Northumberland 011C","E01027463","Total",730,703,27
"2011","Northumberland 015A","E01027447","Total",837,768,69
"2011","Northumberland 015B","E01027448","Total",809,770,39
"2011","Northumberland 015C","E01027450","Total",747,696,51
"2011","Northumberland 015D","E01027473","Total",790,756,34
"2011","Northumberland 016A","E01027452","Total",679,651,28
"2011","Northumberland 016B","E01027453","Total",906,849,57
"2011","Northumberland 016E","E01027461","Total",632,614,18
"2011","Northumberland 016F","E01033718","Total",1036,1010,26
"2011","Northumberland 018A","E01027455","Total",642,635,7
"2011","Northumberland 018B","E01027456","Total",528,525,3
"2011","Northumberland 018C","E01027458","Total",679,654,25
"2011","Northumberland 018D","E01027460","Total",757,734,23
"2011","Northumberland 033A","E01027464","Total",684,646,38
"2011","Northumberland 033B","E01027465","Total",670,644,26
"2011","Northumberland 033C","E01027466","Total",557,530,27
"2011","Northumberland 033F","E01033714","Total",1029,972,57
"2011","Northumberland 034A","E01027449","Total",715,685,30
"2011","Northumberland 034B","E01027468","Total",544,516,28
"2011","Northumberland 034C","E01027469","Total",551,536,15
"2011","Northumberland 034D","E01027471","Total",678,642,36
"2011","Northumberland 034E","E01027472","Total",679,629,50
"2011","Northumberland 019A","E01027479","Total",1129,1028,101
"2011","Northumberland 019B","E01027480","Total",567,520,47
"2011","Northumberland 019C","E01027503","Total",911,796,115
"2011","Northumberland 019D","E01027511","Total",533,495,38
"2011","Northumberland 037A","E01027484","Total",1039,953,86
"2011","Northumberland 037B","E01027485","Total",722,696,26
"2011","Northumberland 037C","E01027486","Total",551,524,27
"2011","Northumberland 037D","E01027487","Total",569,531,38
"2011","Northumberland 037E","E01027512","Total",552,468,84
"2011","Northumberland 036A","E01027483","Total",605,559,46
"2011","Northumberland 036B","E01027496","Total",549,528,21
"2011","Northumberland 036C","E01027508","Total",500,482,18
"2011","Northumberland 036D","E01027513","Total",867,826,41
"2011","Northumberland 035A","E01027476","Total",1231,1161,70
"2011","Northumberland 035B","E01027489","Total",664,650,14
"2011","Northumberland 035C","E01027490","Total",851,812,39
"2011","Northumberland 035D","E01027491","Total",678,642,36
"2011","Northumberland 035E","E01027492","Total",797,764,33
"2011","Northumberland 035F","E01027493","Total",703,677,26
"2011","Northumberland 035G","E01027494","Total",1093,1019,74
"2011","Northumberland 038A","E01027497","Total",1029,1013,16
"2011","Northumberland 038B","E01027498","Total",1199,1167,32
"2011","Northumberland 038C","E01027499","Total",641,629,12
"2011","Northumberland 038D","E01027500","Total",802,763,39
"2011","Northumberland 038E","E01027501","Total",484,475,9
"2011","Northumberland 038F","E01027502","Total",495,486,9
"2011","Northumberland 039A","E01027481","Total",885,796,89
"2011","Northumberland 039B","E01027482","Total",713,685,28
"2011","Northumberland 039C","E01027504","Total",839,802,37
"2011","Northumberland 039D","E01027506","Total",496,468,28
"2011","Northumberland 039E","E01027507","Total",563,542,21
"2011","Northumberland 039F","E01027509","Total",633,612,21
"2011","Northumberland 040A","E01027477","Total",629,520,109
"2011","Northumberland 040B","E01027478","Total",542,502,40
"2011","Northumberland 040C","E01027488","Total",1011,943,68
"2011","Northumberland 040D","E01027495","Total",495,459,36
"2011","Northumberland 040E","E01027505","Total",599,553,46
"2011","Northumberland 040F","E01027510","Total",534,510,24
"2011","Northumberland 009A","E01027541","Total",943,830,113
"2011","Northumberland 009B","E01027542","Total",898,843,55
"2011","Northumberland 009C","E01027543","Total",569,548,21
"2011","Northumberland 009D","E01027544","Total",679,632,47
"2011","Northumberland 010A","E01027528","Total",652,611,41
"2011","Northumberland 010B","E01027529","Total",502,482,20
"2011","Northumberland 010C","E01027539","Total",859,773,86
"2011","Northumberland 010D","E01027545","Total",993,927,66
"2011","Northumberland 010E","E01027546","Total",880,828,52
"2011","Northumberland 013A","E01027533","Total",964,902,62
"2011","Northumberland 013B","E01027540","Total",913,831,82
"2011","Northumberland 013E","E01027549","Total",611,586,25
"2011","Northumberland 013F","E01033716","Total",1128,1050,78
"2011","Northumberland 012A","E01027524","Total",663,635,28
"2011","Northumberland 012B","E01027525","Total",896,859,37
"2011","Northumberland 012C","E01027526","Total",530,522,8
"2011","Northumberland 012D","E01027527","Total",625,605,20
"2011","Northumberland 012E","E01027536","Total",622,611,11
"2011","Northumberland 014A","E01027532","Total",884,837,47
"2011","Northumberland 014B","E01027537","Total",646,631,15
"2011","Northumberland 014C","E01027538","Total",728,720,8
"2011","Northumberland 017A","E01027530","Total",651,625,26
"2011","Northumberland 017B","E01027531","Total",737,715,22
"2011","Northumberland 017C","E01027534","Total",943,904,39
"2011","Northumberland 017D","E01027535","Total",670,658,12
"2011","Northumberland 017E","E01027553","Total",774,734,40
"2011","Northumberland 017F","E01027554","Total",651,621,30
"2011","Northumberland 020A","E01027515","Total",711,689,22
"2011","Northumberland 020B","E01027517","Total",913,879,34
"2011","Northumberland 020C","E01027518","Total",654,640,14
"2011","Northumberland 020D","E01027519","Total",653,635,18
"2011","Northumberland 020E","E01027550","Total",634,606,28
"2011","Northumberland 020F","E01027551","Total",706,631,75
"2011","Northumberland 020G","E01027552","Total",664,597,67
"2011","Northumberland 021A","E01027514","Total",732,709,23
"2011","Northumberland 021B","E01027516","Total",507,505,2
"2011","Northumberland 021C","E01027520","Total",606,594,12
"2011","Northumberland 021D","E01027521","Total",632,623,9
"2011","Northumberland 021E","E01027522","Total",641,624,17
"2011","Northumberland 021F","E01027523","Total",546,533,13
"2011","Redcar and Cleveland 001A","E01012100","Total",1020,883,137
"2011","Redcar and Cleveland 001B","E01012101","Total",781,713,68
"2011","Redcar and Cleveland 001C","E01012102","Total",1110,1038,72
"2011","Redcar and Cleveland 001D","E01012184","Total",656,636,20
"2011","Redcar and Cleveland 002A","E01012105","Total",586,567,19
"2011","Redcar and Cleveland 002B","E01012142","Total",738,724,14
"2011","Redcar and Cleveland 002C","E01012143","Total",533,529,4
"2011","Redcar and Cleveland 002D","E01012144","Total",635,612,23
"2011","Redcar and Cleveland 003C","E01012106","Total",623,604,19
"2011","Redcar and Cleveland 003D","E01012107","Total",681,666,15
"2011","Redcar and Cleveland 003E","E01032560","Total",468,457,11
"2011","Redcar and Cleveland 003F","E01032561","Total",682,659,23
"2011","Redcar and Cleveland 004A","E01012176","Total",677,661,16
"2011","Redcar and Cleveland 004B","E01012177","Total",624,615,9
"2011","Redcar and Cleveland 004C","E01012178","Total",624,605,19
"2011","Redcar and Cleveland 004D","E01012179","Total",645,635,10
"2011","Redcar and Cleveland 004E","E01012180","Total",621,613,8
"2011","Redcar and Cleveland 004F","E01012185","Total",647,633,14
"2011","Redcar and Cleveland 004G","E01012186","Total",781,748,33
"2011","Redcar and Cleveland 005A","E01012127","Total",541,517,24
"2011","Redcar and Cleveland 005B","E01012128","Total",584,542,42
"2011","Redcar and Cleveland 005C","E01012129","Total",875,854,21
"2011","Redcar and Cleveland 005D","E01012130","Total",607,588,19
"2011","Redcar and Cleveland 005E","E01012131","Total",666,652,14
"2011","Redcar and Cleveland 006A","E01012138","Total",1037,1026,11
"2011","Redcar and Cleveland 006B","E01012139","Total",793,781,12
"2011","Redcar and Cleveland 006C","E01012140","Total",635,617,18
"2011","Redcar and Cleveland 006D","E01012141","Total",499,490,9
"2011","Redcar and Cleveland 006E","E01012154","Total",608,591,17
"2011","Redcar and Cleveland 006F","E01012155","Total",790,768,22
"2011","Redcar and Cleveland 006G","E01012156","Total",746,738,8
"2011","Redcar and Cleveland 006H","E01012157","Total",804,761,43
"2011","Redcar and Cleveland 007A","E01012158","Total",663,647,16
"2011","Redcar and Cleveland 007B","E01012159","Total",1076,955,121
"2011","Redcar and Cleveland 007C","E01012160","Total",630,606,24
"2011","Redcar and Cleveland 007D","E01012161","Total",701,657,44
"2011","Redcar and Cleveland 009A","E01012113","Total",574,558,16
"2011","Redcar and Cleveland 009B","E01012114","Total",692,648,44
"2011","Redcar and Cleveland 009E","E01012175","Total",674,636,38
"2011","Redcar and Cleveland 009F","E01033471","Total",897,874,23
"2011","Redcar and Cleveland 010A","E01012095","Total",557,543,14
"2011","Redcar and Cleveland 010B","E01012097","Total",520,512,8
"2011","Redcar and Cleveland 010C","E01012098","Total",567,553,14
"2011","Redcar and Cleveland 010D","E01012099","Total",746,683,63
"2011","Redcar and Cleveland 011A","E01012108","Total",625,618,7
"2011","Redcar and Cleveland 011B","E01012109","Total",634,605,29
"2011","Redcar and Cleveland 011C","E01012110","Total",631,622,9
"2011","Redcar and Cleveland 011D","E01012111","Total",661,642,19
"2011","Redcar and Cleveland 011E","E01012171","Total",673,660,13
"2011","Redcar and Cleveland 011F","E01012172","Total",640,625,15
"2011","Redcar and Cleveland 012A","E01012162","Total",659,624,35
"2011","Redcar and Cleveland 012B","E01012163","Total",870,832,38
"2011","Redcar and Cleveland 012C","E01012164","Total",774,748,26
"2011","Redcar and Cleveland 012D","E01012165","Total",1023,985,38
"2011","Redcar and Cleveland 013A","E01012096","Total",760,707,53
"2011","Redcar and Cleveland 013D","E01012136","Total",712,637,75
"2011","Redcar and Cleveland 013E","E01033473","Total",945,910,35
"2011","Redcar and Cleveland 015A","E01012112","Total",792,783,9
"2011","Redcar and Cleveland 015B","E01012145","Total",695,670,25
"2011","Redcar and Cleveland 015C","E01012147","Total",681,670,11
"2011","Redcar and Cleveland 015D","E01012149","Total",503,497,6
"2011","Redcar and Cleveland 016A","E01012132","Total",983,922,61
"2011","Redcar and Cleveland 016B","E01012134","Total",764,697,67
"2011","Redcar and Cleveland 016C","E01012137","Total",577,549,28
"2011","Redcar and Cleveland 016D","E01012181","Total",742,713,29
"2011","Redcar and Cleveland 018A","E01012117","Total",840,782,58
"2011","Redcar and Cleveland 018B","E01012118","Total",694,656,38
"2011","Redcar and Cleveland 018C","E01012119","Total",901,880,21
"2011","Redcar and Cleveland 018D","E01012121","Total",629,615,14
"2011","Redcar and Cleveland 019E","E01032548","Total",728,715,13
"2011","Redcar and Cleveland 019F","E01032549","Total",675,659,16
"2011","Redcar and Cleveland 019G","E01033472","Total",1094,1063,31
"2011","Redcar and Cleveland 020A","E01012120","Total",650,631,19
"2011","Redcar and Cleveland 020B","E01012124","Total",637,620,17
"2011","Redcar and Cleveland 020C","E01012182","Total",607,598,9
"2011","Redcar and Cleveland 020D","E01012183","Total",634,620,14
"2011","Redcar and Cleveland 021A","E01012148","Total",685,672,13
"2011","Redcar and Cleveland 021B","E01012150","Total",738,711,27
"2011","Redcar and Cleveland 021C","E01012151","Total",665,650,15
"2011","Redcar and Cleveland 021D","E01012152","Total",702,684,18
"2011","Redcar and Cleveland 021E","E01032594","Total",699,637,62
"2011","Redcar and Cleveland 022A","E01012146","Total",540,516,24
"2011","Redcar and Cleveland 022B","E01012167","Total",602,590,12
"2011","Redcar and Cleveland 022C","E01012168","Total",831,819,12
"2011","Redcar and Cleveland 022D","E01012170","Total",577,568,9
"2011","Redcar and Cleveland 022E","E01012173","Total",528,518,10
"2011","Redcar and Cleveland 022F","E01012174","Total",494,481,13
"2011","Redcar and Cleveland 022G","E01033470","Total",857,809,48
"2011","Stockton-on-Tees 001A","E01012242","Total",636,627,9
"2011","Stockton-on-Tees 001B","E01012243","Total",679,665,14
"2011","Stockton-on-Tees 001C","E01012244","Total",639,620,19
"2011","Stockton-on-Tees 001D","E01012246","Total",584,574,10
"2011","Stockton-on-Tees 001E","E01012296","Total",627,598,29
"2011","Stockton-on-Tees 001F","E01012297","Total",1006,978,28
"2011","Stockton-on-Tees 002A","E01012197","Total",832,809,23
"2011","Stockton-on-Tees 002B","E01012256","Total",645,630,15
"2011","Stockton-on-Tees 002C","E01012257","Total",647,632,15
"2011","Stockton-on-Tees 002D","E01012275","Total",649,625,24
"2011","Stockton-on-Tees 002E","E01012276","Total",874,839,35
"2011","Stockton-on-Tees 002F","E01012277","Total",723,704,19
"2011","Stockton-on-Tees 003A","E01012196","Total",693,674,19
"2011","Stockton-on-Tees 003B","E01012198","Total",667,610,57
"2011","Stockton-on-Tees 003C","E01012214","Total",657,643,14
"2011","Stockton-on-Tees 003D","E01012215","Total",514,498,16
"2011","Stockton-on-Tees 003E","E01012216","Total",532,519,13
"2011","Stockton-on-Tees 003F","E01012245","Total",757,729,28
"2011","Stockton-on-Tees 004A","E01012278","Total",516,501,15
"2011","Stockton-on-Tees 004B","E01012279","Total",656,637,19
"2011","Stockton-on-Tees 004C","E01012280","Total",663,649,14
"2011","Stockton-on-Tees 004D","E01012281","Total",663,642,21
"2011","Stockton-on-Tees 005A","E01012255","Total",663,646,17
"2011","Stockton-on-Tees 005B","E01012269","Total",697,668,29
"2011","Stockton-on-Tees 005D","E01012294","Total",506,481,25
"2011","Stockton-on-Tees 005E","E01012295","Total",509,495,14
"2011","Stockton-on-Tees 005F","E01033476","Total",631,597,34
"2011","Stockton-on-Tees 005G","E01033480","Total",653,630,23
"2011","Stockton-on-Tees 006A","E01012210","Total",654,640,14
"2011","Stockton-on-Tees 006B","E01012211","Total",775,750,25
"2011","Stockton-on-Tees 006C","E01012212","Total",704,683,21
"2011","Stockton-on-Tees 006D","E01012213","Total",755,735,20
"2011","Stockton-on-Tees 007A","E01012192","Total",776,748,28
"2011","Stockton-on-Tees 007B","E01012193","Total",621,605,16
"2011","Stockton-on-Tees 007C","E01012260","Total",868,814,54
"2011","Stockton-on-Tees 007D","E01012261","Total",724,703,21
"2011","Stockton-on-Tees 008A","E01012247","Total",519,508,11
"2011","Stockton-on-Tees 008B","E01012249","Total",656,640,16
"2011","Stockton-on-Tees 008C","E01012271","Total",590,575,15
"2011","Stockton-on-Tees 008D","E01012272","Total",509,493,16
"2011","Stockton-on-Tees 008E","E01012273","Total",658,642,16
"2011","Stockton-on-Tees 008F","E01012274","Total",511,500,11
"2011","Stockton-on-Tees 009D","E01012248","Total",660,647,13
"2011","Stockton-on-Tees 009E","E01012250","Total",657,635,22
"2011","Stockton-on-Tees 009F","E01032542","Total",476,446,30
"2011","Stockton-on-Tees 009G","E01032543","Total",905,877,28
"2011","Stockton-on-Tees 009H","E01032544","Total",787,751,36
"2011","Stockton-on-Tees 010A","E01012194","Total",678,647,31
"2011","Stockton-on-Tees 010B","E01012195","Total",712,684,28
"2011","Stockton-on-Tees 010C","E01012258","Total",536,529,7
"2011","Stockton-on-Tees 010D","E01012259","Total",807,776,31
"2011","Stockton-on-Tees 010E","E01012268","Total",796,755,41
"2011","Stockton-on-Tees 011A","E01012187","Total",549,538,11
"2011","Stockton-on-Tees 011B","E01012188","Total",497,491,6
"2011","Stockton-on-Tees 011C","E01012189","Total",645,631,14
"2011","Stockton-on-Tees 011D","E01012205","Total",651,634,17
"2011","Stockton-on-Tees 012A","E01012219","Total",709,693,16
"2011","Stockton-on-Tees 012B","E01012251","Total",686,648,38
"2011","Stockton-on-Tees 012C","E01012252","Total",661,634,27
"2011","Stockton-on-Tees 012D","E01012253","Total",491,484,7
"2011","Stockton-on-Tees 012E","E01012254","Total",725,644,81
"2011","Stockton-on-Tees 013A","E01012204","Total",640,625,15
"2011","Stockton-on-Tees 013B","E01012206","Total",737,716,21
"2011","Stockton-on-Tees 013C","E01012207","Total",795,782,13
"2011","Stockton-on-Tees 013D","E01012208","Total",658,642,16
"2011","Stockton-on-Tees 014A","E01012262","Total",893,810,83
"2011","Stockton-on-Tees 014C","E01012264","Total",1088,1036,52
"2011","Stockton-on-Tees 014E","E01012266","Total",1253,1149,104
"2011","Stockton-on-Tees 014F","E01012267","Total",908,855,53
"2011","Stockton-on-Tees 014G","E01033477","Total",1446,1136,310
"2011","Stockton-on-Tees 015A","E01012190","Total",638,632,6
"2011","Stockton-on-Tees 015B","E01012191","Total",723,713,10
"2011","Stockton-on-Tees 015C","E01012224","Total",786,769,17
"2011","Stockton-on-Tees 015D","E01012225","Total",658,647,11
"2011","Stockton-on-Tees 015E","E01012226","Total",616,600,16
"2011","Stockton-on-Tees 016A","E01012209","Total",693,676,17
"2011","Stockton-on-Tees 016B","E01012217","Total",806,750,56
"2011","Stockton-on-Tees 016C","E01012218","Total",640,615,25
"2011","Stockton-on-Tees 016D","E01012223","Total",647,629,18
"2011","Stockton-on-Tees 017A","E01012286","Total",720,663,57
"2011","Stockton-on-Tees 017B","E01012287","Total",1006,945,61
"2011","Stockton-on-Tees 017C","E01012288","Total",656,621,35
"2011","Stockton-on-Tees 017D","E01012289","Total",535,510,25
"2011","Stockton-on-Tees 018A","E01012238","Total",660,641,19
"2011","Stockton-on-Tees 018B","E01012239","Total",822,783,39
"2011","Stockton-on-Tees 018C","E01012240","Total",778,763,15
"2011","Stockton-on-Tees 018D","E01012241","Total",627,611,16
"2011","Stockton-on-Tees 019A","E01012290","Total",856,829,27
"2011","Stockton-on-Tees 019B","E01012291","Total",722,698,24
"2011","Stockton-on-Tees 019C","E01012292","Total",1093,1058,35
"2011","Stockton-on-Tees 020A","E01012282","Total",551,539,12
"2011","Stockton-on-Tees 020B","E01012283","Total",560,547,13
"2011","Stockton-on-Tees 020C","E01012284","Total",663,649,14
"2011","Stockton-on-Tees 020D","E01012285","Total",629,620,9
"2011","Stockton-on-Tees 021A","E01012199","Total",633,614,19
"2011","Stockton-on-Tees 021B","E01012200","Total",940,889,51
"2011","Stockton-on-Tees 021C","E01012201","Total",756,737,19
"2011","Stockton-on-Tees 021D","E01012202","Total",650,624,26
"2011","Stockton-on-Tees 021E","E01012203","Total",697,687,10
"2011","Stockton-on-Tees 021F","E01012270","Total",614,586,28
"2011","Stockton-on-Tees 022A","E01012228","Total",541,529,12
"2011","Stockton-on-Tees 022B","E01012230","Total",611,599,12
"2011","Stockton-on-Tees 022C","E01012233","Total",587,564,23
"2011","Stockton-on-Tees 022D","E01012236","Total",547,538,9
"2011","Stockton-on-Tees 022E","E01012237","Total",508,496,12
"2011","Stockton-on-Tees 023A","E01012227","Total",598,590,8
"2011","Stockton-on-Tees 023C","E01012231","Total",689,685,4
"2011","Stockton-on-Tees 023D","E01012232","Total",549,545,4
"2011","Stockton-on-Tees 023E","E01012234","Total",587,580,7
"2011","Stockton-on-Tees 023F","E01033474","Total",653,619,34
"2011","Stockton-on-Tees 023G","E01033475","Total",589,575,14
"2011","Stockton-on-Tees 023H","E01033478","Total",608,582,26
"2011","Stockton-on-Tees 023I","E01033479","Total",627,616,11
"2011","Stockton-on-Tees 024A","E01012235","Total",482,461,21
"2011","Stockton-on-Tees 024B","E01012298","Total",552,544,8
"2011","Stockton-on-Tees 024C","E01012299","Total",855,736,119
"2011","Stockton-on-Tees 024D","E01012300","Total",761,747,14
"2011","Stockton-on-Tees 024E","E01012301","Total",575,564,11
"2011","Stockton-on-Tees 024F","E01012302","Total",509,487,22
"2011","Stockton-on-Tees 024G","E01012303","Total",621,606,15
"2011","Gateshead 001A","E01008246","Total",644,633,11
"2011","Gateshead 001B","E01008247","Total",775,761,14
"2011","Gateshead 001C","E01008248","Total",749,724,25
"2011","Gateshead 001D","E01008249","Total",776,721,55
"2011","Gateshead 001E","E01008250","Total",619,592,27
"2011","Gateshead 002A","E01008195","Total",912,881,31
"2011","Gateshead 002B","E01008197","Total",729,695,34
"2011","Gateshead 002C","E01008198","Total",607,600,7
"2011","Gateshead 002D","E01008199","Total",662,636,26
"2011","Gateshead 002E","E01008200","Total",577,558,19
"2011","Gateshead 002F","E01008245","Total",648,632,16
"2011","Gateshead 003A","E01008214","Total",803,746,57
"2011","Gateshead 003B","E01008215","Total",903,823,80
"2011","Gateshead 003C","E01008243","Total",783,733,50
"2011","Gateshead 003D","E01008244","Total",1055,1009,46
"2011","Gateshead 004A","E01008178","Total",714,687,27
"2011","Gateshead 004B","E01008180","Total",653,636,17
"2011","Gateshead 004C","E01008182","Total",774,744,30
"2011","Gateshead 004D","E01008277","Total",676,668,8
"2011","Gateshead 004E","E01008280","Total",918,877,41
"2011","Gateshead 005A","E01008177","Total",645,609,36
"2011","Gateshead 005B","E01008179","Total",533,519,14
"2011","Gateshead 005C","E01008181","Total",657,644,13
"2011","Gateshead 005D","E01008276","Total",758,741,17
"2011","Gateshead 005E","E01008279","Total",669,655,14
"2011","Gateshead 007A","E01008209","Total",1037,990,47
"2011","Gateshead 007B","E01008210","Total",649,617,32
"2011","Gateshead 007C","E01008258","Total",1234,1154,80
"2011","Gateshead 007D","E01008259","Total",1096,1038,58
"2011","Gateshead 008A","E01008167","Total",758,721,37
"2011","Gateshead 008B","E01008169","Total",463,416,47
"2011","Gateshead 008C","E01008170","Total",1035,986,49
"2011","Gateshead 008D","E01008171","Total",618,559,59
"2011","Gateshead 008E","E01008257","Total",689,669,20
"2011","Gateshead 009A","E01008262","Total",854,789,65
"2011","Gateshead 009B","E01008263","Total",686,672,14
"2011","Gateshead 009C","E01008264","Total",614,599,15
"2011","Gateshead 009D","E01008265","Total",644,622,22
"2011","Gateshead 009E","E01008266","Total",665,643,22
"2011","Gateshead 010A","E01008251","Total",970,913,57
"2011","Gateshead 010B","E01008252","Total",758,729,29
"2011","Gateshead 010C","E01008253","Total",929,818,111
"2011","Gateshead 010D","E01008254","Total",783,663,120
"2011","Gateshead 010E","E01008255","Total",777,753,24
"2011","Gateshead 011A","E01008165","Total",614,594,20
"2011","Gateshead 011B","E01008201","Total",635,629,6
"2011","Gateshead 011C","E01008202","Total",821,803,18
"2011","Gateshead 011D","E01008204","Total",758,739,19
"2011","Gateshead 012A","E01008212","Total",748,694,54
"2011","Gateshead 012B","E01008213","Total",656,645,11
"2011","Gateshead 012C","E01008216","Total",760,743,17
"2011","Gateshead 012D","E01008228","Total",568,551,17
"2011","Gateshead 013A","E01008206","Total",754,741,13
"2011","Gateshead 013B","E01008207","Total",603,591,12
"2011","Gateshead 013C","E01008208","Total",763,739,24
"2011","Gateshead 013D","E01008211","Total",763,743,20
"2011","Gateshead 014A","E01008283","Total",614,604,10
"2011","Gateshead 014B","E01008284","Total",626,617,9
"2011","Gateshead 014C","E01008286","Total",681,661,20
"2011","Gateshead 014D","E01008287","Total",835,820,15
"2011","Gateshead 015A","E01008231","Total",707,689,18
"2011","Gateshead 015B","E01008240","Total",652,643,9
"2011","Gateshead 015C","E01008241","Total",728,710,18
"2011","Gateshead 015D","E01008242","Total",708,701,7
"2011","Gateshead 015E","E01008281","Total",669,657,12
"2011","Gateshead 015F","E01008282","Total",673,665,8
"2011","Gateshead 016A","E01008219","Total",734,725,9
"2011","Gateshead 016B","E01008235","Total",640,630,10
"2011","Gateshead 016C","E01008236","Total",791,761,30
"2011","Gateshead 016D","E01008237","Total",608,593,15
"2011","Gateshead 016E","E01008238","Total",704,677,27
"2011","Gateshead 017A","E01008267","Total",737,700,37
"2011","Gateshead 017B","E01008269","Total",663,645,18
"2011","Gateshead 017C","E01008270","Total",613,603,10
"2011","Gateshead 017D","E01008271","Total",613,606,7
"2011","Gateshead 017E","E01008275","Total",661,648,13
"2011","Gateshead 018A","E01008229","Total",648,635,13
"2011","Gateshead 018B","E01008230","Total",667,630,37
"2011","Gateshead 018C","E01008232","Total",606,589,17
"2011","Gateshead 018D","E01008233","Total",607,606,1
"2011","Gateshead 018E","E01008285","Total",680,664,16
"2011","Gateshead 019A","E01008256","Total",787,775,12
"2011","Gateshead 019B","E01008260","Total",640,629,11
"2011","Gateshead 019C","E01008261","Total",657,642,15
"2011","Gateshead 019D","E01008268","Total",640,628,12
"2011","Gateshead 019E","E01008272","Total",667,651,16
"2011","Gateshead 019F","E01008273","Total",634,628,6
"2011","Gateshead 019G","E01008274","Total",636,632,4
"2011","Gateshead 020A","E01008193","Total",498,493,5
"2011","Gateshead 020B","E01008194","Total",614,602,12
"2011","Gateshead 020C","E01008234","Total",1057,1034,23
"2011","Gateshead 020D","E01008239","Total",663,634,29
"2011","Gateshead 021A","E01008218","Total",777,766,11
"2011","Gateshead 021B","E01008220","Total",585,576,9
"2011","Gateshead 021C","E01008221","Total",734,718,16
"2011","Gateshead 021D","E01008225","Total",816,800,16
"2011","Gateshead 021E","E01008227","Total",681,662,19
"2011","Gateshead 022A","E01008184","Total",662,641,21
"2011","Gateshead 022B","E01008185","Total",604,581,23
"2011","Gateshead 022C","E01008188","Total",621,610,11
"2011","Gateshead 022D","E01008278","Total",617,603,14
"2011","Gateshead 023A","E01008189","Total",652,645,7
"2011","Gateshead 023B","E01008190","Total",568,560,8
"2011","Gateshead 023C","E01008191","Total",783,767,16
"2011","Gateshead 023D","E01008192","Total",686,677,9
"2011","Gateshead 023E","E01008217","Total",746,731,15
"2011","Gateshead 024A","E01008183","Total",673,650,23
"2011","Gateshead 024B","E01008186","Total",1064,938,126
"2011","Gateshead 024C","E01008187","Total",821,789,32
"2011","Gateshead 024D","E01008196","Total",855,823,32
"2011","Gateshead 025A","E01008222","Total",664,654,10
"2011","Gateshead 025B","E01008223","Total",827,800,27
"2011","Gateshead 025C","E01008224","Total",813,801,12
"2011","Gateshead 025D","E01008226","Total",694,669,25
"2011","Gateshead 026A","E01008172","Total",795,779,16
"2011","Gateshead 026B","E01008173","Total",624,615,9
"2011","Gateshead 026C","E01008174","Total",934,903,31
"2011","Gateshead 026D","E01008175","Total",729,681,48
"2011","Gateshead 026E","E01008176","Total",629,621,8
"2011","Gateshead 027A","E01008162","Total",1246,1191,55
"2011","Gateshead 027B","E01008164","Total",723,638,85
"2011","Gateshead 027C","E01008166","Total",1169,1023,146
"2011","Gateshead 027D","E01008168","Total",1168,1097,71
"2011","Gateshead 028A","E01008163","Total",725,678,47
"2011","Gateshead 028B","E01008203","Total",915,877,38
"2011","Gateshead 028C","E01008205","Total",703,676,27
"2011","Newcastle upon Tyne 001A","E01008294","Total",633,618,15
"2011","Newcastle upon Tyne 001B","E01008306","Total",740,720,20
"2011","Newcastle upon Tyne 001C","E01008307","Total",521,500,21
"2011","Newcastle upon Tyne 001D","E01008308","Total",647,616,31
"2011","Newcastle upon Tyne 001E","E01008311","Total",709,689,20
"2011","Newcastle upon Tyne 001F","E01008312","Total",518,503,15
"2011","Newcastle upon Tyne 001G","E01008313","Total",488,476,12
"2011","Newcastle upon Tyne 002A","E01008309","Total",748,728,20
"2011","Newcastle upon Tyne 002C","E01008352","Total",631,612,19
"2011","Newcastle upon Tyne 002D","E01008357","Total",712,689,23
"2011","Newcastle upon Tyne 002E","E01008358","Total",891,759,132
"2011","Newcastle upon Tyne 002F","E01033550","Total",714,694,20
"2011","Newcastle upon Tyne 002G","E01033551","Total",760,736,24
"2011","Newcastle upon Tyne 003A","E01008336","Total",697,674,23
"2011","Newcastle upon Tyne 003B","E01008337","Total",600,578,22
"2011","Newcastle upon Tyne 003C","E01008338","Total",520,498,22
"2011","Newcastle upon Tyne 003D","E01008339","Total",677,663,14
"2011","Newcastle upon Tyne 003E","E01008340","Total",643,628,15
"2011","Newcastle upon Tyne 003F","E01008341","Total",640,618,22
"2011","Newcastle upon Tyne 003G","E01008342","Total",743,722,21
"2011","Newcastle upon Tyne 004A","E01008293","Total",667,639,28
"2011","Newcastle upon Tyne 004B","E01008456","Total",685,674,11
"2011","Newcastle upon Tyne 004C","E01008457","Total",827,787,40
"2011","Newcastle upon Tyne 004D","E01008458","Total",728,700,28
"2011","Newcastle upon Tyne 004E","E01008459","Total",740,724,16
"2011","Newcastle upon Tyne 004F","E01008460","Total",611,605,6
"2011","Newcastle upon Tyne 005A","E01008351","Total",635,620,15
"2011","Newcastle upon Tyne 005B","E01008354","Total",788,767,21
"2011","Newcastle upon Tyne 005C","E01008418","Total",917,869,48
"2011","Newcastle upon Tyne 005D","E01008420","Total",575,555,20
"2011","Newcastle upon Tyne 005E","E01008422","Total",673,644,29
"2011","Newcastle upon Tyne 005F","E01008424","Total",797,759,38
"2011","Newcastle upon Tyne 006A","E01008353","Total",709,696,13
"2011","Newcastle upon Tyne 006B","E01008355","Total",787,745,42
"2011","Newcastle upon Tyne 006C","E01008356","Total",605,587,18
"2011","Newcastle upon Tyne 006D","E01008378","Total",544,535,9
"2011","Newcastle upon Tyne 006E","E01008419","Total",667,632,35
"2011","Newcastle upon Tyne 006F","E01008421","Total",686,664,22
"2011","Newcastle upon Tyne 006G","E01008423","Total",545,530,15
"2011","Newcastle upon Tyne 007A","E01008317","Total",608,593,15
"2011","Newcastle upon Tyne 007B","E01008319","Total",702,685,17
"2011","Newcastle upon Tyne 007C","E01008320","Total",635,611,24
"2011","Newcastle upon Tyne 007D","E01008321","Total",755,725,30
"2011","Newcastle upon Tyne 007E","E01008322","Total",600,585,15
"2011","Newcastle upon Tyne 007F","E01008323","Total",737,702,35
"2011","Newcastle upon Tyne 008A","E01008295","Total",620,604,16
"2011","Newcastle upon Tyne 008B","E01008374","Total",643,632,11
"2011","Newcastle upon Tyne 008C","E01008375","Total",735,721,14
"2011","Newcastle upon Tyne 008D","E01008376","Total",476,468,8
"2011","Newcastle upon Tyne 008E","E01008377","Total",866,845,21
"2011","Newcastle upon Tyne 008F","E01008379","Total",737,703,34
"2011","Newcastle upon Tyne 008G","E01008380","Total",808,739,69
"2011","Newcastle upon Tyne 011A","E01008296","Total",717,690,27
"2011","Newcastle upon Tyne 011B","E01008297","Total",640,626,14
"2011","Newcastle upon Tyne 011C","E01008298","Total",594,584,10
"2011","Newcastle upon Tyne 011D","E01008299","Total",532,527,5
"2011","Newcastle upon Tyne 012A","E01008314","Total",491,473,18
"2011","Newcastle upon Tyne 012B","E01008315","Total",658,627,31
"2011","Newcastle upon Tyne 012C","E01008316","Total",679,650,29
"2011","Newcastle upon Tyne 012D","E01008318","Total",640,631,9
"2011","Newcastle upon Tyne 012E","E01008363","Total",850,806,44
"2011","Newcastle upon Tyne 012F","E01008365","Total",586,572,14
"2011","Newcastle upon Tyne 013A","E01008366","Total",666,636,30
"2011","Newcastle upon Tyne 013B","E01008369","Total",724,680,44
"2011","Newcastle upon Tyne 013C","E01008371","Total",618,572,46
"2011","Newcastle upon Tyne 013D","E01008372","Total",756,728,28
"2011","Newcastle upon Tyne 013E","E01008373","Total",751,727,24
"2011","Newcastle upon Tyne 014A","E01008400","Total",724,703,21
"2011","Newcastle upon Tyne 014B","E01008401","Total",615,607,8
"2011","Newcastle upon Tyne 014C","E01008402","Total",669,654,15
"2011","Newcastle upon Tyne 014D","E01008403","Total",653,632,21
"2011","Newcastle upon Tyne 014E","E01008404","Total",828,804,24
"2011","Newcastle upon Tyne 014F","E01008405","Total",657,639,18
"2011","Newcastle upon Tyne 014G","E01008443","Total",618,608,10
"2011","Newcastle upon Tyne 015A","E01008324","Total",553,547,6
"2011","Newcastle upon Tyne 015B","E01008325","Total",668,663,5
"2011","Newcastle upon Tyne 015C","E01008326","Total",590,582,8
"2011","Newcastle upon Tyne 015D","E01008327","Total",596,586,10
"2011","Newcastle upon Tyne 015E","E01008328","Total",582,576,6
"2011","Newcastle upon Tyne 015F","E01008329","Total",633,624,9
"2011","Newcastle upon Tyne 015G","E01008330","Total",625,617,8
"2011","Newcastle upon Tyne 016A","E01008300","Total",693,665,28
"2011","Newcastle upon Tyne 016B","E01008450","Total",584,574,10
"2011","Newcastle upon Tyne 016C","E01008451","Total",871,839,32
"2011","Newcastle upon Tyne 016D","E01008452","Total",521,497,24
"2011","Newcastle upon Tyne 017A","E01008367","Total",823,785,38
"2011","Newcastle upon Tyne 017B","E01008368","Total",580,554,26
"2011","Newcastle upon Tyne 017C","E01008370","Total",885,822,63
"2011","Newcastle upon Tyne 017D","E01008409","Total",743,718,25
"2011","Newcastle upon Tyne 017E","E01008411","Total",732,696,36
"2011","Newcastle upon Tyne 018A","E01008303","Total",1086,1060,26
"2011","Newcastle upon Tyne 018B","E01008359","Total",615,577,38
"2011","Newcastle upon Tyne 018C","E01008360","Total",819,768,51
"2011","Newcastle upon Tyne 018D","E01008361","Total",727,686,41
"2011","Newcastle upon Tyne 018E","E01008362","Total",754,730,24
"2011","Newcastle upon Tyne 018F","E01008364","Total",744,715,29
"2011","Newcastle upon Tyne 019A","E01008343","Total",624,606,18
"2011","Newcastle upon Tyne 019B","E01008344","Total",717,701,16
"2011","Newcastle upon Tyne 019C","E01008345","Total",858,849,9
"2011","Newcastle upon Tyne 019D","E01008346","Total",528,520,8
"2011","Newcastle upon Tyne 019E","E01008347","Total",562,552,10
"2011","Newcastle upon Tyne 019F","E01008348","Total",416,406,10
"2011","Newcastle upon Tyne 019G","E01008349","Total",493,482,11
"2011","Newcastle upon Tyne 019H","E01008350","Total",584,571,13
"2011","Newcastle upon Tyne 020A","E01008430","Total",638,614,24
"2011","Newcastle upon Tyne 020B","E01008431","Total",643,616,27
"2011","Newcastle upon Tyne 020C","E01008433","Total",643,634,9
"2011","Newcastle upon Tyne 020D","E01008434","Total",615,603,12
"2011","Newcastle upon Tyne 020E","E01008435","Total",646,629,17
"2011","Newcastle upon Tyne 020F","E01008436","Total",800,781,19
"2011","Newcastle upon Tyne 021A","E01008381","Total",661,651,10
"2011","Newcastle upon Tyne 021B","E01008382","Total",515,504,11
"2011","Newcastle upon Tyne 021C","E01008383","Total",655,646,9
"2011","Newcastle upon Tyne 021D","E01008384","Total",607,597,10
"2011","Newcastle upon Tyne 021E","E01008385","Total",724,656,68
"2011","Newcastle upon Tyne 021F","E01008386","Total",574,570,4
"2011","Newcastle upon Tyne 021G","E01008387","Total",643,624,19
"2011","Newcastle upon Tyne 022B","E01008396","Total",713,683,30
"2011","Newcastle upon Tyne 022C","E01008398","Total",909,868,41
"2011","Newcastle upon Tyne 022D","E01008449","Total",601,575,26
"2011","Newcastle upon Tyne 022E","E01008453","Total",606,569,37
"2011","Newcastle upon Tyne 022G","E01008455","Total",513,500,13
"2011","Newcastle upon Tyne 022H","E01033556","Total",995,950,45
"2011","Newcastle upon Tyne 023A","E01008406","Total",795,766,29
"2011","Newcastle upon Tyne 023B","E01008407","Total",787,758,29
"2011","Newcastle upon Tyne 023D","E01008410","Total",729,708,21
"2011","Newcastle upon Tyne 023E","E01008412","Total",663,637,26
"2011","Newcastle upon Tyne 023F","E01008413","Total",632,614,18
"2011","Newcastle upon Tyne 023G","E01033548","Total",745,677,68
"2011","Newcastle upon Tyne 023H","E01033553","Total",707,675,32
"2011","Newcastle upon Tyne 024A","E01008394","Total",463,439,24
"2011","Newcastle upon Tyne 024B","E01008395","Total",815,765,50
"2011","Newcastle upon Tyne 024C","E01008397","Total",569,531,38
"2011","Newcastle upon Tyne 024D","E01008399","Total",813,800,13
"2011","Newcastle upon Tyne 024E","E01008439","Total",826,805,21
"2011","Newcastle upon Tyne 024G","E01033543","Total",864,751,113
"2011","Newcastle upon Tyne 024H","E01033545","Total",832,760,72
"2011","Newcastle upon Tyne 024I","E01033554","Total",790,736,54
"2011","Newcastle upon Tyne 025B","E01008415","Total",542,516,26
"2011","Newcastle upon Tyne 025C","E01008416","Total",735,728,7
"2011","Newcastle upon Tyne 025E","E01033547","Total",972,949,23
"2011","Newcastle upon Tyne 026A","E01008301","Total",965,913,52
"2011","Newcastle upon Tyne 026B","E01008302","Total",808,780,28
"2011","Newcastle upon Tyne 026C","E01008304","Total",1121,1078,43
"2011","Newcastle upon Tyne 026D","E01008305","Total",961,921,40
"2011","Newcastle upon Tyne 026E","E01008391","Total",599,590,9
"2011","Newcastle upon Tyne 026F","E01008392","Total",802,764,38
"2011","Newcastle upon Tyne 026G","E01008432","Total",647,629,18
"2011","Newcastle upon Tyne 027A","E01008288","Total",644,626,18
"2011","Newcastle upon Tyne 027B","E01008289","Total",614,603,11
"2011","Newcastle upon Tyne 027C","E01008290","Total",566,543,23
"2011","Newcastle upon Tyne 027D","E01008291","Total",964,901,63
"2011","Newcastle upon Tyne 027E","E01008292","Total",567,560,7
"2011","Newcastle upon Tyne 028A","E01008388","Total",870,836,34
"2011","Newcastle upon Tyne 028B","E01008389","Total",805,788,17
"2011","Newcastle upon Tyne 028C","E01008426","Total",657,640,17
"2011","Newcastle upon Tyne 028D","E01008429","Total",630,620,10
"2011","Newcastle upon Tyne 029A","E01008331","Total",620,593,27
"2011","Newcastle upon Tyne 029B","E01008332","Total",964,906,58
"2011","Newcastle upon Tyne 029C","E01008333","Total",569,536,33
"2011","Newcastle upon Tyne 029D","E01008334","Total",866,833,33
"2011","Newcastle upon Tyne 029E","E01008335","Total",710,674,36
"2011","Newcastle upon Tyne 029F","E01008437","Total",951,567,384
"2011","Newcastle upon Tyne 029G","E01008438","Total",958,850,108
"2011","Newcastle upon Tyne 030A","E01008390","Total",821,814,7
"2011","Newcastle upon Tyne 030B","E01008425","Total",1039,1030,9
"2011","Newcastle upon Tyne 030C","E01008427","Total",612,581,31
"2011","Newcastle upon Tyne 030D","E01008428","Total",558,543,15
"2011","Newcastle upon Tyne 031A","E01008441","Total",784,772,12
"2011","Newcastle upon Tyne 031B","E01008442","Total",623,620,3
"2011","Newcastle upon Tyne 031C","E01008444","Total",677,664,13
"2011","Newcastle upon Tyne 031D","E01008445","Total",813,800,13
"2011","Newcastle upon Tyne 031E","E01008446","Total",657,641,16
"2011","Newcastle upon Tyne 031F","E01008447","Total",622,609,13
"2011","Newcastle upon Tyne 031G","E01008448","Total",638,633,5
"2011","North Tyneside 001A","E01008547","Total",617,601,16
"2011","North Tyneside 001B","E01008548","Total",529,528,1
"2011","North Tyneside 001C","E01008549","Total",702,681,21
"2011","North Tyneside 001D","E01008551","Total",677,661,16
"2011","North Tyneside 002A","E01008478","Total",816,775,41
"2011","North Tyneside 002B","E01008480","Total",728,716,12
"2011","North Tyneside 002C","E01008504","Total",655,646,9
"2011","North Tyneside 002D","E01008578","Total",619,602,17
"2011","North Tyneside 002E","E01008583","Total",635,616,19
"2011","North Tyneside 003A","E01008520","Total",604,573,31
"2011","North Tyneside 003B","E01008523","Total",498,483,15
"2011","North Tyneside 003C","E01008546","Total",615,604,11
"2011","North Tyneside 003D","E01008550","Total",649,634,15
"2011","North Tyneside 004A","E01008577","Total",682,660,22
"2011","North Tyneside 004B","E01008579","Total",742,726,16
"2011","North Tyneside 004C","E01008580","Total",629,607,22
"2011","North Tyneside 004D","E01008581","Total",677,656,21
"2011","North Tyneside 004E","E01008582","Total",657,634,23
"2011","North Tyneside 005A","E01008517","Total",614,598,16
"2011","North Tyneside 005B","E01008519","Total",681,659,22
"2011","North Tyneside 005C","E01008521","Total",707,689,18
"2011","North Tyneside 005D","E01008522","Total",678,658,20
"2011","North Tyneside 006A","E01008584","Total",746,668,78
"2011","North Tyneside 006B","E01008585","Total",679,651,28
"2011","North Tyneside 006C","E01008587","Total",671,638,33
"2011","North Tyneside 006D","E01008588","Total",725,676,49
"2011","North Tyneside 006E","E01008589","Total",575,562,13
"2011","North Tyneside 007A","E01008518","Total",817,783,34
"2011","North Tyneside 007B","E01008564","Total",653,633,20
"2011","North Tyneside 007C","E01008565","Total",923,874,49
"2011","North Tyneside 007D","E01008567","Total",611,587,24
"2011","North Tyneside 008A","E01008475","Total",697,687,10
"2011","North Tyneside 008B","E01008476","Total",811,793,18
"2011","North Tyneside 008C","E01008477","Total",677,659,18
"2011","North Tyneside 008D","E01008479","Total",660,647,13
"2011","North Tyneside 009A","E01008552","Total",769,748,21
"2011","North Tyneside 009B","E01008553","Total",877,831,46
"2011","North Tyneside 009C","E01008554","Total",682,674,8
"2011","North Tyneside 009D","E01008555","Total",681,671,10
"2011","North Tyneside 009E","E01008586","Total",725,674,51
"2011","North Tyneside 010A","E01008495","Total",749,736,13
"2011","North Tyneside 010B","E01008496","Total",826,775,51
"2011","North Tyneside 010C","E01008497","Total",669,651,18
"2011","North Tyneside 010D","E01008498","Total",723,718,5
"2011","North Tyneside 011B","E01008568","Total",699,683,16
"2011","North Tyneside 011C","E01008569","Total",659,647,12
"2011","North Tyneside 011D","E01008570","Total",621,599,22
"2011","North Tyneside 011E","E01032647","Total",682,667,15
"2011","North Tyneside 011F","E01032648","Total",681,657,24
"2011","North Tyneside 012A","E01008500","Total",743,728,15
"2011","North Tyneside 012B","E01008505","Total",826,805,21
"2011","North Tyneside 012C","E01008506","Total",615,613,2
"2011","North Tyneside 012D","E01008507","Total",632,626,6
"2011","North Tyneside 013A","E01008493","Total",654,641,13
"2011","North Tyneside 013B","E01008494","Total",754,734,20
"2011","North Tyneside 013C","E01008556","Total",877,849,28
"2011","North Tyneside 013D","E01008557","Total",626,617,9
"2011","North Tyneside 014A","E01008470","Total",662,643,19
"2011","North Tyneside 014B","E01008499","Total",741,727,14
"2011","North Tyneside 014C","E01008502","Total",715,697,18
"2011","North Tyneside 014D","E01008516","Total",661,649,12
"2011","North Tyneside 015A","E01008488","Total",668,647,21
"2011","North Tyneside 015B","E01008489","Total",768,752,16
"2011","North Tyneside 015C","E01008490","Total",802,768,34
"2011","North Tyneside 015D","E01008491","Total",633,622,11
"2011","North Tyneside 016A","E01008558","Total",909,855,54
"2011","North Tyneside 016B","E01008560","Total",921,857,64
"2011","North Tyneside 016C","E01008561","Total",959,879,80
"2011","North Tyneside 016D","E01008562","Total",661,639,22
"2011","North Tyneside 017A","E01008525","Total",755,724,31
"2011","North Tyneside 017B","E01008527","Total",784,745,39
"2011","North Tyneside 017C","E01008559","Total",814,786,28
"2011","North Tyneside 017D","E01008563","Total",606,594,12
"2011","North Tyneside 018A","E01008469","Total",784,757,27
"2011","North Tyneside 018B","E01008472","Total",686,673,13
"2011","North Tyneside 018C","E01008473","Total",543,527,16
"2011","North Tyneside 018D","E01008501","Total",787,772,15
"2011","North Tyneside 018E","E01008503","Total",813,771,42
"2011","North Tyneside 019A","E01008471","Total",670,660,10
"2011","North Tyneside 019B","E01008474","Total",624,614,10
"2011","North Tyneside 019C","E01008513","Total",1165,1137,28
"2011","North Tyneside 019D","E01008514","Total",780,774,6
"2011","North Tyneside 019F","E01032649","Total",625,612,13
"2011","North Tyneside 019G","E01032650","Total",601,594,7
"2011","North Tyneside 020A","E01008486","Total",681,661,20
"2011","North Tyneside 020B","E01008487","Total",701,692,9
"2011","North Tyneside 020C","E01008526","Total",633,617,16
"2011","North Tyneside 020D","E01008530","Total",809,783,26
"2011","North Tyneside 021A","E01008461","Total",647,623,24
"2011","North Tyneside 021B","E01008466","Total",566,559,7
"2011","North Tyneside 021C","E01008467","Total",645,635,10
"2011","North Tyneside 021D","E01008468","Total",656,633,23
"2011","North Tyneside 022A","E01008483","Total",777,757,20
"2011","North Tyneside 022B","E01008524","Total",1214,1119,95
"2011","North Tyneside 022C","E01008528","Total",658,634,24
"2011","North Tyneside 022D","E01008529","Total",772,751,21
"2011","North Tyneside 023A","E01008481","Total",635,614,21
"2011","North Tyneside 023B","E01008482","Total",845,824,21
"2011","North Tyneside 023C","E01008484","Total",668,639,29
"2011","North Tyneside 023D","E01008485","Total",649,644,5
"2011","North Tyneside 023E","E01008492","Total",779,750,29
"2011","North Tyneside 024A","E01008462","Total",582,545,37
"2011","North Tyneside 024B","E01008463","Total",642,607,35
"2011","North Tyneside 024C","E01008464","Total",683,655,28
"2011","North Tyneside 024D","E01008465","Total",659,641,18
"2011","North Tyneside 025A","E01008531","Total",647,631,16
"2011","North Tyneside 025B","E01008532","Total",716,701,15
"2011","North Tyneside 025C","E01008534","Total",626,619,7
"2011","North Tyneside 025D","E01008538","Total",536,520,16
"2011","North Tyneside 026A","E01008508","Total",626,617,9
"2011","North Tyneside 026B","E01008509","Total",790,747,43
"2011","North Tyneside 026C","E01008510","Total",772,755,17
"2011","North Tyneside 026D","E01008512","Total",792,763,29
"2011","North Tyneside 027A","E01008539","Total",745,719,26
"2011","North Tyneside 027B","E01008540","Total",797,743,54
"2011","North Tyneside 027C","E01008541","Total",826,792,34
"2011","North Tyneside 027D","E01008544","Total",1007,964,43
"2011","North Tyneside 027E","E01008545","Total",685,665,20
"2011","North Tyneside 028A","E01008511","Total",811,780,31
"2011","North Tyneside 028B","E01008542","Total",775,726,49
"2011","North Tyneside 028C","E01008543","Total",1019,931,88
"2011","North Tyneside 028D","E01008571","Total",912,875,37
"2011","North Tyneside 029A","E01008572","Total",978,925,53
"2011","North Tyneside 029B","E01008573","Total",908,838,70
"2011","North Tyneside 029C","E01008574","Total",707,692,15
"2011","North Tyneside 029D","E01008576","Total",861,840,21
"2011","North Tyneside 030A","E01008533","Total",638,631,7
"2011","North Tyneside 030B","E01008535","Total",667,652,15
"2011","North Tyneside 030C","E01008536","Total",815,748,67
"2011","North Tyneside 030D","E01008537","Total",698,661,37
"2011","North Tyneside 030E","E01008575","Total",748,693,55
"2011","South Tyneside 001A","E01008595","Total",865,813,52
"2011","South Tyneside 001B","E01008596","Total",619,576,43
"2011","South Tyneside 001C","E01008597","Total",1098,1046,52
"2011","South Tyneside 001D","E01008598","Total",702,648,54
"2011","South Tyneside 001E","E01008599","Total",762,729,33
"2011","South Tyneside 002A","E01008664","Total",761,696,65
"2011","South Tyneside 002B","E01008665","Total",797,762,35
"2011","South Tyneside 002C","E01008666","Total",856,803,53
"2011","South Tyneside 002D","E01008667","Total",938,899,39
"2011","South Tyneside 002E","E01008668","Total",873,813,60
"2011","South Tyneside 003A","E01008673","Total",538,524,14
"2011","South Tyneside 003B","E01008675","Total",794,757,37
"2011","South Tyneside 003C","E01008676","Total",569,538,31
"2011","South Tyneside 003D","E01008677","Total",604,590,14
"2011","South Tyneside 003E","E01008678","Total",675,626,49
"2011","South Tyneside 004A","E01008647","Total",680,659,21
"2011","South Tyneside 004B","E01008648","Total",689,668,21
"2011","South Tyneside 004C","E01008649","Total",719,701,18
"2011","South Tyneside 004D","E01008651","Total",830,778,52
"2011","South Tyneside 005A","E01008679","Total",661,625,36
"2011","South Tyneside 005B","E01008680","Total",626,604,22
"2011","South Tyneside 005C","E01008682","Total",520,509,11
"2011","South Tyneside 005D","E01008683","Total",777,729,48
"2011","South Tyneside 006A","E01008635","Total",649,633,16
"2011","South Tyneside 006B","E01008650","Total",612,599,13
"2011","South Tyneside 006C","E01008674","Total",526,512,14
"2011","South Tyneside 006D","E01008681","Total",667,637,30
"2011","South Tyneside 007A","E01008600","Total",672,623,49
"2011","South Tyneside 007B","E01008604","Total",800,769,31
"2011","South Tyneside 007C","E01008660","Total",682,655,27
"2011","South Tyneside 007D","E01008661","Total",523,512,11
"2011","South Tyneside 008A","E01008633","Total",620,603,17
"2011","South Tyneside 008B","E01008634","Total",639,622,17
"2011","South Tyneside 008C","E01008636","Total",604,596,8
"2011","South Tyneside 008D","E01008637","Total",640,629,11
"2011","South Tyneside 009A","E01008639","Total",877,848,29
"2011","South Tyneside 009B","E01008652","Total",533,514,19
"2011","South Tyneside 009C","E01008653","Total",541,526,15
"2011","South Tyneside 009D","E01008654","Total",643,600,43
"2011","South Tyneside 009E","E01008655","Total",677,663,14
"2011","South Tyneside 009F","E01008657","Total",596,578,18
"2011","South Tyneside 010A","E01008638","Total",628,612,16
"2011","South Tyneside 010B","E01008640","Total",931,889,42
"2011","South Tyneside 010C","E01008641","Total",847,818,29
"2011","South Tyneside 010D","E01008642","Total",586,578,8
"2011","South Tyneside 011A","E01008590","Total",805,749,56
"2011","South Tyneside 011B","E01008591","Total",809,763,46
"2011","South Tyneside 011C","E01008592","Total",741,689,52
"2011","South Tyneside 011D","E01008594","Total",764,738,26
"2011","South Tyneside 012A","E01008601","Total",657,635,22
"2011","South Tyneside 012B","E01008669","Total",674,649,25
"2011","South Tyneside 012C","E01008671","Total",683,647,36
"2011","South Tyneside 012D","E01008672","Total",601,588,13
"2011","South Tyneside 013A","E01008622","Total",727,713,14
"2011","South Tyneside 013C","E01008625","Total",738,718,20
"2011","South Tyneside 013E","E01033074","Total",919,887,32
"2011","South Tyneside 014A","E01008602","Total",644,631,13
"2011","South Tyneside 014B","E01008603","Total",670,648,22
"2011","South Tyneside 014C","E01008608","Total",570,544,26
"2011","South Tyneside 014D","E01008670","Total",754,744,10
"2011","South Tyneside 015A","E01008643","Total",636,620,16
"2011","South Tyneside 015B","E01008644","Total",765,753,12
"2011","South Tyneside 015C","E01008645","Total",678,668,10
"2011","South Tyneside 015D","E01008646","Total",628,609,19
"2011","South Tyneside 015E","E01008656","Total",615,604,11
"2011","South Tyneside 015F","E01008658","Total",595,581,14
"2011","South Tyneside 016A","E01008593","Total",616,569,47
"2011","South Tyneside 016B","E01008605","Total",517,508,9
"2011","South Tyneside 016C","E01008606","Total",684,651,33
"2011","South Tyneside 016D","E01008607","Total",642,604,38
"2011","South Tyneside 016E","E01008609","Total",669,648,21
"2011","South Tyneside 017A","E01008631","Total",619,614,5
"2011","South Tyneside 017B","E01008632","Total",575,571,4
"2011","South Tyneside 017C","E01008659","Total",644,634,10
"2011","South Tyneside 017D","E01008662","Total",523,514,9
"2011","South Tyneside 017E","E01008663","Total",644,637,7
"2011","South Tyneside 018A","E01008624","Total",601,590,11
"2011","South Tyneside 018B","E01008684","Total",616,589,27
"2011","South Tyneside 018C","E01008685","Total",822,806,16
"2011","South Tyneside 018D","E01008686","Total",743,726,17
"2011","South Tyneside 018E","E01008687","Total",878,844,34
"2011","South Tyneside 019A","E01008688","Total",673,654,19
"2011","South Tyneside 019B","E01008689","Total",783,769,14
"2011","South Tyneside 019C","E01008690","Total",661,646,15
"2011","South Tyneside 019D","E01008691","Total",500,494,6
"2011","South Tyneside 019E","E01008692","Total",627,615,12
"2011","South Tyneside 020A","E01008627","Total",623,611,12
"2011","South Tyneside 020B","E01008628","Total",646,624,22
"2011","South Tyneside 020C","E01008629","Total",605,595,10
"2011","South Tyneside 020D","E01008630","Total",641,627,14
"2011","South Tyneside 021A","E01008610","Total",647,637,10
"2011","South Tyneside 021B","E01008611","Total",616,602,14
"2011","South Tyneside 021C","E01008612","Total",651,640,11
"2011","South Tyneside 021D","E01008613","Total",822,757,65
"2011","South Tyneside 022A","E01008616","Total",655,643,12
"2011","South Tyneside 022B","E01008618","Total",526,512,14
"2011","South Tyneside 022C","E01008619","Total",751,712,39
"2011","South Tyneside 022D","E01008621","Total",623,604,19
"2011","South Tyneside 023A","E01008614","Total",693,676,17
"2011","South Tyneside 023B","E01008615","Total",706,679,27
"2011","South Tyneside 023C","E01008617","Total",664,621,43
"2011","South Tyneside 023D","E01008620","Total",682,657,25
"2011","Sunderland 001A","E01008713","Total",642,630,12
"2011","Sunderland 001B","E01008722","Total",665,644,21
"2011","Sunderland 001C","E01008724","Total",489,483,6
"2011","Sunderland 001D","E01008726","Total",687,670,17
"2011","Sunderland 002A","E01008723","Total",594,572,22
"2011","Sunderland 002B","E01008725","Total",640,619,21
"2011","Sunderland 002C","E01008727","Total",791,769,22
"2011","Sunderland 002D","E01008728","Total",597,583,14
"2011","Sunderland 002E","E01008792","Total",520,505,15
"2011","Sunderland 003A","E01008698","Total",738,724,14
"2011","Sunderland 003B","E01008837","Total",642,633,9
"2011","Sunderland 003C","E01008838","Total",685,680,5
"2011","Sunderland 003D","E01008839","Total",691,671,20
"2011","Sunderland 003E","E01008840","Total",602,586,16
"2011","Sunderland 003F","E01008841","Total",537,528,9
"2011","Sunderland 004A","E01008712","Total",801,774,27
"2011","Sunderland 004B","E01008817","Total",476,465,11
"2011","Sunderland 004C","E01008819","Total",635,630,5
"2011","Sunderland 004D","E01008821","Total",552,539,13
"2011","Sunderland 004E","E01008822","Total",747,732,15
"2011","Sunderland 004F","E01008842","Total",602,592,10
"2011","Sunderland 005A","E01008708","Total",708,695,13
"2011","Sunderland 005B","E01008709","Total",712,687,25
"2011","Sunderland 005D","E01008711","Total",708,687,21
"2011","Sunderland 005F","E01008820","Total",587,558,29
"2011","Sunderland 005G","E01033075","Total",976,950,26
"2011","Sunderland 006A","E01008786","Total",666,648,18
"2011","Sunderland 006B","E01008787","Total",759,710,49
"2011","Sunderland 006C","E01008788","Total",783,758,25
"2011","Sunderland 006D","E01008789","Total",685,642,43
"2011","Sunderland 006E","E01008790","Total",683,657,26
"2011","Sunderland 006F","E01008791","Total",1088,1011,77
"2011","Sunderland 007A","E01008855","Total",654,644,10
"2011","Sunderland 007B","E01008856","Total",644,629,15
"2011","Sunderland 007C","E01008876","Total",585,579,6
"2011","Sunderland 007D","E01008877","Total",650,634,16
"2011","Sunderland 008A","E01008693","Total",592,555,37
"2011","Sunderland 008B","E01008694","Total",628,618,10
"2011","Sunderland 008C","E01008695","Total",616,606,10
"2011","Sunderland 008D","E01008696","Total",494,490,4
"2011","Sunderland 008E","E01008697","Total",591,571,20
"2011","Sunderland 008F","E01008699","Total",610,605,5
"2011","Sunderland 009A","E01008853","Total",634,619,15
"2011","Sunderland 009B","E01008854","Total",857,812,45
"2011","Sunderland 009C","E01008857","Total",647,630,17
"2011","Sunderland 009D","E01008858","Total",614,598,16
"2011","Sunderland 009E","E01008859","Total",544,534,10
"2011","Sunderland 009F","E01008860","Total",611,596,15
"2011","Sunderland 009G","E01008878","Total",648,635,13
"2011","Sunderland 010A","E01008873","Total",551,540,11
"2011","Sunderland 010B","E01008874","Total",675,671,4
"2011","Sunderland 010C","E01008875","Total",683,674,9
"2011","Sunderland 010D","E01008879","Total",639,617,22
"2011","Sunderland 010E","E01008880","Total",522,512,10
"2011","Sunderland 011A","E01008701","Total",689,650,39
"2011","Sunderland 011B","E01008704","Total",679,650,29
"2011","Sunderland 011C","E01008706","Total",697,668,29
"2011","Sunderland 011D","E01008707","Total",578,547,31
"2011","Sunderland 012A","E01008756","Total",667,652,15
"2011","Sunderland 012B","E01008762","Total",659,639,20
"2011","Sunderland 012C","E01008812","Total",765,751,14
"2011","Sunderland 012F","E01033076","Total",604,596,8
"2011","Sunderland 013A","E01008700","Total",548,516,32
"2011","Sunderland 013B","E01008703","Total",1181,1089,92
"2011","Sunderland 013C","E01008705","Total",517,485,32
"2011","Sunderland 013D","E01008831","Total",1256,1131,125
"2011","Sunderland 013E","E01008834","Total",1048,967,81
"2011","Sunderland 014A","E01008810","Total",720,712,8
"2011","Sunderland 014B","E01008811","Total",702,690,12
"2011","Sunderland 014C","E01008813","Total",657,643,14
"2011","Sunderland 014D","E01008814","Total",679,661,18
"2011","Sunderland 015A","E01008757","Total",689,648,41
"2011","Sunderland 015B","E01008758","Total",615,601,14
"2011","Sunderland 015C","E01008759","Total",697,664,33
"2011","Sunderland 015D","E01008761","Total",611,588,23
"2011","Sunderland 016A","E01008702","Total",573,566,7
"2011","Sunderland 016B","E01008735","Total",1160,1032,128
"2011","Sunderland 016C","E01008736","Total",675,609,66
"2011","Sunderland 016D","E01008737","Total",683,627,56
"2011","Sunderland 016E","E01008738","Total",624,605,19
"2011","Sunderland 016F","E01008836","Total",737,704,33
"2011","Sunderland 017A","E01008845","Total",695,672,23
"2011","Sunderland 017B","E01008846","Total",483,464,19
"2011","Sunderland 017C","E01008847","Total",521,513,8
"2011","Sunderland 017D","E01008850","Total",650,625,25
"2011","Sunderland 017E","E01008851","Total",794,753,41
"2011","Sunderland 018A","E01008760","Total",648,626,22
"2011","Sunderland 018B","E01008830","Total",606,573,33
"2011","Sunderland 018C","E01008832","Total",653,632,21
"2011","Sunderland 018D","E01008833","Total",664,637,27
"2011","Sunderland 019A","E01008843","Total",564,555,9
"2011","Sunderland 019B","E01008844","Total",706,688,18
"2011","Sunderland 019C","E01008848","Total",617,608,9
"2011","Sunderland 019D","E01008849","Total",508,499,9
"2011","Sunderland 019E","E01008852","Total",541,531,10
"2011","Sunderland 020A","E01008867","Total",822,803,19
"2011","Sunderland 020B","E01008868","Total",516,513,3
"2011","Sunderland 020C","E01008869","Total",530,523,7
"2011","Sunderland 020D","E01008870","Total",605,595,10
"2011","Sunderland 020E","E01008871","Total",608,602,6
"2011","Sunderland 020F","E01008872","Total",673,663,10
"2011","Sunderland 021A","E01008729","Total",473,462,11
"2011","Sunderland 021B","E01008730","Total",656,647,9
"2011","Sunderland 021C","E01008731","Total",527,519,8
"2011","Sunderland 021D","E01008732","Total",965,940,25
"2011","Sunderland 021E","E01008733","Total",899,882,17
"2011","Sunderland 021F","E01008734","Total",644,637,7
"2011","Sunderland 022A","E01008740","Total",632,609,23
"2011","Sunderland 022B","E01008781","Total",641,633,8
"2011","Sunderland 022C","E01008782","Total",616,607,9
"2011","Sunderland 022D","E01008783","Total",637,622,15
"2011","Sunderland 022E","E01008784","Total",654,648,6
"2011","Sunderland 022F","E01008785","Total",637,624,13
"2011","Sunderland 022G","E01008835","Total",640,611,29
"2011","Sunderland 023A","E01008823","Total",611,606,5
"2011","Sunderland 023B","E01008824","Total",636,625,11
"2011","Sunderland 023C","E01008825","Total",703,687,16
"2011","Sunderland 023D","E01008826","Total",612,606,6
"2011","Sunderland 023E","E01008827","Total",531,524,7
"2011","Sunderland 023F","E01008828","Total",649,643,6
"2011","Sunderland 023G","E01008829","Total",637,627,10
"2011","Sunderland 024A","E01008739","Total",615,606,9
"2011","Sunderland 024B","E01008741","Total",635,619,16
"2011","Sunderland 024C","E01008779","Total",694,689,5
"2011","Sunderland 024D","E01008780","Total",856,848,8
"2011","Sunderland 025A","E01008799","Total",662,641,21
"2011","Sunderland 025B","E01008861","Total",663,649,14
"2011","Sunderland 025C","E01008862","Total",569,567,2
"2011","Sunderland 025D","E01008863","Total",645,633,12
"2011","Sunderland 025E","E01008864","Total",548,540,8
"2011","Sunderland 025F","E01008865","Total",628,608,20
"2011","Sunderland 025G","E01008866","Total",619,606,13
"2011","Sunderland 026A","E01008773","Total",688,675,13
"2011","Sunderland 026B","E01008776","Total",505,494,11
"2011","Sunderland 026C","E01008777","Total",902,886,16
"2011","Sunderland 026D","E01008778","Total",626,609,17
"2011","Sunderland 026E","E01008809","Total",709,693,16
"2011","Sunderland 027A","E01008803","Total",679,650,29
"2011","Sunderland 027B","E01008804","Total",677,663,14
"2011","Sunderland 027C","E01008805","Total",679,660,19
"2011","Sunderland 027F","E01033077","Total",784,741,43
"2011","Sunderland 028A","E01008763","Total",615,607,8
"2011","Sunderland 028B","E01008764","Total",657,652,5
"2011","Sunderland 028C","E01008766","Total",916,911,5
"2011","Sunderland 028D","E01008768","Total",593,585,8
"2011","Sunderland 028E","E01008769","Total",789,775,14
"2011","Sunderland 029A","E01008772","Total",602,585,17
"2011","Sunderland 029B","E01008774","Total",613,591,22
"2011","Sunderland 029C","E01008775","Total",612,601,11
"2011","Sunderland 029D","E01008802","Total",658,643,15
"2011","Sunderland 029E","E01008808","Total",660,634,26
"2011","Sunderland 030A","E01008793","Total",848,823,25
"2011","Sunderland 030B","E01008795","Total",738,722,16
"2011","Sunderland 030C","E01008797","Total",850,833,17
"2011","Sunderland 030D","E01008800","Total",618,582,36
"2011","Sunderland 030E","E01008801","Total",678,658,20
"2011","Sunderland 031A","E01008765","Total",615,603,12
"2011","Sunderland 031B","E01008767","Total",648,632,16
"2011","Sunderland 031C","E01008770","Total",603,600,3
"2011","Sunderland 031D","E01008771","Total",621,618,3
"2011","Sunderland 032A","E01008720","Total",649,618,31
"2011","Sunderland 032B","E01008721","Total",637,626,11
"2011","Sunderland 032D","E01008796","Total",663,621,42
"2011","Sunderland 032F","E01032483","Total",762,728,34
"2011","Sunderland 032G","E01032484","Total",593,572,21
"2011","Sunderland 033A","E01008750","Total",775,762,13
"2011","Sunderland 033B","E01008751","Total",468,462,6
"2011","Sunderland 033C","E01008752","Total",725,692,33
"2011","Sunderland 033D","E01008753","Total",586,559,27
"2011","Sunderland 033E","E01008755","Total",624,589,35
"2011","Sunderland 034A","E01008714","Total",543,528,15
"2011","Sunderland 034B","E01008715","Total",600,587,13
"2011","Sunderland 034C","E01008716","Total",601,592,9
"2011","Sunderland 034D","E01008717","Total",718,683,35
"2011","Sunderland 034E","E01008749","Total",645,638,7
"2011","Sunderland 034F","E01008754","Total",709,694,15
"2011","Sunderland 035A","E01008718","Total",630,610,20
"2011","Sunderland 035B","E01008719","Total",601,557,44
"2011","Sunderland 035C","E01008742","Total",797,754,43
"2011","Sunderland 035D","E01008747","Total",675,656,19
"2011","Sunderland 035E","E01008748","Total",670,655,15
"2011","Sunderland 036A","E01008743","Total",741,725,16
"2011","Sunderland 036B","E01008744","Total",789,750,39
"2011","Sunderland 036C","E01008745","Total",776,728,48
"2011","Sunderland 036D","E01008746","Total",743,714,29
"2011","Blackburn with Darwen 001A","E01012607","Total",672,640,32
"2011","Blackburn with Darwen 001B","E01012608","Total",769,731,38
"2011","Blackburn with Darwen 001C","E01012633","Total",757,729,28
"2011","Blackburn with Darwen 001D","E01012634","Total",614,590,24
"2011","Blackburn with Darwen 001E","E01012635","Total",623,589,34
"2011","Blackburn with Darwen 001F","E01012636","Total",699,673,26
"2011","Blackburn with Darwen 002A","E01012581","Total",516,495,21
"2011","Blackburn with Darwen 002B","E01012582","Total",539,525,14
"2011","Blackburn with Darwen 002C","E01012583","Total",668,643,25
"2011","Blackburn with Darwen 002D","E01012587","Total",709,661,48
"2011","Blackburn with Darwen 002E","E01012588","Total",656,617,39
"2011","Blackburn with Darwen 003A","E01012574","Total",570,563,7
"2011","Blackburn with Darwen 003B","E01012577","Total",548,516,32
"2011","Blackburn with Darwen 003C","E01012578","Total",572,528,44
"2011","Blackburn with Darwen 003D","E01012605","Total",623,578,45
"2011","Blackburn with Darwen 003E","E01012606","Total",513,483,30
"2011","Blackburn with Darwen 004A","E01012579","Total",562,542,20
"2011","Blackburn with Darwen 004B","E01012580","Total",567,537,30
"2011","Blackburn with Darwen 004C","E01012642","Total",512,482,30
"2011","Blackburn with Darwen 004D","E01012645","Total",616,582,34
"2011","Blackburn with Darwen 005A","E01012585","Total",499,466,33
"2011","Blackburn with Darwen 005B","E01012586","Total",582,490,92
"2011","Blackburn with Darwen 005C","E01012656","Total",675,627,48
"2011","Blackburn with Darwen 005D","E01012657","Total",760,718,42
"2011","Blackburn with Darwen 005E","E01012658","Total",790,756,34
"2011","Blackburn with Darwen 006A","E01012629","Total",500,479,21
"2011","Blackburn with Darwen 006B","E01012631","Total",603,579,24
"2011","Blackburn with Darwen 006C","E01012643","Total",649,627,22
"2011","Blackburn with Darwen 006D","E01012644","Total",714,661,53
"2011","Blackburn with Darwen 006E","E01012655","Total",934,879,55
"2011","Blackburn with Darwen 007A","E01012571","Total",480,457,23
"2011","Blackburn with Darwen 007B","E01012572","Total",526,522,4
"2011","Blackburn with Darwen 007C","E01012573","Total",509,484,25
"2011","Blackburn with Darwen 007D","E01012575","Total",565,546,19
"2011","Blackburn with Darwen 007E","E01012630","Total",636,601,35
"2011","Blackburn with Darwen 008A","E01012576","Total",601,569,32
"2011","Blackburn with Darwen 008B","E01012637","Total",646,637,9
"2011","Blackburn with Darwen 008C","E01012638","Total",719,703,16
"2011","Blackburn with Darwen 008D","E01012639","Total",752,722,30
"2011","Blackburn with Darwen 008E","E01012640","Total",758,722,36
"2011","Blackburn with Darwen 008F","E01012641","Total",555,550,5
"2011","Blackburn with Darwen 009A","E01012595","Total",872,860,12
"2011","Blackburn with Darwen 009B","E01012596","Total",848,794,54
"2011","Blackburn with Darwen 009C","E01012622","Total",813,780,33
"2011","Blackburn with Darwen 009D","E01012623","Total",668,636,32
"2011","Blackburn with Darwen 009E","E01012624","Total",742,715,27
"2011","Blackburn with Darwen 009F","E01012625","Total",820,774,46
"2011","Blackburn with Darwen 010A","E01012584","Total",549,521,28
"2011","Blackburn with Darwen 010B","E01012609","Total",663,654,9
"2011","Blackburn with Darwen 010C","E01012610","Total",509,506,3
"2011","Blackburn with Darwen 010D","E01012611","Total",489,482,7
"2011","Blackburn with Darwen 010E","E01012612","Total",631,625,6
"2011","Blackburn with Darwen 010F","E01012613","Total",567,558,9
"2011","Blackburn with Darwen 011A","E01012600","Total",637,635,2
"2011","Blackburn with Darwen 011B","E01012601","Total",594,593,1
"2011","Blackburn with Darwen 011C","E01012602","Total",655,651,4
"2011","Blackburn with Darwen 011D","E01012603","Total",660,649,11
"2011","Blackburn with Darwen 011E","E01012604","Total",607,599,8
"2011","Blackburn with Darwen 011F","E01012632","Total",829,808,21
"2011","Blackburn with Darwen 012A","E01012594","Total",628,626,2
"2011","Blackburn with Darwen 012B","E01012618","Total",664,647,17
"2011","Blackburn with Darwen 012C","E01012619","Total",558,554,4
"2011","Blackburn with Darwen 012D","E01012620","Total",640,639,1
"2011","Blackburn with Darwen 012E","E01012621","Total",629,625,4
"2011","Blackburn with Darwen 013A","E01012593","Total",748,742,6
"2011","Blackburn with Darwen 013B","E01012597","Total",684,679,5
"2011","Blackburn with Darwen 013C","E01012598","Total",1050,1050,0
"2011","Blackburn with Darwen 013D","E01012599","Total",504,498,6
"2011","Blackburn with Darwen 014A","E01012589","Total",670,653,17
"2011","Blackburn with Darwen 014B","E01012590","Total",639,630,9
"2011","Blackburn with Darwen 014C","E01012591","Total",667,666,1
"2011","Blackburn with Darwen 014D","E01012648","Total",539,531,8
"2011","Blackburn with Darwen 014E","E01012652","Total",674,652,22
"2011","Blackburn with Darwen 015A","E01012617","Total",644,602,42
"2011","Blackburn with Darwen 015B","E01012646","Total",817,744,73
"2011","Blackburn with Darwen 015C","E01012647","Total",682,646,36
"2011","Blackburn with Darwen 015D","E01012650","Total",659,596,63
"2011","Blackburn with Darwen 016A","E01012649","Total",683,633,50
"2011","Blackburn with Darwen 016B","E01012651","Total",706,686,20
"2011","Blackburn with Darwen 016C","E01012653","Total",616,580,36
"2011","Blackburn with Darwen 016D","E01012654","Total",841,762,79
"2011","Blackburn with Darwen 017A","E01012614","Total",688,673,15
"2011","Blackburn with Darwen 017B","E01012615","Total",780,748,32
"2011","Blackburn with Darwen 017C","E01012616","Total",793,761,32
"2011","Blackburn with Darwen 017D","E01012659","Total",622,593,29
"2011","Blackburn with Darwen 017E","E01012660","Total",477,463,14
"2011","Blackburn with Darwen 017F","E01012661","Total",725,687,38
"2011","Blackburn with Darwen 018A","E01012592","Total",861,826,35
"2011","Blackburn with Darwen 018D","E01012628","Total",519,497,22
"2011","Blackburn with Darwen 018E","E01032485","Total",751,719,32
"2011","Blackburn with Darwen 018F","E01032486","Total",625,606,19
"2011","Blackpool 001A","E01012663","Total",826,751,75
"2011","Blackpool 001B","E01012664","Total",755,714,41
"2011","Blackpool 001C","E01012665","Total",913,863,50
"2011","Blackpool 001D","E01012716","Total",676,642,34
"2011","Blackpool 001E","E01012719","Total",654,625,29
"2011","Blackpool 002A","E01012662","Total",875,832,43
"2011","Blackpool 002B","E01012703","Total",747,706,41
"2011","Blackpool 002C","E01012704","Total",1120,1078,42
"2011","Blackpool 002D","E01012706","Total",728,709,19
"2011","Blackpool 002E","E01012717","Total",740,715,25
"2011","Blackpool 003A","E01012666","Total",727,667,60
"2011","Blackpool 003B","E01012667","Total",668,642,26
"2011","Blackpool 003C","E01012668","Total",762,728,34
"2011","Blackpool 003D","E01012669","Total",980,875,105
"2011","Blackpool 003E","E01012718","Total",802,771,31
"2011","Blackpool 004A","E01012690","Total",760,740,20
"2011","Blackpool 004B","E01012691","Total",828,790,38
"2011","Blackpool 004C","E01012692","Total",859,827,32
"2011","Blackpool 004D","E01012705","Total",751,727,24
"2011","Blackpool 004E","E01012723","Total",686,654,32
"2011","Blackpool 005A","E01012693","Total",771,725,46
"2011","Blackpool 005B","E01012711","Total",638,602,36
"2011","Blackpool 005C","E01012747","Total",642,611,31
"2011","Blackpool 005D","E01012750","Total",786,735,51
"2011","Blackpool 006A","E01012681","Total",966,762,204
"2011","Blackpool 006B","E01012683","Total",819,715,104
"2011","Blackpool 006C","E01012748","Total",830,715,115
"2011","Blackpool 006D","E01012749","Total",768,715,53
"2011","Blackpool 007A","E01012707","Total",672,640,32
"2011","Blackpool 007B","E01012720","Total",679,649,30
"2011","Blackpool 007C","E01012721","Total",870,835,35
"2011","Blackpool 007D","E01012724","Total",693,621,72
"2011","Blackpool 008A","E01012678","Total",778,738,40
"2011","Blackpool 008B","E01012679","Total",698,637,61
"2011","Blackpool 008C","E01012680","Total",726,684,42
"2011","Blackpool 008D","E01012682","Total",821,745,76
"2011","Blackpool 008E","E01012684","Total",726,689,37
"2011","Blackpool 009A","E01012676","Total",640,611,29
"2011","Blackpool 009B","E01012677","Total",669,614,55
"2011","Blackpool 009C","E01012708","Total",635,607,28
"2011","Blackpool 009D","E01012709","Total",795,744,51
"2011","Blackpool 009E","E01012710","Total",507,480,27
"2011","Blackpool 009F","E01012722","Total",534,514,20
"2011","Blackpool 010A","E01012673","Total",832,712,120
"2011","Blackpool 010B","E01012675","Total",773,697,76
"2011","Blackpool 010C","E01012735","Total",806,700,106
"2011","Blackpool 010D","E01012736","Total",692,468,224
"2011","Blackpool 010E","E01012737","Total",973,805,168
"2011","Blackpool 011A","E01012670","Total",654,574,80
"2011","Blackpool 011B","E01012733","Total",530,471,59
"2011","Blackpool 011C","E01012734","Total",673,631,42
"2011","Blackpool 011D","E01012738","Total",629,563,66
"2011","Blackpool 011E","E01012739","Total",602,578,24
"2011","Blackpool 011F","E01012742","Total",567,541,26
"2011","Blackpool 012A","E01012712","Total",731,695,36
"2011","Blackpool 012B","E01012713","Total",869,826,43
"2011","Blackpool 012C","E01012715","Total",744,698,46
"2011","Blackpool 012D","E01012740","Total",719,685,34
"2011","Blackpool 012E","E01012741","Total",635,608,27
"2011","Blackpool 013A","E01012671","Total",713,586,127
"2011","Blackpool 013B","E01012672","Total",660,540,120
"2011","Blackpool 013C","E01012674","Total",799,720,79
"2011","Blackpool 013D","E01012751","Total",983,735,248
"2011","Blackpool 014A","E01012686","Total",668,636,32
"2011","Blackpool 014B","E01012687","Total",653,632,21
"2011","Blackpool 014C","E01012688","Total",678,658,20
"2011","Blackpool 014D","E01012689","Total",669,630,39
"2011","Blackpool 014E","E01012714","Total",826,796,30
"2011","Blackpool 015A","E01012695","Total",659,616,43
"2011","Blackpool 015B","E01012743","Total",842,742,100
"2011","Blackpool 015C","E01012744","Total",791,746,45
"2011","Blackpool 015D","E01012745","Total",799,755,44
"2011","Blackpool 015E","E01012746","Total",842,796,46
"2011","Blackpool 016A","E01012685","Total",669,638,31
"2011","Blackpool 016B","E01012694","Total",686,645,41
"2011","Blackpool 016C","E01012696","Total",703,667,36
"2011","Blackpool 016D","E01012697","Total",702,680,22
"2011","Blackpool 016E","E01012698","Total",675,637,38
"2011","Blackpool 017A","E01012726","Total",800,757,43
"2011","Blackpool 017B","E01012728","Total",795,736,59
"2011","Blackpool 017C","E01012752","Total",640,583,57
"2011","Blackpool 017D","E01012753","Total",494,469,25
"2011","Blackpool 017E","E01012754","Total",608,522,86
"2011","Blackpool 017F","E01012755","Total",637,608,29
"2011","Blackpool 018A","E01012701","Total",644,619,25
"2011","Blackpool 018B","E01012729","Total",778,749,29
"2011","Blackpool 018C","E01012730","Total",715,685,30
"2011","Blackpool 018D","E01012731","Total",753,728,25
"2011","Blackpool 018E","E01012732","Total",864,829,35
"2011","Blackpool 019A","E01012699","Total",772,759,13
"2011","Blackpool 019B","E01012700","Total",784,758,26
"2011","Blackpool 019C","E01012702","Total",800,766,34
"2011","Blackpool 019D","E01012725","Total",618,595,23
"2011","Blackpool 019E","E01012727","Total",675,653,22
"2011","Cheshire East 022A","E01018393","Total",945,839,106
"2011","Cheshire East 022B","E01018411","Total",974,934,40
"2011","Cheshire East 022C","E01018412","Total",684,660,24
"2011","Cheshire East 023A","E01018413","Total",516,503,13
"2011","Cheshire East 023B","E01018414","Total",650,624,26
"2011","Cheshire East 023C","E01018415","Total",822,774,48
"2011","Cheshire East 023D","E01018416","Total",524,518,6
"2011","Cheshire East 024A","E01018424","Total",789,731,58
"2011","Cheshire East 024B","E01018425","Total",813,748,65
"2011","Cheshire East 024C","E01018426","Total",751,727,24
"2011","Cheshire East 024D","E01018427","Total",509,504,5
"2011","Cheshire East 025A","E01018419","Total",541,535,6
"2011","Cheshire East 025B","E01018420","Total",742,716,26
"2011","Cheshire East 025C","E01018421","Total",558,539,19
"2011","Cheshire East 025D","E01018422","Total",575,542,33
"2011","Cheshire East 025E","E01018423","Total",645,629,16
"2011","Cheshire East 026A","E01018395","Total",734,701,33
"2011","Cheshire East 026B","E01018396","Total",620,609,11
"2011","Cheshire East 026C","E01018400","Total",1006,977,29
"2011","Cheshire East 026D","E01018401","Total",630,610,20
"2011","Cheshire East 027A","E01018398","Total",776,735,41
"2011","Cheshire East 027B","E01018399","Total",740,690,50
"2011","Cheshire East 027C","E01018402","Total",1011,942,69
"2011","Cheshire East 027D","E01018403","Total",843,825,18
"2011","Cheshire East 028A","E01018397","Total",762,726,36
"2011","Cheshire East 028B","E01018408","Total",765,756,9
"2011","Cheshire East 028C","E01018409","Total",899,870,29
"2011","Cheshire East 028D","E01018410","Total",664,653,11
"2011","Cheshire East 029A","E01018404","Total",631,611,20
"2011","Cheshire East 029B","E01018405","Total",615,600,15
"2011","Cheshire East 029C","E01018406","Total",630,613,17
"2011","Cheshire East 029D","E01018407","Total",660,643,17
"2011","Cheshire East 030A","E01018436","Total",636,611,25
"2011","Cheshire East 030B","E01018437","Total",815,753,62
"2011","Cheshire East 030C","E01018438","Total",639,619,20
"2011","Cheshire East 030D","E01018439","Total",571,557,14
"2011","Cheshire East 031A","E01018440","Total",749,724,25
"2011","Cheshire East 031B","E01018441","Total",675,654,21
"2011","Cheshire East 031C","E01018442","Total",771,753,18
"2011","Cheshire East 031D","E01018443","Total",658,639,19
"2011","Cheshire East 032A","E01018432","Total",661,648,13
"2011","Cheshire East 032B","E01018433","Total",603,586,17
"2011","Cheshire East 032C","E01018434","Total",638,623,15
"2011","Cheshire East 032D","E01018435","Total",704,673,31
"2011","Cheshire East 033A","E01018394","Total",850,815,35
"2011","Cheshire East 033B","E01018417","Total",758,734,24
"2011","Cheshire East 033C","E01018418","Total",683,661,22
"2011","Cheshire East 033D","E01018428","Total",641,625,16
"2011","Cheshire East 033E","E01018429","Total",687,660,27
"2011","Cheshire East 033F","E01018430","Total",586,577,9
"2011","Cheshire East 033G","E01018431","Total",539,512,27
"2011","Cheshire East 040A","E01018387","Total",756,736,20
"2011","Cheshire East 040B","E01018388","Total",769,745,24
"2011","Cheshire East 040C","E01018389","Total",764,729,35
"2011","Cheshire East 040D","E01018390","Total",786,757,29
"2011","Cheshire East 042A","E01018386","Total",672,629,43
"2011","Cheshire East 042B","E01018391","Total",842,812,30
"2011","Cheshire East 042C","E01018392","Total",799,775,24
"2011","Cheshire East 034A","E01018472","Total",689,659,30
"2011","Cheshire East 034B","E01018473","Total",664,657,7
"2011","Cheshire East 034C","E01018474","Total",682,670,12
"2011","Cheshire East 034D","E01018475","Total",636,632,4
"2011","Cheshire East 035A","E01018463","Total",658,627,31
"2011","Cheshire East 035B","E01018476","Total",533,513,20
"2011","Cheshire East 035C","E01018477","Total",652,627,25
"2011","Cheshire East 035D","E01018478","Total",538,527,11
"2011","Cheshire East 035E","E01018479","Total",721,704,17
"2011","Cheshire East 036A","E01018459","Total",534,510,24
"2011","Cheshire East 036B","E01018460","Total",648,622,26
"2011","Cheshire East 036C","E01018461","Total",663,628,35
"2011","Cheshire East 036D","E01018466","Total",1196,1126,70
"2011","Cheshire East 036E","E01018467","Total",1057,996,61
"2011","Cheshire East 037A","E01018482","Total",654,639,15
"2011","Cheshire East 037B","E01018483","Total",654,631,23
"2011","Cheshire East 037C","E01018484","Total",920,901,19
"2011","Cheshire East 037D","E01018485","Total",647,633,14
"2011","Cheshire East 038A","E01018499","Total",726,711,15
"2011","Cheshire East 038B","E01018500","Total",535,529,6
"2011","Cheshire East 038C","E01018501","Total",794,766,28
"2011","Cheshire East 038D","E01018502","Total",562,543,19
"2011","Cheshire East 039A","E01018462","Total",773,715,58
"2011","Cheshire East 039B","E01018464","Total",693,650,43
"2011","Cheshire East 039C","E01018496","Total",700,681,19
"2011","Cheshire East 039D","E01018497","Total",563,526,37
"2011","Cheshire East 039E","E01018498","Total",671,641,30
"2011","Cheshire East 041A","E01018465","Total",1239,1172,67
"2011","Cheshire East 041B","E01018468","Total",659,640,19
"2011","Cheshire East 041C","E01018469","Total",669,646,23
"2011","Cheshire East 041D","E01018470","Total",593,576,17
"2011","Cheshire East 041E","E01018471","Total",643,626,17
"2011","Cheshire East 043A","E01018486","Total",750,702,48
"2011","Cheshire East 043B","E01018487","Total",704,653,51
"2011","Cheshire East 043C","E01018488","Total",621,599,22
"2011","Cheshire East 043D","E01018489","Total",574,534,40
"2011","Cheshire East 044A","E01018510","Total",630,623,7
"2011","Cheshire East 044B","E01018511","Total",665,644,21
"2011","Cheshire East 044C","E01018512","Total",725,713,12
"2011","Cheshire East 044D","E01018513","Total",671,660,11
"2011","Cheshire East 045A","E01018445","Total",864,828,36
"2011","Cheshire East 045B","E01018446","Total",512,502,10
"2011","Cheshire East 045C","E01018447","Total",804,727,77
"2011","Cheshire East 045D","E01018448","Total",775,729,46
"2011","Cheshire East 046A","E01018490","Total",655,637,18
"2011","Cheshire East 046B","E01018491","Total",648,625,23
"2011","Cheshire East 046C","E01018492","Total",528,513,15
"2011","Cheshire East 046D","E01018505","Total",449,436,13
"2011","Cheshire East 046E","E01018506","Total",542,533,9
"2011","Cheshire East 046F","E01018507","Total",575,559,16
"2011","Cheshire East 047A","E01018451","Total",804,758,46
"2011","Cheshire East 047B","E01018454","Total",742,708,34
"2011","Cheshire East 047C","E01018455","Total",625,607,18
"2011","Cheshire East 047D","E01018456","Total",602,587,15
"2011","Cheshire East 047E","E01018457","Total",814,759,55
"2011","Cheshire East 049A","E01018444","Total",922,866,56
"2011","Cheshire East 049B","E01018480","Total",891,821,70
"2011","Cheshire East 049C","E01018515","Total",953,897,56
"2011","Cheshire East 049D","E01018516","Total",634,608,26
"2011","Cheshire East 049F","E01033375","Total",451,444,7
"2011","Cheshire East 049G","E01033376","Total",460,447,13
"2011","Cheshire East 049H","E01033378","Total",557,529,28
"2011","Cheshire East 048A","E01018493","Total",641,622,19
"2011","Cheshire East 048B","E01018494","Total",609,597,12
"2011","Cheshire East 048C","E01018495","Total",552,538,14
"2011","Cheshire East 048D","E01018508","Total",508,493,15
"2011","Cheshire East 048E","E01018509","Total",534,514,20
"2011","Cheshire East 050A","E01018452","Total",529,511,18
"2011","Cheshire East 050C","E01018503","Total",700,689,11
"2011","Cheshire East 050D","E01018504","Total",909,855,54
"2011","Cheshire East 050E","E01033372","Total",688,605,83
"2011","Cheshire East 050F","E01033373","Total",666,631,35
"2011","Cheshire East 051A","E01018449","Total",780,746,34
"2011","Cheshire East 051B","E01018450","Total",969,912,57
"2011","Cheshire East 051C","E01018458","Total",907,869,38
"2011","Cheshire East 051D","E01018481","Total",842,803,39
"2011","Cheshire East 051E","E01018514","Total",856,810,46
"2011","Cheshire East 001A","E01018585","Total",636,617,19
"2011","Cheshire East 001B","E01018586","Total",712,686,26
"2011","Cheshire East 001C","E01018587","Total",690,653,37
"2011","Cheshire East 001D","E01018661","Total",527,516,11
"2011","Cheshire East 002A","E01018657","Total",500,487,13
"2011","Cheshire East 002B","E01018662","Total",488,477,11
"2011","Cheshire East 002C","E01018663","Total",687,660,27
"2011","Cheshire East 002D","E01018664","Total",595,589,6
"2011","Cheshire East 002E","E01018665","Total",502,484,18
"2011","Cheshire East 003A","E01018655","Total",785,748,37
"2011","Cheshire East 003B","E01018656","Total",671,647,24
"2011","Cheshire East 003C","E01018658","Total",492,489,3
"2011","Cheshire East 003D","E01018659","Total",532,521,11
"2011","Cheshire East 003E","E01018660","Total",415,406,9
"2011","Cheshire East 004A","E01018582","Total",841,806,35
"2011","Cheshire East 004B","E01018592","Total",750,731,19
"2011","Cheshire East 004C","E01018593","Total",818,767,51
"2011","Cheshire East 004D","E01018594","Total",878,829,49
"2011","Cheshire East 004E","E01018595","Total",774,729,45
"2011","Cheshire East 004F","E01018596","Total",947,916,31
"2011","Cheshire East 005A","E01018583","Total",815,793,22
"2011","Cheshire East 005B","E01018584","Total",741,716,25
"2011","Cheshire East 005C","E01018612","Total",538,520,18
"2011","Cheshire East 005D","E01018613","Total",738,706,32
"2011","Cheshire East 006A","E01018600","Total",689,639,50
"2011","Cheshire East 006B","E01018601","Total",888,836,52
"2011","Cheshire East 006C","E01018602","Total",914,833,81
"2011","Cheshire East 006D","E01018652","Total",637,603,34
"2011","Cheshire East 007A","E01018598","Total",669,649,20
"2011","Cheshire East 007B","E01018599","Total",497,488,9
"2011","Cheshire East 007C","E01018648","Total",984,929,55
"2011","Cheshire East 007D","E01018649","Total",629,586,43
"2011","Cheshire East 007E","E01018650","Total",772,738,34
"2011","Cheshire East 007F","E01018651","Total",541,501,40
"2011","Cheshire East 007G","E01018654","Total",957,910,47
"2011","Cheshire East 008A","E01018588","Total",655,633,22
"2011","Cheshire East 008B","E01018589","Total",634,622,12
"2011","Cheshire East 008C","E01018590","Total",773,746,27
"2011","Cheshire East 008D","E01018653","Total",923,888,35
"2011","Cheshire East 009A","E01018605","Total",507,494,13
"2011","Cheshire East 009B","E01018609","Total",770,754,16
"2011","Cheshire East 009C","E01018610","Total",940,899,41
"2011","Cheshire East 009D","E01018611","Total",771,749,22
"2011","Cheshire East 011A","E01018666","Total",776,715,61
"2011","Cheshire East 011B","E01018667","Total",801,727,74
"2011","Cheshire East 011C","E01018668","Total",687,651,36
"2011","Cheshire East 010A","E01018603","Total",520,512,8
"2011","Cheshire East 010B","E01018604","Total",627,617,10
"2011","Cheshire East 010C","E01018606","Total",894,818,76
"2011","Cheshire East 010D","E01018607","Total",534,516,18
"2011","Cheshire East 010E","E01018608","Total",568,551,17
"2011","Cheshire East 012A","E01018572","Total",797,746,51
"2011","Cheshire East 012B","E01018573","Total",719,674,45
"2011","Cheshire East 012C","E01018574","Total",1058,988,70
"2011","Cheshire East 012D","E01018580","Total",710,658,52
"2011","Cheshire East 012E","E01018581","Total",577,558,19
"2011","Cheshire East 013A","E01018575","Total",512,473,39
"2011","Cheshire East 013B","E01018576","Total",954,872,82
"2011","Cheshire East 013C","E01018577","Total",1149,1118,31
"2011","Cheshire East 013D","E01018578","Total",499,486,13
"2011","Cheshire East 013E","E01018579","Total",499,488,11
"2011","Cheshire East 014A","E01018641","Total",505,499,6
"2011","Cheshire East 014B","E01018642","Total",545,535,10
"2011","Cheshire East 014C","E01018643","Total",732,721,11
"2011","Cheshire East 014D","E01018644","Total",676,647,29
"2011","Cheshire East 015A","E01018614","Total",876,829,47
"2011","Cheshire East 015B","E01018618","Total",624,601,23
"2011","Cheshire East 015C","E01018619","Total",578,570,8
"2011","Cheshire East 015D","E01018620","Total",593,580,13
"2011","Cheshire East 015E","E01018621","Total",573,560,13
"2011","Cheshire East 016A","E01018626","Total",1146,1064,82
"2011","Cheshire East 016B","E01018628","Total",666,652,14
"2011","Cheshire East 016C","E01018629","Total",873,842,31
"2011","Cheshire East 016D","E01018630","Total",651,629,22
"2011","Cheshire East 016E","E01018631","Total",725,714,11
"2011","Cheshire East 017A","E01018615","Total",546,515,31
"2011","Cheshire East 017B","E01018616","Total",519,508,11
"2011","Cheshire East 017C","E01018617","Total",716,692,24
"2011","Cheshire East 017D","E01018632","Total",676,661,15
"2011","Cheshire East 017E","E01018633","Total",630,616,14
"2011","Cheshire East 018A","E01018622","Total",786,732,54
"2011","Cheshire East 018B","E01018623","Total",739,699,40
"2011","Cheshire East 018C","E01018624","Total",1108,996,112
"2011","Cheshire East 018D","E01018625","Total",688,657,31
"2011","Cheshire East 018E","E01018627","Total",892,817,75
"2011","Cheshire East 018F","E01018635","Total",620,589,31
"2011","Cheshire East 018G","E01018636","Total",594,589,5
"2011","Cheshire East 019A","E01018634","Total",778,766,12
"2011","Cheshire East 019B","E01018645","Total",920,887,33
"2011","Cheshire East 019C","E01018646","Total",738,733,5
"2011","Cheshire East 019D","E01018647","Total",685,672,13
"2011","Cheshire East 020A","E01018591","Total",1073,1029,44
"2011","Cheshire East 020B","E01018597","Total",1075,1026,49
"2011","Cheshire East 020C","E01018669","Total",1159,1104,55
"2011","Cheshire East 020D","E01018670","Total",1084,1029,55
"2011","Cheshire East 021A","E01018637","Total",702,693,9
"2011","Cheshire East 021B","E01018638","Total",688,674,14
"2011","Cheshire East 021C","E01018639","Total",727,674,53
"2011","Cheshire East 021D","E01018640","Total",641,624,17
"2011","Cheshire West and Chester 022A","E01018308","Total",828,782,46
"2011","Cheshire West and Chester 022B","E01018336","Total",533,525,8
"2011","Cheshire West and Chester 022C","E01018337","Total",567,555,12
"2011","Cheshire West and Chester 022D","E01018338","Total",796,779,17
"2011","Cheshire West and Chester 022E","E01018358","Total",485,475,10
"2011","Cheshire West and Chester 022F","E01018359","Total",425,415,10
"2011","Cheshire West and Chester 025A","E01018360","Total",829,771,58
"2011","Cheshire West and Chester 025B","E01018366","Total",661,647,14
"2011","Cheshire West and Chester 025C","E01018367","Total",820,793,27
"2011","Cheshire West and Chester 027A","E01018364","Total",765,755,10
"2011","Cheshire West and Chester 027B","E01018365","Total",896,857,39
"2011","Cheshire West and Chester 027C","E01018378","Total",541,524,17
"2011","Cheshire West and Chester 027D","E01018379","Total",625,605,20
"2011","Cheshire West and Chester 027E","E01018380","Total",530,513,17
"2011","Cheshire West and Chester 028A","E01018362","Total",658,635,23
"2011","Cheshire West and Chester 028B","E01018363","Total",492,479,13
"2011","Cheshire West and Chester 028C","E01018374","Total",832,785,47
"2011","Cheshire West and Chester 028D","E01018375","Total",860,802,58
"2011","Cheshire West and Chester 028E","E01018376","Total",655,630,25
"2011","Cheshire West and Chester 028F","E01018377","Total",715,659,56
"2011","Cheshire West and Chester 029A","E01018309","Total",675,657,18
"2011","Cheshire West and Chester 029B","E01018310","Total",657,598,59
"2011","Cheshire West and Chester 029C","E01018311","Total",670,649,21
"2011","Cheshire West and Chester 029D","E01018312","Total",615,584,31
"2011","Cheshire West and Chester 031A","E01018313","Total",609,581,28
"2011","Cheshire West and Chester 031B","E01018314","Total",731,699,32
"2011","Cheshire West and Chester 031C","E01018315","Total",501,490,11
"2011","Cheshire West and Chester 031D","E01018316","Total",604,589,15
"2011","Cheshire West and Chester 031E","E01018317","Total",781,744,37
"2011","Cheshire West and Chester 030A","E01018349","Total",700,677,23
"2011","Cheshire West and Chester 030B","E01018350","Total",806,790,16
"2011","Cheshire West and Chester 030C","E01018368","Total",622,602,20
"2011","Cheshire West and Chester 030D","E01018370","Total",553,534,19
"2011","Cheshire West and Chester 032A","E01018345","Total",526,512,14
"2011","Cheshire West and Chester 032B","E01018346","Total",559,542,17
"2011","Cheshire West and Chester 032C","E01018347","Total",620,612,8
"2011","Cheshire West and Chester 032D","E01018383","Total",612,601,11
"2011","Cheshire West and Chester 032E","E01018384","Total",631,621,10
"2011","Cheshire West and Chester 033B","E01018327","Total",1249,1176,73
"2011","Cheshire West and Chester 033C","E01018343","Total",842,786,56
"2011","Cheshire West and Chester 033D","E01018361","Total",639,609,30
"2011","Cheshire West and Chester 033E","E01032930","Total",1224,1122,102
"2011","Cheshire West and Chester 033F","E01032931","Total",664,581,83
"2011","Cheshire West and Chester 034A","E01018326","Total",1512,1175,337
"2011","Cheshire West and Chester 034B","E01018328","Total",563,466,97
"2011","Cheshire West and Chester 034C","E01018329","Total",1231,1055,176
"2011","Cheshire West and Chester 034D","E01018330","Total",489,459,30
"2011","Cheshire West and Chester 034E","E01018331","Total",771,714,57
"2011","Cheshire West and Chester 036A","E01018319","Total",1073,993,80
"2011","Cheshire West and Chester 036B","E01018344","Total",961,919,42
"2011","Cheshire West and Chester 036C","E01018381","Total",536,517,19
"2011","Cheshire West and Chester 036D","E01018382","Total",840,788,52
"2011","Cheshire West and Chester 039A","E01018323","Total",590,562,28
"2011","Cheshire West and Chester 039B","E01018324","Total",552,532,20
"2011","Cheshire West and Chester 039C","E01018325","Total",594,586,8
"2011","Cheshire West and Chester 039D","E01018385","Total",880,855,25
"2011","Cheshire West and Chester 041A","E01018320","Total",630,616,14
"2011","Cheshire West and Chester 041B","E01018321","Total",553,531,22
"2011","Cheshire West and Chester 041C","E01018322","Total",523,506,17
"2011","Cheshire West and Chester 041D","E01018348","Total",919,894,25
"2011","Cheshire West and Chester 043A","E01018332","Total",491,476,15
"2011","Cheshire West and Chester 043B","E01018333","Total",695,663,32
"2011","Cheshire West and Chester 043C","E01018334","Total",676,651,25
"2011","Cheshire West and Chester 043D","E01018340","Total",693,659,34
"2011","Cheshire West and Chester 043E","E01018341","Total",525,517,8
"2011","Cheshire West and Chester 043F","E01018342","Total",952,866,86
"2011","Cheshire West and Chester 044A","E01018351","Total",686,656,30
"2011","Cheshire West and Chester 044B","E01018352","Total",876,844,32
"2011","Cheshire West and Chester 044C","E01018353","Total",643,628,15
"2011","Cheshire West and Chester 044D","E01018354","Total",666,648,18
"2011","Cheshire West and Chester 046A","E01018335","Total",915,874,41
"2011","Cheshire West and Chester 046B","E01018369","Total",627,606,21
"2011","Cheshire West and Chester 046C","E01018371","Total",784,760,24
"2011","Cheshire West and Chester 046D","E01018372","Total",865,821,44
"2011","Cheshire West and Chester 047A","E01018339","Total",928,893,35
"2011","Cheshire West and Chester 047B","E01018355","Total",608,571,37
"2011","Cheshire West and Chester 047C","E01018356","Total",615,599,16
"2011","Cheshire West and Chester 047D","E01018357","Total",555,539,16
"2011","Cheshire West and Chester 047E","E01018373","Total",891,843,48
"2011","Cheshire West and Chester 001A","E01018534","Total",1283,1195,88
"2011","Cheshire West and Chester 001B","E01018535","Total",657,628,29
"2011","Cheshire West and Chester 001C","E01018536","Total",778,743,35
"2011","Cheshire West and Chester 001D","E01018537","Total",949,896,53
"2011","Cheshire West and Chester 004A","E01018518","Total",708,671,37
"2011","Cheshire West and Chester 004B","E01018569","Total",558,545,13
"2011","Cheshire West and Chester 004C","E01018570","Total",551,521,30
"2011","Cheshire West and Chester 004D","E01018571","Total",668,630,38
"2011","Cheshire West and Chester 005A","E01018546","Total",682,646,36
"2011","Cheshire West and Chester 005B","E01018547","Total",643,608,35
"2011","Cheshire West and Chester 005C","E01018548","Total",721,702,19
"2011","Cheshire West and Chester 005D","E01018549","Total",691,656,35
"2011","Cheshire West and Chester 006A","E01018532","Total",893,853,40
"2011","Cheshire West and Chester 006B","E01018533","Total",645,623,22
"2011","Cheshire West and Chester 006C","E01018544","Total",653,645,8
"2011","Cheshire West and Chester 006D","E01018545","Total",851,827,24
"2011","Cheshire West and Chester 007A","E01018519","Total",722,670,52
"2011","Cheshire West and Chester 007B","E01018520","Total",537,492,45
"2011","Cheshire West and Chester 007C","E01018525","Total",534,525,9
"2011","Cheshire West and Chester 007D","E01018563","Total",1077,1040,37
"2011","Cheshire West and Chester 007E","E01018564","Total",1244,1119,125
"2011","Cheshire West and Chester 008A","E01018523","Total",628,600,28
"2011","Cheshire West and Chester 008B","E01018524","Total",620,604,16
"2011","Cheshire West and Chester 008C","E01018541","Total",660,626,34
"2011","Cheshire West and Chester 008D","E01018542","Total",511,494,17
"2011","Cheshire West and Chester 008E","E01018543","Total",632,604,28
"2011","Cheshire West and Chester 009A","E01018528","Total",510,496,14
"2011","Cheshire West and Chester 009B","E01018529","Total",657,648,9
"2011","Cheshire West and Chester 009C","E01018530","Total",578,563,15
"2011","Cheshire West and Chester 009D","E01018531","Total",711,667,44
"2011","Cheshire West and Chester 009E","E01018560","Total",483,471,12
"2011","Cheshire West and Chester 009F","E01018561","Total",482,475,7
"2011","Cheshire West and Chester 009G","E01018562","Total",532,524,8
"2011","Cheshire West and Chester 010A","E01018522","Total",634,591,43
"2011","Cheshire West and Chester 010B","E01018538","Total",474,451,23
"2011","Cheshire West and Chester 010C","E01018539","Total",525,482,43
"2011","Cheshire West and Chester 010D","E01018540","Total",627,611,16
"2011","Cheshire West and Chester 011A","E01018521","Total",504,501,3
"2011","Cheshire West and Chester 011B","E01018550","Total",513,481,32
"2011","Cheshire West and Chester 011C","E01018551","Total",720,694,26
"2011","Cheshire West and Chester 011D","E01018552","Total",654,641,13
"2011","Cheshire West and Chester 011E","E01018553","Total",704,686,18
"2011","Cheshire West and Chester 013A","E01018556","Total",643,635,8
"2011","Cheshire West and Chester 013B","E01018557","Total",682,662,20
"2011","Cheshire West and Chester 013C","E01018558","Total",506,500,6
"2011","Cheshire West and Chester 013D","E01018559","Total",472,468,4
"2011","Cheshire West and Chester 014A","E01018565","Total",650,618,32
"2011","Cheshire West and Chester 014B","E01018566","Total",612,592,20
"2011","Cheshire West and Chester 014C","E01018567","Total",621,590,31
"2011","Cheshire West and Chester 014D","E01018568","Total",586,575,11
"2011","Cheshire West and Chester 016A","E01018526","Total",681,666,15
"2011","Cheshire West and Chester 016B","E01018527","Total",668,654,14
"2011","Cheshire West and Chester 016C","E01018554","Total",1010,993,17
"2011","Cheshire West and Chester 016D","E01018555","Total",487,479,8
"2011","Cheshire West and Chester 002A","E01018685","Total",610,601,9
"2011","Cheshire West and Chester 002B","E01018686","Total",625,603,22
"2011","Cheshire West and Chester 002C","E01018687","Total",597,585,12
"2011","Cheshire West and Chester 002D","E01018688","Total",732,692,40
"2011","Cheshire West and Chester 002E","E01018689","Total",700,676,24
"2011","Cheshire West and Chester 002F","E01018690","Total",910,868,42
"2011","Cheshire West and Chester 003A","E01018675","Total",893,871,22
"2011","Cheshire West and Chester 003B","E01018708","Total",949,889,60
"2011","Cheshire West and Chester 003C","E01018721","Total",957,921,36
"2011","Cheshire West and Chester 012A","E01018671","Total",525,513,12
"2011","Cheshire West and Chester 012B","E01018672","Total",686,667,19
"2011","Cheshire West and Chester 012C","E01018673","Total",534,522,12
"2011","Cheshire West and Chester 012D","E01018674","Total",720,691,29
"2011","Cheshire West and Chester 015A","E01018684","Total",998,927,71
"2011","Cheshire West and Chester 015B","E01018695","Total",769,738,31
"2011","Cheshire West and Chester 015C","E01018696","Total",645,626,19
"2011","Cheshire West and Chester 015D","E01018697","Total",825,779,46
"2011","Cheshire West and Chester 015E","E01018698","Total",841,814,27
"2011","Cheshire West and Chester 017A","E01018704","Total",552,541,11
"2011","Cheshire West and Chester 017B","E01018705","Total",635,620,15
"2011","Cheshire West and Chester 017C","E01018706","Total",541,526,15
"2011","Cheshire West and Chester 017D","E01018718","Total",678,671,7
"2011","Cheshire West and Chester 017E","E01018722","Total",1009,941,68
"2011","Cheshire West and Chester 018A","E01018713","Total",1183,1144,39
"2011","Cheshire West and Chester 018B","E01018714","Total",953,890,63
"2011","Cheshire West and Chester 018C","E01018715","Total",818,766,52
"2011","Cheshire West and Chester 019A","E01018726","Total",623,613,10
"2011","Cheshire West and Chester 019B","E01018727","Total",791,749,42
"2011","Cheshire West and Chester 019C","E01018728","Total",656,636,20
"2011","Cheshire West and Chester 019D","E01018729","Total",772,757,15
"2011","Cheshire West and Chester 020A","E01018709","Total",694,669,25
"2011","Cheshire West and Chester 020B","E01018710","Total",596,579,17
"2011","Cheshire West and Chester 020C","E01018711","Total",761,730,31
"2011","Cheshire West and Chester 020D","E01018712","Total",778,752,26
"2011","Cheshire West and Chester 021A","E01018699","Total",668,653,15
"2011","Cheshire West and Chester 021B","E01018701","Total",628,622,6
"2011","Cheshire West and Chester 021C","E01018716","Total",654,641,13
"2011","Cheshire West and Chester 021D","E01018717","Total",787,766,21
"2011","Cheshire West and Chester 021E","E01018719","Total",652,639,13
"2011","Cheshire West and Chester 021F","E01018720","Total",674,668,6
"2011","Cheshire West and Chester 023A","E01018691","Total",740,700,40
"2011","Cheshire West and Chester 023B","E01018693","Total",641,626,15
"2011","Cheshire West and Chester 023C","E01018694","Total",669,635,34
"2011","Cheshire West and Chester 023D","E01018700","Total",766,761,5
"2011","Cheshire West and Chester 023E","E01018702","Total",483,481,2
"2011","Cheshire West and Chester 023F","E01018703","Total",864,828,36
"2011","Cheshire West and Chester 024A","E01018676","Total",670,642,28
"2011","Cheshire West and Chester 024B","E01018677","Total",669,648,21
"2011","Cheshire West and Chester 024C","E01018678","Total",526,510,16
"2011","Cheshire West and Chester 024D","E01018679","Total",749,725,24
"2011","Cheshire West and Chester 024E","E01018692","Total",875,793,82
"2011","Cheshire West and Chester 026A","E01018680","Total",669,647,22
"2011","Cheshire West and Chester 026B","E01018681","Total",647,627,20
"2011","Cheshire West and Chester 026C","E01018682","Total",508,491,17
"2011","Cheshire West and Chester 026D","E01018683","Total",661,643,18
"2011","Cheshire West and Chester 035A","E01018733","Total",623,611,12
"2011","Cheshire West and Chester 035B","E01018734","Total",545,530,15
"2011","Cheshire West and Chester 035C","E01018748","Total",536,507,29
"2011","Cheshire West and Chester 035D","E01018749","Total",973,951,22
"2011","Cheshire West and Chester 037A","E01018736","Total",680,657,23
"2011","Cheshire West and Chester 037B","E01018737","Total",550,534,16
"2011","Cheshire West and Chester 037C","E01018743","Total",633,625,8
"2011","Cheshire West and Chester 037D","E01018744","Total",687,680,7
"2011","Cheshire West and Chester 038A","E01018732","Total",581,554,27
"2011","Cheshire West and Chester 038B","E01018745","Total",737,708,29
"2011","Cheshire West and Chester 038C","E01018746","Total",731,708,23
"2011","Cheshire West and Chester 038D","E01018747","Total",688,657,31
"2011","Cheshire West and Chester 040A","E01018730","Total",648,635,13
"2011","Cheshire West and Chester 040B","E01018738","Total",591,560,31
"2011","Cheshire West and Chester 040C","E01018739","Total",602,575,27
"2011","Cheshire West and Chester 040D","E01018741","Total",538,527,11
"2011","Cheshire West and Chester 042A","E01018731","Total",708,676,32
"2011","Cheshire West and Chester 042B","E01018735","Total",557,540,17
"2011","Cheshire West and Chester 042C","E01018740","Total",624,608,16
"2011","Cheshire West and Chester 042D","E01018742","Total",646,630,16
"2011","Cheshire West and Chester 045A","E01018707","Total",767,736,31
"2011","Cheshire West and Chester 045B","E01018723","Total",531,510,21
"2011","Cheshire West and Chester 045C","E01018724","Total",705,666,39
"2011","Cheshire West and Chester 045D","E01018725","Total",576,543,33
"2011","Halton 001A","E01012392","Total",929,910,19
"2011","Halton 001B","E01012393","Total",900,865,35
"2011","Halton 001C","E01012395","Total",630,620,10
"2011","Halton 001D","E01012411","Total",618,591,27
"2011","Halton 002A","E01012374","Total",1103,1075,28
"2011","Halton 002B","E01012375","Total",566,559,7
"2011","Halton 002C","E01012376","Total",940,922,18
"2011","Halton 002D","E01012421","Total",540,536,4
"2011","Halton 002E","E01012423","Total",653,640,13
"2011","Halton 003A","E01012368","Total",880,849,31
"2011","Halton 003B","E01012410","Total",538,533,5
"2011","Halton 003C","E01012412","Total",722,684,38
"2011","Halton 003D","E01012413","Total",680,663,17
"2011","Halton 003E","E01012414","Total",511,504,7
"2011","Halton 004A","E01012377","Total",756,745,11
"2011","Halton 004B","E01012390","Total",692,678,14
"2011","Halton 004C","E01012419","Total",497,486,11
"2011","Halton 004D","E01012420","Total",767,746,21
"2011","Halton 004E","E01012422","Total",652,632,20
"2011","Halton 005A","E01012369","Total",633,619,14
"2011","Halton 005B","E01012394","Total",715,675,40
"2011","Halton 005C","E01012425","Total",710,692,18
"2011","Halton 005D","E01012426","Total",583,572,11
"2011","Halton 005E","E01012427","Total",658,649,9
"2011","Halton 006A","E01012378","Total",650,640,10
"2011","Halton 006B","E01012379","Total",658,634,24
"2011","Halton 006C","E01012380","Total",582,571,11
"2011","Halton 006D","E01012388","Total",754,730,24
"2011","Halton 006E","E01012442","Total",624,618,6
"2011","Halton 007A","E01012367","Total",809,776,33
"2011","Halton 007B","E01012370","Total",858,811,47
"2011","Halton 007C","E01012424","Total",781,761,20
"2011","Halton 007D","E01012441","Total",1153,1078,75
"2011","Halton 008A","E01012389","Total",752,745,7
"2011","Halton 008B","E01012391","Total",1041,975,66
"2011","Halton 008C","E01012401","Total",816,787,29
"2011","Halton 008D","E01012443","Total",612,601,11
"2011","Halton 009A","E01012385","Total",604,575,29
"2011","Halton 009B","E01012386","Total",676,661,15
"2011","Halton 009C","E01012387","Total",526,507,19
"2011","Halton 009D","E01012434","Total",613,601,12
"2011","Halton 009E","E01012435","Total",784,759,25
"2011","Halton 010A","E01012381","Total",667,656,11
"2011","Halton 010B","E01012382","Total",717,709,8
"2011","Halton 010C","E01012384","Total",767,748,19
"2011","Halton 010D","E01012444","Total",430,427,3
"2011","Halton 010E","E01012445","Total",560,553,7
"2011","Halton 011A","E01012398","Total",521,513,8
"2011","Halton 011B","E01012400","Total",522,507,15
"2011","Halton 011C","E01012402","Total",660,656,4
"2011","Halton 011D","E01012404","Total",587,577,10
"2011","Halton 011E","E01012405","Total",855,836,19
"2011","Halton 012A","E01012416","Total",801,774,27
"2011","Halton 012B","E01012417","Total",591,577,14
"2011","Halton 012C","E01012428","Total",1065,1024,41
"2011","Halton 012D","E01012429","Total",640,627,13
"2011","Halton 012E","E01012430","Total",925,884,41
"2011","Halton 012F","E01012431","Total",1079,1011,68
"2011","Halton 013A","E01012383","Total",768,756,12
"2011","Halton 013B","E01012396","Total",607,600,7
"2011","Halton 013C","E01012397","Total",694,679,15
"2011","Halton 013D","E01012399","Total",649,639,10
"2011","Halton 013E","E01012403","Total",652,647,5
"2011","Halton 013F","E01012408","Total",759,739,20
"2011","Halton 014A","E01012432","Total",679,666,13
"2011","Halton 014B","E01012433","Total",696,690,6
"2011","Halton 014C","E01012436","Total",509,504,5
"2011","Halton 014D","E01012438","Total",537,535,2
"2011","Halton 014E","E01012440","Total",535,524,11
"2011","Halton 015A","E01012406","Total",679,673,6
"2011","Halton 015B","E01012407","Total",769,758,11
"2011","Halton 015C","E01012409","Total",647,633,14
"2011","Halton 015D","E01012437","Total",545,539,6
"2011","Halton 015E","E01012439","Total",651,642,9
"2011","Halton 016A","E01012371","Total",530,526,4
"2011","Halton 016B","E01012372","Total",517,507,10
"2011","Halton 016C","E01012373","Total",543,538,5
"2011","Halton 016D","E01012415","Total",547,545,2
"2011","Halton 016E","E01012418","Total",628,618,10
"2011","Warrington 001A","E01012471","Total",539,507,32
"2011","Warrington 001B","E01012472","Total",769,740,29
"2011","Warrington 001C","E01012476","Total",701,668,33
"2011","Warrington 001D","E01012477","Total",621,610,11
"2011","Warrington 002A","E01012473","Total",697,678,19
"2011","Warrington 002B","E01012474","Total",635,611,24
"2011","Warrington 002C","E01012475","Total",676,643,33
"2011","Warrington 002D","E01012554","Total",872,840,32
"2011","Warrington 003A","E01012467","Total",532,522,10
"2011","Warrington 003B","E01012468","Total",959,914,45
"2011","Warrington 003C","E01012469","Total",674,624,50
"2011","Warrington 003D","E01012470","Total",505,497,8
"2011","Warrington 004A","E01012460","Total",644,629,15
"2011","Warrington 004B","E01012462","Total",663,633,30
"2011","Warrington 004C","E01012463","Total",516,506,10
"2011","Warrington 004D","E01012464","Total",612,599,13
"2011","Warrington 005A","E01012459","Total",636,622,14
"2011","Warrington 005B","E01012461","Total",549,535,14
"2011","Warrington 005C","E01012465","Total",630,608,22
"2011","Warrington 005D","E01012466","Total",717,707,10
"2011","Warrington 006A","E01012526","Total",672,654,18
"2011","Warrington 006B","E01012534","Total",674,655,19
"2011","Warrington 006C","E01012535","Total",721,701,20
"2011","Warrington 006D","E01012537","Total",720,702,18
"2011","Warrington 006E","E01012539","Total",712,697,15
"2011","Warrington 007A","E01012538","Total",626,619,7
"2011","Warrington 007B","E01012540","Total",598,587,11
"2011","Warrington 007C","E01012541","Total",525,516,9
"2011","Warrington 007D","E01012542","Total",645,633,12
"2011","Warrington 007E","E01012543","Total",608,595,13
"2011","Warrington 007F","E01012544","Total",597,588,9
"2011","Warrington 008A","E01012521","Total",668,654,14
"2011","Warrington 008B","E01012522","Total",628,613,15
"2011","Warrington 008C","E01012533","Total",561,554,7
"2011","Warrington 008D","E01012536","Total",653,631,22
"2011","Warrington 008E","E01012545","Total",710,703,7
"2011","Warrington 008F","E01012546","Total",687,682,5
"2011","Warrington 009A","E01012561","Total",694,678,16
"2011","Warrington 009B","E01012562","Total",622,610,12
"2011","Warrington 009C","E01012567","Total",649,641,8
"2011","Warrington 009D","E01012568","Total",1014,963,51
"2011","Warrington 010A","E01012563","Total",644,635,9
"2011","Warrington 010B","E01012564","Total",536,526,10
"2011","Warrington 010C","E01012565","Total",947,932,15
"2011","Warrington 010D","E01012566","Total",743,729,14
"2011","Warrington 010E","E01012569","Total",719,703,16
"2011","Warrington 010F","E01012570","Total",619,604,15
"2011","Warrington 011A","E01012481","Total",738,714,24
"2011","Warrington 011B","E01012482","Total",894,869,25
"2011","Warrington 011C","E01012520","Total",665,638,27
"2011","Warrington 011D","E01012523","Total",656,621,35
"2011","Warrington 011E","E01012524","Total",644,627,17
"2011","Warrington 011F","E01012525","Total",667,635,32
"2011","Warrington 012A","E01012478","Total",636,617,19
"2011","Warrington 012B","E01012547","Total",701,682,19
"2011","Warrington 012C","E01012548","Total",712,703,9
"2011","Warrington 012D","E01012549","Total",652,639,13
"2011","Warrington 012E","E01012550","Total",721,702,19
"2011","Warrington 013A","E01012453","Total",668,654,14
"2011","Warrington 013B","E01012454","Total",932,859,73
"2011","Warrington 013C","E01012455","Total",908,876,32
"2011","Warrington 013D","E01012457","Total",827,777,50
"2011","Warrington 014A","E01012551","Total",605,598,7
"2011","Warrington 014B","E01012552","Total",641,619,22
"2011","Warrington 014C","E01012553","Total",505,499,6
"2011","Warrington 014D","E01012555","Total",536,525,11
"2011","Warrington 014E","E01012556","Total",645,621,24
"2011","Warrington 015A","E01012491","Total",629,621,8
"2011","Warrington 015B","E01012492","Total",616,609,7
"2011","Warrington 015C","E01012493","Total",675,669,6
"2011","Warrington 015D","E01012494","Total",657,649,8
"2011","Warrington 015E","E01012500","Total",609,593,16
"2011","Warrington 016A","E01012495","Total",662,643,19
"2011","Warrington 016B","E01012496","Total",601,585,16
"2011","Warrington 016C","E01012497","Total",527,516,11
"2011","Warrington 016D","E01012498","Total",675,656,19
"2011","Warrington 016E","E01012499","Total",748,739,9
"2011","Warrington 016F","E01012501","Total",618,603,15
"2011","Warrington 017A","E01012479","Total",818,793,25
"2011","Warrington 017B","E01012480","Total",962,921,41
"2011","Warrington 017D","E01012510","Total",902,868,34
"2011","Warrington 017E","E01012511","Total",811,786,25
"2011","Warrington 017F","E01033299","Total",1017,971,46
"2011","Warrington 017G","E01033303","Total",630,591,39
"2011","Warrington 018B","E01012458","Total",1064,1011,53
"2011","Warrington 018C","E01012483","Total",933,883,50
"2011","Warrington 018D","E01012509","Total",921,882,39
"2011","Warrington 018E","E01012512","Total",763,739,24
"2011","Warrington 018F","E01033300","Total",717,613,104
"2011","Warrington 018G","E01033302","Total",785,740,45
"2011","Warrington 019A","E01012527","Total",648,622,26
"2011","Warrington 019B","E01012528","Total",510,500,10
"2011","Warrington 019C","E01012529","Total",620,599,21
"2011","Warrington 019D","E01012530","Total",542,529,13
"2011","Warrington 019E","E01012531","Total",688,675,13
"2011","Warrington 019F","E01012532","Total",616,601,15
"2011","Warrington 020A","E01012504","Total",803,753,50
"2011","Warrington 020B","E01012505","Total",666,652,14
"2011","Warrington 020C","E01012506","Total",695,668,27
"2011","Warrington 020D","E01012507","Total",1004,943,61
"2011","Warrington 020E","E01012508","Total",736,715,21
"2011","Warrington 021A","E01012513","Total",825,805,20
"2011","Warrington 021B","E01012514","Total",758,737,21
"2011","Warrington 021C","E01012515","Total",680,659,21
"2011","Warrington 021D","E01012516","Total",620,589,31
"2011","Warrington 021E","E01012517","Total",925,900,25
"2011","Warrington 021F","E01012518","Total",885,846,39
"2011","Warrington 021G","E01012519","Total",648,635,13
"2011","Warrington 022A","E01012485","Total",671,660,11
"2011","Warrington 022B","E01012486","Total",660,631,29
"2011","Warrington 022C","E01012487","Total",675,652,23
"2011","Warrington 022D","E01012489","Total",705,681,24
"2011","Warrington 022E","E01012490","Total",656,629,27
"2011","Warrington 023A","E01012450","Total",654,633,21
"2011","Warrington 023B","E01012451","Total",660,648,12
"2011","Warrington 023C","E01012557","Total",786,755,31
"2011","Warrington 023D","E01012558","Total",790,749,41
"2011","Warrington 023E","E01012559","Total",608,593,15
"2011","Warrington 023F","E01012560","Total",646,631,15
"2011","Warrington 024A","E01012448","Total",511,498,13
"2011","Warrington 024B","E01012488","Total",746,716,30
"2011","Warrington 024C","E01012502","Total",659,629,30
"2011","Warrington 024D","E01012503","Total",584,559,25
"2011","Warrington 025A","E01012446","Total",531,527,4
"2011","Warrington 025B","E01012447","Total",498,494,4
"2011","Warrington 025C","E01012449","Total",662,641,21
"2011","Warrington 025D","E01012452","Total",759,732,27
"2011","Allerdale 001A","E01019126","Total",818,755,63
"2011","Allerdale 001B","E01019127","Total",757,707,50
"2011","Allerdale 001C","E01019132","Total",755,728,27
"2011","Allerdale 001D","E01019134","Total",686,670,16
"2011","Allerdale 001E","E01019135","Total",694,676,18
"2011","Allerdale 001F","E01019136","Total",671,648,23
"2011","Allerdale 001G","E01019137","Total",594,521,73
"2011","Allerdale 002A","E01019083","Total",930,784,146
"2011","Allerdale 002B","E01019107","Total",736,683,53
"2011","Allerdale 002C","E01019130","Total",726,697,29
"2011","Allerdale 002D","E01019131","Total",875,781,94
"2011","Allerdale 003A","E01019081","Total",881,825,56
"2011","Allerdale 003B","E01019082","Total",729,677,52
"2011","Allerdale 003C","E01019102","Total",832,734,98
"2011","Allerdale 003D","E01019128","Total",720,681,39
"2011","Allerdale 003E","E01019133","Total",719,663,56
"2011","Allerdale 004A","E01019093","Total",667,646,21
"2011","Allerdale 004B","E01019094","Total",750,721,29
"2011","Allerdale 004C","E01019096","Total",1008,979,29
"2011","Allerdale 004D","E01019114","Total",669,625,44
"2011","Allerdale 004E","E01019115","Total",849,784,65
"2011","Allerdale 005A","E01019095","Total",707,680,27
"2011","Allerdale 005B","E01019097","Total",791,758,33
"2011","Allerdale 005C","E01019098","Total",736,711,25
"2011","Allerdale 005D","E01019099","Total",780,749,31
"2011","Allerdale 006A","E01019084","Total",676,653,23
"2011","Allerdale 006B","E01019085","Total",656,616,40
"2011","Allerdale 006C","E01019086","Total",504,460,44
"2011","Allerdale 006D","E01019088","Total",1070,949,121
"2011","Allerdale 006E","E01019091","Total",830,776,54
"2011","Allerdale 007A","E01019078","Total",685,659,26
"2011","Allerdale 007B","E01019079","Total",654,645,9
"2011","Allerdale 007C","E01019080","Total",898,835,63
"2011","Allerdale 007D","E01019087","Total",727,699,28
"2011","Allerdale 007E","E01019090","Total",824,675,149
"2011","Allerdale 008A","E01019116","Total",670,611,59
"2011","Allerdale 008B","E01019118","Total",701,661,40
"2011","Allerdale 008C","E01019122","Total",693,668,25
"2011","Allerdale 008D","E01019123","Total",677,667,10
"2011","Allerdale 008E","E01019124","Total",856,840,16
"2011","Allerdale 008F","E01019125","Total",710,694,16
"2011","Allerdale 009A","E01019111","Total",700,687,13
"2011","Allerdale 009B","E01019112","Total",771,760,11
"2011","Allerdale 009C","E01019113","Total",847,837,10
"2011","Allerdale 009D","E01019120","Total",840,812,28
"2011","Allerdale 009E","E01019121","Total",1109,1036,73
"2011","Allerdale 010A","E01019108","Total",644,629,15
"2011","Allerdale 010B","E01019109","Total",767,752,15
"2011","Allerdale 010C","E01019110","Total",876,865,11
"2011","Allerdale 010D","E01019117","Total",597,579,18
"2011","Allerdale 010E","E01019119","Total",646,636,10
"2011","Allerdale 011A","E01019089","Total",737,710,27
"2011","Allerdale 011B","E01019100","Total",750,718,32
"2011","Allerdale 011C","E01019101","Total",628,619,9
"2011","Allerdale 011D","E01019129","Total",723,702,21
"2011","Allerdale 012A","E01019092","Total",906,642,264
"2011","Allerdale 012B","E01019103","Total",604,516,88
"2011","Allerdale 012C","E01019104","Total",910,699,211
"2011","Allerdale 012D","E01019105","Total",697,525,172
"2011","Allerdale 012E","E01019106","Total",775,630,145
"2011","Barrow-in-Furness 001A","E01019144","Total",623,590,33
"2011","Barrow-in-Furness 001B","E01019145","Total",898,837,61
"2011","Barrow-in-Furness 001C","E01019146","Total",617,583,34
"2011","Barrow-in-Furness 001D","E01019147","Total",728,670,58
"2011","Barrow-in-Furness 002A","E01019148","Total",621,603,18
"2011","Barrow-in-Furness 002B","E01019149","Total",710,653,57
"2011","Barrow-in-Furness 002C","E01019150","Total",776,739,37
"2011","Barrow-in-Furness 002D","E01019151","Total",639,623,16
"2011","Barrow-in-Furness 003A","E01019152","Total",490,461,29
"2011","Barrow-in-Furness 003B","E01019153","Total",473,460,13
"2011","Barrow-in-Furness 003C","E01019154","Total",641,615,26
"2011","Barrow-in-Furness 003D","E01019155","Total",707,680,27
"2011","Barrow-in-Furness 003E","E01019162","Total",651,630,21
"2011","Barrow-in-Furness 003F","E01019163","Total",525,504,21
"2011","Barrow-in-Furness 004A","E01019156","Total",809,766,43
"2011","Barrow-in-Furness 004B","E01019159","Total",539,505,34
"2011","Barrow-in-Furness 004C","E01019164","Total",635,609,26
"2011","Barrow-in-Furness 004D","E01019165","Total",684,659,25
"2011","Barrow-in-Furness 004E","E01019166","Total",675,650,25
"2011","Barrow-in-Furness 005A","E01019167","Total",759,723,36
"2011","Barrow-in-Furness 005B","E01019168","Total",629,613,16
"2011","Barrow-in-Furness 005C","E01019169","Total",530,515,15
"2011","Barrow-in-Furness 005D","E01019170","Total",527,506,21
"2011","Barrow-in-Furness 005E","E01019171","Total",675,633,42
"2011","Barrow-in-Furness 006A","E01019161","Total",726,694,32
"2011","Barrow-in-Furness 006B","E01019176","Total",729,708,21
"2011","Barrow-in-Furness 006C","E01019177","Total",613,598,15
"2011","Barrow-in-Furness 006D","E01019178","Total",758,704,54
"2011","Barrow-in-Furness 006E","E01019179","Total",535,520,15
"2011","Barrow-in-Furness 007A","E01019140","Total",512,483,29
"2011","Barrow-in-Furness 007B","E01019160","Total",634,617,17
"2011","Barrow-in-Furness 007C","E01019172","Total",678,641,37
"2011","Barrow-in-Furness 007D","E01019173","Total",656,619,37
"2011","Barrow-in-Furness 007E","E01019174","Total",491,472,19
"2011","Barrow-in-Furness 007F","E01019175","Total",615,594,21
"2011","Barrow-in-Furness 008A","E01019141","Total",741,692,49
"2011","Barrow-in-Furness 008B","E01019142","Total",755,701,54
"2011","Barrow-in-Furness 008C","E01019143","Total",805,718,87
"2011","Barrow-in-Furness 008D","E01019157","Total",825,743,82
"2011","Barrow-in-Furness 008E","E01019158","Total",622,568,54
"2011","Barrow-in-Furness 009A","E01019180","Total",981,942,39
"2011","Barrow-in-Furness 009C","E01019182","Total",659,625,34
"2011","Barrow-in-Furness 009E","E01019184","Total",672,633,39
"2011","Barrow-in-Furness 009F","E01033160","Total",906,888,18
"2011","Barrow-in-Furness 010A","E01019138","Total",643,609,34
"2011","Barrow-in-Furness 010B","E01019139","Total",1103,856,247
"2011","Barrow-in-Furness 010C","E01019185","Total",636,614,22
"2011","Barrow-in-Furness 010D","E01019186","Total",632,601,31
"2011","Barrow-in-Furness 010E","E01019187","Total",570,557,13
"2011","Carlisle 001A","E01019226","Total",500,481,19
"2011","Carlisle 001B","E01019227","Total",695,674,21
"2011","Carlisle 001C","E01019228","Total",693,658,35
"2011","Carlisle 001D","E01019229","Total",879,816,63
"2011","Carlisle 002A","E01019200","Total",756,727,29
"2011","Carlisle 002B","E01019201","Total",698,668,30
"2011","Carlisle 002C","E01019202","Total",754,710,44
"2011","Carlisle 002D","E01019225","Total",921,843,78
"2011","Carlisle 003A","E01019188","Total",673,651,22
"2011","Carlisle 003B","E01019189","Total",680,666,14
"2011","Carlisle 003C","E01019190","Total",707,693,14
"2011","Carlisle 003D","E01019191","Total",706,689,17
"2011","Carlisle 003E","E01019244","Total",652,636,16
"2011","Carlisle 004A","E01019196","Total",860,837,23
"2011","Carlisle 004B","E01019238","Total",607,595,12
"2011","Carlisle 004C","E01019240","Total",740,715,25
"2011","Carlisle 004D","E01019241","Total",690,679,11
"2011","Carlisle 004E","E01019243","Total",659,637,22
"2011","Carlisle 004F","E01019251","Total",769,754,15
"2011","Carlisle 005A","E01019192","Total",634,621,13
"2011","Carlisle 005B","E01019195","Total",559,551,8
"2011","Carlisle 005C","E01019203","Total",903,871,32
"2011","Carlisle 005D","E01019254","Total",611,601,10
"2011","Carlisle 005E","E01019255","Total",560,553,7
"2011","Carlisle 006A","E01019204","Total",670,618,52
"2011","Carlisle 006B","E01019206","Total",888,785,103
"2011","Carlisle 006C","E01019234","Total",924,899,25
"2011","Carlisle 006D","E01019235","Total",704,674,30
"2011","Carlisle 006E","E01019237","Total",629,610,19
"2011","Carlisle 006F","E01019242","Total",652,615,37
"2011","Carlisle 007A","E01019219","Total",993,940,53
"2011","Carlisle 007B","E01019224","Total",920,897,23
"2011","Carlisle 007C","E01019239","Total",642,623,19
"2011","Carlisle 007D","E01019249","Total",693,672,21
"2011","Carlisle 007E","E01019250","Total",614,588,26
"2011","Carlisle 008A","E01019205","Total",897,834,63
"2011","Carlisle 008B","E01019207","Total",738,689,49
"2011","Carlisle 008C","E01019215","Total",791,742,49
"2011","Carlisle 008D","E01019218","Total",639,617,22
"2011","Carlisle 008E","E01019233","Total",656,637,19
"2011","Carlisle 009A","E01019193","Total",701,662,39
"2011","Carlisle 009B","E01019194","Total",959,864,95
"2011","Carlisle 009C","E01019230","Total",811,799,12
"2011","Carlisle 009D","E01019231","Total",844,826,18
"2011","Carlisle 009E","E01019232","Total",669,651,18
"2011","Carlisle 009F","E01019252","Total",688,673,15
"2011","Carlisle 010A","E01019209","Total",712,683,29
"2011","Carlisle 010B","E01019211","Total",905,850,55
"2011","Carlisle 010C","E01019216","Total",874,848,26
"2011","Carlisle 010D","E01019217","Total",962,915,47
"2011","Carlisle 010E","E01019220","Total",832,708,124
"2011","Carlisle 010F","E01019236","Total",788,752,36
"2011","Carlisle 011A","E01019197","Total",904,887,17
"2011","Carlisle 011B","E01019198","Total",643,637,6
"2011","Carlisle 011C","E01019199","Total",497,494,3
"2011","Carlisle 011D","E01019221","Total",878,862,16
"2011","Carlisle 011E","E01019222","Total",790,734,56
"2011","Carlisle 011F","E01019245","Total",701,666,35
"2011","Carlisle 012A","E01019208","Total",632,624,8
"2011","Carlisle 012B","E01019210","Total",604,588,16
"2011","Carlisle 012C","E01019246","Total",647,621,26
"2011","Carlisle 012D","E01019247","Total",671,656,15
"2011","Carlisle 012E","E01019248","Total",533,518,15
"2011","Carlisle 013A","E01019212","Total",681,640,41
"2011","Carlisle 013B","E01019213","Total",1195,1155,40
"2011","Carlisle 013C","E01019214","Total",849,826,23
"2011","Carlisle 013D","E01019223","Total",725,669,56
"2011","Carlisle 013E","E01019253","Total",778,768,10
"2011","Copeland 001A","E01019268","Total",515,489,26
"2011","Copeland 001B","E01019269","Total",699,680,19
"2011","Copeland 001C","E01019270","Total",622,594,28
"2011","Copeland 001D","E01019297","Total",560,546,14
"2011","Copeland 002A","E01019260","Total",657,635,22
"2011","Copeland 002B","E01019280","Total",1144,1030,114
"2011","Copeland 002C","E01019281","Total",604,569,35
"2011","Copeland 002D","E01019282","Total",515,501,14
"2011","Copeland 003A","E01019261","Total",707,686,21
"2011","Copeland 003B","E01019262","Total",743,726,17
"2011","Copeland 003C","E01019284","Total",601,582,19
"2011","Copeland 003D","E01019285","Total",680,645,35
"2011","Copeland 003E","E01019286","Total",649,630,19
"2011","Copeland 003F","E01019287","Total",515,510,5
"2011","Copeland 003G","E01019288","Total",549,546,3
"2011","Copeland 004A","E01019256","Total",719,660,59
"2011","Copeland 004B","E01019263","Total",517,491,26
"2011","Copeland 004C","E01019264","Total",725,701,24
"2011","Copeland 004D","E01019265","Total",654,612,42
"2011","Copeland 004E","E01019266","Total",680,642,38
"2011","Copeland 004F","E01019267","Total",620,603,17
"2011","Copeland 004G","E01019276","Total",506,447,59
"2011","Copeland 004H","E01019277","Total",593,552,41
"2011","Copeland 004I","E01019278","Total",613,570,43
"2011","Copeland 005A","E01019291","Total",619,599,20
"2011","Copeland 005B","E01019292","Total",528,504,24
"2011","Copeland 005C","E01019294","Total",633,619,14
"2011","Copeland 005D","E01019295","Total",624,609,15
"2011","Copeland 005E","E01019296","Total",610,595,15
"2011","Copeland 005F","E01019301","Total",667,634,33
"2011","Copeland 005G","E01019302","Total",443,423,20
"2011","Copeland 006A","E01019271","Total",602,582,20
"2011","Copeland 006B","E01019272","Total",618,609,9
"2011","Copeland 006C","E01019273","Total",709,687,22
"2011","Copeland 006D","E01019274","Total",842,790,52
"2011","Copeland 006E","E01019275","Total",975,937,38
"2011","Copeland 007A","E01019257","Total",690,643,47
"2011","Copeland 007B","E01019258","Total",707,666,41
"2011","Copeland 007C","E01019279","Total",729,644,85
"2011","Copeland 007D","E01019300","Total",808,737,71
"2011","Copeland 007E","E01019303","Total",709,654,55
"2011","Copeland 007F","E01019304","Total",690,582,108
"2011","Copeland 008A","E01019259","Total",665,584,81
"2011","Copeland 008B","E01019283","Total",635,574,61
"2011","Copeland 008C","E01019289","Total",635,598,37
"2011","Copeland 008D","E01019290","Total",508,463,45
"2011","Copeland 008E","E01019293","Total",696,571,125
"2011","Copeland 008F","E01019298","Total",715,682,33
"2011","Copeland 008G","E01019299","Total",1006,903,103
"2011","Eden 001A","E01019305","Total",1156,996,160
"2011","Eden 001B","E01019314","Total",587,531,56
"2011","Eden 001C","E01019320","Total",653,600,53
"2011","Eden 001D","E01019321","Total",712,644,68
"2011","Eden 002A","E01019315","Total",774,732,42
"2011","Eden 002B","E01019316","Total",554,528,26
"2011","Eden 002C","E01019322","Total",672,625,47
"2011","Eden 002D","E01019338","Total",658,608,50
"2011","Eden 003A","E01019327","Total",690,667,23
"2011","Eden 003B","E01019332","Total",675,663,12
"2011","Eden 003C","E01019333","Total",553,536,17
"2011","Eden 003D","E01019335","Total",670,656,14
"2011","Eden 003E","E01019336","Total",875,832,43
"2011","Eden 004A","E01019312","Total",726,635,91
"2011","Eden 004B","E01019326","Total",711,696,15
"2011","Eden 004C","E01019328","Total",552,533,19
"2011","Eden 004D","E01019329","Total",522,501,21
"2011","Eden 004E","E01019330","Total",677,656,21
"2011","Eden 004F","E01019331","Total",683,666,17
"2011","Eden 004G","E01019334","Total",647,624,23
"2011","Eden 005A","E01019308","Total",752,620,132
"2011","Eden 005B","E01019311","Total",703,637,66
"2011","Eden 005C","E01019313","Total",771,639,132
"2011","Eden 005D","E01019339","Total",843,595,248
"2011","Eden 006A","E01019306","Total",689,651,38
"2011","Eden 006B","E01019307","Total",804,764,40
"2011","Eden 006C","E01019310","Total",660,574,86
"2011","Eden 006D","E01019319","Total",684,640,44
"2011","Eden 006E","E01019323","Total",608,538,70
"2011","Eden 006F","E01019324","Total",598,532,66
"2011","Eden 006G","E01019337","Total",685,620,65
"2011","Eden 007A","E01019309","Total",1144,982,162
"2011","Eden 007B","E01019317","Total",619,549,70
"2011","Eden 007C","E01019318","Total",688,621,67
"2011","Eden 007D","E01019325","Total",685,589,96
"2011","Eden 007E","E01019340","Total",628,563,65
"2011","South Lakeland 001A","E01019374","Total",938,708,230
"2011","South Lakeland 001B","E01019375","Total",1133,690,443
"2011","South Lakeland 001C","E01019376","Total",1081,576,505
"2011","South Lakeland 001D","E01019395","Total",1231,950,281
"2011","South Lakeland 002A","E01019387","Total",1130,960,170
"2011","South Lakeland 002B","E01019396","Total",1140,937,203
"2011","South Lakeland 002C","E01019397","Total",1392,899,493
"2011","South Lakeland 002D","E01019398","Total",536,481,55
"2011","South Lakeland 002E","E01019399","Total",478,461,17
"2011","South Lakeland 003A","E01019346","Total",957,849,108
"2011","South Lakeland 003B","E01019359","Total",987,953,34
"2011","South Lakeland 003C","E01019365","Total",1063,1006,57
"2011","South Lakeland 003D","E01019370","Total",1126,1057,69
"2011","South Lakeland 004A","E01019360","Total",1161,1059,102
"2011","South Lakeland 004B","E01019363","Total",1028,949,79
"2011","South Lakeland 004C","E01019364","Total",885,841,44
"2011","South Lakeland 004D","E01019371","Total",948,934,14
"2011","South Lakeland 005A","E01019358","Total",807,790,17
"2011","South Lakeland 005B","E01019362","Total",917,900,17
"2011","South Lakeland 005C","E01019366","Total",809,781,28
"2011","South Lakeland 005D","E01019394","Total",1050,926,124
"2011","South Lakeland 006A","E01019361","Total",814,797,17
"2011","South Lakeland 006B","E01019367","Total",1138,1091,47
"2011","South Lakeland 006C","E01019368","Total",858,840,18
"2011","South Lakeland 006D","E01019369","Total",891,869,22
"2011","South Lakeland 007A","E01019356","Total",1073,684,389
"2011","South Lakeland 007B","E01019381","Total",1099,923,176
"2011","South Lakeland 007C","E01019386","Total",1019,797,222
"2011","South Lakeland 008A","E01019344","Total",613,468,145
"2011","South Lakeland 008B","E01019345","Total",605,530,75
"2011","South Lakeland 008C","E01019350","Total",1137,735,402
"2011","South Lakeland 008D","E01019351","Total",892,760,132
"2011","South Lakeland 009A","E01019372","Total",680,557,123
"2011","South Lakeland 009B","E01019373","Total",593,543,50
"2011","South Lakeland 009C","E01019384","Total",1209,973,236
"2011","South Lakeland 009D","E01019385","Total",663,588,75
"2011","South Lakeland 010A","E01019348","Total",547,518,29
"2011","South Lakeland 010B","E01019352","Total",977,902,75
"2011","South Lakeland 010C","E01019377","Total",881,805,76
"2011","South Lakeland 010D","E01019383","Total",960,882,78
"2011","South Lakeland 011A","E01019341","Total",855,752,103
"2011","South Lakeland 011B","E01019342","Total",589,508,81
"2011","South Lakeland 011C","E01019343","Total",740,668,72
"2011","South Lakeland 011D","E01019347","Total",844,781,63
"2011","South Lakeland 011E","E01019382","Total",985,947,38
"2011","South Lakeland 012A","E01019388","Total",797,774,23
"2011","South Lakeland 012B","E01019389","Total",1064,1005,59
"2011","South Lakeland 012C","E01019390","Total",1063,960,103
"2011","South Lakeland 012D","E01019392","Total",1122,1006,116
"2011","South Lakeland 013A","E01019349","Total",981,822,159
"2011","South Lakeland 013B","E01019353","Total",793,695,98
"2011","South Lakeland 013C","E01019354","Total",898,737,161
"2011","South Lakeland 013D","E01019355","Total",736,659,77
"2011","South Lakeland 013E","E01019357","Total",913,831,82
"2011","South Lakeland 014A","E01019378","Total",711,688,23
"2011","South Lakeland 014B","E01019379","Total",700,633,67
"2011","South Lakeland 014C","E01019380","Total",523,474,49
"2011","South Lakeland 014D","E01019391","Total",756,739,17
"2011","South Lakeland 014E","E01019393","Total",950,904,46
"2011","Bolton 001A","E01004768","Total",619,605,14
"2011","Bolton 001B","E01004803","Total",736,709,27
"2011","Bolton 001C","E01004804","Total",617,602,15
"2011","Bolton 001D","E01004807","Total",557,543,14
"2011","Bolton 001E","E01004808","Total",699,687,12
"2011","Bolton 002A","E01004788","Total",623,609,14
"2011","Bolton 002B","E01004790","Total",683,644,39
"2011","Bolton 002C","E01004805","Total",689,676,13
"2011","Bolton 002D","E01004806","Total",669,650,19
"2011","Bolton 002E","E01004810","Total",627,626,1
"2011","Bolton 003A","E01004769","Total",705,685,20
"2011","Bolton 003B","E01004770","Total",629,616,13
"2011","Bolton 003C","E01004771","Total",649,636,13
"2011","Bolton 003D","E01004773","Total",890,852,38
"2011","Bolton 003E","E01004809","Total",915,893,22
"2011","Bolton 004A","E01004777","Total",730,705,25
"2011","Bolton 004B","E01004881","Total",775,748,27
"2011","Bolton 004C","E01004888","Total",562,554,8
"2011","Bolton 004D","E01004889","Total",618,608,10
"2011","Bolton 004E","E01004890","Total",703,673,30
"2011","Bolton 005A","E01004766","Total",849,795,54
"2011","Bolton 005B","E01004767","Total",792,768,24
"2011","Bolton 005C","E01004772","Total",750,731,19
"2011","Bolton 005D","E01004774","Total",744,706,38
"2011","Bolton 005E","E01004824","Total",525,496,29
"2011","Bolton 006A","E01004784","Total",515,508,7
"2011","Bolton 006B","E01004785","Total",654,641,13
"2011","Bolton 006C","E01004786","Total",666,648,18
"2011","Bolton 006D","E01004789","Total",619,591,28
"2011","Bolton 006E","E01004791","Total",649,607,42
"2011","Bolton 006F","E01004792","Total",662,642,20
"2011","Bolton 007A","E01004779","Total",596,588,8
"2011","Bolton 007B","E01004781","Total",817,792,25
"2011","Bolton 007C","E01004882","Total",613,594,19
"2011","Bolton 007D","E01004883","Total",658,627,31
"2011","Bolton 007E","E01004884","Total",710,685,25
"2011","Bolton 008A","E01004864","Total",717,697,20
"2011","Bolton 008B","E01004867","Total",653,632,21
"2011","Bolton 008C","E01004921","Total",775,737,38
"2011","Bolton 008D","E01004924","Total",612,604,8
"2011","Bolton 008E","E01004925","Total",664,646,18
"2011","Bolton 009A","E01004778","Total",529,517,12
"2011","Bolton 009B","E01004780","Total",909,871,38
"2011","Bolton 009C","E01004782","Total",512,494,18
"2011","Bolton 009D","E01004783","Total",658,636,22
"2011","Bolton 010A","E01004802","Total",773,750,23
"2011","Bolton 010B","E01004926","Total",532,510,22
"2011","Bolton 010C","E01004927","Total",1062,1008,54
"2011","Bolton 010D","E01004929","Total",901,867,34
"2011","Bolton 011A","E01004820","Total",665,645,20
"2011","Bolton 011B","E01004825","Total",664,631,33
"2011","Bolton 011C","E01004826","Total",671,634,37
"2011","Bolton 011D","E01004865","Total",700,653,47
"2011","Bolton 011E","E01004866","Total",796,780,16
"2011","Bolton 012A","E01004840","Total",770,715,55
"2011","Bolton 012B","E01004841","Total",686,669,17
"2011","Bolton 012C","E01004842","Total",751,732,19
"2011","Bolton 012D","E01004919","Total",675,656,19
"2011","Bolton 012E","E01004920","Total",692,658,34
"2011","Bolton 013A","E01004787","Total",812,778,34
"2011","Bolton 013B","E01004793","Total",686,658,28
"2011","Bolton 013C","E01004794","Total",702,678,24
"2011","Bolton 013D","E01004795","Total",731,700,31
"2011","Bolton 013E","E01004797","Total",531,507,24
"2011","Bolton 014A","E01004775","Total",629,614,15
"2011","Bolton 014B","E01004885","Total",540,530,10
"2011","Bolton 014C","E01004886","Total",623,610,13
"2011","Bolton 014D","E01004887","Total",626,618,8
"2011","Bolton 015A","E01004868","Total",744,692,52
"2011","Bolton 015B","E01004869","Total",918,848,70
"2011","Bolton 015C","E01004870","Total",881,794,87
"2011","Bolton 015D","E01004871","Total",563,545,18
"2011","Bolton 015E","E01004922","Total",847,775,72
"2011","Bolton 016B","E01004822","Total",659,625,34
"2011","Bolton 016C","E01004823","Total",870,838,32
"2011","Bolton 016D","E01004848","Total",757,714,43
"2011","Bolton 016E","E01033217","Total",687,658,29
"2011","Bolton 016F","E01033220","Total",791,745,46
"2011","Bolton 017A","E01004818","Total",802,713,89
"2011","Bolton 017B","E01004819","Total",641,596,45
"2011","Bolton 017C","E01004928","Total",742,684,58
"2011","Bolton 017D","E01004930","Total",658,646,12
"2011","Bolton 017E","E01004931","Total",787,767,20
"2011","Bolton 017F","E01004932","Total",776,717,59
"2011","Bolton 018A","E01004834","Total",611,579,32
"2011","Bolton 018B","E01004838","Total",685,642,43
"2011","Bolton 018C","E01004843","Total",644,621,23
"2011","Bolton 018D","E01004845","Total",734,692,42
"2011","Bolton 018E","E01004923","Total",696,663,33
"2011","Bolton 019A","E01004796","Total",681,643,38
"2011","Bolton 019B","E01004798","Total",713,689,24
"2011","Bolton 019C","E01004799","Total",604,598,6
"2011","Bolton 019D","E01004800","Total",541,529,12
"2011","Bolton 019E","E01004801","Total",709,690,19
"2011","Bolton 019F","E01004917","Total",897,869,28
"2011","Bolton 020A","E01004835","Total",593,577,16
"2011","Bolton 020B","E01004836","Total",611,588,23
"2011","Bolton 020C","E01004837","Total",613,599,14
"2011","Bolton 020D","E01004844","Total",624,612,12
"2011","Bolton 020E","E01004897","Total",489,474,15
"2011","Bolton 021A","E01004827","Total",713,684,29
"2011","Bolton 021B","E01004849","Total",579,548,31
"2011","Bolton 021C","E01004850","Total",789,762,27
"2011","Bolton 021D","E01004851","Total",698,674,24
"2011","Bolton 021E","E01004853","Total",530,517,13
"2011","Bolton 022A","E01004811","Total",680,633,47
"2011","Bolton 022B","E01004812","Total",679,624,55
"2011","Bolton 022C","E01004813","Total",554,530,24
"2011","Bolton 022D","E01004815","Total",613,589,24
"2011","Bolton 022E","E01004817","Total",797,754,43
"2011","Bolton 023A","E01004828","Total",674,652,22
"2011","Bolton 023B","E01004829","Total",526,498,28
"2011","Bolton 023C","E01004832","Total",677,650,27
"2011","Bolton 023D","E01004854","Total",493,460,33
"2011","Bolton 023E","E01004878","Total",574,541,33
"2011","Bolton 024A","E01004911","Total",777,745,32
"2011","Bolton 024B","E01004912","Total",658,642,16
"2011","Bolton 024C","E01004913","Total",796,768,28
"2011","Bolton 024D","E01004914","Total",527,519,8
"2011","Bolton 024E","E01004915","Total",543,536,7
"2011","Bolton 024F","E01004916","Total",679,666,13
"2011","Bolton 024G","E01004918","Total",526,520,6
"2011","Bolton 025A","E01004846","Total",541,512,29
"2011","Bolton 025B","E01004847","Total",659,638,21
"2011","Bolton 025C","E01004852","Total",496,484,12
"2011","Bolton 025D","E01004877","Total",725,689,36
"2011","Bolton 025E","E01004879","Total",550,520,30
"2011","Bolton 026A","E01004830","Total",780,741,39
"2011","Bolton 026B","E01004831","Total",683,654,29
"2011","Bolton 026C","E01004833","Total",664,636,28
"2011","Bolton 026D","E01004839","Total",994,944,50
"2011","Bolton 027A","E01004814","Total",628,582,46
"2011","Bolton 027B","E01004855","Total",654,613,41
"2011","Bolton 027C","E01004856","Total",673,637,36
"2011","Bolton 027D","E01004857","Total",697,636,61
"2011","Bolton 028A","E01004891","Total",775,756,19
"2011","Bolton 028B","E01004893","Total",602,592,10
"2011","Bolton 028C","E01004894","Total",816,797,19
"2011","Bolton 028E","E01004901","Total",753,739,14
"2011","Bolton 028F","E01033218","Total",660,648,12
"2011","Bolton 028G","E01033219","Total",605,593,12
"2011","Bolton 029A","E01004816","Total",533,513,20
"2011","Bolton 029B","E01004872","Total",657,619,38
"2011","Bolton 029C","E01004873","Total",642,626,16
"2011","Bolton 029D","E01004875","Total",666,653,13
"2011","Bolton 029E","E01004880","Total",524,508,16
"2011","Bolton 030A","E01004892","Total",711,693,18
"2011","Bolton 030B","E01004896","Total",569,556,13
"2011","Bolton 030C","E01004899","Total",647,622,25
"2011","Bolton 030D","E01004900","Total",646,624,22
"2011","Bolton 031A","E01004776","Total",813,794,19
"2011","Bolton 031B","E01004895","Total",609,588,21
"2011","Bolton 031C","E01004936","Total",978,950,28
"2011","Bolton 031D","E01004938","Total",642,632,10
"2011","Bolton 031E","E01004939","Total",710,686,24
"2011","Bolton 032A","E01004858","Total",775,755,20
"2011","Bolton 032B","E01004859","Total",742,704,38
"2011","Bolton 032C","E01004860","Total",714,691,23
"2011","Bolton 032D","E01004902","Total",848,802,46
"2011","Bolton 032E","E01004906","Total",861,810,51
"2011","Bolton 033A","E01004861","Total",640,623,17
"2011","Bolton 033B","E01004862","Total",632,610,22
"2011","Bolton 033C","E01004863","Total",674,646,28
"2011","Bolton 033D","E01004874","Total",692,683,9
"2011","Bolton 033E","E01004876","Total",801,792,9
"2011","Bolton 034A","E01004903","Total",586,575,11
"2011","Bolton 034B","E01004904","Total",729,696,33
"2011","Bolton 034C","E01004905","Total",708,679,29
"2011","Bolton 034D","E01004907","Total",558,541,17
"2011","Bolton 034E","E01004908","Total",579,570,9
"2011","Bolton 034F","E01004909","Total",654,632,22
"2011","Bolton 034G","E01004910","Total",992,970,22
"2011","Bolton 035A","E01004933","Total",589,569,20
"2011","Bolton 035B","E01004934","Total",570,560,10
"2011","Bolton 035C","E01004935","Total",733,705,28
"2011","Bolton 035D","E01004937","Total",579,558,21
"2011","Bolton 035E","E01004940","Total",632,616,16
"2011","Bury 001A","E01005014","Total",807,746,61
"2011","Bury 001B","E01005015","Total",726,688,38
"2011","Bury 001C","E01005016","Total",759,718,41
"2011","Bury 001D","E01005017","Total",731,707,24
"2011","Bury 001E","E01005018","Total",743,713,30
"2011","Bury 001F","E01005021","Total",429,410,19
"2011","Bury 002A","E01005019","Total",639,620,19
"2011","Bury 002B","E01005023","Total",566,554,12
"2011","Bury 002C","E01005046","Total",657,643,14
"2011","Bury 002D","E01005048","Total",686,666,20
"2011","Bury 003A","E01005020","Total",508,507,1
"2011","Bury 003B","E01005022","Total",669,644,25
"2011","Bury 003C","E01005047","Total",592,568,24
"2011","Bury 003D","E01005049","Total",771,738,33
"2011","Bury 003E","E01005051","Total",731,658,73
"2011","Bury 004A","E01004976","Total",652,638,14
"2011","Bury 004B","E01004977","Total",791,767,24
"2011","Bury 004C","E01004978","Total",686,654,32
"2011","Bury 004D","E01004981","Total",656,632,24
"2011","Bury 004E","E01004982","Total",655,635,20
"2011","Bury 005A","E01004961","Total",659,647,12
"2011","Bury 005B","E01004965","Total",502,486,16
"2011","Bury 005C","E01004966","Total",746,719,27
"2011","Bury 005D","E01004967","Total",476,472,4
"2011","Bury 006A","E01004963","Total",687,673,14
"2011","Bury 006B","E01004968","Total",635,627,8
"2011","Bury 006C","E01005050","Total",838,819,19
"2011","Bury 006D","E01005052","Total",590,582,8
"2011","Bury 006E","E01005053","Total",656,640,16
"2011","Bury 007A","E01004954","Total",677,658,19
"2011","Bury 007B","E01004955","Total",574,550,24
"2011","Bury 007C","E01004956","Total",746,696,50
"2011","Bury 007D","E01004957","Total",823,813,10
"2011","Bury 007E","E01004960","Total",650,632,18
"2011","Bury 008A","E01004958","Total",699,661,38
"2011","Bury 008B","E01004959","Total",764,728,36
"2011","Bury 008C","E01004979","Total",699,630,69
"2011","Bury 008D","E01004980","Total",635,596,39
"2011","Bury 008E","E01005024","Total",557,511,46
"2011","Bury 008F","E01005026","Total",577,545,32
"2011","Bury 009A","E01004947","Total",714,653,61
"2011","Bury 009B","E01004948","Total",886,836,50
"2011","Bury 009C","E01004962","Total",748,708,40
"2011","Bury 009D","E01004964","Total",882,832,50
"2011","Bury 010A","E01004949","Total",607,596,11
"2011","Bury 010B","E01004950","Total",626,612,14
"2011","Bury 010C","E01004951","Total",663,653,10
"2011","Bury 010D","E01004952","Total",630,619,11
"2011","Bury 010E","E01004953","Total",642,628,14
"2011","Bury 011A","E01005025","Total",705,685,20
"2011","Bury 011B","E01005027","Total",761,732,29
"2011","Bury 011C","E01005028","Total",826,803,23
"2011","Bury 011D","E01005029","Total",671,660,11
"2011","Bury 012A","E01005000","Total",609,574,35
"2011","Bury 012B","E01005001","Total",505,493,12
"2011","Bury 012C","E01005005","Total",658,632,26
"2011","Bury 012D","E01005006","Total",662,647,15
"2011","Bury 013A","E01005030","Total",747,733,14
"2011","Bury 013B","E01005054","Total",666,641,25
"2011","Bury 013C","E01005059","Total",751,733,18
"2011","Bury 013D","E01005060","Total",754,734,20
"2011","Bury 014A","E01004997","Total",624,594,30
"2011","Bury 014B","E01004998","Total",668,641,27
"2011","Bury 014C","E01004999","Total",606,596,10
"2011","Bury 014D","E01005002","Total",652,635,17
"2011","Bury 014E","E01005003","Total",684,654,30
"2011","Bury 015A","E01004991","Total",598,588,10
"2011","Bury 015B","E01004992","Total",674,637,37
"2011","Bury 015C","E01004993","Total",560,551,9
"2011","Bury 015D","E01004994","Total",658,614,44
"2011","Bury 016A","E01004990","Total",679,634,45
"2011","Bury 016B","E01004996","Total",783,731,52
"2011","Bury 016C","E01005004","Total",882,849,33
"2011","Bury 016D","E01005008","Total",925,875,50
"2011","Bury 016E","E01005009","Total",854,742,112
"2011","Bury 017A","E01004945","Total",670,658,12
"2011","Bury 017B","E01005055","Total",598,584,14
"2011","Bury 017C","E01005056","Total",618,604,14
"2011","Bury 017D","E01005057","Total",642,630,12
"2011","Bury 017E","E01005058","Total",514,505,9
"2011","Bury 018A","E01004995","Total",667,640,27
"2011","Bury 018B","E01005010","Total",677,660,17
"2011","Bury 018C","E01005012","Total",796,755,41
"2011","Bury 018D","E01005013","Total",1030,956,74
"2011","Bury 019A","E01004984","Total",604,573,31
"2011","Bury 019B","E01004985","Total",613,577,36
"2011","Bury 019C","E01004989","Total",611,567,44
"2011","Bury 019D","E01005007","Total",744,710,34
"2011","Bury 019E","E01005011","Total",615,589,26
"2011","Bury 020A","E01004983","Total",634,545,89
"2011","Bury 020B","E01004986","Total",869,806,63
"2011","Bury 020C","E01004987","Total",683,649,34
"2011","Bury 020D","E01004988","Total",657,637,20
"2011","Bury 021A","E01004941","Total",747,726,21
"2011","Bury 021B","E01004942","Total",655,639,16
"2011","Bury 021C","E01004943","Total",706,650,56
"2011","Bury 021D","E01004944","Total",648,630,18
"2011","Bury 021E","E01004946","Total",817,798,19
"2011","Bury 022A","E01004969","Total",768,705,63
"2011","Bury 022B","E01004970","Total",615,605,10
"2011","Bury 022C","E01004971","Total",611,598,13
"2011","Bury 022D","E01005034","Total",663,640,23
"2011","Bury 023A","E01004972","Total",584,573,11
"2011","Bury 023B","E01004973","Total",685,658,27
"2011","Bury 023C","E01004975","Total",788,757,31
"2011","Bury 023D","E01005039","Total",725,699,26
"2011","Bury 023E","E01005045","Total",706,682,24
"2011","Bury 024A","E01004974","Total",619,603,16
"2011","Bury 024B","E01005033","Total",639,614,25
"2011","Bury 024C","E01005036","Total",1057,1030,27
"2011","Bury 024D","E01005037","Total",650,628,22
"2011","Bury 025A","E01005031","Total",643,627,16
"2011","Bury 025B","E01005032","Total",549,523,26
"2011","Bury 025C","E01005035","Total",649,626,23
"2011","Bury 025D","E01005038","Total",540,531,9
"2011","Bury 026A","E01005040","Total",736,696,40
"2011","Bury 026B","E01005041","Total",538,519,19
"2011","Bury 026C","E01005042","Total",634,608,26
"2011","Bury 026D","E01005043","Total",514,496,18
"2011","Bury 026E","E01005044","Total",508,471,37
"2011","Manchester 001A","E01005098","Total",780,777,3
"2011","Manchester 001B","E01005099","Total",750,726,24
"2011","Manchester 001C","E01005100","Total",668,658,10
"2011","Manchester 001D","E01005102","Total",636,626,10
"2011","Manchester 001E","E01005103","Total",886,835,51
"2011","Manchester 002A","E01005101","Total",748,723,25
"2011","Manchester 002B","E01005135","Total",638,624,14
"2011","Manchester 002C","E01005136","Total",657,637,20
"2011","Manchester 002D","E01005138","Total",814,787,27
"2011","Manchester 002E","E01005140","Total",1251,1185,66
"2011","Manchester 003B","E01005139","Total",734,714,20
"2011","Manchester 003C","E01005141","Total",820,805,15
"2011","Manchester 003D","E01005251","Total",650,633,17
"2011","Manchester 003E","E01005252","Total",774,763,11
"2011","Manchester 003F","E01033685","Total",662,652,10
"2011","Manchester 003G","E01033687","Total",819,802,17
"2011","Manchester 004A","E01005104","Total",859,842,17
"2011","Manchester 004B","E01005160","Total",736,721,15
"2011","Manchester 004C","E01005161","Total",669,657,12
"2011","Manchester 004D","E01005162","Total",688,679,9
"2011","Manchester 004E","E01005163","Total",674,661,13
"2011","Manchester 005A","E01005247","Total",639,627,12
"2011","Manchester 005B","E01005248","Total",583,573,10
"2011","Manchester 005C","E01005249","Total",802,777,25
"2011","Manchester 005D","E01005250","Total",764,750,14
"2011","Manchester 005E","E01005253","Total",645,639,6
"2011","Manchester 005F","E01005254","Total",706,683,23
"2011","Manchester 006A","E01005164","Total",748,694,54
"2011","Manchester 006B","E01005205","Total",964,937,27
"2011","Manchester 006C","E01005206","Total",762,747,15
"2011","Manchester 006D","E01005207","Total",833,817,16
"2011","Manchester 007A","E01005223","Total",565,549,16
"2011","Manchester 007B","E01005224","Total",784,715,69
"2011","Manchester 007C","E01005225","Total",884,837,47
"2011","Manchester 007D","E01005226","Total",749,683,66
"2011","Manchester 007E","E01005229","Total",627,609,18
"2011","Manchester 008A","E01005145","Total",849,801,48
"2011","Manchester 008B","E01005146","Total",881,852,29
"2011","Manchester 008C","E01005149","Total",517,474,43
"2011","Manchester 008D","E01005165","Total",1046,976,70
"2011","Manchester 008E","E01005166","Total",752,716,36
"2011","Manchester 008F","E01005167","Total",586,565,21
"2011","Manchester 009A","E01005202","Total",841,783,58
"2011","Manchester 009B","E01005203","Total",947,927,20
"2011","Manchester 009D","E01005227","Total",770,698,72
"2011","Manchester 009E","E01005228","Total",821,755,66
"2011","Manchester 009F","E01033678","Total",702,688,14
"2011","Manchester 009G","E01033679","Total",662,643,19
"2011","Manchester 011A","E01005256","Total",890,854,36
"2011","Manchester 011B","E01005257","Total",862,820,42
"2011","Manchester 011C","E01005258","Total",805,781,24
"2011","Manchester 011D","E01005259","Total",831,782,49
"2011","Manchester 011E","E01005260","Total",620,592,28
"2011","Manchester 012A","E01005093","Total",694,678,16
"2011","Manchester 012B","E01005094","Total",687,660,27
"2011","Manchester 012C","E01005097","Total",658,650,8
"2011","Manchester 012D","E01005255","Total",856,824,32
"2011","Manchester 012E","E01005261","Total",680,651,29
"2011","Manchester 013B","E01005129","Total",729,709,20
"2011","Manchester 013C","E01005132","Total",691,661,30
"2011","Manchester 013D","E01005133","Total",611,596,15
"2011","Manchester 013E","E01033663","Total",878,712,166
"2011","Manchester 013F","E01033684","Total",655,649,6
"2011","Manchester 013G","E01033688","Total",708,691,17
"2011","Manchester 015A","E01005092","Total",792,720,72
"2011","Manchester 015C","E01005105","Total",847,809,38
"2011","Manchester 015D","E01005106","Total",876,825,51
"2011","Manchester 015E","E01005107","Total",758,740,18
"2011","Manchester 015F","E01033668","Total",613,598,15
"2011","Manchester 015G","E01033669","Total",697,677,20
"2011","Manchester 017A","E01005108","Total",1100,1053,47
"2011","Manchester 017D","E01005189","Total",854,826,28
"2011","Manchester 017E","E01005190","Total",937,881,56
"2011","Manchester 017F","E01033666","Total",1198,1103,95
"2011","Manchester 018A","E01005061","Total",815,743,72
"2011","Manchester 018B","E01005062","Total",814,772,42
"2011","Manchester 018C","E01005063","Total",631,614,17
"2011","Manchester 018D","E01005065","Total",939,916,23
"2011","Manchester 018E","E01005066","Total",512,501,11
"2011","Manchester 019A","E01005208","Total",1165,1110,55
"2011","Manchester 019B","E01005209","Total",888,868,20
"2011","Manchester 019C","E01005210","Total",668,638,30
"2011","Manchester 019D","E01005214","Total",1044,1013,31
"2011","Manchester 020A","E01005067","Total",638,587,51
"2011","Manchester 020B","E01005186","Total",977,945,32
"2011","Manchester 020C","E01005232","Total",736,713,23
"2011","Manchester 020D","E01005235","Total",742,719,23
"2011","Manchester 020E","E01005239","Total",665,660,5
"2011","Manchester 021A","E01005187","Total",859,787,72
"2011","Manchester 021B","E01005188","Total",736,703,33
"2011","Manchester 021C","E01005191","Total",830,800,30
"2011","Manchester 021D","E01005192","Total",712,679,33
"2011","Manchester 021E","E01005193","Total",845,818,27
"2011","Manchester 022B","E01005230","Total",911,819,92
"2011","Manchester 022C","E01005231","Total",702,633,69
"2011","Manchester 022D","E01005236","Total",774,702,72
"2011","Manchester 022E","E01005237","Total",561,533,28
"2011","Manchester 022F","E01033652","Total",432,411,21
"2011","Manchester 022G","E01033657","Total",445,435,10
"2011","Manchester 023A","E01005195","Total",762,735,27
"2011","Manchester 023B","E01005196","Total",953,894,59
"2011","Manchester 023C","E01005197","Total",727,697,30
"2011","Manchester 023D","E01005198","Total",675,649,26
"2011","Manchester 023E","E01005201","Total",857,816,41
"2011","Manchester 024A","E01005240","Total",1081,1003,78
"2011","Manchester 024B","E01005243","Total",1093,1084,9
"2011","Manchester 024C","E01005245","Total",899,871,28
"2011","Manchester 024D","E01005246","Total",762,738,24
"2011","Manchester 025A","E01005241","Total",1047,1009,38
"2011","Manchester 025B","E01005242","Total",1081,1008,73
"2011","Manchester 025C","E01005244","Total",970,926,44
"2011","Manchester 025D","E01005285","Total",511,476,35
"2011","Manchester 025E","E01005288","Total",700,640,60
"2011","Manchester 026A","E01005280","Total",542,528,14
"2011","Manchester 026B","E01005281","Total",603,542,61
"2011","Manchester 026C","E01005284","Total",927,834,93
"2011","Manchester 026D","E01005286","Total",817,738,79
"2011","Manchester 026E","E01005287","Total",689,652,37
"2011","Manchester 027A","E01005194","Total",985,940,45
"2011","Manchester 027B","E01005199","Total",944,895,49
"2011","Manchester 027C","E01005200","Total",810,764,46
"2011","Manchester 027D","E01005233","Total",803,770,33
"2011","Manchester 027E","E01005234","Total",672,633,39
"2011","Manchester 027F","E01005238","Total",591,564,27
"2011","Manchester 028A","E01005297","Total",970,916,54
"2011","Manchester 028B","E01005298","Total",665,641,24
"2011","Manchester 028C","E01005302","Total",1007,930,77
"2011","Manchester 028E","E01033680","Total",695,646,49
"2011","Manchester 028F","E01033686","Total",707,608,99
"2011","Manchester 029A","E01005150","Total",999,930,69
"2011","Manchester 029B","E01005151","Total",745,717,28
"2011","Manchester 029C","E01005152","Total",615,600,15
"2011","Manchester 029D","E01005159","Total",654,621,33
"2011","Manchester 029E","E01005296","Total",684,614,70
"2011","Manchester 029F","E01005299","Total",546,533,13
"2011","Manchester 030A","E01005178","Total",769,742,27
"2011","Manchester 030B","E01005179","Total",1017,953,64
"2011","Manchester 030C","E01005180","Total",806,782,24
"2011","Manchester 030D","E01005181","Total",747,683,64
"2011","Manchester 030E","E01005182","Total",475,469,6
"2011","Manchester 030F","E01005183","Total",687,670,17
"2011","Manchester 031A","E01005219","Total",1022,916,106
"2011","Manchester 031B","E01005220","Total",774,728,46
"2011","Manchester 031C","E01005221","Total",835,779,56
"2011","Manchester 031D","E01005222","Total",946,897,49
"2011","Manchester 032A","E01005184","Total",874,779,95
"2011","Manchester 032B","E01005185","Total",582,534,48
"2011","Manchester 032C","E01005271","Total",729,694,35
"2011","Manchester 032D","E01005282","Total",587,550,37
"2011","Manchester 032E","E01005283","Total",442,408,34
"2011","Manchester 033A","E01005154","Total",706,669,37
"2011","Manchester 033B","E01005156","Total",655,635,20
"2011","Manchester 033C","E01005158","Total",731,711,20
"2011","Manchester 033D","E01005300","Total",517,490,27
"2011","Manchester 033E","E01005301","Total",661,612,49
"2011","Manchester 034A","E01005118","Total",506,497,9
"2011","Manchester 034B","E01005120","Total",678,661,17
"2011","Manchester 034C","E01005215","Total",781,756,25
"2011","Manchester 034D","E01005216","Total",639,611,28
"2011","Manchester 034E","E01005217","Total",730,678,52
"2011","Manchester 034F","E01005218","Total",682,632,50
"2011","Manchester 035A","E01005270","Total",696,675,21
"2011","Manchester 035B","E01005272","Total",797,755,42
"2011","Manchester 035C","E01005273","Total",609,553,56
"2011","Manchester 035D","E01005278","Total",564,541,23
"2011","Manchester 035E","E01005279","Total",837,817,20
"2011","Manchester 036A","E01005305","Total",613,592,21
"2011","Manchester 036B","E01005309","Total",1028,963,65
"2011","Manchester 036C","E01005310","Total",601,579,22
"2011","Manchester 036D","E01005311","Total",651,615,36
"2011","Manchester 036E","E01005312","Total",660,618,42
"2011","Manchester 037A","E01005082","Total",669,659,10
"2011","Manchester 037B","E01005153","Total",852,820,32
"2011","Manchester 037C","E01005155","Total",712,683,29
"2011","Manchester 037D","E01005157","Total",626,614,12
"2011","Manchester 038A","E01005274","Total",707,682,25
"2011","Manchester 038B","E01005275","Total",872,818,54
"2011","Manchester 038C","E01005276","Total",679,643,36
"2011","Manchester 038D","E01005277","Total",820,778,42
"2011","Manchester 039A","E01005076","Total",808,782,26
"2011","Manchester 039C","E01005081","Total",791,784,7
"2011","Manchester 039D","E01005083","Total",926,888,38
"2011","Manchester 039E","E01033670","Total",684,655,29
"2011","Manchester 039F","E01033671","Total",814,793,21
"2011","Manchester 040A","E01005125","Total",659,635,24
"2011","Manchester 040B","E01005304","Total",691,657,34
"2011","Manchester 040C","E01005306","Total",727,687,40
"2011","Manchester 040D","E01005307","Total",752,721,31
"2011","Manchester 040E","E01005308","Total",649,625,24
"2011","Manchester 041A","E01005119","Total",639,629,10
"2011","Manchester 041B","E01005121","Total",617,599,18
"2011","Manchester 041C","E01005122","Total",666,641,25
"2011","Manchester 041D","E01005123","Total",631,622,9
"2011","Manchester 041E","E01005124","Total",697,686,11
"2011","Manchester 042A","E01005077","Total",640,630,10
"2011","Manchester 042B","E01005078","Total",877,824,53
"2011","Manchester 042C","E01005079","Total",644,628,16
"2011","Manchester 042D","E01005084","Total",877,867,10
"2011","Manchester 043A","E01005172","Total",832,803,29
"2011","Manchester 043B","E01005173","Total",734,703,31
"2011","Manchester 043C","E01005174","Total",638,624,14
"2011","Manchester 043D","E01005175","Total",705,693,12
"2011","Manchester 043E","E01005176","Total",988,936,52
"2011","Manchester 043F","E01005177","Total",663,643,20
"2011","Manchester 044A","E01005115","Total",798,785,13
"2011","Manchester 044B","E01005262","Total",879,861,18
"2011","Manchester 044C","E01005264","Total",620,617,3
"2011","Manchester 044D","E01005265","Total",702,682,20
"2011","Manchester 044E","E01005266","Total",859,835,24
"2011","Manchester 045A","E01005126","Total",862,819,43
"2011","Manchester 045B","E01005168","Total",541,522,19
"2011","Manchester 045C","E01005169","Total",511,487,24
"2011","Manchester 045D","E01005170","Total",611,584,27
"2011","Manchester 045E","E01005171","Total",740,711,29
"2011","Manchester 046A","E01005263","Total",844,825,19
"2011","Manchester 046B","E01005267","Total",677,664,13
"2011","Manchester 046C","E01005268","Total",1052,994,58
"2011","Manchester 046D","E01005269","Total",629,617,12
"2011","Manchester 047A","E01005069","Total",650,641,9
"2011","Manchester 047B","E01005111","Total",626,622,4
"2011","Manchester 047C","E01005113","Total",842,830,12
"2011","Manchester 047D","E01005114","Total",837,810,27
"2011","Manchester 047E","E01005116","Total",1007,973,34
"2011","Manchester 048A","E01005071","Total",701,684,17
"2011","Manchester 048B","E01005072","Total",831,811,20
"2011","Manchester 048C","E01005073","Total",630,615,15
"2011","Manchester 048D","E01005112","Total",693,676,17
"2011","Manchester 048E","E01005117","Total",963,938,25
"2011","Manchester 049A","E01005085","Total",607,599,8
"2011","Manchester 049B","E01005086","Total",718,715,3
"2011","Manchester 049C","E01005089","Total",713,699,14
"2011","Manchester 049D","E01005289","Total",654,641,13
"2011","Manchester 049E","E01005295","Total",1160,1124,36
"2011","Manchester 050A","E01005087","Total",805,792,13
"2011","Manchester 050B","E01005088","Total",690,687,3
"2011","Manchester 050C","E01005090","Total",767,745,22
"2011","Manchester 050D","E01005091","Total",882,867,15
"2011","Manchester 050E","E01005291","Total",722,714,8
"2011","Manchester 051A","E01005068","Total",723,704,19
"2011","Manchester 051B","E01005070","Total",755,740,15
"2011","Manchester 051C","E01005074","Total",658,644,14
"2011","Manchester 051D","E01005075","Total",625,612,13
"2011","Manchester 051E","E01005319","Total",904,880,24
"2011","Manchester 052A","E01005290","Total",692,675,17
"2011","Manchester 052B","E01005292","Total",702,696,6
"2011","Manchester 052C","E01005293","Total",530,521,9
"2011","Manchester 052D","E01005294","Total",656,645,11
"2011","Manchester 052E","E01005317","Total",813,774,39
"2011","Manchester 053A","E01005313","Total",630,618,12
"2011","Manchester 053B","E01005314","Total",648,635,13
"2011","Manchester 053C","E01005315","Total",729,715,14
"2011","Manchester 053D","E01005316","Total",717,702,15
"2011","Manchester 053E","E01005318","Total",813,782,31
"2011","Manchester 054A","E01005130","Total",785,767,18
"2011","Manchester 054B","E01033651","Total",673,630,43
"2011","Manchester 054C","E01033658","Total",805,711,94
"2011","Manchester 054D","E01033664","Total",641,607,34
"2011","Manchester 054E","E01033667","Total",679,653,26
"2011","Manchester 055A","E01005128","Total",819,766,53
"2011","Manchester 055B","E01033653","Total",1093,1036,57
"2011","Manchester 055C","E01033654","Total",647,617,30
"2011","Manchester 055D","E01033659","Total",805,760,45
"2011","Manchester 055E","E01033661","Total",746,706,40
"2011","Manchester 056A","E01005143","Total",827,792,35
"2011","Manchester 056B","E01033655","Total",755,694,61
"2011","Manchester 056C","E01033665","Total",830,723,107
"2011","Manchester 056D","E01033676","Total",756,730,26
"2011","Manchester 057A","E01005212","Total",708,696,12
"2011","Manchester 057B","E01033656","Total",819,761,58
"2011","Manchester 057C","E01033662","Total",912,842,70
"2011","Manchester 058A","E01005142","Total",756,729,27
"2011","Manchester 058B","E01005147","Total",942,914,28
"2011","Manchester 058C","E01033674","Total",688,647,41
"2011","Manchester 058D","E01033675","Total",774,757,17
"2011","Manchester 059A","E01005213","Total",1226,1178,48
"2011","Manchester 059B","E01033660","Total",715,698,17
"2011","Manchester 059C","E01033672","Total",764,725,39
"2011","Manchester 059D","E01033673","Total",706,673,33
"2011","Manchester 060A","E01033677","Total",794,699,95
"2011","Manchester 060B","E01033681","Total",952,844,108
"2011","Manchester 060C","E01033682","Total",880,797,83
"2011","Manchester 060D","E01033683","Total",844,747,97
"2011","Oldham 001A","E01005357","Total",628,616,12
"2011","Oldham 001B","E01005358","Total",752,735,17
"2011","Oldham 001C","E01005359","Total",784,757,27
"2011","Oldham 001D","E01005360","Total",668,648,20
"2011","Oldham 002A","E01005441","Total",817,792,25
"2011","Oldham 002B","E01005442","Total",599,588,11
"2011","Oldham 002C","E01005444","Total",710,672,38
"2011","Oldham 002D","E01005445","Total",705,672,33
"2011","Oldham 003A","E01005361","Total",744,728,16
"2011","Oldham 003B","E01005443","Total",555,552,3
"2011","Oldham 003C","E01005446","Total",622,605,17
"2011","Oldham 003D","E01005447","Total",746,701,45
"2011","Oldham 004A","E01005390","Total",616,604,12
"2011","Oldham 004B","E01005394","Total",670,654,16
"2011","Oldham 004C","E01005395","Total",628,610,18
"2011","Oldham 004D","E01005396","Total",593,589,4
"2011","Oldham 005A","E01005355","Total",654,630,24
"2011","Oldham 005B","E01005356","Total",517,503,14
"2011","Oldham 005C","E01005399","Total",711,698,13
"2011","Oldham 005D","E01005403","Total",660,644,16
"2011","Oldham 006A","E01005410","Total",613,599,14
"2011","Oldham 006B","E01005411","Total",764,721,43
"2011","Oldham 006C","E01005414","Total",561,525,36
"2011","Oldham 006D","E01005415","Total",522,508,14
"2011","Oldham 007C","E01005452","Total",554,543,11
"2011","Oldham 007D","E01005453","Total",549,537,12
"2011","Oldham 007E","E01032558","Total",660,641,19
"2011","Oldham 007F","E01032559","Total",1026,1005,21
"2011","Oldham 008A","E01005391","Total",663,651,12
"2011","Oldham 008B","E01005392","Total",794,767,27
"2011","Oldham 008C","E01005393","Total",536,524,12
"2011","Oldham 008D","E01005401","Total",703,689,14
"2011","Oldham 009A","E01005397","Total",652,637,15
"2011","Oldham 009B","E01005398","Total",678,656,22
"2011","Oldham 009C","E01005400","Total",781,753,28
"2011","Oldham 009D","E01005402","Total",630,622,8
"2011","Oldham 010A","E01005335","Total",544,540,4
"2011","Oldham 010B","E01005337","Total",663,655,8
"2011","Oldham 010C","E01005339","Total",601,589,12
"2011","Oldham 010D","E01005340","Total",610,606,4
"2011","Oldham 011A","E01005421","Total",766,735,31
"2011","Oldham 011B","E01005422","Total",546,533,13
"2011","Oldham 011E","E01032920","Total",915,880,35
"2011","Oldham 012A","E01005448","Total",828,781,47
"2011","Oldham 012B","E01005449","Total",602,578,24
"2011","Oldham 012C","E01005454","Total",583,569,14
"2011","Oldham 012D","E01005455","Total",636,619,17
"2011","Oldham 012E","E01005456","Total",835,785,50
"2011","Oldham 013A","E01005407","Total",748,724,24
"2011","Oldham 013B","E01005412","Total",841,784,57
"2011","Oldham 013C","E01005416","Total",642,599,43
"2011","Oldham 013D","E01005417","Total",659,635,24
"2011","Oldham 014A","E01005348","Total",629,625,4
"2011","Oldham 014B","E01005350","Total",994,989,5
"2011","Oldham 014C","E01005432","Total",651,648,3
"2011","Oldham 014D","E01005433","Total",674,666,8
"2011","Oldham 015A","E01005329","Total",626,616,10
"2011","Oldham 015B","E01005330","Total",637,626,11
"2011","Oldham 015C","E01005333","Total",510,499,11
"2011","Oldham 015D","E01005336","Total",635,630,5
"2011","Oldham 016A","E01005349","Total",547,538,9
"2011","Oldham 016B","E01005351","Total",472,467,5
"2011","Oldham 016C","E01005352","Total",464,461,3
"2011","Oldham 016D","E01005353","Total",669,657,12
"2011","Oldham 016E","E01005354","Total",544,541,3
"2011","Oldham 017A","E01005327","Total",798,757,41
"2011","Oldham 017B","E01005328","Total",751,696,55
"2011","Oldham 017C","E01005331","Total",659,635,24
"2011","Oldham 017D","E01005334","Total",542,541,1
"2011","Oldham 017E","E01005338","Total",757,752,5
"2011","Oldham 018A","E01005387","Total",654,631,23
"2011","Oldham 018B","E01005388","Total",611,596,15
"2011","Oldham 018C","E01005389","Total",766,727,39
"2011","Oldham 018D","E01005418","Total",594,585,9
"2011","Oldham 019A","E01005428","Total",574,532,42
"2011","Oldham 019B","E01005431","Total",757,717,40
"2011","Oldham 019C","E01005450","Total",692,627,65
"2011","Oldham 019D","E01005451","Total",510,482,28
"2011","Oldham 020C","E01005408","Total",823,794,29
"2011","Oldham 020D","E01005409","Total",696,664,32
"2011","Oldham 020E","E01032922","Total",1122,1071,51
"2011","Oldham 021A","E01005406","Total",616,594,22
"2011","Oldham 021B","E01005413","Total",668,654,14
"2011","Oldham 021C","E01005419","Total",655,638,17
"2011","Oldham 021D","E01005420","Total",750,716,34
"2011","Oldham 022A","E01005321","Total",627,596,31
"2011","Oldham 022B","E01005326","Total",571,554,17
"2011","Oldham 022C","E01005427","Total",537,497,40
"2011","Oldham 022D","E01005429","Total",495,479,16
"2011","Oldham 022E","E01005430","Total",748,714,34
"2011","Oldham 024A","E01005320","Total",692,631,61
"2011","Oldham 024B","E01005434","Total",743,657,86
"2011","Oldham 024C","E01005437","Total",537,529,8
"2011","Oldham 024D","E01005459","Total",424,407,17
"2011","Oldham 026A","E01005383","Total",746,718,28
"2011","Oldham 026D","E01005386","Total",650,626,24
"2011","Oldham 026E","E01032556","Total",687,662,25
"2011","Oldham 026F","E01032557","Total",780,745,35
"2011","Oldham 027A","E01005342","Total",692,662,30
"2011","Oldham 027B","E01005343","Total",571,547,24
"2011","Oldham 027C","E01005344","Total",706,656,50
"2011","Oldham 027D","E01005381","Total",659,642,17
"2011","Oldham 028A","E01005332","Total",1010,979,31
"2011","Oldham 028B","E01005341","Total",615,602,13
"2011","Oldham 028C","E01005345","Total",639,620,19
"2011","Oldham 028D","E01005346","Total",628,610,18
"2011","Oldham 028E","E01005347","Total",558,540,18
"2011","Oldham 029A","E01005322","Total",555,523,32
"2011","Oldham 029B","E01005323","Total",645,621,24
"2011","Oldham 029C","E01005324","Total",625,612,13
"2011","Oldham 029D","E01005325","Total",427,419,8
"2011","Oldham 029E","E01005438","Total",1030,966,64
"2011","Oldham 030A","E01005377","Total",502,498,4
"2011","Oldham 030B","E01005379","Total",514,507,7
"2011","Oldham 030C","E01005380","Total",543,533,10
"2011","Oldham 030D","E01005382","Total",682,598,84
"2011","Oldham 030E","E01005439","Total",680,654,26
"2011","Oldham 031A","E01005362","Total",625,612,13
"2011","Oldham 031B","E01005364","Total",726,709,17
"2011","Oldham 031C","E01005368","Total",759,729,30
"2011","Oldham 031D","E01005376","Total",584,558,26
"2011","Oldham 031E","E01005378","Total",689,663,26
"2011","Oldham 032A","E01005363","Total",765,699,66
"2011","Oldham 032B","E01005369","Total",697,655,42
"2011","Oldham 032C","E01005370","Total",750,714,36
"2011","Oldham 032D","E01005371","Total",602,554,48
"2011","Oldham 033A","E01005365","Total",637,624,13
"2011","Oldham 033B","E01005366","Total",720,699,21
"2011","Oldham 033C","E01005367","Total",582,572,10
"2011","Oldham 033D","E01005440","Total",644,625,19
"2011","Oldham 034A","E01005372","Total",545,518,27
"2011","Oldham 034B","E01005373","Total",522,507,15
"2011","Oldham 034C","E01005374","Total",634,621,13
"2011","Oldham 034D","E01005375","Total",669,652,17
"2011","Oldham 035A","E01005435","Total",512,490,22
"2011","Oldham 035B","E01005436","Total",545,520,25
"2011","Oldham 035C","E01005460","Total",790,753,37
"2011","Oldham 035D","E01005461","Total",567,536,31
"2011","Oldham 035E","E01005462","Total",576,552,24
"2011","Oldham 035F","E01005463","Total",432,406,26
"2011","Oldham 035G","E01032921","Total",804,771,33
"2011","Rochdale 001A","E01005518","Total",605,591,14
"2011","Rochdale 001B","E01005520","Total",817,811,6
"2011","Rochdale 001C","E01005522","Total",677,658,19
"2011","Rochdale 001D","E01005523","Total",806,800,6
"2011","Rochdale 002A","E01005519","Total",620,615,5
"2011","Rochdale 002B","E01005594","Total",588,582,6
"2011","Rochdale 002C","E01005597","Total",674,672,2
"2011","Rochdale 002D","E01005598","Total",683,675,8
"2011","Rochdale 003A","E01005516","Total",566,552,14
"2011","Rochdale 003B","E01005517","Total",669,651,18
"2011","Rochdale 003C","E01005521","Total",659,627,32
"2011","Rochdale 003D","E01005596","Total",759,753,6
"2011","Rochdale 004A","E01005578","Total",491,489,2
"2011","Rochdale 004B","E01005579","Total",539,538,1
"2011","Rochdale 004C","E01005586","Total",669,664,5
"2011","Rochdale 004D","E01005593","Total",571,569,2
"2011","Rochdale 004E","E01005595","Total",796,792,4
"2011","Rochdale 005A","E01005489","Total",511,503,8
"2011","Rochdale 005B","E01005490","Total",419,410,9
"2011","Rochdale 005C","E01005491","Total",707,697,10
"2011","Rochdale 005D","E01005493","Total",682,669,13
"2011","Rochdale 005E","E01005494","Total",715,704,11
"2011","Rochdale 005F","E01005495","Total",705,684,21
"2011","Rochdale 006A","E01005488","Total",590,581,9
"2011","Rochdale 006B","E01005492","Total",629,614,15
"2011","Rochdale 006C","E01005499","Total",666,649,17
"2011","Rochdale 006D","E01005571","Total",673,653,20
"2011","Rochdale 007A","E01005570","Total",591,572,19
"2011","Rochdale 007B","E01005572","Total",643,638,5
"2011","Rochdale 007C","E01005573","Total",562,561,1
"2011","Rochdale 007D","E01005574","Total",698,680,18
"2011","Rochdale 007E","E01005587","Total",510,508,2
"2011","Rochdale 007F","E01005588","Total",700,688,12
"2011","Rochdale 008A","E01005580","Total",595,585,10
"2011","Rochdale 008B","E01005581","Total",607,599,8
"2011","Rochdale 008D","E01005583","Total",468,464,4
"2011","Rochdale 008F","E01005585","Total",472,463,9
"2011","Rochdale 008G","E01033258","Total",805,795,10
"2011","Rochdale 009A","E01005496","Total",545,537,8
"2011","Rochdale 009B","E01005589","Total",678,653,25
"2011","Rochdale 009C","E01005590","Total",544,527,17
"2011","Rochdale 009D","E01005591","Total",641,626,15
"2011","Rochdale 009E","E01005592","Total",643,615,28
"2011","Rochdale 010A","E01005472","Total",680,663,17
"2011","Rochdale 010B","E01005473","Total",514,492,22
"2011","Rochdale 010C","E01005482","Total",1213,1173,40
"2011","Rochdale 010D","E01005483","Total",846,812,34
"2011","Rochdale 010E","E01005484","Total",935,907,28
"2011","Rochdale 010F","E01005486","Total",604,566,38
"2011","Rochdale 010G","E01005487","Total",589,568,21
"2011","Rochdale 011A","E01005474","Total",486,480,6
"2011","Rochdale 011B","E01005575","Total",739,722,17
"2011","Rochdale 011C","E01005576","Total",568,557,11
"2011","Rochdale 011D","E01005577","Total",663,637,26
"2011","Rochdale 012A","E01005469","Total",736,716,20
"2011","Rochdale 012B","E01005563","Total",660,631,29
"2011","Rochdale 012C","E01005565","Total",571,558,13
"2011","Rochdale 012D","E01005566","Total",860,810,50
"2011","Rochdale 012E","E01005568","Total",657,632,25
"2011","Rochdale 012F","E01005569","Total",663,641,22
"2011","Rochdale 013A","E01005556","Total",693,669,24
"2011","Rochdale 013B","E01005559","Total",706,691,15
"2011","Rochdale 013C","E01005560","Total",724,695,29
"2011","Rochdale 013D","E01005567","Total",662,647,15
"2011","Rochdale 014A","E01005555","Total",542,525,17
"2011","Rochdale 014B","E01005557","Total",514,499,15
"2011","Rochdale 014C","E01005558","Total",725,711,14
"2011","Rochdale 014D","E01005561","Total",608,598,10
"2011","Rochdale 014E","E01005562","Total",709,691,18
"2011","Rochdale 015A","E01005470","Total",498,474,24
"2011","Rochdale 015B","E01005471","Total",592,562,30
"2011","Rochdale 015C","E01005475","Total",623,597,26
"2011","Rochdale 015D","E01005485","Total",638,622,16
"2011","Rochdale 015E","E01005564","Total",669,641,28
"2011","Rochdale 016A","E01005464","Total",653,643,10
"2011","Rochdale 016B","E01005465","Total",791,761,30
"2011","Rochdale 016C","E01005466","Total",1093,1072,21
"2011","Rochdale 016D","E01005467","Total",833,800,33
"2011","Rochdale 016E","E01005468","Total",617,602,15
"2011","Rochdale 017A","E01005476","Total",737,708,29
"2011","Rochdale 017B","E01005477","Total",901,815,86
"2011","Rochdale 017C","E01005478","Total",704,682,22
"2011","Rochdale 017D","E01005479","Total",731,711,20
"2011","Rochdale 017E","E01005480","Total",752,739,13
"2011","Rochdale 017F","E01005481","Total",615,602,13
"2011","Rochdale 018A","E01005497","Total",704,682,22
"2011","Rochdale 018B","E01005501","Total",934,892,42
"2011","Rochdale 018C","E01005502","Total",755,715,40
"2011","Rochdale 018D","E01005504","Total",658,638,20
"2011","Rochdale 018E","E01005505","Total",811,780,31
"2011","Rochdale 018F","E01005509","Total",998,964,34
"2011","Rochdale 019A","E01005510","Total",450,440,10
"2011","Rochdale 019B","E01005511","Total",516,503,13
"2011","Rochdale 019C","E01005512","Total",705,685,20
"2011","Rochdale 019D","E01005513","Total",613,599,14
"2011","Rochdale 019E","E01005514","Total",680,658,22
"2011","Rochdale 019F","E01005515","Total",722,706,16
"2011","Rochdale 020A","E01005498","Total",620,587,33
"2011","Rochdale 020B","E01005500","Total",676,647,29
"2011","Rochdale 020C","E01005503","Total",540,522,18
"2011","Rochdale 020D","E01005506","Total",689,671,18
"2011","Rochdale 020E","E01005507","Total",730,711,19
"2011","Rochdale 020F","E01005508","Total",749,729,20
"2011","Rochdale 021A","E01005524","Total",655,638,17
"2011","Rochdale 021B","E01005525","Total",830,818,12
"2011","Rochdale 021C","E01005526","Total",699,678,21
"2011","Rochdale 021D","E01005528","Total",683,674,9
"2011","Rochdale 021E","E01005536","Total",682,653,29
"2011","Rochdale 021F","E01005543","Total",530,523,7
"2011","Rochdale 022A","E01005527","Total",650,636,14
"2011","Rochdale 022B","E01005529","Total",812,795,17
"2011","Rochdale 022C","E01005551","Total",813,797,16
"2011","Rochdale 022D","E01005552","Total",911,882,29
"2011","Rochdale 022E","E01005553","Total",785,759,26
"2011","Rochdale 022F","E01005554","Total",591,583,8
"2011","Rochdale 023A","E01005534","Total",655,642,13
"2011","Rochdale 023B","E01005535","Total",718,690,28
"2011","Rochdale 023C","E01005537","Total",573,566,7
"2011","Rochdale 023D","E01005538","Total",594,581,13
"2011","Rochdale 023E","E01005540","Total",599,581,18
"2011","Rochdale 023F","E01005541","Total",741,704,37
"2011","Rochdale 023G","E01005542","Total",638,623,15
"2011","Rochdale 024A","E01005533","Total",868,836,32
"2011","Rochdale 024B","E01005539","Total",725,694,31
"2011","Rochdale 024C","E01005546","Total",636,618,18
"2011","Rochdale 024D","E01005547","Total",660,630,30
"2011","Rochdale 024E","E01005548","Total",664,655,9
"2011","Rochdale 025A","E01005530","Total",659,645,14
"2011","Rochdale 025B","E01005531","Total",523,509,14
"2011","Rochdale 025C","E01005532","Total",688,669,19
"2011","Rochdale 025D","E01005544","Total",628,609,19
"2011","Rochdale 025E","E01005545","Total",493,481,12
"2011","Rochdale 025F","E01005549","Total",610,588,22
"2011","Rochdale 025G","E01005550","Total",650,630,20
"2011","Salford 001A","E01005659","Total",658,631,27
"2011","Salford 001B","E01005660","Total",705,675,30
"2011","Salford 001C","E01005663","Total",635,618,17
"2011","Salford 001D","E01005664","Total",652,630,22
"2011","Salford 001E","E01005665","Total",652,629,23
"2011","Salford 002A","E01005703","Total",732,704,28
"2011","Salford 002B","E01005704","Total",614,591,23
"2011","Salford 002C","E01005706","Total",676,655,21
"2011","Salford 002D","E01005708","Total",810,750,60
"2011","Salford 003A","E01005702","Total",953,927,26
"2011","Salford 003B","E01005705","Total",898,869,29
"2011","Salford 003C","E01005707","Total",806,783,23
"2011","Salford 004A","E01005661","Total",749,725,24
"2011","Salford 004B","E01005662","Total",628,617,11
"2011","Salford 004C","E01005709","Total",617,605,12
"2011","Salford 004D","E01005710","Total",620,608,12
"2011","Salford 005A","E01005670","Total",864,822,42
"2011","Salford 005B","E01005672","Total",641,608,33
"2011","Salford 005C","E01005676","Total",568,554,14
"2011","Salford 005D","E01005677","Total",719,696,23
"2011","Salford 006A","E01005686","Total",644,621,23
"2011","Salford 006B","E01005688","Total",676,657,19
"2011","Salford 006C","E01005691","Total",713,697,16
"2011","Salford 006D","E01005692","Total",787,734,53
"2011","Salford 007A","E01005711","Total",673,659,14
"2011","Salford 007B","E01005712","Total",748,728,20
"2011","Salford 007C","E01005713","Total",642,632,10
"2011","Salford 007D","E01005714","Total",629,617,12
"2011","Salford 007E","E01005715","Total",752,724,28
"2011","Salford 007F","E01005718","Total",854,822,32
"2011","Salford 008A","E01005673","Total",670,642,28
"2011","Salford 008B","E01005675","Total",741,712,29
"2011","Salford 008C","E01005678","Total",674,653,21
"2011","Salford 008D","E01005679","Total",696,670,26
"2011","Salford 009A","E01005687","Total",847,800,47
"2011","Salford 009B","E01005689","Total",599,575,24
"2011","Salford 009C","E01005690","Total",706,678,28
"2011","Salford 009D","E01005693","Total",639,611,28
"2011","Salford 010A","E01005646","Total",566,527,39
"2011","Salford 010B","E01005649","Total",732,682,50
"2011","Salford 010C","E01005650","Total",692,597,95
"2011","Salford 010D","E01005651","Total",550,537,13
"2011","Salford 011A","E01005647","Total",714,675,39
"2011","Salford 011B","E01005648","Total",921,861,60
"2011","Salford 011C","E01005652","Total",569,548,21
"2011","Salford 011D","E01005653","Total",657,626,31
"2011","Salford 012A","E01005671","Total",787,745,42
"2011","Salford 012B","E01005674","Total",596,574,22
"2011","Salford 012C","E01005694","Total",695,686,9
"2011","Salford 012D","E01005696","Total",653,626,27
"2011","Salford 012E","E01005698","Total",835,801,34
"2011","Salford 012F","E01005700","Total",692,661,31
"2011","Salford 013A","E01005716","Total",683,668,15
"2011","Salford 013B","E01005717","Total",548,543,5
"2011","Salford 013C","E01005734","Total",644,618,26
"2011","Salford 013D","E01005735","Total",599,579,20
"2011","Salford 013E","E01005736","Total",650,626,24
"2011","Salford 013F","E01005737","Total",628,604,24
"2011","Salford 013G","E01005739","Total",625,614,11
"2011","Salford 014A","E01005695","Total",652,620,32
"2011","Salford 014B","E01005697","Total",690,676,14
"2011","Salford 014C","E01005738","Total",809,768,41
"2011","Salford 014D","E01005740","Total",739,708,31
"2011","Salford 014E","E01005741","Total",706,685,21
"2011","Salford 014F","E01005742","Total",695,673,22
"2011","Salford 015A","E01005625","Total",622,601,21
"2011","Salford 015B","E01005627","Total",488,477,11
"2011","Salford 015C","E01005699","Total",659,639,20
"2011","Salford 015D","E01005701","Total",639,619,20
"2011","Salford 016A","E01005609","Total",870,852,18
"2011","Salford 016B","E01005611","Total",987,898,89
"2011","Salford 016C","E01005612","Total",1057,1031,26
"2011","Salford 016D","E01005613","Total",1023,984,39
"2011","Salford 016E","E01005614","Total",562,529,33
"2011","Salford 016F","E01005615","Total",768,695,73
"2011","Salford 017A","E01005624","Total",695,677,18
"2011","Salford 017B","E01005680","Total",770,723,47
"2011","Salford 017C","E01005683","Total",809,777,32
"2011","Salford 017F","E01032919","Total",1057,976,81
"2011","Salford 018A","E01005622","Total",701,665,36
"2011","Salford 018B","E01005623","Total",521,498,23
"2011","Salford 018C","E01005626","Total",530,507,23
"2011","Salford 018D","E01005628","Total",727,692,35
"2011","Salford 019A","E01005725","Total",580,559,21
"2011","Salford 019B","E01005726","Total",647,615,32
"2011","Salford 019C","E01005727","Total",704,653,51
"2011","Salford 019D","E01005728","Total",614,584,30
"2011","Salford 019E","E01005733","Total",520,503,17
"2011","Salford 020A","E01005631","Total",1074,1021,53
"2011","Salford 020B","E01005632","Total",955,916,39
"2011","Salford 020C","E01005633","Total",605,597,8
"2011","Salford 020D","E01005634","Total",625,601,24
"2011","Salford 020E","E01005635","Total",777,704,73
"2011","Salford 020F","E01005636","Total",718,680,38
"2011","Salford 020G","E01005637","Total",672,628,44
"2011","Salford 021A","E01005629","Total",639,618,21
"2011","Salford 021B","E01005630","Total",676,648,28
"2011","Salford 021C","E01005719","Total",1140,915,225
"2011","Salford 021D","E01005720","Total",1206,1121,85
"2011","Salford 021E","E01005722","Total",747,709,38
"2011","Salford 021F","E01005723","Total",667,639,28
"2011","Salford 021G","E01005724","Total",661,643,18
"2011","Salford 022D","E01005610","Total",484,472,12
"2011","Salford 022E","E01032684","Total",657,631,26
"2011","Salford 022F","E01032687","Total",775,716,59
"2011","Salford 022G","E01032906","Total",767,712,55
"2011","Salford 022H","E01032907","Total",727,659,68
"2011","Salford 022I","E01032909","Total",934,837,97
"2011","Salford 022J","E01032911","Total",802,731,71
"2011","Salford 022K","E01033330","Total",906,875,31
"2011","Salford 023A","E01005654","Total",795,754,41
"2011","Salford 023B","E01005656","Total",687,645,42
"2011","Salford 023C","E01005657","Total",769,709,60
"2011","Salford 023D","E01005721","Total",814,766,48
"2011","Salford 024A","E01005655","Total",758,716,42
"2011","Salford 024B","E01005658","Total",678,662,16
"2011","Salford 024C","E01005681","Total",574,568,6
"2011","Salford 024D","E01005682","Total",1086,1035,51
"2011","Salford 025A","E01005729","Total",796,743,53
"2011","Salford 025B","E01005730","Total",750,711,39
"2011","Salford 025C","E01005731","Total",621,594,27
"2011","Salford 025D","E01005732","Total",573,558,15
"2011","Salford 026A","E01005599","Total",849,809,40
"2011","Salford 026B","E01005600","Total",631,612,19
"2011","Salford 026C","E01005601","Total",693,662,31
"2011","Salford 026D","E01005602","Total",892,775,117
"2011","Salford 027A","E01005603","Total",703,653,50
"2011","Salford 027B","E01005604","Total",738,702,36
"2011","Salford 027C","E01005605","Total",706,668,38
"2011","Salford 027D","E01005638","Total",807,759,48
"2011","Salford 028B","E01005667","Total",909,879,30
"2011","Salford 028E","E01032685","Total",1190,945,245
"2011","Salford 028F","E01032686","Total",1017,880,137
"2011","Salford 028G","E01032912","Total",870,779,91
"2011","Salford 028H","E01032914","Total",1066,943,123
"2011","Salford 028I","E01032915","Total",707,693,14
"2011","Salford 028J","E01032917","Total",615,591,24
"2011","Salford 029A","E01005639","Total",633,605,28
"2011","Salford 029B","E01005640","Total",567,546,21
"2011","Salford 029C","E01005641","Total",665,640,25
"2011","Salford 029D","E01005642","Total",521,512,9
"2011","Salford 029E","E01005643","Total",697,671,26
"2011","Salford 029F","E01005644","Total",642,631,11
"2011","Salford 029G","E01005645","Total",610,603,7
"2011","Salford 030A","E01005616","Total",641,620,21
"2011","Salford 030B","E01005617","Total",644,611,33
"2011","Salford 030C","E01005618","Total",695,666,29
"2011","Salford 030D","E01005619","Total",550,528,22
"2011","Salford 030E","E01005620","Total",1101,1060,41
"2011","Salford 030F","E01005621","Total",821,768,53
"2011","Stockport 001A","E01005886","Total",682,656,26
"2011","Stockport 001B","E01005888","Total",603,592,11
"2011","Stockport 001C","E01005889","Total",713,686,27
"2011","Stockport 001D","E01005891","Total",583,569,14
"2011","Stockport 001E","E01005894","Total",579,573,6
"2011","Stockport 002A","E01005887","Total",614,595,19
"2011","Stockport 002B","E01005890","Total",602,579,23
"2011","Stockport 002C","E01005893","Total",876,837,39
"2011","Stockport 002D","E01005896","Total",803,776,27
"2011","Stockport 002E","E01005919","Total",734,716,18
"2011","Stockport 003A","E01005862","Total",613,604,9
"2011","Stockport 003B","E01005892","Total",565,560,5
"2011","Stockport 003C","E01005895","Total",498,491,7
"2011","Stockport 003D","E01005920","Total",648,636,12
"2011","Stockport 003E","E01005921","Total",708,690,18
"2011","Stockport 003F","E01005922","Total",645,635,10
"2011","Stockport 004A","E01005753","Total",681,672,9
"2011","Stockport 004B","E01005754","Total",961,945,16
"2011","Stockport 004C","E01005755","Total",698,672,26
"2011","Stockport 004D","E01005756","Total",774,764,10
"2011","Stockport 005A","E01005745","Total",604,595,9
"2011","Stockport 005B","E01005746","Total",785,777,8
"2011","Stockport 005C","E01005747","Total",596,587,9
"2011","Stockport 005D","E01005748","Total",672,659,13
"2011","Stockport 006A","E01005863","Total",816,776,40
"2011","Stockport 006B","E01005864","Total",653,624,29
"2011","Stockport 006C","E01005866","Total",878,821,57
"2011","Stockport 006D","E01005869","Total",631,610,21
"2011","Stockport 007A","E01005914","Total",689,675,14
"2011","Stockport 007B","E01005915","Total",748,722,26
"2011","Stockport 007C","E01005916","Total",747,708,39
"2011","Stockport 007D","E01005917","Total",888,847,41
"2011","Stockport 008A","E01005859","Total",662,625,37
"2011","Stockport 008B","E01005865","Total",646,632,14
"2011","Stockport 008C","E01005867","Total",688,660,28
"2011","Stockport 008D","E01005868","Total",596,576,20
"2011","Stockport 009A","E01005743","Total",596,583,13
"2011","Stockport 009B","E01005744","Total",631,605,26
"2011","Stockport 009C","E01005749","Total",752,731,21
"2011","Stockport 009D","E01005750","Total",727,703,24
"2011","Stockport 009E","E01005751","Total",601,586,15
"2011","Stockport 010A","E01005897","Total",610,599,11
"2011","Stockport 010B","E01005898","Total",753,723,30
"2011","Stockport 010C","E01005900","Total",802,770,32
"2011","Stockport 010D","E01005903","Total",644,623,21
"2011","Stockport 010E","E01005904","Total",652,624,28
"2011","Stockport 011A","E01005853","Total",672,655,17
"2011","Stockport 011B","E01005856","Total",678,661,17
"2011","Stockport 011C","E01005860","Total",600,580,20
"2011","Stockport 011D","E01005861","Total",734,714,20
"2011","Stockport 012A","E01005752","Total",642,626,16
"2011","Stockport 012B","E01005899","Total",786,744,42
"2011","Stockport 012C","E01005901","Total",637,621,16
"2011","Stockport 012D","E01005902","Total",759,736,23
"2011","Stockport 012E","E01005905","Total",642,614,28
"2011","Stockport 013A","E01005852","Total",737,695,42
"2011","Stockport 013B","E01005854","Total",758,739,19
"2011","Stockport 013C","E01005855","Total",608,594,14
"2011","Stockport 013D","E01005857","Total",620,595,25
"2011","Stockport 013E","E01005858","Total",821,790,31
"2011","Stockport 014A","E01005757","Total",729,709,20
"2011","Stockport 014B","E01005758","Total",1208,1148,60
"2011","Stockport 014C","E01005766","Total",726,695,31
"2011","Stockport 014D","E01005918","Total",911,894,17
"2011","Stockport 015A","E01005870","Total",619,600,19
"2011","Stockport 015B","E01005871","Total",610,597,13
"2011","Stockport 015C","E01005873","Total",595,578,17
"2011","Stockport 015D","E01005875","Total",669,656,13
"2011","Stockport 016A","E01005764","Total",809,777,32
"2011","Stockport 016B","E01005816","Total",730,699,31
"2011","Stockport 016C","E01005817","Total",671,636,35
"2011","Stockport 016D","E01005822","Total",928,886,42
"2011","Stockport 017A","E01005880","Total",678,643,35
"2011","Stockport 017B","E01005881","Total",511,506,5
"2011","Stockport 017C","E01005883","Total",691,663,28
"2011","Stockport 017D","E01005908","Total",598,575,23
"2011","Stockport 018A","E01005765","Total",589,578,11
"2011","Stockport 018B","E01005818","Total",570,557,13
"2011","Stockport 018C","E01005819","Total",661,651,10
"2011","Stockport 018D","E01005820","Total",664,642,22
"2011","Stockport 018E","E01005821","Total",697,679,18
"2011","Stockport 018F","E01005823","Total",720,696,24
"2011","Stockport 019A","E01005825","Total",708,692,16
"2011","Stockport 019B","E01005872","Total",826,802,24
"2011","Stockport 019C","E01005874","Total",942,924,18
"2011","Stockport 019D","E01005876","Total",623,610,13
"2011","Stockport 019E","E01005877","Total",632,617,15
"2011","Stockport 020A","E01005878","Total",644,637,7
"2011","Stockport 020B","E01005879","Total",620,592,28
"2011","Stockport 020C","E01005882","Total",497,489,8
"2011","Stockport 020D","E01005884","Total",607,585,22
"2011","Stockport 020E","E01005885","Total",686,637,49
"2011","Stockport 021A","E01005832","Total",653,623,30
"2011","Stockport 021B","E01005833","Total",471,464,7
"2011","Stockport 021C","E01005835","Total",584,564,20
"2011","Stockport 021D","E01005837","Total",685,672,13
"2011","Stockport 021E","E01005843","Total",625,619,6
"2011","Stockport 022A","E01005769","Total",693,663,30
"2011","Stockport 022B","E01005778","Total",665,641,24
"2011","Stockport 022C","E01005779","Total",602,580,22
"2011","Stockport 022D","E01005780","Total",575,557,18
"2011","Stockport 022E","E01005781","Total",846,820,26
"2011","Stockport 023A","E01005759","Total",707,690,17
"2011","Stockport 023B","E01005760","Total",895,848,47
"2011","Stockport 023C","E01005797","Total",701,670,31
"2011","Stockport 023D","E01005800","Total",715,693,22
"2011","Stockport 023E","E01005804","Total",495,481,14
"2011","Stockport 024A","E01005824","Total",629,610,19
"2011","Stockport 024B","E01005826","Total",612,597,15
"2011","Stockport 024C","E01005827","Total",611,598,13
"2011","Stockport 024D","E01005828","Total",599,586,13
"2011","Stockport 024E","E01005829","Total",507,498,9
"2011","Stockport 025A","E01005768","Total",647,615,32
"2011","Stockport 025B","E01005770","Total",672,629,43
"2011","Stockport 025C","E01005771","Total",565,545,20
"2011","Stockport 025D","E01005775","Total",642,624,18
"2011","Stockport 026A","E01005761","Total",563,550,13
"2011","Stockport 026B","E01005762","Total",675,664,11
"2011","Stockport 026C","E01005763","Total",665,648,17
"2011","Stockport 026D","E01005799","Total",726,701,25
"2011","Stockport 027A","E01005798","Total",840,787,53
"2011","Stockport 027B","E01005801","Total",667,634,33
"2011","Stockport 027C","E01005802","Total",618,597,21
"2011","Stockport 027D","E01005803","Total",619,602,17
"2011","Stockport 027E","E01005830","Total",736,707,29
"2011","Stockport 027F","E01005831","Total",687,664,23
"2011","Stockport 028A","E01005767","Total",615,591,24
"2011","Stockport 028B","E01005772","Total",603,573,30
"2011","Stockport 028C","E01005773","Total",661,635,26
"2011","Stockport 028D","E01005774","Total",702,684,18
"2011","Stockport 028E","E01005776","Total",619,598,21
"2011","Stockport 029A","E01005909","Total",662,645,17
"2011","Stockport 029B","E01005910","Total",740,707,33
"2011","Stockport 029C","E01005911","Total",553,540,13
"2011","Stockport 029D","E01005912","Total",633,610,23
"2011","Stockport 030A","E01005782","Total",560,552,8
"2011","Stockport 030B","E01005783","Total",672,654,18
"2011","Stockport 030C","E01005784","Total",546,529,17
"2011","Stockport 030D","E01005785","Total",662,641,21
"2011","Stockport 030E","E01005786","Total",628,610,18
"2011","Stockport 031A","E01005834","Total",642,631,11
"2011","Stockport 031B","E01005836","Total",891,851,40
"2011","Stockport 031C","E01005838","Total",969,852,117
"2011","Stockport 031D","E01005840","Total",784,732,52
"2011","Stockport 032A","E01005927","Total",496,491,5
"2011","Stockport 032B","E01005928","Total",694,674,20
"2011","Stockport 032C","E01005929","Total",633,610,23
"2011","Stockport 032D","E01005930","Total",623,600,23
"2011","Stockport 033A","E01005806","Total",505,495,10
"2011","Stockport 033B","E01005813","Total",627,612,15
"2011","Stockport 033C","E01005814","Total",557,547,10
"2011","Stockport 033D","E01005815","Total",599,586,13
"2011","Stockport 034A","E01005777","Total",693,682,11
"2011","Stockport 034B","E01005787","Total",479,474,5
"2011","Stockport 034C","E01005788","Total",625,603,22
"2011","Stockport 034D","E01005790","Total",522,511,11
"2011","Stockport 035A","E01005805","Total",600,591,9
"2011","Stockport 035B","E01005807","Total",638,623,15
"2011","Stockport 035C","E01005839","Total",529,522,7
"2011","Stockport 035D","E01005841","Total",641,625,16
"2011","Stockport 036A","E01005844","Total",576,553,23
"2011","Stockport 036B","E01005845","Total",626,604,22
"2011","Stockport 036C","E01005849","Total",616,607,9
"2011","Stockport 036D","E01005851","Total",626,611,15
"2011","Stockport 037A","E01005808","Total",536,526,10
"2011","Stockport 037B","E01005809","Total",511,498,13
"2011","Stockport 037C","E01005810","Total",681,658,23
"2011","Stockport 037D","E01005811","Total",651,636,15
"2011","Stockport 037E","E01005812","Total",496,479,17
"2011","Stockport 038A","E01005842","Total",685,673,12
"2011","Stockport 038B","E01005906","Total",664,646,18
"2011","Stockport 038C","E01005907","Total",637,609,28
"2011","Stockport 038D","E01005913","Total",661,649,12
"2011","Stockport 039A","E01005789","Total",688,655,33
"2011","Stockport 039B","E01005791","Total",659,647,12
"2011","Stockport 039C","E01005793","Total",635,621,14
"2011","Stockport 039D","E01005795","Total",535,527,8
"2011","Stockport 039E","E01005796","Total",502,497,5
"2011","Stockport 040A","E01005846","Total",633,614,19
"2011","Stockport 040B","E01005847","Total",643,619,24
"2011","Stockport 040C","E01005848","Total",772,730,42
"2011","Stockport 040D","E01005850","Total",783,759,24
"2011","Stockport 041A","E01005792","Total",615,603,12
"2011","Stockport 041B","E01005794","Total",515,504,11
"2011","Stockport 041C","E01005923","Total",629,626,3
"2011","Stockport 041D","E01005931","Total",661,643,18
"2011","Stockport 042A","E01005924","Total",541,528,13
"2011","Stockport 042B","E01005925","Total",639,612,27
"2011","Stockport 042C","E01005926","Total",515,485,30
"2011","Stockport 042D","E01005932","Total",539,535,4
"2011","Tameside 001A","E01006053","Total",867,818,49
"2011","Tameside 001B","E01006054","Total",786,759,27
"2011","Tameside 001C","E01006055","Total",679,639,40
"2011","Tameside 001D","E01006057","Total",675,644,31
"2011","Tameside 001E","E01006058","Total",1024,945,79
"2011","Tameside 001F","E01006059","Total",654,612,42
"2011","Tameside 002A","E01005938","Total",691,670,21
"2011","Tameside 002B","E01005939","Total",506,494,12
"2011","Tameside 002C","E01005940","Total",621,596,25
"2011","Tameside 002D","E01005955","Total",645,632,13
"2011","Tameside 003A","E01006056","Total",527,507,20
"2011","Tameside 003B","E01006061","Total",985,962,23
"2011","Tameside 003C","E01006062","Total",825,813,12
"2011","Tameside 003D","E01006063","Total",576,564,12
"2011","Tameside 004A","E01005936","Total",662,637,25
"2011","Tameside 004B","E01005937","Total",719,692,27
"2011","Tameside 004C","E01005945","Total",777,743,34
"2011","Tameside 004D","E01005946","Total",715,676,39
"2011","Tameside 004E","E01005947","Total",859,756,103
"2011","Tameside 005A","E01005954","Total",806,777,29
"2011","Tameside 005B","E01005956","Total",599,578,21
"2011","Tameside 005C","E01005957","Total",622,589,33
"2011","Tameside 005D","E01005958","Total",686,659,27
"2011","Tameside 005E","E01005959","Total",680,655,25
"2011","Tameside 006A","E01005933","Total",563,548,15
"2011","Tameside 006B","E01005934","Total",641,614,27
"2011","Tameside 006C","E01005935","Total",683,656,27
"2011","Tameside 006D","E01005949","Total",758,715,43
"2011","Tameside 006E","E01005960","Total",770,723,47
"2011","Tameside 007A","E01005941","Total",790,731,59
"2011","Tameside 007B","E01005942","Total",743,701,42
"2011","Tameside 007C","E01005943","Total",895,828,67
"2011","Tameside 007D","E01005944","Total",582,554,28
"2011","Tameside 008A","E01006060","Total",735,687,48
"2011","Tameside 008B","E01006064","Total",754,724,30
"2011","Tameside 008C","E01006065","Total",515,500,15
"2011","Tameside 008D","E01006066","Total",627,598,29
"2011","Tameside 009A","E01006067","Total",736,727,9
"2011","Tameside 009B","E01006068","Total",877,834,43
"2011","Tameside 009C","E01006069","Total",677,650,27
"2011","Tameside 009D","E01006073","Total",765,721,44
"2011","Tameside 010A","E01005993","Total",631,615,16
"2011","Tameside 010B","E01005995","Total",515,508,7
"2011","Tameside 010C","E01005996","Total",836,804,32
"2011","Tameside 010D","E01005997","Total",705,673,32
"2011","Tameside 010E","E01006000","Total",864,822,42
"2011","Tameside 011A","E01005994","Total",634,605,29
"2011","Tameside 011B","E01005999","Total",929,840,89
"2011","Tameside 011C","E01006002","Total",585,560,25
"2011","Tameside 011D","E01006004","Total",628,603,25
"2011","Tameside 011E","E01006005","Total",663,634,29
"2011","Tameside 011F","E01006007","Total",681,655,26
"2011","Tameside 012A","E01005998","Total",775,729,46
"2011","Tameside 012B","E01006001","Total",690,647,43
"2011","Tameside 012C","E01006003","Total",650,617,33
"2011","Tameside 012D","E01006006","Total",645,604,41
"2011","Tameside 013A","E01005948","Total",1069,959,110
"2011","Tameside 013B","E01005950","Total",637,584,53
"2011","Tameside 013C","E01005951","Total",800,731,69
"2011","Tameside 013D","E01005952","Total",1230,1181,49
"2011","Tameside 013E","E01005953","Total",853,797,56
"2011","Tameside 014A","E01005961","Total",630,562,68
"2011","Tameside 014B","E01005962","Total",617,597,20
"2011","Tameside 014C","E01005968","Total",639,628,11
"2011","Tameside 014D","E01005969","Total",594,573,21
"2011","Tameside 015A","E01006022","Total",854,790,64
"2011","Tameside 015B","E01006023","Total",823,790,33
"2011","Tameside 015C","E01006070","Total",648,628,20
"2011","Tameside 015D","E01006071","Total",678,650,28
"2011","Tameside 015E","E01006072","Total",680,671,9
"2011","Tameside 016A","E01006009","Total",596,569,27
"2011","Tameside 016B","E01006017","Total",560,536,24
"2011","Tameside 016C","E01006018","Total",586,560,26
"2011","Tameside 016D","E01006021","Total",633,610,23
"2011","Tameside 017A","E01006008","Total",634,615,19
"2011","Tameside 017B","E01006010","Total",692,671,21
"2011","Tameside 017C","E01006012","Total",814,777,37
"2011","Tameside 017D","E01006015","Total",536,531,5
"2011","Tameside 017E","E01006016","Total",1062,979,83
"2011","Tameside 018A","E01006011","Total",705,682,23
"2011","Tameside 018B","E01006013","Total",566,548,18
"2011","Tameside 018C","E01006014","Total",501,478,23
"2011","Tameside 018D","E01006019","Total",821,803,18
"2011","Tameside 018E","E01006020","Total",620,607,13
"2011","Tameside 019A","E01005963","Total",522,509,13
"2011","Tameside 019B","E01005964","Total",681,660,21
"2011","Tameside 019C","E01005965","Total",679,662,17
"2011","Tameside 019D","E01005966","Total",556,539,17
"2011","Tameside 019E","E01005967","Total",716,694,22
"2011","Tameside 020A","E01006031","Total",679,661,18
"2011","Tameside 020B","E01006032","Total",562,547,15
"2011","Tameside 020C","E01006033","Total",669,635,34
"2011","Tameside 020D","E01006034","Total",950,931,19
"2011","Tameside 020E","E01006035","Total",993,954,39
"2011","Tameside 020F","E01006036","Total",841,819,22
"2011","Tameside 021A","E01005970","Total",663,652,11
"2011","Tameside 021B","E01005972","Total",781,737,44
"2011","Tameside 021C","E01005974","Total",791,742,49
"2011","Tameside 021D","E01005975","Total",706,680,26
"2011","Tameside 022A","E01006024","Total",697,675,22
"2011","Tameside 022B","E01006026","Total",766,744,22
"2011","Tameside 022C","E01006037","Total",620,605,15
"2011","Tameside 022D","E01006038","Total",669,655,14
"2011","Tameside 023A","E01006047","Total",615,572,43
"2011","Tameside 023B","E01006048","Total",772,729,43
"2011","Tameside 023C","E01006049","Total",775,714,61
"2011","Tameside 023D","E01006051","Total",779,735,44
"2011","Tameside 024A","E01005985","Total",730,709,21
"2011","Tameside 024B","E01005987","Total",735,711,24
"2011","Tameside 024C","E01005988","Total",652,636,16
"2011","Tameside 024D","E01005990","Total",651,620,31
"2011","Tameside 024E","E01005991","Total",644,617,27
"2011","Tameside 025A","E01005971","Total",652,632,20
"2011","Tameside 025B","E01005986","Total",550,531,19
"2011","Tameside 025C","E01005989","Total",523,512,11
"2011","Tameside 025D","E01005992","Total",617,592,25
"2011","Tameside 026A","E01005973","Total",614,597,17
"2011","Tameside 026B","E01005976","Total",640,624,16
"2011","Tameside 026C","E01005977","Total",678,658,20
"2011","Tameside 026D","E01005978","Total",617,605,12
"2011","Tameside 027A","E01006025","Total",615,593,22
"2011","Tameside 027B","E01006027","Total",644,621,23
"2011","Tameside 027C","E01006050","Total",822,797,25
"2011","Tameside 027D","E01006052","Total",676,661,15
"2011","Tameside 028A","E01006028","Total",918,883,35
"2011","Tameside 028B","E01006029","Total",754,718,36
"2011","Tameside 028C","E01006030","Total",776,748,28
"2011","Tameside 028D","E01006039","Total",458,440,18
"2011","Tameside 028E","E01006040","Total",600,564,36
"2011","Tameside 028F","E01006041","Total",735,662,73
"2011","Tameside 029A","E01005979","Total",795,777,18
"2011","Tameside 029B","E01005980","Total",659,641,18
"2011","Tameside 029C","E01005981","Total",815,791,24
"2011","Tameside 029D","E01005982","Total",597,583,14
"2011","Tameside 029E","E01005983","Total",728,707,21
"2011","Tameside 029F","E01005984","Total",788,773,15
"2011","Tameside 030A","E01006042","Total",810,770,40
"2011","Tameside 030B","E01006043","Total",623,606,17
"2011","Tameside 030C","E01006044","Total",629,612,17
"2011","Tameside 030D","E01006045","Total",561,542,19
"2011","Tameside 030E","E01006046","Total",641,618,23
"2011","Trafford 001A","E01006109","Total",802,781,21
"2011","Trafford 001B","E01006110","Total",696,671,25
"2011","Trafford 001C","E01006111","Total",579,568,11
"2011","Trafford 001D","E01006112","Total",577,561,16
"2011","Trafford 001E","E01006185","Total",1052,1015,37
"2011","Trafford 001F","E01006188","Total",577,566,11
"2011","Trafford 002A","E01006116","Total",546,536,10
"2011","Trafford 002B","E01006117","Total",654,637,17
"2011","Trafford 002C","E01006118","Total",621,608,13
"2011","Trafford 002D","E01006119","Total",643,636,7
"2011","Trafford 002E","E01006121","Total",622,614,8
"2011","Trafford 003A","E01006141","Total",591,585,6
"2011","Trafford 003B","E01006186","Total",828,792,36
"2011","Trafford 003C","E01006187","Total",1198,1156,42
"2011","Trafford 003D","E01006189","Total",951,918,33
"2011","Trafford 004A","E01006113","Total",477,468,9
"2011","Trafford 004B","E01006114","Total",593,574,19
"2011","Trafford 004C","E01006115","Total",645,632,13
"2011","Trafford 004D","E01006145","Total",698,677,21
"2011","Trafford 004E","E01006146","Total",674,658,16
"2011","Trafford 005A","E01006122","Total",686,672,14
"2011","Trafford 005B","E01006123","Total",667,659,8
"2011","Trafford 005C","E01006124","Total",611,596,15
"2011","Trafford 005D","E01006128","Total",739,720,19
"2011","Trafford 005E","E01006131","Total",657,646,11
"2011","Trafford 006A","E01006155","Total",688,676,12
"2011","Trafford 006B","E01006157","Total",629,609,20
"2011","Trafford 006C","E01006159","Total",727,715,12
"2011","Trafford 006D","E01006182","Total",610,598,12
"2011","Trafford 006E","E01006183","Total",659,632,27
"2011","Trafford 007A","E01006125","Total",636,602,34
"2011","Trafford 007B","E01006126","Total",741,711,30
"2011","Trafford 007C","E01006127","Total",639,631,8
"2011","Trafford 007D","E01006130","Total",767,752,15
"2011","Trafford 007E","E01006132","Total",694,673,21
"2011","Trafford 008A","E01006156","Total",697,676,21
"2011","Trafford 008B","E01006158","Total",801,772,29
"2011","Trafford 008C","E01006179","Total",878,854,24
"2011","Trafford 008D","E01006184","Total",746,731,15
"2011","Trafford 009A","E01006198","Total",675,667,8
"2011","Trafford 009B","E01006199","Total",756,742,14
"2011","Trafford 009C","E01006200","Total",678,671,7
"2011","Trafford 009D","E01006201","Total",674,657,17
"2011","Trafford 009E","E01006202","Total",641,626,15
"2011","Trafford 010A","E01006120","Total",573,560,13
"2011","Trafford 010B","E01006129","Total",641,632,9
"2011","Trafford 010C","E01006133","Total",676,664,12
"2011","Trafford 010D","E01006197","Total",615,600,15
"2011","Trafford 010E","E01006203","Total",529,516,13
"2011","Trafford 011A","E01006142","Total",776,751,25
"2011","Trafford 011B","E01006143","Total",723,709,14
"2011","Trafford 011C","E01006144","Total",747,718,29
"2011","Trafford 011D","E01006180","Total",827,794,33
"2011","Trafford 011E","E01006181","Total",692,656,36
"2011","Trafford 012A","E01006147","Total",549,542,7
"2011","Trafford 012B","E01006149","Total",684,659,25
"2011","Trafford 012C","E01006150","Total",737,709,28
"2011","Trafford 012D","E01006154","Total",654,634,20
"2011","Trafford 012E","E01006165","Total",893,874,19
"2011","Trafford 013A","E01006166","Total",716,705,11
"2011","Trafford 013B","E01006169","Total",697,683,14
"2011","Trafford 013C","E01006170","Total",699,687,12
"2011","Trafford 013D","E01006171","Total",814,799,15
"2011","Trafford 014A","E01006098","Total",525,515,10
"2011","Trafford 014B","E01006099","Total",577,558,19
"2011","Trafford 014C","E01006164","Total",743,727,16
"2011","Trafford 014D","E01006174","Total",849,815,34
"2011","Trafford 014E","E01006178","Total",798,781,17
"2011","Trafford 015A","E01006097","Total",885,852,33
"2011","Trafford 015B","E01006160","Total",1005,963,42
"2011","Trafford 015C","E01006161","Total",962,900,62
"2011","Trafford 015D","E01006162","Total",736,701,35
"2011","Trafford 015E","E01006163","Total",849,826,23
"2011","Trafford 016A","E01006148","Total",723,690,33
"2011","Trafford 016B","E01006151","Total",589,562,27
"2011","Trafford 016C","E01006152","Total",634,621,13
"2011","Trafford 016D","E01006153","Total",648,637,11
"2011","Trafford 016E","E01006172","Total",688,678,10
"2011","Trafford 017A","E01006104","Total",763,747,16
"2011","Trafford 017B","E01006105","Total",792,777,15
"2011","Trafford 017C","E01006106","Total",632,617,15
"2011","Trafford 017D","E01006107","Total",749,723,26
"2011","Trafford 017E","E01006108","Total",689,680,9
"2011","Trafford 018A","E01006102","Total",586,574,12
"2011","Trafford 018B","E01006173","Total",619,606,13
"2011","Trafford 018C","E01006175","Total",762,749,13
"2011","Trafford 018D","E01006176","Total",776,757,19
"2011","Trafford 018E","E01006177","Total",624,613,11
"2011","Trafford 019A","E01006091","Total",1022,980,42
"2011","Trafford 019B","E01006092","Total",523,515,8
"2011","Trafford 019C","E01006095","Total",696,682,14
"2011","Trafford 019D","E01006167","Total",783,772,11
"2011","Trafford 019E","E01006168","Total",850,837,13
"2011","Trafford 020A","E01006090","Total",930,906,24
"2011","Trafford 020B","E01006094","Total",619,593,26
"2011","Trafford 020C","E01006096","Total",580,559,21
"2011","Trafford 020D","E01006100","Total",632,611,21
"2011","Trafford 020E","E01006103","Total",613,602,11
"2011","Trafford 021A","E01006101","Total",565,557,8
"2011","Trafford 021B","E01006190","Total",663,647,16
"2011","Trafford 021C","E01006195","Total",674,658,16
"2011","Trafford 021D","E01006196","Total",706,692,14
"2011","Trafford 021E","E01006210","Total",686,675,11
"2011","Trafford 022A","E01006204","Total",710,692,18
"2011","Trafford 022B","E01006206","Total",797,776,21
"2011","Trafford 022C","E01006207","Total",813,795,18
"2011","Trafford 022D","E01006208","Total",664,653,11
"2011","Trafford 022E","E01006211","Total",654,642,12
"2011","Trafford 023A","E01006093","Total",627,608,19
"2011","Trafford 023B","E01006191","Total",660,645,15
"2011","Trafford 023C","E01006192","Total",654,632,22
"2011","Trafford 023D","E01006205","Total",576,563,13
"2011","Trafford 023E","E01006209","Total",660,630,30
"2011","Trafford 024A","E01006078","Total",890,856,34
"2011","Trafford 024B","E01006080","Total",855,788,67
"2011","Trafford 024C","E01006089","Total",656,632,24
"2011","Trafford 024D","E01006193","Total",638,624,14
"2011","Trafford 024E","E01006194","Total",1003,983,20
"2011","Trafford 025A","E01006074","Total",631,619,12
"2011","Trafford 025B","E01006075","Total",941,887,54
"2011","Trafford 025C","E01006076","Total",843,779,64
"2011","Trafford 025D","E01006079","Total",904,879,25
"2011","Trafford 025E","E01006087","Total",613,584,29
"2011","Trafford 026A","E01006083","Total",501,488,13
"2011","Trafford 026B","E01006084","Total",671,641,30
"2011","Trafford 026C","E01006088","Total",670,654,16
"2011","Trafford 026D","E01006139","Total",736,709,27
"2011","Trafford 026E","E01006140","Total",654,639,15
"2011","Trafford 027A","E01006077","Total",818,776,42
"2011","Trafford 027B","E01006081","Total",524,503,21
"2011","Trafford 027C","E01006082","Total",726,675,51
"2011","Trafford 027D","E01006085","Total",646,622,24
"2011","Trafford 027E","E01006086","Total",696,675,21
"2011","Trafford 028A","E01006134","Total",568,528,40
"2011","Trafford 028B","E01006135","Total",644,619,25
"2011","Trafford 028C","E01006136","Total",644,614,30
"2011","Trafford 028D","E01006137","Total",514,492,22
"2011","Trafford 028E","E01006138","Total",822,794,28
"2011","Wigan 001A","E01006315","Total",530,518,12
"2011","Wigan 001B","E01006316","Total",645,618,27
"2011","Wigan 001C","E01006317","Total",686,662,24
"2011","Wigan 001D","E01006319","Total",536,523,13
"2011","Wigan 002A","E01006229","Total",692,669,23
"2011","Wigan 002B","E01006230","Total",598,584,14
"2011","Wigan 002C","E01006233","Total",572,555,17
"2011","Wigan 002D","E01006237","Total",615,603,12
"2011","Wigan 002E","E01006238","Total",788,762,26
"2011","Wigan 003A","E01006259","Total",557,542,15
"2011","Wigan 003B","E01006312","Total",638,618,20
"2011","Wigan 003C","E01006313","Total",469,458,11
"2011","Wigan 003D","E01006314","Total",767,740,27
"2011","Wigan 003E","E01006318","Total",638,627,11
"2011","Wigan 003F","E01006320","Total",574,560,14
"2011","Wigan 003G","E01006321","Total",714,703,11
"2011","Wigan 004A","E01006231","Total",641,620,21
"2011","Wigan 004B","E01006232","Total",814,761,53
"2011","Wigan 004C","E01006234","Total",544,536,8
"2011","Wigan 004D","E01006235","Total",714,698,16
"2011","Wigan 005A","E01006253","Total",696,666,30
"2011","Wigan 005B","E01006254","Total",657,634,23
"2011","Wigan 005C","E01006255","Total",675,655,20
"2011","Wigan 005D","E01006256","Total",623,606,17
"2011","Wigan 005E","E01006260","Total",652,638,14
"2011","Wigan 006A","E01006370","Total",940,834,106
"2011","Wigan 006B","E01006372","Total",689,660,29
"2011","Wigan 006C","E01006373","Total",667,642,25
"2011","Wigan 006D","E01006374","Total",713,693,20
"2011","Wigan 006E","E01006390","Total",726,699,27
"2011","Wigan 007A","E01006236","Total",684,660,24
"2011","Wigan 007B","E01006388","Total",774,744,30
"2011","Wigan 007C","E01006389","Total",518,512,6
"2011","Wigan 007D","E01006391","Total",679,667,12
"2011","Wigan 008A","E01006257","Total",552,532,20
"2011","Wigan 008B","E01006258","Total",748,715,33
"2011","Wigan 008C","E01006369","Total",1003,910,93
"2011","Wigan 008D","E01006371","Total",685,661,24
"2011","Wigan 008E","E01006375","Total",754,674,80
"2011","Wigan 009A","E01006306","Total",903,861,42
"2011","Wigan 009B","E01006307","Total",662,635,27
"2011","Wigan 009C","E01006386","Total",1011,984,27
"2011","Wigan 009D","E01006387","Total",568,539,29
"2011","Wigan 009E","E01006392","Total",637,622,15
"2011","Wigan 010A","E01006350","Total",758,742,16
"2011","Wigan 010B","E01006351","Total",950,930,20
"2011","Wigan 010C","E01006357","Total",676,654,22
"2011","Wigan 010D","E01006360","Total",739,729,10
"2011","Wigan 010E","E01006361","Total",727,690,37
"2011","Wigan 011A","E01006356","Total",623,608,15
"2011","Wigan 011B","E01006396","Total",587,566,21
"2011","Wigan 011C","E01006397","Total",599,576,23
"2011","Wigan 011D","E01006398","Total",522,507,15
"2011","Wigan 011E","E01006399","Total",735,701,34
"2011","Wigan 012A","E01006305","Total",737,707,30
"2011","Wigan 012B","E01006308","Total",729,684,45
"2011","Wigan 012C","E01006309","Total",660,633,27
"2011","Wigan 012D","E01006310","Total",737,698,39
"2011","Wigan 012E","E01006311","Total",677,650,27
"2011","Wigan 013A","E01006269","Total",756,735,21
"2011","Wigan 013B","E01006271","Total",768,742,26
"2011","Wigan 013C","E01006272","Total",770,701,69
"2011","Wigan 013D","E01006273","Total",688,662,26
"2011","Wigan 013E","E01006276","Total",915,868,47
"2011","Wigan 014A","E01006353","Total",696,656,40
"2011","Wigan 014B","E01006354","Total",673,648,25
"2011","Wigan 014C","E01006355","Total",718,694,24
"2011","Wigan 014D","E01006358","Total",841,805,36
"2011","Wigan 014E","E01006359","Total",625,610,15
"2011","Wigan 015A","E01006349","Total",934,886,48
"2011","Wigan 015B","E01006352","Total",800,754,46
"2011","Wigan 015C","E01006404","Total",736,703,33
"2011","Wigan 015D","E01006405","Total",673,646,27
"2011","Wigan 015E","E01006411","Total",865,834,31
"2011","Wigan 016A","E01006270","Total",681,664,17
"2011","Wigan 016B","E01006274","Total",706,663,43
"2011","Wigan 016C","E01006275","Total",680,654,26
"2011","Wigan 016D","E01006277","Total",644,628,16
"2011","Wigan 016E","E01006286","Total",658,642,16
"2011","Wigan 017A","E01006239","Total",1047,1008,39
"2011","Wigan 017B","E01006240","Total",645,629,16
"2011","Wigan 017C","E01006241","Total",788,762,26
"2011","Wigan 017D","E01006287","Total",490,478,12
"2011","Wigan 017E","E01006289","Total",894,863,31
"2011","Wigan 018A","E01006362","Total",766,748,18
"2011","Wigan 018B","E01006363","Total",749,725,24
"2011","Wigan 018C","E01006364","Total",830,814,16
"2011","Wigan 018D","E01006365","Total",842,820,22
"2011","Wigan 018E","E01006366","Total",809,798,11
"2011","Wigan 018F","E01006367","Total",728,699,29
"2011","Wigan 018G","E01006368","Total",734,716,18
"2011","Wigan 019A","E01006278","Total",718,697,21
"2011","Wigan 019B","E01006279","Total",628,613,15
"2011","Wigan 019C","E01006280","Total",657,627,30
"2011","Wigan 019D","E01006281","Total",750,725,25
"2011","Wigan 019E","E01006285","Total",733,714,19
"2011","Wigan 020A","E01006406","Total",645,626,19
"2011","Wigan 020B","E01006407","Total",603,591,12
"2011","Wigan 020C","E01006408","Total",654,644,10
"2011","Wigan 020D","E01006409","Total",597,590,7
"2011","Wigan 020E","E01006410","Total",540,538,2
"2011","Wigan 021A","E01006393","Total",618,605,13
"2011","Wigan 021B","E01006394","Total",660,648,12
"2011","Wigan 021C","E01006395","Total",872,859,13
"2011","Wigan 021D","E01006400","Total",509,504,5
"2011","Wigan 021E","E01006401","Total",579,565,14
"2011","Wigan 021F","E01006402","Total",476,471,5
"2011","Wigan 021G","E01006403","Total",691,682,9
"2011","Wigan 022A","E01006290","Total",638,619,19
"2011","Wigan 022B","E01006291","Total",707,676,31
"2011","Wigan 022C","E01006292","Total",661,648,13
"2011","Wigan 022D","E01006293","Total",773,729,44
"2011","Wigan 023A","E01006242","Total",792,760,32
"2011","Wigan 023B","E01006243","Total",934,876,58
"2011","Wigan 023C","E01006244","Total",933,848,85
"2011","Wigan 023D","E01006245","Total",1124,1081,43
"2011","Wigan 024A","E01006213","Total",767,710,57
"2011","Wigan 024B","E01006215","Total",788,735,53
"2011","Wigan 024C","E01006217","Total",977,934,43
"2011","Wigan 024D","E01006218","Total",944,864,80
"2011","Wigan 024E","E01006219","Total",544,523,21
"2011","Wigan 025A","E01006288","Total",755,736,19
"2011","Wigan 025B","E01006294","Total",989,909,80
"2011","Wigan 025C","E01006295","Total",870,803,67
"2011","Wigan 025D","E01006377","Total",675,667,8
"2011","Wigan 025E","E01006378","Total",611,591,20
"2011","Wigan 026A","E01006212","Total",587,570,17
"2011","Wigan 026B","E01006214","Total",644,596,48
"2011","Wigan 026C","E01006216","Total",915,883,32
"2011","Wigan 026D","E01006322","Total",710,677,33
"2011","Wigan 026E","E01006329","Total",506,476,30
"2011","Wigan 027A","E01006282","Total",708,686,22
"2011","Wigan 027B","E01006283","Total",705,682,23
"2011","Wigan 027C","E01006284","Total",677,649,28
"2011","Wigan 027D","E01006336","Total",741,734,7
"2011","Wigan 027E","E01006337","Total",670,658,12
"2011","Wigan 028A","E01006376","Total",716,694,22
"2011","Wigan 028B","E01006381","Total",733,709,24
"2011","Wigan 028C","E01006382","Total",522,517,5
"2011","Wigan 028D","E01006383","Total",642,636,6
"2011","Wigan 028E","E01006384","Total",610,601,9
"2011","Wigan 029A","E01006250","Total",688,676,12
"2011","Wigan 029B","E01006251","Total",636,604,32
"2011","Wigan 029C","E01006379","Total",698,689,9
"2011","Wigan 029D","E01006380","Total",765,746,19
"2011","Wigan 029E","E01006385","Total",617,611,6
"2011","Wigan 030A","E01006328","Total",729,680,49
"2011","Wigan 030B","E01006333","Total",935,843,92
"2011","Wigan 030C","E01006334","Total",916,837,79
"2011","Wigan 030D","E01006338","Total",775,735,40
"2011","Wigan 031A","E01006248","Total",817,796,21
"2011","Wigan 031B","E01006249","Total",666,642,24
"2011","Wigan 031C","E01006330","Total",690,668,22
"2011","Wigan 031D","E01006331","Total",652,640,12
"2011","Wigan 031E","E01006332","Total",885,856,29
"2011","Wigan 032A","E01006262","Total",640,623,17
"2011","Wigan 032B","E01006263","Total",655,641,14
"2011","Wigan 032C","E01006266","Total",651,626,25
"2011","Wigan 032D","E01006267","Total",812,790,22
"2011","Wigan 032E","E01006268","Total",744,717,27
"2011","Wigan 033A","E01006323","Total",669,638,31
"2011","Wigan 033B","E01006324","Total",655,614,41
"2011","Wigan 033C","E01006325","Total",641,628,13
"2011","Wigan 033D","E01006326","Total",688,659,29
"2011","Wigan 033E","E01006327","Total",628,620,8
"2011","Wigan 034A","E01006246","Total",761,732,29
"2011","Wigan 034B","E01006247","Total",579,555,24
"2011","Wigan 034C","E01006252","Total",651,639,12
"2011","Wigan 034D","E01006297","Total",793,772,21
"2011","Wigan 034E","E01006335","Total",828,777,51
"2011","Wigan 035A","E01006220","Total",803,768,35
"2011","Wigan 035B","E01006221","Total",724,695,29
"2011","Wigan 035C","E01006222","Total",650,644,6
"2011","Wigan 035D","E01006224","Total",526,518,8
"2011","Wigan 035E","E01006226","Total",767,750,17
"2011","Wigan 036A","E01006223","Total",756,717,39
"2011","Wigan 036B","E01006225","Total",669,645,24
"2011","Wigan 036C","E01006261","Total",672,655,17
"2011","Wigan 036D","E01006264","Total",528,523,5
"2011","Wigan 036E","E01006265","Total",639,619,20
"2011","Wigan 037A","E01006296","Total",729,710,19
"2011","Wigan 037B","E01006298","Total",704,677,27
"2011","Wigan 037C","E01006299","Total",895,827,68
"2011","Wigan 037D","E01006300","Total",622,610,12
"2011","Wigan 037E","E01006301","Total",554,532,22
"2011","Wigan 038A","E01006227","Total",636,621,15
"2011","Wigan 038B","E01006228","Total",768,730,38
"2011","Wigan 038C","E01006342","Total",709,686,23
"2011","Wigan 038D","E01006344","Total",603,596,7
"2011","Wigan 038E","E01006346","Total",1014,974,40
"2011","Wigan 039A","E01006339","Total",604,595,9
"2011","Wigan 039B","E01006340","Total",659,645,14
"2011","Wigan 039C","E01006343","Total",655,649,6
"2011","Wigan 039D","E01006345","Total",684,672,12
"2011","Wigan 039E","E01006348","Total",717,680,37
"2011","Wigan 040A","E01006302","Total",684,658,26
"2011","Wigan 040B","E01006303","Total",626,601,25
"2011","Wigan 040C","E01006304","Total",655,632,23
"2011","Wigan 040D","E01006341","Total",771,755,16
"2011","Wigan 040E","E01006347","Total",654,642,12
"2011","Burnley 001A","E01024859","Total",722,689,33
"2011","Burnley 001B","E01024861","Total",538,530,8
"2011","Burnley 001C","E01024862","Total",676,661,15
"2011","Burnley 001D","E01024891","Total",664,645,19
"2011","Burnley 001E","E01024892","Total",654,628,26
"2011","Burnley 001F","E01024894","Total",538,528,10
"2011","Burnley 002A","E01024893","Total",719,654,65
"2011","Burnley 002B","E01024896","Total",599,583,16
"2011","Burnley 002C","E01024897","Total",560,537,23
"2011","Burnley 002D","E01024898","Total",775,708,67
"2011","Burnley 003A","E01024856","Total",690,604,86
"2011","Burnley 003B","E01024875","Total",494,412,82
"2011","Burnley 003C","E01024876","Total",559,451,108
"2011","Burnley 003D","E01024877","Total",629,538,91
"2011","Burnley 003E","E01024878","Total",475,427,48
"2011","Burnley 003F","E01024895","Total",718,587,131
"2011","Burnley 004A","E01024883","Total",676,655,21
"2011","Burnley 004B","E01024884","Total",718,695,23
"2011","Burnley 004C","E01024885","Total",967,866,101
"2011","Burnley 004D","E01024886","Total",699,633,66
"2011","Burnley 004E","E01024889","Total",677,626,51
"2011","Burnley 004F","E01024890","Total",669,639,30
"2011","Burnley 005A","E01024879","Total",589,571,18
"2011","Burnley 005B","E01024880","Total",652,632,20
"2011","Burnley 005C","E01024912","Total",601,584,17
"2011","Burnley 005D","E01024913","Total",509,504,5
"2011","Burnley 005E","E01024914","Total",621,615,6
"2011","Burnley 006A","E01024881","Total",683,621,62
"2011","Burnley 006B","E01024882","Total",763,720,43
"2011","Burnley 006C","E01024902","Total",745,701,44
"2011","Burnley 006D","E01024911","Total",852,803,49
"2011","Burnley 007A","E01024855","Total",815,779,36
"2011","Burnley 007B","E01024857","Total",671,631,40
"2011","Burnley 007C","E01024858","Total",718,640,78
"2011","Burnley 007D","E01024864","Total",780,740,40
"2011","Burnley 008A","E01024863","Total",639,617,22
"2011","Burnley 008B","E01024865","Total",790,771,19
"2011","Burnley 008C","E01024866","Total",874,858,16
"2011","Burnley 008D","E01024867","Total",613,598,15
"2011","Burnley 009A","E01024860","Total",552,529,23
"2011","Burnley 009B","E01024868","Total",543,520,23
"2011","Burnley 009C","E01024869","Total",664,646,18
"2011","Burnley 009D","E01024870","Total",534,516,18
"2011","Burnley 010A","E01024872","Total",702,660,42
"2011","Burnley 010B","E01024899","Total",693,677,16
"2011","Burnley 010C","E01024900","Total",714,685,29
"2011","Burnley 010D","E01024907","Total",671,579,92
"2011","Burnley 010E","E01024908","Total",639,557,82
"2011","Burnley 010F","E01024909","Total",782,706,76
"2011","Burnley 011A","E01024874","Total",457,436,21
"2011","Burnley 011B","E01024887","Total",621,598,23
"2011","Burnley 011C","E01024888","Total",760,723,37
"2011","Burnley 011D","E01024901","Total",779,767,12
"2011","Burnley 014D","E01024871","Total",538,520,18
"2011","Burnley 014E","E01024873","Total",618,610,8
"2011","Burnley 014F","E01024903","Total",490,482,8
"2011","Burnley 014A","E01024904","Total",763,720,43
"2011","Burnley 014G","E01024905","Total",516,502,14
"2011","Burnley 014B","E01024906","Total",896,800,96
"2011","Burnley 014C","E01024910","Total",701,636,65
"2011","Chorley 001A","E01024951","Total",480,472,8
"2011","Chorley 001B","E01024952","Total",618,604,14
"2011","Chorley 001C","E01024953","Total",652,646,6
"2011","Chorley 001D","E01024954","Total",658,638,20
"2011","Chorley 002A","E01024921","Total",902,857,45
"2011","Chorley 002B","E01024978","Total",592,573,19
"2011","Chorley 002C","E01024979","Total",620,591,29
"2011","Chorley 002D","E01024980","Total",595,581,14
"2011","Chorley 003A","E01024946","Total",539,526,13
"2011","Chorley 003B","E01024947","Total",505,499,6
"2011","Chorley 003C","E01024955","Total",680,656,24
"2011","Chorley 003D","E01024956","Total",631,619,12
"2011","Chorley 003E","E01024957","Total",597,592,5
"2011","Chorley 003F","E01024958","Total",575,565,10
"2011","Chorley 004A","E01024948","Total",670,642,28
"2011","Chorley 004B","E01024949","Total",1030,996,34
"2011","Chorley 004C","E01024950","Total",545,536,9
"2011","Chorley 004D","E01024977","Total",934,899,35
"2011","Chorley 005A","E01024967","Total",547,532,15
"2011","Chorley 005B","E01024968","Total",751,738,13
"2011","Chorley 005C","E01024969","Total",609,598,11
"2011","Chorley 005D","E01024970","Total",588,575,13
"2011","Chorley 005E","E01024971","Total",550,528,22
"2011","Chorley 005F","E01024972","Total",545,535,10
"2011","Chorley 006A","E01024929","Total",569,545,24
"2011","Chorley 006B","E01024930","Total",656,633,23
"2011","Chorley 006C","E01024931","Total",697,666,31
"2011","Chorley 006D","E01024932","Total",429,417,12
"2011","Chorley 006E","E01024933","Total",655,629,26
"2011","Chorley 006F","E01024937","Total",658,638,20
"2011","Chorley 007A","E01024964","Total",643,620,23
"2011","Chorley 007B","E01024974","Total",667,642,25
"2011","Chorley 007C","E01024975","Total",568,535,33
"2011","Chorley 007D","E01024976","Total",687,659,28
"2011","Chorley 008A","E01024919","Total",1288,1113,175
"2011","Chorley 008B","E01024920","Total",952,920,32
"2011","Chorley 008C","E01024934","Total",645,621,24
"2011","Chorley 008D","E01024935","Total",636,627,9
"2011","Chorley 009A","E01024925","Total",801,761,40
"2011","Chorley 009B","E01024926","Total",889,854,35
"2011","Chorley 009C","E01024927","Total",762,732,30
"2011","Chorley 009D","E01024928","Total",691,656,35
"2011","Chorley 010A","E01024936","Total",798,754,44
"2011","Chorley 010B","E01024938","Total",743,699,44
"2011","Chorley 010C","E01024939","Total",733,701,32
"2011","Chorley 010D","E01024940","Total",918,851,67
"2011","Chorley 010E","E01024941","Total",811,742,69
"2011","Chorley 011A","E01024923","Total",543,523,20
"2011","Chorley 011B","E01024924","Total",611,600,11
"2011","Chorley 011C","E01024963","Total",694,673,21
"2011","Chorley 011D","E01024965","Total",595,570,25
"2011","Chorley 011E","E01024966","Total",672,657,15
"2011","Chorley 012A","E01024942","Total",811,779,32
"2011","Chorley 012B","E01024943","Total",983,946,37
"2011","Chorley 012C","E01024944","Total",748,636,112
"2011","Chorley 012D","E01024945","Total",1195,1162,33
"2011","Chorley 013A","E01024922","Total",605,587,18
"2011","Chorley 013B","E01024959","Total",822,753,69
"2011","Chorley 013C","E01024960","Total",653,639,14
"2011","Chorley 013D","E01024961","Total",693,662,31
"2011","Chorley 013E","E01024962","Total",639,623,16
"2011","Chorley 014A","E01024915","Total",993,961,32
"2011","Chorley 014B","E01024916","Total",743,725,18
"2011","Chorley 014C","E01024917","Total",804,773,31
"2011","Chorley 014D","E01024918","Total",785,760,25
"2011","Chorley 014E","E01024973","Total",908,877,31
"2011","Fylde 001A","E01024993","Total",684,626,58
"2011","Fylde 001B","E01025026","Total",613,554,59
"2011","Fylde 001C","E01025027","Total",763,708,55
"2011","Fylde 001D","E01025028","Total",564,545,19
"2011","Fylde 001E","E01025031","Total",553,535,18
"2011","Fylde 002A","E01025007","Total",516,501,15
"2011","Fylde 002B","E01025008","Total",508,498,10
"2011","Fylde 002C","E01025009","Total",770,728,42
"2011","Fylde 002D","E01025011","Total",717,675,42
"2011","Fylde 002E","E01025012","Total",894,795,99
"2011","Fylde 002F","E01025013","Total",747,716,31
"2011","Fylde 002G","E01025019","Total",651,620,31
"2011","Fylde 003A","E01024998","Total",742,721,21
"2011","Fylde 003B","E01025010","Total",540,524,16
"2011","Fylde 003C","E01025014","Total",703,685,18
"2011","Fylde 003D","E01025015","Total",647,634,13
"2011","Fylde 004A","E01025004","Total",620,600,20
"2011","Fylde 004B","E01025006","Total",703,667,36
"2011","Fylde 004C","E01025023","Total",618,604,14
"2011","Fylde 004D","E01025024","Total",806,699,107
"2011","Fylde 004E","E01025025","Total",724,695,29
"2011","Fylde 005A","E01025001","Total",828,793,35
"2011","Fylde 005B","E01025002","Total",691,664,27
"2011","Fylde 005C","E01025005","Total",768,736,32
"2011","Fylde 005D","E01025016","Total",1068,1024,44
"2011","Fylde 005E","E01025018","Total",586,565,21
"2011","Fylde 006A","E01024984","Total",737,670,67
"2011","Fylde 006B","E01024985","Total",646,627,19
"2011","Fylde 006C","E01024986","Total",1120,916,204
"2011","Fylde 006D","E01024987","Total",856,753,103
"2011","Fylde 006E","E01024988","Total",1019,844,175
"2011","Fylde 006F","E01024989","Total",692,656,36
"2011","Fylde 006G","E01024996","Total",725,639,86
"2011","Fylde 007A","E01024997","Total",701,671,30
"2011","Fylde 007B","E01024999","Total",713,691,22
"2011","Fylde 007C","E01025000","Total",619,596,23
"2011","Fylde 007D","E01025029","Total",999,924,75
"2011","Fylde 007E","E01025030","Total",721,683,38
"2011","Fylde 008A","E01024981","Total",737,685,52
"2011","Fylde 008B","E01024982","Total",701,622,79
"2011","Fylde 008C","E01024983","Total",652,625,27
"2011","Fylde 008D","E01024994","Total",800,722,78
"2011","Fylde 008E","E01024995","Total",725,664,61
"2011","Fylde 008F","E01025003","Total",841,792,49
"2011","Fylde 008G","E01025017","Total",847,813,34
"2011","Fylde 009A","E01024990","Total",922,815,107
"2011","Fylde 009B","E01024991","Total",613,517,96
"2011","Fylde 009C","E01024992","Total",779,734,45
"2011","Fylde 009D","E01025020","Total",591,559,32
"2011","Fylde 009E","E01025021","Total",718,681,37
"2011","Fylde 009F","E01025022","Total",937,874,63
"2011","Hyndburn 001A","E01025060","Total",637,602,35
"2011","Hyndburn 001B","E01025061","Total",712,682,30
"2011","Hyndburn 001C","E01025062","Total",790,715,75
"2011","Hyndburn 001D","E01025063","Total",715,694,21
"2011","Hyndburn 001E","E01025064","Total",706,689,17
"2011","Hyndburn 001F","E01025065","Total",825,764,61
"2011","Hyndburn 001G","E01025066","Total",673,642,31
"2011","Hyndburn 002A","E01025032","Total",641,617,24
"2011","Hyndburn 002B","E01025033","Total",826,807,19
"2011","Hyndburn 002C","E01025034","Total",740,719,21
"2011","Hyndburn 002D","E01025048","Total",705,689,16
"2011","Hyndburn 002E","E01025049","Total",843,780,63
"2011","Hyndburn 002F","E01025050","Total",671,638,33
"2011","Hyndburn 002G","E01025053","Total",665,641,24
"2011","Hyndburn 003A","E01025070","Total",536,493,43
"2011","Hyndburn 003B","E01025071","Total",653,616,37
"2011","Hyndburn 003C","E01025072","Total",686,641,45
"2011","Hyndburn 003D","E01025073","Total",612,591,21
"2011","Hyndburn 003E","E01025074","Total",578,571,7
"2011","Hyndburn 004A","E01025051","Total",615,602,13
"2011","Hyndburn 004B","E01025052","Total",651,638,13
"2011","Hyndburn 004C","E01025057","Total",705,692,13
"2011","Hyndburn 004D","E01025058","Total",666,655,11
"2011","Hyndburn 004E","E01025059","Total",688,672,16
"2011","Hyndburn 004F","E01025067","Total",730,709,21
"2011","Hyndburn 004G","E01025068","Total",771,738,33
"2011","Hyndburn 004H","E01025069","Total",647,632,15
"2011","Hyndburn 005A","E01025044","Total",517,500,17
"2011","Hyndburn 005B","E01025045","Total",528,514,14
"2011","Hyndburn 005C","E01025046","Total",651,628,23
"2011","Hyndburn 005D","E01025081","Total",672,662,10
"2011","Hyndburn 006A","E01025041","Total",675,660,15
"2011","Hyndburn 006B","E01025042","Total",640,619,21
"2011","Hyndburn 006E","E01025082","Total",691,664,27
"2011","Hyndburn 006F","E01025083","Total",844,811,33
"2011","Hyndburn 006G","E01025084","Total",635,551,84
"2011","Hyndburn 006H","E01033231","Total",910,880,30
"2011","Hyndburn 007A","E01025055","Total",745,708,37
"2011","Hyndburn 007B","E01025075","Total",854,779,75
"2011","Hyndburn 007C","E01025076","Total",661,637,24
"2011","Hyndburn 007D","E01025077","Total",650,632,18
"2011","Hyndburn 007E","E01025078","Total",648,631,17
"2011","Hyndburn 008A","E01025035","Total",668,647,21
"2011","Hyndburn 008B","E01025036","Total",1028,783,245
"2011","Hyndburn 008C","E01025037","Total",677,624,53
"2011","Hyndburn 008D","E01025038","Total",613,600,13
"2011","Hyndburn 008E","E01025039","Total",504,492,12
"2011","Hyndburn 008F","E01025040","Total",644,624,20
"2011","Hyndburn 009A","E01025054","Total",797,769,28
"2011","Hyndburn 009B","E01025056","Total",618,606,12
"2011","Hyndburn 009C","E01025079","Total",745,723,22
"2011","Hyndburn 009D","E01025080","Total",697,668,29
"2011","Lancaster 001A","E01025088","Total",464,455,9
"2011","Lancaster 001B","E01025096","Total",697,675,22
"2011","Lancaster 001C","E01025097","Total",663,646,17
"2011","Lancaster 001D","E01025098","Total",631,596,35
"2011","Lancaster 001E","E01025148","Total",1056,941,115
"2011","Lancaster 001F","E01025168","Total",545,523,22
"2011","Lancaster 001G","E01025169","Total",585,543,42
"2011","Lancaster 002A","E01025130","Total",1063,956,107
"2011","Lancaster 002B","E01025132","Total",643,590,53
"2011","Lancaster 002C","E01025166","Total",574,541,33
"2011","Lancaster 002D","E01025167","Total",546,478,68
"2011","Lancaster 003A","E01025089","Total",654,627,27
"2011","Lancaster 003B","E01025090","Total",779,751,28
"2011","Lancaster 003C","E01025158","Total",645,620,25
"2011","Lancaster 003D","E01025159","Total",643,612,31
"2011","Lancaster 003E","E01025160","Total",575,554,21
"2011","Lancaster 004A","E01025085","Total",628,604,24
"2011","Lancaster 004B","E01025086","Total",673,656,17
"2011","Lancaster 004C","E01025087","Total",756,683,73
"2011","Lancaster 004D","E01025161","Total",645,627,18
"2011","Lancaster 005A","E01025108","Total",567,533,34
"2011","Lancaster 005B","E01025109","Total",468,447,21
"2011","Lancaster 005C","E01025131","Total",695,654,41
"2011","Lancaster 005D","E01025133","Total",706,676,30
"2011","Lancaster 006A","E01025112","Total",830,779,51
"2011","Lancaster 006B","E01025136","Total",747,715,32
"2011","Lancaster 006C","E01025138","Total",605,585,20
"2011","Lancaster 006D","E01025139","Total",979,853,126
"2011","Lancaster 006E","E01025140","Total",683,644,39
"2011","Lancaster 008A","E01025111","Total",743,728,15
"2011","Lancaster 008B","E01025113","Total",662,639,23
"2011","Lancaster 008C","E01025118","Total",508,478,30
"2011","Lancaster 008D","E01025119","Total",610,577,33
"2011","Lancaster 009A","E01025110","Total",906,697,209
"2011","Lancaster 009B","E01025116","Total",723,660,63
"2011","Lancaster 009C","E01025117","Total",800,646,154
"2011","Lancaster 009D","E01025120","Total",709,633,76
"2011","Lancaster 010A","E01025170","Total",853,834,19
"2011","Lancaster 010B","E01025171","Total",835,794,41
"2011","Lancaster 010C","E01025172","Total",676,656,20
"2011","Lancaster 010D","E01025173","Total",795,775,20
"2011","Lancaster 011A","E01025149","Total",1003,970,33
"2011","Lancaster 011B","E01025150","Total",624,609,15
"2011","Lancaster 011C","E01025151","Total",830,777,53
"2011","Lancaster 011D","E01025152","Total",638,616,22
"2011","Lancaster 011E","E01025154","Total",646,633,13
"2011","Lancaster 013A","E01025091","Total",658,645,13
"2011","Lancaster 013B","E01025092","Total",525,513,12
"2011","Lancaster 013C","E01025095","Total",519,500,19
"2011","Lancaster 013D","E01025126","Total",785,763,22
"2011","Lancaster 014A","E01025093","Total",789,713,76
"2011","Lancaster 014B","E01025094","Total",636,616,20
"2011","Lancaster 014C","E01025099","Total",838,781,57
"2011","Lancaster 014E","E01033071","Total",632,572,60
"2011","Lancaster 014F","E01033073","Total",737,695,42
"2011","Lancaster 015A","E01025125","Total",398,379,19
"2011","Lancaster 015B","E01025128","Total",678,646,32
"2011","Lancaster 015C","E01025129","Total",500,473,27
"2011","Lancaster 015D","E01025147","Total",627,607,20
"2011","Lancaster 016A","E01025114","Total",716,681,35
"2011","Lancaster 016B","E01025115","Total",683,660,23
"2011","Lancaster 016C","E01025121","Total",763,739,24
"2011","Lancaster 016D","E01025122","Total",821,781,40
"2011","Lancaster 016E","E01025123","Total",938,905,33
"2011","Lancaster 016F","E01025124","Total",691,676,15
"2011","Lancaster 016I","E01033072","Total",1132,1070,62
"2011","Lancaster 017A","E01025100","Total",691,668,23
"2011","Lancaster 017B","E01025101","Total",664,631,33
"2011","Lancaster 017C","E01025102","Total",541,533,8
"2011","Lancaster 017D","E01025103","Total",528,520,8
"2011","Lancaster 017E","E01025144","Total",823,797,26
"2011","Lancaster 017F","E01025146","Total",805,784,21
"2011","Lancaster 018A","E01025127","Total",610,600,10
"2011","Lancaster 018B","E01025141","Total",626,606,20
"2011","Lancaster 018C","E01025143","Total",664,639,25
"2011","Lancaster 018D","E01025145","Total",630,614,16
"2011","Lancaster 019A","E01025105","Total",537,517,20
"2011","Lancaster 019B","E01025106","Total",783,754,29
"2011","Lancaster 019C","E01025107","Total",718,679,39
"2011","Lancaster 019D","E01025142","Total",637,621,16
"2011","Lancaster 020A","E01025137","Total",628,604,24
"2011","Lancaster 020F","E01025153","Total",513,499,14
"2011","Lancaster 020G","E01025155","Total",525,510,15
"2011","Lancaster 020H","E01025156","Total",448,444,4
"2011","Lancaster 020I","E01025157","Total",583,572,11
"2011","Lancaster 020B","E01025162","Total",726,682,44
"2011","Lancaster 020C","E01025163","Total",641,628,13
"2011","Lancaster 020D","E01025164","Total",657,632,25
"2011","Lancaster 020E","E01025165","Total",592,587,5
"2011","Pendle 001A","E01025191","Total",549,530,19
"2011","Pendle 001B","E01025192","Total",642,604,38
"2011","Pendle 001C","E01025193","Total",624,609,15
"2011","Pendle 001D","E01025194","Total",663,623,40
"2011","Pendle 002A","E01025195","Total",549,518,31
"2011","Pendle 002B","E01025196","Total",882,810,72
"2011","Pendle 002C","E01025197","Total",599,569,30
"2011","Pendle 002D","E01025198","Total",637,602,35
"2011","Pendle 003A","E01025199","Total",778,733,45
"2011","Pendle 003B","E01025200","Total",711,661,50
"2011","Pendle 003C","E01025201","Total",719,689,30
"2011","Pendle 003D","E01025202","Total",622,595,27
"2011","Pendle 004A","E01025205","Total",654,606,48
"2011","Pendle 004B","E01025206","Total",525,511,14
"2011","Pendle 004C","E01025207","Total",732,681,51
"2011","Pendle 004D","E01025208","Total",694,664,30
"2011","Pendle 005A","E01025220","Total",696,655,41
"2011","Pendle 005B","E01025221","Total",539,521,18
"2011","Pendle 005C","E01025222","Total",635,616,19
"2011","Pendle 005D","E01025223","Total",660,621,39
"2011","Pendle 006A","E01025178","Total",814,793,21
"2011","Pendle 006B","E01025179","Total",738,701,37
"2011","Pendle 006C","E01025180","Total",809,774,35
"2011","Pendle 006D","E01025203","Total",807,748,59
"2011","Pendle 007A","E01025226","Total",839,784,55
"2011","Pendle 007B","E01025227","Total",1047,977,70
"2011","Pendle 007C","E01025228","Total",659,648,11
"2011","Pendle 008A","E01025174","Total",617,613,4
"2011","Pendle 008B","E01025175","Total",670,661,9
"2011","Pendle 008C","E01025176","Total",1038,1015,23
"2011","Pendle 008D","E01025177","Total",808,784,24
"2011","Pendle 008E","E01025204","Total",731,723,8
"2011","Pendle 008F","E01025211","Total",675,663,12
"2011","Pendle 009A","E01025181","Total",634,618,16
"2011","Pendle 009B","E01025182","Total",633,611,22
"2011","Pendle 009C","E01025183","Total",730,700,30
"2011","Pendle 009D","E01025184","Total",556,522,34
"2011","Pendle 010A","E01025188","Total",981,886,95
"2011","Pendle 010B","E01025189","Total",749,687,62
"2011","Pendle 010C","E01025210","Total",843,803,40
"2011","Pendle 010D","E01025217","Total",707,635,72
"2011","Pendle 010E","E01025218","Total",544,510,34
"2011","Pendle 010F","E01025219","Total",676,537,139
"2011","Pendle 011A","E01025224","Total",852,768,84
"2011","Pendle 011B","E01025225","Total",686,653,33
"2011","Pendle 011C","E01025229","Total",688,659,29
"2011","Pendle 011D","E01025230","Total",589,547,42
"2011","Pendle 012A","E01025187","Total",591,575,16
"2011","Pendle 012B","E01025190","Total",673,647,26
"2011","Pendle 012C","E01025209","Total",713,693,20
"2011","Pendle 012D","E01025216","Total",749,714,35
"2011","Pendle 013A","E01025185","Total",761,721,40
"2011","Pendle 013B","E01025186","Total",662,596,66
"2011","Pendle 013C","E01025212","Total",534,527,7
"2011","Pendle 013D","E01025213","Total",412,405,7
"2011","Pendle 013E","E01025214","Total",537,533,4
"2011","Pendle 013F","E01025215","Total",525,499,26
"2011","Preston 001A","E01025278","Total",1030,1003,27
"2011","Preston 001B","E01025279","Total",745,722,23
"2011","Preston 001C","E01025282","Total",587,568,19
"2011","Preston 002A","E01025257","Total",511,505,6
"2011","Preston 002B","E01025277","Total",780,737,43
"2011","Preston 002C","E01025280","Total",727,703,24
"2011","Preston 002D","E01025281","Total",602,583,19
"2011","Preston 003A","E01025256","Total",661,636,25
"2011","Preston 003B","E01025258","Total",643,635,8
"2011","Preston 003C","E01025259","Total",895,874,21
"2011","Preston 003D","E01025299","Total",640,624,16
"2011","Preston 003E","E01025301","Total",478,469,9
"2011","Preston 003F","E01025302","Total",514,504,10
"2011","Preston 004A","E01025253","Total",713,692,21
"2011","Preston 004B","E01025254","Total",477,470,7
"2011","Preston 004C","E01025255","Total",598,588,10
"2011","Preston 004D","E01025300","Total",578,557,21
"2011","Preston 004E","E01025303","Total",623,608,15
"2011","Preston 005A","E01025260","Total",786,765,21
"2011","Preston 005B","E01025262","Total",735,719,16
"2011","Preston 005C","E01025263","Total",660,640,20
"2011","Preston 005D","E01025264","Total",668,652,16
"2011","Preston 006A","E01025239","Total",679,663,16
"2011","Preston 006B","E01025241","Total",699,666,33
"2011","Preston 006C","E01025242","Total",640,625,15
"2011","Preston 006D","E01025243","Total",832,786,46
"2011","Preston 006E","E01025251","Total",585,559,26
"2011","Preston 007A","E01025234","Total",574,563,11
"2011","Preston 007B","E01025235","Total",688,675,13
"2011","Preston 007C","E01025237","Total",672,653,19
"2011","Preston 007D","E01025238","Total",663,649,14
"2011","Preston 007E","E01025245","Total",953,928,25
"2011","Preston 007F","E01025252","Total",660,631,29
"2011","Preston 008A","E01025233","Total",534,523,11
"2011","Preston 008B","E01025240","Total",670,652,18
"2011","Preston 008C","E01025261","Total",672,651,21
"2011","Preston 008D","E01025266","Total",530,520,10
"2011","Preston 008E","E01025309","Total",525,514,11
"2011","Preston 009A","E01025236","Total",592,573,19
"2011","Preston 009B","E01025283","Total",647,627,20
"2011","Preston 009C","E01025284","Total",674,665,9
"2011","Preston 009D","E01025285","Total",524,513,11
"2011","Preston 009E","E01025286","Total",713,685,28
"2011","Preston 009F","E01025287","Total",1041,991,50
"2011","Preston 010A","E01025270","Total",685,666,19
"2011","Preston 010B","E01025272","Total",616,616,0
"2011","Preston 010C","E01025273","Total",512,501,11
"2011","Preston 010D","E01025288","Total",1061,899,162
"2011","Preston 011A","E01025246","Total",549,531,18
"2011","Preston 011B","E01025274","Total",923,818,105
"2011","Preston 011C","E01025275","Total",830,772,58
"2011","Preston 011D","E01025294","Total",715,667,48
"2011","Preston 012A","E01025276","Total",714,652,62
"2011","Preston 012B","E01025308","Total",778,741,37
"2011","Preston 012C","E01025310","Total",762,709,53
"2011","Preston 012D","E01025311","Total",694,666,28
"2011","Preston 012E","E01025312","Total",808,762,46
"2011","Preston 012F","E01025313","Total",715,652,63
"2011","Preston 012G","E01025314","Total",924,823,101
"2011","Preston 013A","E01025231","Total",625,591,34
"2011","Preston 013B","E01025232","Total",819,760,59
"2011","Preston 013C","E01025265","Total",660,648,12
"2011","Preston 013D","E01025267","Total",641,627,14
"2011","Preston 013E","E01025268","Total",836,811,25
"2011","Preston 013F","E01025269","Total",670,649,21
"2011","Preston 013G","E01025271","Total",637,620,17
"2011","Preston 014A","E01025295","Total",1183,1090,93
"2011","Preston 014B","E01025296","Total",807,762,45
"2011","Preston 014C","E01025297","Total",899,829,70
"2011","Preston 014D","E01025298","Total",700,614,86
"2011","Preston 015A","E01025244","Total",553,511,42
"2011","Preston 015B","E01025292","Total",815,753,62
"2011","Preston 015C","E01025293","Total",985,924,61
"2011","Preston 016A","E01025247","Total",721,667,54
"2011","Preston 016B","E01025248","Total",523,509,14
"2011","Preston 016C","E01025249","Total",452,436,16
"2011","Preston 016D","E01025250","Total",671,642,29
"2011","Preston 016E","E01025304","Total",631,611,20
"2011","Preston 016F","E01025305","Total",701,664,37
"2011","Preston 017A","E01025289","Total",814,739,75
"2011","Preston 017B","E01025290","Total",902,785,117
"2011","Preston 017C","E01025291","Total",691,657,34
"2011","Preston 017D","E01025306","Total",935,854,81
"2011","Preston 017F","E01033223","Total",685,606,79
"2011","Preston 017G","E01033224","Total",643,600,43
"2011","Preston 017H","E01033226","Total",616,567,49
"2011","Ribble Valley 001A","E01025315","Total",565,544,21
"2011","Ribble Valley 001B","E01025320","Total",577,536,41
"2011","Ribble Valley 001C","E01025331","Total",617,563,54
"2011","Ribble Valley 001D","E01025348","Total",779,728,51
"2011","Ribble Valley 001E","E01025349","Total",600,573,27
"2011","Ribble Valley 002A","E01025334","Total",702,681,21
"2011","Ribble Valley 002B","E01025344","Total",647,624,23
"2011","Ribble Valley 002C","E01025345","Total",652,626,26
"2011","Ribble Valley 002D","E01025346","Total",672,652,20
"2011","Ribble Valley 002E","E01025347","Total",699,683,16
"2011","Ribble Valley 003A","E01025329","Total",628,614,14
"2011","Ribble Valley 003B","E01025330","Total",624,603,21
"2011","Ribble Valley 003C","E01025335","Total",744,706,38
"2011","Ribble Valley 003D","E01025338","Total",763,723,40
"2011","Ribble Valley 003E","E01025339","Total",664,649,15
"2011","Ribble Valley 004A","E01025322","Total",584,544,40
"2011","Ribble Valley 004B","E01025326","Total",662,629,33
"2011","Ribble Valley 004C","E01025327","Total",550,541,9
"2011","Ribble Valley 004D","E01025342","Total",706,667,39
"2011","Ribble Valley 005A","E01025321","Total",584,565,19
"2011","Ribble Valley 005B","E01025340","Total",641,609,32
"2011","Ribble Valley 005C","E01025341","Total",493,482,11
"2011","Ribble Valley 005D","E01025343","Total",630,614,16
"2011","Ribble Valley 005E","E01025354","Total",596,572,24
"2011","Ribble Valley 006A","E01025316","Total",575,567,8
"2011","Ribble Valley 006B","E01025317","Total",502,484,18
"2011","Ribble Valley 006C","E01025325","Total",785,737,48
"2011","Ribble Valley 006D","E01025328","Total",525,503,22
"2011","Ribble Valley 007A","E01025318","Total",463,454,9
"2011","Ribble Valley 007B","E01025319","Total",819,801,18
"2011","Ribble Valley 007C","E01025333","Total",556,536,20
"2011","Ribble Valley 007D","E01025350","Total",578,562,16
"2011","Ribble Valley 007E","E01025351","Total",1018,979,39
"2011","Ribble Valley 008A","E01025323","Total",501,478,23
"2011","Ribble Valley 008B","E01025324","Total",615,593,22
"2011","Ribble Valley 008C","E01025332","Total",441,430,11
"2011","Ribble Valley 008D","E01025336","Total",502,489,13
"2011","Ribble Valley 008E","E01025337","Total",715,695,20
"2011","Ribble Valley 008F","E01025352","Total",569,554,15
"2011","Ribble Valley 008G","E01025353","Total",476,455,21
"2011","Rossendale 001A","E01025355","Total",862,837,25
"2011","Rossendale 001B","E01025361","Total",972,892,80
"2011","Rossendale 001C","E01025362","Total",848,822,26
"2011","Rossendale 001D","E01025393","Total",658,611,47
"2011","Rossendale 002A","E01025363","Total",568,551,17
"2011","Rossendale 002B","E01025364","Total",555,537,18
"2011","Rossendale 002C","E01025366","Total",626,594,32
"2011","Rossendale 002D","E01025395","Total",765,712,53
"2011","Rossendale 002E","E01025396","Total",703,660,43
"2011","Rossendale 002F","E01025397","Total",721,652,69
"2011","Rossendale 002G","E01025398","Total",579,557,22
"2011","Rossendale 003A","E01025367","Total",735,682,53
"2011","Rossendale 003B","E01025368","Total",763,701,62
"2011","Rossendale 003C","E01025369","Total",613,554,59
"2011","Rossendale 003D","E01025381","Total",653,618,35
"2011","Rossendale 003E","E01025382","Total",887,798,89
"2011","Rossendale 003F","E01025383","Total",986,928,58
"2011","Rossendale 004A","E01025356","Total",677,625,52
"2011","Rossendale 004C","E01025373","Total",722,678,44
"2011","Rossendale 004D","E01025385","Total",613,588,25
"2011","Rossendale 004F","E01025387","Total",520,501,19
"2011","Rossendale 004G","E01033281","Total",1198,1111,87
"2011","Rossendale 007A","E01025377","Total",605,554,51
"2011","Rossendale 007B","E01025378","Total",678,647,31
"2011","Rossendale 007C","E01025379","Total",638,621,17
"2011","Rossendale 007D","E01025380","Total",594,583,11
"2011","Rossendale 008A","E01025357","Total",640,608,32
"2011","Rossendale 008B","E01025358","Total",984,943,41
"2011","Rossendale 008C","E01025365","Total",689,656,33
"2011","Rossendale 008D","E01025384","Total",558,533,25
"2011","Rossendale 009A","E01025359","Total",735,708,27
"2011","Rossendale 009B","E01025360","Total",971,919,52
"2011","Rossendale 009C","E01025375","Total",702,682,20
"2011","Rossendale 009D","E01025376","Total",1039,983,56
"2011","Rossendale 010F","E01025370","Total",553,513,40
"2011","Rossendale 010A","E01025371","Total",700,648,52
"2011","Rossendale 010B","E01025374","Total",652,629,23
"2011","Rossendale 010G","E01025388","Total",744,657,87
"2011","Rossendale 010H","E01025389","Total",602,548,54
"2011","Rossendale 010I","E01025390","Total",548,517,31
"2011","Rossendale 010C","E01025391","Total",685,660,25
"2011","Rossendale 010D","E01025392","Total",605,573,32
"2011","Rossendale 010E","E01025394","Total",706,667,39
"2011","South Ribble 001A","E01025424","Total",518,505,13
"2011","South Ribble 001B","E01025425","Total",551,532,19
"2011","South Ribble 001C","E01025426","Total",519,502,17
"2011","South Ribble 001D","E01025466","Total",644,619,25
"2011","South Ribble 002A","E01025413","Total",800,770,30
"2011","South Ribble 002B","E01025414","Total",720,680,40
"2011","South Ribble 002C","E01025456","Total",508,472,36
"2011","South Ribble 002D","E01025458","Total",714,674,40
"2011","South Ribble 003A","E01025408","Total",672,651,21
"2011","South Ribble 003B","E01025409","Total",599,578,21
"2011","South Ribble 003C","E01025410","Total",524,512,12
"2011","South Ribble 003D","E01025467","Total",894,874,20
"2011","South Ribble 004A","E01025403","Total",805,786,19
"2011","South Ribble 004B","E01025457","Total",665,627,38
"2011","South Ribble 004C","E01025463","Total",586,574,12
"2011","South Ribble 004D","E01025464","Total",514,502,12
"2011","South Ribble 004E","E01025465","Total",514,503,11
"2011","South Ribble 005A","E01025411","Total",918,878,40
"2011","South Ribble 005B","E01025448","Total",751,700,51
"2011","South Ribble 005C","E01025449","Total",447,425,22
"2011","South Ribble 005D","E01025450","Total",431,415,16
"2011","South Ribble 006A","E01025412","Total",688,676,12
"2011","South Ribble 006B","E01025427","Total",770,741,29
"2011","South Ribble 006C","E01025428","Total",645,630,15
"2011","South Ribble 006D","E01025429","Total",632,617,15
"2011","South Ribble 007A","E01025404","Total",570,551,19
"2011","South Ribble 007B","E01025405","Total",585,560,25
"2011","South Ribble 007C","E01025406","Total",563,548,15
"2011","South Ribble 007D","E01025407","Total",916,862,54
"2011","South Ribble 008A","E01025399","Total",632,618,14
"2011","South Ribble 008B","E01025400","Total",730,715,15
"2011","South Ribble 008C","E01025401","Total",676,651,25
"2011","South Ribble 008D","E01025402","Total",629,605,24
"2011","South Ribble 009A","E01025442","Total",546,520,26
"2011","South Ribble 009B","E01025443","Total",623,603,20
"2011","South Ribble 009C","E01025444","Total",573,559,14
"2011","South Ribble 009D","E01025461","Total",750,737,13
"2011","South Ribble 009E","E01025462","Total",723,706,17
"2011","South Ribble 010A","E01025439","Total",600,579,21
"2011","South Ribble 010B","E01025453","Total",696,670,26
"2011","South Ribble 010C","E01025454","Total",527,506,21
"2011","South Ribble 010D","E01025455","Total",670,642,28
"2011","South Ribble 011A","E01025436","Total",938,912,26
"2011","South Ribble 011B","E01025437","Total",803,781,22
"2011","South Ribble 011C","E01025438","Total",546,523,23
"2011","South Ribble 011D","E01025440","Total",632,603,29
"2011","South Ribble 011E","E01025441","Total",683,662,21
"2011","South Ribble 012A","E01025417","Total",638,622,16
"2011","South Ribble 012B","E01025418","Total",630,611,19
"2011","South Ribble 012C","E01025419","Total",694,665,29
"2011","South Ribble 012D","E01025420","Total",1080,1057,23
"2011","South Ribble 013A","E01025421","Total",944,912,32
"2011","South Ribble 013B","E01025422","Total",664,639,25
"2011","South Ribble 013C","E01025431","Total",813,772,41
"2011","South Ribble 013D","E01025433","Total",773,753,20
"2011","South Ribble 014A","E01025416","Total",627,610,17
"2011","South Ribble 014B","E01025451","Total",743,733,10
"2011","South Ribble 014C","E01025452","Total",757,738,19
"2011","South Ribble 015A","E01025415","Total",876,846,30
"2011","South Ribble 015B","E01025423","Total",627,604,23
"2011","South Ribble 015C","E01025435","Total",699,674,25
"2011","South Ribble 015D","E01025446","Total",683,663,20
"2011","South Ribble 016A","E01025430","Total",813,796,17
"2011","South Ribble 016C","E01025434","Total",836,827,9
"2011","South Ribble 016D","E01032928","Total",900,826,74
"2011","South Ribble 016E","E01032929","Total",513,497,16
"2011","South Ribble 017A","E01025445","Total",542,536,6
"2011","South Ribble 017B","E01025447","Total",546,533,13
"2011","South Ribble 017C","E01025459","Total",738,710,28
"2011","South Ribble 017D","E01025460","Total",939,922,17
"2011","West Lancashire 001A","E01025496","Total",508,481,27
"2011","West Lancashire 001B","E01025497","Total",579,563,16
"2011","West Lancashire 001C","E01025498","Total",549,520,29
"2011","West Lancashire 001D","E01025530","Total",655,620,35
"2011","West Lancashire 001E","E01025532","Total",624,600,24
"2011","West Lancashire 001F","E01025533","Total",751,709,42
"2011","West Lancashire 002A","E01025507","Total",788,678,110
"2011","West Lancashire 002B","E01025508","Total",746,616,130
"2011","West Lancashire 002C","E01025509","Total",584,553,31
"2011","West Lancashire 002D","E01025513","Total",863,822,41
"2011","West Lancashire 002E","E01025531","Total",664,488,176
"2011","West Lancashire 003A","E01025474","Total",484,458,26
"2011","West Lancashire 003B","E01025495","Total",929,867,62
"2011","West Lancashire 003C","E01025514","Total",1047,966,81
"2011","West Lancashire 003D","E01025515","Total",873,680,193
"2011","West Lancashire 004A","E01025483","Total",986,958,28
"2011","West Lancashire 004B","E01025484","Total",811,791,20
"2011","West Lancashire 004C","E01025485","Total",746,702,44
"2011","West Lancashire 004D","E01025486","Total",671,654,17
"2011","West Lancashire 004E","E01025487","Total",653,624,29
"2011","West Lancashire 005A","E01025510","Total",529,514,15
"2011","West Lancashire 005B","E01025511","Total",492,469,23
"2011","West Lancashire 005C","E01025512","Total",595,563,32
"2011","West Lancashire 005D","E01025538","Total",682,660,22
"2011","West Lancashire 005E","E01025539","Total",595,560,35
"2011","West Lancashire 006A","E01025499","Total",625,596,29
"2011","West Lancashire 006B","E01025501","Total",505,493,12
"2011","West Lancashire 006C","E01025502","Total",650,639,11
"2011","West Lancashire 006D","E01025516","Total",656,631,25
"2011","West Lancashire 006E","E01025517","Total",623,595,28
"2011","West Lancashire 006F","E01025519","Total",535,505,30
"2011","West Lancashire 007A","E01025488","Total",804,743,61
"2011","West Lancashire 007B","E01025489","Total",513,505,8
"2011","West Lancashire 007C","E01025490","Total",508,495,13
"2011","West Lancashire 007D","E01025500","Total",686,664,22
"2011","West Lancashire 007E","E01025518","Total",681,629,52
"2011","West Lancashire 008A","E01025479","Total",890,837,53
"2011","West Lancashire 008B","E01025491","Total",597,575,22
"2011","West Lancashire 008C","E01025506","Total",908,842,66
"2011","West Lancashire 009A","E01025468","Total",605,595,10
"2011","West Lancashire 009B","E01025469","Total",776,761,15
"2011","West Lancashire 009C","E01025470","Total",567,542,25
"2011","West Lancashire 009D","E01025522","Total",523,507,16
"2011","West Lancashire 010A","E01025471","Total",611,574,37
"2011","West Lancashire 010B","E01025480","Total",521,503,18
"2011","West Lancashire 010C","E01025481","Total",677,640,37
"2011","West Lancashire 010D","E01025482","Total",628,578,50
"2011","West Lancashire 010E","E01025520","Total",541,522,19
"2011","West Lancashire 010F","E01025521","Total",664,659,5
"2011","West Lancashire 011A","E01025523","Total",722,685,37
"2011","West Lancashire 011B","E01025524","Total",785,746,39
"2011","West Lancashire 011C","E01025525","Total",665,629,36
"2011","West Lancashire 011D","E01025526","Total",808,774,34
"2011","West Lancashire 012A","E01025472","Total",580,543,37
"2011","West Lancashire 012B","E01025473","Total",621,607,14
"2011","West Lancashire 012C","E01025475","Total",629,606,23
"2011","West Lancashire 012D","E01025476","Total",577,547,30
"2011","West Lancashire 012E","E01025477","Total",496,478,18
"2011","West Lancashire 012F","E01025478","Total",493,478,15
"2011","West Lancashire 013A","E01025492","Total",513,503,10
"2011","West Lancashire 013B","E01025527","Total",636,621,15
"2011","West Lancashire 013C","E01025528","Total",739,685,54
"2011","West Lancashire 013D","E01025529","Total",743,709,34
"2011","West Lancashire 014A","E01025493","Total",694,660,34
"2011","West Lancashire 014B","E01025494","Total",721,676,45
"2011","West Lancashire 014C","E01025503","Total",516,499,17
"2011","West Lancashire 014D","E01025504","Total",492,472,20
"2011","West Lancashire 014E","E01025505","Total",662,632,30
"2011","West Lancashire 015A","E01025534","Total",705,686,19
"2011","West Lancashire 015B","E01025535","Total",604,582,22
"2011","West Lancashire 015C","E01025536","Total",665,646,19
"2011","West Lancashire 015D","E01025537","Total",709,683,26
"2011","West Lancashire 015E","E01025540","Total",521,488,33
"2011","Wyre 001A","E01025573","Total",616,590,26
"2011","Wyre 001B","E01025574","Total",785,741,44
"2011","Wyre 001C","E01025581","Total",669,587,82
"2011","Wyre 001D","E01025582","Total",679,581,98
"2011","Wyre 001E","E01025583","Total",681,602,79
"2011","Wyre 001F","E01025584","Total",1076,851,225
"2011","Wyre 002A","E01025605","Total",586,565,21
"2011","Wyre 002B","E01025606","Total",547,516,31
"2011","Wyre 002C","E01025607","Total",661,630,31
"2011","Wyre 002D","E01025608","Total",699,658,41
"2011","Wyre 003A","E01025590","Total",644,622,22
"2011","Wyre 003B","E01025591","Total",785,748,37
"2011","Wyre 003C","E01025592","Total",650,638,12
"2011","Wyre 003D","E01025593","Total",686,654,32
"2011","Wyre 004A","E01025563","Total",477,455,22
"2011","Wyre 004B","E01025564","Total",746,719,27
"2011","Wyre 004C","E01025565","Total",691,642,49
"2011","Wyre 004D","E01025586","Total",751,715,36
"2011","Wyre 004E","E01025587","Total",744,694,50
"2011","Wyre 004F","E01025588","Total",755,704,51
"2011","Wyre 004G","E01025589","Total",520,489,31
"2011","Wyre 005A","E01025557","Total",697,683,14
"2011","Wyre 005B","E01025575","Total",580,551,29
"2011","Wyre 005C","E01025578","Total",665,629,36
"2011","Wyre 005D","E01025579","Total",538,513,25
"2011","Wyre 005E","E01025580","Total",540,497,43
"2011","Wyre 006A","E01025547","Total",709,669,40
"2011","Wyre 006B","E01025549","Total",890,842,48
"2011","Wyre 006C","E01025609","Total",893,826,67
"2011","Wyre 007A","E01025548","Total",797,747,50
"2011","Wyre 007B","E01025553","Total",1066,1031,35
"2011","Wyre 007C","E01025558","Total",855,822,33
"2011","Wyre 007D","E01025559","Total",824,776,48
"2011","Wyre 007E","E01025560","Total",666,647,19
"2011","Wyre 008A","E01025554","Total",791,764,27
"2011","Wyre 008B","E01025556","Total",666,638,28
"2011","Wyre 008C","E01025570","Total",842,678,164
"2011","Wyre 008D","E01025571","Total",642,586,56
"2011","Wyre 008E","E01025572","Total",705,642,63
"2011","Wyre 008F","E01025604","Total",689,653,36
"2011","Wyre 009A","E01025561","Total",621,591,30
"2011","Wyre 009B","E01025562","Total",920,871,49
"2011","Wyre 009C","E01025585","Total",934,890,44
"2011","Wyre 010A","E01025542","Total",693,684,9
"2011","Wyre 010B","E01025555","Total",719,685,34
"2011","Wyre 010C","E01025601","Total",650,621,29
"2011","Wyre 010D","E01025602","Total",715,691,24
"2011","Wyre 010E","E01025603","Total",739,710,29
"2011","Wyre 011A","E01025541","Total",720,693,27
"2011","Wyre 011B","E01025543","Total",783,747,36
"2011","Wyre 011C","E01025544","Total",781,755,26
"2011","Wyre 011D","E01025576","Total",1120,1069,51
"2011","Wyre 011E","E01025577","Total",662,646,16
"2011","Wyre 012A","E01025550","Total",693,671,22
"2011","Wyre 012B","E01025552","Total",513,497,16
"2011","Wyre 012C","E01025594","Total",775,744,31
"2011","Wyre 012D","E01025595","Total",642,628,14
"2011","Wyre 012E","E01025596","Total",843,820,23
"2011","Wyre 012F","E01025597","Total",498,480,18
"2011","Wyre 013A","E01025545","Total",832,789,43
"2011","Wyre 013B","E01025546","Total",759,716,43
"2011","Wyre 013C","E01025551","Total",566,552,14
"2011","Wyre 013D","E01025567","Total",804,756,48
"2011","Wyre 013E","E01025598","Total",810,765,45
"2011","Wyre 014A","E01025566","Total",878,847,31
"2011","Wyre 014B","E01025568","Total",829,792,37
"2011","Wyre 014C","E01025569","Total",922,877,45
"2011","Wyre 014D","E01025599","Total",458,432,26
"2011","Wyre 014E","E01025600","Total",691,667,24
"2011","Knowsley 001A","E01006448","Total",750,720,30
"2011","Knowsley 001B","E01006492","Total",519,515,4
"2011","Knowsley 001C","E01006493","Total",439,433,6
"2011","Knowsley 001D","E01006494","Total",530,526,4
"2011","Knowsley 001E","E01006495","Total",697,689,8
"2011","Knowsley 002A","E01006454","Total",517,512,5
"2011","Knowsley 002B","E01006456","Total",686,670,16
"2011","Knowsley 002C","E01006457","Total",531,522,9
"2011","Knowsley 002D","E01006458","Total",600,593,7
"2011","Knowsley 002E","E01006490","Total",1044,1032,12
"2011","Knowsley 002F","E01006491","Total",776,761,15
"2011","Knowsley 003A","E01006415","Total",836,825,11
"2011","Knowsley 003B","E01006417","Total",736,711,25
"2011","Knowsley 003C","E01006436","Total",650,636,14
"2011","Knowsley 003D","E01006437","Total",631,618,13
"2011","Knowsley 003E","E01006447","Total",647,632,15
"2011","Knowsley 004A","E01006455","Total",737,701,36
"2011","Knowsley 004B","E01006506","Total",570,550,20
"2011","Knowsley 004C","E01006507","Total",642,636,6
"2011","Knowsley 004D","E01006508","Total",598,576,22
"2011","Knowsley 004E","E01006509","Total",702,695,7
"2011","Knowsley 004F","E01006510","Total",504,493,11
"2011","Knowsley 005A","E01006416","Total",682,665,17
"2011","Knowsley 005B","E01006418","Total",562,549,13
"2011","Knowsley 005C","E01006434","Total",644,631,13
"2011","Knowsley 005D","E01006435","Total",663,653,10
"2011","Knowsley 005E","E01006438","Total",521,510,11
"2011","Knowsley 005F","E01006439","Total",696,686,10
"2011","Knowsley 005G","E01006446","Total",587,566,21
"2011","Knowsley 006A","E01006412","Total",598,591,7
"2011","Knowsley 006B","E01006413","Total",899,866,33
"2011","Knowsley 006C","E01006414","Total",618,610,8
"2011","Knowsley 006D","E01006441","Total",1013,993,20
"2011","Knowsley 007A","E01006460","Total",681,661,20
"2011","Knowsley 007B","E01006461","Total",626,619,7
"2011","Knowsley 007C","E01006463","Total",1041,971,70
"2011","Knowsley 007D","E01006464","Total",755,727,28
"2011","Knowsley 007E","E01006466","Total",814,776,38
"2011","Knowsley 008A","E01006453","Total",529,515,14
"2011","Knowsley 008B","E01006467","Total",574,558,16
"2011","Knowsley 008E","E01006470","Total",599,585,14
"2011","Knowsley 008F","E01033228","Total",817,810,7
"2011","Knowsley 009A","E01006459","Total",716,614,102
"2011","Knowsley 009B","E01006462","Total",656,639,17
"2011","Knowsley 009C","E01006496","Total",631,606,25
"2011","Knowsley 009D","E01006498","Total",559,548,11
"2011","Knowsley 009E","E01006499","Total",715,681,34
"2011","Knowsley 010A","E01006440","Total",628,622,6
"2011","Knowsley 010B","E01006442","Total",620,614,6
"2011","Knowsley 010C","E01006443","Total",678,667,11
"2011","Knowsley 010D","E01006444","Total",534,521,13
"2011","Knowsley 010E","E01006445","Total",543,539,4
"2011","Knowsley 011A","E01006465","Total",651,635,16
"2011","Knowsley 011B","E01006482","Total",605,587,18
"2011","Knowsley 011C","E01006483","Total",630,614,16
"2011","Knowsley 011D","E01006484","Total",596,567,29
"2011","Knowsley 012A","E01006449","Total",636,623,13
"2011","Knowsley 012B","E01006450","Total",649,619,30
"2011","Knowsley 012C","E01006451","Total",620,606,14
"2011","Knowsley 012D","E01006452","Total",632,618,14
"2011","Knowsley 013A","E01006497","Total",489,472,17
"2011","Knowsley 013B","E01006500","Total",473,464,9
"2011","Knowsley 013C","E01006501","Total",576,562,14
"2011","Knowsley 013D","E01006504","Total",600,573,27
"2011","Knowsley 013E","E01006505","Total",715,700,15
"2011","Knowsley 014A","E01006472","Total",649,638,11
"2011","Knowsley 014B","E01006485","Total",629,615,14
"2011","Knowsley 014C","E01006486","Total",523,491,32
"2011","Knowsley 014D","E01006487","Total",646,630,16
"2011","Knowsley 014E","E01006488","Total",705,686,19
"2011","Knowsley 014F","E01006489","Total",602,581,21
"2011","Knowsley 015A","E01006477","Total",592,575,17
"2011","Knowsley 015B","E01006478","Total",631,613,18
"2011","Knowsley 015C","E01006479","Total",616,590,26
"2011","Knowsley 015D","E01006480","Total",624,613,11
"2011","Knowsley 015E","E01006481","Total",669,642,27
"2011","Knowsley 016A","E01006471","Total",649,624,25
"2011","Knowsley 016B","E01006473","Total",498,490,8
"2011","Knowsley 016C","E01006474","Total",662,637,25
"2011","Knowsley 016D","E01006475","Total",572,555,17
"2011","Knowsley 016E","E01006476","Total",582,568,14
"2011","Knowsley 017A","E01006420","Total",783,764,19
"2011","Knowsley 017B","E01006424","Total",814,803,11
"2011","Knowsley 017C","E01006502","Total",795,767,28
"2011","Knowsley 017D","E01006503","Total",567,544,23
"2011","Knowsley 018A","E01006421","Total",431,428,3
"2011","Knowsley 018B","E01006425","Total",566,559,7
"2011","Knowsley 018C","E01006430","Total",616,611,5
"2011","Knowsley 018D","E01006433","Total",643,633,10
"2011","Knowsley 019A","E01006419","Total",631,628,3
"2011","Knowsley 019B","E01006422","Total",533,528,5
"2011","Knowsley 019C","E01006423","Total",535,528,7
"2011","Knowsley 019D","E01006427","Total",630,618,12
"2011","Knowsley 020A","E01006426","Total",574,556,18
"2011","Knowsley 020B","E01006428","Total",636,630,6
"2011","Knowsley 020C","E01006429","Total",470,463,7
"2011","Knowsley 020D","E01006431","Total",791,765,26
"2011","Knowsley 020E","E01006432","Total",696,671,25
"2011","Liverpool 001A","E01006651","Total",616,592,24
"2011","Liverpool 001B","E01006653","Total",678,656,22
"2011","Liverpool 001C","E01006655","Total",753,706,47
"2011","Liverpool 001D","E01006658","Total",648,634,14
"2011","Liverpool 001E","E01006660","Total",631,616,15
"2011","Liverpool 002A","E01006652","Total",653,633,20
"2011","Liverpool 002B","E01006656","Total",696,669,27
"2011","Liverpool 002C","E01006657","Total",606,582,24
"2011","Liverpool 002D","E01006780","Total",641,619,22
"2011","Liverpool 002E","E01006783","Total",664,645,19
"2011","Liverpool 003A","E01006781","Total",607,600,7
"2011","Liverpool 003B","E01006782","Total",723,691,32
"2011","Liverpool 003C","E01006784","Total",610,586,24
"2011","Liverpool 003D","E01006785","Total",804,781,23
"2011","Liverpool 003E","E01006786","Total",778,764,14
"2011","Liverpool 004A","E01006661","Total",765,749,16
"2011","Liverpool 004B","E01006662","Total",802,785,17
"2011","Liverpool 004C","E01006663","Total",521,510,11
"2011","Liverpool 004D","E01006664","Total",875,822,53
"2011","Liverpool 004E","E01006669","Total",560,551,9
"2011","Liverpool 005A","E01006654","Total",650,627,23
"2011","Liverpool 005B","E01006659","Total",573,548,25
"2011","Liverpool 005C","E01006734","Total",645,625,20
"2011","Liverpool 005D","E01006735","Total",575,571,4
"2011","Liverpool 005E","E01006736","Total",598,582,16
"2011","Liverpool 005F","E01006737","Total",567,562,5
"2011","Liverpool 006A","E01006787","Total",721,691,30
"2011","Liverpool 006B","E01006788","Total",693,681,12
"2011","Liverpool 006C","E01006790","Total",842,801,41
"2011","Liverpool 006D","E01006791","Total",898,873,25
"2011","Liverpool 007A","E01006665","Total",642,630,12
"2011","Liverpool 007B","E01006666","Total",518,514,4
"2011","Liverpool 007C","E01006667","Total",626,618,8
"2011","Liverpool 007D","E01006668","Total",594,590,4
"2011","Liverpool 007E","E01006670","Total",627,607,20
"2011","Liverpool 008A","E01006607","Total",660,641,19
"2011","Liverpool 008B","E01006612","Total",746,740,6
"2011","Liverpool 008C","E01006729","Total",541,539,2
"2011","Liverpool 008F","E01032510","Total",796,776,20
"2011","Liverpool 008G","E01032511","Total",625,616,9
"2011","Liverpool 009A","E01006608","Total",575,563,12
"2011","Liverpool 009B","E01006609","Total",618,576,42
"2011","Liverpool 009C","E01006610","Total",718,669,49
"2011","Liverpool 009D","E01006613","Total",625,611,14
"2011","Liverpool 009E","E01006705","Total",756,689,67
"2011","Liverpool 010A","E01006598","Total",615,604,11
"2011","Liverpool 010B","E01006599","Total",492,482,10
"2011","Liverpool 010E","E01006672","Total",822,798,24
"2011","Liverpool 010F","E01033759","Total",486,480,6
"2011","Liverpool 011A","E01006600","Total",596,592,4
"2011","Liverpool 011B","E01006603","Total",605,594,11
"2011","Liverpool 011C","E01006730","Total",551,542,9
"2011","Liverpool 011D","E01006731","Total",513,486,27
"2011","Liverpool 011E","E01006732","Total",654,644,10
"2011","Liverpool 012A","E01006611","Total",795,742,53
"2011","Liverpool 012B","E01006614","Total",713,667,46
"2011","Liverpool 012C","E01006615","Total",703,663,40
"2011","Liverpool 012D","E01006698","Total",768,725,43
"2011","Liverpool 012E","E01006700","Total",685,653,32
"2011","Liverpool 013A","E01006623","Total",536,527,9
"2011","Liverpool 013B","E01006624","Total",733,702,31
"2011","Liverpool 013C","E01006627","Total",609,600,9
"2011","Liverpool 013D","E01006671","Total",506,499,7
"2011","Liverpool 014A","E01006699","Total",807,777,30
"2011","Liverpool 014B","E01006701","Total",728,671,57
"2011","Liverpool 014C","E01006702","Total",809,740,69
"2011","Liverpool 014D","E01006703","Total",836,818,18
"2011","Liverpool 014E","E01006778","Total",1218,1124,94
"2011","Liverpool 015A","E01006541","Total",827,803,24
"2011","Liverpool 015B","E01006543","Total",519,509,10
"2011","Liverpool 015C","E01006544","Total",766,738,28
"2011","Liverpool 015D","E01006616","Total",620,613,7
"2011","Liverpool 015E","E01006762","Total",749,725,24
"2011","Liverpool 016A","E01006604","Total",583,571,12
"2011","Liverpool 016B","E01006605","Total",717,696,21
"2011","Liverpool 016C","E01006618","Total",697,692,5
"2011","Liverpool 016D","E01006625","Total",623,609,14
"2011","Liverpool 016E","E01006626","Total",606,593,13
"2011","Liverpool 017A","E01006637","Total",707,670,37
"2011","Liverpool 017B","E01006638","Total",534,518,16
"2011","Liverpool 017C","E01006639","Total",672,640,32
"2011","Liverpool 017D","E01006644","Total",1014,963,51
"2011","Liverpool 017E","E01006645","Total",702,690,12
"2011","Liverpool 018A","E01006542","Total",633,583,50
"2011","Liverpool 018B","E01006558","Total",797,739,58
"2011","Liverpool 018E","E01006562","Total",756,714,42
"2011","Liverpool 018F","E01033747","Total",519,496,23
"2011","Liverpool 019A","E01006545","Total",674,646,28
"2011","Liverpool 019B","E01006546","Total",630,583,47
"2011","Liverpool 019C","E01006547","Total",771,718,53
"2011","Liverpool 019D","E01006548","Total",787,759,28
"2011","Liverpool 019E","E01006766","Total",633,574,59
"2011","Liverpool 019F","E01006767","Total",832,779,53
"2011","Liverpool 020A","E01006606","Total",735,723,12
"2011","Liverpool 020B","E01006761","Total",805,793,12
"2011","Liverpool 020C","E01006763","Total",677,652,25
"2011","Liverpool 020D","E01006764","Total",722,667,55
"2011","Liverpool 020E","E01006765","Total",672,659,13
"2011","Liverpool 020F","E01006768","Total",627,587,40
"2011","Liverpool 021A","E01006617","Total",667,650,17
"2011","Liverpool 021B","E01006619","Total",749,734,15
"2011","Liverpool 021C","E01006620","Total",656,625,31
"2011","Liverpool 021D","E01006621","Total",607,584,23
"2011","Liverpool 021E","E01006622","Total",601,586,15
"2011","Liverpool 021F","E01006640","Total",778,760,18
"2011","Liverpool 022B","E01006776","Total",870,844,26
"2011","Liverpool 022D","E01006779","Total",917,902,15
"2011","Liverpool 022E","E01033764","Total",1212,1172,40
"2011","Liverpool 023A","E01006560","Total",999,996,3
"2011","Liverpool 023B","E01006564","Total",807,800,7
"2011","Liverpool 023C","E01006646","Total",1048,1006,42
"2011","Liverpool 023D","E01006648","Total",1103,1075,28
"2011","Liverpool 024A","E01006540","Total",817,771,46
"2011","Liverpool 024B","E01006563","Total",935,908,27
"2011","Liverpool 024C","E01006647","Total",640,636,4
"2011","Liverpool 024D","E01006693","Total",865,838,27
"2011","Liverpool 025A","E01006572","Total",517,501,16
"2011","Liverpool 025B","E01006574","Total",627,612,15
"2011","Liverpool 025C","E01006641","Total",646,633,13
"2011","Liverpool 025D","E01006642","Total",606,590,16
"2011","Liverpool 025E","E01006643","Total",764,740,24
"2011","Liverpool 026A","E01006567","Total",925,892,33
"2011","Liverpool 026B","E01006568","Total",651,629,22
"2011","Liverpool 026C","E01006570","Total",615,595,20
"2011","Liverpool 026D","E01006571","Total",624,612,12
"2011","Liverpool 027A","E01006711","Total",742,685,57
"2011","Liverpool 027D","E01006717","Total",594,576,18
"2011","Liverpool 027E","E01006718","Total",700,678,22
"2011","Liverpool 027F","E01006719","Total",655,638,17
"2011","Liverpool 027G","E01032508","Total",913,847,66
"2011","Liverpool 027H","E01032509","Total",694,665,29
"2011","Liverpool 028A","E01006690","Total",859,801,58
"2011","Liverpool 028B","E01006692","Total",1045,989,56
"2011","Liverpool 028C","E01006695","Total",1111,1029,82
"2011","Liverpool 028D","E01006759","Total",480,460,20
"2011","Liverpool 028E","E01006760","Total",899,826,73
"2011","Liverpool 029A","E01006565","Total",648,638,10
"2011","Liverpool 029B","E01006569","Total",632,613,19
"2011","Liverpool 029C","E01006573","Total",813,778,35
"2011","Liverpool 029D","E01006712","Total",587,569,18
"2011","Liverpool 029E","E01006713","Total",623,604,19
"2011","Liverpool 030A","E01006691","Total",701,647,54
"2011","Liverpool 030B","E01006694","Total",981,891,90
"2011","Liverpool 030C","E01006696","Total",826,768,58
"2011","Liverpool 030D","E01006697","Total",889,828,61
"2011","Liverpool 030E","E01006746","Total",670,655,15
"2011","Liverpool 031A","E01006512","Total",899,799,100
"2011","Liverpool 031B","E01006747","Total",891,857,34
"2011","Liverpool 031C","E01006748","Total",777,756,21
"2011","Liverpool 031F","E01006751","Total",848,831,17
"2011","Liverpool 031G","E01033763","Total",856,820,36
"2011","Liverpool 032A","E01006566","Total",608,577,31
"2011","Liverpool 032B","E01006585","Total",662,641,21
"2011","Liverpool 032C","E01006586","Total",946,921,25
"2011","Liverpool 032D","E01006587","Total",749,717,32
"2011","Liverpool 032E","E01006716","Total",722,701,21
"2011","Liverpool 034A","E01006575","Total",591,578,13
"2011","Liverpool 034B","E01006576","Total",724,713,11
"2011","Liverpool 034C","E01006577","Total",605,597,8
"2011","Liverpool 034D","E01006579","Total",622,618,4
"2011","Liverpool 034E","E01006584","Total",627,611,16
"2011","Liverpool 035A","E01006720","Total",990,905,85
"2011","Liverpool 035B","E01006725","Total",769,739,30
"2011","Liverpool 035C","E01006726","Total",707,659,48
"2011","Liverpool 035D","E01006727","Total",699,665,34
"2011","Liverpool 035E","E01006728","Total",901,855,46
"2011","Liverpool 035F","E01006752","Total",507,489,18
"2011","Liverpool 036A","E01006578","Total",560,554,6
"2011","Liverpool 036B","E01006580","Total",523,515,8
"2011","Liverpool 036C","E01006581","Total",619,607,12
"2011","Liverpool 036D","E01006773","Total",567,554,13
"2011","Liverpool 036E","E01006774","Total",554,552,2
"2011","Liverpool 037A","E01006514","Total",1194,1115,79
"2011","Liverpool 037B","E01006515","Total",665,641,24
"2011","Liverpool 037D","E01006673","Total",998,954,44
"2011","Liverpool 037E","E01033757","Total",777,715,62
"2011","Liverpool 037F","E01033768","Total",889,835,54
"2011","Liverpool 038A","E01006550","Total",512,483,29
"2011","Liverpool 038B","E01006557","Total",666,635,31
"2011","Liverpool 038C","E01006721","Total",965,912,53
"2011","Liverpool 038D","E01006722","Total",649,608,41
"2011","Liverpool 038E","E01006723","Total",774,749,25
"2011","Liverpool 038F","E01006724","Total",571,554,17
"2011","Liverpool 039A","E01006552","Total",927,869,58
"2011","Liverpool 039B","E01006556","Total",1083,1016,67
"2011","Liverpool 039C","E01006674","Total",1003,826,177
"2011","Liverpool 039D","E01006679","Total",962,920,42
"2011","Liverpool 040A","E01006709","Total",698,685,13
"2011","Liverpool 040B","E01006769","Total",721,712,9
"2011","Liverpool 040C","E01006770","Total",457,445,12
"2011","Liverpool 040D","E01006771","Total",703,694,9
"2011","Liverpool 040E","E01006772","Total",482,480,2
"2011","Liverpool 040F","E01006775","Total",558,556,2
"2011","Liverpool 041A","E01006582","Total",598,585,13
"2011","Liverpool 041B","E01006589","Total",611,599,12
"2011","Liverpool 041C","E01006591","Total",695,671,24
"2011","Liverpool 041D","E01006592","Total",656,624,32
"2011","Liverpool 041E","E01006597","Total",722,683,39
"2011","Liverpool 042A","E01006553","Total",679,642,37
"2011","Liverpool 042C","E01006588","Total",748,702,46
"2011","Liverpool 042D","E01006590","Total",739,701,38
"2011","Liverpool 042E","E01006593","Total",721,662,59
"2011","Liverpool 042F","E01033749","Total",1066,1039,27
"2011","Liverpool 042G","E01033766","Total",444,424,20
"2011","Liverpool 043A","E01006520","Total",1227,1182,45
"2011","Liverpool 043B","E01006549","Total",1041,949,92
"2011","Liverpool 043C","E01006675","Total",1304,1132,172
"2011","Liverpool 043D","E01006677","Total",788,477,311
"2011","Liverpool 044A","E01006518","Total",864,835,29
"2011","Liverpool 044B","E01006630","Total",565,555,10
"2011","Liverpool 044C","E01006632","Total",915,884,31
"2011","Liverpool 044D","E01006676","Total",800,761,39
"2011","Liverpool 044E","E01006678","Total",1109,1059,50
"2011","Liverpool 045A","E01006706","Total",584,582,2
"2011","Liverpool 045B","E01006707","Total",557,553,4
"2011","Liverpool 045C","E01006708","Total",761,754,7
"2011","Liverpool 045D","E01006710","Total",604,592,12
"2011","Liverpool 046A","E01006792","Total",592,557,35
"2011","Liverpool 046B","E01006794","Total",737,711,26
"2011","Liverpool 046C","E01006800","Total",693,679,14
"2011","Liverpool 046D","E01006801","Total",625,609,16
"2011","Liverpool 047A","E01006532","Total",635,617,18
"2011","Liverpool 047B","E01006539","Total",626,601,25
"2011","Liverpool 047C","E01006583","Total",475,467,8
"2011","Liverpool 047D","E01006594","Total",591,579,12
"2011","Liverpool 047E","E01006796","Total",590,581,9
"2011","Liverpool 048A","E01006522","Total",1137,1094,43
"2011","Liverpool 048B","E01006524","Total",623,583,40
"2011","Liverpool 048C","E01006526","Total",675,654,21
"2011","Liverpool 048D","E01006529","Total",570,559,11
"2011","Liverpool 048E","E01006551","Total",771,751,20
"2011","Liverpool 048F","E01006554","Total",690,649,41
"2011","Liverpool 049A","E01006525","Total",499,486,13
"2011","Liverpool 049B","E01006595","Total",849,812,37
"2011","Liverpool 049C","E01006596","Total",624,597,27
"2011","Liverpool 049D","E01006689","Total",725,717,8
"2011","Liverpool 050B","E01006633","Total",721,699,22
"2011","Liverpool 050F","E01032505","Total",585,563,22
"2011","Liverpool 050G","E01032506","Total",689,656,33
"2011","Liverpool 050H","E01032507","Total",711,666,45
"2011","Liverpool 050I","E01033748","Total",829,772,57
"2011","Liverpool 050J","E01033767","Total",595,562,33
"2011","Liverpool 051A","E01006793","Total",790,759,31
"2011","Liverpool 051B","E01006795","Total",649,628,21
"2011","Liverpool 051C","E01006797","Total",722,707,15
"2011","Liverpool 051D","E01006798","Total",621,609,12
"2011","Liverpool 051E","E01006799","Total",1205,1145,60
"2011","Liverpool 052A","E01006521","Total",994,928,66
"2011","Liverpool 052B","E01006523","Total",882,830,52
"2011","Liverpool 052C","E01006528","Total",644,613,31
"2011","Liverpool 052D","E01006628","Total",680,651,29
"2011","Liverpool 052E","E01006629","Total",592,573,19
"2011","Liverpool 053A","E01006527","Total",670,638,32
"2011","Liverpool 053B","E01006680","Total",623,605,18
"2011","Liverpool 053C","E01006682","Total",507,498,9
"2011","Liverpool 053D","E01006683","Total",606,594,12
"2011","Liverpool 053E","E01006686","Total",541,531,10
"2011","Liverpool 054A","E01006534","Total",673,649,24
"2011","Liverpool 054B","E01006535","Total",678,656,22
"2011","Liverpool 054C","E01006536","Total",849,815,34
"2011","Liverpool 054D","E01006681","Total",738,719,19
"2011","Liverpool 055A","E01006530","Total",632,616,16
"2011","Liverpool 055B","E01006531","Total",692,674,18
"2011","Liverpool 055C","E01006533","Total",630,614,16
"2011","Liverpool 055D","E01006537","Total",1005,964,41
"2011","Liverpool 055E","E01006538","Total",538,527,11
"2011","Liverpool 056A","E01006519","Total",540,514,26
"2011","Liverpool 056B","E01006684","Total",1028,999,29
"2011","Liverpool 056C","E01006685","Total",619,604,15
"2011","Liverpool 056D","E01006687","Total",990,933,57
"2011","Liverpool 056E","E01006688","Total",735,712,23
"2011","Liverpool 057A","E01006740","Total",620,604,16
"2011","Liverpool 057B","E01006742","Total",615,591,24
"2011","Liverpool 057C","E01006744","Total",775,739,36
"2011","Liverpool 057D","E01006745","Total",949,907,42
"2011","Liverpool 058A","E01006738","Total",676,662,14
"2011","Liverpool 058B","E01006739","Total",718,707,11
"2011","Liverpool 058C","E01006741","Total",789,778,11
"2011","Liverpool 058D","E01006743","Total",1026,1008,18
"2011","Liverpool 059A","E01006753","Total",677,666,11
"2011","Liverpool 059B","E01006754","Total",837,781,56
"2011","Liverpool 059C","E01006755","Total",706,690,16
"2011","Liverpool 059D","E01006756","Total",769,757,12
"2011","Liverpool 059E","E01006757","Total",634,621,13
"2011","Liverpool 059F","E01006758","Total",644,639,5
"2011","Liverpool 060A","E01006513","Total",998,909,89
"2011","Liverpool 060B","E01033758","Total",562,475,87
"2011","Liverpool 060C","E01033760","Total",576,529,47
"2011","Liverpool 060D","E01033761","Total",920,832,88
"2011","Liverpool 060E","E01033762","Total",468,456,12
"2011","Liverpool 061A","E01033750","Total",990,905,85
"2011","Liverpool 061B","E01033754","Total",1026,838,188
"2011","Liverpool 061C","E01033756","Total",934,733,201
"2011","Liverpool 061D","E01033765","Total",715,659,56
"2011","Liverpool 062A","E01033751","Total",640,603,37
"2011","Liverpool 062B","E01033752","Total",910,790,120
"2011","Liverpool 062C","E01033753","Total",757,714,43
"2011","Liverpool 062D","E01033755","Total",749,675,74
"2011","Sefton 001A","E01006946","Total",703,680,23
"2011","Sefton 001B","E01007028","Total",604,593,11
"2011","Sefton 001C","E01007029","Total",630,612,18
"2011","Sefton 001D","E01007030","Total",655,636,19
"2011","Sefton 001E","E01007036","Total",547,538,9
"2011","Sefton 002A","E01006947","Total",626,609,17
"2011","Sefton 002B","E01007031","Total",607,586,21
"2011","Sefton 002C","E01007032","Total",568,550,18
"2011","Sefton 002D","E01007033","Total",668,646,22
"2011","Sefton 002E","E01007035","Total",651,620,31
"2011","Sefton 003A","E01006944","Total",1007,902,105
"2011","Sefton 003B","E01006948","Total",669,655,14
"2011","Sefton 003C","E01006949","Total",789,730,59
"2011","Sefton 003D","E01006951","Total",830,773,57
"2011","Sefton 003E","E01007034","Total",597,579,18
"2011","Sefton 004A","E01006945","Total",936,802,134
"2011","Sefton 004B","E01006950","Total",1045,800,245
"2011","Sefton 004C","E01006968","Total",1365,1052,313
"2011","Sefton 004D","E01006969","Total",723,667,56
"2011","Sefton 004F","E01033094","Total",769,565,204
"2011","Sefton 004G","E01033097","Total",741,600,141
"2011","Sefton 005A","E01007055","Total",585,580,5
"2011","Sefton 005B","E01007056","Total",692,672,20
"2011","Sefton 005C","E01007057","Total",670,656,14
"2011","Sefton 005D","E01007062","Total",624,597,27
"2011","Sefton 005E","E01007063","Total",654,635,19
"2011","Sefton 006A","E01007058","Total",693,630,63
"2011","Sefton 006B","E01007059","Total",629,608,21
"2011","Sefton 006C","E01007060","Total",612,590,22
"2011","Sefton 006D","E01007061","Total",581,567,14
"2011","Sefton 006E","E01007064","Total",493,473,20
"2011","Sefton 007A","E01006934","Total",689,648,41
"2011","Sefton 007B","E01006970","Total",874,770,104
"2011","Sefton 007C","E01006994","Total",721,649,72
"2011","Sefton 007D","E01006996","Total",719,645,74
"2011","Sefton 007E","E01006998","Total",735,699,36
"2011","Sefton 008A","E01006995","Total",519,488,31
"2011","Sefton 008B","E01006997","Total",644,613,31
"2011","Sefton 008C","E01006999","Total",706,685,21
"2011","Sefton 008D","E01007000","Total",535,517,18
"2011","Sefton 008E","E01007001","Total",697,670,27
"2011","Sefton 008F","E01007002","Total",605,585,20
"2011","Sefton 009A","E01006928","Total",619,583,36
"2011","Sefton 009B","E01006935","Total",711,688,23
"2011","Sefton 009C","E01006971","Total",883,807,76
"2011","Sefton 009D","E01006972","Total",978,907,71
"2011","Sefton 009E","E01006973","Total",712,643,69
"2011","Sefton 009F","E01006974","Total",714,681,33
"2011","Sefton 010A","E01006929","Total",638,616,22
"2011","Sefton 010B","E01006930","Total",641,620,21
"2011","Sefton 010C","E01006931","Total",662,642,20
"2011","Sefton 010D","E01006932","Total",607,592,15
"2011","Sefton 010E","E01006933","Total",605,595,10
"2011","Sefton 011A","E01006920","Total",735,699,36
"2011","Sefton 011B","E01006924","Total",694,681,13
"2011","Sefton 011C","E01006925","Total",613,598,15
"2011","Sefton 011D","E01006927","Total",778,755,23
"2011","Sefton 012A","E01006921","Total",610,596,14
"2011","Sefton 012B","E01006922","Total",640,605,35
"2011","Sefton 012C","E01006923","Total",702,682,20
"2011","Sefton 012D","E01006926","Total",743,717,26
"2011","Sefton 013A","E01006985","Total",618,599,19
"2011","Sefton 013B","E01006986","Total",530,515,15
"2011","Sefton 013C","E01006987","Total",550,540,10
"2011","Sefton 013D","E01006989","Total",566,557,9
"2011","Sefton 013E","E01006990","Total",488,477,11
"2011","Sefton 014A","E01006988","Total",659,625,34
"2011","Sefton 014B","E01007079","Total",677,650,27
"2011","Sefton 014C","E01007080","Total",632,612,20
"2011","Sefton 014D","E01007081","Total",775,722,53
"2011","Sefton 015A","E01006991","Total",613,603,10
"2011","Sefton 015B","E01006992","Total",454,444,10
"2011","Sefton 015C","E01006993","Total",594,586,8
"2011","Sefton 015D","E01007078","Total",661,646,15
"2011","Sefton 016A","E01007075","Total",628,615,13
"2011","Sefton 016B","E01007076","Total",596,575,21
"2011","Sefton 016C","E01007077","Total",605,593,12
"2011","Sefton 016D","E01007082","Total",624,614,10
"2011","Sefton 017A","E01007067","Total",601,591,10
"2011","Sefton 017B","E01007068","Total",488,481,7
"2011","Sefton 017C","E01007069","Total",683,660,23
"2011","Sefton 017D","E01007070","Total",614,602,12
"2011","Sefton 017E","E01007101","Total",624,608,16
"2011","Sefton 018C","E01007095","Total",738,706,32
"2011","Sefton 018D","E01007096","Total",580,567,13
"2011","Sefton 018E","E01007100","Total",607,593,14
"2011","Sefton 018F","E01033096","Total",1012,989,23
"2011","Sefton 019A","E01007074","Total",632,622,10
"2011","Sefton 019B","E01007097","Total",665,654,11
"2011","Sefton 019C","E01007098","Total",645,624,21
"2011","Sefton 019D","E01007099","Total",683,655,28
"2011","Sefton 020A","E01007065","Total",511,501,10
"2011","Sefton 020B","E01007066","Total",612,601,11
"2011","Sefton 020C","E01007071","Total",531,503,28
"2011","Sefton 020D","E01007072","Total",709,685,24
"2011","Sefton 020E","E01007073","Total",506,499,7
"2011","Sefton 021A","E01007020","Total",597,580,17
"2011","Sefton 021B","E01007022","Total",613,597,16
"2011","Sefton 021C","E01007023","Total",546,529,17
"2011","Sefton 021D","E01007027","Total",903,892,11
"2011","Sefton 021E","E01007037","Total",684,656,28
"2011","Sefton 021F","E01007038","Total",636,611,25
"2011","Sefton 022A","E01006936","Total",828,765,63
"2011","Sefton 022B","E01006937","Total",494,482,12
"2011","Sefton 022C","E01006938","Total",573,535,38
"2011","Sefton 022D","E01006939","Total",708,663,45
"2011","Sefton 022E","E01006940","Total",630,599,31
"2011","Sefton 022F","E01006943","Total",492,479,13
"2011","Sefton 023A","E01007083","Total",483,476,7
"2011","Sefton 023B","E01007085","Total",610,580,30
"2011","Sefton 023C","E01007086","Total",510,501,9
"2011","Sefton 023D","E01007091","Total",624,607,17
"2011","Sefton 023E","E01007092","Total",471,459,12
"2011","Sefton 024A","E01006979","Total",631,619,12
"2011","Sefton 024B","E01006980","Total",661,656,5
"2011","Sefton 024C","E01007024","Total",484,478,6
"2011","Sefton 024D","E01007026","Total",531,515,16
"2011","Sefton 024E","E01007089","Total",623,603,20
"2011","Sefton 025A","E01007021","Total",558,541,17
"2011","Sefton 025B","E01007025","Total",546,534,12
"2011","Sefton 025C","E01007105","Total",737,709,28
"2011","Sefton 025D","E01007106","Total",644,630,14
"2011","Sefton 025E","E01007107","Total",490,485,5
"2011","Sefton 025F","E01007108","Total",618,599,19
"2011","Sefton 026A","E01007039","Total",528,512,16
"2011","Sefton 026B","E01007040","Total",778,747,31
"2011","Sefton 026C","E01007042","Total",562,546,16
"2011","Sefton 026D","E01007044","Total",635,621,14
"2011","Sefton 026E","E01007045","Total",491,486,5
"2011","Sefton 027A","E01007041","Total",595,570,25
"2011","Sefton 027B","E01007043","Total",624,611,13
"2011","Sefton 027C","E01007046","Total",649,637,12
"2011","Sefton 027D","E01007053","Total",571,556,15
"2011","Sefton 027E","E01007084","Total",545,539,6
"2011","Sefton 028A","E01006941","Total",740,696,44
"2011","Sefton 028B","E01006942","Total",650,640,10
"2011","Sefton 028C","E01006954","Total",702,680,22
"2011","Sefton 028D","E01007104","Total",593,563,30
"2011","Sefton 028E","E01007109","Total",718,675,43
"2011","Sefton 029A","E01007048","Total",659,635,24
"2011","Sefton 029B","E01007054","Total",633,613,20
"2011","Sefton 029C","E01007087","Total",635,614,21
"2011","Sefton 029D","E01007088","Total",593,575,18
"2011","Sefton 029E","E01007090","Total",561,543,18
"2011","Sefton 030A","E01006955","Total",637,621,16
"2011","Sefton 030B","E01006956","Total",820,679,141
"2011","Sefton 030C","E01006958","Total",796,718,78
"2011","Sefton 030D","E01007102","Total",612,579,33
"2011","Sefton 030E","E01007103","Total",630,614,16
"2011","Sefton 031A","E01006978","Total",577,569,8
"2011","Sefton 031B","E01006981","Total",629,618,11
"2011","Sefton 031C","E01006982","Total",566,557,9
"2011","Sefton 031D","E01006983","Total",694,686,8
"2011","Sefton 031E","E01006984","Total",508,498,10
"2011","Sefton 032A","E01006952","Total",733,627,106
"2011","Sefton 032B","E01006953","Total",696,666,30
"2011","Sefton 032C","E01006957","Total",976,857,119
"2011","Sefton 032D","E01006959","Total",766,666,100
"2011","Sefton 032E","E01006977","Total",915,880,35
"2011","Sefton 033A","E01006976","Total",602,594,8
"2011","Sefton 033B","E01007014","Total",660,650,10
"2011","Sefton 033E","E01007047","Total",677,655,22
"2011","Sefton 033F","E01033095","Total",771,747,24
"2011","Sefton 034A","E01007004","Total",688,654,34
"2011","Sefton 034B","E01007005","Total",648,602,46
"2011","Sefton 034C","E01007011","Total",788,666,122
"2011","Sefton 034D","E01007016","Total",778,738,40
"2011","Sefton 034E","E01007017","Total",774,746,28
"2011","Sefton 035A","E01007019","Total",568,530,38
"2011","Sefton 035B","E01007049","Total",688,652,36
"2011","Sefton 035C","E01007050","Total",497,488,9
"2011","Sefton 035D","E01007051","Total",541,509,32
"2011","Sefton 035E","E01007052","Total",568,548,20
"2011","Sefton 036A","E01006964","Total",761,645,116
"2011","Sefton 036B","E01007003","Total",662,568,94
"2011","Sefton 036C","E01007006","Total",651,605,46
"2011","Sefton 036D","E01007012","Total",663,600,63
"2011","Sefton 036E","E01007013","Total",787,684,103
"2011","Sefton 037A","E01006967","Total",814,753,61
"2011","Sefton 037B","E01007007","Total",718,635,83
"2011","Sefton 037C","E01007008","Total",687,644,43
"2011","Sefton 037D","E01007009","Total",772,654,118
"2011","Sefton 037E","E01007010","Total",579,519,60
"2011","Sefton 038A","E01006960","Total",470,445,25
"2011","Sefton 038B","E01006961","Total",721,632,89
"2011","Sefton 038C","E01006962","Total",675,647,28
"2011","Sefton 038D","E01006963","Total",733,633,100
"2011","Sefton 038E","E01006965","Total",607,580,27
"2011","Sefton 038F","E01006966","Total",712,640,72
"2011","St. Helens 001A","E01006882","Total",513,499,14
"2011","St. Helens 001B","E01006883","Total",636,607,29
"2011","St. Helens 001C","E01006884","Total",647,623,24
"2011","St. Helens 001D","E01006885","Total",577,546,31
"2011","St. Helens 001E","E01006886","Total",595,578,17
"2011","St. Helens 001F","E01006887","Total",621,592,29
"2011","St. Helens 002A","E01006802","Total",775,747,28
"2011","St. Helens 002B","E01006804","Total",680,660,20
"2011","St. Helens 002C","E01006806","Total",635,623,12
"2011","St. Helens 002D","E01006807","Total",602,587,15
"2011","St. Helens 003A","E01006803","Total",630,601,29
"2011","St. Helens 003B","E01006805","Total",643,620,23
"2011","St. Helens 003C","E01006808","Total",547,539,8
"2011","St. Helens 003D","E01006809","Total",625,608,17
"2011","St. Helens 004A","E01006849","Total",665,648,17
"2011","St. Helens 004B","E01006850","Total",768,738,30
"2011","St. Helens 004C","E01006851","Total",585,559,26
"2011","St. Helens 004D","E01006852","Total",536,525,11
"2011","St. Helens 004E","E01006853","Total",600,577,23
"2011","St. Helens 004F","E01006854","Total",661,640,21
"2011","St. Helens 004G","E01006855","Total",663,638,25
"2011","St. Helens 005A","E01006836","Total",635,600,35
"2011","St. Helens 005B","E01006839","Total",589,572,17
"2011","St. Helens 005C","E01006840","Total",698,669,29
"2011","St. Helens 005D","E01006842","Total",674,657,17
"2011","St. Helens 006A","E01006837","Total",638,614,24
"2011","St. Helens 006B","E01006838","Total",786,718,68
"2011","St. Helens 006C","E01006841","Total",655,645,10
"2011","St. Helens 006D","E01006843","Total",561,543,18
"2011","St. Helens 007A","E01006914","Total",550,527,23
"2011","St. Helens 007B","E01006915","Total",692,671,21
"2011","St. Helens 007C","E01006916","Total",693,660,33
"2011","St. Helens 007D","E01006917","Total",690,674,16
"2011","St. Helens 007E","E01006918","Total",539,511,28
"2011","St. Helens 007F","E01006919","Total",666,643,23
"2011","St. Helens 008A","E01006810","Total",499,493,6
"2011","St. Helens 008B","E01006811","Total",634,613,21
"2011","St. Helens 008C","E01006812","Total",624,593,31
"2011","St. Helens 008D","E01006813","Total",730,697,33
"2011","St. Helens 008E","E01006814","Total",612,602,10
"2011","St. Helens 008F","E01006815","Total",573,557,16
"2011","St. Helens 008G","E01006818","Total",536,530,6
"2011","St. Helens 009A","E01006822","Total",571,559,12
"2011","St. Helens 009B","E01006823","Total",589,570,19
"2011","St. Helens 009C","E01006824","Total",534,517,17
"2011","St. Helens 009D","E01006825","Total",623,607,16
"2011","St. Helens 010A","E01006866","Total",662,642,20
"2011","St. Helens 010B","E01006867","Total",808,784,24
"2011","St. Helens 010C","E01006868","Total",676,656,20
"2011","St. Helens 010D","E01006869","Total",682,655,27
"2011","St. Helens 011A","E01006819","Total",634,608,26
"2011","St. Helens 011B","E01006820","Total",647,611,36
"2011","St. Helens 011C","E01006821","Total",696,652,44
"2011","St. Helens 011D","E01006871","Total",710,669,41
"2011","St. Helens 012A","E01006832","Total",819,781,38
"2011","St. Helens 012B","E01006834","Total",651,610,41
"2011","St. Helens 012C","E01006877","Total",810,734,76
"2011","St. Helens 012D","E01006880","Total",809,763,46
"2011","St. Helens 012E","E01006881","Total",815,735,80
"2011","St. Helens 013A","E01006863","Total",900,829,71
"2011","St. Helens 013B","E01006864","Total",858,818,40
"2011","St. Helens 013C","E01006865","Total",863,840,23
"2011","St. Helens 014A","E01006845","Total",750,685,65
"2011","St. Helens 014B","E01006870","Total",711,648,63
"2011","St. Helens 014C","E01006872","Total",910,777,133
"2011","St. Helens 014D","E01006873","Total",521,495,26
"2011","St. Helens 014E","E01006874","Total",690,583,107
"2011","St. Helens 015A","E01006856","Total",661,614,47
"2011","St. Helens 015B","E01006857","Total",620,606,14
"2011","St. Helens 015C","E01006858","Total",634,597,37
"2011","St. Helens 015D","E01006859","Total",727,694,33
"2011","St. Helens 015E","E01006860","Total",649,625,24
"2011","St. Helens 015F","E01006861","Total",644,631,13
"2011","St. Helens 015G","E01006862","Total",603,581,22
"2011","St. Helens 016A","E01006831","Total",715,662,53
"2011","St. Helens 016B","E01006833","Total",784,754,30
"2011","St. Helens 016C","E01006835","Total",663,647,16
"2011","St. Helens 016D","E01006876","Total",704,679,25
"2011","St. Helens 016E","E01006878","Total",673,648,25
"2011","St. Helens 016F","E01006879","Total",618,598,20
"2011","St. Helens 016G","E01006904","Total",705,670,35
"2011","St. Helens 017A","E01006816","Total",732,706,26
"2011","St. Helens 017B","E01006817","Total",653,623,30
"2011","St. Helens 017C","E01006875","Total",538,509,29
"2011","St. Helens 017D","E01006899","Total",833,813,20
"2011","St. Helens 018A","E01006826","Total",663,648,15
"2011","St. Helens 018B","E01006827","Total",631,614,17
"2011","St. Helens 018C","E01006828","Total",905,877,28
"2011","St. Helens 018D","E01006829","Total",537,518,19
"2011","St. Helens 019A","E01006830","Total",541,538,3
"2011","St. Helens 019C","E01006903","Total",816,752,64
"2011","St. Helens 019D","E01006905","Total",603,584,19
"2011","St. Helens 019E","E01006906","Total",699,661,38
"2011","St. Helens 019F","E01006907","Total",709,668,41
"2011","St. Helens 019G","E01006912","Total",697,613,84
"2011","St. Helens 019H","E01006913","Total",534,525,9
"2011","St. Helens 019I","E01032904","Total",708,688,20
"2011","St. Helens 019J","E01032905","Total",696,671,25
"2011","St. Helens 020A","E01006844","Total",860,771,89
"2011","St. Helens 020B","E01006846","Total",634,616,18
"2011","St. Helens 020C","E01006847","Total",719,685,34
"2011","St. Helens 020D","E01006848","Total",644,629,15
"2011","St. Helens 020E","E01006896","Total",668,660,8
"2011","St. Helens 020F","E01006897","Total",646,629,17
"2011","St. Helens 020G","E01006901","Total",543,533,10
"2011","St. Helens 021A","E01006890","Total",630,616,14
"2011","St. Helens 021B","E01006892","Total",569,482,87
"2011","St. Helens 021C","E01006893","Total",639,617,22
"2011","St. Helens 021D","E01006894","Total",611,584,27
"2011","St. Helens 022A","E01006898","Total",796,744,52
"2011","St. Helens 022B","E01006900","Total",1111,1066,45
"2011","St. Helens 022C","E01006908","Total",646,604,42
"2011","St. Helens 022D","E01006909","Total",525,497,28
"2011","St. Helens 022E","E01006910","Total",788,749,39
"2011","St. Helens 022F","E01006911","Total",634,616,18
"2011","St. Helens 023A","E01006888","Total",503,499,4
"2011","St. Helens 023B","E01006889","Total",579,570,9
"2011","St. Helens 023C","E01006891","Total",559,538,21
"2011","St. Helens 023D","E01006895","Total",662,645,17
"2011","Wirral 001A","E01007229","Total",742,699,43
"2011","Wirral 001B","E01007230","Total",587,566,21
"2011","Wirral 001C","E01007231","Total",774,728,46
"2011","Wirral 001D","E01007237","Total",910,866,44
"2011","Wirral 001E","E01007238","Total",916,873,43
"2011","Wirral 002A","E01007218","Total",680,654,26
"2011","Wirral 002B","E01007232","Total",653,619,34
"2011","Wirral 002C","E01007233","Total",791,765,26
"2011","Wirral 002D","E01007234","Total",759,715,44
"2011","Wirral 002E","E01007236","Total",608,593,15
"2011","Wirral 003A","E01007307","Total",727,700,27
"2011","Wirral 003B","E01007308","Total",764,731,33
"2011","Wirral 003C","E01007312","Total",683,662,21
"2011","Wirral 003D","E01007313","Total",790,761,29
"2011","Wirral 003E","E01007315","Total",629,611,18
"2011","Wirral 004A","E01007211","Total",514,502,12
"2011","Wirral 004B","E01007235","Total",620,607,13
"2011","Wirral 004C","E01007310","Total",544,528,16
"2011","Wirral 004D","E01007311","Total",635,616,19
"2011","Wirral 004E","E01007314","Total",623,605,18
"2011","Wirral 004F","E01007316","Total",612,598,14
"2011","Wirral 005A","E01007215","Total",822,784,38
"2011","Wirral 005B","E01007216","Total",673,661,12
"2011","Wirral 005C","E01007219","Total",647,628,19
"2011","Wirral 005D","E01007220","Total",581,548,33
"2011","Wirral 005E","E01007275","Total",717,680,37
"2011","Wirral 006A","E01007203","Total",881,860,21
"2011","Wirral 006B","E01007205","Total",633,619,14
"2011","Wirral 006C","E01007210","Total",897,869,28
"2011","Wirral 006D","E01007309","Total",634,621,13
"2011","Wirral 007A","E01007212","Total",633,618,15
"2011","Wirral 007B","E01007213","Total",667,648,19
"2011","Wirral 007C","E01007214","Total",712,691,21
"2011","Wirral 007D","E01007217","Total",828,790,38
"2011","Wirral 007E","E01007276","Total",620,605,15
"2011","Wirral 008A","E01007272","Total",642,605,37
"2011","Wirral 008B","E01007273","Total",703,667,36
"2011","Wirral 008C","E01007274","Total",691,670,21
"2011","Wirral 008D","E01007277","Total",691,648,43
"2011","Wirral 008E","E01007278","Total",694,658,36
"2011","Wirral 009A","E01007204","Total",694,677,17
"2011","Wirral 009B","E01007206","Total",745,730,15
"2011","Wirral 009C","E01007207","Total",711,685,26
"2011","Wirral 009D","E01007209","Total",708,685,23
"2011","Wirral 010C","E01007269","Total",845,815,30
"2011","Wirral 010D","E01007270","Total",812,778,34
"2011","Wirral 010E","E01007271","Total",790,745,45
"2011","Wirral 010F","E01032903","Total",1169,1081,88
"2011","Wirral 011A","E01007120","Total",556,543,13
"2011","Wirral 011B","E01007121","Total",709,686,23
"2011","Wirral 011C","E01007122","Total",764,720,44
"2011","Wirral 011D","E01007123","Total",763,733,30
"2011","Wirral 011E","E01007124","Total",628,614,14
"2011","Wirral 012A","E01007208","Total",746,734,12
"2011","Wirral 012B","E01007221","Total",670,651,19
"2011","Wirral 012C","E01007225","Total",778,771,7
"2011","Wirral 012D","E01007227","Total",673,645,28
"2011","Wirral 012E","E01007228","Total",728,706,22
"2011","Wirral 013A","E01007195","Total",667,647,20
"2011","Wirral 013B","E01007199","Total",617,602,15
"2011","Wirral 013C","E01007222","Total",718,707,11
"2011","Wirral 013D","E01007223","Total",572,556,16
"2011","Wirral 014A","E01007193","Total",797,740,57
"2011","Wirral 014B","E01007194","Total",702,668,34
"2011","Wirral 014C","E01007200","Total",664,655,9
"2011","Wirral 014D","E01007201","Total",665,640,25
"2011","Wirral 014E","E01007202","Total",652,623,29
"2011","Wirral 015A","E01007125","Total",810,784,26
"2011","Wirral 015B","E01007156","Total",682,660,22
"2011","Wirral 015C","E01007157","Total",616,601,15
"2011","Wirral 015D","E01007158","Total",709,684,25
"2011","Wirral 015E","E01007159","Total",760,721,39
"2011","Wirral 016A","E01007126","Total",1269,1170,99
"2011","Wirral 016B","E01007127","Total",714,670,44
"2011","Wirral 016C","E01007128","Total",967,926,41
"2011","Wirral 016D","E01007129","Total",809,761,48
"2011","Wirral 016E","E01007133","Total",725,679,46
"2011","Wirral 017A","E01007224","Total",623,610,13
"2011","Wirral 017B","E01007226","Total",772,746,26
"2011","Wirral 017C","E01007265","Total",544,531,13
"2011","Wirral 017D","E01007299","Total",600,589,11
"2011","Wirral 017E","E01007306","Total",742,726,16
"2011","Wirral 018A","E01007297","Total",661,618,43
"2011","Wirral 018B","E01007298","Total",627,598,29
"2011","Wirral 018C","E01007301","Total",722,707,15
"2011","Wirral 018D","E01007302","Total",736,711,25
"2011","Wirral 018E","E01007305","Total",747,734,13
"2011","Wirral 019A","E01007119","Total",628,614,14
"2011","Wirral 019B","E01007161","Total",666,646,20
"2011","Wirral 019C","E01007162","Total",564,556,8
"2011","Wirral 019D","E01007300","Total",812,794,18
"2011","Wirral 020A","E01007155","Total",979,919,60
"2011","Wirral 020B","E01007160","Total",870,822,48
"2011","Wirral 020C","E01007240","Total",959,861,98
"2011","Wirral 020D","E01007241","Total",756,703,53
"2011","Wirral 020E","E01007242","Total",925,864,61
"2011","Wirral 021A","E01007130","Total",751,716,35
"2011","Wirral 021B","E01007131","Total",780,724,56
"2011","Wirral 021C","E01007179","Total",647,612,35
"2011","Wirral 021D","E01007291","Total",965,917,48
"2011","Wirral 021E","E01007292","Total",697,679,18
"2011","Wirral 021F","E01007294","Total",706,673,33
"2011","Wirral 022A","E01007180","Total",708,685,23
"2011","Wirral 022B","E01007181","Total",668,640,28
"2011","Wirral 022C","E01007239","Total",829,781,48
"2011","Wirral 022D","E01007243","Total",847,824,23
"2011","Wirral 022E","E01007244","Total",958,913,45
"2011","Wirral 023A","E01007259","Total",505,496,9
"2011","Wirral 023B","E01007261","Total",625,615,10
"2011","Wirral 023C","E01007264","Total",665,656,9
"2011","Wirral 023D","E01007266","Total",625,617,8
"2011","Wirral 023E","E01007267","Total",641,622,19
"2011","Wirral 023F","E01007268","Total",596,581,15
"2011","Wirral 024A","E01007163","Total",920,907,13
"2011","Wirral 024B","E01007245","Total",649,639,10
"2011","Wirral 024C","E01007246","Total",600,592,8
"2011","Wirral 024D","E01007247","Total",672,658,14
"2011","Wirral 024E","E01007252","Total",668,655,13
"2011","Wirral 025A","E01007249","Total",601,592,9
"2011","Wirral 025B","E01007251","Total",597,542,55
"2011","Wirral 025C","E01007257","Total",646,626,20
"2011","Wirral 025D","E01007303","Total",725,700,25
"2011","Wirral 025E","E01007304","Total",656,641,15
"2011","Wirral 026A","E01007196","Total",790,749,41
"2011","Wirral 026B","E01007197","Total",697,662,35
"2011","Wirral 026C","E01007198","Total",910,836,74
"2011","Wirral 026D","E01007263","Total",641,627,14
"2011","Wirral 026E","E01007282","Total",705,665,40
"2011","Wirral 027A","E01007175","Total",907,844,63
"2011","Wirral 027B","E01007290","Total",881,835,46
"2011","Wirral 027C","E01007293","Total",744,713,31
"2011","Wirral 027D","E01007295","Total",578,522,56
"2011","Wirral 027E","E01007296","Total",866,813,53
"2011","Wirral 028A","E01007258","Total",635,624,11
"2011","Wirral 028B","E01007260","Total",653,643,10
"2011","Wirral 028C","E01007262","Total",658,637,21
"2011","Wirral 028D","E01007281","Total",630,594,36
"2011","Wirral 028E","E01007283","Total",515,492,23
"2011","Wirral 029A","E01007173","Total",604,590,14
"2011","Wirral 029B","E01007174","Total",670,646,24
"2011","Wirral 029C","E01007176","Total",793,739,54
"2011","Wirral 029D","E01007177","Total",703,684,19
"2011","Wirral 029E","E01007178","Total",747,711,36
"2011","Wirral 030A","E01007248","Total",608,577,31
"2011","Wirral 030B","E01007250","Total",568,559,9
"2011","Wirral 030C","E01007253","Total",748,727,21
"2011","Wirral 030D","E01007254","Total",632,607,25
"2011","Wirral 031A","E01007115","Total",692,673,19
"2011","Wirral 031B","E01007138","Total",840,782,58
"2011","Wirral 031C","E01007139","Total",723,683,40
"2011","Wirral 031D","E01007141","Total",910,861,49
"2011","Wirral 031E","E01007289","Total",684,664,20
"2011","Wirral 032A","E01007111","Total",603,593,10
"2011","Wirral 032B","E01007112","Total",676,655,21
"2011","Wirral 032C","E01007113","Total",601,586,15
"2011","Wirral 032D","E01007114","Total",608,591,17
"2011","Wirral 032E","E01007116","Total",709,683,26
"2011","Wirral 033A","E01007280","Total",751,741,10
"2011","Wirral 033B","E01007284","Total",709,691,18
"2011","Wirral 033C","E01007285","Total",652,638,14
"2011","Wirral 033D","E01007287","Total",890,871,19
"2011","Wirral 034A","E01007183","Total",540,527,13
"2011","Wirral 034B","E01007255","Total",673,655,18
"2011","Wirral 034C","E01007256","Total",777,746,31
"2011","Wirral 034D","E01007279","Total",683,667,16
"2011","Wirral 034E","E01007286","Total",645,639,6
"2011","Wirral 035A","E01007110","Total",738,706,32
"2011","Wirral 035B","E01007117","Total",651,640,11
"2011","Wirral 035C","E01007118","Total",665,656,9
"2011","Wirral 035D","E01007151","Total",653,636,17
"2011","Wirral 035E","E01007154","Total",634,621,13
"2011","Wirral 036A","E01007140","Total",819,787,32
"2011","Wirral 036B","E01007142","Total",788,761,27
"2011","Wirral 036C","E01007143","Total",718,703,15
"2011","Wirral 036D","E01007152","Total",797,771,26
"2011","Wirral 036E","E01007153","Total",656,643,13
"2011","Wirral 037A","E01007182","Total",763,736,27
"2011","Wirral 037B","E01007184","Total",669,642,27
"2011","Wirral 037C","E01007185","Total",730,699,31
"2011","Wirral 037D","E01007192","Total",639,611,28
"2011","Wirral 037E","E01007288","Total",758,746,12
"2011","Wirral 038A","E01007144","Total",572,545,27
"2011","Wirral 038B","E01007145","Total",543,537,6
"2011","Wirral 038C","E01007146","Total",727,714,13
"2011","Wirral 038D","E01007147","Total",626,606,20
"2011","Wirral 038E","E01007148","Total",674,664,10
"2011","Wirral 039A","E01007135","Total",663,635,28
"2011","Wirral 039B","E01007136","Total",713,699,14
"2011","Wirral 039C","E01007137","Total",801,779,22
"2011","Wirral 039D","E01007170","Total",655,634,21
"2011","Wirral 040A","E01007186","Total",679,660,19
"2011","Wirral 040B","E01007187","Total",670,653,17
"2011","Wirral 040C","E01007188","Total",635,616,19
"2011","Wirral 040D","E01007189","Total",739,717,22
"2011","Wirral 040E","E01007190","Total",660,641,19
"2011","Wirral 040F","E01007191","Total",556,534,22
"2011","Wirral 041A","E01007149","Total",641,621,20
"2011","Wirral 041B","E01007150","Total",599,593,6
"2011","Wirral 041C","E01007165","Total",580,570,10
"2011","Wirral 041D","E01007171","Total",631,617,14
"2011","Wirral 041E","E01007172","Total",623,608,15
"2011","Wirral 042A","E01007164","Total",758,737,21
"2011","Wirral 042B","E01007166","Total",651,636,15
"2011","Wirral 042C","E01007167","Total",635,615,20
"2011","Wirral 042D","E01007168","Total",793,777,16
"2011","Wirral 042E","E01007169","Total",782,761,21
"2011","East Riding of Yorkshire 001A","E01012933","Total",527,476,51
"2011","East Riding of Yorkshire 001B","E01012934","Total",763,711,52
"2011","East Riding of Yorkshire 001C","E01012938","Total",1174,1095,79
"2011","East Riding of Yorkshire 001D","E01012939","Total",858,802,56
"2011","East Riding of Yorkshire 001E","E01012940","Total",884,837,47
"2011","East Riding of Yorkshire 001F","E01012941","Total",757,707,50
"2011","East Riding of Yorkshire 002A","E01012929","Total",832,794,38
"2011","East Riding of Yorkshire 002B","E01012930","Total",667,637,30
"2011","East Riding of Yorkshire 002C","E01012935","Total",665,610,55
"2011","East Riding of Yorkshire 002D","E01012937","Total",1268,1045,223
"2011","East Riding of Yorkshire 002E","E01012942","Total",741,653,88
"2011","East Riding of Yorkshire 003A","E01012928","Total",781,719,62
"2011","East Riding of Yorkshire 003B","E01012931","Total",868,810,58
"2011","East Riding of Yorkshire 003C","E01012932","Total",784,713,71
"2011","East Riding of Yorkshire 003D","E01012946","Total",724,696,28
"2011","East Riding of Yorkshire 003E","E01012949","Total",661,633,28
"2011","East Riding of Yorkshire 004A","E01012936","Total",832,688,144
"2011","East Riding of Yorkshire 004B","E01012943","Total",789,701,88
"2011","East Riding of Yorkshire 004C","E01012945","Total",804,717,87
"2011","East Riding of Yorkshire 004D","E01012952","Total",781,653,128
"2011","East Riding of Yorkshire 005A","E01012944","Total",884,719,165
"2011","East Riding of Yorkshire 005B","E01012947","Total",641,578,63
"2011","East Riding of Yorkshire 005C","E01012948","Total",819,652,167
"2011","East Riding of Yorkshire 005D","E01012951","Total",677,574,103
"2011","East Riding of Yorkshire 006A","E01012950","Total",627,592,35
"2011","East Riding of Yorkshire 006B","E01012990","Total",665,600,65
"2011","East Riding of Yorkshire 006C","E01012991","Total",701,663,38
"2011","East Riding of Yorkshire 006D","E01012992","Total",746,656,90
"2011","East Riding of Yorkshire 008A","E01012978","Total",665,649,16
"2011","East Riding of Yorkshire 008B","E01012981","Total",641,611,30
"2011","East Riding of Yorkshire 008C","E01012983","Total",754,740,14
"2011","East Riding of Yorkshire 008D","E01012989","Total",771,751,20
"2011","East Riding of Yorkshire 008E","E01013125","Total",784,734,50
"2011","East Riding of Yorkshire 009A","E01013057","Total",633,614,19
"2011","East Riding of Yorkshire 009B","E01013059","Total",685,679,6
"2011","East Riding of Yorkshire 009C","E01013060","Total",814,795,19
"2011","East Riding of Yorkshire 009D","E01013061","Total",709,697,12
"2011","East Riding of Yorkshire 009E","E01013126","Total",616,599,17
"2011","East Riding of Yorkshire 010A","E01012986","Total",791,738,53
"2011","East Riding of Yorkshire 010B","E01012987","Total",745,704,41
"2011","East Riding of Yorkshire 010C","E01012988","Total",662,646,16
"2011","East Riding of Yorkshire 010D","E01013048","Total",906,866,40
"2011","East Riding of Yorkshire 011A","E01013052","Total",648,637,11
"2011","East Riding of Yorkshire 011B","E01013053","Total",669,654,15
"2011","East Riding of Yorkshire 011C","E01013054","Total",827,801,26
"2011","East Riding of Yorkshire 011D","E01013055","Total",689,671,18
"2011","East Riding of Yorkshire 011E","E01013056","Total",783,747,36
"2011","East Riding of Yorkshire 011F","E01013058","Total",617,599,18
"2011","East Riding of Yorkshire 011G","E01013119","Total",665,628,37
"2011","East Riding of Yorkshire 012A","E01013046","Total",810,767,43
"2011","East Riding of Yorkshire 012B","E01013047","Total",758,701,57
"2011","East Riding of Yorkshire 012C","E01013049","Total",818,754,64
"2011","East Riding of Yorkshire 012D","E01013050","Total",768,734,34
"2011","East Riding of Yorkshire 012E","E01013051","Total",689,670,19
"2011","East Riding of Yorkshire 013A","E01012922","Total",668,642,26
"2011","East Riding of Yorkshire 013B","E01012923","Total",643,603,40
"2011","East Riding of Yorkshire 013C","E01012925","Total",544,534,10
"2011","East Riding of Yorkshire 013D","E01012927","Total",665,648,17
"2011","East Riding of Yorkshire 014A","E01012924","Total",717,703,14
"2011","East Riding of Yorkshire 014B","E01012926","Total",1087,1059,28
"2011","East Riding of Yorkshire 014C","E01013027","Total",763,736,27
"2011","East Riding of Yorkshire 014D","E01013034","Total",748,734,14
"2011","East Riding of Yorkshire 015A","E01013120","Total",859,834,25
"2011","East Riding of Yorkshire 015B","E01013121","Total",794,769,25
"2011","East Riding of Yorkshire 015C","E01013123","Total",693,663,30
"2011","East Riding of Yorkshire 015D","E01013124","Total",1069,987,82
"2011","East Riding of Yorkshire 016A","E01013064","Total",529,526,3
"2011","East Riding of Yorkshire 016B","E01013065","Total",757,742,15
"2011","East Riding of Yorkshire 016C","E01013066","Total",712,691,21
"2011","East Riding of Yorkshire 016D","E01013067","Total",713,701,12
"2011","East Riding of Yorkshire 016E","E01013068","Total",652,630,22
"2011","East Riding of Yorkshire 016F","E01013070","Total",721,687,34
"2011","East Riding of Yorkshire 017A","E01013038","Total",621,612,9
"2011","East Riding of Yorkshire 017B","E01013045","Total",651,642,9
"2011","East Riding of Yorkshire 017C","E01013069","Total",723,702,21
"2011","East Riding of Yorkshire 017D","E01013071","Total",826,802,24
"2011","East Riding of Yorkshire 018A","E01013022","Total",797,754,43
"2011","East Riding of Yorkshire 018B","E01013023","Total",785,754,31
"2011","East Riding of Yorkshire 018C","E01013024","Total",774,751,23
"2011","East Riding of Yorkshire 018D","E01013122","Total",620,589,31
"2011","East Riding of Yorkshire 018E","E01013127","Total",639,608,31
"2011","East Riding of Yorkshire 019A","E01013036","Total",828,791,37
"2011","East Riding of Yorkshire 019B","E01013037","Total",670,656,14
"2011","East Riding of Yorkshire 019C","E01013040","Total",941,881,60
"2011","East Riding of Yorkshire 019D","E01013041","Total",931,883,48
"2011","East Riding of Yorkshire 019E","E01013062","Total",970,903,67
"2011","East Riding of Yorkshire 019F","E01013063","Total",711,684,27
"2011","East Riding of Yorkshire 020A","E01012919","Total",553,531,22
"2011","East Riding of Yorkshire 020B","E01012921","Total",504,486,18
"2011","East Riding of Yorkshire 020C","E01013039","Total",817,784,33
"2011","East Riding of Yorkshire 020D","E01013042","Total",668,655,13
"2011","East Riding of Yorkshire 020E","E01013043","Total",555,548,7
"2011","East Riding of Yorkshire 020F","E01013044","Total",673,659,14
"2011","East Riding of Yorkshire 021A","E01013029","Total",661,632,29
"2011","East Riding of Yorkshire 021B","E01013030","Total",670,654,16
"2011","East Riding of Yorkshire 021C","E01013031","Total",644,630,14
"2011","East Riding of Yorkshire 021D","E01013032","Total",639,622,17
"2011","East Riding of Yorkshire 021E","E01013035","Total",567,551,16
"2011","East Riding of Yorkshire 022A","E01012954","Total",556,543,13
"2011","East Riding of Yorkshire 022B","E01012956","Total",490,477,13
"2011","East Riding of Yorkshire 022C","E01012958","Total",500,486,14
"2011","East Riding of Yorkshire 022D","E01012961","Total",705,683,22
"2011","East Riding of Yorkshire 022E","E01012966","Total",596,576,20
"2011","East Riding of Yorkshire 023A","E01012953","Total",500,485,15
"2011","East Riding of Yorkshire 023B","E01012955","Total",688,666,22
"2011","East Riding of Yorkshire 023C","E01012959","Total",667,642,25
"2011","East Riding of Yorkshire 023D","E01012962","Total",484,471,13
"2011","East Riding of Yorkshire 023E","E01012964","Total",766,746,20
"2011","East Riding of Yorkshire 024A","E01012920","Total",649,622,27
"2011","East Riding of Yorkshire 024B","E01012965","Total",430,422,8
"2011","East Riding of Yorkshire 024C","E01012967","Total",677,660,17
"2011","East Riding of Yorkshire 024D","E01012968","Total",728,701,27
"2011","East Riding of Yorkshire 024E","E01012969","Total",488,476,12
"2011","East Riding of Yorkshire 025A","E01012957","Total",828,780,48
"2011","East Riding of Yorkshire 025B","E01012960","Total",723,703,20
"2011","East Riding of Yorkshire 025C","E01012963","Total",768,756,12
"2011","East Riding of Yorkshire 025D","E01013112","Total",662,647,15
"2011","East Riding of Yorkshire 026A","E01013018","Total",789,769,20
"2011","East Riding of Yorkshire 026B","E01013019","Total",520,496,24
"2011","East Riding of Yorkshire 026C","E01013021","Total",676,655,21
"2011","East Riding of Yorkshire 026D","E01013025","Total",614,589,25
"2011","East Riding of Yorkshire 026E","E01013026","Total",717,694,23
"2011","East Riding of Yorkshire 027A","E01013105","Total",645,611,34
"2011","East Riding of Yorkshire 027B","E01013110","Total",682,660,22
"2011","East Riding of Yorkshire 027C","E01013111","Total",620,606,14
"2011","East Riding of Yorkshire 027D","E01013115","Total",656,639,17
"2011","East Riding of Yorkshire 027E","E01013117","Total",607,590,17
"2011","East Riding of Yorkshire 028A","E01013108","Total",651,627,24
"2011","East Riding of Yorkshire 028B","E01013113","Total",698,663,35
"2011","East Riding of Yorkshire 028C","E01013114","Total",654,633,21
"2011","East Riding of Yorkshire 028D","E01013116","Total",631,611,20
"2011","East Riding of Yorkshire 028E","E01013118","Total",654,638,16
"2011","East Riding of Yorkshire 029A","E01013094","Total",577,566,11
"2011","East Riding of Yorkshire 029B","E01013095","Total",704,669,35
"2011","East Riding of Yorkshire 029C","E01013096","Total",719,700,19
"2011","East Riding of Yorkshire 029D","E01013097","Total",677,662,15
"2011","East Riding of Yorkshire 029E","E01013102","Total",687,660,27
"2011","East Riding of Yorkshire 031A","E01013028","Total",672,650,22
"2011","East Riding of Yorkshire 031B","E01013078","Total",621,594,27
"2011","East Riding of Yorkshire 031C","E01013081","Total",680,651,29
"2011","East Riding of Yorkshire 031D","E01013082","Total",701,665,36
"2011","East Riding of Yorkshire 031E","E01013085","Total",730,704,26
"2011","East Riding of Yorkshire 032A","E01012970","Total",654,634,20
"2011","East Riding of Yorkshire 032C","E01012972","Total",622,601,21
"2011","East Riding of Yorkshire 032D","E01012973","Total",1166,1135,31
"2011","East Riding of Yorkshire 032E","E01012974","Total",675,661,14
"2011","East Riding of Yorkshire 032F","E01013092","Total",888,844,44
"2011","East Riding of Yorkshire 032G","E01033495","Total",606,580,26
"2011","East Riding of Yorkshire 032H","E01033496","Total",665,651,14
"2011","East Riding of Yorkshire 033A","E01013033","Total",659,643,16
"2011","East Riding of Yorkshire 033B","E01013098","Total",944,920,24
"2011","East Riding of Yorkshire 033C","E01013099","Total",665,638,27
"2011","East Riding of Yorkshire 033D","E01013100","Total",703,686,17
"2011","East Riding of Yorkshire 033E","E01013101","Total",732,717,15
"2011","East Riding of Yorkshire 034A","E01013008","Total",678,650,28
"2011","East Riding of Yorkshire 034B","E01013009","Total",787,753,34
"2011","East Riding of Yorkshire 034C","E01013013","Total",691,672,19
"2011","East Riding of Yorkshire 034D","E01013014","Total",625,608,17
"2011","East Riding of Yorkshire 034E","E01013107","Total",844,777,67
"2011","East Riding of Yorkshire 035A","E01013088","Total",704,688,16
"2011","East Riding of Yorkshire 035B","E01013089","Total",740,707,33
"2011","East Riding of Yorkshire 035C","E01013090","Total",602,587,15
"2011","East Riding of Yorkshire 035D","E01013091","Total",703,671,32
"2011","East Riding of Yorkshire 035E","E01013093","Total",651,630,21
"2011","East Riding of Yorkshire 036A","E01013005","Total",551,528,23
"2011","East Riding of Yorkshire 036B","E01013007","Total",680,663,17
"2011","East Riding of Yorkshire 036C","E01013011","Total",675,652,23
"2011","East Riding of Yorkshire 036D","E01013012","Total",529,520,9
"2011","East Riding of Yorkshire 037A","E01012996","Total",672,638,34
"2011","East Riding of Yorkshire 037B","E01012998","Total",904,884,20
"2011","East Riding of Yorkshire 037C","E01013015","Total",704,674,30
"2011","East Riding of Yorkshire 037D","E01013016","Total",728,704,24
"2011","East Riding of Yorkshire 038A","E01013003","Total",673,658,15
"2011","East Riding of Yorkshire 038B","E01013017","Total",769,731,38
"2011","East Riding of Yorkshire 038C","E01013020","Total",766,720,46
"2011","East Riding of Yorkshire 038D","E01013076","Total",666,630,36
"2011","East Riding of Yorkshire 039A","E01013079","Total",744,686,58
"2011","East Riding of Yorkshire 039B","E01013080","Total",631,580,51
"2011","East Riding of Yorkshire 039C","E01013083","Total",699,616,83
"2011","East Riding of Yorkshire 039D","E01013084","Total",710,678,32
"2011","East Riding of Yorkshire 039E","E01013086","Total",672,634,38
"2011","East Riding of Yorkshire 039F","E01013087","Total",614,572,42
"2011","East Riding of Yorkshire 040A","E01012993","Total",615,596,19
"2011","East Riding of Yorkshire 040B","E01012997","Total",887,850,37
"2011","East Riding of Yorkshire 040C","E01012999","Total",728,681,47
"2011","East Riding of Yorkshire 040D","E01013001","Total",779,756,23
"2011","East Riding of Yorkshire 040E","E01013074","Total",712,676,36
"2011","East Riding of Yorkshire 041A","E01012994","Total",804,781,23
"2011","East Riding of Yorkshire 041B","E01012995","Total",787,771,16
"2011","East Riding of Yorkshire 041C","E01013000","Total",1003,915,88
"2011","East Riding of Yorkshire 041D","E01013002","Total",717,686,31
"2011","East Riding of Yorkshire 041E","E01013004","Total",687,658,29
"2011","East Riding of Yorkshire 042A","E01013072","Total",731,701,30
"2011","East Riding of Yorkshire 042B","E01013073","Total",706,673,33
"2011","East Riding of Yorkshire 042C","E01013075","Total",568,547,21
"2011","East Riding of Yorkshire 042D","E01013077","Total",844,819,25
"2011","East Riding of Yorkshire 043A","E01013006","Total",646,629,17
"2011","East Riding of Yorkshire 043B","E01013010","Total",641,631,10
"2011","East Riding of Yorkshire 043C","E01013103","Total",618,611,7
"2011","East Riding of Yorkshire 043D","E01013104","Total",579,567,12
"2011","East Riding of Yorkshire 043E","E01013106","Total",485,480,5
"2011","East Riding of Yorkshire 043F","E01032596","Total",630,599,31
"2011","East Riding of Yorkshire 044A","E01012975","Total",660,650,10
"2011","East Riding of Yorkshire 044B","E01012977","Total",1050,1019,31
"2011","East Riding of Yorkshire 044C","E01012984","Total",737,706,31
"2011","East Riding of Yorkshire 044D","E01012985","Total",771,739,32
"2011","East Riding of Yorkshire 045A","E01012976","Total",625,613,12
"2011","East Riding of Yorkshire 045B","E01012979","Total",765,731,34
"2011","East Riding of Yorkshire 045C","E01012980","Total",868,837,31
"2011","East Riding of Yorkshire 045D","E01012982","Total",828,775,53
"2011","Kingston upon Hull 001A","E01012779","Total",495,487,8
"2011","Kingston upon Hull 001B","E01012780","Total",614,593,21
"2011","Kingston upon Hull 001C","E01012781","Total",487,471,16
"2011","Kingston upon Hull 001E","E01012832","Total",558,548,10
"2011","Kingston upon Hull 001F","E01033105","Total",573,556,17
"2011","Kingston upon Hull 001G","E01033106","Total",533,495,38
"2011","Kingston upon Hull 001H","E01033107","Total",509,492,17
"2011","Kingston upon Hull 001I","E01033108","Total",560,554,6
"2011","Kingston upon Hull 002A","E01012782","Total",588,576,12
"2011","Kingston upon Hull 002B","E01012785","Total",562,549,13
"2011","Kingston upon Hull 002C","E01012786","Total",520,507,13
"2011","Kingston upon Hull 002D","E01012787","Total",689,681,8
"2011","Kingston upon Hull 002E","E01012788","Total",590,578,12
"2011","Kingston upon Hull 002F","E01012789","Total",551,540,11
"2011","Kingston upon Hull 003A","E01012875","Total",835,645,190
"2011","Kingston upon Hull 003B","E01012876","Total",695,680,15
"2011","Kingston upon Hull 003C","E01012877","Total",520,499,21
"2011","Kingston upon Hull 003D","E01012878","Total",661,650,11
"2011","Kingston upon Hull 003E","E01012879","Total",750,649,101
"2011","Kingston upon Hull 004A","E01012778","Total",551,536,15
"2011","Kingston upon Hull 004B","E01012783","Total",535,529,6
"2011","Kingston upon Hull 004C","E01012784","Total",806,791,15
"2011","Kingston upon Hull 004D","E01012790","Total",600,569,31
"2011","Kingston upon Hull 004E","E01012906","Total",697,679,18
"2011","Kingston upon Hull 004F","E01012908","Total",496,490,6
"2011","Kingston upon Hull 005A","E01012764","Total",560,552,8
"2011","Kingston upon Hull 005B","E01012765","Total",652,628,24
"2011","Kingston upon Hull 005C","E01012768","Total",717,698,19
"2011","Kingston upon Hull 005D","E01012769","Total",710,684,26
"2011","Kingston upon Hull 006A","E01012829","Total",731,692,39
"2011","Kingston upon Hull 006B","E01012830","Total",623,612,11
"2011","Kingston upon Hull 006C","E01012905","Total",593,580,13
"2011","Kingston upon Hull 006D","E01012910","Total",473,466,7
"2011","Kingston upon Hull 006E","E01012912","Total",768,756,12
"2011","Kingston upon Hull 007A","E01012822","Total",671,651,20
"2011","Kingston upon Hull 007B","E01012904","Total",698,655,43
"2011","Kingston upon Hull 007C","E01012907","Total",600,595,5
"2011","Kingston upon Hull 007D","E01012909","Total",602,591,11
"2011","Kingston upon Hull 007E","E01012911","Total",501,500,1
"2011","Kingston upon Hull 008A","E01012873","Total",651,643,8
"2011","Kingston upon Hull 008B","E01012874","Total",655,645,10
"2011","Kingston upon Hull 008C","E01012880","Total",726,704,22
"2011","Kingston upon Hull 008D","E01012881","Total",659,639,20
"2011","Kingston upon Hull 008E","E01012915","Total",661,640,21
"2011","Kingston upon Hull 008F","E01012917","Total",808,785,23
"2011","Kingston upon Hull 008G","E01012918","Total",624,609,15
"2011","Kingston upon Hull 009A","E01012833","Total",659,645,14
"2011","Kingston upon Hull 009B","E01012835","Total",533,525,8
"2011","Kingston upon Hull 009C","E01012836","Total",810,785,25
"2011","Kingston upon Hull 009D","E01012839","Total",566,551,15
"2011","Kingston upon Hull 009E","E01012840","Total",664,648,16
"2011","Kingston upon Hull 010A","E01012824","Total",692,682,10
"2011","Kingston upon Hull 010B","E01012825","Total",689,679,10
"2011","Kingston upon Hull 010C","E01012834","Total",687,664,23
"2011","Kingston upon Hull 010D","E01012837","Total",758,741,17
"2011","Kingston upon Hull 010E","E01012838","Total",619,607,12
"2011","Kingston upon Hull 011A","E01012821","Total",661,609,52
"2011","Kingston upon Hull 011B","E01012823","Total",621,602,19
"2011","Kingston upon Hull 011C","E01012826","Total",726,710,16
"2011","Kingston upon Hull 011D","E01012827","Total",775,755,20
"2011","Kingston upon Hull 011E","E01012828","Total",693,679,14
"2011","Kingston upon Hull 012A","E01012766","Total",574,562,12
"2011","Kingston upon Hull 012B","E01012767","Total",603,583,20
"2011","Kingston upon Hull 012C","E01012914","Total",684,627,57
"2011","Kingston upon Hull 012D","E01012916","Total",707,685,22
"2011","Kingston upon Hull 013A","E01012812","Total",531,521,10
"2011","Kingston upon Hull 013B","E01012813","Total",687,681,6
"2011","Kingston upon Hull 013C","E01012814","Total",636,623,13
"2011","Kingston upon Hull 013D","E01012815","Total",686,675,11
"2011","Kingston upon Hull 013E","E01012818","Total",518,507,11
"2011","Kingston upon Hull 014A","E01012791","Total",678,662,16
"2011","Kingston upon Hull 014B","E01012792","Total",659,644,15
"2011","Kingston upon Hull 014C","E01012793","Total",648,620,28
"2011","Kingston upon Hull 014D","E01012794","Total",651,637,14
"2011","Kingston upon Hull 014E","E01012913","Total",860,821,39
"2011","Kingston upon Hull 015A","E01012761","Total",917,863,54
"2011","Kingston upon Hull 015B","E01012868","Total",730,695,35
"2011","Kingston upon Hull 015C","E01012869","Total",701,675,26
"2011","Kingston upon Hull 015D","E01012871","Total",787,742,45
"2011","Kingston upon Hull 015E","E01012872","Total",727,678,49
"2011","Kingston upon Hull 016A","E01012804","Total",704,683,21
"2011","Kingston upon Hull 016B","E01012806","Total",795,743,52
"2011","Kingston upon Hull 016C","E01012807","Total",611,599,12
"2011","Kingston upon Hull 016D","E01012817","Total",678,648,30
"2011","Kingston upon Hull 016E","E01012819","Total",638,622,16
"2011","Kingston upon Hull 017A","E01012841","Total",663,655,8
"2011","Kingston upon Hull 017B","E01012844","Total",618,609,9
"2011","Kingston upon Hull 017C","E01012849","Total",722,712,10
"2011","Kingston upon Hull 017D","E01012895","Total",598,588,10
"2011","Kingston upon Hull 017E","E01012897","Total",702,695,7
"2011","Kingston upon Hull 017F","E01012898","Total",686,669,17
"2011","Kingston upon Hull 018A","E01012758","Total",733,700,33
"2011","Kingston upon Hull 018B","E01012762","Total",663,632,31
"2011","Kingston upon Hull 018C","E01012763","Total",1061,996,65
"2011","Kingston upon Hull 018D","E01012866","Total",758,701,57
"2011","Kingston upon Hull 018E","E01012870","Total",722,670,52
"2011","Kingston upon Hull 019A","E01012774","Total",686,667,19
"2011","Kingston upon Hull 019B","E01012795","Total",901,880,21
"2011","Kingston upon Hull 019C","E01012797","Total",660,643,17
"2011","Kingston upon Hull 019D","E01012798","Total",852,834,18
"2011","Kingston upon Hull 019E","E01012801","Total",673,664,9
"2011","Kingston upon Hull 020A","E01012816","Total",607,573,34
"2011","Kingston upon Hull 020B","E01012848","Total",652,631,21
"2011","Kingston upon Hull 020C","E01012894","Total",634,629,5
"2011","Kingston upon Hull 020D","E01012896","Total",823,802,21
"2011","Kingston upon Hull 020E","E01012901","Total",629,611,18
"2011","Kingston upon Hull 021A","E01012842","Total",634,602,32
"2011","Kingston upon Hull 021B","E01012843","Total",653,633,20
"2011","Kingston upon Hull 021C","E01012845","Total",640,623,17
"2011","Kingston upon Hull 021D","E01012846","Total",639,624,15
"2011","Kingston upon Hull 021E","E01012847","Total",530,521,9
"2011","Kingston upon Hull 022A","E01012820","Total",585,561,24
"2011","Kingston upon Hull 022B","E01012899","Total",689,669,20
"2011","Kingston upon Hull 022C","E01012900","Total",807,756,51
"2011","Kingston upon Hull 022D","E01012902","Total",629,616,13
"2011","Kingston upon Hull 022E","E01012903","Total",860,829,31
"2011","Kingston upon Hull 023A","E01012796","Total",595,576,19
"2011","Kingston upon Hull 023B","E01012799","Total",645,606,39
"2011","Kingston upon Hull 023C","E01012800","Total",784,755,29
"2011","Kingston upon Hull 023D","E01012802","Total",674,650,24
"2011","Kingston upon Hull 023E","E01012803","Total",690,664,26
"2011","Kingston upon Hull 024A","E01012850","Total",1017,984,33
"2011","Kingston upon Hull 024B","E01012852","Total",842,799,43
"2011","Kingston upon Hull 024C","E01012856","Total",835,819,16
"2011","Kingston upon Hull 024D","E01012857","Total",792,769,23
"2011","Kingston upon Hull 024E","E01012867","Total",774,734,40
"2011","Kingston upon Hull 025A","E01012756","Total",745,714,31
"2011","Kingston upon Hull 025B","E01012757","Total",741,687,54
"2011","Kingston upon Hull 025C","E01012759","Total",886,801,85
"2011","Kingston upon Hull 025D","E01012760","Total",774,724,50
"2011","Kingston upon Hull 025E","E01012862","Total",625,597,28
"2011","Kingston upon Hull 026A","E01012805","Total",717,671,46
"2011","Kingston upon Hull 026B","E01012808","Total",890,874,16
"2011","Kingston upon Hull 026C","E01012809","Total",976,924,52
"2011","Kingston upon Hull 026D","E01012810","Total",962,949,13
"2011","Kingston upon Hull 026E","E01012811","Total",887,855,32
"2011","Kingston upon Hull 027A","E01012773","Total",778,753,25
"2011","Kingston upon Hull 027B","E01012776","Total",661,657,4
"2011","Kingston upon Hull 027C","E01012863","Total",606,602,4
"2011","Kingston upon Hull 027D","E01012864","Total",802,732,70
"2011","Kingston upon Hull 027E","E01012865","Total",606,605,1
"2011","Kingston upon Hull 028A","E01012770","Total",597,591,6
"2011","Kingston upon Hull 028B","E01012771","Total",639,636,3
"2011","Kingston upon Hull 028C","E01012772","Total",618,613,5
"2011","Kingston upon Hull 028D","E01012775","Total",679,658,21
"2011","Kingston upon Hull 028E","E01012777","Total",735,729,6
"2011","Kingston upon Hull 029A","E01012851","Total",1467,1383,84
"2011","Kingston upon Hull 029C","E01012854","Total",1266,1243,23
"2011","Kingston upon Hull 029D","E01012855","Total",953,945,8
"2011","Kingston upon Hull 029E","E01033104","Total",1007,911,96
"2011","Kingston upon Hull 029F","E01033109","Total",899,834,65
"2011","Kingston upon Hull 030A","E01012859","Total",719,651,68
"2011","Kingston upon Hull 030B","E01012889","Total",656,648,8
"2011","Kingston upon Hull 030C","E01012891","Total",1163,1078,85
"2011","Kingston upon Hull 030D","E01012892","Total",878,827,51
"2011","Kingston upon Hull 030E","E01012893","Total",771,701,70
"2011","Kingston upon Hull 031A","E01012858","Total",731,729,2
"2011","Kingston upon Hull 031B","E01012860","Total",644,641,3
"2011","Kingston upon Hull 031D","E01012886","Total",694,691,3
"2011","Kingston upon Hull 031E","E01012888","Total",732,725,7
"2011","Kingston upon Hull 031G","E01033110","Total",764,728,36
"2011","Kingston upon Hull 033A","E01012882","Total",689,685,4
"2011","Kingston upon Hull 033B","E01012883","Total",813,809,4
"2011","Kingston upon Hull 033C","E01012884","Total",825,822,3
"2011","Kingston upon Hull 033D","E01012887","Total",704,703,1
"2011","Kingston upon Hull 033E","E01032595","Total",774,772,2
"2011","North East Lincolnshire 001A","E01013174","Total",564,532,32
"2011","North East Lincolnshire 001B","E01013175","Total",615,601,14
"2011","North East Lincolnshire 001C","E01013176","Total",615,600,15
"2011","North East Lincolnshire 001D","E01013177","Total",829,804,25
"2011","North East Lincolnshire 001E","E01013178","Total",651,637,14
"2011","North East Lincolnshire 001F","E01013179","Total",645,632,13
"2011","North East Lincolnshire 001G","E01013180","Total",631,621,10
"2011","North East Lincolnshire 002A","E01013136","Total",949,885,64
"2011","North East Lincolnshire 002B","E01013137","Total",1031,989,42
"2011","North East Lincolnshire 002C","E01013139","Total",689,656,33
"2011","North East Lincolnshire 002D","E01013142","Total",810,767,43
"2011","North East Lincolnshire 003A","E01013218","Total",707,624,83
"2011","North East Lincolnshire 003B","E01013219","Total",679,641,38
"2011","North East Lincolnshire 003C","E01013220","Total",812,761,51
"2011","North East Lincolnshire 003D","E01013221","Total",1012,953,59
"2011","North East Lincolnshire 003E","E01013222","Total",726,702,24
"2011","North East Lincolnshire 004A","E01013144","Total",809,792,17
"2011","North East Lincolnshire 004B","E01013145","Total",508,503,5
"2011","North East Lincolnshire 004C","E01013146","Total",721,708,13
"2011","North East Lincolnshire 004D","E01013148","Total",583,575,8
"2011","North East Lincolnshire 005A","E01013195","Total",649,616,33
"2011","North East Lincolnshire 005B","E01013196","Total",592,565,27
"2011","North East Lincolnshire 005C","E01013201","Total",714,673,41
"2011","North East Lincolnshire 005D","E01013202","Total",655,621,34
"2011","North East Lincolnshire 005E","E01013203","Total",771,728,43
"2011","North East Lincolnshire 006A","E01013138","Total",673,619,54
"2011","North East Lincolnshire 006B","E01013140","Total",698,652,46
"2011","North East Lincolnshire 006C","E01013141","Total",677,647,30
"2011","North East Lincolnshire 006D","E01013143","Total",614,579,35
"2011","North East Lincolnshire 007A","E01013173","Total",577,534,43
"2011","North East Lincolnshire 007B","E01013223","Total",1178,1149,29
"2011","North East Lincolnshire 007C","E01013224","Total",798,778,20
"2011","North East Lincolnshire 007D","E01013226","Total",645,632,13
"2011","North East Lincolnshire 008A","E01013187","Total",847,792,55
"2011","North East Lincolnshire 008B","E01013188","Total",702,684,18
"2011","North East Lincolnshire 008C","E01013231","Total",725,708,17
"2011","North East Lincolnshire 008D","E01013233","Total",636,618,18
"2011","North East Lincolnshire 009A","E01013147","Total",625,607,18
"2011","North East Lincolnshire 009D","E01013234","Total",687,656,31
"2011","North East Lincolnshire 009E","E01033414","Total",1037,970,67
"2011","North East Lincolnshire 010A","E01013128","Total",644,616,28
"2011","North East Lincolnshire 010B","E01013198","Total",642,613,29
"2011","North East Lincolnshire 010C","E01013199","Total",573,541,32
"2011","North East Lincolnshire 010D","E01013200","Total",523,511,12
"2011","North East Lincolnshire 011A","E01013159","Total",653,613,40
"2011","North East Lincolnshire 011B","E01013161","Total",591,566,25
"2011","North East Lincolnshire 011C","E01013162","Total",725,670,55
"2011","North East Lincolnshire 011D","E01013165","Total",634,602,32
"2011","North East Lincolnshire 012A","E01013158","Total",614,599,15
"2011","North East Lincolnshire 012B","E01013160","Total",666,655,11
"2011","North East Lincolnshire 012C","E01013163","Total",624,605,19
"2011","North East Lincolnshire 012D","E01013164","Total",757,715,42
"2011","North East Lincolnshire 012E","E01013197","Total",539,524,15
"2011","North East Lincolnshire 013A","E01013149","Total",489,485,4
"2011","North East Lincolnshire 013B","E01013150","Total",528,522,6
"2011","North East Lincolnshire 013C","E01013227","Total",772,751,21
"2011","North East Lincolnshire 013D","E01013228","Total",710,691,19
"2011","North East Lincolnshire 013E","E01013229","Total",594,575,19
"2011","North East Lincolnshire 014A","E01013131","Total",819,778,41
"2011","North East Lincolnshire 014B","E01013132","Total",645,635,10
"2011","North East Lincolnshire 014C","E01013133","Total",808,772,36
"2011","North East Lincolnshire 014D","E01013134","Total",700,691,9
"2011","North East Lincolnshire 015A","E01013206","Total",619,593,26
"2011","North East Lincolnshire 015B","E01013207","Total",620,604,16
"2011","North East Lincolnshire 015C","E01013211","Total",657,642,15
"2011","North East Lincolnshire 015D","E01013212","Total",611,599,12
"2011","North East Lincolnshire 016A","E01013181","Total",666,616,50
"2011","North East Lincolnshire 016B","E01013182","Total",653,636,17
"2011","North East Lincolnshire 016C","E01013183","Total",654,639,15
"2011","North East Lincolnshire 016D","E01013184","Total",695,643,52
"2011","North East Lincolnshire 016E","E01013185","Total",685,657,28
"2011","North East Lincolnshire 016F","E01013186","Total",513,502,11
"2011","North East Lincolnshire 017A","E01013129","Total",799,728,71
"2011","North East Lincolnshire 017B","E01013151","Total",532,520,12
"2011","North East Lincolnshire 017C","E01013152","Total",640,620,20
"2011","North East Lincolnshire 017D","E01013155","Total",630,626,4
"2011","North East Lincolnshire 018A","E01013130","Total",642,627,15
"2011","North East Lincolnshire 018B","E01013135","Total",772,758,14
"2011","North East Lincolnshire 018C","E01013154","Total",630,619,11
"2011","North East Lincolnshire 018D","E01013156","Total",669,661,8
"2011","North East Lincolnshire 019A","E01013204","Total",604,586,18
"2011","North East Lincolnshire 019B","E01013205","Total",539,519,20
"2011","North East Lincolnshire 019C","E01013208","Total",537,520,17
"2011","North East Lincolnshire 019D","E01013209","Total",708,676,32
"2011","North East Lincolnshire 019E","E01013210","Total",545,536,9
"2011","North East Lincolnshire 020A","E01013153","Total",660,643,17
"2011","North East Lincolnshire 020B","E01013157","Total",753,735,18
"2011","North East Lincolnshire 020C","E01013166","Total",714,692,22
"2011","North East Lincolnshire 020D","E01013167","Total",990,808,182
"2011","North East Lincolnshire 020E","E01013169","Total",542,528,14
"2011","North East Lincolnshire 021A","E01013189","Total",661,641,20
"2011","North East Lincolnshire 021B","E01013190","Total",1124,1075,49
"2011","North East Lincolnshire 021C","E01013191","Total",650,642,8
"2011","North East Lincolnshire 021D","E01013192","Total",764,744,20
"2011","North East Lincolnshire 021E","E01013194","Total",697,677,20
"2011","North East Lincolnshire 022A","E01013168","Total",738,709,29
"2011","North East Lincolnshire 022B","E01013170","Total",673,665,8
"2011","North East Lincolnshire 022C","E01013171","Total",633,625,8
"2011","North East Lincolnshire 022D","E01013172","Total",707,682,25
"2011","North East Lincolnshire 022E","E01013193","Total",747,728,19
"2011","North East Lincolnshire 023A","E01013213","Total",651,625,26
"2011","North East Lincolnshire 023B","E01013214","Total",652,637,15
"2011","North East Lincolnshire 023C","E01013215","Total",638,620,18
"2011","North East Lincolnshire 023D","E01013216","Total",521,511,10
"2011","North East Lincolnshire 023E","E01013217","Total",640,623,17
"2011","North East Lincolnshire 023F","E01013225","Total",449,429,20
"2011","North Lincolnshire 001A","E01013254","Total",868,814,54
"2011","North Lincolnshire 001B","E01013255","Total",915,832,83
"2011","North Lincolnshire 001C","E01013256","Total",1106,1029,77
"2011","North Lincolnshire 001D","E01013257","Total",791,746,45
"2011","North Lincolnshire 001E","E01013258","Total",720,712,8
"2011","North Lincolnshire 001F","E01013259","Total",704,683,21
"2011","North Lincolnshire 002A","E01013303","Total",620,579,41
"2011","North Lincolnshire 002B","E01013304","Total",681,659,22
"2011","North Lincolnshire 002C","E01013305","Total",677,651,26
"2011","North Lincolnshire 002D","E01013307","Total",778,747,31
"2011","North Lincolnshire 003A","E01013288","Total",679,647,32
"2011","North Lincolnshire 003B","E01013291","Total",627,604,23
"2011","North Lincolnshire 003C","E01013292","Total",787,750,37
"2011","North Lincolnshire 003D","E01013294","Total",692,666,26
"2011","North Lincolnshire 004A","E01013270","Total",870,829,41
"2011","North Lincolnshire 004B","E01013306","Total",685,658,27
"2011","North Lincolnshire 004C","E01013308","Total",778,746,32
"2011","North Lincolnshire 004D","E01013309","Total",725,702,23
"2011","North Lincolnshire 005A","E01013286","Total",1188,1159,29
"2011","North Lincolnshire 005B","E01013287","Total",723,698,25
"2011","North Lincolnshire 005C","E01013289","Total",721,704,17
"2011","North Lincolnshire 005D","E01013290","Total",761,728,33
"2011","North Lincolnshire 005E","E01013293","Total",687,667,20
"2011","North Lincolnshire 006A","E01013245","Total",643,609,34
"2011","North Lincolnshire 006B","E01013246","Total",672,638,34
"2011","North Lincolnshire 006C","E01013247","Total",731,711,20
"2011","North Lincolnshire 006D","E01013248","Total",804,760,44
"2011","North Lincolnshire 006E","E01013249","Total",769,747,22
"2011","North Lincolnshire 007A","E01013297","Total",904,876,28
"2011","North Lincolnshire 007B","E01013300","Total",673,629,44
"2011","North Lincolnshire 007C","E01013302","Total",571,557,14
"2011","North Lincolnshire 007D","E01013331","Total",864,845,19
"2011","North Lincolnshire 008A","E01013296","Total",710,648,62
"2011","North Lincolnshire 008B","E01013298","Total",552,534,18
"2011","North Lincolnshire 008C","E01013299","Total",678,657,21
"2011","North Lincolnshire 008D","E01013330","Total",888,778,110
"2011","North Lincolnshire 008E","E01013332","Total",735,660,75
"2011","North Lincolnshire 009A","E01013295","Total",604,596,8
"2011","North Lincolnshire 009B","E01013301","Total",671,654,17
"2011","North Lincolnshire 009C","E01013333","Total",664,620,44
"2011","North Lincolnshire 009D","E01013334","Total",675,648,27
"2011","North Lincolnshire 010A","E01013310","Total",634,614,20
"2011","North Lincolnshire 010B","E01013312","Total",843,800,43
"2011","North Lincolnshire 010C","E01013313","Total",690,670,20
"2011","North Lincolnshire 010D","E01013314","Total",650,631,19
"2011","North Lincolnshire 011A","E01013267","Total",528,507,21
"2011","North Lincolnshire 011B","E01013268","Total",590,567,23
"2011","North Lincolnshire 011C","E01013269","Total",755,720,35
"2011","North Lincolnshire 011D","E01013271","Total",813,768,45
"2011","North Lincolnshire 011E","E01013272","Total",922,832,90
"2011","North Lincolnshire 011F","E01013273","Total",772,757,15
"2011","North Lincolnshire 012A","E01013279","Total",742,716,26
"2011","North Lincolnshire 012B","E01013285","Total",537,524,13
"2011","North Lincolnshire 012C","E01013316","Total",601,588,13
"2011","North Lincolnshire 012D","E01013321","Total",694,665,29
"2011","North Lincolnshire 013A","E01013274","Total",856,818,38
"2011","North Lincolnshire 013B","E01013275","Total",666,650,16
"2011","North Lincolnshire 013C","E01013276","Total",764,730,34
"2011","North Lincolnshire 013D","E01013277","Total",651,636,15
"2011","North Lincolnshire 014A","E01013315","Total",802,776,26
"2011","North Lincolnshire 014B","E01013317","Total",577,558,19
"2011","North Lincolnshire 014C","E01013318","Total",640,625,15
"2011","North Lincolnshire 014D","E01013319","Total",950,920,30
"2011","North Lincolnshire 015A","E01013238","Total",801,769,32
"2011","North Lincolnshire 015B","E01013240","Total",1054,987,67
"2011","North Lincolnshire 015C","E01013311","Total",793,772,21
"2011","North Lincolnshire 015D","E01013320","Total",653,636,17
"2011","North Lincolnshire 016A","E01013278","Total",668,641,27
"2011","North Lincolnshire 016B","E01013280","Total",612,601,11
"2011","North Lincolnshire 016C","E01013281","Total",528,517,11
"2011","North Lincolnshire 016D","E01013283","Total",542,530,12
"2011","North Lincolnshire 017A","E01013236","Total",748,728,20
"2011","North Lincolnshire 017B","E01013239","Total",765,714,51
"2011","North Lincolnshire 017C","E01013282","Total",639,624,15
"2011","North Lincolnshire 017D","E01013284","Total",661,645,16
"2011","North Lincolnshire 018B","E01013237","Total",667,647,20
"2011","North Lincolnshire 018C","E01013261","Total",653,640,13
"2011","North Lincolnshire 018D","E01013262","Total",608,598,10
"2011","North Lincolnshire 018E","E01013263","Total",689,666,23
"2011","North Lincolnshire 018F","E01033296","Total",610,601,9
"2011","North Lincolnshire 018G","E01033297","Total",661,652,9
"2011","North Lincolnshire 019A","E01013260","Total",680,660,20
"2011","North Lincolnshire 019B","E01013264","Total",771,746,25
"2011","North Lincolnshire 019C","E01013265","Total",745,726,19
"2011","North Lincolnshire 019D","E01013266","Total",854,835,19
"2011","North Lincolnshire 020A","E01013241","Total",786,725,61
"2011","North Lincolnshire 020B","E01013242","Total",738,709,29
"2011","North Lincolnshire 020C","E01013243","Total",904,871,33
"2011","North Lincolnshire 020D","E01013244","Total",834,790,44
"2011","North Lincolnshire 021A","E01013324","Total",649,627,22
"2011","North Lincolnshire 021B","E01013326","Total",714,696,18
"2011","North Lincolnshire 021C","E01013327","Total",719,697,22
"2011","North Lincolnshire 021D","E01013328","Total",532,519,13
"2011","North Lincolnshire 022A","E01013322","Total",861,806,55
"2011","North Lincolnshire 022B","E01013323","Total",696,670,26
"2011","North Lincolnshire 022C","E01013325","Total",665,650,15
"2011","North Lincolnshire 022D","E01013329","Total",802,773,29
"2011","North Lincolnshire 023A","E01013250","Total",732,703,29
"2011","North Lincolnshire 023B","E01013251","Total",791,768,23
"2011","North Lincolnshire 023C","E01013252","Total",716,695,21
"2011","North Lincolnshire 023D","E01013253","Total",842,801,41
"2011","York 001A","E01013436","Total",657,626,31
"2011","York 001B","E01013438","Total",749,733,16
"2011","York 001C","E01013439","Total",539,527,12
"2011","York 001D","E01013440","Total",796,787,9
"2011","York 002A","E01013370","Total",782,756,26
"2011","York 002B","E01013373","Total",650,635,15
"2011","York 002C","E01013375","Total",609,598,11
"2011","York 002D","E01013376","Total",644,635,9
"2011","York 003A","E01013371","Total",600,588,12
"2011","York 003B","E01013372","Total",836,805,31
"2011","York 003C","E01013374","Total",601,594,7
"2011","York 003D","E01013377","Total",666,659,7
"2011","York 004A","E01013404","Total",653,647,6
"2011","York 004B","E01013407","Total",682,672,10
"2011","York 004C","E01013408","Total",635,626,9
"2011","York 004D","E01013410","Total",623,620,3
"2011","York 005A","E01013405","Total",623,611,12
"2011","York 005B","E01013406","Total",877,835,42
"2011","York 005C","E01013409","Total",717,705,12
"2011","York 005D","E01013411","Total",721,713,8
"2011","York 006A","E01013428","Total",712,701,11
"2011","York 006B","E01013429","Total",820,808,12
"2011","York 006C","E01013430","Total",676,656,20
"2011","York 006D","E01013431","Total",663,656,7
"2011","York 006E","E01013435","Total",639,630,9
"2011","York 007A","E01013344","Total",751,677,74
"2011","York 007B","E01013346","Total",854,810,44
"2011","York 007C","E01013432","Total",880,865,15
"2011","York 007D","E01013433","Total",662,651,11
"2011","York 007E","E01013434","Total",647,616,31
"2011","York 008A","E01013379","Total",630,614,16
"2011","York 008B","E01013380","Total",742,716,26
"2011","York 008C","E01013385","Total",649,635,14
"2011","York 008D","E01013387","Total",691,679,12
"2011","York 008E","E01013388","Total",520,503,17
"2011","York 008F","E01013389","Total",520,505,15
"2011","York 008G","E01013437","Total",544,525,19
"2011","York 009A","E01013343","Total",868,839,29
"2011","York 009B","E01013345","Total",823,786,37
"2011","York 009C","E01013347","Total",676,667,9
"2011","York 009D","E01013349","Total",527,523,4
"2011","York 009E","E01013350","Total",701,678,23
"2011","York 010A","E01013348","Total",686,672,14
"2011","York 010B","E01013368","Total",985,937,48
"2011","York 010C","E01013382","Total",786,760,26
"2011","York 010D","E01013383","Total",1084,1031,53
"2011","York 010E","E01013386","Total",777,761,16
"2011","York 011A","E01013421","Total",542,524,18
"2011","York 011B","E01013422","Total",666,644,22
"2011","York 011C","E01013426","Total",732,718,14
"2011","York 011D","E01013427","Total",614,605,9
"2011","York 012A","E01013335","Total",646,639,7
"2011","York 012B","E01013336","Total",647,638,9
"2011","York 012C","E01013337","Total",711,697,14
"2011","York 012D","E01013338","Total",923,902,21
"2011","York 012E","E01013339","Total",652,644,8
"2011","York 012F","E01013392","Total",650,632,18
"2011","York 013A","E01013366","Total",1081,975,106
"2011","York 013C","E01013369","Total",1127,982,145
"2011","York 013E","E01013416","Total",827,791,36
"2011","York 013F","E01033067","Total",791,733,58
"2011","York 013G","E01033068","Total",852,683,169
"2011","York 013H","E01033069","Total",744,645,99
"2011","York 013I","E01033070","Total",809,702,107
"2011","York 014A","E01013381","Total",631,615,16
"2011","York 014B","E01013402","Total",665,641,24
"2011","York 014C","E01013419","Total",663,652,11
"2011","York 014D","E01013420","Total",865,854,11
"2011","York 015A","E01013384","Total",667,653,14
"2011","York 015B","E01013398","Total",566,556,10
"2011","York 015C","E01013399","Total",705,682,23
"2011","York 015D","E01013400","Total",899,862,37
"2011","York 015E","E01013401","Total",610,593,17
"2011","York 015F","E01013403","Total",672,650,22
"2011","York 016A","E01013393","Total",751,730,21
"2011","York 016B","E01013394","Total",681,663,18
"2011","York 016C","E01013395","Total",674,650,24
"2011","York 016D","E01013396","Total",789,767,22
"2011","York 016E","E01013441","Total",726,697,29
"2011","York 016F","E01013445","Total",791,769,22
"2011","York 017A","E01013390","Total",830,796,34
"2011","York 017B","E01013391","Total",1095,1049,46
"2011","York 017C","E01013397","Total",649,643,6
"2011","York 017D","E01013413","Total",753,727,26
"2011","York 017E","E01013417","Total",907,838,69
"2011","York 018A","E01013442","Total",629,615,14
"2011","York 018B","E01013443","Total",720,709,11
"2011","York 018C","E01013444","Total",595,585,10
"2011","York 018D","E01013446","Total",714,700,14
"2011","York 018E","E01013447","Total",624,617,7
"2011","York 018F","E01013448","Total",609,604,5
"2011","York 019A","E01013360","Total",681,648,33
"2011","York 019B","E01013361","Total",832,799,33
"2011","York 019C","E01013362","Total",820,772,48
"2011","York 019D","E01013363","Total",925,861,64
"2011","York 019E","E01013364","Total",978,865,113
"2011","York 019F","E01013418","Total",873,798,75
"2011","York 020A","E01013351","Total",784,761,23
"2011","York 020B","E01013352","Total",788,758,30
"2011","York 020C","E01013451","Total",488,468,20
"2011","York 020D","E01013452","Total",658,640,18
"2011","York 021A","E01013357","Total",832,808,24
"2011","York 021B","E01013358","Total",702,671,31
"2011","York 021C","E01013412","Total",925,881,44
"2011","York 021D","E01013414","Total",797,770,27
"2011","York 022A","E01013353","Total",758,727,31
"2011","York 022B","E01013354","Total",615,613,2
"2011","York 022C","E01013355","Total",739,710,29
"2011","York 022D","E01013356","Total",670,654,16
"2011","York 022E","E01013359","Total",672,660,12
"2011","York 022F","E01013449","Total",716,708,8
"2011","York 023A","E01013365","Total",1230,1181,49
"2011","York 023B","E01013378","Total",512,480,32
"2011","York 023C","E01013450","Total",530,512,18
"2011","York 024A","E01013340","Total",536,521,15
"2011","York 024B","E01013341","Total",636,616,20
"2011","York 024C","E01013342","Total",617,599,18
"2011","York 024D","E01013423","Total",538,533,5
"2011","York 024E","E01013424","Total",516,506,10
"2011","York 024F","E01013425","Total",700,688,12
"2011","Craven 001A","E01027558","Total",962,845,117
"2011","Craven 001B","E01027559","Total",850,781,69
"2011","Craven 001C","E01027569","Total",666,589,77
"2011","Craven 001D","E01027570","Total",1275,1099,176
"2011","Craven 002A","E01027562","Total",782,669,113
"2011","Craven 002B","E01027567","Total",930,789,141
"2011","Craven 002C","E01027585","Total",1054,832,222
"2011","Craven 003A","E01027568","Total",1057,942,115
"2011","Craven 003B","E01027571","Total",928,782,146
"2011","Craven 003C","E01027572","Total",1184,998,186
"2011","Craven 003D","E01027573","Total",761,699,62
"2011","Craven 004A","E01027557","Total",757,655,102
"2011","Craven 004B","E01027561","Total",901,831,70
"2011","Craven 004C","E01027576","Total",697,668,29
"2011","Craven 005A","E01027574","Total",667,646,21
"2011","Craven 005B","E01027575","Total",895,879,16
"2011","Craven 005C","E01027577","Total",1000,929,71
"2011","Craven 005D","E01027579","Total",549,533,16
"2011","Craven 006A","E01027578","Total",778,737,41
"2011","Craven 006B","E01027580","Total",513,486,27
"2011","Craven 006C","E01027581","Total",1235,1141,94
"2011","Craven 006D","E01027582","Total",719,678,41
"2011","Craven 007A","E01027556","Total",739,703,36
"2011","Craven 007B","E01027560","Total",1054,977,77
"2011","Craven 007C","E01027563","Total",762,681,81
"2011","Craven 007D","E01027586","Total",929,854,75
"2011","Craven 008A","E01027555","Total",870,826,44
"2011","Craven 008B","E01027564","Total",599,569,30
"2011","Craven 008C","E01027565","Total",680,657,23
"2011","Craven 008D","E01027566","Total",564,535,29
"2011","Craven 008E","E01027583","Total",869,845,24
"2011","Craven 008F","E01027584","Total",794,728,66
"2011","Hambleton 001A","E01027591","Total",770,730,40
"2011","Hambleton 001B","E01027597","Total",736,687,49
"2011","Hambleton 001C","E01027599","Total",827,801,26
"2011","Hambleton 001D","E01027623","Total",605,584,21
"2011","Hambleton 001E","E01027625","Total",811,772,39
"2011","Hambleton 002A","E01027598","Total",894,855,39
"2011","Hambleton 002B","E01027618","Total",1091,1042,49
"2011","Hambleton 002C","E01027624","Total",535,527,8
"2011","Hambleton 002D","E01027626","Total",628,584,44
"2011","Hambleton 002E","E01027627","Total",870,803,67
"2011","Hambleton 003A","E01027590","Total",1017,982,35
"2011","Hambleton 003B","E01027592","Total",788,758,30
"2011","Hambleton 003C","E01027613","Total",829,767,62
"2011","Hambleton 003D","E01027617","Total",480,451,29
"2011","Hambleton 004A","E01027605","Total",809,728,81
"2011","Hambleton 004B","E01027606","Total",701,692,9
"2011","Hambleton 004C","E01027608","Total",758,731,27
"2011","Hambleton 004D","E01027609","Total",556,548,8
"2011","Hambleton 004E","E01027610","Total",766,733,33
"2011","Hambleton 004F","E01027611","Total",957,925,32
"2011","Hambleton 004G","E01027612","Total",772,757,15
"2011","Hambleton 004H","E01027616","Total",680,661,19
"2011","Hambleton 005A","E01027603","Total",817,789,28
"2011","Hambleton 005B","E01027604","Total",791,762,29
"2011","Hambleton 005C","E01027607","Total",555,550,5
"2011","Hambleton 005D","E01027614","Total",574,565,9
"2011","Hambleton 005E","E01027615","Total",513,504,9
"2011","Hambleton 006A","E01027587","Total",645,623,22
"2011","Hambleton 006B","E01027588","Total",730,677,53
"2011","Hambleton 006C","E01027589","Total",742,714,28
"2011","Hambleton 006D","E01027593","Total",795,751,44
"2011","Hambleton 007B","E01027628","Total",791,766,25
"2011","Hambleton 007C","E01027633","Total",821,788,33
"2011","Hambleton 007D","E01033065","Total",500,473,27
"2011","Hambleton 007E","E01033066","Total",595,548,47
"2011","Hambleton 008A","E01027620","Total",831,808,23
"2011","Hambleton 008B","E01027630","Total",972,869,103
"2011","Hambleton 008C","E01027631","Total",716,677,39
"2011","Hambleton 008D","E01027632","Total",609,595,14
"2011","Hambleton 008E","E01027637","Total",899,823,76
"2011","Hambleton 009A","E01027621","Total",1026,1000,26
"2011","Hambleton 009B","E01027629","Total",629,615,14
"2011","Hambleton 009C","E01027635","Total",968,925,43
"2011","Hambleton 009D","E01027636","Total",935,870,65
"2011","Hambleton 010A","E01027594","Total",757,737,20
"2011","Hambleton 010B","E01027595","Total",771,740,31
"2011","Hambleton 010C","E01027596","Total",763,731,32
"2011","Hambleton 010D","E01027601","Total",830,791,39
"2011","Hambleton 010E","E01027622","Total",850,798,52
"2011","Hambleton 011A","E01027600","Total",818,773,45
"2011","Hambleton 011B","E01027619","Total",998,952,46
"2011","Hambleton 011C","E01027634","Total",802,785,17
"2011","Harrogate 001A","E01027666","Total",774,720,54
"2011","Harrogate 001B","E01027667","Total",592,563,29
"2011","Harrogate 001C","E01027685","Total",661,592,69
"2011","Harrogate 001D","E01027686","Total",521,461,60
"2011","Harrogate 002A","E01027712","Total",526,505,21
"2011","Harrogate 002B","E01027713","Total",816,754,62
"2011","Harrogate 002C","E01027714","Total",790,740,50
"2011","Harrogate 002D","E01027715","Total",458,411,47
"2011","Harrogate 003A","E01027643","Total",680,631,49
"2011","Harrogate 003B","E01027688","Total",716,681,35
"2011","Harrogate 003C","E01027736","Total",690,658,32
"2011","Harrogate 003D","E01027737","Total",644,606,38
"2011","Harrogate 004A","E01027705","Total",744,706,38
"2011","Harrogate 004B","E01027706","Total",1043,976,67
"2011","Harrogate 004C","E01027707","Total",832,792,40
"2011","Harrogate 004D","E01027708","Total",633,604,29
"2011","Harrogate 004E","E01027709","Total",523,507,16
"2011","Harrogate 004F","E01027710","Total",492,465,27
"2011","Harrogate 004G","E01027711","Total",509,499,10
"2011","Harrogate 005A","E01027644","Total",676,664,12
"2011","Harrogate 005B","E01027645","Total",722,677,45
"2011","Harrogate 005C","E01027647","Total",714,677,37
"2011","Harrogate 005D","E01027687","Total",645,617,28
"2011","Harrogate 006A","E01027681","Total",719,668,51
"2011","Harrogate 006B","E01027693","Total",824,745,79
"2011","Harrogate 006C","E01027701","Total",767,681,86
"2011","Harrogate 006D","E01027702","Total",596,551,45
"2011","Harrogate 007A","E01027642","Total",627,596,31
"2011","Harrogate 007B","E01027646","Total",701,669,32
"2011","Harrogate 007C","E01027674","Total",556,546,10
"2011","Harrogate 007D","E01027675","Total",965,938,27
"2011","Harrogate 008A","E01027641","Total",476,470,6
"2011","Harrogate 008B","E01027664","Total",953,895,58
"2011","Harrogate 008C","E01027665","Total",474,453,21
"2011","Harrogate 008D","E01027722","Total",550,539,11
"2011","Harrogate 009A","E01027668","Total",694,672,22
"2011","Harrogate 009B","E01027669","Total",979,934,45
"2011","Harrogate 009C","E01027673","Total",967,881,86
"2011","Harrogate 009D","E01027676","Total",702,686,16
"2011","Harrogate 010A","E01027638","Total",613,598,15
"2011","Harrogate 010B","E01027639","Total",559,546,13
"2011","Harrogate 010C","E01027640","Total",670,657,13
"2011","Harrogate 010D","E01027690","Total",650,632,18
"2011","Harrogate 010E","E01027738","Total",604,579,25
"2011","Harrogate 010F","E01027739","Total",479,458,21
"2011","Harrogate 010G","E01027741","Total",638,622,16
"2011","Harrogate 011A","E01027689","Total",659,635,24
"2011","Harrogate 011B","E01027691","Total",677,665,12
"2011","Harrogate 011C","E01027720","Total",664,653,11
"2011","Harrogate 011D","E01027721","Total",664,643,21
"2011","Harrogate 011E","E01027723","Total",759,740,19
"2011","Harrogate 012A","E01027670","Total",674,662,12
"2011","Harrogate 012B","E01027671","Total",628,621,7
"2011","Harrogate 012C","E01027672","Total",722,698,24
"2011","Harrogate 012D","E01027704","Total",526,500,26
"2011","Harrogate 013A","E01027649","Total",748,696,52
"2011","Harrogate 013B","E01027651","Total",612,600,12
"2011","Harrogate 013C","E01027657","Total",606,580,26
"2011","Harrogate 013D","E01027658","Total",779,740,39
"2011","Harrogate 013E","E01027692","Total",576,545,31
"2011","Harrogate 013F","E01027740","Total",959,940,19
"2011","Harrogate 014A","E01027648","Total",697,679,18
"2011","Harrogate 014B","E01027650","Total",649,625,24
"2011","Harrogate 014C","E01027726","Total",699,674,25
"2011","Harrogate 014D","E01027727","Total",700,673,27
"2011","Harrogate 014E","E01027728","Total",621,612,9
"2011","Harrogate 014F","E01027729","Total",701,682,19
"2011","Harrogate 015A","E01027652","Total",738,691,47
"2011","Harrogate 015B","E01027655","Total",571,535,36
"2011","Harrogate 015C","E01027659","Total",1009,939,70
"2011","Harrogate 015D","E01027677","Total",760,685,75
"2011","Harrogate 015E","E01027678","Total",1013,920,93
"2011","Harrogate 015F","E01027680","Total",864,727,137
"2011","Harrogate 016A","E01027683","Total",596,585,11
"2011","Harrogate 016B","E01027684","Total",611,588,23
"2011","Harrogate 016C","E01027695","Total",717,690,27
"2011","Harrogate 016D","E01027696","Total",582,549,33
"2011","Harrogate 016E","E01027703","Total",807,773,34
"2011","Harrogate 017A","E01027660","Total",671,640,31
"2011","Harrogate 017B","E01027661","Total",627,620,7
"2011","Harrogate 017C","E01027662","Total",458,447,11
"2011","Harrogate 017D","E01027663","Total",628,616,12
"2011","Harrogate 017E","E01027697","Total",602,588,14
"2011","Harrogate 017F","E01027733","Total",531,518,13
"2011","Harrogate 018A","E01027682","Total",715,674,41
"2011","Harrogate 018B","E01027694","Total",498,478,20
"2011","Harrogate 018C","E01027734","Total",688,647,41
"2011","Harrogate 018D","E01027735","Total",693,667,26
"2011","Harrogate 019A","E01027656","Total",948,872,76
"2011","Harrogate 019B","E01027679","Total",898,820,78
"2011","Harrogate 019C","E01027730","Total",767,688,79
"2011","Harrogate 019D","E01027731","Total",674,624,50
"2011","Harrogate 019E","E01027732","Total",583,544,39
"2011","Harrogate 020A","E01027653","Total",684,658,26
"2011","Harrogate 020B","E01027654","Total",498,487,11
"2011","Harrogate 020C","E01027698","Total",647,629,18
"2011","Harrogate 020D","E01027716","Total",625,603,22
"2011","Harrogate 020E","E01027717","Total",629,618,11
"2011","Harrogate 020F","E01027718","Total",758,746,12
"2011","Harrogate 020G","E01027719","Total",634,621,13
"2011","Harrogate 021A","E01027699","Total",534,515,19
"2011","Harrogate 021B","E01027700","Total",517,494,23
"2011","Harrogate 021C","E01027724","Total",692,655,37
"2011","Harrogate 021D","E01027725","Total",661,633,28
"2011","Richmondshire 001A","E01027743","Total",569,536,33
"2011","Richmondshire 001B","E01027751","Total",554,530,24
"2011","Richmondshire 001C","E01027752","Total",609,548,61
"2011","Richmondshire 001D","E01027759","Total",654,615,39
"2011","Richmondshire 001E","E01027761","Total",553,525,28
"2011","Richmondshire 001F","E01027762","Total",615,571,44
"2011","Richmondshire 002A","E01027765","Total",687,670,17
"2011","Richmondshire 002B","E01027766","Total",621,581,40
"2011","Richmondshire 002C","E01027767","Total",637,625,12
"2011","Richmondshire 002D","E01027768","Total",510,496,14
"2011","Richmondshire 002E","E01027769","Total",594,567,27
"2011","Richmondshire 002F","E01027770","Total",920,836,84
"2011","Richmondshire 003A","E01027745","Total",663,624,39
"2011","Richmondshire 003B","E01027746","Total",677,648,29
"2011","Richmondshire 003C","E01027747","Total",642,580,62
"2011","Richmondshire 003D","E01027748","Total",558,530,28
"2011","Richmondshire 004A","E01027749","Total",817,786,31
"2011","Richmondshire 004B","E01027750","Total",1053,998,55
"2011","Richmondshire 004C","E01027754","Total",500,454,46
"2011","Richmondshire 004E","E01027771","Total",538,484,54
"2011","Richmondshire 004F","E01027772","Total",564,544,20
"2011","Richmondshire 004G","E01033183","Total",445,421,24
"2011","Richmondshire 004H","E01033184","Total",533,496,37
"2011","Richmondshire 005A","E01027742","Total",862,631,231
"2011","Richmondshire 005B","E01027753","Total",835,606,229
"2011","Richmondshire 005C","E01027763","Total",847,550,297
"2011","Richmondshire 005D","E01027764","Total",774,542,232
"2011","Richmondshire 005E","E01027773","Total",754,493,261
"2011","Richmondshire 006A","E01027744","Total",739,590,149
"2011","Richmondshire 006B","E01027756","Total",762,716,46
"2011","Richmondshire 006D","E01027758","Total",640,591,49
"2011","Richmondshire 006E","E01027760","Total",719,587,132
"2011","Richmondshire 006F","E01033185","Total",692,611,81
"2011","Richmondshire 006G","E01033186","Total",666,625,41
"2011","Ryedale 001A","E01027776","Total",763,651,112
"2011","Ryedale 001B","E01027777","Total",835,606,229
"2011","Ryedale 001C","E01027783","Total",911,817,94
"2011","Ryedale 001D","E01027784","Total",845,772,73
"2011","Ryedale 002A","E01027792","Total",983,875,108
"2011","Ryedale 002B","E01027793","Total",719,658,61
"2011","Ryedale 002C","E01027794","Total",918,876,42
"2011","Ryedale 002D","E01027795","Total",784,719,65
"2011","Ryedale 002E","E01027801","Total",843,755,88
"2011","Ryedale 002F","E01027802","Total",844,710,134
"2011","Ryedale 003A","E01027775","Total",721,635,86
"2011","Ryedale 003B","E01027780","Total",949,788,161
"2011","Ryedale 003C","E01027781","Total",714,637,77
"2011","Ryedale 003D","E01027800","Total",845,728,117
"2011","Ryedale 004A","E01027779","Total",526,475,51
"2011","Ryedale 004B","E01027796","Total",815,772,43
"2011","Ryedale 004C","E01027798","Total",889,831,58
"2011","Ryedale 004D","E01027803","Total",804,714,90
"2011","Ryedale 007A","E01027774","Total",892,832,60
"2011","Ryedale 007B","E01027778","Total",1070,1000,70
"2011","Ryedale 007C","E01027782","Total",838,766,72
"2011","Ryedale 007D","E01027797","Total",746,716,30
"2011","Ryedale 007E","E01027799","Total",802,762,40
"2011","Ryedale 008A","E01027785","Total",874,811,63
"2011","Ryedale 008B","E01027786","Total",731,688,43
"2011","Ryedale 008C","E01027787","Total",772,744,28
"2011","Ryedale 008D","E01027788","Total",668,658,10
"2011","Ryedale 008E","E01027789","Total",1112,1063,49
"2011","Ryedale 008F","E01027790","Total",868,819,49
"2011","Ryedale 008G","E01027791","Total",662,646,16
"2011","Scarborough 001A","E01027837","Total",689,672,17
"2011","Scarborough 001B","E01027839","Total",756,707,49
"2011","Scarborough 001C","E01027869","Total",1074,623,451
"2011","Scarborough 001D","E01027870","Total",914,685,229
"2011","Scarborough 001E","E01027871","Total",813,695,118
"2011","Scarborough 002A","E01027813","Total",952,837,115
"2011","Scarborough 002B","E01027822","Total",750,610,140
"2011","Scarborough 002C","E01027840","Total",1350,977,373
"2011","Scarborough 002D","E01027841","Total",825,583,242
"2011","Scarborough 003A","E01027838","Total",758,681,77
"2011","Scarborough 003B","E01027864","Total",682,588,94
"2011","Scarborough 003C","E01027865","Total",1190,785,405
"2011","Scarborough 003D","E01027866","Total",731,661,70
"2011","Scarborough 004A","E01027821","Total",803,651,152
"2011","Scarborough 004B","E01027823","Total",729,662,67
"2011","Scarborough 004C","E01027831","Total",533,463,70
"2011","Scarborough 004D","E01027832","Total",726,448,278
"2011","Scarborough 004E","E01027836","Total",1096,1018,78
"2011","Scarborough 004F","E01027857","Total",647,560,87
"2011","Scarborough 005A","E01027842","Total",735,709,26
"2011","Scarborough 005B","E01027843","Total",645,622,23
"2011","Scarborough 005C","E01027844","Total",670,656,14
"2011","Scarborough 005D","E01027845","Total",761,725,36
"2011","Scarborough 005E","E01027855","Total",665,628,37
"2011","Scarborough 005F","E01027856","Total",660,610,50
"2011","Scarborough 006A","E01027805","Total",956,778,178
"2011","Scarborough 006B","E01027806","Total",1093,928,165
"2011","Scarborough 006C","E01027846","Total",929,766,163
"2011","Scarborough 006D","E01027847","Total",1242,996,246
"2011","Scarborough 006E","E01027848","Total",523,456,67
"2011","Scarborough 007A","E01027849","Total",561,518,43
"2011","Scarborough 007B","E01027850","Total",644,622,22
"2011","Scarborough 007C","E01027872","Total",614,604,10
"2011","Scarborough 007D","E01027874","Total",666,620,46
"2011","Scarborough 008A","E01027810","Total",682,649,33
"2011","Scarborough 008B","E01027811","Total",719,687,32
"2011","Scarborough 008C","E01027812","Total",845,753,92
"2011","Scarborough 008D","E01027851","Total",643,626,17
"2011","Scarborough 008E","E01027862","Total",811,753,58
"2011","Scarborough 009A","E01027824","Total",743,717,26
"2011","Scarborough 009B","E01027825","Total",807,759,48
"2011","Scarborough 009C","E01027826","Total",704,655,49
"2011","Scarborough 009D","E01027861","Total",703,646,57
"2011","Scarborough 009E","E01027863","Total",678,661,17
"2011","Scarborough 009F","E01027873","Total",745,723,22
"2011","Scarborough 010A","E01027804","Total",1120,847,273
"2011","Scarborough 010B","E01027852","Total",1070,899,171
"2011","Scarborough 010C","E01027853","Total",720,657,63
"2011","Scarborough 010D","E01027854","Total",1167,857,310
"2011","Scarborough 010E","E01027868","Total",1525,1173,352
"2011","Scarborough 011A","E01027807","Total",675,646,29
"2011","Scarborough 011B","E01027808","Total",666,654,12
"2011","Scarborough 011C","E01027809","Total",696,644,52
"2011","Scarborough 011D","E01027818","Total",623,611,12
"2011","Scarborough 011E","E01027867","Total",667,627,40
"2011","Scarborough 012A","E01027817","Total",621,592,29
"2011","Scarborough 012B","E01027819","Total",598,581,17
"2011","Scarborough 012C","E01027820","Total",521,510,11
"2011","Scarborough 012D","E01027858","Total",631,606,25
"2011","Scarborough 012E","E01027860","Total",651,637,14
"2011","Scarborough 013A","E01027814","Total",721,677,44
"2011","Scarborough 013B","E01027815","Total",656,594,62
"2011","Scarborough 013C","E01027816","Total",714,697,17
"2011","Scarborough 013D","E01027859","Total",749,719,30
"2011","Scarborough 014A","E01027827","Total",1393,892,501
"2011","Scarborough 014B","E01027828","Total",881,798,83
"2011","Scarborough 014C","E01027829","Total",868,771,97
"2011","Scarborough 014D","E01027830","Total",789,736,53
"2011","Scarborough 014E","E01027833","Total",916,747,169
"2011","Scarborough 014F","E01027834","Total",783,738,45
"2011","Scarborough 014G","E01027835","Total",837,752,85
"2011","Selby 001A","E01027918","Total",679,648,31
"2011","Selby 001B","E01027919","Total",542,509,33
"2011","Selby 001C","E01027920","Total",507,500,7
"2011","Selby 001D","E01027921","Total",884,859,25
"2011","Selby 001E","E01027922","Total",712,668,44
"2011","Selby 002A","E01027875","Total",766,712,54
"2011","Selby 002B","E01027886","Total",598,559,39
"2011","Selby 002C","E01027887","Total",717,663,54
"2011","Selby 002D","E01027888","Total",745,702,43
"2011","Selby 002E","E01027904","Total",943,890,53
"2011","Selby 003A","E01027876","Total",669,653,16
"2011","Selby 003B","E01027877","Total",526,511,15
"2011","Selby 003C","E01027900","Total",789,757,32
"2011","Selby 003D","E01027901","Total",657,636,21
"2011","Selby 003E","E01027902","Total",609,587,22
"2011","Selby 003F","E01027903","Total",448,416,32
"2011","Selby 004A","E01027898","Total",1050,1003,47
"2011","Selby 004B","E01027914","Total",692,669,23
"2011","Selby 004C","E01027915","Total",741,710,31
"2011","Selby 004D","E01027916","Total",677,653,24
"2011","Selby 004E","E01027917","Total",737,699,38
"2011","Selby 005A","E01027878","Total",572,548,24
"2011","Selby 005B","E01027905","Total",918,868,50
"2011","Selby 005C","E01027907","Total",582,563,19
"2011","Selby 005D","E01027908","Total",841,779,62
"2011","Selby 005E","E01027909","Total",1059,952,107
"2011","Selby 005F","E01027910","Total",1156,1099,57
"2011","Selby 006A","E01027881","Total",611,593,18
"2011","Selby 006B","E01027906","Total",599,575,24
"2011","Selby 006C","E01027911","Total",649,619,30
"2011","Selby 006D","E01027912","Total",434,428,6
"2011","Selby 006E","E01027913","Total",509,490,19
"2011","Selby 007A","E01027879","Total",573,566,7
"2011","Selby 007B","E01027880","Total",652,626,26
"2011","Selby 007C","E01027882","Total",733,699,34
"2011","Selby 007D","E01027894","Total",808,773,35
"2011","Selby 007E","E01027895","Total",706,675,31
"2011","Selby 008A","E01027883","Total",483,446,37
"2011","Selby 008B","E01027884","Total",668,627,41
"2011","Selby 008C","E01027885","Total",675,655,20
"2011","Selby 008D","E01027896","Total",831,802,29
"2011","Selby 008E","E01027897","Total",885,840,45
"2011","Selby 009A","E01027891","Total",777,746,31
"2011","Selby 009B","E01027892","Total",865,836,29
"2011","Selby 009C","E01027893","Total",821,764,57
"2011","Selby 009D","E01027899","Total",740,683,57
"2011","Selby 010A","E01027889","Total",736,718,18
"2011","Selby 010B","E01027890","Total",831,807,24
"2011","Selby 010C","E01027923","Total",1013,944,69
"2011","Selby 010D","E01027924","Total",879,834,45
"2011","Barnsley 001A","E01007434","Total",877,837,40
"2011","Barnsley 001B","E01007435","Total",739,723,16
"2011","Barnsley 001C","E01007438","Total",640,629,11
"2011","Barnsley 001D","E01007439","Total",518,507,11
"2011","Barnsley 002A","E01007433","Total",694,678,16
"2011","Barnsley 002B","E01007436","Total",577,568,9
"2011","Barnsley 002C","E01007437","Total",647,626,21
"2011","Barnsley 002D","E01007440","Total",713,665,48
"2011","Barnsley 003A","E01007329","Total",651,637,14
"2011","Barnsley 003B","E01007331","Total",851,823,28
"2011","Barnsley 003C","E01007342","Total",577,563,14
"2011","Barnsley 003D","E01007343","Total",685,650,35
"2011","Barnsley 004A","E01007356","Total",626,602,24
"2011","Barnsley 004B","E01007357","Total",617,598,19
"2011","Barnsley 004C","E01007361","Total",735,698,37
"2011","Barnsley 004D","E01007362","Total",713,691,22
"2011","Barnsley 004E","E01007363","Total",794,769,25
"2011","Barnsley 005A","E01007355","Total",611,594,17
"2011","Barnsley 005B","E01007358","Total",665,643,22
"2011","Barnsley 005C","E01007359","Total",687,660,27
"2011","Barnsley 005D","E01007360","Total",673,659,14
"2011","Barnsley 005E","E01007386","Total",792,769,23
"2011","Barnsley 006A","E01007328","Total",811,801,10
"2011","Barnsley 006B","E01007330","Total",741,725,16
"2011","Barnsley 006C","E01007332","Total",1020,979,41
"2011","Barnsley 006D","E01007333","Total",510,494,16
"2011","Barnsley 007A","E01007323","Total",622,614,8
"2011","Barnsley 007B","E01007324","Total",766,747,19
"2011","Barnsley 007C","E01007325","Total",621,613,8
"2011","Barnsley 007D","E01007326","Total",660,651,9
"2011","Barnsley 007E","E01007327","Total",818,804,14
"2011","Barnsley 007F","E01007411","Total",500,489,11
"2011","Barnsley 008A","E01007341","Total",528,513,15
"2011","Barnsley 008B","E01007345","Total",707,675,32
"2011","Barnsley 008C","E01007346","Total",697,664,33
"2011","Barnsley 008D","E01007347","Total",680,666,14
"2011","Barnsley 009A","E01007334","Total",570,554,16
"2011","Barnsley 009B","E01007335","Total",620,603,17
"2011","Barnsley 009C","E01007400","Total",872,848,24
"2011","Barnsley 009D","E01007404","Total",627,606,21
"2011","Barnsley 009E","E01007406","Total",862,837,25
"2011","Barnsley 010C","E01007408","Total",666,637,29
"2011","Barnsley 010D","E01007409","Total",654,624,30
"2011","Barnsley 010E","E01007410","Total",887,854,33
"2011","Barnsley 010G","E01032550","Total",1231,1177,54
"2011","Barnsley 010H","E01032551","Total",1113,1084,29
"2011","Barnsley 011A","E01007344","Total",927,889,38
"2011","Barnsley 011B","E01007402","Total",674,657,17
"2011","Barnsley 011C","E01007403","Total",619,613,6
"2011","Barnsley 011D","E01007405","Total",647,590,57
"2011","Barnsley 012A","E01007379","Total",721,695,26
"2011","Barnsley 012B","E01007380","Total",755,737,18
"2011","Barnsley 012C","E01007381","Total",681,661,20
"2011","Barnsley 012D","E01007387","Total",635,619,16
"2011","Barnsley 012E","E01007442","Total",655,642,13
"2011","Barnsley 012F","E01007444","Total",796,768,28
"2011","Barnsley 012G","E01007446","Total",663,642,21
"2011","Barnsley 013A","E01007336","Total",833,764,69
"2011","Barnsley 013B","E01007340","Total",794,744,50
"2011","Barnsley 013C","E01007415","Total",663,634,29
"2011","Barnsley 013D","E01007417","Total",797,734,63
"2011","Barnsley 013E","E01007441","Total",778,737,41
"2011","Barnsley 013F","E01007443","Total",1119,1005,114
"2011","Barnsley 013G","E01007445","Total",768,731,37
"2011","Barnsley 014A","E01007372","Total",557,540,17
"2011","Barnsley 014B","E01007373","Total",721,675,46
"2011","Barnsley 014C","E01007374","Total",677,657,20
"2011","Barnsley 014D","E01007375","Total",728,685,43
"2011","Barnsley 014E","E01007377","Total",474,443,31
"2011","Barnsley 014F","E01007378","Total",776,750,26
"2011","Barnsley 015A","E01007319","Total",628,613,15
"2011","Barnsley 015B","E01007321","Total",674,655,19
"2011","Barnsley 015C","E01007322","Total",949,905,44
"2011","Barnsley 015D","E01007337","Total",926,870,56
"2011","Barnsley 016A","E01007418","Total",634,602,32
"2011","Barnsley 016B","E01007419","Total",739,714,25
"2011","Barnsley 016C","E01007420","Total",635,618,17
"2011","Barnsley 016D","E01007425","Total",669,632,37
"2011","Barnsley 017A","E01007338","Total",953,916,37
"2011","Barnsley 017B","E01007339","Total",785,728,57
"2011","Barnsley 017C","E01007413","Total",636,605,31
"2011","Barnsley 017D","E01007414","Total",729,706,23
"2011","Barnsley 018A","E01007317","Total",662,653,9
"2011","Barnsley 018B","E01007318","Total",673,644,29
"2011","Barnsley 018C","E01007320","Total",707,673,34
"2011","Barnsley 018D","E01007416","Total",530,517,13
"2011","Barnsley 019A","E01007382","Total",720,689,31
"2011","Barnsley 019B","E01007383","Total",522,513,9
"2011","Barnsley 019C","E01007384","Total",733,703,30
"2011","Barnsley 019D","E01007385","Total",686,668,18
"2011","Barnsley 020A","E01007348","Total",625,613,12
"2011","Barnsley 020B","E01007349","Total",724,668,56
"2011","Barnsley 020C","E01007350","Total",540,523,17
"2011","Barnsley 020D","E01007351","Total",680,643,37
"2011","Barnsley 020E","E01007352","Total",664,623,41
"2011","Barnsley 020F","E01007353","Total",689,657,32
"2011","Barnsley 020G","E01007354","Total",733,697,36
"2011","Barnsley 021A","E01007458","Total",658,619,39
"2011","Barnsley 021B","E01007459","Total",758,733,25
"2011","Barnsley 021C","E01007460","Total",625,612,13
"2011","Barnsley 021D","E01007461","Total",807,776,31
"2011","Barnsley 021E","E01007462","Total",680,658,22
"2011","Barnsley 021F","E01007463","Total",804,782,22
"2011","Barnsley 022A","E01007369","Total",830,687,143
"2011","Barnsley 022B","E01007370","Total",657,605,52
"2011","Barnsley 022C","E01007371","Total",852,817,35
"2011","Barnsley 022D","E01007376","Total",701,639,62
"2011","Barnsley 023A","E01007447","Total",673,657,16
"2011","Barnsley 023B","E01007448","Total",831,773,58
"2011","Barnsley 023C","E01007449","Total",862,815,47
"2011","Barnsley 023D","E01007450","Total",740,709,31
"2011","Barnsley 024A","E01007427","Total",713,671,42
"2011","Barnsley 024B","E01007428","Total",677,654,23
"2011","Barnsley 024C","E01007429","Total",744,726,18
"2011","Barnsley 024D","E01007430","Total",931,896,35
"2011","Barnsley 024E","E01007431","Total",559,543,16
"2011","Barnsley 024F","E01007432","Total",590,577,13
"2011","Barnsley 025A","E01007364","Total",618,593,25
"2011","Barnsley 025B","E01007365","Total",549,514,35
"2011","Barnsley 025C","E01007366","Total",874,847,27
"2011","Barnsley 025D","E01007367","Total",505,473,32
"2011","Barnsley 025E","E01007368","Total",745,698,47
"2011","Barnsley 026A","E01007451","Total",757,728,29
"2011","Barnsley 026B","E01007452","Total",660,634,26
"2011","Barnsley 026C","E01007453","Total",654,646,8
"2011","Barnsley 026E","E01007455","Total",599,587,12
"2011","Barnsley 026F","E01032924","Total",658,602,56
"2011","Barnsley 026G","E01032925","Total",643,603,40
"2011","Barnsley 027A","E01007421","Total",591,563,28
"2011","Barnsley 027B","E01007422","Total",661,635,26
"2011","Barnsley 027C","E01007423","Total",730,705,25
"2011","Barnsley 027D","E01007426","Total",727,692,35
"2011","Barnsley 028A","E01007396","Total",787,740,47
"2011","Barnsley 028B","E01007397","Total",712,677,35
"2011","Barnsley 028C","E01007398","Total",795,769,26
"2011","Barnsley 028D","E01007399","Total",943,895,48
"2011","Barnsley 028E","E01007424","Total",749,726,23
"2011","Barnsley 029A","E01007388","Total",749,694,55
"2011","Barnsley 029B","E01007393","Total",909,811,98
"2011","Barnsley 029C","E01007394","Total",588,565,23
"2011","Barnsley 029D","E01007456","Total",805,766,39
"2011","Barnsley 029E","E01007457","Total",724,689,35
"2011","Barnsley 030A","E01007389","Total",675,666,9
"2011","Barnsley 030B","E01007390","Total",670,646,24
"2011","Barnsley 030C","E01007391","Total",708,684,24
"2011","Barnsley 030D","E01007392","Total",623,609,14
"2011","Barnsley 030E","E01007395","Total",855,820,35
"2011","Doncaster 001A","E01007632","Total",636,615,21
"2011","Doncaster 001B","E01007633","Total",529,514,15
"2011","Doncaster 001C","E01007634","Total",685,653,32
"2011","Doncaster 001D","E01007635","Total",627,618,9
"2011","Doncaster 002A","E01007487","Total",702,691,11
"2011","Doncaster 002B","E01007488","Total",766,726,40
"2011","Doncaster 002C","E01007489","Total",757,722,35
"2011","Doncaster 002D","E01007490","Total",649,631,18
"2011","Doncaster 002E","E01007491","Total",700,661,39
"2011","Doncaster 002F","E01007492","Total",686,664,22
"2011","Doncaster 002G","E01007493","Total",733,715,18
"2011","Doncaster 003A","E01007636","Total",669,654,15
"2011","Doncaster 003B","E01007637","Total",692,655,37
"2011","Doncaster 003C","E01007638","Total",722,706,16
"2011","Doncaster 003D","E01007639","Total",931,899,32
"2011","Doncaster 003E","E01007640","Total",741,725,16
"2011","Doncaster 003F","E01007641","Total",601,588,13
"2011","Doncaster 003G","E01007642","Total",669,649,20
"2011","Doncaster 004A","E01007625","Total",645,620,25
"2011","Doncaster 004B","E01007626","Total",569,546,23
"2011","Doncaster 004C","E01007627","Total",723,701,22
"2011","Doncaster 004D","E01007628","Total",553,541,12
"2011","Doncaster 004E","E01007629","Total",688,663,25
"2011","Doncaster 005A","E01007468","Total",622,607,15
"2011","Doncaster 005B","E01007469","Total",555,543,12
"2011","Doncaster 005C","E01007470","Total",564,553,11
"2011","Doncaster 005D","E01007472","Total",661,654,7
"2011","Doncaster 005E","E01007473","Total",651,616,35
"2011","Doncaster 005F","E01007474","Total",665,649,16
"2011","Doncaster 006A","E01007554","Total",702,676,26
"2011","Doncaster 006B","E01007555","Total",636,626,10
"2011","Doncaster 006C","E01007556","Total",550,533,17
"2011","Doncaster 006D","E01007561","Total",563,556,7
"2011","Doncaster 006E","E01007562","Total",622,610,12
"2011","Doncaster 006F","E01007563","Total",544,525,19
"2011","Doncaster 007A","E01007621","Total",551,539,12
"2011","Doncaster 007B","E01007622","Total",678,666,12
"2011","Doncaster 007C","E01007623","Total",604,585,19
"2011","Doncaster 007D","E01007624","Total",765,750,15
"2011","Doncaster 007E","E01007630","Total",663,652,11
"2011","Doncaster 007F","E01007631","Total",542,534,8
"2011","Doncaster 008A","E01007553","Total",739,715,24
"2011","Doncaster 008B","E01007557","Total",439,419,20
"2011","Doncaster 008C","E01007558","Total",641,622,19
"2011","Doncaster 008D","E01007559","Total",425,405,20
"2011","Doncaster 008E","E01007560","Total",666,644,22
"2011","Doncaster 009A","E01007464","Total",615,600,15
"2011","Doncaster 009B","E01007465","Total",652,629,23
"2011","Doncaster 009C","E01007466","Total",663,640,23
"2011","Doncaster 009D","E01007467","Total",666,645,21
"2011","Doncaster 009E","E01007471","Total",606,591,15
"2011","Doncaster 009F","E01007504","Total",650,622,28
"2011","Doncaster 009G","E01007507","Total",522,496,26
"2011","Doncaster 010A","E01007506","Total",571,545,26
"2011","Doncaster 010B","E01007508","Total",723,695,28
"2011","Doncaster 010C","E01007509","Total",865,814,51
"2011","Doncaster 010D","E01007510","Total",761,734,27
"2011","Doncaster 010E","E01007511","Total",646,609,37
"2011","Doncaster 011A","E01007475","Total",642,627,15
"2011","Doncaster 011B","E01007476","Total",657,643,14
"2011","Doncaster 011C","E01007477","Total",617,598,19
"2011","Doncaster 011D","E01007478","Total",674,653,21
"2011","Doncaster 012A","E01007512","Total",739,717,22
"2011","Doncaster 012B","E01007513","Total",650,641,9
"2011","Doncaster 012C","E01007515","Total",669,661,8
"2011","Doncaster 012D","E01007518","Total",614,603,11
"2011","Doncaster 012E","E01007519","Total",531,527,4
"2011","Doncaster 013A","E01007505","Total",742,721,21
"2011","Doncaster 013B","E01007514","Total",712,664,48
"2011","Doncaster 013C","E01007516","Total",578,570,8
"2011","Doncaster 013D","E01007517","Total",755,701,54
"2011","Doncaster 014A","E01007479","Total",696,674,22
"2011","Doncaster 014B","E01007480","Total",560,549,11
"2011","Doncaster 014D","E01007482","Total",658,641,17
"2011","Doncaster 014E","E01033259","Total",670,655,15
"2011","Doncaster 014F","E01033260","Total",647,632,15
"2011","Doncaster 015A","E01007570","Total",661,645,16
"2011","Doncaster 015B","E01007650","Total",848,826,22
"2011","Doncaster 015C","E01007651","Total",703,676,27
"2011","Doncaster 015D","E01007652","Total",787,770,17
"2011","Doncaster 015E","E01007653","Total",671,638,33
"2011","Doncaster 015F","E01007656","Total",665,638,27
"2011","Doncaster 016A","E01007581","Total",631,626,5
"2011","Doncaster 016B","E01007582","Total",641,615,26
"2011","Doncaster 016C","E01007588","Total",684,669,15
"2011","Doncaster 016D","E01007589","Total",728,715,13
"2011","Doncaster 017A","E01007483","Total",624,610,14
"2011","Doncaster 017B","E01007484","Total",642,626,16
"2011","Doncaster 017C","E01007485","Total",609,592,17
"2011","Doncaster 017D","E01007486","Total",649,635,14
"2011","Doncaster 018A","E01007564","Total",622,605,17
"2011","Doncaster 018B","E01007565","Total",668,641,27
"2011","Doncaster 018C","E01007566","Total",800,780,20
"2011","Doncaster 018D","E01007567","Total",540,516,24
"2011","Doncaster 018E","E01007568","Total",604,595,9
"2011","Doncaster 018F","E01007569","Total",636,627,9
"2011","Doncaster 019A","E01007644","Total",595,587,8
"2011","Doncaster 019B","E01007646","Total",658,607,51
"2011","Doncaster 019C","E01007647","Total",743,692,51
"2011","Doncaster 019D","E01007648","Total",928,854,74
"2011","Doncaster 019E","E01007649","Total",637,616,21
"2011","Doncaster 019F","E01007654","Total",649,609,40
"2011","Doncaster 020A","E01007583","Total",652,632,20
"2011","Doncaster 020B","E01007586","Total",668,654,14
"2011","Doncaster 020C","E01007587","Total",758,728,30
"2011","Doncaster 020D","E01007620","Total",723,701,22
"2011","Doncaster 021A","E01007584","Total",690,671,19
"2011","Doncaster 021B","E01007585","Total",641,630,11
"2011","Doncaster 021C","E01007617","Total",658,643,15
"2011","Doncaster 021D","E01007618","Total",513,505,8
"2011","Doncaster 021E","E01007619","Total",732,716,16
"2011","Doncaster 022A","E01007529","Total",729,654,75
"2011","Doncaster 022B","E01007530","Total",570,512,58
"2011","Doncaster 022C","E01007531","Total",825,792,33
"2011","Doncaster 022D","E01007643","Total",689,662,27
"2011","Doncaster 022E","E01007645","Total",912,830,82
"2011","Doncaster 022F","E01007655","Total",940,868,72
"2011","Doncaster 023A","E01007494","Total",697,675,22
"2011","Doncaster 023B","E01007532","Total",1082,1017,65
"2011","Doncaster 023C","E01007533","Total",647,623,24
"2011","Doncaster 023D","E01007535","Total",659,638,21
"2011","Doncaster 024A","E01007522","Total",773,755,18
"2011","Doncaster 024B","E01007525","Total",688,671,17
"2011","Doncaster 024C","E01007528","Total",652,634,18
"2011","Doncaster 024D","E01007604","Total",586,574,12
"2011","Doncaster 025A","E01007521","Total",610,599,11
"2011","Doncaster 025B","E01007523","Total",688,661,27
"2011","Doncaster 025C","E01007524","Total",731,720,11
"2011","Doncaster 025D","E01007526","Total",693,667,26
"2011","Doncaster 025E","E01007607","Total",616,607,9
"2011","Doncaster 026A","E01007599","Total",732,715,17
"2011","Doncaster 026B","E01007600","Total",615,604,11
"2011","Doncaster 026C","E01007601","Total",625,610,15
"2011","Doncaster 026D","E01007602","Total",634,614,20
"2011","Doncaster 026E","E01007603","Total",629,603,26
"2011","Doncaster 027A","E01007520","Total",617,605,12
"2011","Doncaster 027B","E01007527","Total",1073,1015,58
"2011","Doncaster 027C","E01007605","Total",655,633,22
"2011","Doncaster 027D","E01007606","Total",620,607,13
"2011","Doncaster 028A","E01007495","Total",806,757,49
"2011","Doncaster 028B","E01007500","Total",595,577,18
"2011","Doncaster 028C","E01007502","Total",1107,1080,27
"2011","Doncaster 028D","E01007534","Total",1014,916,98
"2011","Doncaster 029A","E01007496","Total",631,606,25
"2011","Doncaster 029B","E01007497","Total",559,542,17
"2011","Doncaster 029C","E01007498","Total",709,657,52
"2011","Doncaster 029D","E01007499","Total",669,655,14
"2011","Doncaster 029E","E01007501","Total",654,643,11
"2011","Doncaster 029F","E01007503","Total",705,683,22
"2011","Doncaster 030A","E01007575","Total",648,627,21
"2011","Doncaster 030B","E01007578","Total",709,685,24
"2011","Doncaster 030C","E01007579","Total",724,691,33
"2011","Doncaster 030D","E01007580","Total",635,620,15
"2011","Doncaster 031A","E01007571","Total",728,690,38
"2011","Doncaster 031B","E01007572","Total",594,574,20
"2011","Doncaster 031C","E01007573","Total",685,667,18
"2011","Doncaster 031D","E01007574","Total",683,638,45
"2011","Doncaster 031E","E01007576","Total",665,646,19
"2011","Doncaster 031F","E01007577","Total",787,711,76
"2011","Doncaster 032A","E01007536","Total",950,890,60
"2011","Doncaster 032B","E01007542","Total",814,787,27
"2011","Doncaster 032C","E01007543","Total",697,687,10
"2011","Doncaster 032D","E01007544","Total",761,750,11
"2011","Doncaster 033A","E01007546","Total",683,619,64
"2011","Doncaster 033B","E01007551","Total",752,725,27
"2011","Doncaster 033C","E01007552","Total",626,603,23
"2011","Doncaster 033D","E01007613","Total",700,673,27
"2011","Doncaster 034A","E01007545","Total",635,616,19
"2011","Doncaster 034B","E01007547","Total",645,607,38
"2011","Doncaster 034C","E01007548","Total",431,425,6
"2011","Doncaster 034D","E01007549","Total",665,653,12
"2011","Doncaster 034E","E01007550","Total",710,696,14
"2011","Doncaster 035A","E01007537","Total",723,706,17
"2011","Doncaster 035B","E01007538","Total",610,590,20
"2011","Doncaster 035C","E01007539","Total",558,545,13
"2011","Doncaster 035D","E01007540","Total",655,639,16
"2011","Doncaster 035E","E01007541","Total",659,646,13
"2011","Doncaster 036A","E01007591","Total",623,607,16
"2011","Doncaster 036B","E01007594","Total",847,825,22
"2011","Doncaster 036C","E01007596","Total",511,499,12
"2011","Doncaster 036D","E01007598","Total",673,665,8
"2011","Doncaster 037A","E01007590","Total",490,476,14
"2011","Doncaster 037B","E01007592","Total",667,641,26
"2011","Doncaster 037C","E01007593","Total",523,508,15
"2011","Doncaster 037D","E01007595","Total",643,633,10
"2011","Doncaster 037E","E01007597","Total",709,683,26
"2011","Doncaster 038A","E01007608","Total",642,623,19
"2011","Doncaster 038B","E01007609","Total",1071,1023,48
"2011","Doncaster 038C","E01007610","Total",831,813,18
"2011","Doncaster 039A","E01007611","Total",596,583,13
"2011","Doncaster 039B","E01007612","Total",670,638,32
"2011","Doncaster 039C","E01007614","Total",547,532,15
"2011","Doncaster 039D","E01007615","Total",667,641,26
"2011","Doncaster 039E","E01007616","Total",599,587,12
"2011","Rotherham 001A","E01007693","Total",981,941,40
"2011","Rotherham 001B","E01007694","Total",750,737,13
"2011","Rotherham 001C","E01007695","Total",992,972,20
"2011","Rotherham 001D","E01007697","Total",671,662,9
"2011","Rotherham 001E","E01007698","Total",661,634,27
"2011","Rotherham 002A","E01007816","Total",656,649,7
"2011","Rotherham 002B","E01007817","Total",652,638,14
"2011","Rotherham 002C","E01007819","Total",647,627,20
"2011","Rotherham 002D","E01007820","Total",679,625,54
"2011","Rotherham 002E","E01007821","Total",693,670,23
"2011","Rotherham 002F","E01007822","Total",740,710,30
"2011","Rotherham 003A","E01007796","Total",591,573,18
"2011","Rotherham 003B","E01007797","Total",594,580,14
"2011","Rotherham 003C","E01007798","Total",552,543,9
"2011","Rotherham 003D","E01007799","Total",634,613,21
"2011","Rotherham 003E","E01007800","Total",750,698,52
"2011","Rotherham 003F","E01007818","Total",692,674,18
"2011","Rotherham 004A","E01007777","Total",677,651,26
"2011","Rotherham 004B","E01007793","Total",642,628,14
"2011","Rotherham 004C","E01007794","Total",558,553,5
"2011","Rotherham 004D","E01007795","Total",645,634,11
"2011","Rotherham 005A","E01007778","Total",602,593,9
"2011","Rotherham 005B","E01007779","Total",619,582,37
"2011","Rotherham 005C","E01007780","Total",631,616,15
"2011","Rotherham 005D","E01007781","Total",679,656,23
"2011","Rotherham 005E","E01007782","Total",610,597,13
"2011","Rotherham 006A","E01007771","Total",641,620,21
"2011","Rotherham 006B","E01007772","Total",584,556,28
"2011","Rotherham 006C","E01007773","Total",671,642,29
"2011","Rotherham 006D","E01007774","Total",622,605,17
"2011","Rotherham 007A","E01007696","Total",687,662,25
"2011","Rotherham 007B","E01007801","Total",623,614,9
"2011","Rotherham 007C","E01007802","Total",594,581,13
"2011","Rotherham 007D","E01007803","Total",555,547,8
"2011","Rotherham 007E","E01007808","Total",598,590,8
"2011","Rotherham 008A","E01007775","Total",561,545,16
"2011","Rotherham 008B","E01007776","Total",682,652,30
"2011","Rotherham 008C","E01007783","Total",853,813,40
"2011","Rotherham 008D","E01007784","Total",832,762,70
"2011","Rotherham 009A","E01007728","Total",492,483,9
"2011","Rotherham 009B","E01007729","Total",864,846,18
"2011","Rotherham 009C","E01007730","Total",711,702,9
"2011","Rotherham 009D","E01007731","Total",606,566,40
"2011","Rotherham 009E","E01007732","Total",791,766,25
"2011","Rotherham 009F","E01007733","Total",651,629,22
"2011","Rotherham 010A","E01007719","Total",543,525,18
"2011","Rotherham 010B","E01007720","Total",655,638,17
"2011","Rotherham 010C","E01007721","Total",731,711,20
"2011","Rotherham 010D","E01007727","Total",694,684,10
"2011","Rotherham 011A","E01007740","Total",600,595,5
"2011","Rotherham 011B","E01007804","Total",669,661,8
"2011","Rotherham 011C","E01007805","Total",651,641,10
"2011","Rotherham 011D","E01007806","Total",536,518,18
"2011","Rotherham 011E","E01007807","Total",618,607,11
"2011","Rotherham 012A","E01007681","Total",588,576,12
"2011","Rotherham 012B","E01007691","Total",902,884,18
"2011","Rotherham 012C","E01007692","Total",731,712,19
"2011","Rotherham 012E","E01032926","Total",659,642,17
"2011","Rotherham 012F","E01032927","Total",652,634,18
"2011","Rotherham 013A","E01007723","Total",604,589,15
"2011","Rotherham 013B","E01007735","Total",578,556,22
"2011","Rotherham 013C","E01007737","Total",624,595,29
"2011","Rotherham 013D","E01007738","Total",568,554,14
"2011","Rotherham 013E","E01007739","Total",626,619,7
"2011","Rotherham 014A","E01007736","Total",711,678,33
"2011","Rotherham 014B","E01007765","Total",674,641,33
"2011","Rotherham 014C","E01007766","Total",528,519,9
"2011","Rotherham 014D","E01007768","Total",864,816,48
"2011","Rotherham 014E","E01007770","Total",638,613,25
"2011","Rotherham 015A","E01007741","Total",712,680,32
"2011","Rotherham 015B","E01007742","Total",624,607,17
"2011","Rotherham 015C","E01007743","Total",506,502,4
"2011","Rotherham 015D","E01007744","Total",742,713,29
"2011","Rotherham 015E","E01007745","Total",738,677,61
"2011","Rotherham 015F","E01007746","Total",596,587,9
"2011","Rotherham 016A","E01007715","Total",708,643,65
"2011","Rotherham 016B","E01007716","Total",807,744,63
"2011","Rotherham 016C","E01007717","Total",865,813,52
"2011","Rotherham 016D","E01007718","Total",702,653,49
"2011","Rotherham 017A","E01007677","Total",587,558,29
"2011","Rotherham 017B","E01007714","Total",1066,990,76
"2011","Rotherham 017C","E01007767","Total",700,671,29
"2011","Rotherham 017D","E01007769","Total",702,614,88
"2011","Rotherham 018A","E01007685","Total",617,597,20
"2011","Rotherham 018B","E01007754","Total",529,523,6
"2011","Rotherham 018C","E01007755","Total",584,573,11
"2011","Rotherham 018D","E01007756","Total",614,601,13
"2011","Rotherham 018E","E01007761","Total",721,701,20
"2011","Rotherham 018F","E01007762","Total",601,582,19
"2011","Rotherham 019A","E01007682","Total",565,555,10
"2011","Rotherham 019B","E01007683","Total",601,582,19
"2011","Rotherham 019C","E01007686","Total",703,686,17
"2011","Rotherham 019D","E01007688","Total",668,654,14
"2011","Rotherham 019E","E01007725","Total",491,477,14
"2011","Rotherham 019F","E01007726","Total",750,733,17
"2011","Rotherham 020A","E01007757","Total",691,674,17
"2011","Rotherham 020B","E01007758","Total",611,565,46
"2011","Rotherham 020C","E01007759","Total",689,670,19
"2011","Rotherham 020D","E01007760","Total",828,786,42
"2011","Rotherham 020E","E01007763","Total",731,674,57
"2011","Rotherham 020F","E01007764","Total",726,691,35
"2011","Rotherham 021A","E01007708","Total",781,761,20
"2011","Rotherham 021B","E01007709","Total",625,611,14
"2011","Rotherham 021C","E01007710","Total",666,656,10
"2011","Rotherham 021D","E01007711","Total",700,688,12
"2011","Rotherham 021E","E01007724","Total",603,584,19
"2011","Rotherham 021F","E01007734","Total",786,768,18
"2011","Rotherham 022A","E01007684","Total",687,666,21
"2011","Rotherham 022B","E01007687","Total",663,644,19
"2011","Rotherham 022C","E01007689","Total",644,623,21
"2011","Rotherham 022D","E01007690","Total",719,694,25
"2011","Rotherham 023A","E01007675","Total",678,653,25
"2011","Rotherham 023B","E01007678","Total",727,662,65
"2011","Rotherham 023C","E01007679","Total",785,748,37
"2011","Rotherham 023D","E01007680","Total",712,684,28
"2011","Rotherham 023E","E01007712","Total",768,747,21
"2011","Rotherham 023F","E01007713","Total",644,632,12
"2011","Rotherham 024A","E01007811","Total",594,579,15
"2011","Rotherham 024B","E01007812","Total",558,544,14
"2011","Rotherham 024C","E01007813","Total",612,591,21
"2011","Rotherham 024D","E01007814","Total",488,474,14
"2011","Rotherham 025A","E01007676","Total",741,719,22
"2011","Rotherham 025B","E01007702","Total",647,614,33
"2011","Rotherham 025C","E01007703","Total",511,500,11
"2011","Rotherham 025D","E01007704","Total",689,670,19
"2011","Rotherham 025E","E01007705","Total",613,593,20
"2011","Rotherham 025F","E01007707","Total",664,649,15
"2011","Rotherham 026A","E01007666","Total",582,570,12
"2011","Rotherham 026B","E01007809","Total",748,726,22
"2011","Rotherham 026C","E01007810","Total",816,793,23
"2011","Rotherham 026D","E01007815","Total",730,705,25
"2011","Rotherham 027A","E01007665","Total",708,702,6
"2011","Rotherham 027B","E01007699","Total",766,755,11
"2011","Rotherham 027C","E01007700","Total",744,719,25
"2011","Rotherham 027D","E01007701","Total",735,723,12
"2011","Rotherham 027E","E01007706","Total",564,556,8
"2011","Rotherham 028A","E01007787","Total",1242,1197,45
"2011","Rotherham 028B","E01007788","Total",699,659,40
"2011","Rotherham 028C","E01007789","Total",774,739,35
"2011","Rotherham 028D","E01007792","Total",490,484,6
"2011","Rotherham 029A","E01007657","Total",592,582,10
"2011","Rotherham 029B","E01007659","Total",487,472,15
"2011","Rotherham 029C","E01007785","Total",534,519,15
"2011","Rotherham 029D","E01007786","Total",500,486,14
"2011","Rotherham 029E","E01007790","Total",750,696,54
"2011","Rotherham 029F","E01007791","Total",577,551,26
"2011","Rotherham 030A","E01007667","Total",589,579,10
"2011","Rotherham 030B","E01007668","Total",706,690,16
"2011","Rotherham 030C","E01007669","Total",658,647,11
"2011","Rotherham 030D","E01007670","Total",625,610,15
"2011","Rotherham 030E","E01007672","Total",597,589,8
"2011","Rotherham 030F","E01007673","Total",664,640,24
"2011","Rotherham 031A","E01007671","Total",845,822,23
"2011","Rotherham 031B","E01007674","Total",837,817,20
"2011","Rotherham 031C","E01007747","Total",562,537,25
"2011","Rotherham 031D","E01007750","Total",666,642,24
"2011","Rotherham 032A","E01007658","Total",608,581,27
"2011","Rotherham 032B","E01007660","Total",499,488,11
"2011","Rotherham 032C","E01007661","Total",590,574,16
"2011","Rotherham 032D","E01007662","Total",487,470,17
"2011","Rotherham 032E","E01007663","Total",666,637,29
"2011","Rotherham 032F","E01007664","Total",844,828,16
"2011","Rotherham 033A","E01007748","Total",670,648,22
"2011","Rotherham 033B","E01007749","Total",783,762,21
"2011","Rotherham 033C","E01007751","Total",871,834,37
"2011","Rotherham 033D","E01007752","Total",638,619,19
"2011","Rotherham 033E","E01007753","Total",685,670,15
"2011","Sheffield 001A","E01008144","Total",753,716,37
"2011","Sheffield 001B","E01008145","Total",742,712,30
"2011","Sheffield 001C","E01008148","Total",655,637,18
"2011","Sheffield 001D","E01008149","Total",662,653,9
"2011","Sheffield 001E","E01008150","Total",656,638,18
"2011","Sheffield 002A","E01008142","Total",643,623,20
"2011","Sheffield 002B","E01008143","Total",809,776,33
"2011","Sheffield 002C","E01008146","Total",528,523,5
"2011","Sheffield 002D","E01008147","Total",638,617,21
"2011","Sheffield 003A","E01007888","Total",562,553,9
"2011","Sheffield 003B","E01007892","Total",677,639,38
"2011","Sheffield 003C","E01007893","Total",646,627,19
"2011","Sheffield 003D","E01007898","Total",636,619,17
"2011","Sheffield 003E","E01007899","Total",634,612,22
"2011","Sheffield 003F","E01007900","Total",789,760,29
"2011","Sheffield 003G","E01007901","Total",734,712,22
"2011","Sheffield 004A","E01007887","Total",619,605,14
"2011","Sheffield 004B","E01007889","Total",1066,1044,22
"2011","Sheffield 004C","E01007890","Total",596,585,11
"2011","Sheffield 004D","E01007891","Total",668,659,9
"2011","Sheffield 004E","E01007894","Total",667,639,28
"2011","Sheffield 004F","E01007895","Total",658,645,13
"2011","Sheffield 004G","E01007896","Total",564,551,13
"2011","Sheffield 005A","E01007897","Total",633,622,11
"2011","Sheffield 005B","E01008134","Total",631,616,15
"2011","Sheffield 005C","E01008135","Total",792,758,34
"2011","Sheffield 005D","E01008137","Total",642,626,16
"2011","Sheffield 005E","E01008141","Total",684,667,17
"2011","Sheffield 006A","E01008053","Total",581,565,16
"2011","Sheffield 006B","E01008056","Total",602,594,8
"2011","Sheffield 006C","E01008058","Total",625,620,5
"2011","Sheffield 006D","E01008138","Total",641,630,11
"2011","Sheffield 006E","E01008139","Total",727,707,20
"2011","Sheffield 007A","E01007856","Total",549,543,6
"2011","Sheffield 007B","E01008054","Total",552,537,15
"2011","Sheffield 007C","E01008055","Total",637,607,30
"2011","Sheffield 007D","E01008057","Total",619,600,19
"2011","Sheffield 008A","E01008126","Total",659,646,13
"2011","Sheffield 008C","E01008128","Total",755,723,32
"2011","Sheffield 008D","E01008136","Total",604,584,20
"2011","Sheffield 008E","E01008140","Total",879,848,31
"2011","Sheffield 008F","E01033275","Total",679,655,24
"2011","Sheffield 008G","E01033280","Total",615,601,14
"2011","Sheffield 009A","E01008085","Total",625,617,8
"2011","Sheffield 009B","E01008086","Total",596,575,21
"2011","Sheffield 009C","E01008116","Total",559,552,7
"2011","Sheffield 009D","E01008117","Total",563,555,8
"2011","Sheffield 009E","E01008118","Total",625,616,9
"2011","Sheffield 009F","E01008119","Total",474,469,5
"2011","Sheffield 009G","E01008125","Total",625,612,13
"2011","Sheffield 010A","E01007849","Total",890,866,24
"2011","Sheffield 010B","E01007857","Total",658,650,8
"2011","Sheffield 010C","E01008059","Total",646,633,13
"2011","Sheffield 010D","E01008060","Total",637,624,13
"2011","Sheffield 011A","E01008061","Total",660,649,11
"2011","Sheffield 011B","E01008063","Total",736,702,34
"2011","Sheffield 011E","E01033277","Total",968,954,14
"2011","Sheffield 012A","E01008087","Total",675,667,8
"2011","Sheffield 012B","E01008088","Total",664,658,6
"2011","Sheffield 012C","E01008090","Total",754,742,12
"2011","Sheffield 012D","E01008092","Total",734,726,8
"2011","Sheffield 012E","E01008122","Total",563,548,15
"2011","Sheffield 012F","E01008124","Total",669,663,6
"2011","Sheffield 013A","E01007848","Total",715,689,26
"2011","Sheffield 013B","E01007851","Total",546,524,22
"2011","Sheffield 013C","E01007947","Total",881,868,13
"2011","Sheffield 013D","E01007948","Total",630,612,18
"2011","Sheffield 013E","E01008062","Total",616,608,8
"2011","Sheffield 014A","E01007847","Total",674,643,31
"2011","Sheffield 014B","E01007850","Total",635,619,16
"2011","Sheffield 014C","E01007852","Total",664,637,27
"2011","Sheffield 014D","E01007853","Total",707,691,16
"2011","Sheffield 014E","E01007854","Total",659,645,14
"2011","Sheffield 014F","E01007855","Total",815,785,30
"2011","Sheffield 015A","E01007941","Total",665,656,9
"2011","Sheffield 015B","E01007945","Total",760,747,13
"2011","Sheffield 015C","E01007946","Total",640,623,17
"2011","Sheffield 015D","E01007950","Total",635,634,1
"2011","Sheffield 015E","E01008123","Total",536,519,17
"2011","Sheffield 016A","E01007987","Total",604,593,11
"2011","Sheffield 016B","E01007988","Total",655,651,4
"2011","Sheffield 016C","E01007989","Total",624,607,17
"2011","Sheffield 016D","E01007991","Total",629,623,6
"2011","Sheffield 017A","E01007995","Total",742,696,46
"2011","Sheffield 017B","E01008089","Total",709,672,37
"2011","Sheffield 017C","E01008091","Total",672,647,25
"2011","Sheffield 017D","E01008093","Total",796,773,23
"2011","Sheffield 018A","E01007903","Total",609,589,20
"2011","Sheffield 018B","E01007904","Total",687,675,12
"2011","Sheffield 018C","E01007913","Total",508,477,31
"2011","Sheffield 018D","E01007914","Total",516,494,22
"2011","Sheffield 019A","E01007870","Total",778,738,40
"2011","Sheffield 019B","E01007871","Total",871,855,16
"2011","Sheffield 019C","E01007943","Total",820,794,26
"2011","Sheffield 019D","E01008094","Total",482,471,11
"2011","Sheffield 020A","E01007869","Total",539,508,31
"2011","Sheffield 020B","E01007872","Total",645,627,18
"2011","Sheffield 020C","E01007873","Total",678,647,31
"2011","Sheffield 020D","E01007942","Total",549,518,31
"2011","Sheffield 020E","E01007949","Total",536,502,34
"2011","Sheffield 021A","E01007990","Total",666,661,5
"2011","Sheffield 021B","E01007992","Total",722,698,24
"2011","Sheffield 021C","E01007993","Total",699,689,10
"2011","Sheffield 021D","E01007994","Total",618,607,11
"2011","Sheffield 021E","E01007996","Total",738,702,36
"2011","Sheffield 022A","E01007874","Total",680,669,11
"2011","Sheffield 022B","E01007875","Total",635,607,28
"2011","Sheffield 022D","E01007877","Total",431,418,13
"2011","Sheffield 022E","E01007940","Total",671,630,41
"2011","Sheffield 022F","E01007944","Total",694,593,101
"2011","Sheffield 022G","E01033269","Total",714,666,48
"2011","Sheffield 022H","E01033270","Total",822,787,35
"2011","Sheffield 023A","E01008129","Total",598,578,20
"2011","Sheffield 023B","E01008130","Total",656,647,9
"2011","Sheffield 023C","E01008131","Total",665,650,15
"2011","Sheffield 023D","E01008132","Total",564,558,6
"2011","Sheffield 023E","E01008133","Total",758,744,14
"2011","Sheffield 024A","E01008151","Total",723,699,24
"2011","Sheffield 024B","E01008153","Total",859,839,20
"2011","Sheffield 024C","E01008154","Total",845,807,38
"2011","Sheffield 024D","E01008155","Total",742,722,20
"2011","Sheffield 024E","E01008156","Total",682,674,8
"2011","Sheffield 024F","E01008160","Total",669,657,12
"2011","Sheffield 025A","E01007997","Total",658,644,14
"2011","Sheffield 025B","E01007998","Total",909,891,18
"2011","Sheffield 025C","E01008152","Total",680,665,15
"2011","Sheffield 025D","E01008158","Total",760,730,30
"2011","Sheffield 026A","E01008065","Total",987,965,22
"2011","Sheffield 026B","E01008068","Total",930,891,39
"2011","Sheffield 026C","E01008072","Total",670,656,14
"2011","Sheffield 026D","E01008157","Total",876,859,17
"2011","Sheffield 026E","E01008161","Total",839,805,34
"2011","Sheffield 027A","E01007883","Total",437,414,23
"2011","Sheffield 027B","E01007902","Total",809,792,17
"2011","Sheffield 027C","E01007905","Total",531,513,18
"2011","Sheffield 027D","E01007906","Total",672,631,41
"2011","Sheffield 028A","E01008064","Total",658,628,30
"2011","Sheffield 028B","E01008066","Total",465,456,9
"2011","Sheffield 028C","E01008069","Total",589,573,16
"2011","Sheffield 028D","E01008074","Total",576,561,15
"2011","Sheffield 029A","E01007951","Total",727,695,32
"2011","Sheffield 029B","E01007960","Total",710,694,16
"2011","Sheffield 029C","E01007962","Total",647,628,19
"2011","Sheffield 029D","E01008159","Total",787,762,25
"2011","Sheffield 030A","E01007866","Total",609,572,37
"2011","Sheffield 030B","E01007867","Total",663,634,29
"2011","Sheffield 030C","E01007868","Total",517,493,24
"2011","Sheffield 030D","E01008067","Total",505,472,33
"2011","Sheffield 030E","E01008073","Total",721,700,21
"2011","Sheffield 032A","E01007907","Total",597,585,12
"2011","Sheffield 032B","E01007908","Total",672,658,14
"2011","Sheffield 032C","E01007909","Total",908,869,39
"2011","Sheffield 032D","E01007911","Total",604,592,12
"2011","Sheffield 032E","E01008014","Total",696,686,10
"2011","Sheffield 032F","E01008016","Total",641,621,20
"2011","Sheffield 033A","E01007952","Total",660,644,16
"2011","Sheffield 033B","E01007953","Total",861,844,17
"2011","Sheffield 033C","E01007954","Total",660,650,10
"2011","Sheffield 033D","E01007961","Total",600,591,9
"2011","Sheffield 036A","E01007859","Total",487,459,28
"2011","Sheffield 036B","E01007860","Total",638,607,31
"2011","Sheffield 036C","E01007863","Total",690,660,30
"2011","Sheffield 036D","E01007864","Total",537,521,16
"2011","Sheffield 036E","E01008104","Total",544,511,33
"2011","Sheffield 037A","E01007910","Total",743,727,16
"2011","Sheffield 037B","E01007912","Total",716,696,20
"2011","Sheffield 037C","E01007971","Total",639,619,20
"2011","Sheffield 037D","E01007973","Total",654,640,14
"2011","Sheffield 038A","E01007858","Total",687,649,38
"2011","Sheffield 038B","E01007861","Total",697,676,21
"2011","Sheffield 038C","E01007862","Total",719,682,37
"2011","Sheffield 038D","E01007865","Total",797,762,35
"2011","Sheffield 039A","E01008011","Total",690,684,6
"2011","Sheffield 039B","E01008012","Total",976,964,12
"2011","Sheffield 039C","E01008013","Total",549,527,22
"2011","Sheffield 039D","E01008015","Total",745,741,4
"2011","Sheffield 039E","E01008017","Total",724,709,15
"2011","Sheffield 039F","E01008018","Total",566,553,13
"2011","Sheffield 040A","E01008105","Total",782,734,48
"2011","Sheffield 040C","E01008107","Total",667,630,37
"2011","Sheffield 040D","E01008111","Total",641,574,67
"2011","Sheffield 040E","E01033271","Total",832,778,54
"2011","Sheffield 040F","E01033272","Total",692,675,17
"2011","Sheffield 041A","E01007955","Total",552,538,14
"2011","Sheffield 041B","E01007956","Total",927,910,17
"2011","Sheffield 041C","E01007957","Total",659,645,14
"2011","Sheffield 041D","E01007958","Total",644,618,26
"2011","Sheffield 041E","E01007959","Total",606,595,11
"2011","Sheffield 042A","E01008108","Total",765,722,43
"2011","Sheffield 042B","E01008109","Total",764,727,37
"2011","Sheffield 042D","E01008112","Total",610,575,35
"2011","Sheffield 042E","E01008113","Total",692,648,44
"2011","Sheffield 042F","E01033273","Total",584,550,34
"2011","Sheffield 042G","E01033274","Total",592,569,23
"2011","Sheffield 043A","E01008095","Total",645,629,16
"2011","Sheffield 043B","E01008096","Total",954,939,15
"2011","Sheffield 043C","E01008097","Total",723,710,13
"2011","Sheffield 043D","E01008101","Total",846,823,23
"2011","Sheffield 044A","E01007965","Total",854,839,15
"2011","Sheffield 044B","E01007969","Total",640,626,14
"2011","Sheffield 044C","E01007972","Total",626,613,13
"2011","Sheffield 044D","E01007974","Total",577,561,16
"2011","Sheffield 045A","E01007963","Total",747,721,26
"2011","Sheffield 045B","E01007967","Total",799,780,19
"2011","Sheffield 045C","E01007999","Total",568,562,6
"2011","Sheffield 045D","E01008008","Total",764,741,23
"2011","Sheffield 045E","E01008009","Total",627,615,12
"2011","Sheffield 046A","E01008043","Total",702,684,18
"2011","Sheffield 046B","E01008044","Total",634,621,13
"2011","Sheffield 046C","E01008047","Total",632,607,25
"2011","Sheffield 046D","E01008048","Total",562,537,25
"2011","Sheffield 046E","E01008050","Total",629,593,36
"2011","Sheffield 047A","E01007931","Total",665,644,21
"2011","Sheffield 047B","E01007934","Total",606,590,16
"2011","Sheffield 047C","E01007935","Total",581,557,24
"2011","Sheffield 047D","E01007936","Total",691,662,29
"2011","Sheffield 047E","E01007937","Total",600,575,25
"2011","Sheffield 047F","E01007938","Total",600,591,9
"2011","Sheffield 048A","E01008098","Total",644,632,12
"2011","Sheffield 048B","E01008100","Total",560,551,9
"2011","Sheffield 048C","E01008102","Total",559,540,19
"2011","Sheffield 048D","E01008103","Total",610,598,12
"2011","Sheffield 049A","E01007964","Total",734,716,18
"2011","Sheffield 049B","E01007966","Total",673,652,21
"2011","Sheffield 049C","E01007968","Total",635,622,13
"2011","Sheffield 049D","E01007970","Total",1015,986,29
"2011","Sheffield 050A","E01008042","Total",683,643,40
"2011","Sheffield 050B","E01008045","Total",558,541,17
"2011","Sheffield 050C","E01008046","Total",732,704,28
"2011","Sheffield 050D","E01008049","Total",802,763,39
"2011","Sheffield 050E","E01008051","Total",679,642,37
"2011","Sheffield 050F","E01008052","Total",826,791,35
"2011","Sheffield 051A","E01007975","Total",834,814,20
"2011","Sheffield 051B","E01007976","Total",680,664,16
"2011","Sheffield 051C","E01007977","Total",865,849,16
"2011","Sheffield 051D","E01007979","Total",689,666,23
"2011","Sheffield 051E","E01008099","Total",673,654,19
"2011","Sheffield 052A","E01008000","Total",721,690,31
"2011","Sheffield 052B","E01008001","Total",681,662,19
"2011","Sheffield 052C","E01008004","Total",761,739,22
"2011","Sheffield 052D","E01008005","Total",724,711,13
"2011","Sheffield 052E","E01008010","Total",607,592,15
"2011","Sheffield 053A","E01007978","Total",791,759,32
"2011","Sheffield 053B","E01007980","Total",687,669,18
"2011","Sheffield 053C","E01007981","Total",629,602,27
"2011","Sheffield 053D","E01007983","Total",673,651,22
"2011","Sheffield 053E","E01007985","Total",681,662,19
"2011","Sheffield 054A","E01007982","Total",830,802,28
"2011","Sheffield 054B","E01008002","Total",704,695,9
"2011","Sheffield 054C","E01008003","Total",642,634,8
"2011","Sheffield 054D","E01008006","Total",649,637,12
"2011","Sheffield 055A","E01007927","Total",666,656,10
"2011","Sheffield 055B","E01007928","Total",726,706,20
"2011","Sheffield 055C","E01007929","Total",667,641,26
"2011","Sheffield 055D","E01007930","Total",547,543,4
"2011","Sheffield 055E","E01007932","Total",627,595,32
"2011","Sheffield 055F","E01007939","Total",674,653,21
"2011","Sheffield 056A","E01008028","Total",676,665,11
"2011","Sheffield 056B","E01008029","Total",606,598,8
"2011","Sheffield 056C","E01008032","Total",650,637,13
"2011","Sheffield 056D","E01008034","Total",690,684,6
"2011","Sheffield 059A","E01007828","Total",770,749,21
"2011","Sheffield 059B","E01007829","Total",752,731,21
"2011","Sheffield 059C","E01007831","Total",708,672,36
"2011","Sheffield 059D","E01007832","Total",703,686,17
"2011","Sheffield 059E","E01007986","Total",684,662,22
"2011","Sheffield 060A","E01008007","Total",840,826,14
"2011","Sheffield 060B","E01008075","Total",657,623,34
"2011","Sheffield 060C","E01008076","Total",653,625,28
"2011","Sheffield 060D","E01008077","Total",724,692,32
"2011","Sheffield 061A","E01008031","Total",640,630,10
"2011","Sheffield 061B","E01008033","Total",620,604,16
"2011","Sheffield 061C","E01008038","Total",755,742,13
"2011","Sheffield 061D","E01008040","Total",708,693,15
"2011","Sheffield 062A","E01007835","Total",628,618,10
"2011","Sheffield 062B","E01007836","Total",712,698,14
"2011","Sheffield 062C","E01007843","Total",793,776,17
"2011","Sheffield 062D","E01007846","Total",673,642,31
"2011","Sheffield 063A","E01008030","Total",571,558,13
"2011","Sheffield 063B","E01008035","Total",480,473,7
"2011","Sheffield 063C","E01008036","Total",619,601,18
"2011","Sheffield 063D","E01008041","Total",566,563,3
"2011","Sheffield 064A","E01007827","Total",721,701,20
"2011","Sheffield 064B","E01007830","Total",677,663,14
"2011","Sheffield 064C","E01007833","Total",817,795,22
"2011","Sheffield 064D","E01007984","Total",600,590,10
"2011","Sheffield 064E","E01008078","Total",679,650,29
"2011","Sheffield 064F","E01008079","Total",513,505,8
"2011","Sheffield 065A","E01008019","Total",749,735,14
"2011","Sheffield 065B","E01008020","Total",621,613,8
"2011","Sheffield 065C","E01008022","Total",789,773,16
"2011","Sheffield 065D","E01008027","Total",711,699,12
"2011","Sheffield 065E","E01008037","Total",734,720,14
"2011","Sheffield 065F","E01008039","Total",621,609,12
"2011","Sheffield 066A","E01007824","Total",577,562,15
"2011","Sheffield 066B","E01007825","Total",621,603,18
"2011","Sheffield 066C","E01007826","Total",593,582,11
"2011","Sheffield 066D","E01007834","Total",793,767,26
"2011","Sheffield 068A","E01007920","Total",706,688,18
"2011","Sheffield 068B","E01007921","Total",780,750,30
"2011","Sheffield 068C","E01007923","Total",832,813,19
"2011","Sheffield 068D","E01007925","Total",779,753,26
"2011","Sheffield 068E","E01007926","Total",744,708,36
"2011","Sheffield 068F","E01007933","Total",650,632,18
"2011","Sheffield 069A","E01007823","Total",843,820,23
"2011","Sheffield 069B","E01007916","Total",784,735,49
"2011","Sheffield 069C","E01007919","Total",821,784,37
"2011","Sheffield 069D","E01008080","Total",684,672,12
"2011","Sheffield 070A","E01008081","Total",825,795,30
"2011","Sheffield 070B","E01008082","Total",829,811,18
"2011","Sheffield 070C","E01008083","Total",743,709,34
"2011","Sheffield 070D","E01008084","Total",846,818,28
"2011","Sheffield 071A","E01007915","Total",621,609,12
"2011","Sheffield 071B","E01007917","Total",711,691,20
"2011","Sheffield 071C","E01007918","Total",788,752,36
"2011","Sheffield 071D","E01007922","Total",595,578,17
"2011","Sheffield 071E","E01007924","Total",719,702,17
"2011","Sheffield 072A","E01008021","Total",565,561,4
"2011","Sheffield 072B","E01008023","Total",950,924,26
"2011","Sheffield 072C","E01008024","Total",767,755,12
"2011","Sheffield 072D","E01008025","Total",880,860,20
"2011","Sheffield 072E","E01032585","Total",679,663,16
"2011","Sheffield 073A","E01033261","Total",795,718,77
"2011","Sheffield 073B","E01033262","Total",679,608,71
"2011","Sheffield 073C","E01033263","Total",671,626,45
"2011","Sheffield 073D","E01033264","Total",694,632,62
"2011","Sheffield 073E","E01033276","Total",755,686,69
"2011","Sheffield 074A","E01008114","Total",914,841,73
"2011","Sheffield 074B","E01008115","Total",553,538,15
"2011","Sheffield 074C","E01033265","Total",702,600,102
"2011","Sheffield 074D","E01033266","Total",674,609,65
"2011","Sheffield 074E","E01033267","Total",605,567,38
"2011","Sheffield 075A","E01007878","Total",661,649,12
"2011","Sheffield 075B","E01007879","Total",757,712,45
"2011","Sheffield 075C","E01007881","Total",708,675,33
"2011","Sheffield 075D","E01007882","Total",643,614,29
"2011","Sheffield 075E","E01007885","Total",710,692,18
"2011","Sheffield 075F","E01007886","Total",686,672,14
"2011","Sheffield 075G","E01033268","Total",1076,1054,22
"2011","Sheffield 076A","E01007838","Total",653,644,9
"2011","Sheffield 076B","E01007839","Total",685,667,18
"2011","Sheffield 076C","E01007841","Total",644,637,7
"2011","Sheffield 076D","E01007842","Total",696,685,11
"2011","Sheffield 076E","E01033278","Total",1196,1173,23
"2011","Sheffield 076F","E01033279","Total",1040,1014,26
"2011","Bradford 001A","E01010646","Total",653,623,30
"2011","Bradford 001B","E01010647","Total",528,509,19
"2011","Bradford 001C","E01010648","Total",648,619,29
"2011","Bradford 001D","E01010692","Total",905,828,77
"2011","Bradford 002A","E01010691","Total",672,645,27
"2011","Bradford 002B","E01010693","Total",580,560,20
"2011","Bradford 002C","E01010694","Total",643,621,22
"2011","Bradford 002D","E01010695","Total",913,843,70
"2011","Bradford 002E","E01010696","Total",618,600,18
"2011","Bradford 002F","E01010697","Total",690,659,31
"2011","Bradford 002G","E01010698","Total",893,847,46
"2011","Bradford 002H","E01010699","Total",797,781,16
"2011","Bradford 003A","E01010767","Total",652,633,19
"2011","Bradford 003B","E01010768","Total",655,637,18
"2011","Bradford 003C","E01010769","Total",750,730,20
"2011","Bradford 003D","E01010771","Total",483,478,5
"2011","Bradford 004A","E01010638","Total",670,653,17
"2011","Bradford 004B","E01010639","Total",894,844,50
"2011","Bradford 004C","E01010640","Total",850,796,54
"2011","Bradford 004D","E01010641","Total",631,622,9
"2011","Bradford 004E","E01010642","Total",761,738,23
"2011","Bradford 004F","E01010643","Total",667,620,47
"2011","Bradford 004G","E01010644","Total",679,635,44
"2011","Bradford 004H","E01010645","Total",554,542,12
"2011","Bradford 005A","E01010770","Total",638,619,19
"2011","Bradford 005B","E01010772","Total",512,501,11
"2011","Bradford 005C","E01010773","Total",648,619,29
"2011","Bradford 005D","E01010774","Total",774,736,38
"2011","Bradford 006A","E01010706","Total",734,709,25
"2011","Bradford 006B","E01010707","Total",784,756,28
"2011","Bradford 006C","E01010708","Total",675,654,21
"2011","Bradford 006D","E01010709","Total",1076,1054,22
"2011","Bradford 007A","E01010719","Total",523,495,28
"2011","Bradford 007B","E01010727","Total",772,743,29
"2011","Bradford 007C","E01010728","Total",566,528,38
"2011","Bradford 007D","E01010729","Total",502,483,19
"2011","Bradford 008A","E01010700","Total",496,450,46
"2011","Bradford 008B","E01010701","Total",478,430,48
"2011","Bradford 008C","E01010702","Total",552,510,42
"2011","Bradford 008D","E01010703","Total",683,663,20
"2011","Bradford 008E","E01010704","Total",643,611,32
"2011","Bradford 008F","E01010705","Total",695,674,21
"2011","Bradford 008G","E01010710","Total",989,884,105
"2011","Bradford 009A","E01010712","Total",531,487,44
"2011","Bradford 009B","E01010720","Total",639,618,21
"2011","Bradford 009C","E01010721","Total",667,622,45
"2011","Bradford 009D","E01010723","Total",544,489,55
"2011","Bradford 009E","E01010724","Total",631,611,20
"2011","Bradford 009F","E01010725","Total",721,696,25
"2011","Bradford 010A","E01010579","Total",647,633,14
"2011","Bradford 010B","E01010580","Total",1030,999,31
"2011","Bradford 010C","E01010764","Total",692,673,19
"2011","Bradford 010D","E01010765","Total",1119,1067,52
"2011","Bradford 010E","E01010766","Total",544,538,6
"2011","Bradford 011A","E01010711","Total",867,803,64
"2011","Bradford 011B","E01010713","Total",595,572,23
"2011","Bradford 011C","E01010714","Total",620,599,21
"2011","Bradford 011D","E01010716","Total",897,854,43
"2011","Bradford 012A","E01010715","Total",471,467,4
"2011","Bradford 012B","E01010717","Total",705,671,34
"2011","Bradford 012C","E01010718","Total",687,665,22
"2011","Bradford 012D","E01010726","Total",643,623,20
"2011","Bradford 012E","E01010859","Total",691,681,10
"2011","Bradford 013A","E01010573","Total",792,726,66
"2011","Bradford 013B","E01010574","Total",644,626,18
"2011","Bradford 013C","E01010575","Total",777,752,25
"2011","Bradford 013D","E01010577","Total",681,662,19
"2011","Bradford 014A","E01010722","Total",671,625,46
"2011","Bradford 014B","E01010860","Total",693,667,26
"2011","Bradford 014C","E01010862","Total",730,712,18
"2011","Bradford 014D","E01010863","Total",636,618,18
"2011","Bradford 015A","E01010578","Total",758,716,42
"2011","Bradford 015B","E01010581","Total",730,709,21
"2011","Bradford 015C","E01010582","Total",752,723,29
"2011","Bradford 015D","E01010584","Total",909,885,24
"2011","Bradford 015E","E01010585","Total",1074,986,88
"2011","Bradford 016A","E01010568","Total",839,822,17
"2011","Bradford 016B","E01010569","Total",857,826,31
"2011","Bradford 016C","E01010571","Total",870,828,42
"2011","Bradford 016D","E01010572","Total",659,639,20
"2011","Bradford 016E","E01010576","Total",664,651,13
"2011","Bradford 017A","E01010683","Total",726,705,21
"2011","Bradford 017B","E01010684","Total",685,661,24
"2011","Bradford 017C","E01010685","Total",743,724,19
"2011","Bradford 017D","E01010686","Total",727,714,13
"2011","Bradford 018A","E01010570","Total",568,550,18
"2011","Bradford 018B","E01010583","Total",800,770,30
"2011","Bradford 018C","E01010784","Total",784,760,24
"2011","Bradford 018D","E01010785","Total",873,807,66
"2011","Bradford 018E","E01010786","Total",572,548,24
"2011","Bradford 018F","E01010790","Total",609,597,12
"2011","Bradford 019A","E01010680","Total",910,892,18
"2011","Bradford 019B","E01010681","Total",512,502,10
"2011","Bradford 019C","E01010682","Total",672,659,13
"2011","Bradford 019D","E01010687","Total",743,732,11
"2011","Bradford 019E","E01010688","Total",852,831,21
"2011","Bradford 019F","E01010689","Total",794,767,27
"2011","Bradford 019G","E01010690","Total",845,820,25
"2011","Bradford 020B","E01010782","Total",920,882,38
"2011","Bradford 020C","E01010787","Total",715,696,19
"2011","Bradford 020D","E01010788","Total",623,585,38
"2011","Bradford 020E","E01033689","Total",850,727,123
"2011","Bradford 020F","E01033694","Total",557,518,39
"2011","Bradford 021A","E01010776","Total",701,677,24
"2011","Bradford 021B","E01010777","Total",789,730,59
"2011","Bradford 021C","E01010779","Total",656,640,16
"2011","Bradford 021D","E01010781","Total",587,574,13
"2011","Bradford 021E","E01010783","Total",687,664,23
"2011","Bradford 022A","E01010586","Total",714,700,14
"2011","Bradford 022B","E01010587","Total",838,813,25
"2011","Bradford 022C","E01010588","Total",705,682,23
"2011","Bradford 022D","E01010589","Total",666,645,21
"2011","Bradford 022E","E01010591","Total",734,691,43
"2011","Bradford 022F","E01010593","Total",775,752,23
"2011","Bradford 022G","E01010596","Total",643,617,26
"2011","Bradford 023A","E01010854","Total",873,828,45
"2011","Bradford 023B","E01010855","Total",801,752,49
"2011","Bradford 023C","E01010856","Total",836,763,73
"2011","Bradford 023D","E01010857","Total",733,697,36
"2011","Bradford 023E","E01010858","Total",726,694,32
"2011","Bradford 023F","E01010861","Total",776,742,34
"2011","Bradford 024A","E01010603","Total",645,631,14
"2011","Bradford 024B","E01010604","Total",740,723,17
"2011","Bradford 024C","E01010605","Total",631,621,10
"2011","Bradford 024D","E01010775","Total",709,697,12
"2011","Bradford 024E","E01010778","Total",783,755,28
"2011","Bradford 025A","E01010789","Total",703,665,38
"2011","Bradford 025B","E01010791","Total",559,523,36
"2011","Bradford 025C","E01010792","Total",615,570,45
"2011","Bradford 025D","E01010793","Total",585,549,36
"2011","Bradford 026A","E01010652","Total",756,739,17
"2011","Bradford 026B","E01010653","Total",707,686,21
"2011","Bradford 026C","E01010655","Total",542,529,13
"2011","Bradford 026D","E01010656","Total",618,608,10
"2011","Bradford 026E","E01010657","Total",696,673,23
"2011","Bradford 027A","E01010649","Total",612,605,7
"2011","Bradford 027B","E01010650","Total",579,575,4
"2011","Bradford 027C","E01010654","Total",583,582,1
"2011","Bradford 027D","E01010826","Total",532,521,11
"2011","Bradford 028A","E01010597","Total",594,581,13
"2011","Bradford 028B","E01010598","Total",675,668,7
"2011","Bradford 028C","E01010599","Total",478,473,5
"2011","Bradford 028D","E01010600","Total",501,493,8
"2011","Bradford 028E","E01010602","Total",620,609,11
"2011","Bradford 029A","E01010670","Total",473,458,15
"2011","Bradford 029B","E01010671","Total",506,483,23
"2011","Bradford 029C","E01010673","Total",534,501,33
"2011","Bradford 029D","E01010675","Total",657,622,35
"2011","Bradford 030A","E01010669","Total",661,640,21
"2011","Bradford 030B","E01010674","Total",528,509,19
"2011","Bradford 030C","E01010677","Total",663,638,25
"2011","Bradford 030D","E01010805","Total",495,473,22
"2011","Bradford 031A","E01010590","Total",827,766,61
"2011","Bradford 031B","E01010592","Total",690,670,20
"2011","Bradford 031C","E01010594","Total",715,686,29
"2011","Bradford 031D","E01010595","Total",846,795,51
"2011","Bradford 032A","E01010601","Total",740,735,5
"2011","Bradford 032B","E01010651","Total",628,621,7
"2011","Bradford 032C","E01010825","Total",527,522,5
"2011","Bradford 032D","E01010827","Total",550,526,24
"2011","Bradford 033A","E01010804","Total",512,485,27
"2011","Bradford 033B","E01010806","Total",520,486,34
"2011","Bradford 033C","E01010807","Total",786,742,44
"2011","Bradford 033D","E01010808","Total",571,539,32
"2011","Bradford 033E","E01010809","Total",523,481,42
"2011","Bradford 034A","E01010676","Total",529,513,16
"2011","Bradford 034B","E01010679","Total",518,495,23
"2011","Bradford 034C","E01010824","Total",755,720,35
"2011","Bradford 034D","E01010840","Total",525,501,24
"2011","Bradford 034E","E01010841","Total",483,471,12
"2011","Bradford 035A","E01010828","Total",757,742,15
"2011","Bradford 035B","E01010829","Total",611,602,9
"2011","Bradford 035C","E01010830","Total",677,631,46
"2011","Bradford 035D","E01010831","Total",583,558,25
"2011","Bradford 035E","E01010832","Total",468,462,6
"2011","Bradford 036A","E01010672","Total",537,522,15
"2011","Bradford 036B","E01010678","Total",567,556,11
"2011","Bradford 036C","E01010799","Total",684,649,35
"2011","Bradford 036D","E01010800","Total",748,710,38
"2011","Bradford 036E","E01010801","Total",664,616,48
"2011","Bradford 036F","E01010802","Total",683,632,51
"2011","Bradford 037A","E01010803","Total",606,538,68
"2011","Bradford 037B","E01010810","Total",555,531,24
"2011","Bradford 037C","E01010811","Total",573,552,21
"2011","Bradford 037D","E01010813","Total",582,531,51
"2011","Bradford 038A","E01010618","Total",535,510,25
"2011","Bradford 038B","E01010619","Total",540,521,19
"2011","Bradford 038C","E01010625","Total",530,499,31
"2011","Bradford 038D","E01010626","Total",514,495,19
"2011","Bradford 038E","E01010627","Total",557,536,21
"2011","Bradford 039A","E01010606","Total",642,609,33
"2011","Bradford 039B","E01010607","Total",636,594,42
"2011","Bradford 039C","E01010617","Total",612,595,17
"2011","Bradford 039E","E01010842","Total",608,595,13
"2011","Bradford 039G","E01033690","Total",731,694,37
"2011","Bradford 039H","E01033691","Total",723,620,103
"2011","Bradford 039I","E01033692","Total",628,595,33
"2011","Bradford 039J","E01033693","Total",692,659,33
"2011","Bradford 040A","E01010628","Total",702,669,33
"2011","Bradford 040B","E01010629","Total",647,619,28
"2011","Bradford 040C","E01010630","Total",632,606,26
"2011","Bradford 040D","E01010631","Total",571,550,21
"2011","Bradford 040E","E01010632","Total",549,500,49
"2011","Bradford 041A","E01010658","Total",625,598,27
"2011","Bradford 041B","E01010812","Total",684,642,42
"2011","Bradford 041C","E01010833","Total",553,523,30
"2011","Bradford 041D","E01010843","Total",467,453,14
"2011","Bradford 042A","E01010620","Total",574,517,57
"2011","Bradford 042B","E01010621","Total",544,528,16
"2011","Bradford 042C","E01010622","Total",648,627,21
"2011","Bradford 042D","E01010623","Total",552,529,23
"2011","Bradford 042E","E01010624","Total",640,602,38
"2011","Bradford 043A","E01010794","Total",821,775,46
"2011","Bradford 043B","E01010795","Total",806,754,52
"2011","Bradford 043C","E01010796","Total",721,687,34
"2011","Bradford 043D","E01010797","Total",553,540,13
"2011","Bradford 043E","E01010798","Total",754,692,62
"2011","Bradford 044A","E01010834","Total",811,676,135
"2011","Bradford 044B","E01010835","Total",830,780,50
"2011","Bradford 044C","E01010836","Total",582,524,58
"2011","Bradford 044D","E01010837","Total",544,515,29
"2011","Bradford 044E","E01010838","Total",532,492,40
"2011","Bradford 044F","E01010839","Total",556,491,65
"2011","Bradford 045A","E01010608","Total",512,492,20
"2011","Bradford 045B","E01010613","Total",688,635,53
"2011","Bradford 045C","E01010730","Total",814,801,13
"2011","Bradford 045D","E01010734","Total",551,516,35
"2011","Bradford 046A","E01010609","Total",716,686,30
"2011","Bradford 046B","E01010610","Total",736,702,34
"2011","Bradford 046C","E01010611","Total",918,878,40
"2011","Bradford 046D","E01010614","Total",586,558,28
"2011","Bradford 047A","E01010633","Total",652,624,28
"2011","Bradford 047B","E01010634","Total",602,586,16
"2011","Bradford 047C","E01010635","Total",677,664,13
"2011","Bradford 047D","E01010636","Total",755,746,9
"2011","Bradford 047E","E01010637","Total",554,532,22
"2011","Bradford 048A","E01010731","Total",765,702,63
"2011","Bradford 048B","E01010732","Total",711,692,19
"2011","Bradford 048C","E01010733","Total",755,701,54
"2011","Bradford 048D","E01010736","Total",734,715,19
"2011","Bradford 048E","E01010737","Total",552,522,30
"2011","Bradford 049A","E01010659","Total",619,600,19
"2011","Bradford 049D","E01010662","Total",504,487,17
"2011","Bradford 049E","E01010664","Total",546,528,18
"2011","Bradford 049G","E01010761","Total",702,683,19
"2011","Bradford 049H","E01033695","Total",715,701,14
"2011","Bradford 049I","E01033696","Total",671,652,19
"2011","Bradford 049J","E01033697","Total",840,791,49
"2011","Bradford 050A","E01010663","Total",684,638,46
"2011","Bradford 050B","E01010665","Total",630,602,28
"2011","Bradford 050C","E01010666","Total",704,662,42
"2011","Bradford 050D","E01010667","Total",643,614,29
"2011","Bradford 051A","E01010735","Total",519,507,12
"2011","Bradford 051B","E01010738","Total",582,556,26
"2011","Bradford 051C","E01010739","Total",645,614,31
"2011","Bradford 051D","E01010740","Total",548,538,10
"2011","Bradford 051E","E01010744","Total",499,480,19
"2011","Bradford 052A","E01010612","Total",622,576,46
"2011","Bradford 052B","E01010819","Total",683,651,32
"2011","Bradford 052C","E01010820","Total",631,604,27
"2011","Bradford 052D","E01010821","Total",851,812,39
"2011","Bradford 052E","E01010822","Total",557,549,8
"2011","Bradford 053A","E01010615","Total",587,566,21
"2011","Bradford 053B","E01010616","Total",602,588,14
"2011","Bradford 053C","E01010742","Total",647,608,39
"2011","Bradford 053D","E01010743","Total",698,676,22
"2011","Bradford 054A","E01010847","Total",705,674,31
"2011","Bradford 054B","E01010848","Total",671,650,21
"2011","Bradford 054C","E01010852","Total",684,663,21
"2011","Bradford 054D","E01010853","Total",517,506,11
"2011","Bradford 055A","E01010668","Total",533,516,17
"2011","Bradford 055B","E01010755","Total",694,671,23
"2011","Bradford 055C","E01010762","Total",625,601,24
"2011","Bradford 055D","E01010763","Total",638,621,17
"2011","Bradford 055E","E01010846","Total",872,849,23
"2011","Bradford 056A","E01010745","Total",649,618,31
"2011","Bradford 056B","E01010747","Total",659,644,15
"2011","Bradford 056C","E01010748","Total",679,670,9
"2011","Bradford 056D","E01010749","Total",632,614,18
"2011","Bradford 057A","E01010814","Total",850,797,53
"2011","Bradford 057B","E01010815","Total",920,873,47
"2011","Bradford 057C","E01010816","Total",777,758,19
"2011","Bradford 057D","E01010817","Total",902,881,21
"2011","Bradford 057E","E01010818","Total",721,691,30
"2011","Bradford 058A","E01010752","Total",863,818,45
"2011","Bradford 058B","E01010753","Total",616,597,19
"2011","Bradford 058C","E01010754","Total",688,662,26
"2011","Bradford 058D","E01010756","Total",623,604,19
"2011","Bradford 058E","E01010758","Total",490,477,13
"2011","Bradford 058F","E01010759","Total",681,660,21
"2011","Bradford 058G","E01010760","Total",616,605,11
"2011","Bradford 059A","E01010741","Total",675,656,19
"2011","Bradford 059B","E01010845","Total",862,848,14
"2011","Bradford 059C","E01010849","Total",618,605,13
"2011","Bradford 059D","E01010850","Total",518,507,11
"2011","Bradford 059E","E01010851","Total",674,662,12
"2011","Bradford 059F","E01010864","Total",533,526,7
"2011","Bradford 059G","E01010867","Total",585,581,4
"2011","Bradford 059H","E01010874","Total",530,512,18
"2011","Bradford 060A","E01010746","Total",693,684,9
"2011","Bradford 060B","E01010750","Total",706,693,13
"2011","Bradford 060C","E01010751","Total",684,676,8
"2011","Bradford 060D","E01010865","Total",745,709,36
"2011","Bradford 060E","E01010866","Total",638,607,31
"2011","Bradford 061A","E01010868","Total",726,700,26
"2011","Bradford 061B","E01010869","Total",770,742,28
"2011","Bradford 061C","E01010870","Total",709,684,25
"2011","Bradford 061D","E01010871","Total",798,756,42
"2011","Bradford 061E","E01010872","Total",677,656,21
"2011","Bradford 061F","E01010873","Total",521,509,12
"2011","Calderdale 001A","E01010911","Total",726,711,15
"2011","Calderdale 001B","E01010912","Total",702,688,14
"2011","Calderdale 001C","E01010913","Total",559,550,9
"2011","Calderdale 001D","E01010915","Total",585,576,9
"2011","Calderdale 002A","E01010914","Total",792,784,8
"2011","Calderdale 002B","E01010924","Total",717,643,74
"2011","Calderdale 002C","E01010925","Total",590,575,15
"2011","Calderdale 002D","E01010926","Total",450,439,11
"2011","Calderdale 003A","E01010931","Total",623,613,10
"2011","Calderdale 003B","E01010932","Total",691,679,12
"2011","Calderdale 003C","E01010933","Total",732,701,31
"2011","Calderdale 003D","E01010935","Total",714,691,23
"2011","Calderdale 003E","E01010936","Total",846,814,32
"2011","Calderdale 003F","E01010937","Total",702,685,17
"2011","Calderdale 004A","E01010881","Total",738,718,20
"2011","Calderdale 004B","E01010882","Total",677,649,28
"2011","Calderdale 004C","E01010883","Total",671,644,27
"2011","Calderdale 004D","E01010887","Total",767,710,57
"2011","Calderdale 004E","E01010888","Total",838,794,44
"2011","Calderdale 004F","E01010923","Total",836,795,41
"2011","Calderdale 005A","E01010916","Total",587,578,9
"2011","Calderdale 005B","E01010939","Total",726,712,14
"2011","Calderdale 005C","E01010941","Total",536,522,14
"2011","Calderdale 005D","E01010942","Total",785,773,12
"2011","Calderdale 005E","E01010944","Total",608,595,13
"2011","Calderdale 006A","E01010938","Total",633,613,20
"2011","Calderdale 006B","E01010940","Total",661,637,24
"2011","Calderdale 006C","E01010943","Total",620,603,17
"2011","Calderdale 006D","E01010961","Total",548,532,16
"2011","Calderdale 007A","E01010917","Total",913,862,51
"2011","Calderdale 007B","E01010918","Total",761,725,36
"2011","Calderdale 007C","E01010919","Total",812,772,40
"2011","Calderdale 007D","E01010920","Total",789,726,63
"2011","Calderdale 007E","E01010921","Total",734,720,14
"2011","Calderdale 008A","E01010934","Total",962,911,51
"2011","Calderdale 008D","E01010967","Total",844,786,58
"2011","Calderdale 008E","E01010994","Total",1184,1046,138
"2011","Calderdale 008F","E01032923","Total",1185,1126,59
"2011","Calderdale 009A","E01010927","Total",715,692,23
"2011","Calderdale 009B","E01010928","Total",631,616,15
"2011","Calderdale 009C","E01010997","Total",642,625,17
"2011","Calderdale 009D","E01010999","Total",651,637,14
"2011","Calderdale 010A","E01010929","Total",960,901,59
"2011","Calderdale 010B","E01010930","Total",755,737,18
"2011","Calderdale 010C","E01010998","Total",740,715,25
"2011","Calderdale 010D","E01011000","Total",638,604,34
"2011","Calderdale 011A","E01010904","Total",614,593,21
"2011","Calderdale 011B","E01010906","Total",611,593,18
"2011","Calderdale 011C","E01010907","Total",616,598,18
"2011","Calderdale 011D","E01010909","Total",747,713,34
"2011","Calderdale 012A","E01010960","Total",504,472,32
"2011","Calderdale 012B","E01010964","Total",643,585,58
"2011","Calderdale 012C","E01010965","Total",543,512,31
"2011","Calderdale 012D","E01010966","Total",555,517,38
"2011","Calderdale 012E","E01010995","Total",450,399,51
"2011","Calderdale 013A","E01010982","Total",641,597,44
"2011","Calderdale 013B","E01010983","Total",817,742,75
"2011","Calderdale 013C","E01010985","Total",662,630,32
"2011","Calderdale 013D","E01010986","Total",818,772,46
"2011","Calderdale 013E","E01010987","Total",802,767,35
"2011","Calderdale 013F","E01010988","Total",666,648,18
"2011","Calderdale 014A","E01010996","Total",469,429,40
"2011","Calderdale 014B","E01011001","Total",492,459,33
"2011","Calderdale 014C","E01011002","Total",680,637,43
"2011","Calderdale 014D","E01011003","Total",598,549,49
"2011","Calderdale 015A","E01010878","Total",948,896,52
"2011","Calderdale 015B","E01010879","Total",843,824,19
"2011","Calderdale 015C","E01010905","Total",784,760,24
"2011","Calderdale 015D","E01010908","Total",972,952,20
"2011","Calderdale 015E","E01010910","Total",584,573,11
"2011","Calderdale 016A","E01010969","Total",782,742,40
"2011","Calderdale 016B","E01010970","Total",910,872,38
"2011","Calderdale 016C","E01010974","Total",643,614,29
"2011","Calderdale 016D","E01010977","Total",682,674,8
"2011","Calderdale 017A","E01010975","Total",760,745,15
"2011","Calderdale 017B","E01010976","Total",797,779,18
"2011","Calderdale 017C","E01010978","Total",587,572,15
"2011","Calderdale 017D","E01010979","Total",893,838,55
"2011","Calderdale 017E","E01010980","Total",705,676,29
"2011","Calderdale 017F","E01010981","Total",732,691,41
"2011","Calderdale 018A","E01010989","Total",801,738,63
"2011","Calderdale 018B","E01010990","Total",760,728,32
"2011","Calderdale 018C","E01010991","Total",703,681,22
"2011","Calderdale 018D","E01010992","Total",789,773,16
"2011","Calderdale 018E","E01010993","Total",745,735,10
"2011","Calderdale 019A","E01010875","Total",790,779,11
"2011","Calderdale 019B","E01010876","Total",698,684,14
"2011","Calderdale 019C","E01010877","Total",830,772,58
"2011","Calderdale 019D","E01010880","Total",737,713,24
"2011","Calderdale 019E","E01010949","Total",785,741,44
"2011","Calderdale 020A","E01010922","Total",839,808,31
"2011","Calderdale 020B","E01010956","Total",710,685,25
"2011","Calderdale 020C","E01010958","Total",678,671,7
"2011","Calderdale 020D","E01010959","Total",727,717,10
"2011","Calderdale 021A","E01010968","Total",797,767,30
"2011","Calderdale 021B","E01010971","Total",846,820,26
"2011","Calderdale 021C","E01010972","Total",678,666,12
"2011","Calderdale 021D","E01010973","Total",789,777,12
"2011","Calderdale 022A","E01010884","Total",799,770,29
"2011","Calderdale 022B","E01010885","Total",688,654,34
"2011","Calderdale 022C","E01010886","Total",543,509,34
"2011","Calderdale 022D","E01010984","Total",628,579,49
"2011","Calderdale 023A","E01010946","Total",572,566,6
"2011","Calderdale 023B","E01010947","Total",666,639,27
"2011","Calderdale 023C","E01010950","Total",725,687,38
"2011","Calderdale 023D","E01010951","Total",691,664,27
"2011","Calderdale 024A","E01010891","Total",839,808,31
"2011","Calderdale 024B","E01010892","Total",749,738,11
"2011","Calderdale 024C","E01010895","Total",669,653,16
"2011","Calderdale 024D","E01010945","Total",691,671,20
"2011","Calderdale 024E","E01010948","Total",665,640,25
"2011","Calderdale 025A","E01010889","Total",925,887,38
"2011","Calderdale 025B","E01010890","Total",889,843,46
"2011","Calderdale 025C","E01010893","Total",635,618,17
"2011","Calderdale 025D","E01010894","Total",775,730,45
"2011","Calderdale 025E","E01010901","Total",731,717,14
"2011","Calderdale 025F","E01010903","Total",729,724,5
"2011","Calderdale 026A","E01010896","Total",678,665,13
"2011","Calderdale 026B","E01010897","Total",780,749,31
"2011","Calderdale 026C","E01010898","Total",822,800,22
"2011","Calderdale 026D","E01010899","Total",584,574,10
"2011","Calderdale 026E","E01010900","Total",675,662,13
"2011","Calderdale 026F","E01010902","Total",663,656,7
"2011","Calderdale 027A","E01010952","Total",766,716,50
"2011","Calderdale 027B","E01010953","Total",615,598,17
"2011","Calderdale 027C","E01010954","Total",987,958,29
"2011","Calderdale 027D","E01010955","Total",629,606,23
"2011","Calderdale 027E","E01010957","Total",674,640,34
"2011","Kirklees 001A","E01011051","Total",703,680,23
"2011","Kirklees 001B","E01011055","Total",574,547,27
"2011","Kirklees 001C","E01011056","Total",728,694,34
"2011","Kirklees 001D","E01011057","Total",649,617,32
"2011","Kirklees 001E","E01011058","Total",520,502,18
"2011","Kirklees 002A","E01011048","Total",916,859,57
"2011","Kirklees 002B","E01011049","Total",736,684,52
"2011","Kirklees 002C","E01011050","Total",634,620,14
"2011","Kirklees 002D","E01011052","Total",729,707,22
"2011","Kirklees 002E","E01011053","Total",644,623,21
"2011","Kirklees 002F","E01011059","Total",686,614,72
"2011","Kirklees 003A","E01011062","Total",823,732,91
"2011","Kirklees 003B","E01011064","Total",662,644,18
"2011","Kirklees 003C","E01011068","Total",737,718,19
"2011","Kirklees 003D","E01011069","Total",629,608,21
"2011","Kirklees 004A","E01011241","Total",663,646,17
"2011","Kirklees 004B","E01011242","Total",700,676,24
"2011","Kirklees 004C","E01011243","Total",773,727,46
"2011","Kirklees 004D","E01011244","Total",870,830,40
"2011","Kirklees 005A","E01011060","Total",814,789,25
"2011","Kirklees 005B","E01011061","Total",922,866,56
"2011","Kirklees 005C","E01011063","Total",1025,970,55
"2011","Kirklees 005D","E01011065","Total",723,693,30
"2011","Kirklees 005E","E01011066","Total",640,624,16
"2011","Kirklees 006A","E01011027","Total",521,498,23
"2011","Kirklees 006B","E01011028","Total",712,666,46
"2011","Kirklees 006C","E01011030","Total",601,574,27
"2011","Kirklees 006D","E01011031","Total",678,658,20
"2011","Kirklees 006E","E01011054","Total",598,580,18
"2011","Kirklees 007A","E01011013","Total",651,627,24
"2011","Kirklees 007B","E01011014","Total",646,607,39
"2011","Kirklees 007C","E01011023","Total",662,630,32
"2011","Kirklees 007D","E01011024","Total",703,663,40
"2011","Kirklees 008A","E01011067","Total",685,670,15
"2011","Kirklees 008B","E01011247","Total",665,648,17
"2011","Kirklees 008C","E01011249","Total",680,659,21
"2011","Kirklees 008D","E01011251","Total",729,703,26
"2011","Kirklees 009A","E01011245","Total",655,634,21
"2011","Kirklees 009B","E01011246","Total",648,621,27
"2011","Kirklees 009C","E01011248","Total",712,679,33
"2011","Kirklees 009D","E01011250","Total",900,846,54
"2011","Kirklees 010A","E01011015","Total",578,550,28
"2011","Kirklees 010B","E01011029","Total",727,677,50
"2011","Kirklees 010C","E01011032","Total",595,578,17
"2011","Kirklees 010D","E01011034","Total",485,469,16
"2011","Kirklees 011A","E01011157","Total",589,574,15
"2011","Kirklees 011B","E01011161","Total",551,528,23
"2011","Kirklees 011C","E01011163","Total",603,589,14
"2011","Kirklees 011D","E01011164","Total",715,695,20
"2011","Kirklees 011E","E01011165","Total",580,564,16
"2011","Kirklees 011F","E01011166","Total",709,658,51
"2011","Kirklees 011G","E01011167","Total",782,732,50
"2011","Kirklees 012A","E01011033","Total",689,667,22
"2011","Kirklees 012B","E01011035","Total",503,481,22
"2011","Kirklees 012C","E01011036","Total",609,586,23
"2011","Kirklees 012D","E01011037","Total",847,802,45
"2011","Kirklees 013A","E01011016","Total",584,541,43
"2011","Kirklees 013B","E01011017","Total",487,467,20
"2011","Kirklees 013C","E01011018","Total",452,433,19
"2011","Kirklees 013D","E01011019","Total",562,526,36
"2011","Kirklees 013E","E01011020","Total",467,446,21
"2011","Kirklees 014A","E01011021","Total",719,690,29
"2011","Kirklees 014B","E01011022","Total",616,597,19
"2011","Kirklees 014C","E01011126","Total",809,771,38
"2011","Kirklees 014D","E01011127","Total",609,590,19
"2011","Kirklees 015A","E01011156","Total",707,687,20
"2011","Kirklees 015B","E01011158","Total",761,716,45
"2011","Kirklees 015C","E01011159","Total",756,726,30
"2011","Kirklees 015D","E01011160","Total",567,553,14
"2011","Kirklees 015E","E01011162","Total",702,674,28
"2011","Kirklees 016A","E01011025","Total",602,582,20
"2011","Kirklees 016B","E01011026","Total",601,557,44
"2011","Kirklees 016C","E01011136","Total",627,592,35
"2011","Kirklees 016D","E01011137","Total",654,641,13
"2011","Kirklees 017A","E01011128","Total",838,788,50
"2011","Kirklees 017B","E01011130","Total",1039,949,90
"2011","Kirklees 017E","E01033542","Total",1058,995,63
"2011","Kirklees 018A","E01011121","Total",654,628,26
"2011","Kirklees 018B","E01011122","Total",500,493,7
"2011","Kirklees 018C","E01011123","Total",725,688,37
"2011","Kirklees 018D","E01011124","Total",875,850,25
"2011","Kirklees 018E","E01011125","Total",695,671,24
"2011","Kirklees 018F","E01011129","Total",521,501,20
"2011","Kirklees 019A","E01011138","Total",667,655,12
"2011","Kirklees 019B","E01011139","Total",479,462,17
"2011","Kirklees 019C","E01011140","Total",484,474,10
"2011","Kirklees 019D","E01011141","Total",553,535,18
"2011","Kirklees 020A","E01011132","Total",555,544,11
"2011","Kirklees 020B","E01011142","Total",708,686,22
"2011","Kirklees 020C","E01011217","Total",754,734,20
"2011","Kirklees 020D","E01011218","Total",763,733,30
"2011","Kirklees 021A","E01011216","Total",599,574,25
"2011","Kirklees 021B","E01011219","Total",719,683,36
"2011","Kirklees 021C","E01011220","Total",752,730,22
"2011","Kirklees 021D","E01011221","Total",745,722,23
"2011","Kirklees 022A","E01011046","Total",517,508,9
"2011","Kirklees 022B","E01011100","Total",738,719,19
"2011","Kirklees 022C","E01011102","Total",535,520,15
"2011","Kirklees 022D","E01011108","Total",674,644,30
"2011","Kirklees 023A","E01011133","Total",493,472,21
"2011","Kirklees 023B","E01011134","Total",644,600,44
"2011","Kirklees 023C","E01011143","Total",561,521,40
"2011","Kirklees 023D","E01011144","Total",538,498,40
"2011","Kirklees 023E","E01011260","Total",550,533,17
"2011","Kirklees 024A","E01011257","Total",521,498,23
"2011","Kirklees 024B","E01011258","Total",425,414,11
"2011","Kirklees 024C","E01011259","Total",604,583,21
"2011","Kirklees 024D","E01011261","Total",449,444,5
"2011","Kirklees 024E","E01011262","Total",555,536,19
"2011","Kirklees 024F","E01011263","Total",654,627,27
"2011","Kirklees 025A","E01011101","Total",762,737,25
"2011","Kirklees 025B","E01011103","Total",672,638,34
"2011","Kirklees 025C","E01011104","Total",810,785,25
"2011","Kirklees 025D","E01011105","Total",813,791,22
"2011","Kirklees 026A","E01011212","Total",821,796,25
"2011","Kirklees 026B","E01011213","Total",671,654,17
"2011","Kirklees 026C","E01011214","Total",711,690,21
"2011","Kirklees 026D","E01011215","Total",1034,974,60
"2011","Kirklees 027A","E01011039","Total",692,673,19
"2011","Kirklees 027B","E01011042","Total",663,639,24
"2011","Kirklees 027C","E01011047","Total",662,649,13
"2011","Kirklees 027D","E01011210","Total",850,812,38
"2011","Kirklees 028A","E01011252","Total",505,487,18
"2011","Kirklees 028B","E01011253","Total",520,513,7
"2011","Kirklees 028C","E01011254","Total",671,646,25
"2011","Kirklees 028D","E01011255","Total",639,625,14
"2011","Kirklees 028E","E01011256","Total",618,607,11
"2011","Kirklees 029A","E01011038","Total",712,684,28
"2011","Kirklees 029B","E01011041","Total",713,662,51
"2011","Kirklees 029C","E01011106","Total",717,680,37
"2011","Kirklees 029D","E01011107","Total",969,826,143
"2011","Kirklees 030A","E01011201","Total",959,883,76
"2011","Kirklees 030B","E01011203","Total",742,728,14
"2011","Kirklees 030C","E01011209","Total",657,640,17
"2011","Kirklees 030D","E01011211","Total",691,680,11
"2011","Kirklees 031A","E01011040","Total",708,682,26
"2011","Kirklees 031B","E01011043","Total",945,889,56
"2011","Kirklees 031C","E01011044","Total",560,543,17
"2011","Kirklees 031D","E01011045","Total",777,725,52
"2011","Kirklees 032A","E01011089","Total",615,603,12
"2011","Kirklees 032B","E01011091","Total",586,573,13
"2011","Kirklees 032C","E01011092","Total",583,568,15
"2011","Kirklees 032D","E01011200","Total",935,906,29
"2011","Kirklees 033A","E01011204","Total",572,545,27
"2011","Kirklees 033B","E01011206","Total",844,805,39
"2011","Kirklees 033C","E01011208","Total",829,773,56
"2011","Kirklees 033D","E01011240","Total",796,757,39
"2011","Kirklees 034A","E01011231","Total",791,751,40
"2011","Kirklees 034B","E01011236","Total",825,779,46
"2011","Kirklees 034C","E01011238","Total",820,751,69
"2011","Kirklees 034D","E01011239","Total",714,691,23
"2011","Kirklees 035A","E01011093","Total",695,681,14
"2011","Kirklees 035B","E01011094","Total",680,674,6
"2011","Kirklees 035C","E01011096","Total",637,615,22
"2011","Kirklees 035D","E01011098","Total",717,669,48
"2011","Kirklees 036A","E01011146","Total",658,638,20
"2011","Kirklees 036B","E01011151","Total",675,648,27
"2011","Kirklees 036C","E01011202","Total",732,710,22
"2011","Kirklees 036D","E01011205","Total",724,696,28
"2011","Kirklees 037A","E01011090","Total",697,677,20
"2011","Kirklees 037B","E01011095","Total",642,628,14
"2011","Kirklees 037C","E01011097","Total",718,697,21
"2011","Kirklees 037D","E01011099","Total",641,621,20
"2011","Kirklees 038A","E01011150","Total",742,694,48
"2011","Kirklees 038B","E01011155","Total",948,873,75
"2011","Kirklees 038C","E01011207","Total",626,606,20
"2011","Kirklees 038D","E01011234","Total",727,703,24
"2011","Kirklees 039A","E01011232","Total",701,675,26
"2011","Kirklees 039B","E01011233","Total",673,647,26
"2011","Kirklees 039C","E01011235","Total",944,869,75
"2011","Kirklees 039D","E01011237","Total",690,647,43
"2011","Kirklees 040A","E01011004","Total",725,710,15
"2011","Kirklees 040B","E01011006","Total",679,651,28
"2011","Kirklees 040C","E01011008","Total",678,642,36
"2011","Kirklees 040D","E01011012","Total",743,710,33
"2011","Kirklees 041A","E01011145","Total",654,637,17
"2011","Kirklees 041B","E01011147","Total",667,637,30
"2011","Kirklees 041C","E01011148","Total",792,761,31
"2011","Kirklees 041D","E01011152","Total",869,777,92
"2011","Kirklees 042A","E01011007","Total",736,659,77
"2011","Kirklees 042B","E01011223","Total",759,726,33
"2011","Kirklees 042C","E01011225","Total",778,733,45
"2011","Kirklees 042D","E01011229","Total",1003,936,67
"2011","Kirklees 043A","E01011080","Total",845,775,70
"2011","Kirklees 043B","E01011081","Total",796,729,67
"2011","Kirklees 043C","E01011082","Total",518,481,37
"2011","Kirklees 043D","E01011230","Total",607,559,48
"2011","Kirklees 044A","E01011005","Total",689,670,19
"2011","Kirklees 044B","E01011009","Total",651,612,39
"2011","Kirklees 044C","E01011010","Total",677,647,30
"2011","Kirklees 044D","E01011011","Total",733,695,38
"2011","Kirklees 045A","E01011077","Total",767,717,50
"2011","Kirklees 045B","E01011149","Total",990,923,67
"2011","Kirklees 045C","E01011153","Total",800,755,45
"2011","Kirklees 045D","E01011154","Total",647,633,14
"2011","Kirklees 046A","E01011191","Total",688,662,26
"2011","Kirklees 046B","E01011192","Total",734,712,22
"2011","Kirklees 046C","E01011193","Total",814,785,29
"2011","Kirklees 046D","E01011194","Total",615,599,16
"2011","Kirklees 047A","E01011079","Total",926,875,51
"2011","Kirklees 047B","E01011083","Total",732,713,19
"2011","Kirklees 047C","E01011084","Total",679,641,38
"2011","Kirklees 047D","E01011085","Total",717,691,26
"2011","Kirklees 048A","E01011224","Total",794,750,44
"2011","Kirklees 048B","E01011226","Total",671,649,22
"2011","Kirklees 048C","E01011227","Total",865,842,23
"2011","Kirklees 048D","E01011228","Total",664,642,22
"2011","Kirklees 049A","E01011071","Total",731,702,29
"2011","Kirklees 049B","E01011072","Total",680,662,18
"2011","Kirklees 049C","E01011073","Total",736,678,58
"2011","Kirklees 049D","E01011078","Total",887,834,53
"2011","Kirklees 050A","E01011086","Total",743,719,24
"2011","Kirklees 050B","E01011087","Total",805,769,36
"2011","Kirklees 050C","E01011088","Total",612,606,6
"2011","Kirklees 050D","E01011222","Total",1087,1003,84
"2011","Kirklees 051A","E01011190","Total",763,729,34
"2011","Kirklees 051B","E01011195","Total",463,447,16
"2011","Kirklees 051C","E01011196","Total",752,726,26
"2011","Kirklees 051D","E01011197","Total",704,667,37
"2011","Kirklees 052A","E01011070","Total",693,661,32
"2011","Kirklees 052B","E01011074","Total",866,832,34
"2011","Kirklees 052C","E01011075","Total",709,662,47
"2011","Kirklees 052D","E01011076","Total",647,626,21
"2011","Kirklees 053A","E01011169","Total",637,607,30
"2011","Kirklees 053B","E01011170","Total",767,740,27
"2011","Kirklees 053C","E01011171","Total",689,632,57
"2011","Kirklees 053D","E01011172","Total",554,531,23
"2011","Kirklees 053E","E01011173","Total",542,525,17
"2011","Kirklees 053F","E01011176","Total",603,577,26
"2011","Kirklees 054A","E01011109","Total",751,723,28
"2011","Kirklees 054B","E01011113","Total",762,740,22
"2011","Kirklees 054C","E01011114","Total",714,688,26
"2011","Kirklees 054D","E01011119","Total",666,660,6
"2011","Kirklees 055A","E01011168","Total",692,672,20
"2011","Kirklees 055B","E01011174","Total",750,704,46
"2011","Kirklees 055C","E01011175","Total",614,598,16
"2011","Kirklees 055D","E01011177","Total",761,722,39
"2011","Kirklees 055E","E01011178","Total",929,871,58
"2011","Kirklees 056A","E01011118","Total",658,634,24
"2011","Kirklees 056B","E01011120","Total",603,592,11
"2011","Kirklees 056C","E01011198","Total",695,662,33
"2011","Kirklees 056D","E01011199","Total",634,621,13
"2011","Kirklees 057A","E01011110","Total",616,584,32
"2011","Kirklees 057B","E01011111","Total",657,643,14
"2011","Kirklees 057C","E01011112","Total",681,667,14
"2011","Kirklees 057D","E01011115","Total",797,772,25
"2011","Kirklees 057E","E01011116","Total",705,691,14
"2011","Kirklees 057F","E01011117","Total",759,729,30
"2011","Kirklees 058A","E01011180","Total",826,799,27
"2011","Kirklees 058B","E01011182","Total",821,766,55
"2011","Kirklees 058C","E01011186","Total",717,678,39
"2011","Kirklees 058D","E01011188","Total",718,699,19
"2011","Kirklees 059A","E01011179","Total",788,765,23
"2011","Kirklees 059B","E01011181","Total",903,846,57
"2011","Kirklees 059C","E01011183","Total",828,793,35
"2011","Kirklees 059D","E01011184","Total",603,582,21
"2011","Kirklees 059E","E01011185","Total",732,701,31
"2011","Kirklees 059F","E01011187","Total",712,685,27
"2011","Kirklees 059G","E01011189","Total",709,675,34
"2011","Leeds 001A","E01011698","Total",641,634,7
"2011","Leeds 001B","E01011699","Total",588,583,5
"2011","Leeds 001C","E01011701","Total",534,529,5
"2011","Leeds 001D","E01011702","Total",498,483,15
"2011","Leeds 001E","E01011703","Total",568,556,12
"2011","Leeds 002A","E01011697","Total",575,558,17
"2011","Leeds 002B","E01011700","Total",523,500,23
"2011","Leeds 002C","E01011704","Total",1044,985,59
"2011","Leeds 002D","E01011705","Total",653,636,17
"2011","Leeds 003A","E01011581","Total",636,626,10
"2011","Leeds 003B","E01011582","Total",771,752,19
"2011","Leeds 003C","E01011583","Total",612,601,11
"2011","Leeds 003D","E01011584","Total",571,555,16
"2011","Leeds 004A","E01011569","Total",853,804,49
"2011","Leeds 004B","E01011571","Total",778,758,20
"2011","Leeds 004C","E01011572","Total",832,816,16
"2011","Leeds 004D","E01011573","Total",550,536,14
"2011","Leeds 004E","E01011574","Total",743,711,32
"2011","Leeds 005A","E01011707","Total",621,616,5
"2011","Leeds 005B","E01011709","Total",681,660,21
"2011","Leeds 005C","E01011710","Total",653,638,15
"2011","Leeds 005D","E01011711","Total",687,656,31
"2011","Leeds 005E","E01011712","Total",637,586,51
"2011","Leeds 006A","E01011561","Total",576,533,43
"2011","Leeds 006B","E01011696","Total",666,656,10
"2011","Leeds 006C","E01011706","Total",643,616,27
"2011","Leeds 006D","E01011708","Total",631,612,19
"2011","Leeds 006E","E01011713","Total",755,737,18
"2011","Leeds 007A","E01011570","Total",994,959,35
"2011","Leeds 007C","E01011576","Total",616,594,22
"2011","Leeds 007E","E01032503","Total",624,600,24
"2011","Leeds 007F","E01032504","Total",689,673,16
"2011","Leeds 008A","E01011266","Total",930,893,37
"2011","Leeds 008B","E01011270","Total",685,649,36
"2011","Leeds 008C","E01011279","Total",592,573,19
"2011","Leeds 008D","E01011280","Total",733,715,18
"2011","Leeds 009A","E01011265","Total",783,748,35
"2011","Leeds 009B","E01011267","Total",704,666,38
"2011","Leeds 009C","E01011271","Total",917,903,14
"2011","Leeds 009D","E01011272","Total",575,571,4
"2011","Leeds 010A","E01011268","Total",624,615,9
"2011","Leeds 010B","E01011273","Total",721,700,21
"2011","Leeds 010C","E01011274","Total",704,680,24
"2011","Leeds 010D","E01011275","Total",622,602,20
"2011","Leeds 011A","E01011264","Total",576,565,11
"2011","Leeds 011B","E01011269","Total",756,735,21
"2011","Leeds 011C","E01011276","Total",631,611,20
"2011","Leeds 011D","E01011578","Total",643,625,18
"2011","Leeds 012A","E01011554","Total",620,603,17
"2011","Leeds 012B","E01011562","Total",645,628,17
"2011","Leeds 012C","E01011563","Total",657,618,39
"2011","Leeds 012D","E01011564","Total",624,605,19
"2011","Leeds 012E","E01011567","Total",580,562,18
"2011","Leeds 013A","E01011376","Total",638,623,15
"2011","Leeds 013B","E01011377","Total",625,607,18
"2011","Leeds 013C","E01011378","Total",693,685,8
"2011","Leeds 013D","E01011382","Total",673,662,11
"2011","Leeds 014A","E01011277","Total",618,607,11
"2011","Leeds 014B","E01011278","Total",740,716,24
"2011","Leeds 014C","E01011579","Total",521,493,28
"2011","Leeds 014D","E01011580","Total",625,603,22
"2011","Leeds 015A","E01011556","Total",798,759,39
"2011","Leeds 015B","E01011557","Total",673,646,27
"2011","Leeds 015C","E01011565","Total",612,592,20
"2011","Leeds 015D","E01011566","Total",577,569,8
"2011","Leeds 015E","E01011568","Total",882,861,21
"2011","Leeds 016A","E01011380","Total",690,679,11
"2011","Leeds 016B","E01011381","Total",526,509,17
"2011","Leeds 016C","E01011385","Total",541,525,16
"2011","Leeds 016D","E01011386","Total",646,621,25
"2011","Leeds 017A","E01011379","Total",783,768,15
"2011","Leeds 017B","E01011384","Total",677,660,17
"2011","Leeds 017E","E01032501","Total",507,498,9
"2011","Leeds 017F","E01032502","Total",821,801,20
"2011","Leeds 018A","E01011555","Total",572,561,11
"2011","Leeds 018B","E01011558","Total",746,722,24
"2011","Leeds 018C","E01011559","Total",587,568,19
"2011","Leeds 018D","E01011560","Total",913,883,30
"2011","Leeds 019A","E01011383","Total",778,742,36
"2011","Leeds 019B","E01011388","Total",652,643,9
"2011","Leeds 019C","E01011684","Total",665,638,27
"2011","Leeds 019D","E01011695","Total",718,704,14
"2011","Leeds 020A","E01011650","Total",615,594,21
"2011","Leeds 020B","E01011651","Total",654,637,17
"2011","Leeds 020C","E01011653","Total",666,606,60
"2011","Leeds 020D","E01011655","Total",752,703,49
"2011","Leeds 021A","E01011455","Total",484,481,3
"2011","Leeds 021B","E01011456","Total",755,728,27
"2011","Leeds 021C","E01011459","Total",775,743,32
"2011","Leeds 021D","E01011461","Total",619,611,8
"2011","Leeds 022A","E01011311","Total",485,463,22
"2011","Leeds 022B","E01011649","Total",663,647,16
"2011","Leeds 022C","E01011715","Total",538,527,11
"2011","Leeds 022D","E01011719","Total",639,628,11
"2011","Leeds 023A","E01011509","Total",664,637,27
"2011","Leeds 023B","E01011511","Total",546,529,17
"2011","Leeds 023C","E01011512","Total",678,654,24
"2011","Leeds 023D","E01011515","Total",665,652,13
"2011","Leeds 023E","E01011516","Total",657,644,13
"2011","Leeds 024A","E01011508","Total",475,463,12
"2011","Leeds 024B","E01011517","Total",750,731,19
"2011","Leeds 024C","E01011652","Total",511,501,10
"2011","Leeds 024D","E01011654","Total",542,530,12
"2011","Leeds 025A","E01011505","Total",673,658,15
"2011","Leeds 025B","E01011506","Total",523,513,10
"2011","Leeds 025C","E01011507","Total",674,660,14
"2011","Leeds 025D","E01011510","Total",889,865,24
"2011","Leeds 025E","E01011514","Total",662,632,30
"2011","Leeds 027A","E01011452","Total",639,616,23
"2011","Leeds 027B","E01011454","Total",688,669,19
"2011","Leeds 027C","E01011457","Total",617,591,26
"2011","Leeds 027D","E01011458","Total",568,556,12
"2011","Leeds 027E","E01011465","Total",810,785,25
"2011","Leeds 028A","E01011453","Total",676,661,15
"2011","Leeds 028B","E01011460","Total",690,655,35
"2011","Leeds 028C","E01011462","Total",712,699,13
"2011","Leeds 028D","E01011463","Total",764,749,15
"2011","Leeds 028E","E01011464","Total",854,821,33
"2011","Leeds 029A","E01011714","Total",615,605,10
"2011","Leeds 029B","E01011716","Total",627,607,20
"2011","Leeds 029C","E01011717","Total",663,655,8
"2011","Leeds 029D","E01011718","Total",609,601,8
"2011","Leeds 029E","E01011720","Total",703,691,12
"2011","Leeds 030A","E01011296","Total",792,771,21
"2011","Leeds 030B","E01011297","Total",650,632,18
"2011","Leeds 030C","E01011309","Total",675,654,21
"2011","Leeds 030D","E01011310","Total",746,716,30
"2011","Leeds 031A","E01011513","Total",958,936,22
"2011","Leeds 031B","E01011688","Total",620,608,12
"2011","Leeds 031C","E01011689","Total",771,765,6
"2011","Leeds 031D","E01011691","Total",661,645,16
"2011","Leeds 032A","E01011504","Total",769,749,20
"2011","Leeds 032B","E01011641","Total",628,618,10
"2011","Leeds 032C","E01011642","Total",501,487,14
"2011","Leeds 032D","E01011645","Total",660,608,52
"2011","Leeds 033A","E01011484","Total",687,671,16
"2011","Leeds 033B","E01011485","Total",775,746,29
"2011","Leeds 033E","E01011686","Total",843,810,33
"2011","Leeds 033F","E01032493","Total",651,619,32
"2011","Leeds 033G","E01032494","Total",736,716,20
"2011","Leeds 034A","E01011350","Total",736,713,23
"2011","Leeds 034B","E01011351","Total",908,878,30
"2011","Leeds 034C","E01011352","Total",931,887,44
"2011","Leeds 034D","E01011353","Total",846,822,24
"2011","Leeds 035A","E01011656","Total",616,597,19
"2011","Leeds 035B","E01011657","Total",623,602,21
"2011","Leeds 035C","E01011659","Total",663,648,15
"2011","Leeds 035D","E01011661","Total",867,852,15
"2011","Leeds 037A","E01011643","Total",641,594,47
"2011","Leeds 037B","E01011644","Total",558,542,16
"2011","Leeds 037C","E01011646","Total",666,644,22
"2011","Leeds 037D","E01011647","Total",517,498,19
"2011","Leeds 037E","E01011648","Total",592,566,26
"2011","Leeds 038A","E01011354","Total",648,624,24
"2011","Leeds 038B","E01011355","Total",595,576,19
"2011","Leeds 038C","E01011357","Total",926,880,46
"2011","Leeds 038D","E01011450","Total",531,523,8
"2011","Leeds 039A","E01011588","Total",707,691,16
"2011","Leeds 039B","E01011589","Total",734,699,35
"2011","Leeds 039C","E01011590","Total",659,639,20
"2011","Leeds 039D","E01011592","Total",746,719,27
"2011","Leeds 039E","E01011593","Total",811,789,22
"2011","Leeds 040A","E01011421","Total",626,607,19
"2011","Leeds 040B","E01011425","Total",620,606,14
"2011","Leeds 040C","E01011658","Total",700,631,69
"2011","Leeds 040D","E01011660","Total",596,588,8
"2011","Leeds 040E","E01011662","Total",516,496,20
"2011","Leeds 041A","E01011721","Total",633,621,12
"2011","Leeds 041B","E01011722","Total",824,812,12
"2011","Leeds 041C","E01011723","Total",639,617,22
"2011","Leeds 041D","E01011724","Total",855,830,25
"2011","Leeds 042A","E01011356","Total",948,897,51
"2011","Leeds 042B","E01011358","Total",711,695,16
"2011","Leeds 042C","E01011359","Total",831,745,86
"2011","Leeds 042D","E01011360","Total",763,722,41
"2011","Leeds 042E","E01011361","Total",1144,1090,54
"2011","Leeds 044A","E01011435","Total",586,562,24
"2011","Leeds 044D","E01011440","Total",633,611,22
"2011","Leeds 044E","E01011441","Total",682,649,33
"2011","Leeds 044F","E01032945","Total",894,848,46
"2011","Leeds 045A","E01011477","Total",879,866,13
"2011","Leeds 045B","E01011480","Total",646,624,22
"2011","Leeds 045C","E01011488","Total",704,666,38
"2011","Leeds 045D","E01011489","Total",847,823,24
"2011","Leeds 046A","E01011324","Total",527,510,17
"2011","Leeds 046B","E01011325","Total",672,653,19
"2011","Leeds 046C","E01011326","Total",584,575,9
"2011","Leeds 046D","E01011332","Total",567,558,9
"2011","Leeds 047A","E01011423","Total",616,607,9
"2011","Leeds 047B","E01011424","Total",527,516,11
"2011","Leeds 047C","E01011427","Total",580,563,17
"2011","Leeds 047D","E01011431","Total",795,769,26
"2011","Leeds 048A","E01011422","Total",539,495,44
"2011","Leeds 048B","E01011426","Total",525,493,32
"2011","Leeds 048C","E01011428","Total",653,601,52
"2011","Leeds 048D","E01011429","Total",739,693,46
"2011","Leeds 050A","E01011663","Total",460,430,30
"2011","Leeds 050B","E01011664","Total",492,477,15
"2011","Leeds 050C","E01011665","Total",648,626,22
"2011","Leeds 050D","E01011667","Total",542,511,31
"2011","Leeds 051A","E01011323","Total",584,576,8
"2011","Leeds 051B","E01011329","Total",675,662,13
"2011","Leeds 051C","E01011330","Total",562,556,6
"2011","Leeds 051D","E01011333","Total",568,559,9
"2011","Leeds 052A","E01011327","Total",647,624,23
"2011","Leeds 052B","E01011328","Total",685,665,20
"2011","Leeds 052C","E01011335","Total",820,792,28
"2011","Leeds 052D","E01011591","Total",830,810,20
"2011","Leeds 053A","E01011430","Total",495,451,44
"2011","Leeds 053B","E01011432","Total",618,571,47
"2011","Leeds 053C","E01011433","Total",731,668,63
"2011","Leeds 053D","E01011434","Total",641,612,29
"2011","Leeds 054A","E01011445","Total",450,436,14
"2011","Leeds 054B","E01011446","Total",484,465,19
"2011","Leeds 054C","E01011447","Total",421,405,16
"2011","Leeds 054D","E01011448","Total",475,460,15
"2011","Leeds 054E","E01011449","Total",601,566,35
"2011","Leeds 055A","E01011670","Total",952,916,36
"2011","Leeds 055B","E01011671","Total",660,644,16
"2011","Leeds 055F","E01033002","Total",811,761,50
"2011","Leeds 055G","E01033003","Total",1226,1109,117
"2011","Leeds 055H","E01033005","Total",920,876,44
"2011","Leeds 056A","E01011478","Total",786,752,34
"2011","Leeds 056B","E01011479","Total",561,543,18
"2011","Leeds 056C","E01011481","Total",663,639,24
"2011","Leeds 056D","E01011482","Total",855,820,35
"2011","Leeds 056E","E01011483","Total",683,665,18
"2011","Leeds 057A","E01011406","Total",603,590,13
"2011","Leeds 057B","E01011407","Total",677,653,24
"2011","Leeds 057C","E01011408","Total",771,735,36
"2011","Leeds 057D","E01011409","Total",660,635,25
"2011","Leeds 057E","E01011410","Total",629,616,13
"2011","Leeds 057F","E01011412","Total",646,624,22
"2011","Leeds 058A","E01011331","Total",597,591,6
"2011","Leeds 058B","E01011334","Total",612,598,14
"2011","Leeds 058C","E01011336","Total",787,777,10
"2011","Leeds 058D","E01011337","Total",473,469,4
"2011","Leeds 059A","E01011281","Total",845,824,21
"2011","Leeds 059B","E01011282","Total",617,610,7
"2011","Leeds 059C","E01011283","Total",549,538,11
"2011","Leeds 059D","E01011286","Total",548,538,10
"2011","Leeds 059E","E01011295","Total",702,686,16
"2011","Leeds 060A","E01011339","Total",842,823,19
"2011","Leeds 060B","E01011340","Total",703,693,10
"2011","Leeds 060C","E01011342","Total",621,569,52
"2011","Leeds 060D","E01011346","Total",849,821,28
"2011","Leeds 061A","E01011341","Total",656,637,19
"2011","Leeds 061B","E01011343","Total",834,807,27
"2011","Leeds 061C","E01011345","Total",639,627,12
"2011","Leeds 061D","E01011666","Total",615,594,21
"2011","Leeds 062A","E01011585","Total",669,650,19
"2011","Leeds 062B","E01011587","Total",785,757,28
"2011","Leeds 062C","E01011594","Total",616,605,11
"2011","Leeds 062D","E01011596","Total",772,759,13
"2011","Leeds 062E","E01011598","Total",757,734,23
"2011","Leeds 063B","E01011678","Total",720,663,57
"2011","Leeds 063D","E01011681","Total",694,673,21
"2011","Leeds 063E","E01033006","Total",1096,1016,80
"2011","Leeds 064A","E01011338","Total",746,740,6
"2011","Leeds 064B","E01011673","Total",854,810,44
"2011","Leeds 064D","E01011677","Total",816,786,30
"2011","Leeds 064E","E01033031","Total",814,782,32
"2011","Leeds 064F","E01033035","Total",758,752,6
"2011","Leeds 065A","E01011344","Total",858,824,34
"2011","Leeds 065B","E01011347","Total",803,776,27
"2011","Leeds 065C","E01011348","Total",652,636,16
"2011","Leeds 065D","E01011349","Total",971,962,9
"2011","Leeds 066A","E01011586","Total",631,597,34
"2011","Leeds 066B","E01011595","Total",650,639,11
"2011","Leeds 066C","E01011597","Total",591,557,34
"2011","Leeds 066D","E01011599","Total",664,647,17
"2011","Leeds 067B","E01011287","Total",609,599,10
"2011","Leeds 067G","E01032499","Total",710,702,8
"2011","Leeds 067H","E01032500","Total",629,568,61
"2011","Leeds 067I","E01032606","Total",916,906,10
"2011","Leeds 067J","E01032607","Total",606,547,59
"2011","Leeds 067K","E01032608","Total",565,500,65
"2011","Leeds 068A","E01011608","Total",596,583,13
"2011","Leeds 068B","E01011609","Total",677,668,9
"2011","Leeds 068C","E01011610","Total",628,616,12
"2011","Leeds 068D","E01011611","Total",615,603,12
"2011","Leeds 068E","E01011614","Total",838,807,31
"2011","Leeds 069A","E01011413","Total",603,584,19
"2011","Leeds 069B","E01011415","Total",753,718,35
"2011","Leeds 069C","E01011416","Total",625,606,19
"2011","Leeds 069D","E01011417","Total",754,724,30
"2011","Leeds 069E","E01011420","Total",635,624,11
"2011","Leeds 070A","E01011615","Total",670,639,31
"2011","Leeds 070B","E01011617","Total",686,679,7
"2011","Leeds 070C","E01011618","Total",756,725,31
"2011","Leeds 070D","E01011621","Total",599,588,11
"2011","Leeds 071A","E01011284","Total",972,878,94
"2011","Leeds 071B","E01011292","Total",867,823,44
"2011","Leeds 071C","E01011293","Total",773,743,30
"2011","Leeds 071D","E01011294","Total",477,462,15
"2011","Leeds 071E","E01011363","Total",757,735,22
"2011","Leeds 072A","E01011616","Total",728,680,48
"2011","Leeds 072B","E01011620","Total",497,490,7
"2011","Leeds 072C","E01011622","Total",679,657,22
"2011","Leeds 072D","E01011624","Total",719,714,5
"2011","Leeds 073A","E01011411","Total",670,665,5
"2011","Leeds 073B","E01011414","Total",640,623,17
"2011","Leeds 073C","E01011418","Total",617,612,5
"2011","Leeds 073D","E01011419","Total",499,496,3
"2011","Leeds 074A","E01011396","Total",818,800,18
"2011","Leeds 074B","E01011399","Total",641,623,18
"2011","Leeds 074C","E01011400","Total",613,597,16
"2011","Leeds 074D","E01011403","Total",637,613,24
"2011","Leeds 075B","E01011623","Total",731,703,28
"2011","Leeds 075C","E01011625","Total",754,698,56
"2011","Leeds 075D","E01011626","Total",992,949,43
"2011","Leeds 075E","E01033021","Total",750,697,53
"2011","Leeds 075F","E01033033","Total",760,740,20
"2011","Leeds 075G","E01033034","Total",678,645,33
"2011","Leeds 076A","E01011602","Total",767,743,24
"2011","Leeds 076B","E01011603","Total",673,658,15
"2011","Leeds 076C","E01011605","Total",659,636,23
"2011","Leeds 076D","E01011606","Total",667,642,25
"2011","Leeds 076E","E01011613","Total",560,549,11
"2011","Leeds 077A","E01011397","Total",603,602,1
"2011","Leeds 077B","E01011398","Total",503,498,5
"2011","Leeds 077C","E01011401","Total",610,601,9
"2011","Leeds 077D","E01011404","Total",528,522,6
"2011","Leeds 077E","E01011405","Total",641,627,14
"2011","Leeds 078A","E01011725","Total",708,699,9
"2011","Leeds 078B","E01011729","Total",765,741,24
"2011","Leeds 078C","E01011730","Total",689,657,32
"2011","Leeds 078D","E01011735","Total",752,738,14
"2011","Leeds 079A","E01011600","Total",687,671,16
"2011","Leeds 079B","E01011601","Total",642,624,18
"2011","Leeds 079C","E01011604","Total",618,601,17
"2011","Leeds 079D","E01011607","Total",707,685,22
"2011","Leeds 079E","E01011612","Total",713,687,26
"2011","Leeds 080A","E01011726","Total",644,634,10
"2011","Leeds 080B","E01011727","Total",691,674,17
"2011","Leeds 080C","E01011728","Total",642,626,16
"2011","Leeds 080D","E01011739","Total",713,699,14
"2011","Leeds 081A","E01011362","Total",1007,974,33
"2011","Leeds 081B","E01011731","Total",619,609,10
"2011","Leeds 081C","E01011732","Total",802,777,25
"2011","Leeds 081D","E01011733","Total",732,691,41
"2011","Leeds 082A","E01011366","Total",816,757,59
"2011","Leeds 082C","E01011368","Total",724,611,113
"2011","Leeds 082D","E01011370","Total",771,698,73
"2011","Leeds 082E","E01033013","Total",722,647,75
"2011","Leeds 082F","E01033032","Total",861,789,72
"2011","Leeds 083A","E01011734","Total",1055,1011,44
"2011","Leeds 083B","E01011736","Total",666,648,18
"2011","Leeds 083C","E01011737","Total",806,760,46
"2011","Leeds 083D","E01011738","Total",642,632,10
"2011","Leeds 085A","E01011364","Total",857,785,72
"2011","Leeds 085B","E01011371","Total",778,728,50
"2011","Leeds 085C","E01011373","Total",619,574,45
"2011","Leeds 085D","E01011374","Total",631,595,36
"2011","Leeds 086A","E01011312","Total",766,669,97
"2011","Leeds 086B","E01011316","Total",826,720,106
"2011","Leeds 086C","E01011372","Total",568,521,47
"2011","Leeds 086D","E01011375","Total",792,689,103
"2011","Leeds 087A","E01011390","Total",630,612,18
"2011","Leeds 087B","E01011391","Total",739,726,13
"2011","Leeds 087C","E01011392","Total",663,643,20
"2011","Leeds 087D","E01011402","Total",841,813,28
"2011","Leeds 088A","E01011298","Total",683,675,8
"2011","Leeds 088B","E01011299","Total",1003,947,56
"2011","Leeds 088C","E01011302","Total",633,619,14
"2011","Leeds 088D","E01011303","Total",498,486,12
"2011","Leeds 089A","E01011300","Total",626,614,12
"2011","Leeds 089B","E01011301","Total",556,547,9
"2011","Leeds 089C","E01011304","Total",726,699,27
"2011","Leeds 089D","E01011305","Total",650,634,16
"2011","Leeds 089E","E01011306","Total",555,544,11
"2011","Leeds 090A","E01011315","Total",681,646,35
"2011","Leeds 090B","E01011317","Total",907,856,51
"2011","Leeds 090C","E01011318","Total",665,637,28
"2011","Leeds 090D","E01011321","Total",667,637,30
"2011","Leeds 090E","E01011369","Total",769,727,42
"2011","Leeds 091A","E01011313","Total",681,649,32
"2011","Leeds 091B","E01011314","Total",708,674,34
"2011","Leeds 091C","E01011319","Total",649,624,25
"2011","Leeds 091D","E01011320","Total",698,679,19
"2011","Leeds 091E","E01011322","Total",690,673,17
"2011","Leeds 092A","E01011471","Total",666,636,30
"2011","Leeds 092B","E01011472","Total",723,700,23
"2011","Leeds 092C","E01011473","Total",650,632,18
"2011","Leeds 092D","E01011474","Total",653,641,12
"2011","Leeds 093A","E01011518","Total",979,957,22
"2011","Leeds 093B","E01011524","Total",554,540,14
"2011","Leeds 093C","E01011526","Total",502,489,13
"2011","Leeds 093D","E01011531","Total",683,676,7
"2011","Leeds 094A","E01011466","Total",665,654,11
"2011","Leeds 094B","E01011469","Total",651,641,10
"2011","Leeds 094C","E01011475","Total",703,690,13
"2011","Leeds 094D","E01011476","Total",511,497,14
"2011","Leeds 095A","E01011519","Total",660,648,12
"2011","Leeds 095B","E01011522","Total",608,589,19
"2011","Leeds 095C","E01011525","Total",723,702,21
"2011","Leeds 095D","E01011528","Total",630,622,8
"2011","Leeds 095E","E01011532","Total",719,710,9
"2011","Leeds 096A","E01011520","Total",671,654,17
"2011","Leeds 096B","E01011521","Total",942,908,34
"2011","Leeds 096C","E01011523","Total",797,771,26
"2011","Leeds 096D","E01011527","Total",791,772,19
"2011","Leeds 096E","E01011529","Total",600,580,20
"2011","Leeds 097B","E01011635","Total",720,705,15
"2011","Leeds 097C","E01011637","Total",748,735,13
"2011","Leeds 097D","E01011638","Total",625,617,8
"2011","Leeds 097F","E01032487","Total",455,448,7
"2011","Leeds 097G","E01032488","Total",741,735,6
"2011","Leeds 098A","E01011627","Total",604,592,12
"2011","Leeds 098B","E01011628","Total",607,597,10
"2011","Leeds 098C","E01011629","Total",616,605,11
"2011","Leeds 098D","E01011632","Total",618,605,13
"2011","Leeds 098E","E01011633","Total",640,622,18
"2011","Leeds 099A","E01011490","Total",1217,1178,39
"2011","Leeds 099C","E01011502","Total",603,595,8
"2011","Leeds 099E","E01032497","Total",672,640,32
"2011","Leeds 099F","E01032498","Total",725,697,28
"2011","Leeds 100A","E01011496","Total",619,606,13
"2011","Leeds 100B","E01011630","Total",901,886,15
"2011","Leeds 100C","E01011634","Total",680,664,16
"2011","Leeds 100D","E01011636","Total",751,722,29
"2011","Leeds 100E","E01011639","Total",653,645,8
"2011","Leeds 101A","E01011491","Total",622,608,14
"2011","Leeds 101B","E01011492","Total",573,553,20
"2011","Leeds 101C","E01011493","Total",658,644,14
"2011","Leeds 101D","E01011494","Total",561,541,20
"2011","Leeds 101E","E01011497","Total",688,671,17
"2011","Leeds 102B","E01011540","Total",658,641,17
"2011","Leeds 102F","E01032489","Total",924,894,30
"2011","Leeds 102G","E01032490","Total",584,570,14
"2011","Leeds 102H","E01032491","Total",494,489,5
"2011","Leeds 102I","E01032492","Total",1048,997,51
"2011","Leeds 103A","E01011307","Total",628,610,18
"2011","Leeds 103B","E01011308","Total",666,655,11
"2011","Leeds 103C","E01011393","Total",719,693,26
"2011","Leeds 103D","E01011394","Total",509,497,12
"2011","Leeds 103E","E01011395","Total",480,464,16
"2011","Leeds 104A","E01011533","Total",713,687,26
"2011","Leeds 104B","E01011541","Total",1068,1010,58
"2011","Leeds 104C","E01011545","Total",680,651,29
"2011","Leeds 104D","E01011547","Total",864,834,30
"2011","Leeds 105C","E01011499","Total",1092,1053,39
"2011","Leeds 105D","E01011500","Total",718,689,29
"2011","Leeds 105E","E01032495","Total",945,922,23
"2011","Leeds 105F","E01032496","Total",895,878,17
"2011","Leeds 106A","E01011530","Total",662,651,11
"2011","Leeds 106B","E01011534","Total",713,684,29
"2011","Leeds 106C","E01011546","Total",780,743,37
"2011","Leeds 106D","E01011548","Total",657,639,18
"2011","Leeds 106E","E01011550","Total",569,552,17
"2011","Leeds 107A","E01011537","Total",976,947,29
"2011","Leeds 107B","E01011538","Total",680,662,18
"2011","Leeds 107C","E01011551","Total",663,647,16
"2011","Leeds 107D","E01011552","Total",588,575,13
"2011","Leeds 108A","E01011535","Total",674,658,16
"2011","Leeds 108B","E01011536","Total",674,660,14
"2011","Leeds 108C","E01011549","Total",525,512,13
"2011","Leeds 108D","E01011553","Total",624,615,9
"2011","Leeds 109A","E01011685","Total",821,777,44
"2011","Leeds 109B","E01011687","Total",599,574,25
"2011","Leeds 109C","E01011690","Total",706,661,45
"2011","Leeds 109D","E01011692","Total",694,666,28
"2011","Leeds 109E","E01011693","Total",775,725,50
"2011","Leeds 109F","E01011694","Total",650,615,35
"2011","Leeds 109G","E01032876","Total",550,533,17
"2011","Leeds 110A","E01011442","Total",569,543,26
"2011","Leeds 110B","E01011443","Total",505,479,26
"2011","Leeds 110C","E01011444","Total",615,586,29
"2011","Leeds 110D","E01011451","Total",486,466,20
"2011","Leeds 110E","E01011668","Total",535,517,18
"2011","Leeds 110F","E01011669","Total",568,518,50
"2011","Leeds 110G","E01032946","Total",809,778,31
"2011","Leeds 111A","E01033008","Total",804,704,100
"2011","Leeds 111B","E01033010","Total",760,690,70
"2011","Leeds 111C","E01033011","Total",862,761,101
"2011","Leeds 111D","E01033015","Total",873,705,168
"2011","Leeds 111E","E01033016","Total",825,709,116
"2011","Leeds 112A","E01011467","Total",688,647,41
"2011","Leeds 112B","E01011468","Total",768,743,25
"2011","Leeds 112C","E01011470","Total",624,607,17
"2011","Leeds 112D","E01033018","Total",790,729,61
"2011","Leeds 112E","E01033019","Total",817,766,51
"2011","Wakefield 001A","E01011740","Total",669,660,9
"2011","Wakefield 001B","E01011741","Total",640,636,4
"2011","Wakefield 001C","E01011742","Total",735,716,19
"2011","Wakefield 001D","E01011745","Total",719,697,22
"2011","Wakefield 001E","E01011746","Total",574,564,10
"2011","Wakefield 002A","E01011752","Total",779,722,57
"2011","Wakefield 002B","E01011753","Total",671,627,44
"2011","Wakefield 002C","E01011756","Total",773,758,15
"2011","Wakefield 002D","E01011760","Total",877,795,82
"2011","Wakefield 002E","E01011762","Total",792,737,55
"2011","Wakefield 003A","E01011743","Total",608,597,11
"2011","Wakefield 003B","E01011744","Total",680,669,11
"2011","Wakefield 003C","E01011747","Total",761,726,35
"2011","Wakefield 003D","E01011750","Total",619,603,16
"2011","Wakefield 003E","E01011754","Total",653,630,23
"2011","Wakefield 004A","E01011757","Total",764,744,20
"2011","Wakefield 004B","E01011759","Total",850,831,19
"2011","Wakefield 004C","E01011761","Total",865,792,73
"2011","Wakefield 004D","E01011763","Total",785,744,41
"2011","Wakefield 004E","E01011764","Total",740,714,26
"2011","Wakefield 005A","E01011748","Total",680,656,24
"2011","Wakefield 005B","E01011749","Total",1030,969,61
"2011","Wakefield 005C","E01011751","Total",533,517,16
"2011","Wakefield 005D","E01011755","Total",697,677,20
"2011","Wakefield 006A","E01011873","Total",702,679,23
"2011","Wakefield 006B","E01011877","Total",553,544,9
"2011","Wakefield 006C","E01011894","Total",552,543,9
"2011","Wakefield 006D","E01011895","Total",597,587,10
"2011","Wakefield 007A","E01011875","Total",686,676,10
"2011","Wakefield 007B","E01011876","Total",705,653,52
"2011","Wakefield 007C","E01011878","Total",690,668,22
"2011","Wakefield 007D","E01011880","Total",691,660,31
"2011","Wakefield 008A","E01011881","Total",672,660,12
"2011","Wakefield 008B","E01011887","Total",513,498,15
"2011","Wakefield 008C","E01011893","Total",588,574,14
"2011","Wakefield 008D","E01011896","Total",648,627,21
"2011","Wakefield 008E","E01011897","Total",725,698,27
"2011","Wakefield 009A","E01011874","Total",679,665,14
"2011","Wakefield 009B","E01011879","Total",676,637,39
"2011","Wakefield 009C","E01011882","Total",649,641,8
"2011","Wakefield 009D","E01011883","Total",668,642,26
"2011","Wakefield 010A","E01011805","Total",733,707,26
"2011","Wakefield 010B","E01011807","Total",681,662,19
"2011","Wakefield 010C","E01011808","Total",819,770,49
"2011","Wakefield 010D","E01011810","Total",588,582,6
"2011","Wakefield 011A","E01011803","Total",606,583,23
"2011","Wakefield 011B","E01011804","Total",731,708,23
"2011","Wakefield 011C","E01011806","Total",680,664,16
"2011","Wakefield 011D","E01011809","Total",760,736,24
"2011","Wakefield 011E","E01011811","Total",696,661,35
"2011","Wakefield 012A","E01011835","Total",658,640,18
"2011","Wakefield 012B","E01011836","Total",588,576,12
"2011","Wakefield 012C","E01011839","Total",659,642,17
"2011","Wakefield 012D","E01011843","Total",667,643,24
"2011","Wakefield 012E","E01011844","Total",738,729,9
"2011","Wakefield 013A","E01011758","Total",683,614,69
"2011","Wakefield 013B","E01011812","Total",1027,1010,17
"2011","Wakefield 013C","E01011820","Total",666,636,30
"2011","Wakefield 013D","E01011821","Total",634,599,35
"2011","Wakefield 014A","E01011885","Total",608,597,11
"2011","Wakefield 014B","E01011886","Total",666,649,17
"2011","Wakefield 014C","E01011888","Total",613,598,15
"2011","Wakefield 014D","E01011890","Total",500,489,11
"2011","Wakefield 014E","E01011891","Total",731,716,15
"2011","Wakefield 015A","E01011834","Total",622,613,9
"2011","Wakefield 015B","E01011837","Total",670,613,57
"2011","Wakefield 015C","E01011838","Total",1192,1102,90
"2011","Wakefield 015D","E01011841","Total",738,706,32
"2011","Wakefield 015E","E01011842","Total",712,689,23
"2011","Wakefield 016A","E01011813","Total",764,700,64
"2011","Wakefield 016B","E01011814","Total",856,803,53
"2011","Wakefield 016C","E01011815","Total",723,685,38
"2011","Wakefield 016D","E01011816","Total",662,630,32
"2011","Wakefield 016E","E01011819","Total",762,717,45
"2011","Wakefield 016F","E01011822","Total",671,636,35
"2011","Wakefield 017A","E01011884","Total",1012,961,51
"2011","Wakefield 017B","E01011912","Total",868,687,181
"2011","Wakefield 017C","E01011913","Total",614,546,68
"2011","Wakefield 017D","E01011916","Total",1352,1205,147
"2011","Wakefield 018A","E01011840","Total",727,685,42
"2011","Wakefield 018B","E01011850","Total",648,628,20
"2011","Wakefield 018C","E01011852","Total",672,651,21
"2011","Wakefield 018D","E01011853","Total",593,588,5
"2011","Wakefield 019A","E01011920","Total",807,702,105
"2011","Wakefield 019B","E01011923","Total",768,714,54
"2011","Wakefield 019C","E01011924","Total",685,655,30
"2011","Wakefield 019D","E01011925","Total",677,667,10
"2011","Wakefield 020A","E01011909","Total",612,595,17
"2011","Wakefield 020B","E01011910","Total",783,730,53
"2011","Wakefield 020C","E01011911","Total",657,629,28
"2011","Wakefield 020D","E01011914","Total",710,667,43
"2011","Wakefield 020E","E01011915","Total",671,631,40
"2011","Wakefield 021A","E01011823","Total",637,619,18
"2011","Wakefield 021B","E01011824","Total",633,620,13
"2011","Wakefield 021C","E01011825","Total",792,771,21
"2011","Wakefield 021D","E01011826","Total",605,590,15
"2011","Wakefield 021E","E01011827","Total",534,526,8
"2011","Wakefield 021F","E01011828","Total",662,631,31
"2011","Wakefield 022A","E01011889","Total",514,502,12
"2011","Wakefield 022B","E01011892","Total",803,779,24
"2011","Wakefield 022C","E01011919","Total",865,832,33
"2011","Wakefield 022D","E01011921","Total",643,608,35
"2011","Wakefield 022E","E01011926","Total",674,645,29
"2011","Wakefield 022F","E01011927","Total",595,568,27
"2011","Wakefield 023A","E01011845","Total",636,626,10
"2011","Wakefield 023B","E01011846","Total",617,594,23
"2011","Wakefield 023C","E01011847","Total",636,615,21
"2011","Wakefield 023D","E01011848","Total",633,624,9
"2011","Wakefield 023E","E01011851","Total",736,690,46
"2011","Wakefield 024A","E01011775","Total",1167,1131,36
"2011","Wakefield 024B","E01011776","Total",651,619,32
"2011","Wakefield 024C","E01011777","Total",655,622,33
"2011","Wakefield 024D","E01011778","Total",686,652,34
"2011","Wakefield 024E","E01011817","Total",573,557,16
"2011","Wakefield 024F","E01011818","Total",619,592,27
"2011","Wakefield 025A","E01011829","Total",641,613,28
"2011","Wakefield 025B","E01011830","Total",687,660,27
"2011","Wakefield 025C","E01011831","Total",798,776,22
"2011","Wakefield 025D","E01011832","Total",639,621,18
"2011","Wakefield 025E","E01011833","Total",683,667,16
"2011","Wakefield 026A","E01011899","Total",546,542,4
"2011","Wakefield 026B","E01011900","Total",774,752,22
"2011","Wakefield 026C","E01011901","Total",597,584,13
"2011","Wakefield 026D","E01011904","Total",509,500,9
"2011","Wakefield 026E","E01011918","Total",650,634,16
"2011","Wakefield 026F","E01011922","Total",655,639,16
"2011","Wakefield 027A","E01011779","Total",610,598,12
"2011","Wakefield 027B","E01011780","Total",907,870,37
"2011","Wakefield 027C","E01011781","Total",860,804,56
"2011","Wakefield 027D","E01011782","Total",687,640,47
"2011","Wakefield 027E","E01011783","Total",641,594,47
"2011","Wakefield 028A","E01011902","Total",707,674,33
"2011","Wakefield 028B","E01011903","Total",649,617,32
"2011","Wakefield 028C","E01011905","Total",705,684,21
"2011","Wakefield 028D","E01011907","Total",911,875,36
"2011","Wakefield 029A","E01011793","Total",744,729,15
"2011","Wakefield 029B","E01011794","Total",627,613,14
"2011","Wakefield 029C","E01011795","Total",606,595,11
"2011","Wakefield 029D","E01011796","Total",597,582,15
"2011","Wakefield 029E","E01011799","Total",809,775,34
"2011","Wakefield 029F","E01011800","Total",746,718,28
"2011","Wakefield 030A","E01011898","Total",754,717,37
"2011","Wakefield 030B","E01011906","Total",691,672,19
"2011","Wakefield 030C","E01011908","Total",1068,934,134
"2011","Wakefield 030D","E01011917","Total",776,699,77
"2011","Wakefield 030E","E01011944","Total",642,589,53
"2011","Wakefield 031A","E01011797","Total",724,706,18
"2011","Wakefield 031B","E01011798","Total",705,662,43
"2011","Wakefield 031C","E01011801","Total",661,645,16
"2011","Wakefield 031D","E01011802","Total",663,647,16
"2011","Wakefield 032A","E01011765","Total",659,640,19
"2011","Wakefield 032B","E01011766","Total",610,584,26
"2011","Wakefield 032C","E01011773","Total",624,609,15
"2011","Wakefield 032D","E01011774","Total",627,590,37
"2011","Wakefield 033A","E01011939","Total",653,639,14
"2011","Wakefield 033B","E01011945","Total",681,648,33
"2011","Wakefield 033C","E01011947","Total",695,670,25
"2011","Wakefield 033D","E01011948","Total",689,665,24
"2011","Wakefield 034A","E01011767","Total",767,740,27
"2011","Wakefield 034B","E01011768","Total",611,583,28
"2011","Wakefield 034C","E01011769","Total",980,930,50
"2011","Wakefield 034D","E01011770","Total",839,795,44
"2011","Wakefield 034E","E01011849","Total",751,730,21
"2011","Wakefield 034F","E01011857","Total",749,721,28
"2011","Wakefield 035A","E01011928","Total",653,625,28
"2011","Wakefield 035B","E01011931","Total",651,637,14
"2011","Wakefield 035C","E01011932","Total",632,607,25
"2011","Wakefield 035D","E01011938","Total",599,570,29
"2011","Wakefield 036A","E01011929","Total",765,746,19
"2011","Wakefield 036B","E01011930","Total",740,713,27
"2011","Wakefield 036C","E01011933","Total",686,657,29
"2011","Wakefield 036D","E01011937","Total",622,606,16
"2011","Wakefield 037A","E01011934","Total",660,621,39
"2011","Wakefield 037B","E01011936","Total",668,659,9
"2011","Wakefield 037C","E01011940","Total",636,614,22
"2011","Wakefield 037D","E01011943","Total",831,806,25
"2011","Wakefield 038A","E01011935","Total",801,756,45
"2011","Wakefield 038B","E01011941","Total",665,646,19
"2011","Wakefield 038C","E01011942","Total",575,554,21
"2011","Wakefield 038D","E01011946","Total",634,617,17
"2011","Wakefield 039A","E01011785","Total",642,608,34
"2011","Wakefield 039B","E01011789","Total",556,510,46
"2011","Wakefield 039C","E01011791","Total",641,626,15
"2011","Wakefield 039D","E01011792","Total",660,631,29
"2011","Wakefield 040A","E01011771","Total",631,615,16
"2011","Wakefield 040B","E01011772","Total",729,692,37
"2011","Wakefield 040C","E01011784","Total",802,772,30
"2011","Wakefield 040D","E01011786","Total",651,620,31
"2011","Wakefield 041A","E01011854","Total",543,513,30
"2011","Wakefield 041B","E01011855","Total",706,686,20
"2011","Wakefield 041C","E01011856","Total",655,622,33
"2011","Wakefield 041D","E01011858","Total",657,638,19
"2011","Wakefield 042A","E01011787","Total",794,765,29
"2011","Wakefield 042B","E01011788","Total",752,729,23
"2011","Wakefield 042C","E01011790","Total",802,761,41
"2011","Wakefield 042D","E01011865","Total",776,754,22
"2011","Wakefield 042E","E01011867","Total",708,684,24
"2011","Wakefield 043A","E01011859","Total",705,688,17
"2011","Wakefield 043B","E01011869","Total",744,683,61
"2011","Wakefield 043C","E01011870","Total",650,641,9
"2011","Wakefield 043D","E01011871","Total",700,661,39
"2011","Wakefield 044A","E01011860","Total",658,642,16
"2011","Wakefield 044B","E01011861","Total",838,815,23
"2011","Wakefield 044C","E01011862","Total",631,606,25
"2011","Wakefield 044D","E01011863","Total",636,609,27
"2011","Wakefield 045A","E01011864","Total",689,662,27
"2011","Wakefield 045B","E01011866","Total",651,641,10
"2011","Wakefield 045C","E01011868","Total",843,814,29
"2011","Wakefield 045D","E01011872","Total",652,629,23
"2011","Derby 001A","E01013461","Total",733,711,22
"2011","Derby 001B","E01013462","Total",648,633,15
"2011","Derby 001C","E01013463","Total",623,607,16
"2011","Derby 001D","E01013464","Total",653,634,19
"2011","Derby 002A","E01013465","Total",714,694,20
"2011","Derby 002B","E01013466","Total",660,648,12
"2011","Derby 002C","E01013467","Total",619,609,10
"2011","Derby 002D","E01013468","Total",718,698,20
"2011","Derby 002E","E01013469","Total",752,722,30
"2011","Derby 003A","E01013574","Total",553,536,17
"2011","Derby 003B","E01013575","Total",623,602,21
"2011","Derby 003C","E01013576","Total",576,566,10
"2011","Derby 003D","E01013577","Total",605,596,9
"2011","Derby 003E","E01013578","Total",564,555,9
"2011","Derby 003F","E01013579","Total",648,631,17
"2011","Derby 003G","E01013580","Total",739,701,38
"2011","Derby 004A","E01013530","Total",640,622,18
"2011","Derby 004B","E01013531","Total",615,601,14
"2011","Derby 004C","E01013532","Total",634,618,16
"2011","Derby 004D","E01013581","Total",619,610,9
"2011","Derby 005A","E01013526","Total",760,735,25
"2011","Derby 005B","E01013527","Total",675,638,37
"2011","Derby 005C","E01013528","Total",770,731,39
"2011","Derby 005D","E01013529","Total",1112,1032,80
"2011","Derby 006A","E01013505","Total",627,608,19
"2011","Derby 006B","E01013506","Total",721,696,25
"2011","Derby 006C","E01013513","Total",517,500,17
"2011","Derby 006D","E01013534","Total",684,662,22
"2011","Derby 006E","E01013582","Total",707,694,13
"2011","Derby 007A","E01013533","Total",731,705,26
"2011","Derby 007B","E01013535","Total",538,521,17
"2011","Derby 007C","E01013536","Total",707,680,27
"2011","Derby 007D","E01013537","Total",762,725,37
"2011","Derby 007E","E01013538","Total",672,625,47
"2011","Derby 008A","E01013522","Total",980,918,62
"2011","Derby 008B","E01013523","Total",881,836,45
"2011","Derby 008C","E01013524","Total",715,676,39
"2011","Derby 008D","E01013525","Total",1094,1062,32
"2011","Derby 009A","E01013548","Total",653,639,14
"2011","Derby 009B","E01013549","Total",631,622,9
"2011","Derby 009C","E01013552","Total",754,738,16
"2011","Derby 009D","E01013553","Total",658,646,12
"2011","Derby 009E","E01013555","Total",604,598,6
"2011","Derby 010A","E01013592","Total",673,635,38
"2011","Derby 010B","E01013594","Total",643,630,13
"2011","Derby 010C","E01013596","Total",712,692,20
"2011","Derby 010D","E01013599","Total",629,618,11
"2011","Derby 011A","E01013547","Total",860,809,51
"2011","Derby 011B","E01013550","Total",548,538,10
"2011","Derby 011C","E01013551","Total",717,687,30
"2011","Derby 011D","E01013554","Total",862,805,57
"2011","Derby 012A","E01013507","Total",663,643,20
"2011","Derby 012B","E01013508","Total",502,488,14
"2011","Derby 012C","E01013509","Total",730,713,17
"2011","Derby 012D","E01013510","Total",642,624,18
"2011","Derby 012E","E01013511","Total",667,637,30
"2011","Derby 012F","E01013512","Total",644,632,12
"2011","Derby 013A","E01013453","Total",1219,1121,98
"2011","Derby 013B","E01013454","Total",558,543,15
"2011","Derby 013C","E01013456","Total",1113,1053,60
"2011","Derby 013D","E01013457","Total",848,822,26
"2011","Derby 013E","E01013460","Total",975,909,66
"2011","Derby 013F","E01013479","Total",1286,1142,144
"2011","Derby 014A","E01013593","Total",615,591,24
"2011","Derby 014B","E01013595","Total",1019,957,62
"2011","Derby 014C","E01013597","Total",676,650,26
"2011","Derby 014D","E01013598","Total",655,632,23
"2011","Derby 015A","E01013556","Total",629,611,18
"2011","Derby 015B","E01013557","Total",623,605,18
"2011","Derby 015C","E01013558","Total",905,853,52
"2011","Derby 015D","E01013559","Total",588,579,9
"2011","Derby 015E","E01013564","Total",820,809,11
"2011","Derby 016A","E01013480","Total",1213,1085,128
"2011","Derby 016B","E01013483","Total",732,699,33
"2011","Derby 016C","E01013485","Total",679,639,40
"2011","Derby 016D","E01013565","Total",566,541,25
"2011","Derby 016E","E01013566","Total",764,720,44
"2011","Derby 017A","E01013455","Total",837,812,25
"2011","Derby 017B","E01013458","Total",610,569,41
"2011","Derby 017C","E01013542","Total",761,696,65
"2011","Derby 017D","E01013546","Total",676,645,31
"2011","Derby 018A","E01013481","Total",617,585,32
"2011","Derby 018C","E01013484","Total",727,695,32
"2011","Derby 018D","E01013486","Total",621,573,48
"2011","Derby 018E","E01013487","Total",821,761,60
"2011","Derby 018F","E01033166","Total",652,584,68
"2011","Derby 018G","E01033167","Total",648,621,27
"2011","Derby 019A","E01013540","Total",658,645,13
"2011","Derby 019B","E01013560","Total",605,595,10
"2011","Derby 019C","E01013561","Total",709,687,22
"2011","Derby 019D","E01013562","Total",752,719,33
"2011","Derby 019E","E01013563","Total",639,627,12
"2011","Derby 020A","E01013459","Total",620,595,25
"2011","Derby 020B","E01013567","Total",722,633,89
"2011","Derby 020C","E01013568","Total",799,751,48
"2011","Derby 020D","E01013569","Total",576,541,35
"2011","Derby 021A","E01013539","Total",724,718,6
"2011","Derby 021B","E01013541","Total",665,651,14
"2011","Derby 021C","E01013543","Total",637,624,13
"2011","Derby 021D","E01013544","Total",683,670,13
"2011","Derby 021E","E01013545","Total",746,714,32
"2011","Derby 022A","E01013488","Total",587,572,15
"2011","Derby 022B","E01013489","Total",642,618,24
"2011","Derby 022C","E01013490","Total",600,587,13
"2011","Derby 022D","E01013491","Total",622,600,22
"2011","Derby 023A","E01013570","Total",730,681,49
"2011","Derby 023B","E01013571","Total",705,670,35
"2011","Derby 023C","E01013572","Total",712,688,24
"2011","Derby 023D","E01013573","Total",832,813,19
"2011","Derby 024A","E01013470","Total",645,625,20
"2011","Derby 024B","E01013474","Total",751,719,32
"2011","Derby 024C","E01013476","Total",743,723,20
"2011","Derby 024E","E01033171","Total",744,655,89
"2011","Derby 024F","E01033172","Total",804,730,74
"2011","Derby 025A","E01013471","Total",862,806,56
"2011","Derby 025B","E01013473","Total",719,670,49
"2011","Derby 025C","E01013475","Total",596,573,23
"2011","Derby 025D","E01013477","Total",815,765,50
"2011","Derby 025E","E01013502","Total",632,614,18
"2011","Derby 025F","E01013503","Total",642,615,27
"2011","Derby 026A","E01013472","Total",1020,965,55
"2011","Derby 026B","E01013497","Total",639,617,22
"2011","Derby 026C","E01013504","Total",744,714,30
"2011","Derby 026D","E01013583","Total",598,582,16
"2011","Derby 026E","E01013590","Total",669,643,26
"2011","Derby 026F","E01013591","Total",875,819,56
"2011","Derby 027A","E01013492","Total",607,594,13
"2011","Derby 027B","E01013493","Total",669,647,22
"2011","Derby 027C","E01013494","Total",818,795,23
"2011","Derby 027D","E01013495","Total",725,712,13
"2011","Derby 028A","E01013496","Total",680,661,19
"2011","Derby 028B","E01013498","Total",608,585,23
"2011","Derby 028C","E01013499","Total",667,646,21
"2011","Derby 028D","E01013500","Total",748,724,24
"2011","Derby 028E","E01013501","Total",646,620,26
"2011","Derby 029A","E01013584","Total",650,635,15
"2011","Derby 029B","E01013585","Total",684,660,24
"2011","Derby 029C","E01013586","Total",635,618,17
"2011","Derby 029D","E01013587","Total",608,590,18
"2011","Derby 029E","E01013588","Total",684,662,22
"2011","Derby 029F","E01013589","Total",562,551,11
"2011","Derby 030B","E01013517","Total",686,667,19
"2011","Derby 030C","E01013518","Total",601,581,20
"2011","Derby 030D","E01013521","Total",737,691,46
"2011","Derby 030E","E01033168","Total",502,494,8
"2011","Derby 030F","E01033169","Total",572,558,14
"2011","Derby 030G","E01033170","Total",589,566,23
"2011","Derby 031A","E01013514","Total",703,684,19
"2011","Derby 031B","E01013515","Total",751,730,21
"2011","Derby 031C","E01013519","Total",598,587,11
"2011","Derby 031D","E01013520","Total",660,645,15
"2011","Leicester 001A","E01013615","Total",559,543,16
"2011","Leicester 001B","E01013616","Total",695,683,12
"2011","Leicester 001C","E01013618","Total",703,685,18
"2011","Leicester 001D","E01013619","Total",659,639,20
"2011","Leicester 002A","E01013733","Total",635,619,16
"2011","Leicester 002B","E01013734","Total",544,531,13
"2011","Leicester 002C","E01013735","Total",472,469,3
"2011","Leicester 002D","E01013736","Total",728,720,8
"2011","Leicester 002E","E01013737","Total",473,465,8
"2011","Leicester 003A","E01013600","Total",771,755,16
"2011","Leicester 003B","E01013601","Total",655,644,11
"2011","Leicester 003C","E01013602","Total",817,797,20
"2011","Leicester 003D","E01013603","Total",816,798,18
"2011","Leicester 003E","E01013604","Total",660,648,12
"2011","Leicester 003F","E01013605","Total",718,698,20
"2011","Leicester 004A","E01013617","Total",977,936,41
"2011","Leicester 004B","E01013620","Total",708,694,14
"2011","Leicester 004C","E01013621","Total",749,743,6
"2011","Leicester 004D","E01013622","Total",748,729,19
"2011","Leicester 004E","E01013623","Total",821,807,14
"2011","Leicester 005A","E01013732","Total",757,742,15
"2011","Leicester 005B","E01013739","Total",593,570,23
"2011","Leicester 005C","E01013740","Total",509,499,10
"2011","Leicester 005D","E01013741","Total",548,529,19
"2011","Leicester 006A","E01013625","Total",700,668,32
"2011","Leicester 006B","E01013628","Total",685,645,40
"2011","Leicester 006C","E01013715","Total",453,439,14
"2011","Leicester 006D","E01013716","Total",585,560,25
"2011","Leicester 006E","E01013738","Total",505,491,14
"2011","Leicester 007A","E01013624","Total",525,511,14
"2011","Leicester 007B","E01013626","Total",587,574,13
"2011","Leicester 007C","E01013627","Total",432,421,11
"2011","Leicester 007D","E01013629","Total",555,527,28
"2011","Leicester 007E","E01013630","Total",597,576,21
"2011","Leicester 008A","E01013606","Total",701,693,8
"2011","Leicester 008B","E01013607","Total",1224,1136,88
"2011","Leicester 008C","E01013680","Total",849,822,27
"2011","Leicester 008D","E01013685","Total",630,616,14
"2011","Leicester 008E","E01013686","Total",726,708,18
"2011","Leicester 009A","E01013696","Total",830,818,12
"2011","Leicester 009B","E01013697","Total",961,921,40
"2011","Leicester 009C","E01013699","Total",674,644,30
"2011","Leicester 009E","E01032862","Total",721,693,28
"2011","Leicester 009F","E01032863","Total",624,612,12
"2011","Leicester 009G","E01032865","Total",688,681,7
"2011","Leicester 010A","E01013713","Total",511,489,22
"2011","Leicester 010B","E01013714","Total",519,503,16
"2011","Leicester 010C","E01013717","Total",505,495,10
"2011","Leicester 010D","E01013718","Total",572,558,14
"2011","Leicester 010E","E01013719","Total",500,480,20
"2011","Leicester 010F","E01013720","Total",619,606,13
"2011","Leicester 011A","E01013651","Total",652,648,4
"2011","Leicester 011B","E01013652","Total",577,576,1
"2011","Leicester 011C","E01013653","Total",690,683,7
"2011","Leicester 011D","E01013655","Total",740,717,23
"2011","Leicester 012A","E01013721","Total",673,658,15
"2011","Leicester 012B","E01013723","Total",486,480,6
"2011","Leicester 012C","E01013725","Total",534,528,6
"2011","Leicester 012D","E01013726","Total",903,885,18
"2011","Leicester 012E","E01013728","Total",551,542,9
"2011","Leicester 013A","E01013694","Total",659,650,9
"2011","Leicester 013B","E01013700","Total",619,615,4
"2011","Leicester 013C","E01013770","Total",565,551,14
"2011","Leicester 013D","E01013771","Total",539,519,20
"2011","Leicester 013E","E01013773","Total",582,576,6
"2011","Leicester 016A","E01013681","Total",801,772,29
"2011","Leicester 016B","E01013682","Total",811,772,39
"2011","Leicester 016C","E01013683","Total",1049,980,69
"2011","Leicester 016D","E01013684","Total",946,894,52
"2011","Leicester 017A","E01013654","Total",862,835,27
"2011","Leicester 017B","E01013656","Total",517,502,15
"2011","Leicester 017C","E01013657","Total",540,529,11
"2011","Leicester 017D","E01013658","Total",587,561,26
"2011","Leicester 017E","E01013659","Total",596,565,31
"2011","Leicester 017F","E01013743","Total",448,428,20
"2011","Leicester 017G","E01013745","Total",442,423,19
"2011","Leicester 018A","E01013742","Total",477,462,15
"2011","Leicester 018B","E01013744","Total",492,482,10
"2011","Leicester 018C","E01013746","Total",737,724,13
"2011","Leicester 018D","E01013748","Total",769,682,87
"2011","Leicester 018E","E01013754","Total",709,705,4
"2011","Leicester 018F","E01013755","Total",721,720,1
"2011","Leicester 019A","E01013660","Total",681,647,34
"2011","Leicester 019B","E01013661","Total",640,633,7
"2011","Leicester 019C","E01013664","Total",782,777,5
"2011","Leicester 019D","E01013665","Total",631,620,11
"2011","Leicester 019E","E01013667","Total",696,678,18
"2011","Leicester 019F","E01013668","Total",628,578,50
"2011","Leicester 020A","E01013729","Total",551,545,6
"2011","Leicester 020B","E01013780","Total",646,622,24
"2011","Leicester 020C","E01013783","Total",634,619,15
"2011","Leicester 020D","E01013785","Total",554,542,12
"2011","Leicester 020E","E01013786","Total",723,700,23
"2011","Leicester 021A","E01013662","Total",537,517,20
"2011","Leicester 021B","E01013663","Total",523,512,11
"2011","Leicester 021C","E01013747","Total",550,532,18
"2011","Leicester 021D","E01013749","Total",458,449,9
"2011","Leicester 021E","E01013750","Total",425,416,9
"2011","Leicester 021F","E01013758","Total",441,428,13
"2011","Leicester 022A","E01013751","Total",541,524,17
"2011","Leicester 022B","E01013752","Total",461,444,17
"2011","Leicester 022C","E01013753","Total",541,517,24
"2011","Leicester 022D","E01013760","Total",742,698,44
"2011","Leicester 022E","E01013761","Total",636,619,17
"2011","Leicester 022F","E01013762","Total",552,542,10
"2011","Leicester 023A","E01013774","Total",745,704,41
"2011","Leicester 023B","E01013776","Total",812,754,58
"2011","Leicester 023C","E01013778","Total",981,939,42
"2011","Leicester 023D","E01013779","Total",963,893,70
"2011","Leicester 023E","E01013781","Total",820,768,52
"2011","Leicester 023F","E01013782","Total",701,673,28
"2011","Leicester 023G","E01013784","Total",560,525,35
"2011","Leicester 025A","E01013666","Total",615,597,18
"2011","Leicester 025B","E01013669","Total",479,457,22
"2011","Leicester 025C","E01013670","Total",739,707,32
"2011","Leicester 025D","E01013671","Total",607,589,18
"2011","Leicester 025E","E01013672","Total",527,511,16
"2011","Leicester 026A","E01013631","Total",553,544,9
"2011","Leicester 026B","E01013632","Total",754,740,14
"2011","Leicester 026C","E01013638","Total",675,664,11
"2011","Leicester 026D","E01013640","Total",645,636,9
"2011","Leicester 027A","E01013756","Total",703,675,28
"2011","Leicester 027B","E01013757","Total",501,489,12
"2011","Leicester 027C","E01013759","Total",543,531,12
"2011","Leicester 027D","E01013763","Total",867,828,39
"2011","Leicester 027E","E01013764","Total",471,458,13
"2011","Leicester 027F","E01013765","Total",579,548,31
"2011","Leicester 027G","E01013766","Total",510,500,10
"2011","Leicester 028A","E01013633","Total",691,681,10
"2011","Leicester 028B","E01013634","Total",628,622,6
"2011","Leicester 028C","E01013637","Total",782,764,18
"2011","Leicester 028D","E01013639","Total",543,538,5
"2011","Leicester 028E","E01013641","Total",645,617,28
"2011","Leicester 029A","E01013635","Total",619,595,24
"2011","Leicester 029B","E01013636","Total",510,492,18
"2011","Leicester 029C","E01013775","Total",1044,968,76
"2011","Leicester 029D","E01013777","Total",778,731,47
"2011","Leicester 030A","E01013642","Total",895,837,58
"2011","Leicester 030B","E01013643","Total",776,738,38
"2011","Leicester 030C","E01013649","Total",724,684,40
"2011","Leicester 030D","E01013650","Total",767,742,25
"2011","Leicester 030E","E01013702","Total",645,623,22
"2011","Leicester 030F","E01013710","Total",743,714,29
"2011","Leicester 030G","E01013711","Total",771,728,43
"2011","Leicester 031A","E01013613","Total",826,775,51
"2011","Leicester 031B","E01013614","Total",748,714,34
"2011","Leicester 031C","E01013687","Total",764,737,27
"2011","Leicester 031D","E01013688","Total",731,699,32
"2011","Leicester 032A","E01013703","Total",520,513,7
"2011","Leicester 032B","E01013704","Total",618,597,21
"2011","Leicester 032C","E01013706","Total",665,646,19
"2011","Leicester 032D","E01013707","Total",613,602,11
"2011","Leicester 032E","E01013712","Total",603,570,33
"2011","Leicester 034A","E01013608","Total",631,627,4
"2011","Leicester 034B","E01013609","Total",785,741,44
"2011","Leicester 034C","E01013610","Total",767,747,20
"2011","Leicester 034D","E01013611","Total",627,604,23
"2011","Leicester 034E","E01013612","Total",659,631,28
"2011","Leicester 035A","E01013678","Total",685,644,41
"2011","Leicester 035B","E01013679","Total",530,520,10
"2011","Leicester 035C","E01013691","Total",610,606,4
"2011","Leicester 035D","E01013692","Total",490,483,7
"2011","Leicester 035E","E01013693","Total",526,522,4
"2011","Leicester 036A","E01013673","Total",615,611,4
"2011","Leicester 036B","E01013674","Total",796,774,22
"2011","Leicester 036C","E01013675","Total",676,667,9
"2011","Leicester 036D","E01013676","Total",833,823,10
"2011","Leicester 036E","E01013677","Total",691,672,19
"2011","Leicester 037A","E01013695","Total",616,609,7
"2011","Leicester 037B","E01013698","Total",593,587,6
"2011","Leicester 037C","E01013767","Total",582,567,15
"2011","Leicester 037D","E01013768","Total",727,705,22
"2011","Leicester 037E","E01013772","Total",635,616,19
"2011","Leicester 037F","E01032597","Total",679,655,24
"2011","Leicester 038A","E01013689","Total",553,519,34
"2011","Leicester 038B","E01013690","Total",683,656,27
"2011","Leicester 038C","E01013705","Total",681,667,14
"2011","Leicester 038D","E01013709","Total",572,552,20
"2011","Leicester 038E","E01032599","Total",596,580,16
"2011","Leicester 039A","E01013722","Total",614,598,16
"2011","Leicester 039B","E01013727","Total",661,649,12
"2011","Leicester 039C","E01013730","Total",779,758,21
"2011","Leicester 039D","E01013731","Total",655,648,7
"2011","Leicester 039E","E01032602","Total",616,601,15
"2011","Leicester 040A","E01013646","Total",1176,1099,77
"2011","Leicester 040B","E01013647","Total",990,947,43
"2011","Leicester 040C","E01013648","Total",786,746,40
"2011","Leicester 040D","E01032875","Total",441,423,18
"2011","Leicester 041A","E01032867","Total",904,813,91
"2011","Leicester 041B","E01032868","Total",506,483,23
"2011","Leicester 041C","E01032872","Total",854,778,76
"2011","Leicester 041D","E01032873","Total",924,887,37
"2011","Nottingham 001A","E01013887","Total",650,637,13
"2011","Nottingham 001B","E01013892","Total",603,600,3
"2011","Nottingham 001C","E01013893","Total",610,583,27
"2011","Nottingham 001D","E01013894","Total",644,638,6
"2011","Nottingham 002A","E01013879","Total",586,573,13
"2011","Nottingham 002B","E01013880","Total",688,678,10
"2011","Nottingham 002C","E01013881","Total",667,649,18
"2011","Nottingham 002D","E01013882","Total",661,628,33
"2011","Nottingham 002E","E01013885","Total",828,769,59
"2011","Nottingham 004A","E01013886","Total",679,660,19
"2011","Nottingham 004B","E01013888","Total",716,696,20
"2011","Nottingham 004C","E01013889","Total",750,721,29
"2011","Nottingham 004D","E01013890","Total",680,661,19
"2011","Nottingham 004E","E01013891","Total",759,731,28
"2011","Nottingham 005A","E01013875","Total",526,521,5
"2011","Nottingham 005B","E01013876","Total",776,757,19
"2011","Nottingham 005C","E01013877","Total",702,680,22
"2011","Nottingham 005D","E01013878","Total",555,538,17
"2011","Nottingham 005E","E01013883","Total",693,681,12
"2011","Nottingham 005F","E01013884","Total",656,639,17
"2011","Nottingham 006A","E01013853","Total",665,653,12
"2011","Nottingham 006B","E01013854","Total",656,639,17
"2011","Nottingham 006C","E01013855","Total",659,642,17
"2011","Nottingham 006D","E01013856","Total",656,638,18
"2011","Nottingham 006F","E01033397","Total",718,694,24
"2011","Nottingham 006G","E01033398","Total",660,637,23
"2011","Nottingham 007A","E01013963","Total",737,718,19
"2011","Nottingham 007B","E01013964","Total",683,671,12
"2011","Nottingham 007C","E01013965","Total",635,617,18
"2011","Nottingham 007D","E01013966","Total",579,568,11
"2011","Nottingham 007E","E01013967","Total",492,478,14
"2011","Nottingham 008A","E01013827","Total",625,608,17
"2011","Nottingham 008B","E01013828","Total",820,790,30
"2011","Nottingham 008C","E01013834","Total",670,642,28
"2011","Nottingham 008D","E01013835","Total",735,715,20
"2011","Nottingham 008E","E01013836","Total",921,872,49
"2011","Nottingham 009A","E01013829","Total",822,797,25
"2011","Nottingham 009B","E01013830","Total",712,696,16
"2011","Nottingham 009C","E01013831","Total",685,672,13
"2011","Nottingham 009D","E01013832","Total",775,745,30
"2011","Nottingham 009E","E01013833","Total",573,561,12
"2011","Nottingham 010A","E01013935","Total",773,744,29
"2011","Nottingham 010B","E01013968","Total",702,669,33
"2011","Nottingham 010C","E01013969","Total",837,798,39
"2011","Nottingham 010D","E01013970","Total",704,670,34
"2011","Nottingham 010E","E01013971","Total",822,769,53
"2011","Nottingham 011A","E01013817","Total",670,642,28
"2011","Nottingham 011B","E01013818","Total",589,579,10
"2011","Nottingham 011C","E01013822","Total",659,641,18
"2011","Nottingham 011D","E01013825","Total",707,690,17
"2011","Nottingham 011E","E01013826","Total",724,706,18
"2011","Nottingham 012A","E01013837","Total",757,736,21
"2011","Nottingham 012B","E01013838","Total",688,664,24
"2011","Nottingham 012C","E01013839","Total",932,862,70
"2011","Nottingham 012D","E01013840","Total",1021,982,39
"2011","Nottingham 012E","E01013841","Total",738,692,46
"2011","Nottingham 013A","E01013819","Total",775,735,40
"2011","Nottingham 013B","E01013820","Total",685,669,16
"2011","Nottingham 013C","E01013821","Total",654,627,27
"2011","Nottingham 013D","E01013823","Total",681,666,15
"2011","Nottingham 013E","E01013824","Total",620,599,21
"2011","Nottingham 014A","E01013864","Total",732,710,22
"2011","Nottingham 014B","E01013865","Total",779,752,27
"2011","Nottingham 014C","E01013866","Total",635,609,26
"2011","Nottingham 014D","E01013867","Total",611,598,13
"2011","Nottingham 015A","E01013937","Total",804,748,56
"2011","Nottingham 015B","E01013938","Total",748,704,44
"2011","Nottingham 015C","E01013941","Total",904,827,77
"2011","Nottingham 015D","E01013943","Total",888,812,76
"2011","Nottingham 015E","E01013972","Total",729,693,36
"2011","Nottingham 016A","E01013936","Total",1108,1057,51
"2011","Nottingham 016B","E01013939","Total",796,769,27
"2011","Nottingham 016C","E01013940","Total",780,753,27
"2011","Nottingham 016D","E01013942","Total",1004,958,46
"2011","Nottingham 017A","E01013843","Total",718,663,55
"2011","Nottingham 017B","E01013844","Total",682,621,61
"2011","Nottingham 017C","E01013845","Total",645,606,39
"2011","Nottingham 017D","E01013847","Total",465,433,32
"2011","Nottingham 018A","E01013810","Total",650,617,33
"2011","Nottingham 018B","E01013811","Total",650,588,62
"2011","Nottingham 018C","E01013812","Total",616,570,46
"2011","Nottingham 018D","E01013842","Total",707,648,59
"2011","Nottingham 018E","E01013846","Total",733,684,49
"2011","Nottingham 019A","E01013930","Total",757,731,26
"2011","Nottingham 019B","E01013931","Total",645,622,23
"2011","Nottingham 019C","E01013932","Total",685,658,27
"2011","Nottingham 019D","E01013933","Total",817,780,37
"2011","Nottingham 019E","E01013934","Total",675,647,28
"2011","Nottingham 020A","E01013859","Total",752,732,20
"2011","Nottingham 020B","E01013861","Total",746,722,24
"2011","Nottingham 020C","E01013868","Total",653,627,26
"2011","Nottingham 020D","E01013929","Total",771,751,20
"2011","Nottingham 021A","E01013954","Total",617,594,23
"2011","Nottingham 021B","E01013959","Total",870,841,29
"2011","Nottingham 021C","E01013960","Total",793,770,23
"2011","Nottingham 021D","E01013962","Total",888,859,29
"2011","Nottingham 022A","E01013813","Total",767,758,9
"2011","Nottingham 022B","E01013814","Total",936,841,95
"2011","Nottingham 022C","E01013815","Total",707,627,80
"2011","Nottingham 022D","E01013816","Total",971,914,57
"2011","Nottingham 023C","E01013958","Total",871,838,33
"2011","Nottingham 023D","E01013961","Total",891,853,38
"2011","Nottingham 023E","E01033399","Total",585,569,16
"2011","Nottingham 023F","E01033401","Total",599,559,40
"2011","Nottingham 023G","E01033405","Total",796,711,85
"2011","Nottingham 023H","E01033409","Total",629,619,10
"2011","Nottingham 023I","E01033411","Total",592,578,14
"2011","Nottingham 024A","E01013913","Total",701,688,13
"2011","Nottingham 024B","E01013914","Total",641,627,14
"2011","Nottingham 024C","E01013915","Total",672,656,16
"2011","Nottingham 024D","E01013916","Total",636,622,14
"2011","Nottingham 024E","E01013917","Total",806,783,23
"2011","Nottingham 025A","E01013858","Total",606,592,14
"2011","Nottingham 025B","E01013860","Total",739,713,26
"2011","Nottingham 025C","E01013862","Total",654,640,14
"2011","Nottingham 025D","E01013863","Total",641,620,21
"2011","Nottingham 026A","E01013944","Total",690,651,39
"2011","Nottingham 026B","E01013945","Total",652,610,42
"2011","Nottingham 026D","E01013947","Total",801,759,42
"2011","Nottingham 026E","E01013948","Total",786,754,32
"2011","Nottingham 026F","E01013953","Total",539,513,26
"2011","Nottingham 026G","E01033395","Total",596,549,47
"2011","Nottingham 026H","E01033396","Total",572,552,20
"2011","Nottingham 027A","E01013977","Total",792,766,26
"2011","Nottingham 027B","E01013978","Total",695,669,26
"2011","Nottingham 027C","E01013979","Total",626,601,25
"2011","Nottingham 027D","E01013981","Total",666,653,13
"2011","Nottingham 028E","E01032520","Total",1128,1058,70
"2011","Nottingham 028F","E01032522","Total",1060,1002,58
"2011","Nottingham 028G","E01033404","Total",1282,1219,63
"2011","Nottingham 029A","E01013918","Total",843,781,62
"2011","Nottingham 029B","E01013919","Total",886,836,50
"2011","Nottingham 029C","E01013920","Total",1303,1219,84
"2011","Nottingham 029D","E01013921","Total",937,882,55
"2011","Nottingham 029E","E01013957","Total",684,654,30
"2011","Nottingham 030A","E01013980","Total",685,666,19
"2011","Nottingham 030B","E01013982","Total",641,625,16
"2011","Nottingham 030C","E01013983","Total",749,733,16
"2011","Nottingham 030D","E01013984","Total",660,643,17
"2011","Nottingham 030E","E01013985","Total",753,739,14
"2011","Nottingham 031C","E01013924","Total",759,723,36
"2011","Nottingham 031E","E01013926","Total",666,633,33
"2011","Nottingham 031G","E01013928","Total",592,548,44
"2011","Nottingham 031H","E01033408","Total",1051,1014,37
"2011","Nottingham 031I","E01033410","Total",872,820,52
"2011","Nottingham 032A","E01013973","Total",427,401,26
"2011","Nottingham 032B","E01013974","Total",711,667,44
"2011","Nottingham 032C","E01013975","Total",441,425,16
"2011","Nottingham 032D","E01013976","Total",709,679,30
"2011","Nottingham 034A","E01013895","Total",648,636,12
"2011","Nottingham 034B","E01013896","Total",608,588,20
"2011","Nottingham 034C","E01013901","Total",655,639,16
"2011","Nottingham 034D","E01013902","Total",684,677,7
"2011","Nottingham 035A","E01013897","Total",651,641,10
"2011","Nottingham 035B","E01013898","Total",445,436,9
"2011","Nottingham 035C","E01013899","Total",500,492,8
"2011","Nottingham 035D","E01013900","Total",675,672,3
"2011","Nottingham 035E","E01013903","Total",499,491,8
"2011","Nottingham 035F","E01013907","Total",778,756,22
"2011","Nottingham 036A","E01013905","Total",642,633,9
"2011","Nottingham 036B","E01013908","Total",792,774,18
"2011","Nottingham 036C","E01013909","Total",803,786,17
"2011","Nottingham 036D","E01013912","Total",680,666,14
"2011","Nottingham 037A","E01013904","Total",637,626,11
"2011","Nottingham 037B","E01013906","Total",700,689,11
"2011","Nottingham 037C","E01013910","Total",649,628,21
"2011","Nottingham 037D","E01013911","Total",707,690,17
"2011","Nottingham 038A","E01013849","Total",714,693,21
"2011","Nottingham 038B","E01013850","Total",736,715,21
"2011","Nottingham 038C","E01013851","Total",818,786,32
"2011","Nottingham 038D","E01013852","Total",773,763,10
"2011","Nottingham 038E","E01032621","Total",721,704,17
"2011","Nottingham 039A","E01013874","Total",722,684,38
"2011","Nottingham 039B","E01033400","Total",675,599,76
"2011","Nottingham 039C","E01033402","Total",756,623,133
"2011","Nottingham 039D","E01033403","Total",682,639,43
"2011","Nottingham 039E","E01033406","Total",651,602,49
"2011","Nottingham 039F","E01033407","Total",710,640,70
"2011","Nottingham 040A","E01013870","Total",1098,1026,72
"2011","Nottingham 040B","E01013871","Total",884,858,26
"2011","Nottingham 040C","E01013872","Total",841,821,20
"2011","Nottingham 040D","E01013873","Total",660,619,41
"2011","Rutland 001A","E01013788","Total",1218,1014,204
"2011","Rutland 001B","E01013789","Total",657,596,61
"2011","Rutland 001C","E01013790","Total",537,501,36
"2011","Rutland 001D","E01013796","Total",606,565,41
"2011","Rutland 002A","E01013793","Total",673,610,63
"2011","Rutland 002B","E01013800","Total",668,659,9
"2011","Rutland 002C","E01013801","Total",766,725,41
"2011","Rutland 002D","E01013809","Total",562,525,37
"2011","Rutland 003A","E01013798","Total",584,579,5
"2011","Rutland 003B","E01013799","Total",714,651,63
"2011","Rutland 003C","E01013802","Total",1216,1178,38
"2011","Rutland 003D","E01013803","Total",1003,982,21
"2011","Rutland 004A","E01013791","Total",510,483,27
"2011","Rutland 004B","E01013792","Total",719,684,35
"2011","Rutland 004C","E01013797","Total",771,724,47
"2011","Rutland 004D","E01013804","Total",686,661,25
"2011","Rutland 004E","E01013805","Total",559,536,23
"2011","Rutland 005A","E01013787","Total",606,540,66
"2011","Rutland 005B","E01013794","Total",624,561,63
"2011","Rutland 005C","E01013795","Total",525,488,37
"2011","Rutland 005D","E01013806","Total",551,498,53
"2011","Rutland 005E","E01013807","Total",660,622,38
"2011","Rutland 005F","E01013808","Total",657,620,37
"2011","Amber Valley 001A","E01019400","Total",701,669,32
"2011","Amber Valley 001B","E01019401","Total",814,771,43
"2011","Amber Valley 001C","E01019402","Total",661,646,15
"2011","Amber Valley 001D","E01019404","Total",788,759,29
"2011","Amber Valley 002A","E01019406","Total",516,482,34
"2011","Amber Valley 002B","E01019423","Total",612,556,56
"2011","Amber Valley 002C","E01019424","Total",538,506,32
"2011","Amber Valley 002D","E01019477","Total",1081,1006,75
"2011","Amber Valley 003A","E01019403","Total",697,675,22
"2011","Amber Valley 003B","E01019444","Total",627,594,33
"2011","Amber Valley 003C","E01019468","Total",677,650,27
"2011","Amber Valley 003D","E01019469","Total",688,657,31
"2011","Amber Valley 003E","E01019471","Total",669,642,27
"2011","Amber Valley 004A","E01019443","Total",734,713,21
"2011","Amber Valley 004B","E01019470","Total",740,707,33
"2011","Amber Valley 004C","E01019473","Total",544,536,8
"2011","Amber Valley 004D","E01019474","Total",529,518,11
"2011","Amber Valley 004E","E01019475","Total",551,532,19
"2011","Amber Valley 004F","E01019476","Total",654,637,17
"2011","Amber Valley 005A","E01019420","Total",644,601,43
"2011","Amber Valley 005B","E01019442","Total",670,649,21
"2011","Amber Valley 005C","E01019445","Total",666,640,26
"2011","Amber Valley 005D","E01019455","Total",658,627,31
"2011","Amber Valley 005E","E01019456","Total",801,763,38
"2011","Amber Valley 005F","E01019457","Total",571,548,23
"2011","Amber Valley 006A","E01019429","Total",734,700,34
"2011","Amber Valley 006B","E01019454","Total",638,632,6
"2011","Amber Valley 006C","E01019460","Total",684,664,20
"2011","Amber Valley 006D","E01019461","Total",679,657,22
"2011","Amber Valley 006E","E01019462","Total",553,544,9
"2011","Amber Valley 007A","E01019405","Total",657,592,65
"2011","Amber Valley 007B","E01019414","Total",732,705,27
"2011","Amber Valley 007C","E01019428","Total",650,630,20
"2011","Amber Valley 007D","E01019430","Total",832,800,32
"2011","Amber Valley 008A","E01019421","Total",833,818,15
"2011","Amber Valley 008B","E01019422","Total",673,653,20
"2011","Amber Valley 008C","E01019432","Total",869,847,22
"2011","Amber Valley 008D","E01019458","Total",782,712,70
"2011","Amber Valley 008E","E01019459","Total",609,598,11
"2011","Amber Valley 008F","E01019463","Total",650,639,11
"2011","Amber Valley 009A","E01019408","Total",727,643,84
"2011","Amber Valley 009B","E01019409","Total",775,743,32
"2011","Amber Valley 009C","E01019412","Total",583,579,4
"2011","Amber Valley 009D","E01019413","Total",560,548,12
"2011","Amber Valley 009E","E01019416","Total",666,641,25
"2011","Amber Valley 010A","E01019407","Total",1116,1017,99
"2011","Amber Valley 010B","E01019415","Total",848,801,47
"2011","Amber Valley 010C","E01019417","Total",967,912,55
"2011","Amber Valley 010D","E01019419","Total",957,913,44
"2011","Amber Valley 011A","E01019410","Total",650,631,19
"2011","Amber Valley 011B","E01019411","Total",663,644,19
"2011","Amber Valley 011C","E01019418","Total",737,703,34
"2011","Amber Valley 011D","E01019447","Total",683,651,32
"2011","Amber Valley 011E","E01019449","Total",810,784,26
"2011","Amber Valley 012A","E01019431","Total",618,600,18
"2011","Amber Valley 012B","E01019433","Total",798,769,29
"2011","Amber Valley 012C","E01019438","Total",687,667,20
"2011","Amber Valley 012D","E01019451","Total",854,830,24
"2011","Amber Valley 012E","E01019464","Total",812,792,20
"2011","Amber Valley 013A","E01019434","Total",556,540,16
"2011","Amber Valley 013B","E01019435","Total",684,662,22
"2011","Amber Valley 013C","E01019436","Total",596,558,38
"2011","Amber Valley 013D","E01019439","Total",545,516,29
"2011","Amber Valley 013E","E01019440","Total",699,662,37
"2011","Amber Valley 015A","E01019446","Total",519,509,10
"2011","Amber Valley 015B","E01019448","Total",704,686,18
"2011","Amber Valley 015C","E01019450","Total",674,639,35
"2011","Amber Valley 015D","E01019465","Total",538,525,13
"2011","Amber Valley 015E","E01019467","Total",686,650,36
"2011","Amber Valley 016A","E01019425","Total",658,639,19
"2011","Amber Valley 016B","E01019426","Total",730,672,58
"2011","Amber Valley 016C","E01019427","Total",757,717,40
"2011","Amber Valley 016D","E01019472","Total",1176,1123,53
"2011","Amber Valley 017A","E01019437","Total",627,610,17
"2011","Amber Valley 017B","E01019441","Total",715,672,43
"2011","Amber Valley 017C","E01019452","Total",740,733,7
"2011","Amber Valley 017D","E01019453","Total",873,808,65
"2011","Amber Valley 017E","E01032613","Total",548,532,16
"2011","Bolsover 001A","E01019478","Total",674,652,22
"2011","Bolsover 001B","E01019479","Total",709,690,19
"2011","Bolsover 001C","E01019491","Total",1026,981,45
"2011","Bolsover 001D","E01019493","Total",683,663,20
"2011","Bolsover 001E","E01019494","Total",931,913,18
"2011","Bolsover 002A","E01019492","Total",827,796,31
"2011","Bolsover 002B","E01019495","Total",733,703,30
"2011","Bolsover 002C","E01019524","Total",615,587,28
"2011","Bolsover 002D","E01019525","Total",673,652,21
"2011","Bolsover 003A","E01019496","Total",651,625,26
"2011","Bolsover 003B","E01019497","Total",729,651,78
"2011","Bolsover 003C","E01019498","Total",782,731,51
"2011","Bolsover 003D","E01019523","Total",544,500,44
"2011","Bolsover 004A","E01019483","Total",897,857,40
"2011","Bolsover 004B","E01019484","Total",939,864,75
"2011","Bolsover 004C","E01019485","Total",581,555,26
"2011","Bolsover 004D","E01019488","Total",708,643,65
"2011","Bolsover 005A","E01019486","Total",447,439,8
"2011","Bolsover 005B","E01019487","Total",732,715,17
"2011","Bolsover 005C","E01019489","Total",549,535,14
"2011","Bolsover 005D","E01019490","Total",487,475,12
"2011","Bolsover 005E","E01019502","Total",732,703,29
"2011","Bolsover 005F","E01019504","Total",643,611,32
"2011","Bolsover 006A","E01019508","Total",868,827,41
"2011","Bolsover 006B","E01019509","Total",507,489,18
"2011","Bolsover 006C","E01019510","Total",582,561,21
"2011","Bolsover 006D","E01019512","Total",1123,1092,31
"2011","Bolsover 007A","E01019503","Total",1078,1046,32
"2011","Bolsover 007B","E01019505","Total",649,605,44
"2011","Bolsover 007C","E01019506","Total",587,565,22
"2011","Bolsover 007D","E01019507","Total",842,778,64
"2011","Bolsover 007E","E01019511","Total",890,837,53
"2011","Bolsover 008A","E01019480","Total",697,677,20
"2011","Bolsover 008B","E01019482","Total",693,670,23
"2011","Bolsover 008C","E01019520","Total",777,724,53
"2011","Bolsover 008D","E01019521","Total",697,663,34
"2011","Bolsover 008E","E01019522","Total",687,648,39
"2011","Bolsover 009A","E01019481","Total",549,541,8
"2011","Bolsover 009B","E01019514","Total",691,661,30
"2011","Bolsover 009C","E01019515","Total",700,675,25
"2011","Bolsover 009D","E01019516","Total",736,682,54
"2011","Bolsover 009E","E01019519","Total",819,788,31
"2011","Bolsover 010A","E01019499","Total",638,599,39
"2011","Bolsover 010B","E01019500","Total",643,597,46
"2011","Bolsover 010C","E01019501","Total",680,654,26
"2011","Bolsover 010D","E01019513","Total",581,559,22
"2011","Bolsover 010E","E01019517","Total",678,657,21
"2011","Bolsover 010F","E01019518","Total",680,665,15
"2011","Chesterfield 001A","E01019526","Total",637,620,17
"2011","Chesterfield 001B","E01019528","Total",718,704,14
"2011","Chesterfield 001C","E01019572","Total",677,642,35
"2011","Chesterfield 001D","E01019573","Total",718,678,40
"2011","Chesterfield 001E","E01019574","Total",677,642,35
"2011","Chesterfield 002A","E01019563","Total",672,647,25
"2011","Chesterfield 002B","E01019564","Total",673,650,23
"2011","Chesterfield 002C","E01019565","Total",669,652,17
"2011","Chesterfield 002D","E01019566","Total",750,722,28
"2011","Chesterfield 002E","E01019568","Total",570,557,13
"2011","Chesterfield 003A","E01019527","Total",715,693,22
"2011","Chesterfield 003B","E01019529","Total",682,649,33
"2011","Chesterfield 003C","E01019530","Total",721,689,32
"2011","Chesterfield 003D","E01019531","Total",663,630,33
"2011","Chesterfield 003E","E01019553","Total",772,737,35
"2011","Chesterfield 004A","E01019541","Total",686,667,19
"2011","Chesterfield 004B","E01019542","Total",896,841,55
"2011","Chesterfield 004C","E01019543","Total",787,768,19
"2011","Chesterfield 004D","E01019544","Total",741,724,17
"2011","Chesterfield 004E","E01019571","Total",654,638,16
"2011","Chesterfield 005A","E01019532","Total",545,535,10
"2011","Chesterfield 005B","E01019533","Total",645,630,15
"2011","Chesterfield 005C","E01019534","Total",635,615,20
"2011","Chesterfield 005D","E01019535","Total",661,638,23
"2011","Chesterfield 005E","E01019536","Total",845,814,31
"2011","Chesterfield 006A","E01019549","Total",545,529,16
"2011","Chesterfield 006B","E01019550","Total",688,670,18
"2011","Chesterfield 006C","E01019551","Total",718,706,12
"2011","Chesterfield 006D","E01019552","Total",529,517,12
"2011","Chesterfield 006E","E01019567","Total",790,768,22
"2011","Chesterfield 007A","E01019537","Total",638,627,11
"2011","Chesterfield 007B","E01019569","Total",924,857,67
"2011","Chesterfield 007C","E01019570","Total",618,599,19
"2011","Chesterfield 007D","E01019580","Total",673,659,14
"2011","Chesterfield 007E","E01019581","Total",708,688,20
"2011","Chesterfield 008A","E01019557","Total",623,617,6
"2011","Chesterfield 008B","E01019558","Total",588,581,7
"2011","Chesterfield 008C","E01019559","Total",499,494,5
"2011","Chesterfield 008D","E01019560","Total",632,622,10
"2011","Chesterfield 008E","E01019561","Total",758,738,20
"2011","Chesterfield 008F","E01019562","Total",643,628,15
"2011","Chesterfield 009A","E01019539","Total",771,745,26
"2011","Chesterfield 009B","E01019540","Total",652,630,22
"2011","Chesterfield 009C","E01019555","Total",806,775,31
"2011","Chesterfield 009D","E01019590","Total",876,848,28
"2011","Chesterfield 009E","E01019591","Total",682,657,25
"2011","Chesterfield 010A","E01019538","Total",884,803,81
"2011","Chesterfield 010B","E01019554","Total",769,725,44
"2011","Chesterfield 010C","E01019556","Total",765,705,60
"2011","Chesterfield 010D","E01019579","Total",851,786,65
"2011","Chesterfield 010F","E01033387","Total",672,621,51
"2011","Chesterfield 010G","E01033388","Total",668,631,37
"2011","Chesterfield 011A","E01019586","Total",644,616,28
"2011","Chesterfield 011B","E01019587","Total",658,642,16
"2011","Chesterfield 011C","E01019588","Total",635,623,12
"2011","Chesterfield 011D","E01019589","Total",621,609,12
"2011","Chesterfield 011E","E01019592","Total",709,684,25
"2011","Chesterfield 011F","E01019593","Total",508,498,10
"2011","Chesterfield 012A","E01019545","Total",641,619,22
"2011","Chesterfield 012B","E01019546","Total",666,643,23
"2011","Chesterfield 012C","E01019547","Total",674,653,21
"2011","Chesterfield 012D","E01019548","Total",995,965,30
"2011","Chesterfield 012E","E01019582","Total",661,634,27
"2011","Chesterfield 012F","E01019583","Total",628,611,17
"2011","Chesterfield 012G","E01019585","Total",1038,999,39
"2011","Chesterfield 013A","E01019575","Total",726,700,26
"2011","Chesterfield 013B","E01019576","Total",729,716,13
"2011","Chesterfield 013C","E01019577","Total",792,762,30
"2011","Chesterfield 013D","E01019578","Total",838,814,24
"2011","Derbyshire Dales 001A","E01019602","Total",920,841,79
"2011","Derbyshire Dales 001B","E01019614","Total",771,726,45
"2011","Derbyshire Dales 001C","E01019615","Total",1059,937,122
"2011","Derbyshire Dales 001D","E01019631","Total",920,798,122
"2011","Derbyshire Dales 002A","E01019600","Total",892,762,130
"2011","Derbyshire Dales 002B","E01019604","Total",888,823,65
"2011","Derbyshire Dales 002C","E01019606","Total",865,780,85
"2011","Derbyshire Dales 002D","E01019618","Total",860,734,126
"2011","Derbyshire Dales 003A","E01019599","Total",710,653,57
"2011","Derbyshire Dales 003B","E01019601","Total",760,718,42
"2011","Derbyshire Dales 003C","E01019613","Total",798,687,111
"2011","Derbyshire Dales 003D","E01019617","Total",835,705,130
"2011","Derbyshire Dales 004A","E01019608","Total",808,774,34
"2011","Derbyshire Dales 004B","E01019610","Total",712,672,40
"2011","Derbyshire Dales 004C","E01019630","Total",852,783,69
"2011","Derbyshire Dales 005A","E01019609","Total",1014,946,68
"2011","Derbyshire Dales 005B","E01019621","Total",569,547,22
"2011","Derbyshire Dales 005C","E01019622","Total",717,689,28
"2011","Derbyshire Dales 005D","E01019624","Total",570,529,41
"2011","Derbyshire Dales 005E","E01019627","Total",545,513,32
"2011","Derbyshire Dales 005F","E01019628","Total",526,498,28
"2011","Derbyshire Dales 006A","E01019619","Total",762,699,63
"2011","Derbyshire Dales 006B","E01019620","Total",767,683,84
"2011","Derbyshire Dales 006C","E01019623","Total",761,670,91
"2011","Derbyshire Dales 006D","E01019625","Total",688,677,11
"2011","Derbyshire Dales 006E","E01019626","Total",737,668,69
"2011","Derbyshire Dales 006F","E01019632","Total",851,732,119
"2011","Derbyshire Dales 007A","E01019633","Total",663,636,27
"2011","Derbyshire Dales 007B","E01019634","Total",720,660,60
"2011","Derbyshire Dales 007C","E01019635","Total",603,574,29
"2011","Derbyshire Dales 007D","E01019636","Total",790,712,78
"2011","Derbyshire Dales 008A","E01019595","Total",991,915,76
"2011","Derbyshire Dales 008B","E01019605","Total",898,781,117
"2011","Derbyshire Dales 008C","E01019611","Total",788,702,86
"2011","Derbyshire Dales 008D","E01019616","Total",807,758,49
"2011","Derbyshire Dales 009A","E01019594","Total",810,769,41
"2011","Derbyshire Dales 009B","E01019596","Total",731,708,23
"2011","Derbyshire Dales 009C","E01019597","Total",606,592,14
"2011","Derbyshire Dales 009D","E01019598","Total",767,727,40
"2011","Derbyshire Dales 010A","E01019603","Total",747,699,48
"2011","Derbyshire Dales 010B","E01019607","Total",815,765,50
"2011","Derbyshire Dales 010C","E01019612","Total",866,828,38
"2011","Derbyshire Dales 010D","E01019629","Total",730,674,56
"2011","Erewash 001A","E01019644","Total",762,714,48
"2011","Erewash 001B","E01019646","Total",660,631,29
"2011","Erewash 001C","E01019663","Total",709,689,20
"2011","Erewash 001D","E01019664","Total",514,494,20
"2011","Erewash 001E","E01019665","Total",647,631,16
"2011","Erewash 003A","E01019657","Total",808,774,34
"2011","Erewash 003B","E01019660","Total",877,853,24
"2011","Erewash 003C","E01019661","Total",669,605,64
"2011","Erewash 003D","E01019662","Total",847,773,74
"2011","Erewash 003E","E01019672","Total",795,729,66
"2011","Erewash 003F","E01019690","Total",587,550,37
"2011","Erewash 004A","E01019670","Total",769,751,18
"2011","Erewash 004B","E01019671","Total",820,784,36
"2011","Erewash 004C","E01019701","Total",984,935,49
"2011","Erewash 005A","E01019673","Total",537,516,21
"2011","Erewash 005B","E01019702","Total",769,753,16
"2011","Erewash 005C","E01019703","Total",678,651,27
"2011","Erewash 005D","E01019704","Total",646,630,16
"2011","Erewash 006A","E01019658","Total",821,794,27
"2011","Erewash 006B","E01019659","Total",730,712,18
"2011","Erewash 006C","E01019674","Total",527,513,14
"2011","Erewash 006D","E01019688","Total",682,648,34
"2011","Erewash 006E","E01019689","Total",669,643,26
"2011","Erewash 007A","E01019666","Total",629,612,17
"2011","Erewash 007B","E01019667","Total",702,692,10
"2011","Erewash 007C","E01019668","Total",690,673,17
"2011","Erewash 007D","E01019669","Total",702,690,12
"2011","Erewash 008A","E01019656","Total",521,501,20
"2011","Erewash 008B","E01019691","Total",656,642,14
"2011","Erewash 008C","E01019692","Total",682,655,27
"2011","Erewash 008D","E01019693","Total",927,847,80
"2011","Erewash 008E","E01019694","Total",514,496,18
"2011","Erewash 008F","E01019696","Total",613,585,28
"2011","Erewash 009A","E01019683","Total",563,549,14
"2011","Erewash 009B","E01019684","Total",714,694,20
"2011","Erewash 009C","E01019685","Total",693,662,31
"2011","Erewash 009D","E01019686","Total",629,606,23
"2011","Erewash 009E","E01019687","Total",673,664,9
"2011","Erewash 010A","E01019648","Total",671,648,23
"2011","Erewash 010B","E01019649","Total",831,795,36
"2011","Erewash 010C","E01019650","Total",769,748,21
"2011","Erewash 010D","E01019651","Total",638,621,17
"2011","Erewash 010E","E01019695","Total",631,602,29
"2011","Erewash 011A","E01019641","Total",638,620,18
"2011","Erewash 011B","E01019652","Total",661,640,21
"2011","Erewash 011C","E01019653","Total",612,595,17
"2011","Erewash 011D","E01019707","Total",647,635,12
"2011","Erewash 011E","E01019708","Total",651,634,17
"2011","Erewash 012A","E01019647","Total",1075,972,103
"2011","Erewash 012B","E01019675","Total",775,752,23
"2011","Erewash 012C","E01019679","Total",767,742,25
"2011","Erewash 012D","E01019682","Total",850,793,57
"2011","Erewash 013A","E01019642","Total",652,641,11
"2011","Erewash 013B","E01019643","Total",729,709,20
"2011","Erewash 013C","E01019654","Total",730,708,22
"2011","Erewash 013D","E01019655","Total",716,675,41
"2011","Erewash 014A","E01019676","Total",680,653,27
"2011","Erewash 014B","E01019677","Total",654,637,17
"2011","Erewash 014C","E01019678","Total",683,670,13
"2011","Erewash 014D","E01019680","Total",676,653,23
"2011","Erewash 014E","E01019681","Total",694,680,14
"2011","Erewash 014F","E01019698","Total",636,612,24
"2011","Erewash 015A","E01019697","Total",636,624,12
"2011","Erewash 015B","E01019699","Total",739,725,14
"2011","Erewash 015C","E01019700","Total",1036,1006,30
"2011","Erewash 015D","E01019705","Total",822,800,22
"2011","Erewash 015E","E01019706","Total",523,512,11
"2011","Erewash 015F","E01019709","Total",539,527,12
"2011","Erewash 016A","E01019638","Total",525,513,12
"2011","Erewash 016B","E01019639","Total",447,428,19
"2011","Erewash 016C","E01019640","Total",594,586,8
"2011","Erewash 016D","E01019645","Total",733,702,31
"2011","Erewash 016E","E01032614","Total",497,493,4
"2011","High Peak 001A","E01019733","Total",678,650,28
"2011","High Peak 001B","E01019752","Total",575,557,18
"2011","High Peak 001C","E01019753","Total",656,627,29
"2011","High Peak 001D","E01019763","Total",961,917,44
"2011","High Peak 002A","E01019728","Total",524,518,6
"2011","High Peak 002B","E01019729","Total",532,528,4
"2011","High Peak 002C","E01019730","Total",884,850,34
"2011","High Peak 002D","E01019731","Total",499,490,9
"2011","High Peak 002E","E01019732","Total",624,608,16
"2011","High Peak 003A","E01019738","Total",658,614,44
"2011","High Peak 003B","E01019739","Total",887,821,66
"2011","High Peak 003C","E01019740","Total",561,526,35
"2011","High Peak 003D","E01019750","Total",597,577,20
"2011","High Peak 003E","E01019751","Total",922,881,41
"2011","High Peak 003F","E01019768","Total",1084,1044,40
"2011","High Peak 004A","E01019727","Total",786,756,30
"2011","High Peak 004B","E01019749","Total",499,492,7
"2011","High Peak 004C","E01019754","Total",820,774,46
"2011","High Peak 004D","E01019756","Total",648,636,12
"2011","High Peak 004E","E01019757","Total",571,550,21
"2011","High Peak 004F","E01019758","Total",603,587,16
"2011","High Peak 005A","E01019746","Total",728,693,35
"2011","High Peak 005B","E01019747","Total",528,518,10
"2011","High Peak 005C","E01019748","Total",707,665,42
"2011","High Peak 005D","E01019755","Total",885,838,47
"2011","High Peak 005E","E01019766","Total",638,614,24
"2011","High Peak 006A","E01019711","Total",620,593,27
"2011","High Peak 006B","E01019734","Total",960,911,49
"2011","High Peak 006C","E01019743","Total",605,587,18
"2011","High Peak 006D","E01019744","Total",665,645,20
"2011","High Peak 006E","E01019745","Total",506,491,15
"2011","High Peak 008A","E01019712","Total",653,607,46
"2011","High Peak 008B","E01019713","Total",451,429,22
"2011","High Peak 008C","E01019764","Total",687,655,32
"2011","High Peak 008D","E01019765","Total",911,859,52
"2011","High Peak 008E","E01019767","Total",692,666,26
"2011","High Peak 010A","E01019710","Total",957,902,55
"2011","High Peak 010B","E01019715","Total",771,702,69
"2011","High Peak 010C","E01019717","Total",754,678,76
"2011","High Peak 010D","E01019722","Total",767,734,33
"2011","High Peak 010E","E01019723","Total",983,893,90
"2011","High Peak 011A","E01019716","Total",567,547,20
"2011","High Peak 011B","E01019724","Total",544,525,19
"2011","High Peak 011C","E01019759","Total",676,665,11
"2011","High Peak 011D","E01019760","Total",644,625,19
"2011","High Peak 011E","E01019761","Total",591,576,15
"2011","High Peak 012A","E01019714","Total",1056,1016,40
"2011","High Peak 012B","E01019725","Total",601,581,20
"2011","High Peak 012C","E01019726","Total",560,544,16
"2011","High Peak 012D","E01019762","Total",810,771,39
"2011","High Peak 013E","E01019718","Total",998,950,48
"2011","High Peak 013F","E01019719","Total",717,678,39
"2011","High Peak 013G","E01019720","Total",692,663,29
"2011","High Peak 013H","E01019721","Total",480,470,10
"2011","High Peak 013A","E01019735","Total",707,655,52
"2011","High Peak 013B","E01019736","Total",562,504,58
"2011","High Peak 013C","E01019737","Total",604,559,45
"2011","High Peak 013I","E01019741","Total",486,466,20
"2011","High Peak 013D","E01019742","Total",489,468,21
"2011","North East Derbyshire 001A","E01019801","Total",463,459,4
"2011","North East Derbyshire 001B","E01019802","Total",552,546,6
"2011","North East Derbyshire 001C","E01019803","Total",521,516,5
"2011","North East Derbyshire 001D","E01019804","Total",535,528,7
"2011","North East Derbyshire 001E","E01019805","Total",536,534,2
"2011","North East Derbyshire 001F","E01019806","Total",644,641,3
"2011","North East Derbyshire 001G","E01019807","Total",624,621,3
"2011","North East Derbyshire 002A","E01019778","Total",759,754,5
"2011","North East Derbyshire 002B","E01019779","Total",764,750,14
"2011","North East Derbyshire 002C","E01019790","Total",863,850,13
"2011","North East Derbyshire 002D","E01019816","Total",765,757,8
"2011","North East Derbyshire 004A","E01019780","Total",615,610,5
"2011","North East Derbyshire 004B","E01019781","Total",640,630,10
"2011","North East Derbyshire 004C","E01019782","Total",611,605,6
"2011","North East Derbyshire 004D","E01019786","Total",753,739,14
"2011","North East Derbyshire 004E","E01019827","Total",808,803,5
"2011","North East Derbyshire 005A","E01019770","Total",883,837,46
"2011","North East Derbyshire 005B","E01019787","Total",779,771,8
"2011","North East Derbyshire 005C","E01019788","Total",685,677,8
"2011","North East Derbyshire 005D","E01019794","Total",599,595,4
"2011","North East Derbyshire 006A","E01019783","Total",527,520,7
"2011","North East Derbyshire 006B","E01019784","Total",511,504,7
"2011","North East Derbyshire 006C","E01019785","Total",520,516,4
"2011","North East Derbyshire 006D","E01019793","Total",645,638,7
"2011","North East Derbyshire 006E","E01019795","Total",980,958,22
"2011","North East Derbyshire 007A","E01019798","Total",624,603,21
"2011","North East Derbyshire 007B","E01019821","Total",628,608,20
"2011","North East Derbyshire 007C","E01019822","Total",692,678,14
"2011","North East Derbyshire 007D","E01019823","Total",540,525,15
"2011","North East Derbyshire 008A","E01019771","Total",985,956,29
"2011","North East Derbyshire 008B","E01019772","Total",651,635,16
"2011","North East Derbyshire 008C","E01019828","Total",704,682,22
"2011","North East Derbyshire 008D","E01019829","Total",631,621,10
"2011","North East Derbyshire 009A","E01019796","Total",507,490,17
"2011","North East Derbyshire 009B","E01019797","Total",630,598,32
"2011","North East Derbyshire 009C","E01019799","Total",939,901,38
"2011","North East Derbyshire 009D","E01019800","Total",733,704,29
"2011","North East Derbyshire 009E","E01019808","Total",718,697,21
"2011","North East Derbyshire 009F","E01019826","Total",652,637,15
"2011","North East Derbyshire 010A","E01019769","Total",842,798,44
"2011","North East Derbyshire 010B","E01019774","Total",761,738,23
"2011","North East Derbyshire 010C","E01019824","Total",532,516,16
"2011","North East Derbyshire 010D","E01019830","Total",539,524,15
"2011","North East Derbyshire 010E","E01019831","Total",603,587,16
"2011","North East Derbyshire 011A","E01019809","Total",549,534,15
"2011","North East Derbyshire 011B","E01019810","Total",725,697,28
"2011","North East Derbyshire 011C","E01019811","Total",686,673,13
"2011","North East Derbyshire 011D","E01019812","Total",810,781,29
"2011","North East Derbyshire 011E","E01019813","Total",772,746,26
"2011","North East Derbyshire 011F","E01019825","Total",553,547,6
"2011","North East Derbyshire 012A","E01019773","Total",1157,1104,53
"2011","North East Derbyshire 012B","E01019775","Total",834,808,26
"2011","North East Derbyshire 012C","E01019776","Total",649,629,20
"2011","North East Derbyshire 012D","E01019777","Total",1083,1063,20
"2011","North East Derbyshire 013A","E01019814","Total",780,756,24
"2011","North East Derbyshire 013B","E01019817","Total",531,523,8
"2011","North East Derbyshire 013C","E01019818","Total",663,644,19
"2011","North East Derbyshire 013D","E01019819","Total",646,629,17
"2011","North East Derbyshire 013E","E01019820","Total",635,618,17
"2011","North East Derbyshire 014A","E01019791","Total",754,748,6
"2011","North East Derbyshire 014B","E01019792","Total",882,879,3
"2011","North East Derbyshire 014C","E01019815","Total",1101,1091,10
"2011","North East Derbyshire 014D","E01032586","Total",749,743,6
"2011","South Derbyshire 001A","E01019839","Total",705,681,24
"2011","South Derbyshire 001B","E01019845","Total",583,570,13
"2011","South Derbyshire 001C","E01019846","Total",570,553,17
"2011","South Derbyshire 001D","E01019866","Total",918,896,22
"2011","South Derbyshire 002A","E01019840","Total",681,666,15
"2011","South Derbyshire 002B","E01019841","Total",647,636,11
"2011","South Derbyshire 002C","E01019847","Total",608,590,18
"2011","South Derbyshire 002D","E01019848","Total",833,792,41
"2011","South Derbyshire 002F","E01033532","Total",564,554,10
"2011","South Derbyshire 002G","E01033533","Total",608,599,9
"2011","South Derbyshire 002H","E01033534","Total",511,493,18
"2011","South Derbyshire 003A","E01019873","Total",583,573,10
"2011","South Derbyshire 003B","E01019874","Total",602,589,13
"2011","South Derbyshire 003C","E01019875","Total",494,485,9
"2011","South Derbyshire 003D","E01019881","Total",585,573,12
"2011","South Derbyshire 003E","E01019882","Total",699,683,16
"2011","South Derbyshire 004A","E01019832","Total",839,803,36
"2011","South Derbyshire 004B","E01019833","Total",760,746,14
"2011","South Derbyshire 004C","E01019834","Total",666,646,20
"2011","South Derbyshire 004D","E01019835","Total",613,605,8
"2011","South Derbyshire 005A","E01019867","Total",645,618,27
"2011","South Derbyshire 005B","E01019868","Total",688,661,27
"2011","South Derbyshire 005C","E01019869","Total",567,538,29
"2011","South Derbyshire 005D","E01019880","Total",665,655,10
"2011","South Derbyshire 006A","E01019843","Total",719,673,46
"2011","South Derbyshire 006B","E01019853","Total",650,635,15
"2011","South Derbyshire 006C","E01019854","Total",931,860,71
"2011","South Derbyshire 006D","E01019855","Total",674,648,26
"2011","South Derbyshire 007A","E01019844","Total",686,662,24
"2011","South Derbyshire 007B","E01019856","Total",647,638,9
"2011","South Derbyshire 007C","E01019857","Total",490,479,11
"2011","South Derbyshire 007D","E01019858","Total",666,646,20
"2011","South Derbyshire 007E","E01019859","Total",736,716,20
"2011","South Derbyshire 008A","E01019860","Total",517,510,7
"2011","South Derbyshire 008B","E01019861","Total",808,766,42
"2011","South Derbyshire 008C","E01019862","Total",662,645,17
"2011","South Derbyshire 008D","E01019863","Total",766,732,34
"2011","South Derbyshire 008E","E01019864","Total",619,602,17
"2011","South Derbyshire 008F","E01019865","Total",531,520,11
"2011","South Derbyshire 009A","E01019876","Total",840,812,28
"2011","South Derbyshire 009B","E01019877","Total",858,789,69
"2011","South Derbyshire 009C","E01019878","Total",665,654,11
"2011","South Derbyshire 009D","E01019879","Total",768,754,14
"2011","South Derbyshire 011A","E01019850","Total",670,658,12
"2011","South Derbyshire 011B","E01019851","Total",701,673,28
"2011","South Derbyshire 011C","E01019852","Total",779,738,41
"2011","South Derbyshire 011D","E01019870","Total",669,649,20
"2011","South Derbyshire 011E","E01019871","Total",781,750,31
"2011","South Derbyshire 011F","E01019872","Total",866,828,38
"2011","South Derbyshire 012A","E01019837","Total",853,814,39
"2011","South Derbyshire 012B","E01019838","Total",761,734,27
"2011","South Derbyshire 012C","E01033531","Total",707,672,35
"2011","South Derbyshire 012D","E01033536","Total",703,672,31
"2011","South Derbyshire 012E","E01033537","Total",725,703,22
"2011","South Derbyshire 013A","E01019842","Total",685,666,19
"2011","South Derbyshire 013B","E01019883","Total",1304,1206,98
"2011","South Derbyshire 013C","E01019885","Total",752,730,22
"2011","South Derbyshire 013D","E01033535","Total",559,553,6
"2011","Blaby 002A","E01025631","Total",503,491,12
"2011","Blaby 002B","E01025632","Total",477,470,7
"2011","Blaby 002C","E01025633","Total",737,717,20
"2011","Blaby 002D","E01025635","Total",502,483,19
"2011","Blaby 003A","E01025634","Total",544,535,9
"2011","Blaby 003B","E01025638","Total",650,636,14
"2011","Blaby 003C","E01025639","Total",548,533,15
"2011","Blaby 003D","E01025640","Total",681,658,23
"2011","Blaby 003E","E01025645","Total",473,462,11
"2011","Blaby 004A","E01025666","Total",643,628,15
"2011","Blaby 004B","E01025667","Total",498,490,8
"2011","Blaby 004C","E01025668","Total",979,945,34
"2011","Blaby 004D","E01025669","Total",866,840,26
"2011","Blaby 005A","E01025636","Total",629,607,22
"2011","Blaby 005B","E01025637","Total",559,554,5
"2011","Blaby 005C","E01025652","Total",515,505,10
"2011","Blaby 005D","E01025653","Total",684,668,16
"2011","Blaby 005E","E01025654","Total",531,512,19
"2011","Blaby 005F","E01025655","Total",651,619,32
"2011","Blaby 005G","E01025656","Total",510,496,14
"2011","Blaby 006A","E01025625","Total",585,569,16
"2011","Blaby 006B","E01025626","Total",582,567,15
"2011","Blaby 006C","E01025627","Total",936,897,39
"2011","Blaby 006D","E01025651","Total",655,645,10
"2011","Blaby 006E","E01025657","Total",825,808,17
"2011","Blaby 006F","E01025660","Total",695,681,14
"2011","Blaby 007A","E01025641","Total",800,786,14
"2011","Blaby 007B","E01025642","Total",865,841,24
"2011","Blaby 007C","E01025643","Total",648,632,16
"2011","Blaby 007D","E01025649","Total",691,673,18
"2011","Blaby 007E","E01025650","Total",574,570,4
"2011","Blaby 008A","E01025610","Total",669,660,9
"2011","Blaby 008B","E01025611","Total",612,609,3
"2011","Blaby 008C","E01025612","Total",706,691,15
"2011","Blaby 008D","E01025658","Total",755,736,19
"2011","Blaby 008E","E01025659","Total",888,857,31
"2011","Blaby 009A","E01025615","Total",563,557,6
"2011","Blaby 009B","E01025646","Total",765,752,13
"2011","Blaby 009C","E01025647","Total",727,712,15
"2011","Blaby 009D","E01025648","Total",742,732,10
"2011","Blaby 010A","E01025613","Total",640,619,21
"2011","Blaby 010B","E01025614","Total",703,696,7
"2011","Blaby 010C","E01025620","Total",488,470,18
"2011","Blaby 010D","E01025621","Total",460,448,12
"2011","Blaby 010E","E01025644","Total",574,569,5
"2011","Blaby 011A","E01025616","Total",667,638,29
"2011","Blaby 011B","E01025617","Total",748,731,17
"2011","Blaby 011C","E01025618","Total",752,735,17
"2011","Blaby 011D","E01025619","Total",702,693,9
"2011","Blaby 012A","E01025661","Total",691,678,13
"2011","Blaby 012B","E01025662","Total",717,698,19
"2011","Blaby 012C","E01025663","Total",603,582,21
"2011","Blaby 012D","E01025664","Total",552,544,8
"2011","Blaby 012E","E01025665","Total",676,644,32
"2011","Blaby 013A","E01025622","Total",781,760,21
"2011","Blaby 013B","E01025623","Total",724,680,44
"2011","Blaby 013C","E01025624","Total",691,685,6
"2011","Blaby 013D","E01025629","Total",666,648,18
"2011","Blaby 013E","E01025630","Total",712,695,17
"2011","Blaby 013F","E01032603","Total",661,649,12
"2011","Charnwood 001B","E01025692","Total",820,808,12
"2011","Charnwood 001C","E01025693","Total",878,849,29
"2011","Charnwood 001E","E01033386","Total",979,943,36
"2011","Charnwood 002A","E01025699","Total",938,813,125
"2011","Charnwood 002B","E01025700","Total",798,735,63
"2011","Charnwood 002C","E01025701","Total",728,676,52
"2011","Charnwood 002D","E01025703","Total",917,842,75
"2011","Charnwood 002E","E01025704","Total",634,587,47
"2011","Charnwood 002F","E01025705","Total",575,520,55
"2011","Charnwood 002G","E01025706","Total",783,752,31
"2011","Charnwood 003A","E01025720","Total",753,680,73
"2011","Charnwood 003B","E01025721","Total",594,565,29
"2011","Charnwood 003C","E01025722","Total",436,421,15
"2011","Charnwood 003D","E01025723","Total",687,616,71
"2011","Charnwood 003E","E01025724","Total",640,561,79
"2011","Charnwood 003F","E01025725","Total",661,606,55
"2011","Charnwood 004A","E01025695","Total",679,662,17
"2011","Charnwood 004B","E01025696","Total",550,541,9
"2011","Charnwood 004C","E01025697","Total",708,686,22
"2011","Charnwood 004D","E01025698","Total",669,651,18
"2011","Charnwood 005A","E01025744","Total",784,772,12
"2011","Charnwood 005B","E01025745","Total",651,635,16
"2011","Charnwood 005C","E01025746","Total",848,777,71
"2011","Charnwood 005D","E01025747","Total",816,796,20
"2011","Charnwood 006A","E01025740","Total",715,688,27
"2011","Charnwood 006B","E01025741","Total",655,643,12
"2011","Charnwood 006C","E01025742","Total",691,671,20
"2011","Charnwood 006D","E01025743","Total",852,811,41
"2011","Charnwood 007A","E01025689","Total",796,757,39
"2011","Charnwood 007B","E01025690","Total",571,538,33
"2011","Charnwood 007C","E01025707","Total",583,558,25
"2011","Charnwood 007D","E01025709","Total",491,475,16
"2011","Charnwood 008A","E01025760","Total",570,544,26
"2011","Charnwood 008B","E01025761","Total",742,721,21
"2011","Charnwood 008C","E01025768","Total",607,582,25
"2011","Charnwood 008D","E01025769","Total",591,574,17
"2011","Charnwood 009A","E01025702","Total",538,527,11
"2011","Charnwood 009B","E01025715","Total",632,599,33
"2011","Charnwood 009C","E01025716","Total",631,616,15
"2011","Charnwood 009D","E01025717","Total",832,807,25
"2011","Charnwood 009E","E01025718","Total",722,674,48
"2011","Charnwood 009F","E01025719","Total",634,601,33
"2011","Charnwood 010A","E01025708","Total",541,519,22
"2011","Charnwood 010B","E01025710","Total",524,502,22
"2011","Charnwood 010C","E01025711","Total",652,645,7
"2011","Charnwood 010D","E01025712","Total",623,599,24
"2011","Charnwood 010E","E01025713","Total",499,482,17
"2011","Charnwood 010F","E01025714","Total",812,795,17
"2011","Charnwood 011A","E01025674","Total",658,646,12
"2011","Charnwood 011B","E01025675","Total",682,670,12
"2011","Charnwood 011C","E01025676","Total",894,841,53
"2011","Charnwood 011D","E01025677","Total",624,609,15
"2011","Charnwood 012A","E01025732","Total",667,651,16
"2011","Charnwood 012B","E01025733","Total",732,712,20
"2011","Charnwood 012C","E01025734","Total",655,637,18
"2011","Charnwood 012D","E01025735","Total",915,873,42
"2011","Charnwood 013A","E01025748","Total",957,918,39
"2011","Charnwood 013B","E01025749","Total",638,625,13
"2011","Charnwood 013C","E01025750","Total",614,602,12
"2011","Charnwood 013D","E01025751","Total",936,891,45
"2011","Charnwood 014A","E01025726","Total",809,793,16
"2011","Charnwood 014B","E01025727","Total",698,680,18
"2011","Charnwood 014C","E01025728","Total",758,748,10
"2011","Charnwood 014D","E01025729","Total",669,665,4
"2011","Charnwood 014E","E01025737","Total",777,750,27
"2011","Charnwood 014F","E01025739","Total",686,645,41
"2011","Charnwood 015A","E01025685","Total",549,542,7
"2011","Charnwood 015B","E01025686","Total",546,542,4
"2011","Charnwood 015C","E01025730","Total",687,662,25
"2011","Charnwood 015D","E01025731","Total",656,644,12
"2011","Charnwood 016A","E01025687","Total",734,682,52
"2011","Charnwood 016B","E01025688","Total",698,665,33
"2011","Charnwood 016C","E01025736","Total",640,624,16
"2011","Charnwood 016D","E01025738","Total",594,575,19
"2011","Charnwood 017A","E01025756","Total",899,855,44
"2011","Charnwood 017B","E01025757","Total",565,550,15
"2011","Charnwood 017C","E01025758","Total",665,651,14
"2011","Charnwood 017D","E01025759","Total",749,722,27
"2011","Charnwood 018A","E01025752","Total",856,800,56
"2011","Charnwood 018B","E01025753","Total",712,688,24
"2011","Charnwood 018C","E01025754","Total",530,522,8
"2011","Charnwood 018D","E01025755","Total",635,617,18
"2011","Charnwood 019A","E01025679","Total",1031,989,42
"2011","Charnwood 019B","E01025680","Total",670,656,14
"2011","Charnwood 019C","E01025681","Total",690,662,28
"2011","Charnwood 019D","E01025682","Total",646,637,9
"2011","Charnwood 020A","E01025678","Total",678,652,26
"2011","Charnwood 020B","E01025683","Total",683,674,9
"2011","Charnwood 020C","E01025684","Total",807,772,35
"2011","Charnwood 021A","E01025762","Total",670,647,23
"2011","Charnwood 021B","E01025763","Total",733,715,18
"2011","Charnwood 021C","E01025764","Total",520,504,16
"2011","Charnwood 021D","E01025765","Total",621,606,15
"2011","Charnwood 021E","E01025766","Total",888,859,29
"2011","Charnwood 021F","E01025767","Total",639,613,26
"2011","Charnwood 022A","E01025670","Total",544,534,10
"2011","Charnwood 022B","E01025671","Total",797,769,28
"2011","Charnwood 022C","E01025672","Total",759,739,20
"2011","Charnwood 022D","E01025673","Total",815,769,46
"2011","Harborough 002A","E01025770","Total",841,803,38
"2011","Harborough 002B","E01025809","Total",958,930,28
"2011","Harborough 002C","E01025815","Total",877,848,29
"2011","Harborough 003A","E01025781","Total",617,600,17
"2011","Harborough 003B","E01025782","Total",632,617,15
"2011","Harborough 003C","E01025783","Total",626,611,15
"2011","Harborough 003D","E01025785","Total",940,902,38
"2011","Harborough 003E","E01025786","Total",696,678,18
"2011","Harborough 003F","E01025787","Total",746,720,26
"2011","Harborough 004A","E01025772","Total",897,880,17
"2011","Harborough 004B","E01025773","Total",531,525,6
"2011","Harborough 004C","E01025774","Total",481,474,7
"2011","Harborough 004D","E01025775","Total",784,769,15
"2011","Harborough 004E","E01025776","Total",781,774,7
"2011","Harborough 005A","E01025771","Total",1062,1026,36
"2011","Harborough 005B","E01025778","Total",817,801,16
"2011","Harborough 005C","E01025779","Total",634,623,11
"2011","Harborough 005D","E01025780","Total",531,524,7
"2011","Harborough 005E","E01025784","Total",548,531,17
"2011","Harborough 005F","E01025788","Total",493,465,28
"2011","Harborough 006A","E01025777","Total",940,910,30
"2011","Harborough 006B","E01025808","Total",1066,1031,35
"2011","Harborough 006C","E01025810","Total",943,919,24
"2011","Harborough 006D","E01025816","Total",904,889,15
"2011","Harborough 007A","E01025789","Total",487,476,11
"2011","Harborough 007B","E01025794","Total",742,724,18
"2011","Harborough 007C","E01025797","Total",732,713,19
"2011","Harborough 007D","E01025802","Total",643,617,26
"2011","Harborough 007E","E01025803","Total",588,582,6
"2011","Harborough 007F","E01025805","Total",672,661,11
"2011","Harborough 008A","E01025795","Total",898,848,50
"2011","Harborough 008B","E01025796","Total",892,862,30
"2011","Harborough 008C","E01025801","Total",659,618,41
"2011","Harborough 008D","E01025806","Total",709,680,29
"2011","Harborough 009A","E01025798","Total",875,839,36
"2011","Harborough 009B","E01025799","Total",709,704,5
"2011","Harborough 009C","E01025800","Total",709,538,171
"2011","Harborough 009D","E01025804","Total",869,842,27
"2011","Harborough 009E","E01025807","Total",621,595,26
"2011","Harborough 010A","E01025790","Total",936,921,15
"2011","Harborough 010B","E01025791","Total",970,937,33
"2011","Harborough 010C","E01025792","Total",1135,1095,40
"2011","Harborough 010D","E01025793","Total",1006,987,19
"2011","Harborough 011A","E01025812","Total",753,728,25
"2011","Harborough 011B","E01025813","Total",624,598,26
"2011","Harborough 011C","E01025814","Total",641,622,19
"2011","Harborough 011D","E01032598","Total",895,861,34
"2011","Hinckley and Bosworth 001A","E01025868","Total",681,663,18
"2011","Hinckley and Bosworth 001B","E01025869","Total",770,750,20
"2011","Hinckley and Bosworth 001C","E01025870","Total",623,597,26
"2011","Hinckley and Bosworth 001D","E01025871","Total",534,524,10
"2011","Hinckley and Bosworth 001E","E01025878","Total",1072,1034,38
"2011","Hinckley and Bosworth 002A","E01025846","Total",837,821,16
"2011","Hinckley and Bosworth 002B","E01025847","Total",665,654,11
"2011","Hinckley and Bosworth 002C","E01025848","Total",728,708,20
"2011","Hinckley and Bosworth 003A","E01025845","Total",660,642,18
"2011","Hinckley and Bosworth 003B","E01025877","Total",745,728,17
"2011","Hinckley and Bosworth 003C","E01025879","Total",534,525,9
"2011","Hinckley and Bosworth 003D","E01025880","Total",652,637,15
"2011","Hinckley and Bosworth 004A","E01025819","Total",727,710,17
"2011","Hinckley and Bosworth 004B","E01025820","Total",685,657,28
"2011","Hinckley and Bosworth 004C","E01025837","Total",859,834,25
"2011","Hinckley and Bosworth 004D","E01025838","Total",699,671,28
"2011","Hinckley and Bosworth 004E","E01025882","Total",715,690,25
"2011","Hinckley and Bosworth 005A","E01025872","Total",674,653,21
"2011","Hinckley and Bosworth 005B","E01025873","Total",677,651,26
"2011","Hinckley and Bosworth 005C","E01025874","Total",686,674,12
"2011","Hinckley and Bosworth 005D","E01025875","Total",673,658,15
"2011","Hinckley and Bosworth 005E","E01025876","Total",770,742,28
"2011","Hinckley and Bosworth 006A","E01025839","Total",744,698,46
"2011","Hinckley and Bosworth 006B","E01025840","Total",720,685,35
"2011","Hinckley and Bosworth 006C","E01025841","Total",823,763,60
"2011","Hinckley and Bosworth 006D","E01025842","Total",788,764,24
"2011","Hinckley and Bosworth 006E","E01025843","Total",767,729,38
"2011","Hinckley and Bosworth 006F","E01025844","Total",772,751,21
"2011","Hinckley and Bosworth 007A","E01025821","Total",882,796,86
"2011","Hinckley and Bosworth 007B","E01025822","Total",672,654,18
"2011","Hinckley and Bosworth 007C","E01025823","Total",662,639,23
"2011","Hinckley and Bosworth 007D","E01025824","Total",641,629,12
"2011","Hinckley and Bosworth 007E","E01025825","Total",620,607,13
"2011","Hinckley and Bosworth 007F","E01025826","Total",593,583,10
"2011","Hinckley and Bosworth 008A","E01025817","Total",852,834,18
"2011","Hinckley and Bosworth 008B","E01025818","Total",578,557,21
"2011","Hinckley and Bosworth 008C","E01025864","Total",652,639,13
"2011","Hinckley and Bosworth 008D","E01025881","Total",632,616,16
"2011","Hinckley and Bosworth 009A","E01025859","Total",590,579,11
"2011","Hinckley and Bosworth 009B","E01025860","Total",547,543,4
"2011","Hinckley and Bosworth 009C","E01025861","Total",772,748,24
"2011","Hinckley and Bosworth 009D","E01025862","Total",666,655,11
"2011","Hinckley and Bosworth 010A","E01025850","Total",655,626,29
"2011","Hinckley and Bosworth 010B","E01025852","Total",943,856,87
"2011","Hinckley and Bosworth 010C","E01025858","Total",950,905,45
"2011","Hinckley and Bosworth 010D","E01025863","Total",726,708,18
"2011","Hinckley and Bosworth 010E","E01025865","Total",798,775,23
"2011","Hinckley and Bosworth 011A","E01025853","Total",1186,1152,34
"2011","Hinckley and Bosworth 011B","E01025854","Total",737,726,11
"2011","Hinckley and Bosworth 011C","E01025855","Total",615,598,17
"2011","Hinckley and Bosworth 011D","E01025866","Total",746,717,29
"2011","Hinckley and Bosworth 011E","E01025867","Total",678,665,13
"2011","Hinckley and Bosworth 012A","E01025849","Total",844,795,49
"2011","Hinckley and Bosworth 012B","E01025851","Total",535,521,14
"2011","Hinckley and Bosworth 012C","E01025856","Total",675,649,26
"2011","Hinckley and Bosworth 012D","E01025857","Total",612,599,13
"2011","Hinckley and Bosworth 013A","E01025827","Total",725,701,24
"2011","Hinckley and Bosworth 013B","E01025828","Total",637,617,20
"2011","Hinckley and Bosworth 013C","E01025829","Total",672,643,29
"2011","Hinckley and Bosworth 013D","E01025830","Total",686,658,28
"2011","Hinckley and Bosworth 014A","E01025831","Total",615,602,13
"2011","Hinckley and Bosworth 014B","E01025832","Total",629,614,15
"2011","Hinckley and Bosworth 014C","E01025833","Total",697,673,24
"2011","Hinckley and Bosworth 014D","E01025834","Total",626,609,17
"2011","Hinckley and Bosworth 014E","E01025835","Total",729,715,14
"2011","Hinckley and Bosworth 014F","E01025836","Total",571,561,10
"2011","Melton 001A","E01025885","Total",750,738,12
"2011","Melton 001B","E01025886","Total",846,815,31
"2011","Melton 001C","E01025887","Total",830,791,39
"2011","Melton 001D","E01025890","Total",555,538,17
"2011","Melton 001E","E01025891","Total",565,545,20
"2011","Melton 001F","E01025892","Total",684,660,24
"2011","Melton 002A","E01025901","Total",810,793,17
"2011","Melton 002B","E01025902","Total",714,705,9
"2011","Melton 002C","E01025903","Total",863,837,26
"2011","Melton 002D","E01025904","Total",852,832,20
"2011","Melton 002E","E01025906","Total",659,648,11
"2011","Melton 003A","E01025883","Total",723,702,21
"2011","Melton 003B","E01025884","Total",767,752,15
"2011","Melton 003C","E01025888","Total",776,739,37
"2011","Melton 003D","E01025909","Total",840,808,32
"2011","Melton 004A","E01025896","Total",671,660,11
"2011","Melton 004B","E01025897","Total",978,941,37
"2011","Melton 004C","E01025898","Total",559,529,30
"2011","Melton 004D","E01025899","Total",519,489,30
"2011","Melton 004E","E01025900","Total",637,626,11
"2011","Melton 004F","E01025905","Total",741,716,25
"2011","Melton 005A","E01025893","Total",873,859,14
"2011","Melton 005B","E01025894","Total",852,804,48
"2011","Melton 005C","E01025895","Total",757,740,17
"2011","Melton 005D","E01025907","Total",719,696,23
"2011","Melton 005E","E01025908","Total",761,738,23
"2011","Melton 006A","E01025889","Total",753,720,33
"2011","Melton 006B","E01025910","Total",792,759,33
"2011","Melton 006C","E01025911","Total",668,644,24
"2011","Melton 006D","E01025912","Total",698,666,32
"2011","North West Leicestershire 001A","E01025924","Total",478,450,28
"2011","North West Leicestershire 001B","E01025925","Total",1258,1190,68
"2011","North West Leicestershire 001C","E01025926","Total",670,649,21
"2011","North West Leicestershire 001D","E01025927","Total",680,669,11
"2011","North West Leicestershire 001E","E01025928","Total",632,618,14
"2011","North West Leicestershire 002A","E01025923","Total",607,590,17
"2011","North West Leicestershire 002B","E01025944","Total",649,625,24
"2011","North West Leicestershire 002C","E01025945","Total",689,666,23
"2011","North West Leicestershire 002D","E01025946","Total",758,717,41
"2011","North West Leicestershire 003A","E01025915","Total",571,553,18
"2011","North West Leicestershire 003B","E01025916","Total",673,652,21
"2011","North West Leicestershire 003C","E01025917","Total",894,854,40
"2011","North West Leicestershire 003D","E01025918","Total",715,693,22
"2011","North West Leicestershire 004A","E01025960","Total",631,621,10
"2011","North West Leicestershire 004B","E01025961","Total",662,640,22
"2011","North West Leicestershire 004C","E01025962","Total",606,594,12
"2011","North West Leicestershire 004D","E01025965","Total",602,583,19
"2011","North West Leicestershire 005A","E01025955","Total",587,576,11
"2011","North West Leicestershire 005B","E01025956","Total",506,484,22
"2011","North West Leicestershire 005C","E01025963","Total",642,624,18
"2011","North West Leicestershire 005D","E01025964","Total",674,661,13
"2011","North West Leicestershire 006A","E01025914","Total",540,531,9
"2011","North West Leicestershire 006B","E01025919","Total",610,589,21
"2011","North West Leicestershire 006C","E01025920","Total",674,657,17
"2011","North West Leicestershire 006D","E01025921","Total",753,721,32
"2011","North West Leicestershire 007A","E01025966","Total",662,643,19
"2011","North West Leicestershire 007B","E01025967","Total",744,736,8
"2011","North West Leicestershire 007C","E01025968","Total",801,778,23
"2011","North West Leicestershire 007D","E01025969","Total",838,809,29
"2011","North West Leicestershire 008A","E01025950","Total",753,731,22
"2011","North West Leicestershire 008B","E01025951","Total",705,691,14
"2011","North West Leicestershire 008C","E01025952","Total",673,650,23
"2011","North West Leicestershire 008D","E01025953","Total",496,468,28
"2011","North West Leicestershire 008E","E01025954","Total",618,605,13
"2011","North West Leicestershire 009A","E01025932","Total",556,541,15
"2011","North West Leicestershire 009B","E01025933","Total",541,538,3
"2011","North West Leicestershire 009C","E01025934","Total",693,646,47
"2011","North West Leicestershire 009D","E01025935","Total",555,544,11
"2011","North West Leicestershire 009E","E01025936","Total",596,559,37
"2011","North West Leicestershire 010A","E01025929","Total",849,833,16
"2011","North West Leicestershire 010B","E01025930","Total",783,727,56
"2011","North West Leicestershire 010C","E01025931","Total",833,789,44
"2011","North West Leicestershire 010D","E01025957","Total",813,776,37
"2011","North West Leicestershire 011B","E01025937","Total",677,668,9
"2011","North West Leicestershire 011C","E01025958","Total",673,652,21
"2011","North West Leicestershire 011D","E01025959","Total",896,874,22
"2011","North West Leicestershire 011E","E01033102","Total",663,649,14
"2011","North West Leicestershire 011F","E01033103","Total",650,638,12
"2011","North West Leicestershire 012A","E01025913","Total",950,918,32
"2011","North West Leicestershire 012B","E01025947","Total",772,758,14
"2011","North West Leicestershire 012C","E01025948","Total",692,676,16
"2011","North West Leicestershire 012D","E01025949","Total",751,722,29
"2011","North West Leicestershire 013A","E01025938","Total",547,532,15
"2011","North West Leicestershire 013B","E01025939","Total",843,794,49
"2011","North West Leicestershire 013C","E01025940","Total",866,837,29
"2011","North West Leicestershire 013D","E01025941","Total",677,630,47
"2011","North West Leicestershire 013E","E01025942","Total",707,698,9
"2011","North West Leicestershire 013F","E01025943","Total",838,811,27
"2011","Oadby and Wigston 003A","E01025970","Total",516,507,9
"2011","Oadby and Wigston 003B","E01025971","Total",502,478,24
"2011","Oadby and Wigston 003C","E01025972","Total",482,461,21
"2011","Oadby and Wigston 003D","E01025976","Total",609,575,34
"2011","Oadby and Wigston 003E","E01025977","Total",692,605,87
"2011","Oadby and Wigston 003F","E01025978","Total",746,684,62
"2011","Oadby and Wigston 005A","E01025992","Total",818,745,73
"2011","Oadby and Wigston 005B","E01025994","Total",621,578,43
"2011","Oadby and Wigston 005C","E01025997","Total",600,578,22
"2011","Oadby and Wigston 005D","E01025999","Total",671,625,46
"2011","Oadby and Wigston 005E","E01026005","Total",739,719,20
"2011","Oadby and Wigston 006A","E01025985","Total",610,589,21
"2011","Oadby and Wigston 006B","E01025986","Total",638,607,31
"2011","Oadby and Wigston 006C","E01025987","Total",700,633,67
"2011","Oadby and Wigston 006D","E01025988","Total",718,681,37
"2011","Oadby and Wigston 006E","E01025989","Total",792,746,46
"2011","Oadby and Wigston 007A","E01025990","Total",619,600,19
"2011","Oadby and Wigston 007B","E01025991","Total",597,573,24
"2011","Oadby and Wigston 007C","E01025993","Total",594,576,18
"2011","Oadby and Wigston 007D","E01025998","Total",770,742,28
"2011","Oadby and Wigston 007E","E01026000","Total",547,532,15
"2011","Oadby and Wigston 007F","E01026001","Total",612,590,22
"2011","Oadby and Wigston 008A","E01025995","Total",613,581,32
"2011","Oadby and Wigston 008B","E01026003","Total",674,651,23
"2011","Oadby and Wigston 008C","E01026004","Total",700,682,18
"2011","Oadby and Wigston 008D","E01032600","Total",827,794,33
"2011","Oadby and Wigston 008E","E01032601","Total",586,569,17
"2011","Oadby and Wigston 009A","E01025973","Total",499,474,25
"2011","Oadby and Wigston 009B","E01025974","Total",608,565,43
"2011","Oadby and Wigston 009C","E01025975","Total",528,503,25
"2011","Oadby and Wigston 009E","E01025979","Total",514,490,24
"2011","Oadby and Wigston 009D","E01025980","Total",475,449,26
"2011","Oadby and Wigston 009F","E01025981","Total",628,589,39
"2011","Oadby and Wigston 009G","E01025982","Total",628,607,21
"2011","Oadby and Wigston 009H","E01025983","Total",511,479,32
"2011","Oadby and Wigston 009I","E01025984","Total",498,482,16
"2011","Boston 001A","E01026007","Total",499,474,25
"2011","Boston 001B","E01026008","Total",565,527,38
"2011","Boston 001C","E01026009","Total",538,516,22
"2011","Boston 001D","E01026023","Total",620,589,31
"2011","Boston 001E","E01026024","Total",887,829,58
"2011","Boston 002A","E01026010","Total",659,631,28
"2011","Boston 002B","E01026011","Total",1155,1111,44
"2011","Boston 002C","E01026030","Total",1019,994,25
"2011","Boston 002D","E01026032","Total",818,784,34
"2011","Boston 002E","E01026037","Total",624,599,25
"2011","Boston 003A","E01026006","Total",1263,1149,114
"2011","Boston 003B","E01026021","Total",797,767,30
"2011","Boston 003C","E01026025","Total",1042,988,54
"2011","Boston 003D","E01026036","Total",740,687,53
"2011","Boston 004A","E01026012","Total",558,549,9
"2011","Boston 004B","E01026015","Total",657,643,14
"2011","Boston 004C","E01026026","Total",834,819,15
"2011","Boston 004D","E01026027","Total",774,761,13
"2011","Boston 004E","E01026028","Total",874,851,23
"2011","Boston 006A","E01026016","Total",1023,987,36
"2011","Boston 006B","E01026033","Total",813,789,24
"2011","Boston 006C","E01026034","Total",821,793,28
"2011","Boston 007A","E01026017","Total",714,691,23
"2011","Boston 007B","E01026018","Total",745,715,30
"2011","Boston 007C","E01026019","Total",1189,1161,28
"2011","Boston 007D","E01026020","Total",977,926,51
"2011","Boston 007E","E01026041","Total",622,613,9
"2011","Boston 008A","E01026013","Total",642,625,17
"2011","Boston 008B","E01026014","Total",831,799,32
"2011","Boston 008C","E01026022","Total",891,867,24
"2011","Boston 008D","E01026038","Total",582,573,9
"2011","Boston 008E","E01026040","Total",509,497,12
"2011","Boston 009A","E01026029","Total",1043,1007,36
"2011","Boston 009B","E01026031","Total",633,618,15
"2011","Boston 009C","E01026035","Total",893,869,24
"2011","Boston 009D","E01026039","Total",506,493,13
"2011","East Lindsey 001A","E01026045","Total",901,861,40
"2011","East Lindsey 001B","E01026061","Total",509,503,6
"2011","East Lindsey 001C","E01026062","Total",538,525,13
"2011","East Lindsey 001D","E01026063","Total",567,555,12
"2011","East Lindsey 001E","E01026080","Total",893,853,40
"2011","East Lindsey 001F","E01026106","Total",515,500,15
"2011","East Lindsey 001G","E01026107","Total",509,484,25
"2011","East Lindsey 002A","E01026058","Total",949,913,36
"2011","East Lindsey 002B","E01026076","Total",988,932,56
"2011","East Lindsey 002C","E01026079","Total",890,843,47
"2011","East Lindsey 003A","E01026077","Total",512,503,9
"2011","East Lindsey 003B","E01026078","Total",484,472,12
"2011","East Lindsey 003C","E01026087","Total",502,490,12
"2011","East Lindsey 003D","E01026088","Total",555,548,7
"2011","East Lindsey 003E","E01026090","Total",625,610,15
"2011","East Lindsey 003F","E01026091","Total",490,477,13
"2011","East Lindsey 003G","E01026108","Total",1085,1051,34
"2011","East Lindsey 004A","E01026081","Total",1241,1175,66
"2011","East Lindsey 004C","E01026089","Total",1018,971,47
"2011","East Lindsey 004D","E01032986","Total",626,593,33
"2011","East Lindsey 004E","E01032987","Total",670,640,30
"2011","East Lindsey 005A","E01026072","Total",949,888,61
"2011","East Lindsey 005B","E01026073","Total",1032,943,89
"2011","East Lindsey 005C","E01026074","Total",1082,966,116
"2011","East Lindsey 005D","E01026099","Total",968,889,79
"2011","East Lindsey 006A","E01026103","Total",1127,1009,118
"2011","East Lindsey 006B","E01026104","Total",1221,1086,135
"2011","East Lindsey 006C","E01026109","Total",1308,1149,159
"2011","East Lindsey 007A","E01026071","Total",1003,951,52
"2011","East Lindsey 007B","E01026082","Total",1084,1003,81
"2011","East Lindsey 007C","E01026121","Total",1152,1105,47
"2011","East Lindsey 008A","E01026042","Total",719,672,47
"2011","East Lindsey 008B","E01026043","Total",751,720,31
"2011","East Lindsey 008C","E01026044","Total",645,587,58
"2011","East Lindsey 008D","E01026113","Total",968,886,82
"2011","East Lindsey 008E","E01026117","Total",830,778,52
"2011","East Lindsey 009A","E01026060","Total",603,565,38
"2011","East Lindsey 009B","E01026068","Total",1011,942,69
"2011","East Lindsey 009C","E01026070","Total",885,837,48
"2011","East Lindsey 009D","E01026105","Total",1033,959,74
"2011","East Lindsey 010A","E01026048","Total",877,756,121
"2011","East Lindsey 010B","E01026049","Total",848,727,121
"2011","East Lindsey 010C","E01026050","Total",874,798,76
"2011","East Lindsey 010D","E01026069","Total",1063,978,85
"2011","East Lindsey 011A","E01026064","Total",680,654,26
"2011","East Lindsey 011B","E01026065","Total",855,828,27
"2011","East Lindsey 011C","E01026066","Total",908,876,32
"2011","East Lindsey 011D","E01026067","Total",1003,933,70
"2011","East Lindsey 012A","E01026084","Total",769,683,86
"2011","East Lindsey 012B","E01026085","Total",1149,1094,55
"2011","East Lindsey 012C","E01026115","Total",858,802,56
"2011","East Lindsey 012D","E01026116","Total",767,713,54
"2011","East Lindsey 013A","E01026046","Total",565,531,34
"2011","East Lindsey 013B","E01026047","Total",631,588,43
"2011","East Lindsey 013C","E01026055","Total",511,485,26
"2011","East Lindsey 013D","E01026059","Total",470,452,18
"2011","East Lindsey 013E","E01026100","Total",862,808,54
"2011","East Lindsey 013F","E01026101","Total",628,590,38
"2011","East Lindsey 014A","E01026092","Total",692,630,62
"2011","East Lindsey 014B","E01026093","Total",1044,852,192
"2011","East Lindsey 014C","E01026095","Total",601,483,118
"2011","East Lindsey 014D","E01026114","Total",845,730,115
"2011","East Lindsey 015A","E01026083","Total",815,795,20
"2011","East Lindsey 015B","E01026094","Total",875,836,39
"2011","East Lindsey 015C","E01026096","Total",658,614,44
"2011","East Lindsey 015D","E01026097","Total",812,771,41
"2011","East Lindsey 016A","E01026051","Total",545,525,20
"2011","East Lindsey 016B","E01026052","Total",746,644,102
"2011","East Lindsey 016C","E01026053","Total",850,763,87
"2011","East Lindsey 016D","E01026054","Total",774,725,49
"2011","East Lindsey 016E","E01026118","Total",808,777,31
"2011","East Lindsey 016F","E01026119","Total",528,502,26
"2011","East Lindsey 016G","E01026120","Total",729,663,66
"2011","East Lindsey 017A","E01026056","Total",509,474,35
"2011","East Lindsey 017B","E01026110","Total",682,644,38
"2011","East Lindsey 017C","E01026111","Total",677,652,25
"2011","East Lindsey 017D","E01026112","Total",553,502,51
"2011","East Lindsey 018A","E01026057","Total",886,825,61
"2011","East Lindsey 018B","E01026075","Total",982,927,55
"2011","East Lindsey 018C","E01026098","Total",915,880,35
"2011","East Lindsey 018D","E01026102","Total",988,946,42
"2011","Lincoln 001A","E01026149","Total",826,791,35
"2011","Lincoln 001B","E01026150","Total",841,766,75
"2011","Lincoln 001C","E01026166","Total",558,537,21
"2011","Lincoln 001D","E01026168","Total",630,616,14
"2011","Lincoln 002A","E01026153","Total",1136,1090,46
"2011","Lincoln 002B","E01026155","Total",773,744,29
"2011","Lincoln 002C","E01026157","Total",650,628,22
"2011","Lincoln 002D","E01026165","Total",736,715,21
"2011","Lincoln 003A","E01026125","Total",539,500,39
"2011","Lincoln 003B","E01026144","Total",666,628,38
"2011","Lincoln 003C","E01026147","Total",1061,1025,36
"2011","Lincoln 003D","E01026148","Total",1062,936,126
"2011","Lincoln 003E","E01026151","Total",895,835,60
"2011","Lincoln 003F","E01026164","Total",578,558,20
"2011","Lincoln 003G","E01026167","Total",877,775,102
"2011","Lincoln 004A","E01026122","Total",901,749,152
"2011","Lincoln 004B","E01026123","Total",1074,1009,65
"2011","Lincoln 004C","E01026124","Total",746,645,101
"2011","Lincoln 004D","E01026126","Total",917,852,65
"2011","Lincoln 004E","E01026152","Total",592,565,27
"2011","Lincoln 004F","E01026154","Total",525,512,13
"2011","Lincoln 004G","E01026156","Total",496,474,22
"2011","Lincoln 005A","E01026132","Total",894,784,110
"2011","Lincoln 005B","E01026143","Total",831,711,120
"2011","Lincoln 005C","E01026145","Total",660,619,41
"2011","Lincoln 005D","E01026146","Total",814,726,88
"2011","Lincoln 006A","E01026134","Total",820,764,56
"2011","Lincoln 006B","E01026176","Total",1084,890,194
"2011","Lincoln 006C","E01026177","Total",907,777,130
"2011","Lincoln 006D","E01026178","Total",863,771,92
"2011","Lincoln 007A","E01026127","Total",660,639,21
"2011","Lincoln 007B","E01026128","Total",1222,1185,37
"2011","Lincoln 007C","E01026129","Total",747,705,42
"2011","Lincoln 007D","E01026131","Total",620,597,23
"2011","Lincoln 008A","E01026133","Total",1098,995,103
"2011","Lincoln 008B","E01026135","Total",714,676,38
"2011","Lincoln 008C","E01026136","Total",638,616,22
"2011","Lincoln 008D","E01026174","Total",680,604,76
"2011","Lincoln 009A","E01026130","Total",613,588,25
"2011","Lincoln 009B","E01026158","Total",674,648,26
"2011","Lincoln 009C","E01026159","Total",667,643,24
"2011","Lincoln 009D","E01026160","Total",632,606,26
"2011","Lincoln 009E","E01026162","Total",653,621,32
"2011","Lincoln 009F","E01026163","Total",621,602,19
"2011","Lincoln 010A","E01026161","Total",689,675,14
"2011","Lincoln 010B","E01026170","Total",615,591,24
"2011","Lincoln 010C","E01026172","Total",591,575,16
"2011","Lincoln 010D","E01026173","Total",717,697,20
"2011","Lincoln 010E","E01026175","Total",970,883,87
"2011","Lincoln 011A","E01026137","Total",476,465,11
"2011","Lincoln 011B","E01026138","Total",627,618,9
"2011","Lincoln 011C","E01026139","Total",558,496,62
"2011","Lincoln 011D","E01026140","Total",640,624,16
"2011","Lincoln 011E","E01026141","Total",564,557,7
"2011","Lincoln 011F","E01026142","Total",517,508,9
"2011","Lincoln 011G","E01026169","Total",779,752,27
"2011","Lincoln 011H","E01026171","Total",689,667,22
"2011","North Kesteven 001A","E01026186","Total",708,690,18
"2011","North Kesteven 001B","E01026187","Total",771,750,21
"2011","North Kesteven 001C","E01026189","Total",831,809,22
"2011","North Kesteven 001D","E01026203","Total",835,802,33
"2011","North Kesteven 001E","E01026204","Total",753,738,15
"2011","North Kesteven 001F","E01026206","Total",796,780,16
"2011","North Kesteven 003B","E01026182","Total",595,579,16
"2011","North Kesteven 003C","E01026193","Total",638,615,23
"2011","North Kesteven 003D","E01026199","Total",995,954,41
"2011","North Kesteven 003E","E01026225","Total",692,678,14
"2011","North Kesteven 003F","E01026226","Total",822,812,10
"2011","North Kesteven 003G","E01032990","Total",945,919,26
"2011","North Kesteven 003H","E01032994","Total",578,556,22
"2011","North Kesteven 004A","E01026184","Total",529,508,21
"2011","North Kesteven 004B","E01026185","Total",838,810,28
"2011","North Kesteven 004C","E01026188","Total",1069,1041,28
"2011","North Kesteven 004D","E01026190","Total",667,646,21
"2011","North Kesteven 004E","E01026237","Total",511,492,19
"2011","North Kesteven 004F","E01026238","Total",540,526,14
"2011","North Kesteven 005A","E01026191","Total",722,697,25
"2011","North Kesteven 005B","E01026205","Total",682,665,17
"2011","North Kesteven 005C","E01026211","Total",779,746,33
"2011","North Kesteven 005D","E01026212","Total",685,663,22
"2011","North Kesteven 005E","E01026213","Total",821,794,27
"2011","North Kesteven 006A","E01026192","Total",519,496,23
"2011","North Kesteven 006B","E01026194","Total",819,803,16
"2011","North Kesteven 006C","E01026195","Total",848,814,34
"2011","North Kesteven 006D","E01026196","Total",691,651,40
"2011","North Kesteven 007A","E01026180","Total",634,604,30
"2011","North Kesteven 007B","E01026183","Total",1151,1096,55
"2011","North Kesteven 007C","E01026210","Total",1008,957,51
"2011","North Kesteven 007D","E01026224","Total",778,763,15
"2011","North Kesteven 008A","E01026179","Total",470,437,33
"2011","North Kesteven 008B","E01026197","Total",644,605,39
"2011","North Kesteven 008C","E01026198","Total",530,446,84
"2011","North Kesteven 008D","E01026223","Total",919,899,20
"2011","North Kesteven 009A","E01026209","Total",985,961,24
"2011","North Kesteven 009B","E01026221","Total",1088,1039,49
"2011","North Kesteven 009C","E01026222","Total",838,817,21
"2011","North Kesteven 010A","E01026227","Total",803,752,51
"2011","North Kesteven 010B","E01026230","Total",558,534,24
"2011","North Kesteven 010C","E01026231","Total",1109,1091,18
"2011","North Kesteven 010D","E01026232","Total",1058,1015,43
"2011","North Kesteven 010E","E01026235","Total",767,731,36
"2011","North Kesteven 011A","E01026228","Total",628,618,10
"2011","North Kesteven 011B","E01026229","Total",655,614,41
"2011","North Kesteven 011C","E01026233","Total",729,723,6
"2011","North Kesteven 011D","E01026234","Total",1071,1051,20
"2011","North Kesteven 011E","E01026236","Total",537,524,13
"2011","North Kesteven 012A","E01026200","Total",722,696,26
"2011","North Kesteven 012B","E01026201","Total",883,858,25
"2011","North Kesteven 012C","E01026202","Total",883,852,31
"2011","North Kesteven 012D","E01026207","Total",543,523,20
"2011","North Kesteven 012E","E01026208","Total",679,662,17
"2011","North Kesteven 013A","E01026220","Total",1037,1019,18
"2011","North Kesteven 013B","E01032988","Total",608,599,9
"2011","North Kesteven 013C","E01032989","Total",563,551,12
"2011","North Kesteven 013D","E01032993","Total",634,623,11
"2011","North Kesteven 014A","E01026214","Total",521,513,8
"2011","North Kesteven 014B","E01026215","Total",477,464,13
"2011","North Kesteven 014C","E01026218","Total",582,565,17
"2011","North Kesteven 014D","E01026219","Total",517,506,11
"2011","North Kesteven 014E","E01032991","Total",641,630,11
"2011","North Kesteven 014F","E01032992","Total",625,600,25
"2011","South Holland 001A","E01026242","Total",644,621,23
"2011","South Holland 001B","E01026243","Total",584,570,14
"2011","South Holland 001C","E01026244","Total",555,545,10
"2011","South Holland 001D","E01026247","Total",850,815,35
"2011","South Holland 001E","E01026276","Total",1019,972,47
"2011","South Holland 002A","E01026246","Total",994,951,43
"2011","South Holland 002B","E01026248","Total",956,892,64
"2011","South Holland 002C","E01026257","Total",887,856,31
"2011","South Holland 003A","E01026250","Total",896,841,55
"2011","South Holland 003B","E01026251","Total",818,792,26
"2011","South Holland 003C","E01026252","Total",816,779,37
"2011","South Holland 003D","E01026253","Total",812,797,15
"2011","South Holland 004A","E01026281","Total",552,538,14
"2011","South Holland 004B","E01026282","Total",739,713,26
"2011","South Holland 004C","E01026283","Total",751,726,25
"2011","South Holland 004D","E01026285","Total",627,609,18
"2011","South Holland 004E","E01026286","Total",507,498,9
"2011","South Holland 005A","E01026241","Total",800,772,28
"2011","South Holland 005B","E01026258","Total",767,747,20
"2011","South Holland 005C","E01026259","Total",723,703,20
"2011","South Holland 005D","E01026260","Total",893,857,36
"2011","South Holland 006B","E01026266","Total",959,919,40
"2011","South Holland 006C","E01026273","Total",730,716,14
"2011","South Holland 006D","E01026274","Total",766,755,11
"2011","South Holland 006E","E01026275","Total",880,859,21
"2011","South Holland 006F","E01032995","Total",749,692,57
"2011","South Holland 006G","E01032996","Total",561,542,19
"2011","South Holland 007A","E01026268","Total",885,873,12
"2011","South Holland 007B","E01026269","Total",956,925,31
"2011","South Holland 007C","E01026270","Total",774,744,30
"2011","South Holland 007D","E01026271","Total",768,756,12
"2011","South Holland 007E","E01026272","Total",581,559,22
"2011","South Holland 008A","E01026254","Total",876,835,41
"2011","South Holland 008B","E01026255","Total",924,864,60
"2011","South Holland 008C","E01026256","Total",708,688,20
"2011","South Holland 008D","E01026277","Total",762,704,58
"2011","South Holland 008E","E01026278","Total",651,609,42
"2011","South Holland 008F","E01026279","Total",642,614,28
"2011","South Holland 009A","E01026262","Total",649,638,11
"2011","South Holland 009B","E01026263","Total",816,805,11
"2011","South Holland 009C","E01026264","Total",652,636,16
"2011","South Holland 009D","E01026265","Total",534,511,23
"2011","South Holland 009E","E01026267","Total",1197,1177,20
"2011","South Holland 010A","E01026245","Total",980,933,47
"2011","South Holland 010B","E01026249","Total",809,773,36
"2011","South Holland 010C","E01026280","Total",1077,1020,57
"2011","South Holland 011A","E01026239","Total",823,778,45
"2011","South Holland 011B","E01026240","Total",983,964,19
"2011","South Holland 011C","E01026284","Total",813,781,32
"2011","South Kesteven 001A","E01026313","Total",661,653,8
"2011","South Kesteven 001B","E01026314","Total",580,561,19
"2011","South Kesteven 001C","E01026329","Total",818,786,32
"2011","South Kesteven 001D","E01026333","Total",1057,1017,40
"2011","South Kesteven 002A","E01026291","Total",854,840,14
"2011","South Kesteven 002B","E01026340","Total",988,966,22
"2011","South Kesteven 002C","E01026355","Total",1052,999,53
"2011","South Kesteven 002D","E01026365","Total",1031,993,38
"2011","South Kesteven 003A","E01026325","Total",621,613,8
"2011","South Kesteven 003B","E01026326","Total",622,609,13
"2011","South Kesteven 003C","E01026327","Total",616,610,6
"2011","South Kesteven 003D","E01026328","Total",609,600,9
"2011","South Kesteven 003E","E01026352","Total",567,561,6
"2011","South Kesteven 003F","E01026353","Total",903,857,46
"2011","South Kesteven 003G","E01026354","Total",491,489,2
"2011","South Kesteven 004A","E01026320","Total",659,654,5
"2011","South Kesteven 004B","E01026321","Total",545,537,8
"2011","South Kesteven 004C","E01026322","Total",547,534,13
"2011","South Kesteven 004D","E01026323","Total",1009,948,61
"2011","South Kesteven 004E","E01026324","Total",893,885,8
"2011","South Kesteven 005A","E01026308","Total",611,596,15
"2011","South Kesteven 005B","E01026309","Total",708,693,15
"2011","South Kesteven 005C","E01026310","Total",465,454,11
"2011","South Kesteven 005D","E01026311","Total",692,666,26
"2011","South Kesteven 005E","E01026312","Total",460,452,8
"2011","South Kesteven 006A","E01026317","Total",1066,978,88
"2011","South Kesteven 006B","E01026318","Total",926,856,70
"2011","South Kesteven 006C","E01026319","Total",991,932,59
"2011","South Kesteven 006D","E01026343","Total",988,909,79
"2011","South Kesteven 006E","E01026344","Total",721,682,39
"2011","South Kesteven 006F","E01026345","Total",648,628,20
"2011","South Kesteven 007A","E01026292","Total",646,618,28
"2011","South Kesteven 007B","E01026293","Total",911,844,67
"2011","South Kesteven 007C","E01026294","Total",667,647,20
"2011","South Kesteven 007D","E01026316","Total",1099,1038,61
"2011","South Kesteven 007E","E01026332","Total",987,945,42
"2011","South Kesteven 008A","E01026290","Total",946,905,41
"2011","South Kesteven 008B","E01026341","Total",638,619,19
"2011","South Kesteven 008C","E01026342","Total",580,570,10
"2011","South Kesteven 008D","E01026361","Total",1177,1130,47
"2011","South Kesteven 009A","E01026315","Total",978,922,56
"2011","South Kesteven 009B","E01026331","Total",1088,1042,46
"2011","South Kesteven 009C","E01026338","Total",546,527,19
"2011","South Kesteven 009D","E01026339","Total",571,539,32
"2011","South Kesteven 010A","E01026299","Total",745,718,27
"2011","South Kesteven 010B","E01026300","Total",640,628,12
"2011","South Kesteven 010C","E01026301","Total",719,694,25
"2011","South Kesteven 010D","E01026302","Total",509,491,18
"2011","South Kesteven 011B","E01026296","Total",668,651,17
"2011","South Kesteven 011C","E01026297","Total",600,586,14
"2011","South Kesteven 011D","E01026298","Total",938,868,70
"2011","South Kesteven 011E","E01032997","Total",480,472,8
"2011","South Kesteven 011F","E01032998","Total",500,482,18
"2011","South Kesteven 011G","E01032999","Total",543,521,22
"2011","South Kesteven 012A","E01026330","Total",898,868,30
"2011","South Kesteven 012B","E01026360","Total",913,885,28
"2011","South Kesteven 012C","E01026362","Total",687,671,16
"2011","South Kesteven 012D","E01026363","Total",552,531,21
"2011","South Kesteven 012E","E01026364","Total",730,709,21
"2011","South Kesteven 013A","E01026334","Total",636,619,17
"2011","South Kesteven 013B","E01026335","Total",746,721,25
"2011","South Kesteven 013C","E01026336","Total",724,693,31
"2011","South Kesteven 013D","E01026337","Total",663,653,10
"2011","South Kesteven 014A","E01026303","Total",527,521,6
"2011","South Kesteven 014B","E01026304","Total",628,609,19
"2011","South Kesteven 014C","E01026305","Total",608,596,12
"2011","South Kesteven 014D","E01026306","Total",722,709,13
"2011","South Kesteven 014E","E01026307","Total",559,550,9
"2011","South Kesteven 015A","E01026287","Total",631,623,8
"2011","South Kesteven 015B","E01026288","Total",759,744,15
"2011","South Kesteven 015C","E01026289","Total",873,858,15
"2011","South Kesteven 015D","E01026346","Total",520,512,8
"2011","South Kesteven 015E","E01026347","Total",891,843,48
"2011","South Kesteven 015F","E01026348","Total",482,466,16
"2011","South Kesteven 016A","E01026349","Total",820,791,29
"2011","South Kesteven 016B","E01026350","Total",913,848,65
"2011","South Kesteven 016C","E01026351","Total",983,850,133
"2011","South Kesteven 016D","E01026356","Total",592,580,12
"2011","South Kesteven 016E","E01026357","Total",599,588,11
"2011","South Kesteven 016F","E01026358","Total",641,624,17
"2011","South Kesteven 016G","E01026359","Total",680,667,13
"2011","West Lindsey 001A","E01026367","Total",796,741,55
"2011","West Lindsey 001B","E01026368","Total",712,687,25
"2011","West Lindsey 001C","E01026387","Total",1119,1089,30
"2011","West Lindsey 001D","E01026416","Total",587,552,35
"2011","West Lindsey 001G","E01032683","Total",1055,998,57
"2011","West Lindsey 002A","E01026380","Total",757,736,21
"2011","West Lindsey 002B","E01026401","Total",654,621,33
"2011","West Lindsey 002C","E01026402","Total",856,828,28
"2011","West Lindsey 002D","E01026403","Total",582,558,24
"2011","West Lindsey 002E","E01026407","Total",592,558,34
"2011","West Lindsey 002F","E01026408","Total",608,580,28
"2011","West Lindsey 003A","E01026389","Total",831,784,47
"2011","West Lindsey 003B","E01026390","Total",898,841,57
"2011","West Lindsey 003C","E01026391","Total",869,818,51
"2011","West Lindsey 003D","E01026392","Total",1327,1281,46
"2011","West Lindsey 003E","E01026415","Total",438,406,32
"2011","West Lindsey 004A","E01026378","Total",774,721,53
"2011","West Lindsey 004B","E01026379","Total",805,733,72
"2011","West Lindsey 004C","E01026381","Total",841,799,42
"2011","West Lindsey 004D","E01026382","Total",767,740,27
"2011","West Lindsey 004E","E01026383","Total",812,614,198
"2011","West Lindsey 004F","E01026384","Total",1051,892,159
"2011","West Lindsey 005A","E01026385","Total",516,511,5
"2011","West Lindsey 005B","E01026386","Total",525,522,3
"2011","West Lindsey 005C","E01026399","Total",621,607,14
"2011","West Lindsey 005D","E01026411","Total",1107,1045,62
"2011","West Lindsey 006A","E01026374","Total",661,641,20
"2011","West Lindsey 006B","E01026375","Total",697,664,33
"2011","West Lindsey 006C","E01026376","Total",802,778,24
"2011","West Lindsey 006D","E01026377","Total",927,898,29
"2011","West Lindsey 007A","E01026388","Total",953,933,20
"2011","West Lindsey 007B","E01026404","Total",987,962,25
"2011","West Lindsey 007C","E01026409","Total",516,511,5
"2011","West Lindsey 007D","E01026410","Total",764,746,18
"2011","West Lindsey 008A","E01026372","Total",1059,1030,29
"2011","West Lindsey 008B","E01026412","Total",736,722,14
"2011","West Lindsey 008C","E01026413","Total",889,871,18
"2011","West Lindsey 008D","E01026414","Total",726,694,32
"2011","West Lindsey 009A","E01026396","Total",556,545,11
"2011","West Lindsey 009B","E01026397","Total",1035,993,42
"2011","West Lindsey 009C","E01026398","Total",717,707,10
"2011","West Lindsey 009D","E01026400","Total",627,622,5
"2011","West Lindsey 010A","E01026393","Total",654,636,18
"2011","West Lindsey 010B","E01026394","Total",792,770,22
"2011","West Lindsey 010C","E01026395","Total",688,658,30
"2011","West Lindsey 010D","E01026405","Total",541,523,18
"2011","West Lindsey 010E","E01026406","Total",533,525,8
"2011","West Lindsey 011A","E01026366","Total",974,915,59
"2011","West Lindsey 011B","E01026369","Total",498,486,12
"2011","West Lindsey 011C","E01026370","Total",963,940,23
"2011","West Lindsey 011D","E01026371","Total",539,525,14
"2011","West Lindsey 011E","E01026373","Total",867,828,39
"2011","Corby 001A","E01026971","Total",750,739,11
"2011","Corby 001B","E01026979","Total",603,566,37
"2011","Corby 001C","E01026980","Total",686,652,34
"2011","Corby 001D","E01026982","Total",815,787,28
"2011","Corby 002A","E01026969","Total",811,802,9
"2011","Corby 002B","E01026970","Total",667,656,11
"2011","Corby 002C","E01026972","Total",781,766,15
"2011","Corby 002D","E01026976","Total",553,544,9
"2011","Corby 002E","E01026981","Total",493,480,13
"2011","Corby 002F","E01026983","Total",473,464,9
"2011","Corby 003A","E01026957","Total",770,727,43
"2011","Corby 003B","E01026958","Total",781,738,43
"2011","Corby 003C","E01026977","Total",879,838,41
"2011","Corby 003D","E01026978","Total",657,604,53
"2011","Corby 004A","E01026962","Total",609,602,7
"2011","Corby 004B","E01026973","Total",597,587,10
"2011","Corby 004C","E01026974","Total",491,476,15
"2011","Corby 004D","E01026975","Total",665,645,20
"2011","Corby 004E","E01026984","Total",770,752,18
"2011","Corby 004F","E01026985","Total",648,637,11
"2011","Corby 005A","E01026949","Total",646,613,33
"2011","Corby 005B","E01026950","Total",631,614,17
"2011","Corby 005C","E01026951","Total",530,495,35
"2011","Corby 005D","E01026952","Total",518,499,19
"2011","Corby 006A","E01026959","Total",663,646,17
"2011","Corby 006B","E01026960","Total",648,609,39
"2011","Corby 006C","E01026961","Total",512,502,10
"2011","Corby 006D","E01026965","Total",474,426,48
"2011","Corby 006E","E01026966","Total",580,564,16
"2011","Corby 006F","E01026967","Total",709,693,16
"2011","Corby 006G","E01026968","Total",658,611,47
"2011","Corby 008A","E01026953","Total",608,590,18
"2011","Corby 008B","E01026954","Total",542,534,8
"2011","Corby 008C","E01026955","Total",569,557,12
"2011","Corby 008D","E01026956","Total",847,818,29
"2011","Corby 009A","E01026963","Total",558,550,8
"2011","Corby 009B","E01032963","Total",637,613,24
"2011","Corby 009C","E01032964","Total",618,584,34
"2011","Corby 009D","E01032965","Total",512,492,20
"2011","Corby 009E","E01032966","Total",644,603,41
"2011","Corby 009F","E01032967","Total",578,540,38
"2011","Daventry 001A","E01027005","Total",857,823,34
"2011","Daventry 001B","E01027026","Total",819,794,25
"2011","Daventry 001C","E01027030","Total",759,731,28
"2011","Daventry 002A","E01027000","Total",621,608,13
"2011","Daventry 002B","E01027001","Total",514,510,4
"2011","Daventry 002C","E01027002","Total",669,638,31
"2011","Daventry 002D","E01027003","Total",608,593,15
"2011","Daventry 002E","E01027022","Total",777,745,32
"2011","Daventry 003A","E01026994","Total",464,453,11
"2011","Daventry 003D","E01026999","Total",814,776,38
"2011","Daventry 003E","E01027006","Total",775,745,30
"2011","Daventry 003F","E01032968","Total",928,909,19
"2011","Daventry 004A","E01026998","Total",767,742,25
"2011","Daventry 004B","E01027015","Total",533,522,11
"2011","Daventry 004C","E01027016","Total",649,616,33
"2011","Daventry 004D","E01027021","Total",790,768,22
"2011","Daventry 004E","E01027027","Total",935,903,32
"2011","Daventry 005A","E01026997","Total",720,682,38
"2011","Daventry 005B","E01027018","Total",678,623,55
"2011","Daventry 005C","E01027019","Total",665,652,13
"2011","Daventry 005D","E01027020","Total",545,535,10
"2011","Daventry 005E","E01027023","Total",851,824,27
"2011","Daventry 006A","E01026987","Total",525,516,9
"2011","Daventry 006B","E01026989","Total",605,592,13
"2011","Daventry 006C","E01026990","Total",1098,1069,29
"2011","Daventry 006D","E01027012","Total",732,726,6
"2011","Daventry 006E","E01027014","Total",806,799,7
"2011","Daventry 007A","E01026986","Total",1148,1134,14
"2011","Daventry 007B","E01026988","Total",604,596,8
"2011","Daventry 007C","E01026991","Total",769,759,10
"2011","Daventry 007D","E01026992","Total",964,931,33
"2011","Daventry 007E","E01027010","Total",496,489,7
"2011","Daventry 008A","E01027007","Total",541,536,5
"2011","Daventry 008B","E01027008","Total",907,888,19
"2011","Daventry 008C","E01027009","Total",616,595,21
"2011","Daventry 008D","E01027013","Total",724,715,9
"2011","Daventry 009A","E01027011","Total",857,820,37
"2011","Daventry 009B","E01027017","Total",692,670,22
"2011","Daventry 009C","E01027024","Total",732,714,18
"2011","Daventry 009D","E01027025","Total",767,751,16
"2011","Daventry 010A","E01026993","Total",857,824,33
"2011","Daventry 010B","E01027004","Total",816,773,43
"2011","Daventry 010C","E01027028","Total",921,887,34
"2011","Daventry 010D","E01027029","Total",710,671,39
"2011","East Northamptonshire 001A","E01027033","Total",837,802,35
"2011","East Northamptonshire 001B","E01027043","Total",861,805,56
"2011","East Northamptonshire 001C","E01027050","Total",837,791,46
"2011","East Northamptonshire 002A","E01027031","Total",886,832,54
"2011","East Northamptonshire 002B","E01027044","Total",902,839,63
"2011","East Northamptonshire 002C","E01027046","Total",526,513,13
"2011","East Northamptonshire 002D","E01027047","Total",573,561,12
"2011","East Northamptonshire 002E","E01027048","Total",646,614,32
"2011","East Northamptonshire 002F","E01027049","Total",490,439,51
"2011","East Northamptonshire 003A","E01027032","Total",835,779,56
"2011","East Northamptonshire 003B","E01027045","Total",879,819,60
"2011","East Northamptonshire 003C","E01027075","Total",816,804,12
"2011","East Northamptonshire 003D","E01027076","Total",945,926,19
"2011","East Northamptonshire 003E","E01027077","Total",768,736,32
"2011","East Northamptonshire 004A","E01027057","Total",748,718,30
"2011","East Northamptonshire 004B","E01027074","Total",889,858,31
"2011","East Northamptonshire 004C","E01027078","Total",945,888,57
"2011","East Northamptonshire 005A","E01027051","Total",769,750,19
"2011","East Northamptonshire 005B","E01027052","Total",593,576,17
"2011","East Northamptonshire 005C","E01027053","Total",651,624,27
"2011","East Northamptonshire 005D","E01027054","Total",523,515,8
"2011","East Northamptonshire 005E","E01027055","Total",486,465,21
"2011","East Northamptonshire 005F","E01027056","Total",647,625,22
"2011","East Northamptonshire 006A","E01027038","Total",705,675,30
"2011","East Northamptonshire 006B","E01027039","Total",782,737,45
"2011","East Northamptonshire 006C","E01027040","Total",728,707,21
"2011","East Northamptonshire 006D","E01027041","Total",761,728,33
"2011","East Northamptonshire 006E","E01027042","Total",733,721,12
"2011","East Northamptonshire 007A","E01027034","Total",751,739,12
"2011","East Northamptonshire 007B","E01027035","Total",622,588,34
"2011","East Northamptonshire 007D","E01027037","Total",857,836,21
"2011","East Northamptonshire 007E","E01033244","Total",947,925,22
"2011","East Northamptonshire 007F","E01033245","Total",440,423,17
"2011","East Northamptonshire 008A","E01027061","Total",816,757,59
"2011","East Northamptonshire 008B","E01027062","Total",992,929,63
"2011","East Northamptonshire 008C","E01027063","Total",755,730,25
"2011","East Northamptonshire 008D","E01027064","Total",658,641,17
"2011","East Northamptonshire 008E","E01027072","Total",625,608,17
"2011","East Northamptonshire 008F","E01027073","Total",926,889,37
"2011","East Northamptonshire 009A","E01027058","Total",643,622,21
"2011","East Northamptonshire 009B","E01027059","Total",814,750,64
"2011","East Northamptonshire 009C","E01027060","Total",927,845,82
"2011","East Northamptonshire 009D","E01027065","Total",926,847,79
"2011","East Northamptonshire 009E","E01027069","Total",901,805,96
"2011","East Northamptonshire 010A","E01027066","Total",836,808,28
"2011","East Northamptonshire 010B","E01027067","Total",689,675,14
"2011","East Northamptonshire 010C","E01027068","Total",1138,1118,20
"2011","East Northamptonshire 010D","E01027070","Total",705,682,23
"2011","East Northamptonshire 010E","E01027071","Total",610,598,12
"2011","Kettering 001A","E01027090","Total",667,615,52
"2011","Kettering 001B","E01027103","Total",715,682,33
"2011","Kettering 001C","E01027129","Total",1009,949,60
"2011","Kettering 002B","E01027094","Total",674,649,25
"2011","Kettering 002C","E01027095","Total",594,576,18
"2011","Kettering 002D","E01027107","Total",601,565,36
"2011","Kettering 002E","E01027108","Total",546,526,20
"2011","Kettering 002F","E01027109","Total",521,505,16
"2011","Kettering 002G","E01032969","Total",520,490,30
"2011","Kettering 002H","E01032970","Total",599,571,28
"2011","Kettering 002I","E01032971","Total",557,508,49
"2011","Kettering 003A","E01027123","Total",681,662,19
"2011","Kettering 003B","E01027124","Total",1085,1003,82
"2011","Kettering 003C","E01027125","Total",731,709,22
"2011","Kettering 003D","E01027126","Total",1033,992,41
"2011","Kettering 004A","E01027079","Total",765,739,26
"2011","Kettering 004B","E01027080","Total",768,752,16
"2011","Kettering 004C","E01027087","Total",505,495,10
"2011","Kettering 004D","E01027088","Total",497,482,15
"2011","Kettering 004E","E01027089","Total",833,809,24
"2011","Kettering 005A","E01027081","Total",626,613,13
"2011","Kettering 005B","E01027082","Total",750,703,47
"2011","Kettering 005C","E01027083","Total",662,648,14
"2011","Kettering 005D","E01027127","Total",803,780,23
"2011","Kettering 005E","E01027128","Total",691,676,15
"2011","Kettering 006A","E01027105","Total",1016,918,98
"2011","Kettering 006B","E01027106","Total",953,876,77
"2011","Kettering 006C","E01027111","Total",976,916,60
"2011","Kettering 006D","E01027112","Total",1012,935,77
"2011","Kettering 007A","E01027104","Total",1173,1096,77
"2011","Kettering 007B","E01027110","Total",1222,1110,112
"2011","Kettering 007C","E01027113","Total",1010,963,47
"2011","Kettering 007D","E01027115","Total",505,485,20
"2011","Kettering 007E","E01027116","Total",823,817,6
"2011","Kettering 007F","E01027117","Total",644,610,34
"2011","Kettering 008A","E01027096","Total",461,453,8
"2011","Kettering 008B","E01027097","Total",606,592,14
"2011","Kettering 008C","E01027098","Total",489,482,7
"2011","Kettering 008D","E01027099","Total",681,670,11
"2011","Kettering 008E","E01027122","Total",517,503,14
"2011","Kettering 009A","E01027100","Total",705,683,22
"2011","Kettering 009B","E01027114","Total",700,680,20
"2011","Kettering 009C","E01027130","Total",817,788,29
"2011","Kettering 009D","E01027131","Total",1016,994,22
"2011","Kettering 010A","E01027084","Total",660,642,18
"2011","Kettering 010B","E01027085","Total",534,517,17
"2011","Kettering 010C","E01027086","Total",708,684,24
"2011","Kettering 010D","E01027120","Total",530,521,9
"2011","Kettering 010E","E01027121","Total",544,533,11
"2011","Kettering 011A","E01027091","Total",802,762,40
"2011","Kettering 011B","E01027092","Total",650,619,31
"2011","Kettering 011C","E01027101","Total",1065,1017,48
"2011","Kettering 011D","E01027102","Total",696,679,17
"2011","Kettering 011F","E01027119","Total",779,748,31
"2011","Kettering 011G","E01032972","Total",592,578,14
"2011","Kettering 011H","E01032973","Total",607,596,11
"2011","Kettering 011I","E01032974","Total",560,535,25
"2011","Northampton 001A","E01027145","Total",581,567,14
"2011","Northampton 001B","E01027148","Total",578,572,6
"2011","Northampton 001C","E01027149","Total",617,612,5
"2011","Northampton 001D","E01027232","Total",647,622,25
"2011","Northampton 002A","E01027218","Total",718,701,17
"2011","Northampton 002B","E01027219","Total",839,798,41
"2011","Northampton 002C","E01027221","Total",775,748,27
"2011","Northampton 002D","E01027222","Total",501,497,4
"2011","Northampton 003A","E01027143","Total",535,530,5
"2011","Northampton 003B","E01027144","Total",641,635,6
"2011","Northampton 003C","E01027146","Total",653,635,18
"2011","Northampton 003D","E01027147","Total",833,809,24
"2011","Northampton 004A","E01027195","Total",644,607,37
"2011","Northampton 004B","E01027245","Total",690,667,23
"2011","Northampton 004C","E01027247","Total",632,619,13
"2011","Northampton 004D","E01027248","Total",599,586,13
"2011","Northampton 004E","E01027249","Total",703,683,20
"2011","Northampton 005A","E01027174","Total",523,515,8
"2011","Northampton 005B","E01027175","Total",617,599,18
"2011","Northampton 005C","E01027178","Total",807,781,26
"2011","Northampton 005D","E01027200","Total",593,577,16
"2011","Northampton 005E","E01027246","Total",776,756,20
"2011","Northampton 006A","E01027171","Total",697,683,14
"2011","Northampton 006B","E01027172","Total",683,658,25
"2011","Northampton 006C","E01027182","Total",621,606,15
"2011","Northampton 006D","E01027183","Total",632,613,19
"2011","Northampton 007A","E01027196","Total",534,527,7
"2011","Northampton 007B","E01027197","Total",616,605,11
"2011","Northampton 007C","E01027198","Total",668,650,18
"2011","Northampton 007D","E01027199","Total",520,504,16
"2011","Northampton 008A","E01027190","Total",796,778,18
"2011","Northampton 008B","E01027191","Total",791,761,30
"2011","Northampton 008C","E01027193","Total",643,619,24
"2011","Northampton 008D","E01027194","Total",640,626,14
"2011","Northampton 009A","E01027192","Total",569,538,31
"2011","Northampton 009B","E01027229","Total",624,613,11
"2011","Northampton 009C","E01027230","Total",642,618,24
"2011","Northampton 009D","E01027231","Total",825,800,25
"2011","Northampton 010A","E01027179","Total",795,770,25
"2011","Northampton 010B","E01027180","Total",721,707,14
"2011","Northampton 010C","E01027181","Total",800,770,30
"2011","Northampton 011A","E01027140","Total",497,461,36
"2011","Northampton 011B","E01027142","Total",620,601,19
"2011","Northampton 011C","E01027176","Total",614,602,12
"2011","Northampton 011D","E01027177","Total",645,630,15
"2011","Northampton 012A","E01027168","Total",772,728,44
"2011","Northampton 012B","E01027169","Total",594,585,9
"2011","Northampton 012C","E01027170","Total",639,621,18
"2011","Northampton 012D","E01027173","Total",617,600,17
"2011","Northampton 013A","E01027136","Total",828,776,52
"2011","Northampton 013B","E01027186","Total",691,668,23
"2011","Northampton 013C","E01027188","Total",742,732,10
"2011","Northampton 013D","E01027220","Total",622,596,26
"2011","Northampton 014A","E01027208","Total",613,602,11
"2011","Northampton 014B","E01027209","Total",558,551,7
"2011","Northampton 014C","E01027211","Total",635,629,6
"2011","Northampton 014D","E01027212","Total",576,566,10
"2011","Northampton 015A","E01027184","Total",671,625,46
"2011","Northampton 015B","E01027185","Total",615,595,20
"2011","Northampton 015C","E01027187","Total",581,539,42
"2011","Northampton 015D","E01027189","Total",749,734,15
"2011","Northampton 016A","E01027137","Total",660,631,29
"2011","Northampton 016B","E01027138","Total",645,635,10
"2011","Northampton 016C","E01027139","Total",631,616,15
"2011","Northampton 016D","E01027141","Total",553,540,13
"2011","Northampton 016E","E01027259","Total",593,581,12
"2011","Northampton 017A","E01027239","Total",690,666,24
"2011","Northampton 017B","E01027241","Total",734,711,23
"2011","Northampton 017C","E01027242","Total",615,595,20
"2011","Northampton 017D","E01027243","Total",707,674,33
"2011","Northampton 017E","E01027244","Total",718,684,34
"2011","Northampton 018A","E01027213","Total",650,642,8
"2011","Northampton 018B","E01027214","Total",764,746,18
"2011","Northampton 018C","E01027216","Total",800,776,24
"2011","Northampton 018D","E01027240","Total",533,512,21
"2011","Northampton 019A","E01027207","Total",623,605,18
"2011","Northampton 019B","E01027210","Total",459,451,8
"2011","Northampton 019C","E01027215","Total",612,601,11
"2011","Northampton 019D","E01027217","Total",988,941,47
"2011","Northampton 020A","E01027255","Total",544,540,4
"2011","Northampton 020B","E01027256","Total",653,630,23
"2011","Northampton 020C","E01027258","Total",503,497,6
"2011","Northampton 020D","E01027260","Total",598,584,14
"2011","Northampton 021B","E01027152","Total",784,742,42
"2011","Northampton 021C","E01027153","Total",1052,994,58
"2011","Northampton 021D","E01027154","Total",818,778,40
"2011","Northampton 021E","E01032978","Total",821,799,22
"2011","Northampton 021F","E01032979","Total",802,743,59
"2011","Northampton 022A","E01027132","Total",1005,937,68
"2011","Northampton 022B","E01027133","Total",792,759,33
"2011","Northampton 022C","E01027134","Total",729,690,39
"2011","Northampton 022D","E01027135","Total",757,716,41
"2011","Northampton 023A","E01027155","Total",1051,980,71
"2011","Northampton 023B","E01027225","Total",780,724,56
"2011","Northampton 023C","E01027227","Total",708,659,49
"2011","Northampton 023D","E01027228","Total",971,929,42
"2011","Northampton 024A","E01027151","Total",760,728,32
"2011","Northampton 024B","E01027236","Total",709,679,30
"2011","Northampton 024C","E01027237","Total",910,882,28
"2011","Northampton 024D","E01027238","Total",992,960,32
"2011","Northampton 025A","E01027223","Total",1167,1107,60
"2011","Northampton 025B","E01027224","Total",944,904,40
"2011","Northampton 025C","E01027226","Total",919,853,66
"2011","Northampton 025D","E01027257","Total",491,477,14
"2011","Northampton 026A","E01027233","Total",497,483,14
"2011","Northampton 026B","E01027234","Total",604,588,16
"2011","Northampton 026C","E01027235","Total",648,629,19
"2011","Northampton 026D","E01027252","Total",651,640,11
"2011","Northampton 027A","E01027156","Total",509,504,5
"2011","Northampton 027B","E01027159","Total",518,511,7
"2011","Northampton 027C","E01027160","Total",717,705,12
"2011","Northampton 027D","E01027161","Total",677,669,8
"2011","Northampton 028B","E01027158","Total",657,646,11
"2011","Northampton 028C","E01027201","Total",897,880,17
"2011","Northampton 028D","E01027202","Total",684,674,10
"2011","Northampton 028E","E01032980","Total",765,732,33
"2011","Northampton 028F","E01032981","Total",694,669,25
"2011","Northampton 029A","E01027250","Total",606,595,11
"2011","Northampton 029C","E01027253","Total",742,730,12
"2011","Northampton 029D","E01027254","Total",661,652,9
"2011","Northampton 029E","E01032975","Total",663,651,12
"2011","Northampton 029F","E01032976","Total",672,651,21
"2011","Northampton 029G","E01032977","Total",732,707,25
"2011","Northampton 030A","E01027162","Total",709,689,20
"2011","Northampton 030B","E01027163","Total",573,566,7
"2011","Northampton 030C","E01027164","Total",636,622,14
"2011","Northampton 030D","E01027165","Total",498,491,7
"2011","Northampton 030E","E01027166","Total",639,625,14
"2011","Northampton 030F","E01027167","Total",601,572,29
"2011","Northampton 031A","E01027203","Total",563,557,6
"2011","Northampton 031B","E01027204","Total",661,642,19
"2011","Northampton 031C","E01027205","Total",744,723,21
"2011","Northampton 031D","E01027206","Total",1049,1027,22
"2011","South Northamptonshire 001A","E01027282","Total",663,653,10
"2011","South Northamptonshire 001B","E01027283","Total",643,611,32
"2011","South Northamptonshire 001C","E01027285","Total",710,689,21
"2011","South Northamptonshire 001D","E01027286","Total",668,654,14
"2011","South Northamptonshire 001E","E01027287","Total",703,679,24
"2011","South Northamptonshire 002A","E01027273","Total",787,763,24
"2011","South Northamptonshire 002B","E01027274","Total",638,623,15
"2011","South Northamptonshire 002C","E01027275","Total",621,600,21
"2011","South Northamptonshire 002D","E01027308","Total",722,687,35
"2011","South Northamptonshire 003A","E01027263","Total",824,796,28
"2011","South Northamptonshire 003C","E01027279","Total",758,743,15
"2011","South Northamptonshire 003D","E01027284","Total",774,756,18
"2011","South Northamptonshire 003E","E01027294","Total",760,744,16
"2011","South Northamptonshire 003F","E01032982","Total",524,500,24
"2011","South Northamptonshire 003G","E01032983","Total",536,523,13
"2011","South Northamptonshire 003H","E01032984","Total",550,539,11
"2011","South Northamptonshire 003I","E01032985","Total",622,611,11
"2011","South Northamptonshire 004A","E01027262","Total",711,675,36
"2011","South Northamptonshire 004B","E01027277","Total",785,760,25
"2011","South Northamptonshire 004C","E01027289","Total",727,714,13
"2011","South Northamptonshire 004D","E01027300","Total",527,523,4
"2011","South Northamptonshire 004E","E01027303","Total",679,639,40
"2011","South Northamptonshire 005A","E01027297","Total",730,695,35
"2011","South Northamptonshire 005B","E01027298","Total",528,516,12
"2011","South Northamptonshire 005C","E01027299","Total",627,616,11
"2011","South Northamptonshire 005D","E01027301","Total",952,909,43
"2011","South Northamptonshire 005E","E01027302","Total",679,672,7
"2011","South Northamptonshire 006A","E01027291","Total",620,590,30
"2011","South Northamptonshire 006B","E01027292","Total",477,466,11
"2011","South Northamptonshire 006C","E01027293","Total",497,483,14
"2011","South Northamptonshire 006D","E01027304","Total",784,729,55
"2011","South Northamptonshire 006E","E01027305","Total",822,769,53
"2011","South Northamptonshire 007A","E01027261","Total",821,776,45
"2011","South Northamptonshire 007B","E01027295","Total",889,858,31
"2011","South Northamptonshire 007C","E01027306","Total",773,722,51
"2011","South Northamptonshire 008A","E01027276","Total",1071,1040,31
"2011","South Northamptonshire 008B","E01027280","Total",930,897,33
"2011","South Northamptonshire 008C","E01027281","Total",700,684,16
"2011","South Northamptonshire 008D","E01027307","Total",865,832,33
"2011","South Northamptonshire 009A","E01027265","Total",686,669,17
"2011","South Northamptonshire 009B","E01027266","Total",491,482,9
"2011","South Northamptonshire 009C","E01027270","Total",584,581,3
"2011","South Northamptonshire 009D","E01027271","Total",640,628,12
"2011","South Northamptonshire 009E","E01027272","Total",600,591,9
"2011","South Northamptonshire 010A","E01027264","Total",733,648,85
"2011","South Northamptonshire 010B","E01027267","Total",548,509,39
"2011","South Northamptonshire 010C","E01027268","Total",533,517,16
"2011","South Northamptonshire 010D","E01027269","Total",729,689,40
"2011","South Northamptonshire 011A","E01027288","Total",930,904,26
"2011","South Northamptonshire 011B","E01027290","Total",999,918,81
"2011","South Northamptonshire 011C","E01027296","Total",878,845,33
"2011","Wellingborough 001A","E01027326","Total",738,710,28
"2011","Wellingborough 001B","E01027327","Total",733,695,38
"2011","Wellingborough 001C","E01027328","Total",597,582,15
"2011","Wellingborough 001D","E01027338","Total",1016,994,22
"2011","Wellingborough 002A","E01027330","Total",653,633,20
"2011","Wellingborough 002B","E01027331","Total",642,623,19
"2011","Wellingborough 002C","E01027332","Total",659,649,10
"2011","Wellingborough 002D","E01027333","Total",851,840,11
"2011","Wellingborough 002E","E01027334","Total",562,531,31
"2011","Wellingborough 003A","E01027343","Total",628,621,7
"2011","Wellingborough 003B","E01027344","Total",635,628,7
"2011","Wellingborough 003C","E01027345","Total",494,489,5
"2011","Wellingborough 003D","E01027346","Total",586,577,9
"2011","Wellingborough 003E","E01027347","Total",761,744,17
"2011","Wellingborough 004A","E01027313","Total",669,639,30
"2011","Wellingborough 004B","E01027314","Total",941,897,44
"2011","Wellingborough 004C","E01027315","Total",1115,1062,53
"2011","Wellingborough 004D","E01027316","Total",690,650,40
"2011","Wellingborough 005A","E01027339","Total",586,555,31
"2011","Wellingborough 005B","E01027340","Total",666,658,8
"2011","Wellingborough 005C","E01027341","Total",603,593,10
"2011","Wellingborough 005D","E01027342","Total",678,652,26
"2011","Wellingborough 006A","E01027349","Total",994,860,134
"2011","Wellingborough 006B","E01027350","Total",700,672,28
"2011","Wellingborough 006C","E01027351","Total",817,794,23
"2011","Wellingborough 006D","E01027352","Total",668,638,30
"2011","Wellingborough 007A","E01027309","Total",665,651,14
"2011","Wellingborough 007B","E01027310","Total",623,607,16
"2011","Wellingborough 007C","E01027311","Total",490,483,7
"2011","Wellingborough 007D","E01027312","Total",645,627,18
"2011","Wellingborough 008A","E01027317","Total",665,644,21
"2011","Wellingborough 008B","E01027318","Total",596,591,5
"2011","Wellingborough 008C","E01027319","Total",614,605,9
"2011","Wellingborough 008D","E01027320","Total",769,744,25
"2011","Wellingborough 008E","E01027321","Total",585,580,5
"2011","Wellingborough 009A","E01027322","Total",527,511,16
"2011","Wellingborough 009B","E01027323","Total",623,610,13
"2011","Wellingborough 009C","E01027324","Total",508,503,5
"2011","Wellingborough 009D","E01027325","Total",698,673,25
"2011","Wellingborough 009E","E01027329","Total",807,791,16
"2011","Wellingborough 009F","E01027353","Total",797,772,25
"2011","Wellingborough 010A","E01027335","Total",646,632,14
"2011","Wellingborough 010B","E01027336","Total",664,652,12
"2011","Wellingborough 010C","E01027337","Total",804,793,11
"2011","Wellingborough 010D","E01027348","Total",915,890,25
"2011","Wellingborough 010E","E01027354","Total",1081,1053,28
"2011","Wellingborough 010F","E01027355","Total",679,659,20
"2011","Ashfield 001A","E01027979","Total",719,699,20
"2011","Ashfield 001B","E01027980","Total",663,649,14
"2011","Ashfield 001C","E01027981","Total",716,678,38
"2011","Ashfield 001D","E01027983","Total",712,642,70
"2011","Ashfield 002A","E01027970","Total",629,609,20
"2011","Ashfield 002B","E01027971","Total",621,602,19
"2011","Ashfield 002C","E01027982","Total",681,666,15
"2011","Ashfield 002D","E01027984","Total",654,636,18
"2011","Ashfield 003A","E01027966","Total",654,636,18
"2011","Ashfield 003B","E01027986","Total",660,624,36
"2011","Ashfield 003C","E01027987","Total",774,746,28
"2011","Ashfield 003D","E01027990","Total",820,789,31
"2011","Ashfield 004A","E01027967","Total",807,756,51
"2011","Ashfield 004B","E01027972","Total",894,874,20
"2011","Ashfield 004C","E01027977","Total",809,782,27
"2011","Ashfield 004D","E01027978","Total",861,805,56
"2011","Ashfield 004E","E01027985","Total",781,757,24
"2011","Ashfield 005A","E01027964","Total",643,617,26
"2011","Ashfield 005B","E01027965","Total",587,563,24
"2011","Ashfield 005C","E01027968","Total",597,573,24
"2011","Ashfield 005D","E01027974","Total",697,671,26
"2011","Ashfield 005E","E01027976","Total",833,790,43
"2011","Ashfield 006A","E01027969","Total",594,575,19
"2011","Ashfield 006B","E01027975","Total",734,708,26
"2011","Ashfield 006C","E01027988","Total",711,693,18
"2011","Ashfield 006D","E01027989","Total",767,736,31
"2011","Ashfield 006E","E01027991","Total",551,539,12
"2011","Ashfield 006F","E01027992","Total",857,846,11
"2011","Ashfield 007A","E01027949","Total",672,646,26
"2011","Ashfield 007B","E01027951","Total",665,648,17
"2011","Ashfield 007C","E01027953","Total",656,636,20
"2011","Ashfield 007D","E01027954","Total",699,664,35
"2011","Ashfield 007E","E01027973","Total",661,647,14
"2011","Ashfield 008A","E01027952","Total",860,808,52
"2011","Ashfield 008B","E01027955","Total",551,512,39
"2011","Ashfield 008C","E01027956","Total",710,686,24
"2011","Ashfield 008D","E01027958","Total",617,596,21
"2011","Ashfield 009A","E01027947","Total",718,692,26
"2011","Ashfield 009B","E01027948","Total",827,792,35
"2011","Ashfield 009C","E01027950","Total",955,918,37
"2011","Ashfield 009D","E01027957","Total",540,524,16
"2011","Ashfield 009E","E01027959","Total",532,527,5
"2011","Ashfield 010A","E01027995","Total",691,681,10
"2011","Ashfield 010B","E01027996","Total",882,859,23
"2011","Ashfield 010C","E01027997","Total",788,740,48
"2011","Ashfield 010D","E01027998","Total",867,836,31
"2011","Ashfield 011A","E01027960","Total",769,740,29
"2011","Ashfield 011B","E01027961","Total",820,792,28
"2011","Ashfield 011C","E01027962","Total",622,608,14
"2011","Ashfield 011D","E01027963","Total",658,645,13
"2011","Ashfield 012A","E01027945","Total",758,726,32
"2011","Ashfield 012B","E01027946","Total",629,621,8
"2011","Ashfield 012C","E01027993","Total",676,655,21
"2011","Ashfield 012D","E01027994","Total",659,640,19
"2011","Ashfield 013A","E01027929","Total",1081,1052,29
"2011","Ashfield 013B","E01027931","Total",953,899,54
"2011","Ashfield 013C","E01027934","Total",587,582,5
"2011","Ashfield 013D","E01027935","Total",514,503,11
"2011","Ashfield 013E","E01027936","Total",663,650,13
"2011","Ashfield 014A","E01027927","Total",961,934,27
"2011","Ashfield 014B","E01027928","Total",968,893,75
"2011","Ashfield 014C","E01027932","Total",936,898,38
"2011","Ashfield 014D","E01027933","Total",707,661,46
"2011","Ashfield 014E","E01027937","Total",690,648,42
"2011","Ashfield 015A","E01027925","Total",774,743,31
"2011","Ashfield 015B","E01027938","Total",499,489,10
"2011","Ashfield 015C","E01027940","Total",570,562,8
"2011","Ashfield 015D","E01027943","Total",609,592,17
"2011","Ashfield 015E","E01027944","Total",667,655,12
"2011","Ashfield 016A","E01027926","Total",679,657,22
"2011","Ashfield 016B","E01027930","Total",734,717,17
"2011","Ashfield 016C","E01027939","Total",612,601,11
"2011","Ashfield 016D","E01027941","Total",579,571,8
"2011","Ashfield 016E","E01027942","Total",538,524,14
"2011","Bassetlaw 001A","E01028000","Total",988,951,37
"2011","Bassetlaw 001B","E01028024","Total",803,775,28
"2011","Bassetlaw 001C","E01028025","Total",663,633,30
"2011","Bassetlaw 001D","E01028026","Total",699,661,38
"2011","Bassetlaw 001E","E01028027","Total",630,592,38
"2011","Bassetlaw 001F","E01028028","Total",695,677,18
"2011","Bassetlaw 002A","E01027999","Total",1079,994,85
"2011","Bassetlaw 002B","E01028005","Total",855,822,33
"2011","Bassetlaw 002C","E01028031","Total",499,473,26
"2011","Bassetlaw 002D","E01028032","Total",594,559,35
"2011","Bassetlaw 002E","E01028035","Total",1000,961,39
"2011","Bassetlaw 003A","E01028023","Total",998,947,51
"2011","Bassetlaw 003B","E01028034","Total",1055,1010,45
"2011","Bassetlaw 003C","E01028036","Total",905,868,37
"2011","Bassetlaw 004A","E01028001","Total",595,593,2
"2011","Bassetlaw 004B","E01028002","Total",603,600,3
"2011","Bassetlaw 004C","E01028003","Total",603,600,3
"2011","Bassetlaw 004D","E01028004","Total",697,681,16
"2011","Bassetlaw 004E","E01028029","Total",532,524,8
"2011","Bassetlaw 004F","E01028030","Total",502,497,5
"2011","Bassetlaw 005A","E01028013","Total",848,783,65
"2011","Bassetlaw 005B","E01028014","Total",778,767,11
"2011","Bassetlaw 005C","E01028015","Total",648,628,20
"2011","Bassetlaw 005D","E01028016","Total",639,615,24
"2011","Bassetlaw 006A","E01028046","Total",686,673,13
"2011","Bassetlaw 006B","E01028047","Total",742,739,3
"2011","Bassetlaw 006C","E01028048","Total",612,611,1
"2011","Bassetlaw 006D","E01028049","Total",754,749,5
"2011","Bassetlaw 006E","E01028050","Total",740,729,11
"2011","Bassetlaw 008A","E01028008","Total",519,508,11
"2011","Bassetlaw 008B","E01028009","Total",650,630,20
"2011","Bassetlaw 008C","E01028010","Total",571,547,24
"2011","Bassetlaw 008D","E01028011","Total",856,794,62
"2011","Bassetlaw 008E","E01028012","Total",647,618,29
"2011","Bassetlaw 008F","E01028022","Total",703,659,44
"2011","Bassetlaw 009A","E01028055","Total",783,774,9
"2011","Bassetlaw 009B","E01028056","Total",512,507,5
"2011","Bassetlaw 009C","E01028058","Total",751,741,10
"2011","Bassetlaw 009D","E01028059","Total",643,640,3
"2011","Bassetlaw 010A","E01028017","Total",645,620,25
"2011","Bassetlaw 010B","E01028018","Total",640,625,15
"2011","Bassetlaw 010C","E01028019","Total",643,628,15
"2011","Bassetlaw 010D","E01028020","Total",946,864,82
"2011","Bassetlaw 010E","E01028021","Total",701,674,27
"2011","Bassetlaw 012A","E01028057","Total",642,602,40
"2011","Bassetlaw 012B","E01028065","Total",744,726,18
"2011","Bassetlaw 012C","E01028066","Total",713,684,29
"2011","Bassetlaw 012D","E01028068","Total",873,823,50
"2011","Bassetlaw 013A","E01028060","Total",752,727,25
"2011","Bassetlaw 013B","E01028061","Total",650,639,11
"2011","Bassetlaw 013C","E01028062","Total",997,912,85
"2011","Bassetlaw 013D","E01028067","Total",656,643,13
"2011","Bassetlaw 014A","E01028040","Total",449,434,15
"2011","Bassetlaw 014B","E01028041","Total",468,453,15
"2011","Bassetlaw 014C","E01028043","Total",612,601,11
"2011","Bassetlaw 014D","E01028063","Total",739,730,9
"2011","Bassetlaw 014E","E01028064","Total",548,533,15
"2011","Bassetlaw 015A","E01028006","Total",565,535,30
"2011","Bassetlaw 015B","E01028007","Total",470,455,15
"2011","Bassetlaw 015C","E01028033","Total",902,840,62
"2011","Bassetlaw 015D","E01028037","Total",748,687,61
"2011","Bassetlaw 015E","E01028038","Total",675,641,34
"2011","Bassetlaw 015F","E01028039","Total",547,504,43
"2011","Bassetlaw 016E","E01028042","Total",578,568,10
"2011","Bassetlaw 016F","E01028044","Total",765,755,10
"2011","Bassetlaw 016G","E01028045","Total",872,857,15
"2011","Bassetlaw 016A","E01028051","Total",743,737,6
"2011","Bassetlaw 016B","E01028052","Total",697,689,8
"2011","Bassetlaw 016C","E01028053","Total",791,782,9
"2011","Bassetlaw 016D","E01028054","Total",571,569,2
"2011","Broxtowe 001A","E01028092","Total",542,529,13
"2011","Broxtowe 001B","E01028093","Total",469,454,15
"2011","Broxtowe 001C","E01028107","Total",652,638,14
"2011","Broxtowe 001D","E01028108","Total",673,657,16
"2011","Broxtowe 001E","E01028114","Total",694,664,30
"2011","Broxtowe 002A","E01028110","Total",648,625,23
"2011","Broxtowe 002B","E01028111","Total",673,635,38
"2011","Broxtowe 002C","E01028112","Total",815,742,73
"2011","Broxtowe 002D","E01028113","Total",635,612,23
"2011","Broxtowe 003A","E01028109","Total",779,749,30
"2011","Broxtowe 003B","E01028115","Total",679,666,13
"2011","Broxtowe 003C","E01028116","Total",718,692,26
"2011","Broxtowe 003D","E01028117","Total",560,553,7
"2011","Broxtowe 003E","E01028118","Total",792,766,26
"2011","Broxtowe 004A","E01028102","Total",612,582,30
"2011","Broxtowe 004B","E01028103","Total",553,532,21
"2011","Broxtowe 004C","E01028104","Total",632,616,16
"2011","Broxtowe 004D","E01028122","Total",771,739,32
"2011","Broxtowe 004E","E01028123","Total",783,767,16
"2011","Broxtowe 004F","E01028124","Total",671,640,31
"2011","Broxtowe 007A","E01028087","Total",707,688,19
"2011","Broxtowe 007B","E01028088","Total",651,634,17
"2011","Broxtowe 007C","E01028089","Total",545,537,8
"2011","Broxtowe 007D","E01028090","Total",650,628,22
"2011","Broxtowe 007E","E01028091","Total",636,617,19
"2011","Broxtowe 008A","E01028125","Total",721,695,26
"2011","Broxtowe 008B","E01028126","Total",591,576,15
"2011","Broxtowe 008C","E01028127","Total",787,759,28
"2011","Broxtowe 008D","E01028134","Total",665,636,29
"2011","Broxtowe 009A","E01028076","Total",622,592,30
"2011","Broxtowe 009B","E01028077","Total",620,587,33
"2011","Broxtowe 009C","E01028078","Total",661,624,37
"2011","Broxtowe 009D","E01028079","Total",633,538,95
"2011","Broxtowe 009E","E01028084","Total",760,744,16
"2011","Broxtowe 010A","E01028128","Total",750,730,20
"2011","Broxtowe 010B","E01028129","Total",648,630,18
"2011","Broxtowe 010C","E01028130","Total",837,802,35
"2011","Broxtowe 010D","E01028131","Total",646,621,25
"2011","Broxtowe 010E","E01028132","Total",440,432,8
"2011","Broxtowe 010F","E01028133","Total",689,638,51
"2011","Broxtowe 011A","E01028073","Total",826,775,51
"2011","Broxtowe 011B","E01028074","Total",783,711,72
"2011","Broxtowe 011C","E01028075","Total",740,694,46
"2011","Broxtowe 011D","E01028085","Total",965,902,63
"2011","Broxtowe 011E","E01028086","Total",769,727,42
"2011","Broxtowe 012A","E01028080","Total",793,773,20
"2011","Broxtowe 012B","E01028081","Total",591,574,17
"2011","Broxtowe 012C","E01028082","Total",512,507,5
"2011","Broxtowe 012D","E01028083","Total",629,599,30
"2011","Broxtowe 013A","E01028097","Total",629,615,14
"2011","Broxtowe 013B","E01028098","Total",775,735,40
"2011","Broxtowe 013C","E01028099","Total",642,628,14
"2011","Broxtowe 013D","E01028100","Total",823,782,41
"2011","Broxtowe 013E","E01028101","Total",633,596,37
"2011","Broxtowe 014A","E01028069","Total",536,525,11
"2011","Broxtowe 014B","E01028070","Total",499,483,16
"2011","Broxtowe 014C","E01028094","Total",762,742,20
"2011","Broxtowe 014D","E01028095","Total",633,616,17
"2011","Broxtowe 014E","E01028096","Total",788,766,22
"2011","Broxtowe 015A","E01028135","Total",577,569,8
"2011","Broxtowe 015B","E01028136","Total",679,665,14
"2011","Broxtowe 015C","E01028137","Total",1000,984,16
"2011","Broxtowe 015D","E01028138","Total",578,559,19
"2011","Broxtowe 015E","E01028139","Total",586,573,13
"2011","Broxtowe 016A","E01028105","Total",525,503,22
"2011","Broxtowe 016B","E01028106","Total",690,672,18
"2011","Broxtowe 016C","E01028119","Total",820,798,22
"2011","Broxtowe 016D","E01028120","Total",665,643,22
"2011","Broxtowe 016E","E01028121","Total",602,581,21
"2011","Broxtowe 016F","E01033412","Total",1038,1007,31
"2011","Broxtowe 016G","E01033413","Total",985,950,35
"2011","Gedling 001A","E01028189","Total",985,949,36
"2011","Gedling 001B","E01028198","Total",640,621,19
"2011","Gedling 001C","E01028199","Total",683,657,26
"2011","Gedling 001D","E01028200","Total",718,692,26
"2011","Gedling 001E","E01028201","Total",500,495,5
"2011","Gedling 002A","E01028150","Total",628,615,13
"2011","Gedling 002B","E01028151","Total",479,467,12
"2011","Gedling 002C","E01028152","Total",640,625,15
"2011","Gedling 002D","E01028153","Total",603,585,18
"2011","Gedling 002E","E01028154","Total",721,695,26
"2011","Gedling 002F","E01028213","Total",930,886,44
"2011","Gedling 004A","E01028143","Total",647,633,14
"2011","Gedling 004B","E01028205","Total",532,523,9
"2011","Gedling 004C","E01028206","Total",648,633,15
"2011","Gedling 004D","E01028207","Total",534,524,10
"2011","Gedling 004E","E01028208","Total",499,485,14
"2011","Gedling 005A","E01028173","Total",453,441,12
"2011","Gedling 005B","E01028174","Total",595,585,10
"2011","Gedling 005C","E01028175","Total",835,804,31
"2011","Gedling 005D","E01028209","Total",643,616,27
"2011","Gedling 006A","E01028144","Total",685,663,22
"2011","Gedling 006B","E01028165","Total",784,747,37
"2011","Gedling 006C","E01028166","Total",727,715,12
"2011","Gedling 006D","E01028167","Total",865,832,33
"2011","Gedling 007A","E01028179","Total",602,588,14
"2011","Gedling 007B","E01028180","Total",658,648,10
"2011","Gedling 007C","E01028181","Total",676,666,10
"2011","Gedling 007D","E01028182","Total",657,653,4
"2011","Gedling 007E","E01028183","Total",616,598,18
"2011","Gedling 008A","E01028148","Total",863,836,27
"2011","Gedling 008B","E01028149","Total",781,749,32
"2011","Gedling 008C","E01028178","Total",955,927,28
"2011","Gedling 009A","E01028176","Total",631,613,18
"2011","Gedling 009B","E01028177","Total",771,750,21
"2011","Gedling 009C","E01028214","Total",654,633,21
"2011","Gedling 009D","E01028215","Total",519,510,9
"2011","Gedling 009E","E01028216","Total",525,516,9
"2011","Gedling 009F","E01028217","Total",612,585,27
"2011","Gedling 009G","E01028218","Total",683,665,18
"2011","Gedling 010A","E01028193","Total",726,672,54
"2011","Gedling 010B","E01028194","Total",660,644,16
"2011","Gedling 010C","E01028195","Total",645,621,24
"2011","Gedling 010D","E01028196","Total",595,580,15
"2011","Gedling 010E","E01028197","Total",629,608,21
"2011","Gedling 010F","E01028204","Total",593,583,10
"2011","Gedling 011A","E01028172","Total",470,462,8
"2011","Gedling 011B","E01028190","Total",667,646,21
"2011","Gedling 011C","E01028202","Total",661,649,12
"2011","Gedling 011D","E01028203","Total",627,606,21
"2011","Gedling 011E","E01028212","Total",629,620,9
"2011","Gedling 012A","E01028168","Total",564,541,23
"2011","Gedling 012B","E01028169","Total",619,604,15
"2011","Gedling 012C","E01028170","Total",632,619,13
"2011","Gedling 012D","E01028171","Total",571,563,8
"2011","Gedling 012E","E01028191","Total",759,735,24
"2011","Gedling 012F","E01028192","Total",657,638,19
"2011","Gedling 013A","E01028160","Total",671,657,14
"2011","Gedling 013B","E01028161","Total",692,654,38
"2011","Gedling 013C","E01028162","Total",652,631,21
"2011","Gedling 013D","E01028163","Total",661,639,22
"2011","Gedling 013E","E01028211","Total",602,588,14
"2011","Gedling 014A","E01028155","Total",649,626,23
"2011","Gedling 014B","E01028156","Total",669,655,14
"2011","Gedling 014C","E01028157","Total",506,493,13
"2011","Gedling 014D","E01028158","Total",800,761,39
"2011","Gedling 014E","E01028159","Total",617,600,17
"2011","Gedling 014F","E01028164","Total",584,570,14
"2011","Gedling 014G","E01028210","Total",708,688,20
"2011","Gedling 015A","E01028184","Total",492,481,11
"2011","Gedling 015B","E01028185","Total",919,885,34
"2011","Gedling 015C","E01028186","Total",810,761,49
"2011","Gedling 015D","E01028187","Total",699,676,23
"2011","Gedling 015E","E01028188","Total",670,648,22
"2011","Gedling 016A","E01028142","Total",870,849,21
"2011","Gedling 016B","E01028146","Total",664,653,11
"2011","Gedling 016C","E01028147","Total",504,474,30
"2011","Gedling 016D","E01032622","Total",558,544,14
"2011","Mansfield 001A","E01028224","Total",667,647,20
"2011","Mansfield 001B","E01028257","Total",633,596,37
"2011","Mansfield 001C","E01028258","Total",755,721,34
"2011","Mansfield 001D","E01028259","Total",594,563,31
"2011","Mansfield 002A","E01028223","Total",465,436,29
"2011","Mansfield 002B","E01028225","Total",657,640,17
"2011","Mansfield 002C","E01028226","Total",643,604,39
"2011","Mansfield 002D","E01028260","Total",757,728,29
"2011","Mansfield 003A","E01028251","Total",662,649,13
"2011","Mansfield 003B","E01028252","Total",839,826,13
"2011","Mansfield 003C","E01028253","Total",723,713,10
"2011","Mansfield 003D","E01028277","Total",537,526,11
"2011","Mansfield 003E","E01028278","Total",658,641,17
"2011","Mansfield 004A","E01028271","Total",831,792,39
"2011","Mansfield 004B","E01028279","Total",669,663,6
"2011","Mansfield 004C","E01028280","Total",557,547,10
"2011","Mansfield 004D","E01028281","Total",606,573,33
"2011","Mansfield 004E","E01028283","Total",802,772,30
"2011","Mansfield 005A","E01028242","Total",721,695,26
"2011","Mansfield 005B","E01028250","Total",643,605,38
"2011","Mansfield 005C","E01028272","Total",779,729,50
"2011","Mansfield 005D","E01028273","Total",645,624,21
"2011","Mansfield 006A","E01028229","Total",734,720,14
"2011","Mansfield 006B","E01028232","Total",671,656,15
"2011","Mansfield 006E","E01028267","Total",743,726,17
"2011","Mansfield 006F","E01028282","Total",539,515,24
"2011","Mansfield 006G","E01033392","Total",1051,960,91
"2011","Mansfield 007A","E01028237","Total",689,659,30
"2011","Mansfield 007B","E01028238","Total",608,594,14
"2011","Mansfield 007C","E01028239","Total",698,657,41
"2011","Mansfield 007D","E01028240","Total",659,628,31
"2011","Mansfield 007E","E01028241","Total",917,884,33
"2011","Mansfield 007F","E01028243","Total",839,809,30
"2011","Mansfield 008A","E01028227","Total",644,608,36
"2011","Mansfield 008B","E01028228","Total",529,511,18
"2011","Mansfield 008C","E01028247","Total",845,789,56
"2011","Mansfield 008D","E01028268","Total",868,770,98
"2011","Mansfield 008E","E01028269","Total",702,656,46
"2011","Mansfield 008F","E01028284","Total",764,714,50
"2011","Mansfield 009A","E01028233","Total",862,806,56
"2011","Mansfield 009B","E01028234","Total",831,797,34
"2011","Mansfield 009C","E01028274","Total",722,691,31
"2011","Mansfield 009D","E01028275","Total",684,665,19
"2011","Mansfield 009E","E01028276","Total",819,767,52
"2011","Mansfield 010A","E01028230","Total",598,584,14
"2011","Mansfield 010B","E01028231","Total",664,652,12
"2011","Mansfield 010C","E01028244","Total",685,666,19
"2011","Mansfield 010D","E01028245","Total",616,589,27
"2011","Mansfield 010E","E01028246","Total",751,720,31
"2011","Mansfield 010F","E01028248","Total",650,634,16
"2011","Mansfield 010G","E01028249","Total",592,561,31
"2011","Mansfield 011A","E01028235","Total",704,678,26
"2011","Mansfield 011B","E01028236","Total",746,715,31
"2011","Mansfield 011C","E01028262","Total",630,618,12
"2011","Mansfield 011D","E01028264","Total",784,779,5
"2011","Mansfield 012A","E01028254","Total",587,561,26
"2011","Mansfield 012B","E01028256","Total",851,807,44
"2011","Mansfield 012C","E01028261","Total",701,686,15
"2011","Mansfield 012D","E01028263","Total",817,785,32
"2011","Mansfield 013A","E01028219","Total",657,626,31
"2011","Mansfield 013B","E01028220","Total",831,781,50
"2011","Mansfield 013D","E01028222","Total",713,680,33
"2011","Mansfield 013E","E01028255","Total",614,594,20
"2011","Mansfield 013F","E01028270","Total",673,651,22
"2011","Mansfield 013G","E01033389","Total",640,594,46
"2011","Mansfield 013H","E01033390","Total",610,584,26
"2011","Mansfield 013I","E01033391","Total",520,511,9
"2011","Newark and Sherwood 001A","E01028301","Total",758,727,31
"2011","Newark and Sherwood 001B","E01028302","Total",717,690,27
"2011","Newark and Sherwood 001C","E01028338","Total",692,665,27
"2011","Newark and Sherwood 001D","E01028339","Total",753,727,26
"2011","Newark and Sherwood 001E","E01028340","Total",737,710,27
"2011","Newark and Sherwood 001F","E01028341","Total",828,758,70
"2011","Newark and Sherwood 002A","E01028313","Total",893,849,44
"2011","Newark and Sherwood 002B","E01028314","Total",1017,978,39
"2011","Newark and Sherwood 002C","E01028321","Total",741,717,24
"2011","Newark and Sherwood 002D","E01028322","Total",910,884,26
"2011","Newark and Sherwood 002E","E01028323","Total",696,667,29
"2011","Newark and Sherwood 003A","E01028303","Total",701,669,32
"2011","Newark and Sherwood 003B","E01028312","Total",1003,937,66
"2011","Newark and Sherwood 003C","E01028337","Total",637,621,16
"2011","Newark and Sherwood 003D","E01028349","Total",651,631,20
"2011","Newark and Sherwood 003E","E01028350","Total",523,498,25
"2011","Newark and Sherwood 004A","E01028315","Total",691,653,38
"2011","Newark and Sherwood 004B","E01028316","Total",729,702,27
"2011","Newark and Sherwood 004C","E01028317","Total",683,642,41
"2011","Newark and Sherwood 004D","E01028353","Total",1205,1159,46
"2011","Newark and Sherwood 005A","E01028295","Total",841,801,40
"2011","Newark and Sherwood 005B","E01028297","Total",857,815,42
"2011","Newark and Sherwood 005C","E01028327","Total",691,672,19
"2011","Newark and Sherwood 005D","E01028328","Total",761,738,23
"2011","Newark and Sherwood 005E","E01028329","Total",654,626,28
"2011","Newark and Sherwood 006A","E01028296","Total",585,554,31
"2011","Newark and Sherwood 006B","E01028298","Total",682,664,18
"2011","Newark and Sherwood 006C","E01028299","Total",532,525,7
"2011","Newark and Sherwood 006D","E01028300","Total",696,681,15
"2011","Newark and Sherwood 006E","E01028342","Total",650,622,28
"2011","Newark and Sherwood 006F","E01028343","Total",925,899,26
"2011","Newark and Sherwood 006G","E01028344","Total",628,610,18
"2011","Newark and Sherwood 007A","E01028294","Total",879,820,59
"2011","Newark and Sherwood 007B","E01028304","Total",664,648,16
"2011","Newark and Sherwood 007C","E01028305","Total",606,568,38
"2011","Newark and Sherwood 007D","E01028306","Total",723,688,35
"2011","Newark and Sherwood 007E","E01028307","Total",526,500,26
"2011","Newark and Sherwood 007F","E01028310","Total",1016,888,128
"2011","Newark and Sherwood 007G","E01028311","Total",987,843,144
"2011","Newark and Sherwood 008A","E01028345","Total",1044,999,45
"2011","Newark and Sherwood 008B","E01028346","Total",958,925,33
"2011","Newark and Sherwood 008C","E01028347","Total",661,638,23
"2011","Newark and Sherwood 008D","E01028348","Total",522,507,15
"2011","Newark and Sherwood 009A","E01028292","Total",934,902,32
"2011","Newark and Sherwood 009B","E01028293","Total",906,851,55
"2011","Newark and Sherwood 009C","E01028333","Total",635,614,21
"2011","Newark and Sherwood 009D","E01028334","Total",603,595,8
"2011","Newark and Sherwood 009E","E01028335","Total",937,865,72
"2011","Newark and Sherwood 010A","E01028308","Total",757,736,21
"2011","Newark and Sherwood 010B","E01028309","Total",646,632,14
"2011","Newark and Sherwood 010C","E01028318","Total",632,621,11
"2011","Newark and Sherwood 010D","E01028319","Total",884,848,36
"2011","Newark and Sherwood 010E","E01028320","Total",783,765,18
"2011","Newark and Sherwood 011A","E01028285","Total",548,527,21
"2011","Newark and Sherwood 011B","E01028286","Total",609,598,11
"2011","Newark and Sherwood 011C","E01028287","Total",668,640,28
"2011","Newark and Sherwood 011D","E01028288","Total",661,644,17
"2011","Newark and Sherwood 011E","E01028289","Total",659,642,17
"2011","Newark and Sherwood 011F","E01028290","Total",632,614,18
"2011","Newark and Sherwood 011G","E01028291","Total",662,638,24
"2011","Newark and Sherwood 012B","E01028325","Total",541,515,26
"2011","Newark and Sherwood 012C","E01028326","Total",609,583,26
"2011","Newark and Sherwood 012D","E01028336","Total",500,474,26
"2011","Newark and Sherwood 012E","E01028352","Total",486,468,18
"2011","Newark and Sherwood 012F","E01033393","Total",899,865,34
"2011","Newark and Sherwood 012G","E01033394","Total",581,561,20
"2011","Newark and Sherwood 013A","E01028330","Total",705,689,16
"2011","Newark and Sherwood 013B","E01028331","Total",621,598,23
"2011","Newark and Sherwood 013C","E01028332","Total",707,692,15
"2011","Newark and Sherwood 013D","E01028351","Total",497,481,16
"2011","Rushcliffe 001A","E01028371","Total",842,820,22
"2011","Rushcliffe 001B","E01028403","Total",971,944,27
"2011","Rushcliffe 001C","E01028411","Total",900,851,49
"2011","Rushcliffe 002A","E01028357","Total",645,631,14
"2011","Rushcliffe 002B","E01028358","Total",671,628,43
"2011","Rushcliffe 002C","E01028359","Total",682,667,15
"2011","Rushcliffe 002D","E01028360","Total",801,766,35
"2011","Rushcliffe 002E","E01028361","Total",613,604,9
"2011","Rushcliffe 002F","E01028362","Total",606,593,13
"2011","Rushcliffe 003A","E01028393","Total",521,502,19
"2011","Rushcliffe 003B","E01028394","Total",715,693,22
"2011","Rushcliffe 003C","E01028395","Total",586,571,15
"2011","Rushcliffe 003D","E01028413","Total",785,754,31
"2011","Rushcliffe 003E","E01028414","Total",728,692,36
"2011","Rushcliffe 003F","E01028415","Total",643,628,15
"2011","Rushcliffe 004A","E01028354","Total",605,598,7
"2011","Rushcliffe 004B","E01028355","Total",683,658,25
"2011","Rushcliffe 004C","E01028384","Total",682,667,15
"2011","Rushcliffe 004D","E01028385","Total",688,674,14
"2011","Rushcliffe 004E","E01028386","Total",663,632,31
"2011","Rushcliffe 005A","E01028396","Total",651,641,10
"2011","Rushcliffe 005B","E01028398","Total",728,690,38
"2011","Rushcliffe 005C","E01028399","Total",519,498,21
"2011","Rushcliffe 005D","E01028416","Total",744,691,53
"2011","Rushcliffe 005E","E01028417","Total",661,622,39
"2011","Rushcliffe 005F","E01028418","Total",729,679,50
"2011","Rushcliffe 006A","E01028356","Total",615,606,9
"2011","Rushcliffe 006B","E01028375","Total",812,794,18
"2011","Rushcliffe 006C","E01028376","Total",696,670,26
"2011","Rushcliffe 006D","E01028377","Total",749,735,14
"2011","Rushcliffe 006E","E01028397","Total",707,696,11
"2011","Rushcliffe 007A","E01028363","Total",516,510,6
"2011","Rushcliffe 007B","E01028364","Total",693,676,17
"2011","Rushcliffe 007C","E01028365","Total",700,681,19
"2011","Rushcliffe 007D","E01028391","Total",852,826,26
"2011","Rushcliffe 007E","E01028392","Total",952,934,18
"2011","Rushcliffe 008A","E01028372","Total",577,557,20
"2011","Rushcliffe 008B","E01028373","Total",587,562,25
"2011","Rushcliffe 008C","E01028374","Total",599,580,19
"2011","Rushcliffe 008D","E01028400","Total",591,584,7
"2011","Rushcliffe 008E","E01028401","Total",498,481,17
"2011","Rushcliffe 009A","E01028366","Total",529,515,14
"2011","Rushcliffe 009B","E01028367","Total",558,549,9
"2011","Rushcliffe 009C","E01028368","Total",643,632,11
"2011","Rushcliffe 009D","E01028369","Total",605,592,13
"2011","Rushcliffe 009E","E01028370","Total",658,640,18
"2011","Rushcliffe 010A","E01028402","Total",800,772,28
"2011","Rushcliffe 010B","E01028419","Total",1078,1046,32
"2011","Rushcliffe 010C","E01028420","Total",590,579,11
"2011","Rushcliffe 011A","E01028404","Total",705,674,31
"2011","Rushcliffe 011B","E01028405","Total",932,899,33
"2011","Rushcliffe 011C","E01028406","Total",722,710,12
"2011","Rushcliffe 011D","E01028407","Total",885,863,22
"2011","Rushcliffe 012A","E01028379","Total",752,719,33
"2011","Rushcliffe 012B","E01028412","Total",824,793,31
"2011","Rushcliffe 012C","E01028421","Total",931,866,65
"2011","Rushcliffe 013A","E01028380","Total",549,530,19
"2011","Rushcliffe 013B","E01028381","Total",613,597,16
"2011","Rushcliffe 013C","E01028382","Total",645,628,17
"2011","Rushcliffe 013D","E01028383","Total",522,505,17
"2011","Rushcliffe 014A","E01028378","Total",925,892,33
"2011","Rushcliffe 014B","E01028387","Total",685,672,13
"2011","Rushcliffe 014C","E01028408","Total",915,861,54
"2011","Rushcliffe 015A","E01028388","Total",632,622,10
"2011","Rushcliffe 015B","E01028389","Total",684,669,15
"2011","Rushcliffe 015C","E01028390","Total",697,686,11
"2011","Rushcliffe 015D","E01028409","Total",539,508,31
"2011","Rushcliffe 015E","E01028410","Total",561,530,31
"2011","Herefordshire 001A","E01013998","Total",654,612,42
"2011","Herefordshire 001B","E01014051","Total",810,737,73
"2011","Herefordshire 001C","E01014052","Total",713,652,61
"2011","Herefordshire 001D","E01014096","Total",708,649,59
"2011","Herefordshire 002A","E01014041","Total",752,721,31
"2011","Herefordshire 002B","E01014042","Total",695,665,30
"2011","Herefordshire 002C","E01014043","Total",534,513,21
"2011","Herefordshire 002D","E01014044","Total",628,598,30
"2011","Herefordshire 003A","E01014045","Total",707,683,24
"2011","Herefordshire 003B","E01014046","Total",638,616,22
"2011","Herefordshire 003C","E01014047","Total",632,612,20
"2011","Herefordshire 003D","E01014048","Total",842,776,66
"2011","Herefordshire 004A","E01013999","Total",671,614,57
"2011","Herefordshire 004B","E01014017","Total",695,632,63
"2011","Herefordshire 004C","E01014024","Total",594,545,49
"2011","Herefordshire 004D","E01014025","Total",638,596,42
"2011","Herefordshire 004E","E01014055","Total",751,672,79
"2011","Herefordshire 004F","E01014097","Total",609,576,33
"2011","Herefordshire 005A","E01014000","Total",603,567,36
"2011","Herefordshire 005B","E01014001","Total",666,623,43
"2011","Herefordshire 005C","E01014002","Total",651,616,35
"2011","Herefordshire 005D","E01014003","Total",618,595,23
"2011","Herefordshire 005E","E01014004","Total",625,589,36
"2011","Herefordshire 005F","E01014005","Total",859,798,61
"2011","Herefordshire 005G","E01014015","Total",704,656,48
"2011","Herefordshire 006A","E01014008","Total",762,705,57
"2011","Herefordshire 006B","E01014009","Total",731,646,85
"2011","Herefordshire 006C","E01014033","Total",870,776,94
"2011","Herefordshire 006D","E01014034","Total",754,683,71
"2011","Herefordshire 006E","E01014056","Total",662,610,52
"2011","Herefordshire 007A","E01014006","Total",684,652,32
"2011","Herefordshire 007B","E01014012","Total",718,699,19
"2011","Herefordshire 007C","E01014013","Total",685,670,15
"2011","Herefordshire 007D","E01014016","Total",705,665,40
"2011","Herefordshire 007E","E01014100","Total",680,650,30
"2011","Herefordshire 007F","E01014101","Total",482,454,28
"2011","Herefordshire 008A","E01014022","Total",832,791,41
"2011","Herefordshire 008B","E01014023","Total",698,680,18
"2011","Herefordshire 008C","E01014081","Total",621,598,23
"2011","Herefordshire 008D","E01014082","Total",710,694,16
"2011","Herefordshire 009A","E01014027","Total",548,532,16
"2011","Herefordshire 009B","E01014028","Total",693,624,69
"2011","Herefordshire 009C","E01014029","Total",691,656,35
"2011","Herefordshire 009D","E01014030","Total",614,587,27
"2011","Herefordshire 010A","E01014083","Total",727,710,17
"2011","Herefordshire 010B","E01014084","Total",754,735,19
"2011","Herefordshire 010C","E01014085","Total",597,578,19
"2011","Herefordshire 010D","E01014087","Total",733,712,21
"2011","Herefordshire 010E","E01014088","Total",717,696,21
"2011","Herefordshire 010F","E01014089","Total",589,579,10
"2011","Herefordshire 011A","E01013987","Total",702,671,31
"2011","Herefordshire 011B","E01013988","Total",945,912,33
"2011","Herefordshire 011C","E01014007","Total",689,668,21
"2011","Herefordshire 011D","E01014095","Total",592,581,11
"2011","Herefordshire 012A","E01013986","Total",743,729,14
"2011","Herefordshire 012B","E01013989","Total",593,582,11
"2011","Herefordshire 012C","E01014010","Total",959,849,110
"2011","Herefordshire 012D","E01014011","Total",676,648,28
"2011","Herefordshire 012E","E01014086","Total",737,713,24
"2011","Herefordshire 012F","E01014092","Total",961,903,58
"2011","Herefordshire 013A","E01014075","Total",717,693,24
"2011","Herefordshire 013B","E01014076","Total",1086,1030,56
"2011","Herefordshire 013C","E01014077","Total",724,710,14
"2011","Herefordshire 013D","E01014078","Total",608,599,9
"2011","Herefordshire 014A","E01014090","Total",614,601,13
"2011","Herefordshire 014B","E01014091","Total",649,634,15
"2011","Herefordshire 014C","E01014093","Total",619,598,21
"2011","Herefordshire 014D","E01014094","Total",601,589,12
"2011","Herefordshire 015A","E01014068","Total",625,609,16
"2011","Herefordshire 015B","E01014070","Total",910,897,13
"2011","Herefordshire 015C","E01014072","Total",848,826,22
"2011","Herefordshire 015D","E01014073","Total",813,801,12
"2011","Herefordshire 015E","E01014074","Total",748,722,26
"2011","Herefordshire 016A","E01013996","Total",693,680,13
"2011","Herefordshire 016B","E01013997","Total",845,822,23
"2011","Herefordshire 016C","E01014079","Total",673,641,32
"2011","Herefordshire 016D","E01014080","Total",607,598,9
"2011","Herefordshire 017A","E01013992","Total",604,594,10
"2011","Herefordshire 017B","E01013993","Total",614,606,8
"2011","Herefordshire 017C","E01013994","Total",647,632,15
"2011","Herefordshire 017D","E01013995","Total",751,734,17
"2011","Herefordshire 017E","E01014071","Total",624,610,14
"2011","Herefordshire 018A","E01013990","Total",795,751,44
"2011","Herefordshire 018B","E01013991","Total",556,536,20
"2011","Herefordshire 018C","E01014014","Total",791,729,62
"2011","Herefordshire 018D","E01014054","Total",610,585,25
"2011","Herefordshire 019A","E01014035","Total",863,790,73
"2011","Herefordshire 019B","E01014036","Total",756,690,66
"2011","Herefordshire 019C","E01014037","Total",759,733,26
"2011","Herefordshire 019D","E01014038","Total",633,624,9
"2011","Herefordshire 019E","E01014039","Total",735,721,14
"2011","Herefordshire 019F","E01014040","Total",792,757,35
"2011","Herefordshire 020A","E01014018","Total",711,628,83
"2011","Herefordshire 020B","E01014019","Total",711,671,40
"2011","Herefordshire 020C","E01014020","Total",758,636,122
"2011","Herefordshire 020D","E01014021","Total",691,638,53
"2011","Herefordshire 021A","E01014026","Total",953,896,57
"2011","Herefordshire 021B","E01014059","Total",860,780,80
"2011","Herefordshire 021C","E01014060","Total",689,646,43
"2011","Herefordshire 021D","E01014069","Total",806,793,13
"2011","Herefordshire 021E","E01014098","Total",594,583,11
"2011","Herefordshire 021F","E01014099","Total",794,735,59
"2011","Herefordshire 022A","E01014061","Total",707,683,24
"2011","Herefordshire 022B","E01014062","Total",909,819,90
"2011","Herefordshire 022C","E01014063","Total",763,734,29
"2011","Herefordshire 022D","E01014064","Total",806,779,27
"2011","Herefordshire 022E","E01014065","Total",654,634,20
"2011","Herefordshire 022F","E01014066","Total",602,541,61
"2011","Herefordshire 022G","E01014067","Total",613,594,19
"2011","Herefordshire 023A","E01014031","Total",713,631,82
"2011","Herefordshire 023B","E01014032","Total",789,689,100
"2011","Herefordshire 023C","E01014049","Total",721,666,55
"2011","Herefordshire 023D","E01014050","Total",774,706,68
"2011","Herefordshire 023E","E01014053","Total",771,719,52
"2011","Herefordshire 023F","E01014057","Total",767,726,41
"2011","Herefordshire 023G","E01014058","Total",759,699,60
"2011","Shropshire 025A","E01028853","Total",652,641,11
"2011","Shropshire 025B","E01028854","Total",693,665,28
"2011","Shropshire 025C","E01028855","Total",672,656,16
"2011","Shropshire 025D","E01028856","Total",646,602,44
"2011","Shropshire 025E","E01028857","Total",778,752,26
"2011","Shropshire 027A","E01028826","Total",783,760,23
"2011","Shropshire 027B","E01028827","Total",615,598,17
"2011","Shropshire 027C","E01028844","Total",540,478,62
"2011","Shropshire 027D","E01028845","Total",914,881,33
"2011","Shropshire 029A","E01028838","Total",681,649,32
"2011","Shropshire 029B","E01028839","Total",582,555,27
"2011","Shropshire 029C","E01028840","Total",545,534,11
"2011","Shropshire 029D","E01028841","Total",721,681,40
"2011","Shropshire 029E","E01028850","Total",994,931,63
"2011","Shropshire 029F","E01028851","Total",783,741,42
"2011","Shropshire 029G","E01028852","Total",747,708,39
"2011","Shropshire 031A","E01028830","Total",772,702,70
"2011","Shropshire 031B","E01028831","Total",655,635,20
"2011","Shropshire 031C","E01028836","Total",708,686,22
"2011","Shropshire 031D","E01028837","Total",676,660,16
"2011","Shropshire 033A","E01028832","Total",943,871,72
"2011","Shropshire 033B","E01028833","Total",690,670,20
"2011","Shropshire 033C","E01028834","Total",667,645,22
"2011","Shropshire 033D","E01028835","Total",656,632,24
"2011","Shropshire 034A","E01028828","Total",702,673,29
"2011","Shropshire 034B","E01028829","Total",591,579,12
"2011","Shropshire 034C","E01028842","Total",699,665,34
"2011","Shropshire 034D","E01028847","Total",646,617,29
"2011","Shropshire 034E","E01028859","Total",704,661,43
"2011","Shropshire 035A","E01028843","Total",712,681,31
"2011","Shropshire 035B","E01028846","Total",798,729,69
"2011","Shropshire 035C","E01028848","Total",709,690,19
"2011","Shropshire 035D","E01028849","Total",944,893,51
"2011","Shropshire 035E","E01028858","Total",889,839,50
"2011","Shropshire 001A","E01028891","Total",901,850,51
"2011","Shropshire 001B","E01028892","Total",621,593,28
"2011","Shropshire 001C","E01028894","Total",671,649,22
"2011","Shropshire 001D","E01028895","Total",711,684,27
"2011","Shropshire 001E","E01028896","Total",925,889,36
"2011","Shropshire 001F","E01028897","Total",630,617,13
"2011","Shropshire 002A","E01028880","Total",667,638,29
"2011","Shropshire 002B","E01028881","Total",542,523,19
"2011","Shropshire 002C","E01028882","Total",634,605,29
"2011","Shropshire 002D","E01028893","Total",621,605,16
"2011","Shropshire 002E","E01028899","Total",660,648,12
"2011","Shropshire 004A","E01028864","Total",641,611,30
"2011","Shropshire 004B","E01028865","Total",745,722,23
"2011","Shropshire 004C","E01028866","Total",637,593,44
"2011","Shropshire 004D","E01028867","Total",631,612,19
"2011","Shropshire 004E","E01028872","Total",584,560,24
"2011","Shropshire 005A","E01028873","Total",895,835,60
"2011","Shropshire 005B","E01028874","Total",636,615,21
"2011","Shropshire 005C","E01028875","Total",1008,984,24
"2011","Shropshire 005D","E01028876","Total",877,841,36
"2011","Shropshire 005E","E01028877","Total",548,534,14
"2011","Shropshire 005F","E01028878","Total",704,683,21
"2011","Shropshire 005G","E01028879","Total",665,652,13
"2011","Shropshire 008A","E01028886","Total",808,757,51
"2011","Shropshire 008B","E01028887","Total",616,596,20
"2011","Shropshire 008C","E01028889","Total",642,622,20
"2011","Shropshire 008D","E01028890","Total",696,651,45
"2011","Shropshire 009A","E01028868","Total",602,592,10
"2011","Shropshire 009B","E01028869","Total",587,555,32
"2011","Shropshire 009C","E01028871","Total",503,484,19
"2011","Shropshire 009D","E01028885","Total",856,791,65
"2011","Shropshire 010A","E01028860","Total",745,720,25
"2011","Shropshire 010B","E01028862","Total",677,650,27
"2011","Shropshire 010C","E01028863","Total",519,497,22
"2011","Shropshire 010D","E01028888","Total",616,593,23
"2011","Shropshire 010E","E01028898","Total",585,555,30
"2011","Shropshire 013A","E01028861","Total",558,526,32
"2011","Shropshire 013B","E01028870","Total",606,578,28
"2011","Shropshire 013C","E01028883","Total",552,524,28
"2011","Shropshire 013D","E01028884","Total",668,647,21
"2011","Shropshire 003A","E01028910","Total",533,507,26
"2011","Shropshire 003B","E01028911","Total",554,539,15
"2011","Shropshire 003C","E01028912","Total",520,499,21
"2011","Shropshire 003D","E01028920","Total",543,525,18
"2011","Shropshire 003E","E01028921","Total",661,632,29
"2011","Shropshire 003F","E01028925","Total",564,531,33
"2011","Shropshire 003G","E01028926","Total",632,596,36
"2011","Shropshire 006C","E01028902","Total",521,498,23
"2011","Shropshire 006D","E01028903","Total",654,636,18
"2011","Shropshire 006E","E01028904","Total",587,577,10
"2011","Shropshire 006F","E01028905","Total",755,730,25
"2011","Shropshire 006G","E01028909","Total",622,607,15
"2011","Shropshire 006H","E01033528","Total",1067,1050,17
"2011","Shropshire 007A","E01028906","Total",751,668,83
"2011","Shropshire 007B","E01028907","Total",841,809,32
"2011","Shropshire 007C","E01028908","Total",803,755,48
"2011","Shropshire 007D","E01028916","Total",722,699,23
"2011","Shropshire 007E","E01028917","Total",667,642,25
"2011","Shropshire 007F","E01028924","Total",654,632,22
"2011","Shropshire 011A","E01028913","Total",678,641,37
"2011","Shropshire 011B","E01028918","Total",600,580,20
"2011","Shropshire 011C","E01028919","Total",511,493,18
"2011","Shropshire 011D","E01028927","Total",442,427,15
"2011","Shropshire 011E","E01028928","Total",665,644,21
"2011","Shropshire 012A","E01028914","Total",477,460,17
"2011","Shropshire 012B","E01028915","Total",629,586,43
"2011","Shropshire 012C","E01028922","Total",518,494,24
"2011","Shropshire 012D","E01028923","Total",684,648,36
"2011","Shropshire 014A","E01028929","Total",603,593,10
"2011","Shropshire 014B","E01028969","Total",559,541,18
"2011","Shropshire 014C","E01028970","Total",507,493,14
"2011","Shropshire 014D","E01028971","Total",940,910,30
"2011","Shropshire 014E","E01028978","Total",643,616,27
"2011","Shropshire 014F","E01028979","Total",531,508,23
"2011","Shropshire 015A","E01028933","Total",666,655,11
"2011","Shropshire 015B","E01028934","Total",622,614,8
"2011","Shropshire 015C","E01028956","Total",649,642,7
"2011","Shropshire 015D","E01028957","Total",661,641,20
"2011","Shropshire 015E","E01028958","Total",778,764,14
"2011","Shropshire 016A","E01028932","Total",808,784,24
"2011","Shropshire 016B","E01028981","Total",687,668,19
"2011","Shropshire 016C","E01028982","Total",657,642,15
"2011","Shropshire 016D","E01028983","Total",830,810,20
"2011","Shropshire 017A","E01028930","Total",694,678,16
"2011","Shropshire 017B","E01028931","Total",995,925,70
"2011","Shropshire 017C","E01028944","Total",864,836,28
"2011","Shropshire 017D","E01028945","Total",1075,1032,43
"2011","Shropshire 018A","E01028965","Total",650,641,9
"2011","Shropshire 018B","E01028966","Total",499,494,5
"2011","Shropshire 018C","E01028967","Total",673,655,18
"2011","Shropshire 018D","E01028968","Total",547,537,10
"2011","Shropshire 018E","E01028988","Total",735,710,25
"2011","Shropshire 018F","E01028989","Total",671,658,13
"2011","Shropshire 019A","E01028946","Total",1275,1126,149
"2011","Shropshire 019B","E01028972","Total",754,738,16
"2011","Shropshire 019C","E01028973","Total",1038,969,69
"2011","Shropshire 019D","E01028987","Total",1117,1056,61
"2011","Shropshire 020A","E01028941","Total",863,835,28
"2011","Shropshire 020B","E01028942","Total",517,514,3
"2011","Shropshire 020C","E01028943","Total",1123,1076,47
"2011","Shropshire 020D","E01028951","Total",705,674,31
"2011","Shropshire 020E","E01028953","Total",660,647,13
"2011","Shropshire 021A","E01028947","Total",647,637,10
"2011","Shropshire 021B","E01028948","Total",649,636,13
"2011","Shropshire 021C","E01028949","Total",664,648,16
"2011","Shropshire 021D","E01028985","Total",645,632,13
"2011","Shropshire 022A","E01028938","Total",921,874,47
"2011","Shropshire 022B","E01028939","Total",801,772,29
"2011","Shropshire 022C","E01028984","Total",698,689,9
"2011","Shropshire 022D","E01028986","Total",643,634,9
"2011","Shropshire 023A","E01028940","Total",698,678,20
"2011","Shropshire 023B","E01028952","Total",811,800,11
"2011","Shropshire 023C","E01028962","Total",687,676,11
"2011","Shropshire 023D","E01028963","Total",681,663,18
"2011","Shropshire 023E","E01028964","Total",690,675,15
"2011","Shropshire 023F","E01028974","Total",526,507,19
"2011","Shropshire 024A","E01028935","Total",642,630,12
"2011","Shropshire 024B","E01028936","Total",883,858,25
"2011","Shropshire 024C","E01028937","Total",647,637,10
"2011","Shropshire 024D","E01028959","Total",1137,1098,39
"2011","Shropshire 026A","E01028954","Total",534,522,12
"2011","Shropshire 026B","E01028955","Total",502,494,8
"2011","Shropshire 026C","E01028975","Total",748,720,28
"2011","Shropshire 026D","E01028976","Total",707,684,23
"2011","Shropshire 026E","E01028977","Total",847,819,28
"2011","Shropshire 028A","E01028950","Total",1018,978,40
"2011","Shropshire 028B","E01028960","Total",587,540,47
"2011","Shropshire 028C","E01028961","Total",554,525,29
"2011","Shropshire 028D","E01028980","Total",985,938,47
"2011","Shropshire 030A","E01028991","Total",568,519,49
"2011","Shropshire 030B","E01028992","Total",749,691,58
"2011","Shropshire 030D","E01033529","Total",469,431,38
"2011","Shropshire 030E","E01033530","Total",880,831,49
"2011","Shropshire 032A","E01028990","Total",506,467,39
"2011","Shropshire 032B","E01028997","Total",1161,1075,86
"2011","Shropshire 032C","E01028998","Total",1189,1105,84
"2011","Shropshire 036A","E01028993","Total",683,618,65
"2011","Shropshire 036B","E01029004","Total",484,447,37
"2011","Shropshire 036C","E01029013","Total",838,780,58
"2011","Shropshire 036D","E01029014","Total",515,504,11
"2011","Shropshire 036E","E01029015","Total",651,597,54
"2011","Shropshire 037A","E01028994","Total",605,557,48
"2011","Shropshire 037B","E01029003","Total",1163,1040,123
"2011","Shropshire 037C","E01029005","Total",611,558,53
"2011","Shropshire 037D","E01029016","Total",648,595,53
"2011","Shropshire 038A","E01029006","Total",773,753,20
"2011","Shropshire 038B","E01029007","Total",522,504,18
"2011","Shropshire 038D","E01029009","Total",574,554,20
"2011","Shropshire 038E","E01029010","Total",602,582,20
"2011","Shropshire 038F","E01029011","Total",722,683,39
"2011","Shropshire 038G","E01029012","Total",826,796,30
"2011","Shropshire 038H","E01033526","Total",721,615,106
"2011","Shropshire 038I","E01033527","Total",793,686,107
"2011","Shropshire 039A","E01028995","Total",666,641,25
"2011","Shropshire 039B","E01028996","Total",607,573,34
"2011","Shropshire 039C","E01028999","Total",693,654,39
"2011","Shropshire 039D","E01029000","Total",507,477,30
"2011","Shropshire 039E","E01029001","Total",832,798,34
"2011","Shropshire 039F","E01029002","Total",587,551,36
"2011","Stoke-on-Trent 001A","E01014257","Total",666,640,26
"2011","Stoke-on-Trent 001B","E01014258","Total",557,541,16
"2011","Stoke-on-Trent 001C","E01014259","Total",658,647,11
"2011","Stoke-on-Trent 001D","E01014260","Total",623,604,19
"2011","Stoke-on-Trent 001E","E01014264","Total",806,772,34
"2011","Stoke-on-Trent 002A","E01014357","Total",735,705,30
"2011","Stoke-on-Trent 002B","E01014358","Total",630,590,40
"2011","Stoke-on-Trent 002C","E01014359","Total",798,758,40
"2011","Stoke-on-Trent 002D","E01014360","Total",827,784,43
"2011","Stoke-on-Trent 003A","E01014261","Total",596,577,19
"2011","Stoke-on-Trent 003B","E01014262","Total",541,528,13
"2011","Stoke-on-Trent 003C","E01014263","Total",634,624,10
"2011","Stoke-on-Trent 003D","E01014333","Total",613,605,8
"2011","Stoke-on-Trent 003E","E01014334","Total",766,756,10
"2011","Stoke-on-Trent 004A","E01014331","Total",660,639,21
"2011","Stoke-on-Trent 004B","E01014332","Total",819,790,29
"2011","Stoke-on-Trent 004C","E01014335","Total",795,751,44
"2011","Stoke-on-Trent 004D","E01014336","Total",747,717,30
"2011","Stoke-on-Trent 004E","E01014337","Total",753,722,31
"2011","Stoke-on-Trent 005A","E01014354","Total",910,846,64
"2011","Stoke-on-Trent 005B","E01014355","Total",805,753,52
"2011","Stoke-on-Trent 005C","E01014356","Total",802,746,56
"2011","Stoke-on-Trent 005D","E01014361","Total",756,667,89
"2011","Stoke-on-Trent 006A","E01014241","Total",683,656,27
"2011","Stoke-on-Trent 006B","E01014242","Total",648,628,20
"2011","Stoke-on-Trent 006C","E01014243","Total",613,599,14
"2011","Stoke-on-Trent 006D","E01014244","Total",618,606,12
"2011","Stoke-on-Trent 006E","E01014245","Total",742,706,36
"2011","Stoke-on-Trent 006F","E01014248","Total",687,660,27
"2011","Stoke-on-Trent 007A","E01014214","Total",650,628,22
"2011","Stoke-on-Trent 007B","E01014215","Total",634,610,24
"2011","Stoke-on-Trent 007C","E01014216","Total",647,634,13
"2011","Stoke-on-Trent 007D","E01014265","Total",702,681,21
"2011","Stoke-on-Trent 007E","E01014267","Total",1096,1060,36
"2011","Stoke-on-Trent 007F","E01014272","Total",693,661,32
"2011","Stoke-on-Trent 008A","E01014246","Total",757,728,29
"2011","Stoke-on-Trent 008B","E01014266","Total",614,577,37
"2011","Stoke-on-Trent 008C","E01014268","Total",1046,998,48
"2011","Stoke-on-Trent 008D","E01014270","Total",674,650,24
"2011","Stoke-on-Trent 008E","E01014271","Total",637,615,22
"2011","Stoke-on-Trent 009A","E01014247","Total",826,776,50
"2011","Stoke-on-Trent 009B","E01014250","Total",592,537,55
"2011","Stoke-on-Trent 009C","E01014251","Total",969,912,57
"2011","Stoke-on-Trent 009D","E01014252","Total",777,748,29
"2011","Stoke-on-Trent 009E","E01014255","Total",728,692,36
"2011","Stoke-on-Trent 010A","E01014269","Total",696,668,28
"2011","Stoke-on-Trent 010B","E01014324","Total",710,684,26
"2011","Stoke-on-Trent 010C","E01014325","Total",524,518,6
"2011","Stoke-on-Trent 010D","E01014326","Total",594,589,5
"2011","Stoke-on-Trent 011A","E01014249","Total",848,782,66
"2011","Stoke-on-Trent 011B","E01014253","Total",670,657,13
"2011","Stoke-on-Trent 011C","E01014254","Total",706,643,63
"2011","Stoke-on-Trent 011D","E01014256","Total",829,775,54
"2011","Stoke-on-Trent 012A","E01014210","Total",619,612,7
"2011","Stoke-on-Trent 012B","E01014211","Total",627,622,5
"2011","Stoke-on-Trent 012C","E01014212","Total",614,610,4
"2011","Stoke-on-Trent 012D","E01014213","Total",528,521,7
"2011","Stoke-on-Trent 012E","E01014217","Total",659,639,20
"2011","Stoke-on-Trent 013A","E01014323","Total",652,609,43
"2011","Stoke-on-Trent 013B","E01014327","Total",703,675,28
"2011","Stoke-on-Trent 013C","E01014328","Total",648,640,8
"2011","Stoke-on-Trent 013D","E01014329","Total",736,723,13
"2011","Stoke-on-Trent 013E","E01014330","Total",952,912,40
"2011","Stoke-on-Trent 014A","E01014218","Total",615,612,3
"2011","Stoke-on-Trent 014B","E01014219","Total",600,584,16
"2011","Stoke-on-Trent 014C","E01014225","Total",679,668,11
"2011","Stoke-on-Trent 014D","E01014226","Total",741,723,18
"2011","Stoke-on-Trent 014E","E01014228","Total",575,573,2
"2011","Stoke-on-Trent 014F","E01014230","Total",710,686,24
"2011","Stoke-on-Trent 015A","E01014281","Total",661,622,39
"2011","Stoke-on-Trent 015B","E01014285","Total",972,918,54
"2011","Stoke-on-Trent 015C","E01014286","Total",587,544,43
"2011","Stoke-on-Trent 015D","E01014287","Total",703,635,68
"2011","Stoke-on-Trent 016B","E01014231","Total",960,947,13
"2011","Stoke-on-Trent 016D","E01014282","Total",528,493,35
"2011","Stoke-on-Trent 016E","E01014283","Total",914,806,108
"2011","Stoke-on-Trent 016F","E01014284","Total",504,468,36
"2011","Stoke-on-Trent 016G","E01033216","Total",1248,1186,62
"2011","Stoke-on-Trent 017A","E01014220","Total",725,717,8
"2011","Stoke-on-Trent 017B","E01014221","Total",660,657,3
"2011","Stoke-on-Trent 017C","E01014222","Total",656,647,9
"2011","Stoke-on-Trent 017D","E01014223","Total",763,749,14
"2011","Stoke-on-Trent 017E","E01014224","Total",680,671,9
"2011","Stoke-on-Trent 017F","E01014229","Total",785,771,14
"2011","Stoke-on-Trent 018A","E01014288","Total",776,728,48
"2011","Stoke-on-Trent 018B","E01014289","Total",705,666,39
"2011","Stoke-on-Trent 018C","E01014290","Total",702,673,29
"2011","Stoke-on-Trent 018D","E01014291","Total",638,624,14
"2011","Stoke-on-Trent 018E","E01014292","Total",735,692,43
"2011","Stoke-on-Trent 018F","E01014294","Total",618,597,21
"2011","Stoke-on-Trent 019A","E01014293","Total",861,772,89
"2011","Stoke-on-Trent 019B","E01014295","Total",828,794,34
"2011","Stoke-on-Trent 019C","E01014339","Total",874,803,71
"2011","Stoke-on-Trent 019D","E01014340","Total",903,863,40
"2011","Stoke-on-Trent 019E","E01014345","Total",932,893,39
"2011","Stoke-on-Trent 020A","E01014274","Total",887,858,29
"2011","Stoke-on-Trent 020B","E01014275","Total",778,754,24
"2011","Stoke-on-Trent 020C","E01014276","Total",807,735,72
"2011","Stoke-on-Trent 020D","E01014277","Total",730,711,19
"2011","Stoke-on-Trent 020E","E01014279","Total",886,803,83
"2011","Stoke-on-Trent 021A","E01014273","Total",675,577,98
"2011","Stoke-on-Trent 021B","E01014278","Total",596,588,8
"2011","Stoke-on-Trent 021C","E01014280","Total",628,610,18
"2011","Stoke-on-Trent 021D","E01014297","Total",490,487,3
"2011","Stoke-on-Trent 022A","E01014296","Total",622,608,14
"2011","Stoke-on-Trent 022B","E01014298","Total",696,687,9
"2011","Stoke-on-Trent 022C","E01014300","Total",642,623,19
"2011","Stoke-on-Trent 022D","E01014302","Total",953,926,27
"2011","Stoke-on-Trent 023A","E01014338","Total",704,676,28
"2011","Stoke-on-Trent 023B","E01014341","Total",779,764,15
"2011","Stoke-on-Trent 023C","E01014342","Total",611,598,13
"2011","Stoke-on-Trent 023D","E01014343","Total",883,843,40
"2011","Stoke-on-Trent 023E","E01014344","Total",626,615,11
"2011","Stoke-on-Trent 024A","E01014363","Total",639,624,15
"2011","Stoke-on-Trent 024B","E01014364","Total",623,597,26
"2011","Stoke-on-Trent 024C","E01014365","Total",645,638,7
"2011","Stoke-on-Trent 024D","E01014369","Total",576,556,20
"2011","Stoke-on-Trent 025A","E01014299","Total",603,598,5
"2011","Stoke-on-Trent 025B","E01014301","Total",657,651,6
"2011","Stoke-on-Trent 025C","E01014303","Total",671,656,15
"2011","Stoke-on-Trent 025D","E01014304","Total",662,645,17
"2011","Stoke-on-Trent 025E","E01014362","Total",589,586,3
"2011","Stoke-on-Trent 026A","E01014233","Total",642,629,13
"2011","Stoke-on-Trent 026B","E01014234","Total",578,564,14
"2011","Stoke-on-Trent 026C","E01014239","Total",615,601,14
"2011","Stoke-on-Trent 026D","E01014240","Total",644,626,18
"2011","Stoke-on-Trent 027A","E01014308","Total",781,768,13
"2011","Stoke-on-Trent 027B","E01014309","Total",644,599,45
"2011","Stoke-on-Trent 027C","E01014311","Total",634,617,17
"2011","Stoke-on-Trent 027D","E01014313","Total",846,830,16
"2011","Stoke-on-Trent 028A","E01014321","Total",673,642,31
"2011","Stoke-on-Trent 028B","E01014366","Total",839,809,30
"2011","Stoke-on-Trent 028C","E01014367","Total",700,666,34
"2011","Stoke-on-Trent 028D","E01014368","Total",745,676,69
"2011","Stoke-on-Trent 029A","E01014305","Total",507,481,26
"2011","Stoke-on-Trent 029B","E01014306","Total",590,539,51
"2011","Stoke-on-Trent 029C","E01014307","Total",520,462,58
"2011","Stoke-on-Trent 029D","E01014312","Total",620,593,27
"2011","Stoke-on-Trent 030A","E01014346","Total",748,729,19
"2011","Stoke-on-Trent 030B","E01014348","Total",636,615,21
"2011","Stoke-on-Trent 030C","E01014349","Total",665,642,23
"2011","Stoke-on-Trent 030D","E01014353","Total",719,706,13
"2011","Stoke-on-Trent 031A","E01014310","Total",766,751,15
"2011","Stoke-on-Trent 031B","E01014314","Total",538,523,15
"2011","Stoke-on-Trent 031C","E01014316","Total",640,616,24
"2011","Stoke-on-Trent 031D","E01014317","Total",717,692,25
"2011","Stoke-on-Trent 031E","E01014322","Total",681,656,25
"2011","Stoke-on-Trent 032A","E01014235","Total",801,765,36
"2011","Stoke-on-Trent 032B","E01014236","Total",1021,986,35
"2011","Stoke-on-Trent 032C","E01014237","Total",803,777,26
"2011","Stoke-on-Trent 032D","E01014238","Total",678,666,12
"2011","Stoke-on-Trent 033A","E01014315","Total",603,598,5
"2011","Stoke-on-Trent 033B","E01014318","Total",609,597,12
"2011","Stoke-on-Trent 033C","E01014319","Total",619,597,22
"2011","Stoke-on-Trent 033D","E01014320","Total",496,477,19
"2011","Stoke-on-Trent 034A","E01014347","Total",587,583,4
"2011","Stoke-on-Trent 034B","E01014350","Total",566,553,13
"2011","Stoke-on-Trent 034C","E01014351","Total",578,566,12
"2011","Stoke-on-Trent 034D","E01014352","Total",587,579,8
"2011","Telford and Wrekin 001A","E01014171","Total",600,591,9
"2011","Telford and Wrekin 001B","E01014172","Total",523,518,5
"2011","Telford and Wrekin 001C","E01014173","Total",688,663,25
"2011","Telford and Wrekin 001D","E01014174","Total",600,593,7
"2011","Telford and Wrekin 002A","E01014112","Total",651,624,27
"2011","Telford and Wrekin 002B","E01014131","Total",603,584,19
"2011","Telford and Wrekin 002C","E01014132","Total",459,450,9
"2011","Telford and Wrekin 002D","E01014135","Total",495,477,18
"2011","Telford and Wrekin 003A","E01014175","Total",524,507,17
"2011","Telford and Wrekin 003B","E01014176","Total",644,632,12
"2011","Telford and Wrekin 003C","E01014177","Total",595,584,11
"2011","Telford and Wrekin 003D","E01014178","Total",709,665,44
"2011","Telford and Wrekin 004A","E01014111","Total",654,625,29
"2011","Telford and Wrekin 004B","E01014167","Total",703,688,15
"2011","Telford and Wrekin 004C","E01014168","Total",504,501,3
"2011","Telford and Wrekin 004D","E01014170","Total",673,658,15
"2011","Telford and Wrekin 005A","E01014125","Total",676,659,17
"2011","Telford and Wrekin 005B","E01014126","Total",608,597,11
"2011","Telford and Wrekin 005C","E01014127","Total",660,644,16
"2011","Telford and Wrekin 005D","E01014128","Total",876,814,62
"2011","Telford and Wrekin 005E","E01014169","Total",742,703,39
"2011","Telford and Wrekin 006A","E01014129","Total",552,534,18
"2011","Telford and Wrekin 006B","E01014130","Total",589,579,10
"2011","Telford and Wrekin 006C","E01014179","Total",488,487,1
"2011","Telford and Wrekin 006D","E01014180","Total",591,586,5
"2011","Telford and Wrekin 006E","E01014189","Total",598,589,9
"2011","Telford and Wrekin 006F","E01014190","Total",613,607,6
"2011","Telford and Wrekin 007A","E01014102","Total",688,674,14
"2011","Telford and Wrekin 007B","E01014103","Total",476,473,3
"2011","Telford and Wrekin 007C","E01014138","Total",614,603,11
"2011","Telford and Wrekin 007D","E01014140","Total",631,615,16
"2011","Telford and Wrekin 008A","E01014205","Total",606,596,10
"2011","Telford and Wrekin 008B","E01014206","Total",519,511,8
"2011","Telford and Wrekin 008C","E01014207","Total",504,492,12
"2011","Telford and Wrekin 008D","E01014208","Total",548,534,14
"2011","Telford and Wrekin 008E","E01014209","Total",600,591,9
"2011","Telford and Wrekin 009A","E01014137","Total",529,519,10
"2011","Telford and Wrekin 009B","E01014139","Total",529,517,12
"2011","Telford and Wrekin 009C","E01014141","Total",1130,1086,44
"2011","Telford and Wrekin 009D","E01014142","Total",466,450,16
"2011","Telford and Wrekin 009E","E01014143","Total",625,602,23
"2011","Telford and Wrekin 010A","E01014136","Total",715,693,22
"2011","Telford and Wrekin 010B","E01014148","Total",775,700,75
"2011","Telford and Wrekin 010C","E01014149","Total",462,435,27
"2011","Telford and Wrekin 010D","E01014202","Total",928,899,29
"2011","Telford and Wrekin 010E","E01014203","Total",625,618,7
"2011","Telford and Wrekin 010F","E01014204","Total",773,750,23
"2011","Telford and Wrekin 011A","E01014104","Total",654,641,13
"2011","Telford and Wrekin 011B","E01014105","Total",719,698,21
"2011","Telford and Wrekin 011C","E01014113","Total",672,645,27
"2011","Telford and Wrekin 011D","E01014114","Total",676,647,29
"2011","Telford and Wrekin 012A","E01014133","Total",794,773,21
"2011","Telford and Wrekin 012B","E01014134","Total",603,590,13
"2011","Telford and Wrekin 012C","E01014144","Total",667,656,11
"2011","Telford and Wrekin 012D","E01014145","Total",922,874,48
"2011","Telford and Wrekin 013A","E01014185","Total",811,790,21
"2011","Telford and Wrekin 013B","E01014186","Total",650,627,23
"2011","Telford and Wrekin 013C","E01014187","Total",695,669,26
"2011","Telford and Wrekin 013D","E01014188","Total",623,607,16
"2011","Telford and Wrekin 014A","E01014150","Total",705,686,19
"2011","Telford and Wrekin 014B","E01014151","Total",654,639,15
"2011","Telford and Wrekin 014C","E01014152","Total",604,587,17
"2011","Telford and Wrekin 014D","E01014153","Total",825,793,32
"2011","Telford and Wrekin 014E","E01014154","Total",697,682,15
"2011","Telford and Wrekin 014F","E01014155","Total",689,676,13
"2011","Telford and Wrekin 015A","E01014181","Total",679,667,12
"2011","Telford and Wrekin 015B","E01014182","Total",477,469,8
"2011","Telford and Wrekin 015C","E01014183","Total",614,602,12
"2011","Telford and Wrekin 015D","E01014184","Total",544,529,15
"2011","Telford and Wrekin 016A","E01014146","Total",788,776,12
"2011","Telford and Wrekin 016B","E01014147","Total",886,783,103
"2011","Telford and Wrekin 016C","E01014156","Total",812,796,16
"2011","Telford and Wrekin 016D","E01014157","Total",535,530,5
"2011","Telford and Wrekin 016E","E01014158","Total",650,643,7
"2011","Telford and Wrekin 017A","E01014124","Total",780,755,25
"2011","Telford and Wrekin 017B","E01014163","Total",527,516,11
"2011","Telford and Wrekin 017C","E01014164","Total",706,691,15
"2011","Telford and Wrekin 017D","E01014165","Total",609,586,23
"2011","Telford and Wrekin 017E","E01014166","Total",652,641,11
"2011","Telford and Wrekin 018A","E01014191","Total",752,731,21
"2011","Telford and Wrekin 018B","E01014192","Total",488,480,8
"2011","Telford and Wrekin 018C","E01014193","Total",624,610,14
"2011","Telford and Wrekin 018D","E01014194","Total",630,595,35
"2011","Telford and Wrekin 018E","E01014195","Total",528,523,5
"2011","Telford and Wrekin 018F","E01014196","Total",658,649,9
"2011","Telford and Wrekin 019A","E01014119","Total",690,678,12
"2011","Telford and Wrekin 019B","E01014120","Total",778,767,11
"2011","Telford and Wrekin 019C","E01014121","Total",623,614,9
"2011","Telford and Wrekin 019D","E01014122","Total",757,731,26
"2011","Telford and Wrekin 019E","E01014123","Total",622,617,5
"2011","Telford and Wrekin 020A","E01014106","Total",630,618,12
"2011","Telford and Wrekin 020B","E01014107","Total",481,475,6
"2011","Telford and Wrekin 020C","E01014108","Total",682,645,37
"2011","Telford and Wrekin 020D","E01014109","Total",479,463,16
"2011","Telford and Wrekin 020E","E01014110","Total",514,470,44
"2011","Telford and Wrekin 021A","E01014197","Total",563,552,11
"2011","Telford and Wrekin 021B","E01014198","Total",451,412,39
"2011","Telford and Wrekin 021C","E01014199","Total",630,604,26
"2011","Telford and Wrekin 021D","E01014200","Total",459,452,7
"2011","Telford and Wrekin 021E","E01014201","Total",465,455,10
"2011","Telford and Wrekin 022A","E01014159","Total",612,594,18
"2011","Telford and Wrekin 022B","E01014160","Total",546,526,20
"2011","Telford and Wrekin 022C","E01014161","Total",501,499,2
"2011","Telford and Wrekin 022D","E01014162","Total",875,810,65
"2011","Telford and Wrekin 023A","E01014115","Total",604,549,55
"2011","Telford and Wrekin 023B","E01014116","Total",810,776,34
"2011","Telford and Wrekin 023C","E01014117","Total",507,485,22
"2011","Telford and Wrekin 023D","E01014118","Total",491,447,44
"2011","Cannock Chase 001A","E01029368","Total",518,510,8
"2011","Cannock Chase 001B","E01029369","Total",508,496,12
"2011","Cannock Chase 001C","E01029370","Total",588,577,11
"2011","Cannock Chase 001D","E01029371","Total",630,610,20
"2011","Cannock Chase 001E","E01029402","Total",861,839,22
"2011","Cannock Chase 002A","E01029372","Total",534,527,7
"2011","Cannock Chase 002B","E01029373","Total",899,881,18
"2011","Cannock Chase 002C","E01029401","Total",665,653,12
"2011","Cannock Chase 002D","E01029403","Total",635,620,15
"2011","Cannock Chase 002E","E01029404","Total",846,800,46
"2011","Cannock Chase 003A","E01029345","Total",670,658,12
"2011","Cannock Chase 003B","E01029346","Total",760,743,17
"2011","Cannock Chase 003C","E01029347","Total",667,642,25
"2011","Cannock Chase 003D","E01029348","Total",722,700,22
"2011","Cannock Chase 003E","E01029374","Total",984,955,29
"2011","Cannock Chase 004A","E01029383","Total",625,617,8
"2011","Cannock Chase 004B","E01029385","Total",616,608,8
"2011","Cannock Chase 004C","E01029388","Total",630,615,15
"2011","Cannock Chase 004D","E01029390","Total",468,453,15
"2011","Cannock Chase 005A","E01029384","Total",829,813,16
"2011","Cannock Chase 005B","E01029386","Total",625,603,22
"2011","Cannock Chase 005C","E01029387","Total",654,639,15
"2011","Cannock Chase 005D","E01029389","Total",822,784,38
"2011","Cannock Chase 006A","E01029379","Total",649,643,6
"2011","Cannock Chase 006B","E01029398","Total",706,690,16
"2011","Cannock Chase 006C","E01029399","Total",680,647,33
"2011","Cannock Chase 006D","E01029400","Total",647,636,11
"2011","Cannock Chase 007A","E01029354","Total",662,647,15
"2011","Cannock Chase 007B","E01029355","Total",682,657,25
"2011","Cannock Chase 007C","E01029356","Total",659,638,21
"2011","Cannock Chase 007D","E01029357","Total",562,551,11
"2011","Cannock Chase 007E","E01029358","Total",519,499,20
"2011","Cannock Chase 008A","E01029349","Total",629,615,14
"2011","Cannock Chase 008B","E01029350","Total",708,678,30
"2011","Cannock Chase 008C","E01029351","Total",673,651,22
"2011","Cannock Chase 008D","E01029352","Total",570,548,22
"2011","Cannock Chase 008E","E01029393","Total",766,756,10
"2011","Cannock Chase 009A","E01029380","Total",569,565,4
"2011","Cannock Chase 009B","E01029381","Total",711,692,19
"2011","Cannock Chase 009C","E01029382","Total",756,726,30
"2011","Cannock Chase 009D","E01029391","Total",697,673,24
"2011","Cannock Chase 009E","E01029392","Total",734,716,18
"2011","Cannock Chase 010A","E01029375","Total",901,893,8
"2011","Cannock Chase 010B","E01029376","Total",745,732,13
"2011","Cannock Chase 010C","E01029377","Total",518,513,5
"2011","Cannock Chase 010D","E01029378","Total",666,659,7
"2011","Cannock Chase 011A","E01029353","Total",706,690,16
"2011","Cannock Chase 011B","E01029364","Total",765,724,41
"2011","Cannock Chase 011C","E01029365","Total",666,652,14
"2011","Cannock Chase 011D","E01029366","Total",764,735,29
"2011","Cannock Chase 011E","E01029367","Total",991,944,47
"2011","Cannock Chase 012A","E01029359","Total",805,744,61
"2011","Cannock Chase 012B","E01029360","Total",759,734,25
"2011","Cannock Chase 012C","E01029361","Total",645,628,17
"2011","Cannock Chase 012D","E01029362","Total",712,685,27
"2011","Cannock Chase 012E","E01029363","Total",682,670,12
"2011","Cannock Chase 013A","E01029394","Total",647,634,13
"2011","Cannock Chase 013B","E01029395","Total",704,683,21
"2011","Cannock Chase 013C","E01029396","Total",742,721,21
"2011","Cannock Chase 013D","E01029397","Total",1075,1052,23
"2011","East Staffordshire 001A","E01029405","Total",658,638,20
"2011","East Staffordshire 001B","E01029406","Total",500,474,26
"2011","East Staffordshire 001C","E01029422","Total",496,470,26
"2011","East Staffordshire 001D","E01029423","Total",689,670,19
"2011","East Staffordshire 001E","E01029467","Total",990,900,90
"2011","East Staffordshire 002A","E01029430","Total",621,603,18
"2011","East Staffordshire 002B","E01029431","Total",702,686,16
"2011","East Staffordshire 002C","E01029432","Total",639,632,7
"2011","East Staffordshire 002D","E01029433","Total",639,614,25
"2011","East Staffordshire 003A","E01029459","Total",637,624,13
"2011","East Staffordshire 003B","E01029460","Total",827,786,41
"2011","East Staffordshire 003C","E01029461","Total",866,843,23
"2011","East Staffordshire 003D","E01029462","Total",722,689,33
"2011","East Staffordshire 004A","E01029443","Total",726,707,19
"2011","East Staffordshire 004B","E01029444","Total",741,726,15
"2011","East Staffordshire 004C","E01029463","Total",522,508,14
"2011","East Staffordshire 004D","E01029464","Total",735,693,42
"2011","East Staffordshire 004E","E01029465","Total",738,702,36
"2011","East Staffordshire 004F","E01029466","Total",636,615,21
"2011","East Staffordshire 005A","E01029454","Total",651,642,9
"2011","East Staffordshire 005B","E01029455","Total",754,747,7
"2011","East Staffordshire 005C","E01029456","Total",780,747,33
"2011","East Staffordshire 005D","E01029457","Total",542,533,9
"2011","East Staffordshire 005E","E01029458","Total",624,616,8
"2011","East Staffordshire 006A","E01029411","Total",550,519,31
"2011","East Staffordshire 006B","E01029412","Total",596,576,20
"2011","East Staffordshire 006C","E01029424","Total",451,433,18
"2011","East Staffordshire 006D","E01029425","Total",627,601,26
"2011","East Staffordshire 006E","E01029473","Total",582,562,20
"2011","East Staffordshire 006F","E01029474","Total",537,517,20
"2011","East Staffordshire 007A","E01029434","Total",663,628,35
"2011","East Staffordshire 007B","E01029435","Total",664,641,23
"2011","East Staffordshire 007C","E01029436","Total",866,842,24
"2011","East Staffordshire 007D","E01029437","Total",979,924,55
"2011","East Staffordshire 007E","E01029438","Total",651,638,13
"2011","East Staffordshire 008A","E01029426","Total",766,713,53
"2011","East Staffordshire 008B","E01029427","Total",671,653,18
"2011","East Staffordshire 008C","E01029428","Total",664,645,19
"2011","East Staffordshire 008D","E01029429","Total",525,491,34
"2011","East Staffordshire 009A","E01029445","Total",918,849,69
"2011","East Staffordshire 009B","E01029446","Total",772,743,29
"2011","East Staffordshire 009C","E01029447","Total",654,605,49
"2011","East Staffordshire 009D","E01029448","Total",757,734,23
"2011","East Staffordshire 010A","E01029468","Total",740,693,47
"2011","East Staffordshire 010B","E01029469","Total",777,763,14
"2011","East Staffordshire 010C","E01029470","Total",667,635,32
"2011","East Staffordshire 010D","E01029471","Total",719,685,34
"2011","East Staffordshire 010E","E01029472","Total",671,654,17
"2011","East Staffordshire 011A","E01029407","Total",574,544,30
"2011","East Staffordshire 011B","E01029408","Total",872,825,47
"2011","East Staffordshire 011C","E01029409","Total",723,667,56
"2011","East Staffordshire 011D","E01029410","Total",637,601,36
"2011","East Staffordshire 011F","E01032896","Total",595,564,31
"2011","East Staffordshire 011G","E01032897","Total",597,577,20
"2011","East Staffordshire 011H","E01032898","Total",638,599,39
"2011","East Staffordshire 012A","E01029418","Total",838,823,15
"2011","East Staffordshire 012B","E01029419","Total",662,651,11
"2011","East Staffordshire 012C","E01029420","Total",756,737,19
"2011","East Staffordshire 013A","E01029413","Total",668,655,13
"2011","East Staffordshire 013B","E01029414","Total",705,686,19
"2011","East Staffordshire 013C","E01029415","Total",640,627,13
"2011","East Staffordshire 013D","E01029416","Total",555,538,17
"2011","East Staffordshire 013E","E01029417","Total",545,527,18
"2011","East Staffordshire 014A","E01029449","Total",723,698,25
"2011","East Staffordshire 014B","E01029450","Total",635,617,18
"2011","East Staffordshire 014C","E01029451","Total",895,849,46
"2011","East Staffordshire 014D","E01029452","Total",781,769,12
"2011","East Staffordshire 014E","E01029453","Total",722,703,19
"2011","East Staffordshire 015A","E01029439","Total",649,633,16
"2011","East Staffordshire 015B","E01029440","Total",549,526,23
"2011","East Staffordshire 015C","E01029441","Total",697,670,27
"2011","East Staffordshire 015D","E01029442","Total",570,556,14
"2011","Lichfield 001A","E01029480","Total",790,746,44
"2011","Lichfield 001B","E01029481","Total",870,804,66
"2011","Lichfield 001C","E01029482","Total",656,635,21
"2011","Lichfield 001D","E01029498","Total",747,711,36
"2011","Lichfield 002A","E01029477","Total",681,647,34
"2011","Lichfield 002B","E01029478","Total",667,645,22
"2011","Lichfield 002C","E01029479","Total",1073,1040,33
"2011","Lichfield 002D","E01029509","Total",714,668,46
"2011","Lichfield 003A","E01029486","Total",639,615,24
"2011","Lichfield 003B","E01029507","Total",646,636,10
"2011","Lichfield 003C","E01029508","Total",964,919,45
"2011","Lichfield 003D","E01029515","Total",814,775,39
"2011","Lichfield 004A","E01029492","Total",779,767,12
"2011","Lichfield 004B","E01029499","Total",756,736,20
"2011","Lichfield 004C","E01029501","Total",638,613,25
"2011","Lichfield 004E","E01029526","Total",962,851,111
"2011","Lichfield 004F","E01032899","Total",919,831,88
"2011","Lichfield 004G","E01032900","Total",826,792,34
"2011","Lichfield 005A","E01029483","Total",634,617,17
"2011","Lichfield 005B","E01029484","Total",868,824,44
"2011","Lichfield 005C","E01029485","Total",660,650,10
"2011","Lichfield 005D","E01029500","Total",746,734,12
"2011","Lichfield 005E","E01029520","Total",612,602,10
"2011","Lichfield 005F","E01029524","Total",768,725,43
"2011","Lichfield 005G","E01029525","Total",765,750,15
"2011","Lichfield 006A","E01029487","Total",732,704,28
"2011","Lichfield 006B","E01029493","Total",827,810,17
"2011","Lichfield 006C","E01029494","Total",689,646,43
"2011","Lichfield 006D","E01029495","Total",683,671,12
"2011","Lichfield 006E","E01029497","Total",910,862,48
"2011","Lichfield 007A","E01029491","Total",801,775,26
"2011","Lichfield 007B","E01029511","Total",715,682,33
"2011","Lichfield 007C","E01029512","Total",781,762,19
"2011","Lichfield 007D","E01029518","Total",1154,1114,40
"2011","Lichfield 007E","E01029519","Total",982,935,47
"2011","Lichfield 008A","E01029516","Total",795,743,52
"2011","Lichfield 008B","E01029517","Total",715,669,46
"2011","Lichfield 008C","E01029530","Total",729,676,53
"2011","Lichfield 008D","E01029531","Total",711,679,32
"2011","Lichfield 009A","E01029475","Total",862,842,20
"2011","Lichfield 009B","E01029476","Total",630,607,23
"2011","Lichfield 009C","E01029489","Total",670,653,17
"2011","Lichfield 009D","E01029490","Total",631,607,24
"2011","Lichfield 009E","E01029505","Total",680,649,31
"2011","Lichfield 009F","E01029506","Total",772,757,15
"2011","Lichfield 010A","E01029496","Total",779,753,26
"2011","Lichfield 010B","E01029527","Total",565,548,17
"2011","Lichfield 010C","E01029528","Total",551,523,28
"2011","Lichfield 010D","E01029529","Total",508,491,17
"2011","Lichfield 011A","E01029513","Total",516,491,25
"2011","Lichfield 011B","E01029514","Total",668,613,55
"2011","Lichfield 011C","E01029521","Total",723,692,31
"2011","Lichfield 011D","E01029522","Total",655,625,30
"2011","Lichfield 011E","E01029523","Total",655,625,30
"2011","Lichfield 012A","E01029488","Total",733,695,38
"2011","Lichfield 012B","E01029502","Total",676,644,32
"2011","Lichfield 012C","E01029503","Total",672,644,28
"2011","Lichfield 012D","E01029504","Total",823,704,119
"2011","Newcastle-under-Lyme 001A","E01029562","Total",538,528,10
"2011","Newcastle-under-Lyme 001B","E01029565","Total",473,468,5
"2011","Newcastle-under-Lyme 001C","E01029581","Total",700,675,25
"2011","Newcastle-under-Lyme 001D","E01029582","Total",814,792,22
"2011","Newcastle-under-Lyme 001E","E01029586","Total",553,541,12
"2011","Newcastle-under-Lyme 001F","E01029587","Total",555,539,16
"2011","Newcastle-under-Lyme 002A","E01029561","Total",618,602,16
"2011","Newcastle-under-Lyme 002B","E01029563","Total",613,601,12
"2011","Newcastle-under-Lyme 002C","E01029564","Total",554,542,12
"2011","Newcastle-under-Lyme 002D","E01029588","Total",768,735,33
"2011","Newcastle-under-Lyme 003A","E01029540","Total",644,636,8
"2011","Newcastle-under-Lyme 003B","E01029541","Total",638,624,14
"2011","Newcastle-under-Lyme 003C","E01029542","Total",656,641,15
"2011","Newcastle-under-Lyme 003D","E01029543","Total",484,474,10
"2011","Newcastle-under-Lyme 003E","E01029595","Total",612,591,21
"2011","Newcastle-under-Lyme 003F","E01029597","Total",634,622,12
"2011","Newcastle-under-Lyme 004A","E01029536","Total",653,644,9
"2011","Newcastle-under-Lyme 004B","E01029544","Total",528,517,11
"2011","Newcastle-under-Lyme 004C","E01029545","Total",627,616,11
"2011","Newcastle-under-Lyme 004D","E01029546","Total",492,484,8
"2011","Newcastle-under-Lyme 004E","E01029596","Total",529,522,7
"2011","Newcastle-under-Lyme 005A","E01029532","Total",666,642,24
"2011","Newcastle-under-Lyme 005B","E01029533","Total",656,651,5
"2011","Newcastle-under-Lyme 005C","E01029534","Total",699,673,26
"2011","Newcastle-under-Lyme 005D","E01029535","Total",617,601,16
"2011","Newcastle-under-Lyme 005E","E01029556","Total",1164,1111,53
"2011","Newcastle-under-Lyme 006A","E01029537","Total",641,626,15
"2011","Newcastle-under-Lyme 006B","E01029538","Total",725,715,10
"2011","Newcastle-under-Lyme 006C","E01029539","Total",635,618,17
"2011","Newcastle-under-Lyme 006D","E01029552","Total",643,629,14
"2011","Newcastle-under-Lyme 006E","E01029558","Total",663,638,25
"2011","Newcastle-under-Lyme 007A","E01029547","Total",651,626,25
"2011","Newcastle-under-Lyme 007B","E01029548","Total",685,662,23
"2011","Newcastle-under-Lyme 007C","E01029559","Total",612,588,24
"2011","Newcastle-under-Lyme 007D","E01029560","Total",691,672,19
"2011","Newcastle-under-Lyme 007E","E01029568","Total",641,631,10
"2011","Newcastle-under-Lyme 008A","E01029583","Total",697,682,15
"2011","Newcastle-under-Lyme 008B","E01029584","Total",567,538,29
"2011","Newcastle-under-Lyme 008C","E01029585","Total",684,661,23
"2011","Newcastle-under-Lyme 008D","E01029609","Total",806,767,39
"2011","Newcastle-under-Lyme 008E","E01029611","Total",824,800,24
"2011","Newcastle-under-Lyme 009A","E01029577","Total",705,683,22
"2011","Newcastle-under-Lyme 009B","E01029579","Total",798,766,32
"2011","Newcastle-under-Lyme 009C","E01029580","Total",598,574,24
"2011","Newcastle-under-Lyme 009D","E01029610","Total",613,585,28
"2011","Newcastle-under-Lyme 009E","E01029612","Total",503,495,8
"2011","Newcastle-under-Lyme 010A","E01029553","Total",621,605,16
"2011","Newcastle-under-Lyme 010B","E01029554","Total",687,637,50
"2011","Newcastle-under-Lyme 010C","E01029566","Total",510,504,6
"2011","Newcastle-under-Lyme 010D","E01029567","Total",751,725,26
"2011","Newcastle-under-Lyme 010E","E01029598","Total",790,737,53
"2011","Newcastle-under-Lyme 010F","E01029599","Total",756,734,22
"2011","Newcastle-under-Lyme 011A","E01029555","Total",786,758,28
"2011","Newcastle-under-Lyme 011B","E01029578","Total",826,806,20
"2011","Newcastle-under-Lyme 011C","E01029602","Total",996,946,50
"2011","Newcastle-under-Lyme 011D","E01029603","Total",771,739,32
"2011","Newcastle-under-Lyme 011E","E01029604","Total",980,940,40
"2011","Newcastle-under-Lyme 012A","E01029576","Total",581,550,31
"2011","Newcastle-under-Lyme 012B","E01029593","Total",767,745,22
"2011","Newcastle-under-Lyme 012C","E01029594","Total",889,872,17
"2011","Newcastle-under-Lyme 013A","E01029557","Total",576,551,25
"2011","Newcastle-under-Lyme 013B","E01029573","Total",660,640,20
"2011","Newcastle-under-Lyme 013C","E01029574","Total",691,610,81
"2011","Newcastle-under-Lyme 013D","E01029575","Total",447,435,12
"2011","Newcastle-under-Lyme 014A","E01029549","Total",811,798,13
"2011","Newcastle-under-Lyme 014B","E01029551","Total",671,660,11
"2011","Newcastle-under-Lyme 014C","E01029591","Total",763,738,25
"2011","Newcastle-under-Lyme 014D","E01029600","Total",632,623,9
"2011","Newcastle-under-Lyme 014E","E01029605","Total",567,542,25
"2011","Newcastle-under-Lyme 014F","E01029607","Total",651,639,12
"2011","Newcastle-under-Lyme 015B","E01029589","Total",527,522,5
"2011","Newcastle-under-Lyme 015C","E01029590","Total",626,613,13
"2011","Newcastle-under-Lyme 015E","E01029601","Total",701,690,11
"2011","Newcastle-under-Lyme 015F","E01029606","Total",600,587,13
"2011","Newcastle-under-Lyme 015G","E01029608","Total",676,646,30
"2011","Newcastle-under-Lyme 015H","E01033257","Total",1134,1113,21
"2011","Newcastle-under-Lyme 016A","E01029569","Total",613,595,18
"2011","Newcastle-under-Lyme 016B","E01029570","Total",1088,1035,53
"2011","Newcastle-under-Lyme 016C","E01029571","Total",575,561,14
"2011","Newcastle-under-Lyme 016D","E01029572","Total",667,650,17
"2011","South Staffordshire 001A","E01029655","Total",913,890,23
"2011","South Staffordshire 001B","E01029656","Total",753,729,24
"2011","South Staffordshire 001C","E01029657","Total",626,622,4
"2011","South Staffordshire 001D","E01029658","Total",585,566,19
"2011","South Staffordshire 001E","E01029659","Total",585,578,7
"2011","South Staffordshire 001F","E01029660","Total",926,879,47
"2011","South Staffordshire 002A","E01029621","Total",620,607,13
"2011","South Staffordshire 002B","E01029646","Total",577,568,9
"2011","South Staffordshire 002C","E01029647","Total",907,877,30
"2011","South Staffordshire 002D","E01029648","Total",600,589,11
"2011","South Staffordshire 003A","E01029617","Total",701,681,20
"2011","South Staffordshire 003B","E01029618","Total",767,737,30
"2011","South Staffordshire 003C","E01029668","Total",544,524,20
"2011","South Staffordshire 003D","E01029669","Total",581,564,17
"2011","South Staffordshire 003E","E01029670","Total",672,640,32
"2011","South Staffordshire 004A","E01029620","Total",518,505,13
"2011","South Staffordshire 004B","E01029622","Total",645,633,12
"2011","South Staffordshire 004C","E01029623","Total",495,487,8
"2011","South Staffordshire 004D","E01029624","Total",550,549,1
"2011","South Staffordshire 004E","E01029625","Total",488,481,7
"2011","South Staffordshire 004F","E01029641","Total",705,685,20
"2011","South Staffordshire 004G","E01029642","Total",649,628,21
"2011","South Staffordshire 005A","E01029638","Total",901,885,16
"2011","South Staffordshire 005B","E01029639","Total",521,516,5
"2011","South Staffordshire 005C","E01029640","Total",569,562,7
"2011","South Staffordshire 005D","E01029643","Total",643,635,8
"2011","South Staffordshire 005E","E01029644","Total",605,600,5
"2011","South Staffordshire 006A","E01029616","Total",718,681,37
"2011","South Staffordshire 006B","E01029619","Total",869,841,28
"2011","South Staffordshire 006C","E01029636","Total",608,592,16
"2011","South Staffordshire 006D","E01029637","Total",694,673,21
"2011","South Staffordshire 007A","E01029632","Total",638,606,32
"2011","South Staffordshire 007B","E01029633","Total",681,667,14
"2011","South Staffordshire 007C","E01029634","Total",604,593,11
"2011","South Staffordshire 007D","E01029635","Total",740,724,16
"2011","South Staffordshire 008A","E01029613","Total",641,628,13
"2011","South Staffordshire 008B","E01029614","Total",709,700,9
"2011","South Staffordshire 008C","E01029615","Total",589,574,15
"2011","South Staffordshire 008D","E01029627","Total",683,665,18
"2011","South Staffordshire 009A","E01029626","Total",632,612,20
"2011","South Staffordshire 009B","E01029628","Total",520,512,8
"2011","South Staffordshire 009C","E01029629","Total",504,500,4
"2011","South Staffordshire 009D","E01029630","Total",565,547,18
"2011","South Staffordshire 009E","E01029631","Total",601,580,21
"2011","South Staffordshire 010A","E01029654","Total",970,953,17
"2011","South Staffordshire 010B","E01029661","Total",797,776,21
"2011","South Staffordshire 010C","E01029663","Total",604,597,7
"2011","South Staffordshire 010D","E01029665","Total",783,764,19
"2011","South Staffordshire 011A","E01029662","Total",838,831,7
"2011","South Staffordshire 011B","E01029664","Total",687,675,12
"2011","South Staffordshire 011C","E01029666","Total",781,768,13
"2011","South Staffordshire 012A","E01029671","Total",677,662,15
"2011","South Staffordshire 012B","E01029673","Total",693,672,21
"2011","South Staffordshire 012C","E01029676","Total",542,524,18
"2011","South Staffordshire 012D","E01029679","Total",644,623,21
"2011","South Staffordshire 012E","E01029680","Total",645,632,13
"2011","South Staffordshire 013A","E01029645","Total",907,875,32
"2011","South Staffordshire 013B","E01029667","Total",926,887,39
"2011","South Staffordshire 013C","E01029672","Total",648,626,22
"2011","South Staffordshire 013D","E01029674","Total",700,689,11
"2011","South Staffordshire 013E","E01029675","Total",691,678,13
"2011","South Staffordshire 013F","E01029677","Total",576,557,19
"2011","South Staffordshire 013G","E01029678","Total",694,683,11
"2011","South Staffordshire 014A","E01029649","Total",628,601,27
"2011","South Staffordshire 014B","E01029650","Total",677,660,17
"2011","South Staffordshire 014C","E01029651","Total",645,620,25
"2011","South Staffordshire 014D","E01029652","Total",699,672,27
"2011","South Staffordshire 014E","E01029653","Total",530,521,9
"2011","Stafford 001A","E01029702","Total",687,667,20
"2011","Stafford 001B","E01029703","Total",659,624,35
"2011","Stafford 001C","E01029704","Total",624,602,22
"2011","Stafford 001D","E01029705","Total",641,628,13
"2011","Stafford 002A","E01029681","Total",520,497,23
"2011","Stafford 002B","E01029682","Total",734,711,23
"2011","Stafford 002C","E01029683","Total",582,552,30
"2011","Stafford 002D","E01029748","Total",598,588,10
"2011","Stafford 002E","E01029749","Total",786,738,48
"2011","Stafford 003A","E01029740","Total",713,697,16
"2011","Stafford 003B","E01029744","Total",1049,989,60
"2011","Stafford 003C","E01029745","Total",975,903,72
"2011","Stafford 003D","E01029746","Total",692,674,18
"2011","Stafford 003E","E01029753","Total",660,654,6
"2011","Stafford 003F","E01029756","Total",790,759,31
"2011","Stafford 004A","E01029733","Total",807,765,42
"2011","Stafford 004B","E01029739","Total",611,603,8
"2011","Stafford 004C","E01029741","Total",699,688,11
"2011","Stafford 004D","E01029754","Total",583,565,18
"2011","Stafford 004E","E01029755","Total",662,647,15
"2011","Stafford 005A","E01029695","Total",977,924,53
"2011","Stafford 005B","E01029696","Total",670,644,26
"2011","Stafford 005C","E01029697","Total",565,536,29
"2011","Stafford 005D","E01029698","Total",716,689,27
"2011","Stafford 005E","E01029747","Total",614,595,19
"2011","Stafford 006A","E01029690","Total",658,637,21
"2011","Stafford 006B","E01029718","Total",819,805,14
"2011","Stafford 006C","E01029743","Total",635,614,21
"2011","Stafford 006D","E01029751","Total",739,724,15
"2011","Stafford 007A","E01029719","Total",750,730,20
"2011","Stafford 007B","E01029720","Total",691,670,21
"2011","Stafford 007C","E01029721","Total",664,641,23
"2011","Stafford 007D","E01029750","Total",679,660,19
"2011","Stafford 007E","E01029752","Total",528,521,7
"2011","Stafford 008A","E01029687","Total",860,823,37
"2011","Stafford 008B","E01029710","Total",650,640,10
"2011","Stafford 008C","E01029711","Total",621,612,9
"2011","Stafford 008D","E01029712","Total",799,774,25
"2011","Stafford 008E","E01029713","Total",716,694,22
"2011","Stafford 009A","E01029692","Total",679,669,10
"2011","Stafford 009B","E01029693","Total",867,805,62
"2011","Stafford 009C","E01029722","Total",709,687,22
"2011","Stafford 009D","E01029725","Total",714,695,19
"2011","Stafford 010A","E01029689","Total",881,835,46
"2011","Stafford 010B","E01029691","Total",747,693,54
"2011","Stafford 010C","E01029694","Total",651,619,32
"2011","Stafford 010D","E01029699","Total",1021,955,66
"2011","Stafford 010E","E01029701","Total",1260,1131,129
"2011","Stafford 011A","E01029686","Total",622,607,15
"2011","Stafford 011B","E01029700","Total",549,536,13
"2011","Stafford 011C","E01029723","Total",705,687,18
"2011","Stafford 011D","E01029724","Total",696,680,16
"2011","Stafford 011E","E01029732","Total",635,601,34
"2011","Stafford 012A","E01029714","Total",657,647,10
"2011","Stafford 012B","E01029736","Total",612,602,10
"2011","Stafford 012C","E01029737","Total",686,666,20
"2011","Stafford 012D","E01029738","Total",599,583,16
"2011","Stafford 012E","E01029742","Total",889,861,28
"2011","Stafford 013A","E01029715","Total",801,785,16
"2011","Stafford 013B","E01029716","Total",690,681,9
"2011","Stafford 013C","E01029717","Total",794,770,24
"2011","Stafford 013D","E01029727","Total",701,689,12
"2011","Stafford 013E","E01029728","Total",638,621,17
"2011","Stafford 014A","E01029684","Total",608,596,12
"2011","Stafford 014B","E01029685","Total",648,637,11
"2011","Stafford 014C","E01029730","Total",454,445,9
"2011","Stafford 014D","E01029731","Total",662,638,24
"2011","Stafford 014E","E01029757","Total",648,640,8
"2011","Stafford 014F","E01029758","Total",674,656,18
"2011","Stafford 014G","E01029759","Total",737,726,11
"2011","Stafford 014H","E01029760","Total",684,668,16
"2011","Stafford 015A","E01029688","Total",948,914,34
"2011","Stafford 015B","E01029706","Total",688,660,28
"2011","Stafford 015C","E01029707","Total",696,674,22
"2011","Stafford 015D","E01029708","Total",809,773,36
"2011","Stafford 015E","E01029709","Total",634,620,14
"2011","Stafford 016A","E01029726","Total",715,702,13
"2011","Stafford 016B","E01029729","Total",887,868,19
"2011","Stafford 016C","E01029734","Total",967,949,18
"2011","Stafford 016D","E01029735","Total",972,948,24
"2011","Staffordshire Moorlands 001A","E01029797","Total",688,623,65
"2011","Staffordshire Moorlands 001B","E01029806","Total",698,677,21
"2011","Staffordshire Moorlands 001C","E01029808","Total",690,663,27
"2011","Staffordshire Moorlands 001D","E01029809","Total",623,618,5
"2011","Staffordshire Moorlands 001E","E01029810","Total",566,546,20
"2011","Staffordshire Moorlands 002A","E01029767","Total",750,727,23
"2011","Staffordshire Moorlands 002B","E01029769","Total",776,753,23
"2011","Staffordshire Moorlands 002C","E01029770","Total",857,839,18
"2011","Staffordshire Moorlands 002D","E01029802","Total",797,739,58
"2011","Staffordshire Moorlands 003A","E01029763","Total",703,682,21
"2011","Staffordshire Moorlands 003B","E01029764","Total",665,651,14
"2011","Staffordshire Moorlands 003C","E01029765","Total",551,541,10
"2011","Staffordshire Moorlands 003D","E01029766","Total",654,631,23
"2011","Staffordshire Moorlands 003E","E01029774","Total",989,919,70
"2011","Staffordshire Moorlands 004A","E01029768","Total",639,621,18
"2011","Staffordshire Moorlands 004B","E01029771","Total",759,724,35
"2011","Staffordshire Moorlands 004C","E01029772","Total",797,777,20
"2011","Staffordshire Moorlands 004D","E01029773","Total",686,663,23
"2011","Staffordshire Moorlands 005A","E01029804","Total",1027,923,104
"2011","Staffordshire Moorlands 005B","E01029807","Total",587,547,40
"2011","Staffordshire Moorlands 005C","E01029811","Total",677,658,19
"2011","Staffordshire Moorlands 005D","E01029812","Total",1078,993,85
"2011","Staffordshire Moorlands 005E","E01029814","Total",836,790,46
"2011","Staffordshire Moorlands 006A","E01029792","Total",1022,996,26
"2011","Staffordshire Moorlands 006B","E01029793","Total",713,687,26
"2011","Staffordshire Moorlands 006C","E01029805","Total",747,731,16
"2011","Staffordshire Moorlands 006D","E01029813","Total",947,896,51
"2011","Staffordshire Moorlands 006E","E01029815","Total",702,676,26
"2011","Staffordshire Moorlands 006F","E01029816","Total",618,608,10
"2011","Staffordshire Moorlands 007A","E01029801","Total",868,776,92
"2011","Staffordshire Moorlands 007B","E01029803","Total",831,778,53
"2011","Staffordshire Moorlands 007C","E01029817","Total",920,823,97
"2011","Staffordshire Moorlands 008A","E01029762","Total",700,669,31
"2011","Staffordshire Moorlands 008B","E01029775","Total",694,670,24
"2011","Staffordshire Moorlands 008C","E01029776","Total",770,737,33
"2011","Staffordshire Moorlands 008D","E01029777","Total",658,632,26
"2011","Staffordshire Moorlands 009A","E01029779","Total",743,726,17
"2011","Staffordshire Moorlands 009B","E01029780","Total",663,650,13
"2011","Staffordshire Moorlands 009C","E01029794","Total",604,584,20
"2011","Staffordshire Moorlands 009D","E01029818","Total",632,618,14
"2011","Staffordshire Moorlands 009E","E01029819","Total",745,729,16
"2011","Staffordshire Moorlands 010A","E01029761","Total",652,596,56
"2011","Staffordshire Moorlands 010B","E01029782","Total",867,839,28
"2011","Staffordshire Moorlands 010C","E01029795","Total",795,767,28
"2011","Staffordshire Moorlands 010D","E01029796","Total",673,642,31
"2011","Staffordshire Moorlands 011A","E01029781","Total",670,662,8
"2011","Staffordshire Moorlands 011B","E01029783","Total",674,652,22
"2011","Staffordshire Moorlands 011C","E01029786","Total",607,589,18
"2011","Staffordshire Moorlands 011D","E01029787","Total",847,782,65
"2011","Staffordshire Moorlands 012A","E01029778","Total",730,707,23
"2011","Staffordshire Moorlands 012B","E01029789","Total",462,449,13
"2011","Staffordshire Moorlands 012C","E01029798","Total",764,749,15
"2011","Staffordshire Moorlands 012D","E01029799","Total",838,807,31
"2011","Staffordshire Moorlands 012E","E01029800","Total",685,670,15
"2011","Staffordshire Moorlands 013A","E01029784","Total",927,898,29
"2011","Staffordshire Moorlands 013B","E01029785","Total",735,728,7
"2011","Staffordshire Moorlands 013C","E01029788","Total",561,547,14
"2011","Staffordshire Moorlands 013D","E01029790","Total",798,785,13
"2011","Staffordshire Moorlands 013E","E01029791","Total",637,612,25
"2011","Tamworth 001A","E01029846","Total",527,521,6
"2011","Tamworth 001B","E01029847","Total",542,537,5
"2011","Tamworth 001C","E01029848","Total",520,515,5
"2011","Tamworth 001D","E01029852","Total",774,763,11
"2011","Tamworth 001E","E01029853","Total",688,672,16
"2011","Tamworth 001F","E01029854","Total",653,641,12
"2011","Tamworth 002A","E01029835","Total",1096,1048,48
"2011","Tamworth 002B","E01029836","Total",610,587,23
"2011","Tamworth 002C","E01029849","Total",690,683,7
"2011","Tamworth 002D","E01029850","Total",588,574,14
"2011","Tamworth 002E","E01029851","Total",1029,985,44
"2011","Tamworth 003A","E01029820","Total",591,585,6
"2011","Tamworth 003B","E01029821","Total",667,648,19
"2011","Tamworth 003C","E01029822","Total",531,526,5
"2011","Tamworth 003D","E01029824","Total",739,734,5
"2011","Tamworth 003E","E01029841","Total",619,608,11
"2011","Tamworth 004A","E01029823","Total",668,657,11
"2011","Tamworth 004B","E01029831","Total",645,634,11
"2011","Tamworth 004C","E01029832","Total",714,700,14
"2011","Tamworth 004D","E01029834","Total",697,680,17
"2011","Tamworth 004E","E01029844","Total",500,496,4
"2011","Tamworth 005A","E01029833","Total",701,684,17
"2011","Tamworth 005B","E01029837","Total",704,697,7
"2011","Tamworth 005C","E01029838","Total",736,714,22
"2011","Tamworth 005D","E01029839","Total",448,445,3
"2011","Tamworth 006A","E01029825","Total",514,512,2
"2011","Tamworth 006B","E01029826","Total",652,640,12
"2011","Tamworth 006C","E01029827","Total",544,541,3
"2011","Tamworth 006D","E01029828","Total",491,480,11
"2011","Tamworth 006E","E01029830","Total",566,543,23
"2011","Tamworth 007A","E01029840","Total",470,460,10
"2011","Tamworth 007B","E01029842","Total",528,518,10
"2011","Tamworth 007C","E01029843","Total",555,552,3
"2011","Tamworth 007D","E01029845","Total",475,472,3
"2011","Tamworth 007E","E01029859","Total",769,754,15
"2011","Tamworth 008A","E01029855","Total",553,547,6
"2011","Tamworth 008B","E01029856","Total",602,595,7
"2011","Tamworth 008C","E01029857","Total",576,567,9
"2011","Tamworth 008D","E01029858","Total",643,635,8
"2011","Tamworth 008E","E01029865","Total",613,602,11
"2011","Tamworth 009A","E01029860","Total",542,536,6
"2011","Tamworth 009B","E01029861","Total",612,595,17
"2011","Tamworth 009C","E01029862","Total",486,480,6
"2011","Tamworth 009D","E01029863","Total",794,756,38
"2011","Tamworth 009E","E01029864","Total",656,646,10
"2011","Tamworth 010A","E01029829","Total",812,781,31
"2011","Tamworth 010C","E01029867","Total",700,679,21
"2011","Tamworth 010D","E01029868","Total",505,500,5
"2011","Tamworth 010E","E01029869","Total",669,660,9
"2011","Tamworth 010F","E01032901","Total",645,634,11
"2011","Tamworth 010G","E01032902","Total",615,598,17
"2011","North Warwickshire 001A","E01031035","Total",771,749,22
"2011","North Warwickshire 001B","E01031036","Total",656,619,37
"2011","North Warwickshire 001C","E01031037","Total",670,645,25
"2011","North Warwickshire 001D","E01031038","Total",767,751,16
"2011","North Warwickshire 001E","E01031039","Total",674,656,18
"2011","North Warwickshire 001F","E01031040","Total",779,754,25
"2011","North Warwickshire 002A","E01031016","Total",694,678,16
"2011","North Warwickshire 002B","E01031025","Total",728,690,38
"2011","North Warwickshire 002C","E01031026","Total",618,596,22
"2011","North Warwickshire 002D","E01031031","Total",1056,1015,41
"2011","North Warwickshire 002E","E01031032","Total",558,528,30
"2011","North Warwickshire 003A","E01031009","Total",1010,971,39
"2011","North Warwickshire 003B","E01031010","Total",913,847,66
"2011","North Warwickshire 003C","E01031011","Total",818,788,30
"2011","North Warwickshire 003D","E01031012","Total",643,631,12
"2011","North Warwickshire 003E","E01031013","Total",505,484,21
"2011","North Warwickshire 003F","E01031014","Total",519,505,14
"2011","North Warwickshire 003G","E01031015","Total",614,598,16
"2011","North Warwickshire 004A","E01031023","Total",678,639,39
"2011","North Warwickshire 004B","E01031024","Total",732,675,57
"2011","North Warwickshire 004C","E01031033","Total",817,783,34
"2011","North Warwickshire 004D","E01031034","Total",789,767,22
"2011","North Warwickshire 005A","E01031005","Total",607,578,29
"2011","North Warwickshire 005B","E01031008","Total",594,578,16
"2011","North Warwickshire 005C","E01031017","Total",551,524,27
"2011","North Warwickshire 005D","E01031018","Total",485,461,24
"2011","North Warwickshire 005E","E01031029","Total",600,578,22
"2011","North Warwickshire 005F","E01031030","Total",1052,984,68
"2011","North Warwickshire 006A","E01031019","Total",688,668,20
"2011","North Warwickshire 006B","E01031020","Total",747,700,47
"2011","North Warwickshire 006C","E01031021","Total",822,779,43
"2011","North Warwickshire 006D","E01031022","Total",735,687,48
"2011","North Warwickshire 006E","E01031041","Total",745,720,25
"2011","North Warwickshire 006F","E01031042","Total",748,721,27
"2011","North Warwickshire 007A","E01031006","Total",682,635,47
"2011","North Warwickshire 007B","E01031007","Total",525,489,36
"2011","North Warwickshire 007C","E01031027","Total",622,580,42
"2011","North Warwickshire 007D","E01031028","Total",823,761,62
"2011","Nuneaton and Bedworth 001A","E01031110","Total",668,655,13
"2011","Nuneaton and Bedworth 001B","E01031111","Total",417,412,5
"2011","Nuneaton and Bedworth 001C","E01031112","Total",674,661,13
"2011","Nuneaton and Bedworth 001D","E01031113","Total",633,607,26
"2011","Nuneaton and Bedworth 001E","E01031114","Total",756,745,11
"2011","Nuneaton and Bedworth 002C","E01031073","Total",845,821,24
"2011","Nuneaton and Bedworth 002D","E01031074","Total",760,723,37
"2011","Nuneaton and Bedworth 002E","E01031075","Total",735,709,26
"2011","Nuneaton and Bedworth 002F","E01032890","Total",890,822,68
"2011","Nuneaton and Bedworth 003A","E01031100","Total",508,503,5
"2011","Nuneaton and Bedworth 003B","E01031101","Total",526,516,10
"2011","Nuneaton and Bedworth 003C","E01031102","Total",610,582,28
"2011","Nuneaton and Bedworth 003D","E01031103","Total",504,490,14
"2011","Nuneaton and Bedworth 003E","E01031104","Total",655,642,13
"2011","Nuneaton and Bedworth 004A","E01031081","Total",669,655,14
"2011","Nuneaton and Bedworth 004B","E01031082","Total",506,504,2
"2011","Nuneaton and Bedworth 004C","E01031083","Total",633,626,7
"2011","Nuneaton and Bedworth 004D","E01031084","Total",896,868,28
"2011","Nuneaton and Bedworth 004E","E01031085","Total",530,523,7
"2011","Nuneaton and Bedworth 005A","E01031043","Total",959,906,53
"2011","Nuneaton and Bedworth 005B","E01031044","Total",769,752,17
"2011","Nuneaton and Bedworth 005C","E01031045","Total",827,763,64
"2011","Nuneaton and Bedworth 005D","E01031046","Total",743,716,27
"2011","Nuneaton and Bedworth 005E","E01031047","Total",882,845,37
"2011","Nuneaton and Bedworth 006A","E01031057","Total",708,687,21
"2011","Nuneaton and Bedworth 006B","E01031058","Total",643,623,20
"2011","Nuneaton and Bedworth 006C","E01031059","Total",672,637,35
"2011","Nuneaton and Bedworth 006D","E01031060","Total",645,635,10
"2011","Nuneaton and Bedworth 006E","E01031061","Total",613,602,11
"2011","Nuneaton and Bedworth 007A","E01031090","Total",634,620,14
"2011","Nuneaton and Bedworth 007B","E01031091","Total",637,599,38
"2011","Nuneaton and Bedworth 007C","E01031092","Total",637,622,15
"2011","Nuneaton and Bedworth 007D","E01031093","Total",549,538,11
"2011","Nuneaton and Bedworth 007E","E01031094","Total",521,506,15
"2011","Nuneaton and Bedworth 008A","E01031048","Total",538,511,27
"2011","Nuneaton and Bedworth 008B","E01031049","Total",952,929,23
"2011","Nuneaton and Bedworth 008C","E01031050","Total",797,776,21
"2011","Nuneaton and Bedworth 008D","E01031051","Total",590,581,9
"2011","Nuneaton and Bedworth 009A","E01031115","Total",737,713,24
"2011","Nuneaton and Bedworth 009B","E01031116","Total",741,719,22
"2011","Nuneaton and Bedworth 009C","E01031117","Total",595,589,6
"2011","Nuneaton and Bedworth 009D","E01031118","Total",501,483,18
"2011","Nuneaton and Bedworth 009E","E01031119","Total",747,731,16
"2011","Nuneaton and Bedworth 010A","E01031052","Total",666,639,27
"2011","Nuneaton and Bedworth 010B","E01031053","Total",735,713,22
"2011","Nuneaton and Bedworth 010C","E01031054","Total",676,661,15
"2011","Nuneaton and Bedworth 010D","E01031055","Total",685,664,21
"2011","Nuneaton and Bedworth 010E","E01031056","Total",623,615,8
"2011","Nuneaton and Bedworth 011A","E01031120","Total",593,585,8
"2011","Nuneaton and Bedworth 011B","E01031121","Total",455,454,1
"2011","Nuneaton and Bedworth 011C","E01031122","Total",635,623,12
"2011","Nuneaton and Bedworth 011D","E01031123","Total",516,507,9
"2011","Nuneaton and Bedworth 011E","E01031124","Total",645,638,7
"2011","Nuneaton and Bedworth 012A","E01031105","Total",608,590,18
"2011","Nuneaton and Bedworth 012B","E01031106","Total",634,624,10
"2011","Nuneaton and Bedworth 012C","E01031107","Total",475,469,6
"2011","Nuneaton and Bedworth 012D","E01031108","Total",553,545,8
"2011","Nuneaton and Bedworth 012E","E01031109","Total",758,738,20
"2011","Nuneaton and Bedworth 013A","E01031062","Total",498,494,4
"2011","Nuneaton and Bedworth 013B","E01031063","Total",669,660,9
"2011","Nuneaton and Bedworth 013C","E01031064","Total",617,571,46
"2011","Nuneaton and Bedworth 013D","E01031065","Total",643,623,20
"2011","Nuneaton and Bedworth 013E","E01031066","Total",656,637,19
"2011","Nuneaton and Bedworth 014A","E01031067","Total",759,733,26
"2011","Nuneaton and Bedworth 014B","E01031068","Total",769,739,30
"2011","Nuneaton and Bedworth 014C","E01031069","Total",683,667,16
"2011","Nuneaton and Bedworth 014D","E01031070","Total",672,655,17
"2011","Nuneaton and Bedworth 015A","E01031095","Total",504,496,8
"2011","Nuneaton and Bedworth 015B","E01031096","Total",614,600,14
"2011","Nuneaton and Bedworth 015C","E01031097","Total",772,751,21
"2011","Nuneaton and Bedworth 015D","E01031098","Total",569,559,10
"2011","Nuneaton and Bedworth 015E","E01031099","Total",960,935,25
"2011","Nuneaton and Bedworth 016A","E01031086","Total",809,773,36
"2011","Nuneaton and Bedworth 016B","E01031087","Total",910,890,20
"2011","Nuneaton and Bedworth 016C","E01031088","Total",788,772,16
"2011","Nuneaton and Bedworth 016D","E01031089","Total",654,639,15
"2011","Nuneaton and Bedworth 018A","E01031077","Total",635,612,23
"2011","Nuneaton and Bedworth 018B","E01031078","Total",831,811,20
"2011","Nuneaton and Bedworth 018C","E01031079","Total",654,642,12
"2011","Nuneaton and Bedworth 018D","E01031080","Total",692,669,23
"2011","Nuneaton and Bedworth 018E","E01032588","Total",582,571,11
"2011","Rugby 001B","E01031129","Total",531,510,21
"2011","Rugby 001C","E01031159","Total",717,691,26
"2011","Rugby 001D","E01031160","Total",939,905,34
"2011","Rugby 001E","E01031182","Total",881,839,42
"2011","Rugby 001F","E01032891","Total",731,694,37
"2011","Rugby 001G","E01032892","Total",790,766,24
"2011","Rugby 002A","E01031137","Total",573,561,12
"2011","Rugby 002B","E01031138","Total",457,450,7
"2011","Rugby 002C","E01031139","Total",696,686,10
"2011","Rugby 002D","E01031140","Total",545,537,8
"2011","Rugby 002E","E01031141","Total",778,749,29
"2011","Rugby 002F","E01031142","Total",703,688,15
"2011","Rugby 003A","E01031171","Total",623,607,16
"2011","Rugby 003B","E01031172","Total",753,735,18
"2011","Rugby 003C","E01031173","Total",1041,994,47
"2011","Rugby 003D","E01031174","Total",771,739,32
"2011","Rugby 004A","E01031151","Total",649,620,29
"2011","Rugby 004B","E01031152","Total",501,495,6
"2011","Rugby 004C","E01031153","Total",601,589,12
"2011","Rugby 004D","E01031154","Total",802,763,39
"2011","Rugby 004E","E01031181","Total",744,728,16
"2011","Rugby 005A","E01031130","Total",805,764,41
"2011","Rugby 005B","E01031131","Total",734,687,47
"2011","Rugby 005C","E01031132","Total",907,867,40
"2011","Rugby 005D","E01031133","Total",748,715,33
"2011","Rugby 006A","E01031167","Total",573,551,22
"2011","Rugby 006B","E01031168","Total",1187,1157,30
"2011","Rugby 006C","E01031169","Total",961,923,38
"2011","Rugby 006D","E01031170","Total",798,757,41
"2011","Rugby 007A","E01031125","Total",671,658,13
"2011","Rugby 007C","E01031127","Total",641,624,17
"2011","Rugby 007D","E01031164","Total",870,849,21
"2011","Rugby 007E","E01031165","Total",704,690,14
"2011","Rugby 007F","E01032893","Total",601,589,12
"2011","Rugby 007G","E01032894","Total",488,483,5
"2011","Rugby 007H","E01032895","Total",559,542,17
"2011","Rugby 008A","E01031155","Total",552,545,7
"2011","Rugby 008B","E01031156","Total",657,647,10
"2011","Rugby 008C","E01031157","Total",813,791,22
"2011","Rugby 008D","E01031158","Total",497,480,17
"2011","Rugby 009A","E01031143","Total",659,649,10
"2011","Rugby 009B","E01031144","Total",610,576,34
"2011","Rugby 009C","E01031145","Total",531,503,28
"2011","Rugby 009D","E01031146","Total",638,630,8
"2011","Rugby 010A","E01031161","Total",891,874,17
"2011","Rugby 010B","E01031162","Total",753,732,21
"2011","Rugby 010C","E01031163","Total",766,743,23
"2011","Rugby 010D","E01031179","Total",708,690,18
"2011","Rugby 010E","E01031180","Total",873,856,17
"2011","Rugby 011A","E01031134","Total",753,732,21
"2011","Rugby 011B","E01031135","Total",795,777,18
"2011","Rugby 011C","E01031136","Total",751,722,29
"2011","Rugby 011D","E01031175","Total",586,575,11
"2011","Rugby 011E","E01031176","Total",601,590,11
"2011","Rugby 011F","E01031177","Total",617,609,8
"2011","Rugby 011G","E01031178","Total",657,643,14
"2011","Rugby 012A","E01031147","Total",695,671,24
"2011","Rugby 012B","E01031148","Total",781,740,41
"2011","Rugby 012C","E01031149","Total",652,626,26
"2011","Rugby 012D","E01031150","Total",517,493,24
"2011","Rugby 012E","E01031166","Total",811,779,32
"2011","Stratford-on-Avon 001A","E01031213","Total",807,757,50
"2011","Stratford-on-Avon 001B","E01031243","Total",840,788,52
"2011","Stratford-on-Avon 001C","E01031244","Total",797,742,55
"2011","Stratford-on-Avon 002A","E01031195","Total",959,918,41
"2011","Stratford-on-Avon 002B","E01031202","Total",841,788,53
"2011","Stratford-on-Avon 002C","E01031203","Total",735,706,29
"2011","Stratford-on-Avon 002D","E01031204","Total",685,632,53
"2011","Stratford-on-Avon 003A","E01031239","Total",737,688,49
"2011","Stratford-on-Avon 003B","E01031240","Total",598,579,19
"2011","Stratford-on-Avon 003C","E01031241","Total",602,593,9
"2011","Stratford-on-Avon 003D","E01031242","Total",663,653,10
"2011","Stratford-on-Avon 004A","E01031219","Total",642,639,3
"2011","Stratford-on-Avon 004B","E01031220","Total",606,601,5
"2011","Stratford-on-Avon 004C","E01031221","Total",712,695,17
"2011","Stratford-on-Avon 004D","E01031222","Total",873,843,30
"2011","Stratford-on-Avon 004E","E01031223","Total",542,526,16
"2011","Stratford-on-Avon 004F","E01031224","Total",471,455,16
"2011","Stratford-on-Avon 005A","E01031197","Total",541,513,28
"2011","Stratford-on-Avon 005B","E01031198","Total",556,521,35
"2011","Stratford-on-Avon 005C","E01031199","Total",635,598,37
"2011","Stratford-on-Avon 005D","E01031200","Total",662,652,10
"2011","Stratford-on-Avon 005E","E01031201","Total",681,671,10
"2011","Stratford-on-Avon 005F","E01031210","Total",541,516,25
"2011","Stratford-on-Avon 005G","E01031211","Total",467,449,18
"2011","Stratford-on-Avon 006A","E01031183","Total",857,809,48
"2011","Stratford-on-Avon 006B","E01031184","Total",665,650,15
"2011","Stratford-on-Avon 006C","E01031185","Total",644,628,16
"2011","Stratford-on-Avon 006D","E01031186","Total",688,665,23
"2011","Stratford-on-Avon 007A","E01031187","Total",852,813,39
"2011","Stratford-on-Avon 007B","E01031188","Total",992,912,80
"2011","Stratford-on-Avon 007C","E01031208","Total",897,881,16
"2011","Stratford-on-Avon 008A","E01031217","Total",531,513,18
"2011","Stratford-on-Avon 008B","E01031218","Total",474,452,22
"2011","Stratford-on-Avon 008C","E01031249","Total",522,509,13
"2011","Stratford-on-Avon 008D","E01031250","Total",682,662,20
"2011","Stratford-on-Avon 008E","E01031251","Total",510,504,6
"2011","Stratford-on-Avon 008F","E01031252","Total",540,514,26
"2011","Stratford-on-Avon 008G","E01031253","Total",680,661,19
"2011","Stratford-on-Avon 009A","E01031228","Total",749,713,36
"2011","Stratford-on-Avon 009B","E01031229","Total",1147,1005,142
"2011","Stratford-on-Avon 009C","E01031230","Total",1003,972,31
"2011","Stratford-on-Avon 009D","E01031231","Total",1066,1020,46
"2011","Stratford-on-Avon 009E","E01031236","Total",681,650,31
"2011","Stratford-on-Avon 009F","E01031238","Total",651,640,11
"2011","Stratford-on-Avon 010A","E01031225","Total",751,708,43
"2011","Stratford-on-Avon 010C","E01031227","Total",993,904,89
"2011","Stratford-on-Avon 010D","E01033250","Total",562,552,10
"2011","Stratford-on-Avon 010E","E01033251","Total",475,458,17
"2011","Stratford-on-Avon 010F","E01033252","Total",564,546,18
"2011","Stratford-on-Avon 011A","E01031232","Total",1030,993,37
"2011","Stratford-on-Avon 011B","E01031233","Total",760,731,29
"2011","Stratford-on-Avon 011C","E01031234","Total",1169,971,198
"2011","Stratford-on-Avon 011D","E01031235","Total",1042,941,101
"2011","Stratford-on-Avon 011E","E01031237","Total",608,590,18
"2011","Stratford-on-Avon 012A","E01031189","Total",830,621,209
"2011","Stratford-on-Avon 012B","E01031190","Total",685,669,16
"2011","Stratford-on-Avon 012C","E01031191","Total",719,707,12
"2011","Stratford-on-Avon 012D","E01031192","Total",895,859,36
"2011","Stratford-on-Avon 012E","E01031248","Total",1006,913,93
"2011","Stratford-on-Avon 013A","E01031194","Total",1025,969,56
"2011","Stratford-on-Avon 013B","E01031205","Total",679,659,20
"2011","Stratford-on-Avon 013C","E01031206","Total",637,607,30
"2011","Stratford-on-Avon 013D","E01031207","Total",553,540,13
"2011","Stratford-on-Avon 013E","E01031247","Total",1029,965,64
"2011","Stratford-on-Avon 014A","E01031196","Total",1024,975,49
"2011","Stratford-on-Avon 014B","E01031212","Total",1154,1105,49
"2011","Stratford-on-Avon 014C","E01031245","Total",584,544,40
"2011","Stratford-on-Avon 014D","E01031246","Total",498,464,34
"2011","Stratford-on-Avon 015A","E01031193","Total",1009,948,61
"2011","Stratford-on-Avon 015B","E01031209","Total",1104,975,129
"2011","Stratford-on-Avon 015C","E01031214","Total",788,776,12
"2011","Stratford-on-Avon 015D","E01031215","Total",908,865,43
"2011","Stratford-on-Avon 015E","E01031216","Total",709,677,32
"2011","Warwick 001A","E01031254","Total",648,624,24
"2011","Warwick 001B","E01031255","Total",634,627,7
"2011","Warwick 001C","E01031256","Total",823,795,28
"2011","Warwick 001D","E01031257","Total",696,666,30
"2011","Warwick 001E","E01031258","Total",819,775,44
"2011","Warwick 002A","E01031296","Total",732,718,14
"2011","Warwick 002B","E01031297","Total",893,876,17
"2011","Warwick 002C","E01031298","Total",814,796,18
"2011","Warwick 002D","E01031299","Total",564,560,4
"2011","Warwick 002E","E01031300","Total",723,708,15
"2011","Warwick 003A","E01031303","Total",732,714,18
"2011","Warwick 003B","E01031304","Total",612,603,9
"2011","Warwick 003C","E01031305","Total",664,654,10
"2011","Warwick 003D","E01031306","Total",614,601,13
"2011","Warwick 003E","E01031307","Total",684,664,20
"2011","Warwick 004A","E01031281","Total",647,626,21
"2011","Warwick 004B","E01031282","Total",707,669,38
"2011","Warwick 004C","E01031283","Total",539,526,13
"2011","Warwick 004D","E01031284","Total",521,506,15
"2011","Warwick 005A","E01031277","Total",654,642,12
"2011","Warwick 005B","E01031278","Total",586,566,20
"2011","Warwick 005C","E01031279","Total",632,622,10
"2011","Warwick 005D","E01031280","Total",542,524,18
"2011","Warwick 005E","E01031301","Total",611,590,21
"2011","Warwick 005F","E01031302","Total",446,434,12
"2011","Warwick 005G","E01031308","Total",889,850,39
"2011","Warwick 006A","E01031273","Total",667,656,11
"2011","Warwick 006B","E01031274","Total",635,621,14
"2011","Warwick 006C","E01031275","Total",534,529,5
"2011","Warwick 006D","E01031276","Total",643,636,7
"2011","Warwick 007B","E01031272","Total",820,784,36
"2011","Warwick 007C","E01031285","Total",1108,1043,65
"2011","Warwick 007D","E01031286","Total",715,695,20
"2011","Warwick 007E","E01031287","Total",597,583,14
"2011","Warwick 007F","E01031288","Total",738,713,25
"2011","Warwick 007G","E01031289","Total",588,569,19
"2011","Warwick 007H","E01033253","Total",809,751,58
"2011","Warwick 007I","E01033256","Total",758,707,51
"2011","Warwick 008A","E01031309","Total",861,764,97
"2011","Warwick 008B","E01031310","Total",567,559,8
"2011","Warwick 008C","E01031311","Total",578,569,9
"2011","Warwick 008D","E01031312","Total",553,542,11
"2011","Warwick 008E","E01031313","Total",601,591,10
"2011","Warwick 008F","E01031314","Total",620,605,15
"2011","Warwick 009A","E01031290","Total",881,833,48
"2011","Warwick 009B","E01031291","Total",823,788,35
"2011","Warwick 009C","E01031292","Total",670,649,21
"2011","Warwick 009D","E01031293","Total",730,702,28
"2011","Warwick 009E","E01031294","Total",668,646,22
"2011","Warwick 009F","E01031295","Total",508,497,11
"2011","Warwick 010A","E01031271","Total",922,874,48
"2011","Warwick 010B","E01031332","Total",525,519,6
"2011","Warwick 010C","E01031333","Total",496,482,14
"2011","Warwick 010D","E01031334","Total",668,657,11
"2011","Warwick 010E","E01031335","Total",655,627,28
"2011","Warwick 010F","E01031336","Total",880,832,48
"2011","Warwick 010G","E01031337","Total",719,702,17
"2011","Warwick 011A","E01031321","Total",520,506,14
"2011","Warwick 011B","E01031322","Total",880,851,29
"2011","Warwick 011C","E01031323","Total",843,805,38
"2011","Warwick 011D","E01031324","Total",1326,1245,81
"2011","Warwick 011E","E01031325","Total",638,617,21
"2011","Warwick 011G","E01033254","Total",582,574,8
"2011","Warwick 011H","E01033255","Total",654,640,14
"2011","Warwick 012A","E01031315","Total",813,800,13
"2011","Warwick 012B","E01031316","Total",795,767,28
"2011","Warwick 012C","E01031317","Total",810,749,61
"2011","Warwick 012D","E01031318","Total",682,677,5
"2011","Warwick 012E","E01031319","Total",892,855,37
"2011","Warwick 012F","E01031320","Total",649,632,17
"2011","Warwick 013A","E01031261","Total",603,589,14
"2011","Warwick 013B","E01031262","Total",662,637,25
"2011","Warwick 013C","E01031263","Total",670,641,29
"2011","Warwick 013D","E01031264","Total",634,621,13
"2011","Warwick 013E","E01031265","Total",529,516,13
"2011","Warwick 013F","E01031266","Total",901,861,40
"2011","Warwick 014A","E01031259","Total",517,509,8
"2011","Warwick 014B","E01031260","Total",518,512,6
"2011","Warwick 014C","E01031267","Total",752,736,16
"2011","Warwick 014D","E01031268","Total",1108,1087,21
"2011","Warwick 014E","E01031269","Total",762,743,19
"2011","Warwick 015A","E01031327","Total",641,628,13
"2011","Warwick 015B","E01031328","Total",916,885,31
"2011","Warwick 015C","E01031329","Total",1003,985,18
"2011","Warwick 015D","E01031330","Total",607,599,8
"2011","Warwick 015E","E01031331","Total",761,751,10
"2011","Birmingham 001A","E01009417","Total",636,608,28
"2011","Birmingham 001B","E01009418","Total",668,645,23
"2011","Birmingham 001C","E01009419","Total",606,579,27
"2011","Birmingham 001D","E01009433","Total",781,746,35
"2011","Birmingham 002A","E01009415","Total",708,672,36
"2011","Birmingham 002B","E01009422","Total",891,864,27
"2011","Birmingham 002C","E01009423","Total",792,759,33
"2011","Birmingham 002D","E01009425","Total",891,846,45
"2011","Birmingham 003A","E01009416","Total",1030,1008,22
"2011","Birmingham 003B","E01009420","Total",644,632,12
"2011","Birmingham 003C","E01009426","Total",618,607,11
"2011","Birmingham 003D","E01009429","Total",594,588,6
"2011","Birmingham 003E","E01009431","Total",623,611,12
"2011","Birmingham 004A","E01009421","Total",661,639,22
"2011","Birmingham 004B","E01009424","Total",736,689,47
"2011","Birmingham 004C","E01009427","Total",735,702,33
"2011","Birmingham 004D","E01009428","Total",660,650,10
"2011","Birmingham 004E","E01009430","Total",676,648,28
"2011","Birmingham 004F","E01009468","Total",638,626,12
"2011","Birmingham 005A","E01009445","Total",706,686,20
"2011","Birmingham 005B","E01009446","Total",1049,1008,41
"2011","Birmingham 005C","E01009447","Total",647,629,18
"2011","Birmingham 005D","E01009448","Total",682,673,9
"2011","Birmingham 005E","E01009452","Total",715,682,33
"2011","Birmingham 005F","E01009455","Total",736,721,15
"2011","Birmingham 006A","E01009432","Total",670,642,28
"2011","Birmingham 006B","E01009435","Total",724,711,13
"2011","Birmingham 006C","E01009437","Total",828,806,22
"2011","Birmingham 006D","E01009444","Total",631,623,8
"2011","Birmingham 006E","E01009454","Total",674,655,19
"2011","Birmingham 007A","E01009221","Total",610,593,17
"2011","Birmingham 007B","E01009464","Total",553,530,23
"2011","Birmingham 007C","E01009465","Total",510,503,7
"2011","Birmingham 007D","E01009467","Total",678,662,16
"2011","Birmingham 008A","E01009220","Total",644,628,16
"2011","Birmingham 008B","E01009222","Total",617,604,13
"2011","Birmingham 008C","E01009224","Total",634,620,14
"2011","Birmingham 008D","E01009233","Total",644,628,16
"2011","Birmingham 009A","E01009449","Total",1023,949,74
"2011","Birmingham 009B","E01009451","Total",706,652,54
"2011","Birmingham 009C","E01009453","Total",532,526,6
"2011","Birmingham 009D","E01009466","Total",682,668,14
"2011","Birmingham 009E","E01009471","Total",731,701,30
"2011","Birmingham 010A","E01009135","Total",609,597,12
"2011","Birmingham 010B","E01009469","Total",600,591,9
"2011","Birmingham 010C","E01009470","Total",543,532,11
"2011","Birmingham 010D","E01009472","Total",687,635,52
"2011","Birmingham 010E","E01009473","Total",711,682,29
"2011","Birmingham 010F","E01009474","Total",649,635,14
"2011","Birmingham 011A","E01009127","Total",598,586,12
"2011","Birmingham 011B","E01009128","Total",546,532,14
"2011","Birmingham 011C","E01009130","Total",622,608,14
"2011","Birmingham 011D","E01009131","Total",524,517,7
"2011","Birmingham 011E","E01009133","Total",621,610,11
"2011","Birmingham 011F","E01009134","Total",683,664,19
"2011","Birmingham 011G","E01009137","Total",604,581,23
"2011","Birmingham 012A","E01009434","Total",643,626,17
"2011","Birmingham 012B","E01009436","Total",548,539,9
"2011","Birmingham 012C","E01009438","Total",615,608,7
"2011","Birmingham 012D","E01009440","Total",644,630,14
"2011","Birmingham 012E","E01009450","Total",701,679,22
"2011","Birmingham 013A","E01009223","Total",689,676,13
"2011","Birmingham 013B","E01009225","Total",779,764,15
"2011","Birmingham 013C","E01009227","Total",709,693,16
"2011","Birmingham 013D","E01009228","Total",688,677,11
"2011","Birmingham 014A","E01009121","Total",942,926,16
"2011","Birmingham 014B","E01009122","Total",683,665,18
"2011","Birmingham 014C","E01009129","Total",596,581,15
"2011","Birmingham 014D","E01009132","Total",643,616,27
"2011","Birmingham 014E","E01009136","Total",833,798,35
"2011","Birmingham 015A","E01009457","Total",615,608,7
"2011","Birmingham 015B","E01009459","Total",675,665,10
"2011","Birmingham 015C","E01009461","Total",531,522,9
"2011","Birmingham 015D","E01009463","Total",630,619,11
"2011","Birmingham 016A","E01009235","Total",643,625,18
"2011","Birmingham 016B","E01009243","Total",641,626,15
"2011","Birmingham 016C","E01009245","Total",581,565,16
"2011","Birmingham 016D","E01009246","Total",652,637,15
"2011","Birmingham 016E","E01009247","Total",592,571,21
"2011","Birmingham 017A","E01009226","Total",686,663,23
"2011","Birmingham 017B","E01009229","Total",649,637,12
"2011","Birmingham 017C","E01009230","Total",672,655,17
"2011","Birmingham 017D","E01009231","Total",795,758,37
"2011","Birmingham 018A","E01009001","Total",708,694,14
"2011","Birmingham 018B","E01009003","Total",733,690,43
"2011","Birmingham 018C","E01009456","Total",676,660,16
"2011","Birmingham 018D","E01009458","Total",805,784,21
"2011","Birmingham 018E","E01009460","Total",877,833,44
"2011","Birmingham 018F","E01009462","Total",827,798,29
"2011","Birmingham 019A","E01009234","Total",633,623,10
"2011","Birmingham 019B","E01009236","Total",653,636,17
"2011","Birmingham 019C","E01009244","Total",634,620,14
"2011","Birmingham 019D","E01009248","Total",713,696,17
"2011","Birmingham 020A","E01009403","Total",632,615,17
"2011","Birmingham 020B","E01009404","Total",643,632,11
"2011","Birmingham 020C","E01009405","Total",618,604,14
"2011","Birmingham 020D","E01009406","Total",794,775,19
"2011","Birmingham 020E","E01009407","Total",762,733,29
"2011","Birmingham 021A","E01009439","Total",644,619,25
"2011","Birmingham 021B","E01009441","Total",667,639,28
"2011","Birmingham 021C","E01009442","Total",619,605,14
"2011","Birmingham 021D","E01009443","Total",544,536,8
"2011","Birmingham 022A","E01009123","Total",624,611,13
"2011","Birmingham 022B","E01009124","Total",644,639,5
"2011","Birmingham 022C","E01009125","Total",701,689,12
"2011","Birmingham 022D","E01009232","Total",621,606,15
"2011","Birmingham 023A","E01009002","Total",669,653,16
"2011","Birmingham 023C","E01009006","Total",792,763,29
"2011","Birmingham 023D","E01009007","Total",848,777,71
"2011","Birmingham 023F","E01033632","Total",1068,1018,50
"2011","Birmingham 024A","E01009237","Total",631,604,27
"2011","Birmingham 024B","E01009238","Total",642,632,10
"2011","Birmingham 024C","E01009240","Total",634,610,24
"2011","Birmingham 024D","E01009241","Total",635,608,27
"2011","Birmingham 024E","E01009242","Total",642,605,37
"2011","Birmingham 025A","E01009005","Total",667,643,24
"2011","Birmingham 025B","E01009009","Total",652,637,15
"2011","Birmingham 025C","E01009098","Total",965,933,32
"2011","Birmingham 025D","E01009100","Total",870,839,31
"2011","Birmingham 025E","E01009105","Total",669,653,16
"2011","Birmingham 026A","E01009126","Total",560,542,18
"2011","Birmingham 026B","E01009408","Total",677,657,20
"2011","Birmingham 026C","E01009409","Total",773,724,49
"2011","Birmingham 026D","E01009410","Total",789,764,25
"2011","Birmingham 028A","E01009008","Total",621,603,18
"2011","Birmingham 028B","E01009011","Total",819,783,36
"2011","Birmingham 028C","E01009012","Total",601,590,11
"2011","Birmingham 028D","E01009102","Total",651,630,21
"2011","Birmingham 028E","E01009104","Total",666,646,20
"2011","Birmingham 029A","E01009096","Total",790,774,16
"2011","Birmingham 029B","E01009097","Total",799,792,7
"2011","Birmingham 029C","E01009099","Total",820,811,9
"2011","Birmingham 029D","E01009101","Total",628,626,2
"2011","Birmingham 029E","E01009103","Total",665,657,8
"2011","Birmingham 029F","E01009106","Total",597,587,10
"2011","Birmingham 030A","E01008915","Total",542,506,36
"2011","Birmingham 030B","E01009411","Total",886,871,15
"2011","Birmingham 030C","E01009412","Total",676,651,25
"2011","Birmingham 030D","E01009413","Total",680,655,25
"2011","Birmingham 030E","E01009414","Total",799,768,31
"2011","Birmingham 031A","E01008998","Total",652,639,13
"2011","Birmingham 031B","E01008999","Total",530,522,8
"2011","Birmingham 031C","E01009000","Total",836,794,42
"2011","Birmingham 031D","E01009013","Total",904,857,47
"2011","Birmingham 031E","E01009400","Total",561,525,36
"2011","Birmingham 031F","E01009401","Total",653,636,17
"2011","Birmingham 031H","E01033630","Total",609,595,14
"2011","Birmingham 031I","E01033646","Total",810,772,38
"2011","Birmingham 032A","E01009049","Total",593,570,23
"2011","Birmingham 032B","E01009056","Total",778,749,29
"2011","Birmingham 032C","E01009263","Total",675,650,25
"2011","Birmingham 032D","E01009264","Total",595,585,10
"2011","Birmingham 032E","E01009265","Total",591,572,19
"2011","Birmingham 033A","E01009051","Total",501,478,23
"2011","Birmingham 033B","E01009053","Total",443,435,8
"2011","Birmingham 033C","E01009054","Total",427,417,10
"2011","Birmingham 033D","E01009058","Total",476,465,11
"2011","Birmingham 033E","E01009061","Total",445,432,13
"2011","Birmingham 033F","E01009239","Total",533,495,38
"2011","Birmingham 034A","E01009266","Total",651,615,36
"2011","Birmingham 034B","E01009269","Total",564,544,20
"2011","Birmingham 034C","E01009270","Total",669,646,23
"2011","Birmingham 034D","E01009271","Total",559,535,24
"2011","Birmingham 034E","E01009273","Total",540,512,28
"2011","Birmingham 035A","E01009050","Total",682,652,30
"2011","Birmingham 035D","E01009057","Total",672,647,25
"2011","Birmingham 035E","E01009059","Total",590,569,21
"2011","Birmingham 035F","E01009060","Total",436,426,10
"2011","Birmingham 035G","E01033621","Total",895,866,29
"2011","Birmingham 036A","E01009268","Total",453,432,21
"2011","Birmingham 036B","E01009272","Total",506,487,19
"2011","Birmingham 036C","E01009274","Total",786,739,47
"2011","Birmingham 036D","E01009349","Total",638,595,43
"2011","Birmingham 036E","E01009351","Total",600,564,36
"2011","Birmingham 036F","E01009354","Total",532,520,12
"2011","Birmingham 037A","E01008899","Total",527,478,49
"2011","Birmingham 037C","E01008901","Total",578,573,5
"2011","Birmingham 037E","E01008916","Total",461,454,7
"2011","Birmingham 037F","E01033636","Total",863,845,18
"2011","Birmingham 038A","E01009079","Total",732,719,13
"2011","Birmingham 038B","E01009080","Total",418,412,6
"2011","Birmingham 038C","E01009081","Total",572,558,14
"2011","Birmingham 038D","E01009083","Total",578,559,19
"2011","Birmingham 039A","E01009275","Total",505,476,29
"2011","Birmingham 039B","E01009350","Total",480,454,26
"2011","Birmingham 039C","E01009352","Total",490,465,25
"2011","Birmingham 039D","E01009353","Total",478,460,18
"2011","Birmingham 039E","E01009355","Total",550,522,28
"2011","Birmingham 039H","E01033635","Total",983,947,36
"2011","Birmingham 040A","E01008905","Total",437,421,16
"2011","Birmingham 040B","E01008907","Total",611,560,51
"2011","Birmingham 040C","E01009047","Total",575,552,23
"2011","Birmingham 040D","E01009048","Total",588,567,21
"2011","Birmingham 040E","E01009062","Total",487,476,11
"2011","Birmingham 041D","E01008909","Total",478,472,6
"2011","Birmingham 041F","E01033628","Total",758,754,4
"2011","Birmingham 041G","E01033637","Total",865,850,15
"2011","Birmingham 042A","E01009084","Total",530,515,15
"2011","Birmingham 042B","E01009085","Total",520,505,15
"2011","Birmingham 042C","E01009087","Total",605,582,23
"2011","Birmingham 042D","E01009089","Total",517,495,22
"2011","Birmingham 042E","E01009090","Total",564,540,24
"2011","Birmingham 043A","E01009201","Total",718,695,23
"2011","Birmingham 043B","E01009202","Total",614,593,21
"2011","Birmingham 043C","E01009203","Total",1170,1145,25
"2011","Birmingham 044A","E01009082","Total",512,500,12
"2011","Birmingham 044B","E01009086","Total",622,605,17
"2011","Birmingham 044C","E01009480","Total",597,583,14
"2011","Birmingham 044D","E01009481","Total",727,696,31
"2011","Birmingham 044E","E01009486","Total",620,587,33
"2011","Birmingham 044F","E01009487","Total",630,604,26
"2011","Birmingham 045A","E01009088","Total",728,711,17
"2011","Birmingham 045B","E01009091","Total",684,663,21
"2011","Birmingham 045C","E01009305","Total",757,753,4
"2011","Birmingham 045D","E01009307","Total",777,759,18
"2011","Birmingham 045E","E01009309","Total",667,657,10
"2011","Birmingham 046A","E01009304","Total",848,836,12
"2011","Birmingham 046B","E01009306","Total",696,684,12
"2011","Birmingham 046C","E01009308","Total",820,805,15
"2011","Birmingham 046D","E01009310","Total",824,803,21
"2011","Birmingham 047A","E01009348","Total",824,801,23
"2011","Birmingham 047B","E01009358","Total",750,691,59
"2011","Birmingham 047C","E01009359","Total",746,710,36
"2011","Birmingham 047D","E01009360","Total",941,920,21
"2011","Birmingham 047E","E01009361","Total",860,827,33
"2011","Birmingham 048A","E01009478","Total",680,655,25
"2011","Birmingham 048B","E01009479","Total",638,607,31
"2011","Birmingham 048C","E01009482","Total",494,472,22
"2011","Birmingham 048D","E01009484","Total",540,515,25
"2011","Birmingham 048E","E01009485","Total",516,488,28
"2011","Birmingham 049A","E01008906","Total",488,476,12
"2011","Birmingham 049B","E01008911","Total",609,596,13
"2011","Birmingham 049D","E01009347","Total",775,755,20
"2011","Birmingham 049E","E01033559","Total",820,769,51
"2011","Birmingham 049F","E01033638","Total",694,668,26
"2011","Birmingham 050A","E01008910","Total",672,661,11
"2011","Birmingham 050B","E01008913","Total",684,681,3
"2011","Birmingham 050C","E01008914","Total",918,895,23
"2011","Birmingham 050E","E01033561","Total",500,492,8
"2011","Birmingham 050F","E01033617","Total",435,407,28
"2011","Birmingham 051A","E01009194","Total",690,679,11
"2011","Birmingham 051B","E01009483","Total",542,504,38
"2011","Birmingham 051C","E01009488","Total",705,688,17
"2011","Birmingham 051D","E01009489","Total",542,526,16
"2011","Birmingham 051E","E01009491","Total",517,470,47
"2011","Birmingham 052B","E01009192","Total",639,614,25
"2011","Birmingham 052D","E01009199","Total",585,577,8
"2011","Birmingham 052E","E01009204","Total",721,706,15
"2011","Birmingham 052F","E01033644","Total",839,810,29
"2011","Birmingham 053A","E01009151","Total",649,614,35
"2011","Birmingham 053B","E01009152","Total",659,624,35
"2011","Birmingham 053C","E01009153","Total",896,850,46
"2011","Birmingham 053D","E01009345","Total",539,527,12
"2011","Birmingham 053E","E01009346","Total",551,540,11
"2011","Birmingham 054A","E01009092","Total",645,632,13
"2011","Birmingham 054B","E01009093","Total",676,648,28
"2011","Birmingham 054C","E01009094","Total",545,532,13
"2011","Birmingham 054D","E01009298","Total",593,577,16
"2011","Birmingham 054E","E01009311","Total",607,583,24
"2011","Birmingham 054F","E01009511","Total",518,507,11
"2011","Birmingham 055A","E01009475","Total",601,589,12
"2011","Birmingham 055B","E01009476","Total",580,570,10
"2011","Birmingham 055C","E01009477","Total",590,573,17
"2011","Birmingham 055D","E01009490","Total",692,669,23
"2011","Birmingham 055E","E01009492","Total",563,542,21
"2011","Birmingham 056A","E01009095","Total",658,637,21
"2011","Birmingham 056B","E01009507","Total",618,606,12
"2011","Birmingham 056C","E01009508","Total",606,597,9
"2011","Birmingham 056D","E01009509","Total",662,634,28
"2011","Birmingham 056E","E01009510","Total",676,670,6
"2011","Birmingham 057A","E01009297","Total",747,727,20
"2011","Birmingham 057B","E01009299","Total",669,646,23
"2011","Birmingham 057C","E01009300","Total",735,713,22
"2011","Birmingham 057D","E01009301","Total",822,806,16
"2011","Birmingham 057E","E01009303","Total",739,723,16
"2011","Birmingham 058A","E01009195","Total",697,678,19
"2011","Birmingham 058C","E01009197","Total",461,452,9
"2011","Birmingham 058D","E01009198","Total",465,449,16
"2011","Birmingham 058E","E01033647","Total",415,403,12
"2011","Birmingham 058F","E01033649","Total",490,465,25
"2011","Birmingham 060A","E01009138","Total",576,547,29
"2011","Birmingham 060B","E01009139","Total",604,576,28
"2011","Birmingham 060C","E01009140","Total",763,732,31
"2011","Birmingham 060D","E01009145","Total",766,719,47
"2011","Birmingham 060E","E01009147","Total",694,657,37
"2011","Birmingham 062A","E01009512","Total",645,610,35
"2011","Birmingham 062B","E01009514","Total",648,594,54
"2011","Birmingham 062C","E01009516","Total",537,531,6
"2011","Birmingham 062D","E01009517","Total",673,665,8
"2011","Birmingham 063A","E01009325","Total",502,493,9
"2011","Birmingham 063D","E01009342","Total",453,438,15
"2011","Birmingham 063E","E01009343","Total",544,525,19
"2011","Birmingham 063F","E01033642","Total",848,820,28
"2011","Birmingham 064A","E01008986","Total",877,859,18
"2011","Birmingham 064B","E01008987","Total",670,637,33
"2011","Birmingham 064C","E01008988","Total",1029,975,54
"2011","Birmingham 064D","E01008989","Total",960,930,30
"2011","Birmingham 064E","E01008990","Total",496,468,28
"2011","Birmingham 064F","E01008991","Total",614,581,33
"2011","Birmingham 066A","E01008882","Total",706,687,19
"2011","Birmingham 066B","E01008896","Total",571,564,7
"2011","Birmingham 066C","E01008898","Total",569,563,6
"2011","Birmingham 066D","E01009326","Total",570,560,10
"2011","Birmingham 066E","E01009341","Total",555,544,11
"2011","Birmingham 066F","E01009513","Total",627,616,11
"2011","Birmingham 067A","E01008881","Total",629,619,10
"2011","Birmingham 067B","E01008897","Total",607,602,5
"2011","Birmingham 067C","E01009515","Total",647,637,10
"2011","Birmingham 067D","E01009518","Total",718,697,21
"2011","Birmingham 067E","E01009521","Total",637,613,24
"2011","Birmingham 069A","E01009302","Total",658,635,23
"2011","Birmingham 069B","E01009314","Total",683,661,22
"2011","Birmingham 069C","E01009321","Total",808,791,17
"2011","Birmingham 069D","E01009322","Total",615,603,12
"2011","Birmingham 069E","E01009323","Total",584,569,15
"2011","Birmingham 070A","E01009329","Total",694,645,49
"2011","Birmingham 070B","E01009334","Total",435,425,10
"2011","Birmingham 070C","E01009337","Total",494,479,15
"2011","Birmingham 070D","E01009338","Total",421,408,13
"2011","Birmingham 070E","E01009380","Total",473,465,8
"2011","Birmingham 071A","E01009362","Total",520,516,4
"2011","Birmingham 071B","E01009363","Total",551,547,4
"2011","Birmingham 071C","E01009364","Total",521,515,6
"2011","Birmingham 071D","E01009365","Total",559,554,5
"2011","Birmingham 071E","E01009379","Total",700,686,14
"2011","Birmingham 072A","E01009312","Total",622,614,8
"2011","Birmingham 072B","E01009324","Total",746,727,19
"2011","Birmingham 072C","E01009519","Total",621,606,15
"2011","Birmingham 072D","E01009520","Total",735,717,18
"2011","Birmingham 073A","E01009066","Total",612,601,11
"2011","Birmingham 073B","E01009070","Total",703,687,16
"2011","Birmingham 073C","E01009252","Total",650,621,29
"2011","Birmingham 073D","E01009260","Total",667,640,27
"2011","Birmingham 073E","E01009261","Total",692,667,25
"2011","Birmingham 074A","E01008984","Total",767,754,13
"2011","Birmingham 074B","E01008994","Total",706,673,33
"2011","Birmingham 074C","E01008996","Total",605,599,6
"2011","Birmingham 074D","E01008997","Total",621,599,22
"2011","Birmingham 075A","E01009065","Total",673,661,12
"2011","Birmingham 075B","E01009067","Total",711,677,34
"2011","Birmingham 075C","E01009068","Total",771,714,57
"2011","Birmingham 075D","E01009069","Total",871,823,48
"2011","Birmingham 075E","E01009072","Total",846,802,44
"2011","Birmingham 076A","E01008885","Total",520,504,16
"2011","Birmingham 076B","E01008886","Total",728,714,14
"2011","Birmingham 076C","E01008888","Total",653,639,14
"2011","Birmingham 076D","E01009313","Total",646,630,16
"2011","Birmingham 077A","E01009368","Total",423,417,6
"2011","Birmingham 077D","E01009371","Total",491,478,13
"2011","Birmingham 077E","E01009397","Total",471,450,21
"2011","Birmingham 077F","E01033650","Total",680,671,9
"2011","Birmingham 078A","E01008883","Total",667,651,16
"2011","Birmingham 078B","E01008884","Total",714,682,32
"2011","Birmingham 078C","E01008887","Total",649,626,23
"2011","Birmingham 078D","E01008889","Total",693,659,34
"2011","Birmingham 079A","E01008982","Total",698,667,31
"2011","Birmingham 079C","E01008992","Total",500,482,18
"2011","Birmingham 079E","E01009283","Total",616,593,23
"2011","Birmingham 079F","E01033631","Total",913,836,77
"2011","Birmingham 080A","E01009249","Total",648,629,19
"2011","Birmingham 080B","E01009250","Total",724,689,35
"2011","Birmingham 080C","E01009251","Total",642,627,15
"2011","Birmingham 080D","E01009253","Total",638,624,14
"2011","Birmingham 080E","E01009255","Total",649,633,16
"2011","Birmingham 080F","E01009257","Total",620,596,24
"2011","Birmingham 081A","E01009315","Total",802,783,19
"2011","Birmingham 081B","E01009316","Total",697,683,14
"2011","Birmingham 081C","E01009317","Total",779,760,19
"2011","Birmingham 081D","E01009318","Total",647,627,20
"2011","Birmingham 081E","E01009319","Total",669,653,16
"2011","Birmingham 081F","E01009320","Total",636,609,27
"2011","Birmingham 082A","E01009372","Total",426,420,6
"2011","Birmingham 082B","E01009373","Total",478,466,12
"2011","Birmingham 082D","E01009396","Total",504,478,26
"2011","Birmingham 082F","E01033643","Total",854,814,40
"2011","Birmingham 083A","E01009367","Total",497,490,7
"2011","Birmingham 083B","E01009375","Total",537,522,15
"2011","Birmingham 083C","E01009377","Total",467,452,15
"2011","Birmingham 083D","E01009383","Total",430,418,12
"2011","Birmingham 083E","E01009399","Total",430,416,14
"2011","Birmingham 084A","E01009366","Total",521,517,4
"2011","Birmingham 084B","E01009374","Total",426,423,3
"2011","Birmingham 084C","E01009376","Total",595,564,31
"2011","Birmingham 084F","E01033648","Total",852,826,26
"2011","Birmingham 085A","E01009073","Total",675,657,18
"2011","Birmingham 085B","E01009074","Total",695,667,28
"2011","Birmingham 085C","E01009254","Total",702,669,33
"2011","Birmingham 085D","E01009256","Total",688,663,25
"2011","Birmingham 085E","E01009258","Total",672,661,11
"2011","Birmingham 087B","E01009071","Total",824,789,35
"2011","Birmingham 087C","E01009075","Total",849,829,20
"2011","Birmingham 087E","E01009078","Total",651,626,25
"2011","Birmingham 087F","E01033562","Total",1088,1045,43
"2011","Birmingham 088C","E01009183","Total",602,572,30
"2011","Birmingham 088D","E01009186","Total",814,760,54
"2011","Birmingham 088E","E01033645","Total",903,863,40
"2011","Birmingham 089A","E01008890","Total",722,705,17
"2011","Birmingham 089B","E01008891","Total",706,689,17
"2011","Birmingham 089C","E01008892","Total",533,518,15
"2011","Birmingham 089D","E01008893","Total",743,725,18
"2011","Birmingham 089E","E01008894","Total",693,658,35
"2011","Birmingham 089F","E01008895","Total",787,771,16
"2011","Birmingham 089G","E01009015","Total",812,786,26
"2011","Birmingham 090A","E01009014","Total",695,657,38
"2011","Birmingham 090B","E01009018","Total",730,697,33
"2011","Birmingham 090C","E01009026","Total",607,581,26
"2011","Birmingham 090D","E01009028","Total",643,622,21
"2011","Birmingham 090E","E01009029","Total",540,528,12
"2011","Birmingham 092A","E01009182","Total",721,666,55
"2011","Birmingham 092B","E01009184","Total",775,724,51
"2011","Birmingham 092C","E01009187","Total",716,686,30
"2011","Birmingham 092D","E01009188","Total",705,665,40
"2011","Birmingham 092E","E01009384","Total",739,725,14
"2011","Birmingham 092F","E01009385","Total",631,615,16
"2011","Birmingham 093A","E01009185","Total",807,736,71
"2011","Birmingham 093B","E01009389","Total",494,474,20
"2011","Birmingham 093C","E01009390","Total",691,659,32
"2011","Birmingham 093D","E01009394","Total",785,755,30
"2011","Birmingham 094A","E01008918","Total",754,753,1
"2011","Birmingham 094B","E01008920","Total",568,556,12
"2011","Birmingham 094C","E01008921","Total",636,630,6
"2011","Birmingham 094D","E01008931","Total",655,647,8
"2011","Birmingham 094E","E01009259","Total",706,670,36
"2011","Birmingham 095A","E01008919","Total",720,704,16
"2011","Birmingham 095B","E01009064","Total",612,600,12
"2011","Birmingham 095C","E01009077","Total",733,718,15
"2011","Birmingham 095D","E01009291","Total",636,624,12
"2011","Birmingham 095E","E01009500","Total",647,637,10
"2011","Birmingham 096A","E01009284","Total",702,664,38
"2011","Birmingham 096C","E01009286","Total",537,504,33
"2011","Birmingham 096E","E01009289","Total",587,561,26
"2011","Birmingham 096F","E01009290","Total",492,465,27
"2011","Birmingham 096G","E01033634","Total",828,800,28
"2011","Birmingham 097A","E01009017","Total",508,491,17
"2011","Birmingham 097B","E01009043","Total",664,652,12
"2011","Birmingham 097C","E01009044","Total",486,463,23
"2011","Birmingham 097D","E01009045","Total",626,598,28
"2011","Birmingham 097E","E01009046","Total",623,610,13
"2011","Birmingham 097F","E01009395","Total",583,566,17
"2011","Birmingham 098A","E01009016","Total",757,732,25
"2011","Birmingham 098B","E01009022","Total",623,612,11
"2011","Birmingham 098C","E01009023","Total",586,572,14
"2011","Birmingham 098D","E01009030","Total",496,480,16
"2011","Birmingham 099A","E01009281","Total",681,660,21
"2011","Birmingham 099B","E01009292","Total",690,666,24
"2011","Birmingham 099C","E01009294","Total",833,809,24
"2011","Birmingham 099D","E01009295","Total",711,677,34
"2011","Birmingham 100A","E01009280","Total",618,571,47
"2011","Birmingham 100B","E01009282","Total",668,639,29
"2011","Birmingham 100C","E01009288","Total",451,437,14
"2011","Birmingham 100D","E01009293","Total",648,601,47
"2011","Birmingham 100E","E01009296","Total",613,581,32
"2011","Birmingham 101A","E01008924","Total",638,623,15
"2011","Birmingham 101B","E01009501","Total",655,629,26
"2011","Birmingham 101C","E01009502","Total",671,648,23
"2011","Birmingham 101D","E01009503","Total",628,615,13
"2011","Birmingham 101E","E01009505","Total",710,690,20
"2011","Birmingham 102A","E01008917","Total",532,523,9
"2011","Birmingham 102B","E01008923","Total",655,637,18
"2011","Birmingham 102C","E01008925","Total",517,515,2
"2011","Birmingham 102D","E01008927","Total",656,644,12
"2011","Birmingham 102E","E01008928","Total",691,684,7
"2011","Birmingham 103A","E01009019","Total",620,612,8
"2011","Birmingham 103B","E01009020","Total",566,557,9
"2011","Birmingham 103C","E01009021","Total",666,654,12
"2011","Birmingham 103D","E01009024","Total",623,606,17
"2011","Birmingham 103E","E01009025","Total",600,584,16
"2011","Birmingham 103F","E01009033","Total",703,677,26
"2011","Birmingham 104A","E01009175","Total",620,593,27
"2011","Birmingham 104B","E01009177","Total",673,647,26
"2011","Birmingham 104C","E01009178","Total",756,707,49
"2011","Birmingham 104D","E01009179","Total",669,651,18
"2011","Birmingham 104E","E01009189","Total",638,605,33
"2011","Birmingham 105A","E01008933","Total",563,549,14
"2011","Birmingham 105B","E01008934","Total",567,547,20
"2011","Birmingham 105C","E01009031","Total",622,601,21
"2011","Birmingham 105D","E01009037","Total",732,700,32
"2011","Birmingham 105E","E01009176","Total",702,670,32
"2011","Birmingham 106C","E01008929","Total",698,676,22
"2011","Birmingham 106D","E01008930","Total",725,605,120
"2011","Birmingham 106E","E01009495","Total",511,501,10
"2011","Birmingham 106F","E01033629","Total",1102,1071,31
"2011","Birmingham 107A","E01008953","Total",661,638,23
"2011","Birmingham 107B","E01008963","Total",587,572,15
"2011","Birmingham 107C","E01008964","Total",653,634,19
"2011","Birmingham 107D","E01008965","Total",597,587,10
"2011","Birmingham 107E","E01008966","Total",701,688,13
"2011","Birmingham 108A","E01009032","Total",614,587,27
"2011","Birmingham 108B","E01009034","Total",555,533,22
"2011","Birmingham 108C","E01009035","Total",654,637,17
"2011","Birmingham 108D","E01009036","Total",552,540,12
"2011","Birmingham 109A","E01009494","Total",636,629,7
"2011","Birmingham 109B","E01009496","Total",636,627,9
"2011","Birmingham 109C","E01009497","Total",755,728,27
"2011","Birmingham 109D","E01009504","Total",629,619,10
"2011","Birmingham 109E","E01009506","Total",645,635,10
"2011","Birmingham 110A","E01008967","Total",679,665,14
"2011","Birmingham 110B","E01008968","Total",734,697,37
"2011","Birmingham 110C","E01008970","Total",631,621,10
"2011","Birmingham 110D","E01008981","Total",597,587,10
"2011","Birmingham 111A","E01008932","Total",684,670,14
"2011","Birmingham 111B","E01008935","Total",702,675,27
"2011","Birmingham 111C","E01008936","Total",659,643,16
"2011","Birmingham 111D","E01008938","Total",603,588,15
"2011","Birmingham 111E","E01008939","Total",687,673,14
"2011","Birmingham 112A","E01008951","Total",588,574,14
"2011","Birmingham 112B","E01008952","Total",844,761,83
"2011","Birmingham 112C","E01008955","Total",697,666,31
"2011","Birmingham 112D","E01008956","Total",590,577,13
"2011","Birmingham 112E","E01008957","Total",747,708,39
"2011","Birmingham 113A","E01008950","Total",731,718,13
"2011","Birmingham 113B","E01008954","Total",589,585,4
"2011","Birmingham 113C","E01008958","Total",797,787,10
"2011","Birmingham 113D","E01009493","Total",809,792,17
"2011","Birmingham 115A","E01008937","Total",620,607,13
"2011","Birmingham 115B","E01008940","Total",615,594,21
"2011","Birmingham 115C","E01008941","Total",602,585,17
"2011","Birmingham 115D","E01008944","Total",757,733,24
"2011","Birmingham 116A","E01008959","Total",813,790,23
"2011","Birmingham 116B","E01008960","Total",640,625,15
"2011","Birmingham 116C","E01008961","Total",778,738,40
"2011","Birmingham 116D","E01008962","Total",846,818,28
"2011","Birmingham 117A","E01008942","Total",629,618,11
"2011","Birmingham 117B","E01008943","Total",576,562,14
"2011","Birmingham 117C","E01008969","Total",711,697,14
"2011","Birmingham 117D","E01008971","Total",750,716,34
"2011","Birmingham 118A","E01008972","Total",759,741,18
"2011","Birmingham 118B","E01008973","Total",871,848,23
"2011","Birmingham 118C","E01008974","Total",1180,1153,27
"2011","Birmingham 118D","E01008975","Total",695,669,26
"2011","Birmingham 119A","E01009172","Total",561,548,13
"2011","Birmingham 119B","E01009173","Total",674,656,18
"2011","Birmingham 119C","E01009174","Total",538,533,5
"2011","Birmingham 119D","E01009498","Total",710,688,22
"2011","Birmingham 119E","E01009499","Total",685,673,12
"2011","Birmingham 120A","E01009205","Total",633,615,18
"2011","Birmingham 120B","E01009206","Total",671,658,13
"2011","Birmingham 120C","E01009211","Total",686,676,10
"2011","Birmingham 120D","E01009218","Total",651,635,16
"2011","Birmingham 120E","E01009219","Total",624,609,15
"2011","Birmingham 121A","E01008976","Total",706,679,27
"2011","Birmingham 121B","E01008978","Total",802,744,58
"2011","Birmingham 121C","E01008979","Total",784,765,19
"2011","Birmingham 121D","E01008980","Total",716,681,35
"2011","Birmingham 122A","E01008945","Total",766,745,21
"2011","Birmingham 122B","E01008946","Total",662,643,19
"2011","Birmingham 122C","E01008947","Total",556,543,13
"2011","Birmingham 122D","E01008948","Total",653,627,26
"2011","Birmingham 122E","E01008949","Total",521,515,6
"2011","Birmingham 123A","E01008977","Total",709,698,11
"2011","Birmingham 123B","E01009109","Total",528,516,12
"2011","Birmingham 123C","E01009119","Total",668,641,27
"2011","Birmingham 123D","E01009120","Total",653,628,25
"2011","Birmingham 124A","E01009162","Total",673,653,20
"2011","Birmingham 124B","E01009207","Total",670,663,7
"2011","Birmingham 124C","E01009208","Total",646,618,28
"2011","Birmingham 124D","E01009209","Total",1005,975,30
"2011","Birmingham 124E","E01009213","Total",707,699,8
"2011","Birmingham 125B","E01009155","Total",610,602,8
"2011","Birmingham 125D","E01009157","Total",638,632,6
"2011","Birmingham 125E","E01009160","Total",750,736,14
"2011","Birmingham 125F","E01009161","Total",626,617,9
"2011","Birmingham 125G","E01033633","Total",1004,986,18
"2011","Birmingham 126A","E01009117","Total",830,820,10
"2011","Birmingham 126B","E01009210","Total",808,796,12
"2011","Birmingham 126C","E01009212","Total",792,767,25
"2011","Birmingham 126D","E01009214","Total",814,788,26
"2011","Birmingham 126E","E01009215","Total",992,884,108
"2011","Birmingham 127A","E01009108","Total",565,557,8
"2011","Birmingham 127B","E01009111","Total",565,550,15
"2011","Birmingham 127C","E01009112","Total",615,600,15
"2011","Birmingham 127D","E01009116","Total",604,579,25
"2011","Birmingham 127E","E01009118","Total",692,677,15
"2011","Birmingham 128A","E01009107","Total",844,829,15
"2011","Birmingham 128B","E01009110","Total",658,649,9
"2011","Birmingham 128C","E01009113","Total",642,624,18
"2011","Birmingham 128D","E01009114","Total",685,680,5
"2011","Birmingham 128E","E01009115","Total",624,618,6
"2011","Birmingham 129A","E01009158","Total",779,762,17
"2011","Birmingham 129B","E01009163","Total",644,635,9
"2011","Birmingham 129C","E01009165","Total",675,659,16
"2011","Birmingham 129D","E01009169","Total",693,682,11
"2011","Birmingham 130A","E01009159","Total",783,753,30
"2011","Birmingham 130B","E01009164","Total",646,634,12
"2011","Birmingham 130C","E01009167","Total",614,603,11
"2011","Birmingham 130D","E01009171","Total",716,694,22
"2011","Birmingham 131A","E01009166","Total",572,559,13
"2011","Birmingham 131B","E01009168","Total",639,621,18
"2011","Birmingham 131C","E01009170","Total",634,627,7
"2011","Birmingham 131D","E01009216","Total",831,816,15
"2011","Birmingham 131E","E01009217","Total",675,660,15
"2011","Birmingham 132A","E01009039","Total",656,641,15
"2011","Birmingham 132B","E01009040","Total",640,628,12
"2011","Birmingham 132C","E01009041","Total",642,627,15
"2011","Birmingham 132D","E01009042","Total",549,539,10
"2011","Birmingham 132E","E01032589","Total",625,578,47
"2011","Birmingham 133A","E01009262","Total",533,520,13
"2011","Birmingham 133B","E01009267","Total",585,567,18
"2011","Birmingham 133C","E01009276","Total",557,528,29
"2011","Birmingham 133D","E01009278","Total",557,540,17
"2011","Birmingham 133E","E01009279","Total",457,445,12
"2011","Birmingham 133F","E01032591","Total",497,483,14
"2011","Birmingham 134A","E01008995","Total",734,725,9
"2011","Birmingham 134B","E01033557","Total",980,836,144
"2011","Birmingham 134C","E01033624","Total",520,498,22
"2011","Birmingham 134D","E01033626","Total",570,556,14
"2011","Birmingham 134E","E01033640","Total",579,564,15
"2011","Birmingham 135A","E01009378","Total",1083,1060,23
"2011","Birmingham 135B","E01033567","Total",791,712,79
"2011","Birmingham 135C","E01033615","Total",829,616,213
"2011","Birmingham 135D","E01033616","Total",758,714,44
"2011","Birmingham 136A","E01009143","Total",682,660,22
"2011","Birmingham 136B","E01009146","Total",909,892,17
"2011","Birmingham 136C","E01033564","Total",805,770,35
"2011","Birmingham 136D","E01033639","Total",858,828,30
"2011","Birmingham 137A","E01009141","Total",839,825,14
"2011","Birmingham 137B","E01033565","Total",701,623,78
"2011","Birmingham 137C","E01033618","Total",821,745,76
"2011","Birmingham 137D","E01033619","Total",628,605,23
"2011","Birmingham 137E","E01033627","Total",613,573,40
"2011","Birmingham 138A","E01033620","Total",784,702,82
"2011","Birmingham 138B","E01033622","Total",973,901,72
"2011","Birmingham 138C","E01033623","Total",883,772,111
"2011","Birmingham 138D","E01033625","Total",1206,1058,148
"2011","Birmingham 139A","E01009200","Total",671,659,12
"2011","Birmingham 139B","E01009327","Total",433,412,21
"2011","Birmingham 139C","E01009328","Total",544,525,19
"2011","Birmingham 139D","E01009331","Total",575,557,18
"2011","Birmingham 139E","E01009332","Total",557,539,18
"2011","Birmingham 139F","E01009333","Total",442,436,6
"2011","Birmingham 139G","E01009335","Total",498,479,19
"2011","Birmingham 139H","E01009344","Total",467,460,7
"2011","Birmingham 140A","E01009339","Total",471,455,16
"2011","Birmingham 140B","E01009340","Total",967,941,26
"2011","Birmingham 140C","E01009382","Total",468,448,20
"2011","Birmingham 140D","E01009391","Total",564,522,42
"2011","Birmingham 140E","E01009392","Total",453,444,9
"2011","Birmingham 140F","E01009393","Total",524,473,51
"2011","Birmingham 140G","E01033641","Total",935,891,44
"2011","Coventry 001A","E01009589","Total",615,591,24
"2011","Coventry 001F","E01032536","Total",887,852,35
"2011","Coventry 001G","E01032537","Total",847,831,16
"2011","Coventry 001H","E01032538","Total",1031,994,37
"2011","Coventry 002A","E01009590","Total",544,523,21
"2011","Coventry 002B","E01009591","Total",608,580,28
"2011","Coventry 002C","E01009593","Total",662,633,29
"2011","Coventry 002D","E01009598","Total",656,642,14
"2011","Coventry 004A","E01009604","Total",585,566,19
"2011","Coventry 004B","E01009605","Total",660,650,10
"2011","Coventry 004C","E01009607","Total",812,803,9
"2011","Coventry 004D","E01009608","Total",638,621,17
"2011","Coventry 004E","E01009610","Total",664,637,27
"2011","Coventry 005A","E01009564","Total",623,587,36
"2011","Coventry 005B","E01009575","Total",507,481,26
"2011","Coventry 005C","E01009606","Total",568,537,31
"2011","Coventry 005D","E01009609","Total",625,610,15
"2011","Coventry 006A","E01009524","Total",723,680,43
"2011","Coventry 006B","E01009525","Total",587,575,12
"2011","Coventry 006C","E01009527","Total",672,654,18
"2011","Coventry 006D","E01009594","Total",557,532,25
"2011","Coventry 007A","E01009577","Total",568,527,41
"2011","Coventry 007B","E01009579","Total",763,695,68
"2011","Coventry 007C","E01009581","Total",665,638,27
"2011","Coventry 007D","E01009584","Total",620,603,17
"2011","Coventry 007E","E01009585","Total",414,390,24
"2011","Coventry 007F","E01009709","Total",487,429,58
"2011","Coventry 008A","E01009576","Total",712,684,28
"2011","Coventry 008B","E01009578","Total",574,564,10
"2011","Coventry 008C","E01009582","Total",757,738,19
"2011","Coventry 008D","E01009583","Total",683,672,11
"2011","Coventry 008E","E01009586","Total",665,651,14
"2011","Coventry 009A","E01009565","Total",469,458,11
"2011","Coventry 009B","E01009566","Total",588,569,19
"2011","Coventry 009C","E01009567","Total",701,660,41
"2011","Coventry 009D","E01009568","Total",551,541,10
"2011","Coventry 010A","E01009523","Total",639,609,30
"2011","Coventry 010B","E01009526","Total",621,599,22
"2011","Coventry 010C","E01009528","Total",709,679,30
"2011","Coventry 010D","E01009531","Total",804,761,43
"2011","Coventry 011A","E01009587","Total",621,572,49
"2011","Coventry 011B","E01009624","Total",641,622,19
"2011","Coventry 011C","E01009625","Total",889,867,22
"2011","Coventry 011D","E01009626","Total",656,632,24
"2011","Coventry 012A","E01009622","Total",669,655,14
"2011","Coventry 012B","E01009623","Total",686,678,8
"2011","Coventry 012C","E01009627","Total",737,712,25
"2011","Coventry 012D","E01009628","Total",661,632,29
"2011","Coventry 013A","E01009599","Total",631,607,24
"2011","Coventry 013B","E01009663","Total",643,633,10
"2011","Coventry 013C","E01009710","Total",643,634,9
"2011","Coventry 013D","E01009711","Total",617,600,17
"2011","Coventry 014A","E01009522","Total",667,647,20
"2011","Coventry 014B","E01009529","Total",638,621,17
"2011","Coventry 014C","E01009530","Total",572,561,11
"2011","Coventry 014D","E01009645","Total",588,572,16
"2011","Coventry 015A","E01009569","Total",526,494,32
"2011","Coventry 015B","E01009570","Total",625,596,29
"2011","Coventry 015C","E01009571","Total",705,673,32
"2011","Coventry 015D","E01009572","Total",835,797,38
"2011","Coventry 015E","E01009573","Total",545,525,20
"2011","Coventry 015F","E01009574","Total",586,559,27
"2011","Coventry 016A","E01009655","Total",848,789,59
"2011","Coventry 016B","E01009656","Total",749,713,36
"2011","Coventry 016C","E01009659","Total",834,765,69
"2011","Coventry 016D","E01009662","Total",589,569,20
"2011","Coventry 016E","E01009664","Total",594,578,16
"2011","Coventry 017A","E01009643","Total",611,591,20
"2011","Coventry 017B","E01009644","Total",697,679,18
"2011","Coventry 017C","E01009647","Total",824,785,39
"2011","Coventry 017D","E01009648","Total",619,607,12
"2011","Coventry 017E","E01009652","Total",630,619,11
"2011","Coventry 017F","E01009653","Total",640,625,15
"2011","Coventry 018A","E01009613","Total",515,502,13
"2011","Coventry 018B","E01009657","Total",639,627,12
"2011","Coventry 018C","E01009712","Total",641,620,21
"2011","Coventry 018D","E01009714","Total",591,576,15
"2011","Coventry 018E","E01009716","Total",661,649,12
"2011","Coventry 019A","E01009580","Total",558,547,11
"2011","Coventry 019B","E01009713","Total",538,521,17
"2011","Coventry 019C","E01009715","Total",613,588,25
"2011","Coventry 019D","E01009717","Total",602,585,17
"2011","Coventry 019E","E01009718","Total",921,885,36
"2011","Coventry 020A","E01009629","Total",1147,1079,68
"2011","Coventry 020B","E01009630","Total",736,708,28
"2011","Coventry 020C","E01009631","Total",624,577,47
"2011","Coventry 020D","E01009632","Total",1021,943,78
"2011","Coventry 020E","E01009650","Total",879,790,89
"2011","Coventry 021A","E01009614","Total",599,585,14
"2011","Coventry 021B","E01009654","Total",733,710,23
"2011","Coventry 021C","E01009658","Total",624,585,39
"2011","Coventry 021D","E01009660","Total",682,658,24
"2011","Coventry 022A","E01009646","Total",629,619,10
"2011","Coventry 022B","E01009692","Total",542,531,11
"2011","Coventry 022C","E01009693","Total",711,692,19
"2011","Coventry 022D","E01009694","Total",640,623,17
"2011","Coventry 023A","E01009695","Total",778,754,24
"2011","Coventry 023B","E01009696","Total",663,640,23
"2011","Coventry 023C","E01009704","Total",604,596,8
"2011","Coventry 023D","E01009705","Total",589,578,11
"2011","Coventry 024A","E01009636","Total",1000,967,33
"2011","Coventry 024B","E01009637","Total",500,481,19
"2011","Coventry 024C","E01009638","Total",759,732,27
"2011","Coventry 024D","E01009639","Total",569,545,24
"2011","Coventry 024E","E01009640","Total",729,707,22
"2011","Coventry 024F","E01009641","Total",938,902,36
"2011","Coventry 025A","E01009697","Total",674,644,30
"2011","Coventry 025B","E01009698","Total",644,624,20
"2011","Coventry 025C","E01009703","Total",1191,1144,47
"2011","Coventry 025D","E01009706","Total",672,656,16
"2011","Coventry 026A","E01009649","Total",603,582,21
"2011","Coventry 026B","E01009684","Total",697,680,17
"2011","Coventry 026C","E01009685","Total",734,714,20
"2011","Coventry 026D","E01009686","Total",720,692,28
"2011","Coventry 026E","E01009687","Total",627,600,27
"2011","Coventry 027A","E01009615","Total",707,678,29
"2011","Coventry 027B","E01009616","Total",634,608,26
"2011","Coventry 027C","E01009617","Total",500,473,27
"2011","Coventry 027D","E01009618","Total",630,612,18
"2011","Coventry 027E","E01009620","Total",625,608,17
"2011","Coventry 027F","E01009621","Total",550,536,14
"2011","Coventry 028A","E01009633","Total",747,713,34
"2011","Coventry 028B","E01009634","Total",710,679,31
"2011","Coventry 028C","E01009635","Total",933,886,47
"2011","Coventry 028D","E01009661","Total",878,793,85
"2011","Coventry 029A","E01009674","Total",708,674,34
"2011","Coventry 029B","E01009699","Total",642,624,18
"2011","Coventry 029C","E01009700","Total",871,831,40
"2011","Coventry 029D","E01009701","Total",742,729,13
"2011","Coventry 029E","E01009702","Total",754,729,25
"2011","Coventry 030A","E01009688","Total",636,601,35
"2011","Coventry 030B","E01009689","Total",756,717,39
"2011","Coventry 030C","E01009690","Total",705,660,45
"2011","Coventry 030D","E01009691","Total",669,631,38
"2011","Coventry 031A","E01009548","Total",1133,1038,95
"2011","Coventry 031B","E01009553","Total",726,687,39
"2011","Coventry 031C","E01009642","Total",1083,963,120
"2011","Coventry 031D","E01009651","Total",916,874,42
"2011","Coventry 032A","E01009676","Total",620,600,20
"2011","Coventry 032B","E01009681","Total",555,535,20
"2011","Coventry 032C","E01009682","Total",620,601,19
"2011","Coventry 032D","E01009683","Total",573,560,13
"2011","Coventry 033A","E01009532","Total",601,577,24
"2011","Coventry 033B","E01009535","Total",595,558,37
"2011","Coventry 033C","E01009536","Total",621,613,8
"2011","Coventry 033D","E01009543","Total",570,560,10
"2011","Coventry 033E","E01009707","Total",739,727,12
"2011","Coventry 033F","E01009708","Total",633,626,7
"2011","Coventry 034A","E01009554","Total",608,571,37
"2011","Coventry 034B","E01009555","Total",618,601,17
"2011","Coventry 034C","E01009556","Total",807,772,35
"2011","Coventry 034D","E01009557","Total",553,539,14
"2011","Coventry 034E","E01009558","Total",679,643,36
"2011","Coventry 034F","E01009559","Total",644,606,38
"2011","Coventry 035C","E01009537","Total",653,612,41
"2011","Coventry 035D","E01009538","Total",627,601,26
"2011","Coventry 035E","E01009611","Total",803,772,31
"2011","Coventry 035F","E01009612","Total",603,566,37
"2011","Coventry 035G","E01032527","Total",650,631,19
"2011","Coventry 035H","E01032528","Total",710,697,13
"2011","Coventry 036C","E01009679","Total",636,614,22
"2011","Coventry 036E","E01032531","Total",1203,1147,56
"2011","Coventry 036F","E01032532","Total",555,533,22
"2011","Coventry 036G","E01032533","Total",660,643,17
"2011","Coventry 037B","E01009549","Total",692,668,24
"2011","Coventry 037C","E01009550","Total",792,770,22
"2011","Coventry 037E","E01009552","Total",725,719,6
"2011","Coventry 037F","E01032534","Total",773,756,17
"2011","Coventry 037G","E01032535","Total",496,485,11
"2011","Coventry 038A","E01009544","Total",771,749,22
"2011","Coventry 038D","E01009619","Total",859,831,28
"2011","Coventry 038E","E01032529","Total",711,693,18
"2011","Coventry 038F","E01032530","Total",850,817,33
"2011","Coventry 039A","E01009539","Total",846,774,72
"2011","Coventry 039B","E01009540","Total",791,779,12
"2011","Coventry 039C","E01009541","Total",841,816,25
"2011","Coventry 039D","E01009542","Total",940,893,47
"2011","Coventry 040A","E01009560","Total",554,547,7
"2011","Coventry 040B","E01009561","Total",789,767,22
"2011","Coventry 040C","E01009562","Total",726,709,17
"2011","Coventry 040D","E01009563","Total",630,619,11
"2011","Coventry 040E","E01009672","Total",847,822,25
"2011","Coventry 041A","E01009666","Total",512,503,9
"2011","Coventry 041B","E01009667","Total",590,575,15
"2011","Coventry 041C","E01009668","Total",648,630,18
"2011","Coventry 041D","E01009670","Total",683,673,10
"2011","Coventry 042A","E01009665","Total",486,475,11
"2011","Coventry 042B","E01009669","Total",476,462,14
"2011","Coventry 042C","E01009671","Total",427,410,17
"2011","Coventry 042F","E01033058","Total",939,911,28
"2011","Coventry 043A","E01009588","Total",706,681,25
"2011","Coventry 043B","E01009592","Total",657,640,17
"2011","Coventry 043C","E01009596","Total",590,564,26
"2011","Coventry 043D","E01009597","Total",664,642,22
"2011","Coventry 043E","E01032587","Total",680,670,10
"2011","Dudley 001A","E01009763","Total",702,690,12
"2011","Dudley 001B","E01009764","Total",595,571,24
"2011","Dudley 001C","E01009767","Total",625,615,10
"2011","Dudley 001D","E01009769","Total",737,708,29
"2011","Dudley 001E","E01009770","Total",650,634,16
"2011","Dudley 002A","E01009773","Total",701,665,36
"2011","Dudley 002B","E01009777","Total",633,612,21
"2011","Dudley 002C","E01009778","Total",647,621,26
"2011","Dudley 002D","E01009895","Total",637,611,26
"2011","Dudley 003A","E01009896","Total",618,606,12
"2011","Dudley 003B","E01009897","Total",615,606,9
"2011","Dudley 003C","E01009898","Total",665,652,13
"2011","Dudley 003D","E01009901","Total",608,585,23
"2011","Dudley 003E","E01009902","Total",545,533,12
"2011","Dudley 004A","E01009765","Total",667,641,26
"2011","Dudley 004B","E01009766","Total",685,672,13
"2011","Dudley 004C","E01009768","Total",660,626,34
"2011","Dudley 004D","E01009771","Total",654,640,14
"2011","Dudley 004E","E01009775","Total",618,597,21
"2011","Dudley 004F","E01009776","Total",606,590,16
"2011","Dudley 005A","E01009758","Total",686,664,22
"2011","Dudley 005B","E01009760","Total",529,505,24
"2011","Dudley 005C","E01009772","Total",492,480,12
"2011","Dudley 005D","E01009774","Total",640,625,15
"2011","Dudley 005E","E01009788","Total",734,705,29
"2011","Dudley 006B","E01009756","Total",542,527,15
"2011","Dudley 006C","E01009757","Total",677,645,32
"2011","Dudley 006D","E01009759","Total",543,526,17
"2011","Dudley 006F","E01009762","Total",494,489,5
"2011","Dudley 006G","E01033187","Total",866,837,29
"2011","Dudley 007A","E01009781","Total",914,890,24
"2011","Dudley 007B","E01009786","Total",642,626,16
"2011","Dudley 007C","E01009789","Total",663,643,20
"2011","Dudley 007D","E01009790","Total",688,667,21
"2011","Dudley 008A","E01009779","Total",693,675,18
"2011","Dudley 008B","E01009782","Total",652,632,20
"2011","Dudley 008C","E01009783","Total",609,597,12
"2011","Dudley 008D","E01009785","Total",664,634,30
"2011","Dudley 008E","E01009899","Total",636,625,11
"2011","Dudley 008F","E01009900","Total",642,633,9
"2011","Dudley 009A","E01009780","Total",757,745,12
"2011","Dudley 009B","E01009784","Total",634,625,9
"2011","Dudley 009C","E01009787","Total",594,585,9
"2011","Dudley 009D","E01009880","Total",572,569,3
"2011","Dudley 009E","E01009882","Total",582,542,40
"2011","Dudley 010A","E01009891","Total",637,615,22
"2011","Dudley 010B","E01009892","Total",659,632,27
"2011","Dudley 010C","E01009893","Total",633,607,26
"2011","Dudley 010D","E01009894","Total",720,696,24
"2011","Dudley 011A","E01009844","Total",655,608,47
"2011","Dudley 011B","E01009879","Total",835,802,33
"2011","Dudley 011C","E01009881","Total",1180,1131,49
"2011","Dudley 011D","E01009885","Total",712,682,30
"2011","Dudley 012A","E01009816","Total",611,607,4
"2011","Dudley 012B","E01009817","Total",552,544,8
"2011","Dudley 012C","E01009819","Total",665,662,3
"2011","Dudley 012D","E01009820","Total",664,644,20
"2011","Dudley 013A","E01009748","Total",667,649,18
"2011","Dudley 013B","E01009839","Total",609,582,27
"2011","Dudley 013C","E01009883","Total",577,569,8
"2011","Dudley 013D","E01009884","Total",673,645,28
"2011","Dudley 013E","E01009886","Total",846,833,13
"2011","Dudley 014A","E01009814","Total",524,515,9
"2011","Dudley 014B","E01009815","Total",504,498,6
"2011","Dudley 014C","E01009818","Total",519,511,8
"2011","Dudley 014D","E01009821","Total",618,602,16
"2011","Dudley 014E","E01009822","Total",677,657,20
"2011","Dudley 015A","E01009887","Total",658,637,21
"2011","Dudley 015B","E01009888","Total",677,660,17
"2011","Dudley 015C","E01009889","Total",752,681,71
"2011","Dudley 015D","E01009890","Total",680,665,15
"2011","Dudley 016A","E01009749","Total",610,594,16
"2011","Dudley 016B","E01009750","Total",601,595,6
"2011","Dudley 016C","E01009823","Total",541,537,4
"2011","Dudley 016D","E01009824","Total",725,703,22
"2011","Dudley 017A","E01009751","Total",685,651,34
"2011","Dudley 017B","E01009752","Total",616,595,21
"2011","Dudley 017C","E01009753","Total",630,615,15
"2011","Dudley 017D","E01009754","Total",662,640,22
"2011","Dudley 017E","E01009841","Total",656,631,25
"2011","Dudley 018A","E01009840","Total",581,533,48
"2011","Dudley 018B","E01009842","Total",950,902,48
"2011","Dudley 018C","E01009843","Total",682,659,23
"2011","Dudley 018D","E01009871","Total",870,833,37
"2011","Dudley 018E","E01009875","Total",633,623,10
"2011","Dudley 019A","E01009825","Total",616,604,12
"2011","Dudley 019B","E01009826","Total",650,638,12
"2011","Dudley 019C","E01009827","Total",641,633,8
"2011","Dudley 019D","E01009828","Total",591,573,18
"2011","Dudley 019E","E01009829","Total",645,635,10
"2011","Dudley 019F","E01009830","Total",635,624,11
"2011","Dudley 020A","E01009872","Total",640,615,25
"2011","Dudley 020B","E01009873","Total",639,620,19
"2011","Dudley 020C","E01009874","Total",601,581,20
"2011","Dudley 020D","E01009876","Total",667,653,14
"2011","Dudley 020E","E01009877","Total",645,633,12
"2011","Dudley 021A","E01009911","Total",622,611,11
"2011","Dudley 021B","E01009912","Total",713,691,22
"2011","Dudley 021C","E01009913","Total",662,648,14
"2011","Dudley 021D","E01009914","Total",604,593,11
"2011","Dudley 021E","E01009915","Total",730,712,18
"2011","Dudley 021F","E01009916","Total",747,725,22
"2011","Dudley 022A","E01009741","Total",1235,1179,56
"2011","Dudley 022B","E01009744","Total",921,872,49
"2011","Dudley 022C","E01009746","Total",731,688,43
"2011","Dudley 022D","E01009747","Total",703,661,42
"2011","Dudley 023A","E01009731","Total",725,679,46
"2011","Dudley 023B","E01009740","Total",697,669,28
"2011","Dudley 023C","E01009742","Total",662,647,15
"2011","Dudley 023D","E01009743","Total",715,696,19
"2011","Dudley 023E","E01009745","Total",749,727,22
"2011","Dudley 024A","E01009917","Total",504,498,6
"2011","Dudley 024B","E01009918","Total",611,600,11
"2011","Dudley 024C","E01009919","Total",509,502,7
"2011","Dudley 024D","E01009920","Total",636,621,15
"2011","Dudley 025A","E01009864","Total",617,600,17
"2011","Dudley 025B","E01009865","Total",660,644,16
"2011","Dudley 025C","E01009866","Total",773,732,41
"2011","Dudley 025D","E01009867","Total",712,694,18
"2011","Dudley 025E","E01009878","Total",790,764,26
"2011","Dudley 026A","E01009791","Total",676,662,14
"2011","Dudley 026B","E01009792","Total",655,632,23
"2011","Dudley 026C","E01009795","Total",737,705,32
"2011","Dudley 026D","E01009796","Total",625,604,21
"2011","Dudley 026E","E01009798","Total",744,716,28
"2011","Dudley 027A","E01009719","Total",568,558,10
"2011","Dudley 027B","E01009722","Total",626,618,8
"2011","Dudley 027C","E01009727","Total",511,503,8
"2011","Dudley 027D","E01009728","Total",506,501,5
"2011","Dudley 027E","E01009729","Total",633,620,13
"2011","Dudley 028A","E01009720","Total",532,528,4
"2011","Dudley 028B","E01009723","Total",473,466,7
"2011","Dudley 028C","E01009724","Total",628,623,5
"2011","Dudley 028D","E01009730","Total",617,606,11
"2011","Dudley 029A","E01009903","Total",637,621,16
"2011","Dudley 029B","E01009904","Total",643,625,18
"2011","Dudley 029C","E01009909","Total",643,630,13
"2011","Dudley 029D","E01009910","Total",730,711,19
"2011","Dudley 030A","E01009793","Total",544,527,17
"2011","Dudley 030B","E01009794","Total",649,629,20
"2011","Dudley 030C","E01009797","Total",668,645,23
"2011","Dudley 030D","E01009801","Total",680,667,13
"2011","Dudley 031A","E01009721","Total",919,866,53
"2011","Dudley 031B","E01009725","Total",613,595,18
"2011","Dudley 031C","E01009726","Total",546,535,11
"2011","Dudley 031D","E01009834","Total",720,694,26
"2011","Dudley 032A","E01009833","Total",538,498,40
"2011","Dudley 032B","E01009835","Total",517,498,19
"2011","Dudley 032C","E01009869","Total",693,675,18
"2011","Dudley 032D","E01009870","Total",684,668,16
"2011","Dudley 033A","E01009809","Total",695,669,26
"2011","Dudley 033B","E01009813","Total",660,638,22
"2011","Dudley 033C","E01009861","Total",675,646,29
"2011","Dudley 033D","E01009862","Total",755,724,31
"2011","Dudley 033E","E01009863","Total",748,702,46
"2011","Dudley 033F","E01009868","Total",694,671,23
"2011","Dudley 034A","E01009734","Total",710,686,24
"2011","Dudley 034B","E01009735","Total",651,631,20
"2011","Dudley 034C","E01009736","Total",629,602,27
"2011","Dudley 034D","E01009737","Total",683,664,19
"2011","Dudley 034E","E01009738","Total",619,607,12
"2011","Dudley 035A","E01009856","Total",945,901,44
"2011","Dudley 035B","E01009905","Total",678,647,31
"2011","Dudley 035C","E01009906","Total",892,860,32
"2011","Dudley 035D","E01009907","Total",692,637,55
"2011","Dudley 035E","E01009908","Total",697,679,18
"2011","Dudley 036A","E01009800","Total",651,635,16
"2011","Dudley 036B","E01009802","Total",682,668,14
"2011","Dudley 036C","E01009803","Total",666,653,13
"2011","Dudley 036D","E01009804","Total",554,534,20
"2011","Dudley 037A","E01009831","Total",654,638,16
"2011","Dudley 037B","E01009836","Total",935,859,76
"2011","Dudley 037C","E01009837","Total",654,618,36
"2011","Dudley 037D","E01009838","Total",672,658,14
"2011","Dudley 038A","E01009847","Total",618,607,11
"2011","Dudley 038B","E01009848","Total",641,622,19
"2011","Dudley 038C","E01009849","Total",674,653,21
"2011","Dudley 038D","E01009851","Total",633,625,8
"2011","Dudley 039A","E01009732","Total",746,719,27
"2011","Dudley 039B","E01009733","Total",959,929,30
"2011","Dudley 039C","E01009739","Total",661,640,21
"2011","Dudley 039D","E01009799","Total",675,658,17
"2011","Dudley 039E","E01009805","Total",630,613,17
"2011","Dudley 039F","E01009806","Total",688,672,16
"2011","Dudley 040A","E01009854","Total",655,632,23
"2011","Dudley 040B","E01009857","Total",729,694,35
"2011","Dudley 040C","E01009858","Total",617,593,24
"2011","Dudley 040D","E01009859","Total",660,643,17
"2011","Dudley 041A","E01009845","Total",643,628,15
"2011","Dudley 041B","E01009846","Total",635,617,18
"2011","Dudley 041C","E01009850","Total",686,664,22
"2011","Dudley 041D","E01009852","Total",613,601,12
"2011","Dudley 042A","E01009832","Total",671,659,12
"2011","Dudley 042B","E01009853","Total",646,628,18
"2011","Dudley 042C","E01009855","Total",656,637,19
"2011","Dudley 042D","E01009860","Total",658,646,12
"2011","Dudley 043A","E01009807","Total",772,755,17
"2011","Dudley 043B","E01009808","Total",609,602,7
"2011","Dudley 043C","E01009810","Total",781,764,17
"2011","Dudley 043D","E01009811","Total",676,663,13
"2011","Dudley 043E","E01009812","Total",587,577,10
"2011","Sandwell 001A","E01010085","Total",633,606,27
"2011","Sandwell 001B","E01010086","Total",709,690,19
"2011","Sandwell 001C","E01010087","Total",626,615,11
"2011","Sandwell 001D","E01010088","Total",583,557,26
"2011","Sandwell 001E","E01010089","Total",706,697,9
"2011","Sandwell 002A","E01009969","Total",808,774,34
"2011","Sandwell 002B","E01009970","Total",655,629,26
"2011","Sandwell 002C","E01009971","Total",696,670,26
"2011","Sandwell 002D","E01009973","Total",793,761,32
"2011","Sandwell 003A","E01009960","Total",667,649,18
"2011","Sandwell 003B","E01009961","Total",553,534,19
"2011","Sandwell 003C","E01009966","Total",480,467,13
"2011","Sandwell 003D","E01009967","Total",794,770,24
"2011","Sandwell 003E","E01010092","Total",814,781,33
"2011","Sandwell 004A","E01009962","Total",515,499,16
"2011","Sandwell 004B","E01009963","Total",521,497,24
"2011","Sandwell 004C","E01009964","Total",574,564,10
"2011","Sandwell 004D","E01009965","Total",482,471,11
"2011","Sandwell 005A","E01010090","Total",768,708,60
"2011","Sandwell 005B","E01010091","Total",675,634,41
"2011","Sandwell 005C","E01010096","Total",772,714,58
"2011","Sandwell 005D","E01010097","Total",779,731,48
"2011","Sandwell 006A","E01009968","Total",679,646,33
"2011","Sandwell 006B","E01009972","Total",767,723,44
"2011","Sandwell 006C","E01009974","Total",667,608,59
"2011","Sandwell 006D","E01009975","Total",691,658,33
"2011","Sandwell 007A","E01010030","Total",715,654,61
"2011","Sandwell 007B","E01010034","Total",525,507,18
"2011","Sandwell 007C","E01010035","Total",610,589,21
"2011","Sandwell 007D","E01010036","Total",653,615,38
"2011","Sandwell 009A","E01009982","Total",551,528,23
"2011","Sandwell 009B","E01009983","Total",605,570,35
"2011","Sandwell 009C","E01010029","Total",579,536,43
"2011","Sandwell 009D","E01010037","Total",418,407,11
"2011","Sandwell 010A","E01009991","Total",843,797,46
"2011","Sandwell 010B","E01009994","Total",664,620,44
"2011","Sandwell 010C","E01009995","Total",636,612,24
"2011","Sandwell 010D","E01009996","Total",672,654,18
"2011","Sandwell 010E","E01009997","Total",657,627,30
"2011","Sandwell 010F","E01009998","Total",816,772,44
"2011","Sandwell 011A","E01010008","Total",647,627,20
"2011","Sandwell 011B","E01010010","Total",616,598,18
"2011","Sandwell 011C","E01010011","Total",739,688,51
"2011","Sandwell 011D","E01010012","Total",603,564,39
"2011","Sandwell 012A","E01010007","Total",526,507,19
"2011","Sandwell 012B","E01010009","Total",562,541,21
"2011","Sandwell 012C","E01010013","Total",535,513,22
"2011","Sandwell 012D","E01010014","Total",738,713,25
"2011","Sandwell 013A","E01010093","Total",492,477,15
"2011","Sandwell 013B","E01010094","Total",514,485,29
"2011","Sandwell 013C","E01010095","Total",506,488,18
"2011","Sandwell 013D","E01010098","Total",754,748,6
"2011","Sandwell 013E","E01010099","Total",679,655,24
"2011","Sandwell 013F","E01010100","Total",693,666,27
"2011","Sandwell 014A","E01009978","Total",662,625,37
"2011","Sandwell 014B","E01010031","Total",729,720,9
"2011","Sandwell 014C","E01010032","Total",487,467,20
"2011","Sandwell 014D","E01010033","Total",787,767,20
"2011","Sandwell 014E","E01010074","Total",1052,953,99
"2011","Sandwell 015A","E01010066","Total",675,651,24
"2011","Sandwell 015B","E01010067","Total",694,641,53
"2011","Sandwell 015C","E01010068","Total",657,620,37
"2011","Sandwell 015D","E01010070","Total",775,719,56
"2011","Sandwell 015E","E01010075","Total",465,446,19
"2011","Sandwell 015F","E01010076","Total",638,578,60
"2011","Sandwell 016A","E01009976","Total",1029,980,49
"2011","Sandwell 016B","E01009977","Total",782,711,71
"2011","Sandwell 016C","E01009979","Total",817,797,20
"2011","Sandwell 016D","E01009980","Total",861,825,36
"2011","Sandwell 016E","E01010069","Total",646,627,19
"2011","Sandwell 016F","E01010071","Total",690,682,8
"2011","Sandwell 017A","E01009947","Total",818,788,30
"2011","Sandwell 017B","E01009992","Total",633,615,18
"2011","Sandwell 017C","E01009993","Total",735,715,20
"2011","Sandwell 017D","E01010103","Total",792,782,10
"2011","Sandwell 017E","E01010104","Total",842,827,15
"2011","Sandwell 017F","E01010105","Total",543,517,26
"2011","Sandwell 018A","E01009981","Total",746,716,30
"2011","Sandwell 018C","E01009985","Total",689,674,15
"2011","Sandwell 018E","E01032887","Total",1031,979,52
"2011","Sandwell 019A","E01009986","Total",481,453,28
"2011","Sandwell 019B","E01009987","Total",581,471,110
"2011","Sandwell 019C","E01009989","Total",666,642,24
"2011","Sandwell 019D","E01010106","Total",515,486,29
"2011","Sandwell 020A","E01009988","Total",754,734,20
"2011","Sandwell 020B","E01010101","Total",888,872,16
"2011","Sandwell 020C","E01010102","Total",710,683,27
"2011","Sandwell 020D","E01010107","Total",712,663,49
"2011","Sandwell 021A","E01010015","Total",664,619,45
"2011","Sandwell 021B","E01010016","Total",611,578,33
"2011","Sandwell 021C","E01010018","Total",927,862,65
"2011","Sandwell 021D","E01010072","Total",970,931,39
"2011","Sandwell 021E","E01010073","Total",618,593,25
"2011","Sandwell 022A","E01010077","Total",689,651,38
"2011","Sandwell 022B","E01010079","Total",630,612,18
"2011","Sandwell 022C","E01010080","Total",723,695,28
"2011","Sandwell 022D","E01010081","Total",651,626,25
"2011","Sandwell 022E","E01010082","Total",893,852,41
"2011","Sandwell 022F","E01010083","Total",700,674,26
"2011","Sandwell 022G","E01010084","Total",566,546,20
"2011","Sandwell 023A","E01010046","Total",614,581,33
"2011","Sandwell 023B","E01010047","Total",612,564,48
"2011","Sandwell 023C","E01010048","Total",527,514,13
"2011","Sandwell 023D","E01010049","Total",599,568,31
"2011","Sandwell 023E","E01010050","Total",518,496,22
"2011","Sandwell 023F","E01010052","Total",493,475,18
"2011","Sandwell 023G","E01010053","Total",588,576,12
"2011","Sandwell 024A","E01010017","Total",888,841,47
"2011","Sandwell 024B","E01010019","Total",674,621,53
"2011","Sandwell 024C","E01010020","Total",703,668,35
"2011","Sandwell 024D","E01010021","Total",673,654,19
"2011","Sandwell 025A","E01010039","Total",545,499,46
"2011","Sandwell 025B","E01010043","Total",604,592,12
"2011","Sandwell 025C","E01010044","Total",606,582,24
"2011","Sandwell 025D","E01010078","Total",536,517,19
"2011","Sandwell 026A","E01010059","Total",647,612,35
"2011","Sandwell 026B","E01010061","Total",548,523,25
"2011","Sandwell 026C","E01010062","Total",674,659,15
"2011","Sandwell 026D","E01010063","Total",791,775,16
"2011","Sandwell 026E","E01010064","Total",708,683,25
"2011","Sandwell 026F","E01010065","Total",895,845,50
"2011","Sandwell 027A","E01009934","Total",607,590,17
"2011","Sandwell 027B","E01009935","Total",903,885,18
"2011","Sandwell 027C","E01009936","Total",681,669,12
"2011","Sandwell 027D","E01010004","Total",821,773,48
"2011","Sandwell 028A","E01010054","Total",881,868,13
"2011","Sandwell 028B","E01010055","Total",673,643,30
"2011","Sandwell 028C","E01010056","Total",645,629,16
"2011","Sandwell 028D","E01010057","Total",680,658,22
"2011","Sandwell 028E","E01010060","Total",705,689,16
"2011","Sandwell 029A","E01010038","Total",707,669,38
"2011","Sandwell 029B","E01010040","Total",600,572,28
"2011","Sandwell 029C","E01010041","Total",778,744,34
"2011","Sandwell 029D","E01010045","Total",653,625,28
"2011","Sandwell 030A","E01010000","Total",698,674,24
"2011","Sandwell 030B","E01010002","Total",830,817,13
"2011","Sandwell 030C","E01010003","Total",731,712,19
"2011","Sandwell 030D","E01010005","Total",595,572,23
"2011","Sandwell 030E","E01010006","Total",684,640,44
"2011","Sandwell 031A","E01009938","Total",688,668,20
"2011","Sandwell 031B","E01009943","Total",499,478,21
"2011","Sandwell 031C","E01009944","Total",607,575,32
"2011","Sandwell 031D","E01010051","Total",491,465,26
"2011","Sandwell 031E","E01010058","Total",698,681,17
"2011","Sandwell 032A","E01009937","Total",620,599,21
"2011","Sandwell 032B","E01009939","Total",695,669,26
"2011","Sandwell 032C","E01009940","Total",625,618,7
"2011","Sandwell 032D","E01009941","Total",631,596,35
"2011","Sandwell 032E","E01009942","Total",671,627,44
"2011","Sandwell 033A","E01009929","Total",745,723,22
"2011","Sandwell 033B","E01009930","Total",669,634,35
"2011","Sandwell 033C","E01009931","Total",941,900,41
"2011","Sandwell 033D","E01009932","Total",832,809,23
"2011","Sandwell 033E","E01009999","Total",564,527,37
"2011","Sandwell 034A","E01009921","Total",775,715,60
"2011","Sandwell 034B","E01009922","Total",517,503,14
"2011","Sandwell 034C","E01009924","Total",659,616,43
"2011","Sandwell 034D","E01009925","Total",604,560,44
"2011","Sandwell 034E","E01009926","Total",635,615,20
"2011","Sandwell 034F","E01009927","Total",744,714,30
"2011","Sandwell 034G","E01009928","Total",792,756,36
"2011","Sandwell 035A","E01009933","Total",563,541,22
"2011","Sandwell 035B","E01009952","Total",905,885,20
"2011","Sandwell 035C","E01009955","Total",839,812,27
"2011","Sandwell 035D","E01009956","Total",728,678,50
"2011","Sandwell 035E","E01009959","Total",619,591,28
"2011","Sandwell 035F","E01010042","Total",829,775,54
"2011","Sandwell 036A","E01009923","Total",602,574,28
"2011","Sandwell 036B","E01010024","Total",642,618,24
"2011","Sandwell 036C","E01010026","Total",737,704,33
"2011","Sandwell 036D","E01010027","Total",621,587,34
"2011","Sandwell 037A","E01010001","Total",724,705,19
"2011","Sandwell 037B","E01010022","Total",642,620,22
"2011","Sandwell 037C","E01010023","Total",798,767,31
"2011","Sandwell 037D","E01010025","Total",744,677,67
"2011","Sandwell 037E","E01010028","Total",643,606,37
"2011","Sandwell 038A","E01009953","Total",878,790,88
"2011","Sandwell 038B","E01009954","Total",769,718,51
"2011","Sandwell 038C","E01009957","Total",677,634,43
"2011","Sandwell 038D","E01009958","Total",663,641,22
"2011","Sandwell 039A","E01009946","Total",685,657,28
"2011","Sandwell 039B","E01009948","Total",614,585,29
"2011","Sandwell 039C","E01009949","Total",598,578,20
"2011","Sandwell 039D","E01009950","Total",678,639,39
"2011","Sandwell 039E","E01009951","Total",1054,1004,50
"2011","Sandwell 039F","E01032592","Total",748,714,34
"2011","Solihull 001A","E01010118","Total",514,508,6
"2011","Solihull 001B","E01010120","Total",660,656,4
"2011","Solihull 001C","E01010121","Total",625,605,20
"2011","Solihull 001D","E01010122","Total",615,600,15
"2011","Solihull 002A","E01010235","Total",575,564,11
"2011","Solihull 002B","E01010236","Total",683,665,18
"2011","Solihull 002C","E01010239","Total",640,630,10
"2011","Solihull 002D","E01010240","Total",587,582,5
"2011","Solihull 003A","E01010117","Total",545,533,12
"2011","Solihull 003B","E01010119","Total",620,604,16
"2011","Solihull 003C","E01010123","Total",604,583,21
"2011","Solihull 003D","E01010124","Total",635,619,16
"2011","Solihull 004A","E01010146","Total",666,649,17
"2011","Solihull 004B","E01010234","Total",559,539,20
"2011","Solihull 004C","E01010237","Total",777,760,17
"2011","Solihull 004D","E01010238","Total",680,666,14
"2011","Solihull 005A","E01010145","Total",672,648,24
"2011","Solihull 005B","E01010147","Total",656,641,15
"2011","Solihull 005C","E01010148","Total",742,732,10
"2011","Solihull 005D","E01010149","Total",582,572,10
"2011","Solihull 006A","E01010125","Total",718,711,7
"2011","Solihull 006B","E01010129","Total",697,695,2
"2011","Solihull 006C","E01010139","Total",409,400,9
"2011","Solihull 006D","E01010141","Total",665,656,9
"2011","Solihull 007A","E01010140","Total",657,645,12
"2011","Solihull 007B","E01010142","Total",655,641,14
"2011","Solihull 007C","E01010143","Total",668,658,10
"2011","Solihull 007D","E01010144","Total",749,740,9
"2011","Solihull 008A","E01010111","Total",677,668,9
"2011","Solihull 008B","E01010126","Total",665,661,4
"2011","Solihull 008C","E01010127","Total",765,749,16
"2011","Solihull 008D","E01010128","Total",595,586,9
"2011","Solihull 008E","E01010130","Total",831,820,11
"2011","Solihull 008F","E01010131","Total",638,632,6
"2011","Solihull 009A","E01010109","Total",565,550,15
"2011","Solihull 009B","E01010110","Total",582,574,8
"2011","Solihull 009C","E01010112","Total",683,675,8
"2011","Solihull 009D","E01010113","Total",563,555,8
"2011","Solihull 009E","E01010114","Total",747,730,17
"2011","Solihull 010A","E01010157","Total",616,597,19
"2011","Solihull 010B","E01010159","Total",551,531,20
"2011","Solihull 010C","E01010162","Total",641,623,18
"2011","Solihull 010D","E01010163","Total",560,551,9
"2011","Solihull 011A","E01010132","Total",642,623,19
"2011","Solihull 011B","E01010133","Total",718,696,22
"2011","Solihull 011C","E01010134","Total",599,585,14
"2011","Solihull 011D","E01010135","Total",672,655,17
"2011","Solihull 011E","E01010138","Total",615,601,14
"2011","Solihull 012A","E01010136","Total",535,522,13
"2011","Solihull 012B","E01010137","Total",660,647,13
"2011","Solihull 012C","E01010158","Total",660,637,23
"2011","Solihull 012D","E01010160","Total",641,636,5
"2011","Solihull 012E","E01010161","Total",634,616,18
"2011","Solihull 013A","E01010174","Total",680,655,25
"2011","Solihull 013B","E01010175","Total",743,710,33
"2011","Solihull 013C","E01010177","Total",586,577,9
"2011","Solihull 013D","E01010178","Total",929,894,35
"2011","Solihull 014A","E01010172","Total",600,585,15
"2011","Solihull 014B","E01010173","Total",559,549,10
"2011","Solihull 014C","E01010176","Total",492,473,19
"2011","Solihull 014D","E01010179","Total",830,773,57
"2011","Solihull 015A","E01010115","Total",677,667,10
"2011","Solihull 015B","E01010116","Total",526,522,4
"2011","Solihull 015C","E01010227","Total",825,799,26
"2011","Solihull 015D","E01010228","Total",679,671,8
"2011","Solihull 015E","E01010232","Total",973,954,19
"2011","Solihull 016A","E01010195","Total",595,585,10
"2011","Solihull 016B","E01010226","Total",909,844,65
"2011","Solihull 016C","E01010229","Total",575,553,22
"2011","Solihull 016D","E01010230","Total",787,759,28
"2011","Solihull 016E","E01010231","Total",680,661,19
"2011","Solihull 016F","E01010233","Total",783,763,20
"2011","Solihull 017A","E01010108","Total",886,857,29
"2011","Solihull 017B","E01010164","Total",686,654,32
"2011","Solihull 017C","E01010165","Total",744,712,32
"2011","Solihull 017D","E01010167","Total",663,637,26
"2011","Solihull 018A","E01010199","Total",709,701,8
"2011","Solihull 018B","E01010200","Total",682,663,19
"2011","Solihull 018C","E01010201","Total",628,616,12
"2011","Solihull 018D","E01010204","Total",675,653,22
"2011","Solihull 018E","E01010205","Total",556,543,13
"2011","Solihull 018F","E01010206","Total",648,632,16
"2011","Solihull 019A","E01010192","Total",744,683,61
"2011","Solihull 019B","E01010196","Total",636,624,12
"2011","Solihull 019C","E01010197","Total",653,638,15
"2011","Solihull 019D","E01010198","Total",794,742,52
"2011","Solihull 021A","E01010218","Total",648,634,14
"2011","Solihull 021B","E01010219","Total",721,698,23
"2011","Solihull 021C","E01010221","Total",723,695,28
"2011","Solihull 021D","E01010222","Total",629,618,11
"2011","Solihull 022A","E01010191","Total",797,771,26
"2011","Solihull 022B","E01010202","Total",626,612,14
"2011","Solihull 022C","E01010203","Total",765,747,18
"2011","Solihull 022D","E01010209","Total",708,696,12
"2011","Solihull 022E","E01010213","Total",668,648,20
"2011","Solihull 023A","E01010208","Total",652,643,9
"2011","Solihull 023B","E01010210","Total",653,639,14
"2011","Solihull 023C","E01010211","Total",666,663,3
"2011","Solihull 023D","E01010217","Total",643,630,13
"2011","Solihull 024A","E01010190","Total",683,669,14
"2011","Solihull 024B","E01010193","Total",480,477,3
"2011","Solihull 024C","E01010194","Total",664,653,11
"2011","Solihull 024D","E01010207","Total",611,600,11
"2011","Solihull 025A","E01010166","Total",574,550,24
"2011","Solihull 025B","E01010168","Total",815,793,22
"2011","Solihull 025C","E01010169","Total",686,669,17
"2011","Solihull 025D","E01010170","Total",564,554,10
"2011","Solihull 025E","E01010171","Total",542,535,7
"2011","Solihull 026A","E01010151","Total",825,802,23
"2011","Solihull 026B","E01010152","Total",509,502,7
"2011","Solihull 026C","E01010153","Total",631,618,13
"2011","Solihull 026D","E01010154","Total",698,677,21
"2011","Solihull 026E","E01010155","Total",677,659,18
"2011","Solihull 026F","E01010156","Total",640,630,10
"2011","Solihull 027A","E01010212","Total",495,486,9
"2011","Solihull 027B","E01010214","Total",514,505,9
"2011","Solihull 027C","E01010215","Total",682,675,7
"2011","Solihull 027D","E01010216","Total",616,603,13
"2011","Solihull 028A","E01010150","Total",657,647,10
"2011","Solihull 028B","E01010184","Total",629,615,14
"2011","Solihull 028C","E01010185","Total",621,611,10
"2011","Solihull 028D","E01010186","Total",825,799,26
"2011","Solihull 028E","E01010187","Total",516,510,6
"2011","Solihull 028F","E01010188","Total",706,685,21
"2011","Solihull 029A","E01010180","Total",523,520,3
"2011","Solihull 029B","E01010181","Total",771,749,22
"2011","Solihull 029D","E01010183","Total",535,531,4
"2011","Solihull 029E","E01010189","Total",644,634,10
"2011","Solihull 029F","E01032885","Total",740,665,75
"2011","Solihull 029G","E01032886","Total",789,775,14
"2011","Solihull 030A","E01010220","Total",680,659,21
"2011","Solihull 030B","E01010223","Total",491,486,5
"2011","Solihull 030C","E01010225","Total",589,580,9
"2011","Solihull 030D","E01032590","Total",687,668,19
"2011","Walsall 001A","E01010301","Total",637,631,6
"2011","Walsall 001B","E01010303","Total",615,604,11
"2011","Walsall 001C","E01010306","Total",810,779,31
"2011","Walsall 001D","E01010307","Total",687,675,12
"2011","Walsall 002A","E01010302","Total",652,638,14
"2011","Walsall 002B","E01010304","Total",747,732,15
"2011","Walsall 002C","E01010305","Total",541,523,18
"2011","Walsall 002D","E01010308","Total",618,591,27
"2011","Walsall 003A","E01010345","Total",490,482,8
"2011","Walsall 003B","E01010346","Total",532,525,7
"2011","Walsall 003C","E01010347","Total",657,642,15
"2011","Walsall 003D","E01010350","Total",584,570,14
"2011","Walsall 004A","E01010249","Total",755,737,18
"2011","Walsall 004B","E01010250","Total",596,584,12
"2011","Walsall 004C","E01010252","Total",757,745,12
"2011","Walsall 004D","E01010254","Total",641,617,24
"2011","Walsall 005A","E01010348","Total",643,623,20
"2011","Walsall 005B","E01010349","Total",630,612,18
"2011","Walsall 005C","E01010351","Total",758,743,15
"2011","Walsall 005D","E01010352","Total",674,664,10
"2011","Walsall 006A","E01010284","Total",695,667,28
"2011","Walsall 006B","E01010285","Total",763,737,26
"2011","Walsall 006C","E01010286","Total",664,649,15
"2011","Walsall 006D","E01010290","Total",798,782,16
"2011","Walsall 007A","E01010251","Total",523,517,6
"2011","Walsall 007B","E01010253","Total",546,536,10
"2011","Walsall 007C","E01010255","Total",628,614,14
"2011","Walsall 007D","E01010256","Total",688,668,20
"2011","Walsall 007E","E01010257","Total",522,514,8
"2011","Walsall 008A","E01010292","Total",869,832,37
"2011","Walsall 008B","E01010294","Total",694,667,27
"2011","Walsall 008C","E01010296","Total",600,596,4
"2011","Walsall 008D","E01010297","Total",595,587,8
"2011","Walsall 009A","E01010291","Total",559,548,11
"2011","Walsall 009B","E01010293","Total",754,728,26
"2011","Walsall 009C","E01010298","Total",501,486,15
"2011","Walsall 009D","E01010299","Total",612,604,8
"2011","Walsall 009E","E01010300","Total",669,653,16
"2011","Walsall 010A","E01010319","Total",491,485,6
"2011","Walsall 010B","E01010321","Total",650,636,14
"2011","Walsall 010C","E01010353","Total",685,674,11
"2011","Walsall 010D","E01010354","Total",661,656,5
"2011","Walsall 011A","E01010395","Total",510,508,2
"2011","Walsall 011B","E01010397","Total",631,617,14
"2011","Walsall 011C","E01010398","Total",633,624,9
"2011","Walsall 011D","E01010399","Total",643,637,6
"2011","Walsall 012A","E01010282","Total",530,513,17
"2011","Walsall 012B","E01010287","Total",680,637,43
"2011","Walsall 012C","E01010288","Total",653,630,23
"2011","Walsall 012D","E01010289","Total",631,621,10
"2011","Walsall 013B","E01010277","Total",655,618,37
"2011","Walsall 013D","E01010283","Total",712,692,20
"2011","Walsall 013E","E01032889","Total",720,696,24
"2011","Walsall 014A","E01010393","Total",592,588,4
"2011","Walsall 014B","E01010394","Total",538,531,7
"2011","Walsall 014C","E01010396","Total",648,630,18
"2011","Walsall 014D","E01010400","Total",979,945,34
"2011","Walsall 015A","E01010241","Total",1085,1039,46
"2011","Walsall 015B","E01010242","Total",828,801,27
"2011","Walsall 015C","E01010243","Total",717,688,29
"2011","Walsall 015D","E01010244","Total",655,633,22
"2011","Walsall 016A","E01010320","Total",607,594,13
"2011","Walsall 016B","E01010322","Total",693,676,17
"2011","Walsall 016C","E01010323","Total",626,623,3
"2011","Walsall 016D","E01010324","Total",682,659,23
"2011","Walsall 017A","E01010271","Total",713,687,26
"2011","Walsall 017B","E01010272","Total",752,727,25
"2011","Walsall 017C","E01010273","Total",641,627,14
"2011","Walsall 017D","E01010295","Total",628,615,13
"2011","Walsall 018B","E01010279","Total",717,708,9
"2011","Walsall 018D","E01010374","Total",655,631,24
"2011","Walsall 018E","E01010375","Total",765,735,30
"2011","Walsall 018F","E01032888","Total",1025,1013,12
"2011","Walsall 019A","E01010378","Total",485,476,9
"2011","Walsall 019B","E01010379","Total",573,559,14
"2011","Walsall 019C","E01010382","Total",672,658,14
"2011","Walsall 019D","E01010383","Total",731,693,38
"2011","Walsall 020A","E01010376","Total",494,488,6
"2011","Walsall 020B","E01010377","Total",634,619,15
"2011","Walsall 020C","E01010380","Total",701,683,18
"2011","Walsall 020D","E01010381","Total",688,661,27
"2011","Walsall 021A","E01010267","Total",724,715,9
"2011","Walsall 021B","E01010268","Total",600,579,21
"2011","Walsall 021C","E01010274","Total",624,605,19
"2011","Walsall 021D","E01010275","Total",653,641,12
"2011","Walsall 022A","E01010245","Total",667,649,18
"2011","Walsall 022B","E01010246","Total",630,623,7
"2011","Walsall 022C","E01010247","Total",714,701,13
"2011","Walsall 022D","E01010248","Total",661,649,12
"2011","Walsall 022E","E01010388","Total",567,560,7
"2011","Walsall 023A","E01010258","Total",741,727,14
"2011","Walsall 023B","E01010259","Total",655,647,8
"2011","Walsall 023C","E01010260","Total",693,674,19
"2011","Walsall 023D","E01010266","Total",519,511,8
"2011","Walsall 024A","E01010317","Total",704,674,30
"2011","Walsall 024B","E01010318","Total",800,770,30
"2011","Walsall 024C","E01010325","Total",726,695,31
"2011","Walsall 024D","E01010369","Total",932,902,30
"2011","Walsall 025A","E01010401","Total",649,620,29
"2011","Walsall 025B","E01010403","Total",691,683,8
"2011","Walsall 025C","E01010404","Total",772,728,44
"2011","Walsall 025D","E01010407","Total",643,628,15
"2011","Walsall 025E","E01010408","Total",692,649,43
"2011","Walsall 026A","E01010269","Total",589,530,59
"2011","Walsall 026B","E01010270","Total",693,674,19
"2011","Walsall 026C","E01010362","Total",641,623,18
"2011","Walsall 026D","E01010363","Total",817,758,59
"2011","Walsall 027A","E01010402","Total",673,668,5
"2011","Walsall 027B","E01010405","Total",712,703,9
"2011","Walsall 027C","E01010406","Total",1139,1090,49
"2011","Walsall 027D","E01010409","Total",638,632,6
"2011","Walsall 028A","E01010385","Total",657,642,15
"2011","Walsall 028B","E01010386","Total",776,725,51
"2011","Walsall 028C","E01010387","Total",643,629,14
"2011","Walsall 028D","E01010392","Total",667,656,11
"2011","Walsall 029A","E01010326","Total",604,583,21
"2011","Walsall 029B","E01010327","Total",596,561,35
"2011","Walsall 029C","E01010328","Total",546,534,12
"2011","Walsall 029D","E01010330","Total",668,635,33
"2011","Walsall 030A","E01010368","Total",1059,1023,36
"2011","Walsall 030B","E01010370","Total",887,846,41
"2011","Walsall 030C","E01010371","Total",975,886,89
"2011","Walsall 030D","E01010372","Total",655,623,32
"2011","Walsall 030E","E01010373","Total",540,527,13
"2011","Walsall 031A","E01010361","Total",597,556,41
"2011","Walsall 031B","E01010364","Total",527,505,22
"2011","Walsall 031C","E01010365","Total",632,589,43
"2011","Walsall 031D","E01010366","Total",682,664,18
"2011","Walsall 031E","E01010367","Total",664,622,42
"2011","Walsall 032A","E01010384","Total",587,576,11
"2011","Walsall 032B","E01010389","Total",610,591,19
"2011","Walsall 032C","E01010390","Total",726,707,19
"2011","Walsall 032D","E01010391","Total",798,792,6
"2011","Walsall 033A","E01010261","Total",671,658,13
"2011","Walsall 033B","E01010263","Total",525,507,18
"2011","Walsall 033C","E01010264","Total",650,637,13
"2011","Walsall 033D","E01010265","Total",667,641,26
"2011","Walsall 034A","E01010336","Total",548,532,16
"2011","Walsall 034B","E01010340","Total",596,563,33
"2011","Walsall 034C","E01010341","Total",506,481,25
"2011","Walsall 034D","E01010342","Total",540,508,32
"2011","Walsall 034E","E01010343","Total",503,467,36
"2011","Walsall 034F","E01010344","Total",614,599,15
"2011","Walsall 035A","E01010331","Total",644,631,13
"2011","Walsall 035B","E01010332","Total",678,653,25
"2011","Walsall 035C","E01010333","Total",658,646,12
"2011","Walsall 035D","E01010334","Total",585,568,17
"2011","Walsall 036A","E01010262","Total",661,652,9
"2011","Walsall 036B","E01010309","Total",747,739,8
"2011","Walsall 036C","E01010311","Total",756,715,41
"2011","Walsall 036D","E01010316","Total",641,635,6
"2011","Walsall 037A","E01010335","Total",655,643,12
"2011","Walsall 037B","E01010337","Total",564,547,17
"2011","Walsall 037C","E01010338","Total",558,545,13
"2011","Walsall 037D","E01010339","Total",541,522,19
"2011","Walsall 038A","E01010310","Total",616,608,8
"2011","Walsall 038B","E01010312","Total",719,709,10
"2011","Walsall 038C","E01010313","Total",551,548,3
"2011","Walsall 038D","E01010314","Total",650,641,9
"2011","Walsall 038E","E01010315","Total",581,575,6
"2011","Walsall 039A","E01010329","Total",668,651,17
"2011","Walsall 039B","E01010355","Total",619,612,7
"2011","Walsall 039C","E01010356","Total",637,621,16
"2011","Walsall 039D","E01010357","Total",787,770,17
"2011","Walsall 039E","E01010358","Total",638,624,14
"2011","Walsall 039F","E01010359","Total",661,647,14
"2011","Walsall 039G","E01010360","Total",635,614,21
"2011","Wolverhampton 001A","E01010434","Total",763,733,30
"2011","Wolverhampton 001B","E01010436","Total",616,611,5
"2011","Wolverhampton 001C","E01010437","Total",495,487,8
"2011","Wolverhampton 001D","E01010438","Total",649,632,17
"2011","Wolverhampton 001E","E01010439","Total",549,538,11
"2011","Wolverhampton 001F","E01010440","Total",725,710,15
"2011","Wolverhampton 001G","E01010441","Total",570,557,13
"2011","Wolverhampton 002A","E01010495","Total",822,790,32
"2011","Wolverhampton 002B","E01010497","Total",477,468,9
"2011","Wolverhampton 002C","E01010499","Total",550,519,31
"2011","Wolverhampton 002D","E01010500","Total",503,482,21
"2011","Wolverhampton 003A","E01010496","Total",658,646,12
"2011","Wolverhampton 003B","E01010498","Total",667,648,19
"2011","Wolverhampton 003C","E01010541","Total",682,650,32
"2011","Wolverhampton 003D","E01010543","Total",617,604,13
"2011","Wolverhampton 004A","E01010456","Total",512,499,13
"2011","Wolverhampton 004B","E01010457","Total",664,660,4
"2011","Wolverhampton 004C","E01010462","Total",650,639,11
"2011","Wolverhampton 004D","E01010481","Total",552,539,13
"2011","Wolverhampton 005A","E01010555","Total",735,725,10
"2011","Wolverhampton 005B","E01010556","Total",616,607,9
"2011","Wolverhampton 005C","E01010557","Total",616,607,9
"2011","Wolverhampton 005D","E01010559","Total",683,670,13
"2011","Wolverhampton 005E","E01010560","Total",779,775,4
"2011","Wolverhampton 006A","E01010435","Total",568,548,20
"2011","Wolverhampton 006B","E01010501","Total",621,604,17
"2011","Wolverhampton 006C","E01010502","Total",528,512,16
"2011","Wolverhampton 006D","E01010503","Total",635,606,29
"2011","Wolverhampton 007A","E01010482","Total",506,503,3
"2011","Wolverhampton 007B","E01010483","Total",502,496,6
"2011","Wolverhampton 007C","E01010484","Total",512,506,6
"2011","Wolverhampton 007D","E01010485","Total",668,624,44
"2011","Wolverhampton 008A","E01010458","Total",794,785,9
"2011","Wolverhampton 008B","E01010459","Total",635,624,11
"2011","Wolverhampton 008C","E01010460","Total",647,641,6
"2011","Wolverhampton 008D","E01010461","Total",629,616,13
"2011","Wolverhampton 008E","E01010566","Total",761,743,18
"2011","Wolverhampton 009A","E01010539","Total",682,657,25
"2011","Wolverhampton 009B","E01010540","Total",655,618,37
"2011","Wolverhampton 009C","E01010542","Total",654,627,27
"2011","Wolverhampton 009D","E01010544","Total",627,609,18
"2011","Wolverhampton 009E","E01010545","Total",678,659,19
"2011","Wolverhampton 010A","E01010554","Total",633,630,3
"2011","Wolverhampton 010B","E01010558","Total",713,702,11
"2011","Wolverhampton 010C","E01010562","Total",755,740,15
"2011","Wolverhampton 010D","E01010563","Total",720,702,18
"2011","Wolverhampton 010E","E01010567","Total",673,663,10
"2011","Wolverhampton 011A","E01010478","Total",568,518,50
"2011","Wolverhampton 011B","E01010479","Total",592,576,16
"2011","Wolverhampton 011C","E01010480","Total",508,486,22
"2011","Wolverhampton 011D","E01010486","Total",649,635,14
"2011","Wolverhampton 012A","E01010474","Total",627,613,14
"2011","Wolverhampton 012B","E01010561","Total",633,620,13
"2011","Wolverhampton 012C","E01010564","Total",831,782,49
"2011","Wolverhampton 012D","E01010565","Total",760,747,13
"2011","Wolverhampton 013A","E01010522","Total",688,661,27
"2011","Wolverhampton 013B","E01010523","Total",649,611,38
"2011","Wolverhampton 013C","E01010524","Total",672,632,40
"2011","Wolverhampton 013D","E01010525","Total",556,522,34
"2011","Wolverhampton 014A","E01010546","Total",532,526,6
"2011","Wolverhampton 014B","E01010547","Total",772,744,28
"2011","Wolverhampton 014C","E01010548","Total",762,734,28
"2011","Wolverhampton 014D","E01010549","Total",637,616,21
"2011","Wolverhampton 014E","E01010553","Total",669,655,14
"2011","Wolverhampton 015A","E01010471","Total",901,858,43
"2011","Wolverhampton 015B","E01010472","Total",845,781,64
"2011","Wolverhampton 015C","E01010473","Total",1253,1193,60
"2011","Wolverhampton 015D","E01010475","Total",683,654,29
"2011","Wolverhampton 015E","E01010476","Total",927,872,55
"2011","Wolverhampton 015F","E01010477","Total",733,701,32
"2011","Wolverhampton 016A","E01010526","Total",521,486,35
"2011","Wolverhampton 016B","E01010527","Total",809,769,40
"2011","Wolverhampton 016C","E01010528","Total",534,503,31
"2011","Wolverhampton 016D","E01010529","Total",668,603,65
"2011","Wolverhampton 017A","E01010506","Total",972,888,84
"2011","Wolverhampton 017B","E01010508","Total",770,708,62
"2011","Wolverhampton 017C","E01010510","Total",845,779,66
"2011","Wolverhampton 017D","E01010511","Total",671,604,67
"2011","Wolverhampton 017E","E01010512","Total",667,632,35
"2011","Wolverhampton 018A","E01010442","Total",552,512,40
"2011","Wolverhampton 018B","E01010443","Total",667,659,8
"2011","Wolverhampton 018C","E01010444","Total",610,594,16
"2011","Wolverhampton 018D","E01010445","Total",514,502,12
"2011","Wolverhampton 018E","E01010447","Total",890,863,27
"2011","Wolverhampton 018F","E01010448","Total",725,709,16
"2011","Wolverhampton 019A","E01010509","Total",760,742,18
"2011","Wolverhampton 019B","E01010550","Total",664,641,23
"2011","Wolverhampton 019C","E01010551","Total",812,785,27
"2011","Wolverhampton 019D","E01010552","Total",824,809,15
"2011","Wolverhampton 020A","E01010463","Total",785,728,57
"2011","Wolverhampton 020B","E01010464","Total",866,844,22
"2011","Wolverhampton 020C","E01010465","Total",643,600,43
"2011","Wolverhampton 020D","E01010466","Total",608,558,50
"2011","Wolverhampton 020E","E01010470","Total",670,624,46
"2011","Wolverhampton 020F","E01010521","Total",1152,1068,84
"2011","Wolverhampton 021A","E01010487","Total",620,611,9
"2011","Wolverhampton 021B","E01010488","Total",646,631,15
"2011","Wolverhampton 021C","E01010493","Total",645,623,22
"2011","Wolverhampton 021D","E01010504","Total",540,517,23
"2011","Wolverhampton 021E","E01010505","Total",525,511,14
"2011","Wolverhampton 021F","E01010507","Total",657,638,19
"2011","Wolverhampton 022A","E01010418","Total",595,580,15
"2011","Wolverhampton 022B","E01010421","Total",618,605,13
"2011","Wolverhampton 022C","E01010423","Total",680,660,20
"2011","Wolverhampton 022D","E01010424","Total",626,616,10
"2011","Wolverhampton 023A","E01010417","Total",748,729,19
"2011","Wolverhampton 023B","E01010419","Total",612,576,36
"2011","Wolverhampton 023C","E01010420","Total",536,515,21
"2011","Wolverhampton 023D","E01010425","Total",540,530,10
"2011","Wolverhampton 023E","E01010446","Total",730,709,21
"2011","Wolverhampton 026A","E01010467","Total",663,628,35
"2011","Wolverhampton 026B","E01010468","Total",607,591,16
"2011","Wolverhampton 026C","E01010469","Total",618,598,20
"2011","Wolverhampton 026D","E01010516","Total",543,529,14
"2011","Wolverhampton 026E","E01010518","Total",657,629,28
"2011","Wolverhampton 027A","E01010414","Total",1010,960,50
"2011","Wolverhampton 027B","E01010415","Total",621,596,25
"2011","Wolverhampton 027C","E01010416","Total",761,702,59
"2011","Wolverhampton 027D","E01010422","Total",680,643,37
"2011","Wolverhampton 028A","E01010489","Total",667,659,8
"2011","Wolverhampton 028B","E01010490","Total",951,941,10
"2011","Wolverhampton 028C","E01010491","Total",645,627,18
"2011","Wolverhampton 028D","E01010492","Total",519,510,9
"2011","Wolverhampton 028E","E01010494","Total",621,601,20
"2011","Wolverhampton 029A","E01010449","Total",1010,921,89
"2011","Wolverhampton 029B","E01010450","Total",798,760,38
"2011","Wolverhampton 029C","E01010451","Total",617,594,23
"2011","Wolverhampton 029D","E01010452","Total",722,700,22
"2011","Wolverhampton 029E","E01010455","Total",877,846,31
"2011","Wolverhampton 030A","E01010427","Total",566,535,31
"2011","Wolverhampton 030B","E01010431","Total",485,477,8
"2011","Wolverhampton 030C","E01010432","Total",527,507,20
"2011","Wolverhampton 030D","E01010519","Total",567,539,28
"2011","Wolverhampton 030E","E01010520","Total",685,664,21
"2011","Wolverhampton 031A","E01010513","Total",661,638,23
"2011","Wolverhampton 031B","E01010514","Total",667,651,16
"2011","Wolverhampton 031C","E01010515","Total",681,669,12
"2011","Wolverhampton 031D","E01010517","Total",640,622,18
"2011","Wolverhampton 032A","E01010533","Total",754,729,25
"2011","Wolverhampton 032B","E01010535","Total",658,641,17
"2011","Wolverhampton 032C","E01010536","Total",657,639,18
"2011","Wolverhampton 032D","E01010537","Total",685,657,28
"2011","Wolverhampton 033A","E01010410","Total",821,793,28
"2011","Wolverhampton 033B","E01010411","Total",653,633,20
"2011","Wolverhampton 033C","E01010412","Total",857,826,31
"2011","Wolverhampton 033D","E01010413","Total",739,727,12
"2011","Wolverhampton 034A","E01010531","Total",755,744,11
"2011","Wolverhampton 034B","E01010532","Total",690,673,17
"2011","Wolverhampton 034C","E01010534","Total",486,475,11
"2011","Wolverhampton 034D","E01010538","Total",636,623,13
"2011","Wolverhampton 035A","E01010426","Total",551,530,21
"2011","Wolverhampton 035B","E01010428","Total",541,508,33
"2011","Wolverhampton 035C","E01010429","Total",481,453,28
"2011","Wolverhampton 035D","E01010430","Total",713,669,44
"2011","Wolverhampton 035E","E01010433","Total",448,430,18
"2011","Wolverhampton 035F","E01010453","Total",757,726,31
"2011","Wolverhampton 035G","E01010454","Total",660,623,37
"2011","Wolverhampton 035H","E01010530","Total",591,532,59
"2011","Bromsgrove 001A","E01032138","Total",561,549,12
"2011","Bromsgrove 001B","E01032139","Total",677,662,15
"2011","Bromsgrove 001C","E01032140","Total",727,705,22
"2011","Bromsgrove 001D","E01032141","Total",608,588,20
"2011","Bromsgrove 002A","E01032136","Total",545,506,39
"2011","Bromsgrove 002B","E01032137","Total",676,650,26
"2011","Bromsgrove 002C","E01032168","Total",487,477,10
"2011","Bromsgrove 002D","E01032169","Total",518,494,24
"2011","Bromsgrove 002E","E01032176","Total",950,903,47
"2011","Bromsgrove 003A","E01032126","Total",875,856,19
"2011","Bromsgrove 003B","E01032170","Total",571,556,15
"2011","Bromsgrove 003C","E01032171","Total",637,624,13
"2011","Bromsgrove 003D","E01032172","Total",671,638,33
"2011","Bromsgrove 004A","E01032133","Total",753,740,13
"2011","Bromsgrove 004B","E01032135","Total",648,638,10
"2011","Bromsgrove 004C","E01032145","Total",636,626,10
"2011","Bromsgrove 004D","E01032147","Total",572,565,7
"2011","Bromsgrove 005A","E01032134","Total",648,626,22
"2011","Bromsgrove 005B","E01032146","Total",687,670,17
"2011","Bromsgrove 005C","E01032177","Total",485,469,16
"2011","Bromsgrove 005D","E01032178","Total",557,543,14
"2011","Bromsgrove 006A","E01032142","Total",616,607,9
"2011","Bromsgrove 006B","E01032143","Total",546,534,12
"2011","Bromsgrove 006C","E01032144","Total",794,764,30
"2011","Bromsgrove 006D","E01032149","Total",498,478,20
"2011","Bromsgrove 007A","E01032127","Total",699,686,13
"2011","Bromsgrove 007B","E01032128","Total",634,616,18
"2011","Bromsgrove 007C","E01032129","Total",529,522,7
"2011","Bromsgrove 007D","E01032152","Total",617,603,14
"2011","Bromsgrove 008A","E01032148","Total",453,437,16
"2011","Bromsgrove 008B","E01032150","Total",638,621,17
"2011","Bromsgrove 008C","E01032151","Total",593,573,20
"2011","Bromsgrove 008D","E01032153","Total",620,609,11
"2011","Bromsgrove 008E","E01032155","Total",664,651,13
"2011","Bromsgrove 009A","E01032122","Total",811,771,40
"2011","Bromsgrove 009B","E01032123","Total",699,657,42
"2011","Bromsgrove 009C","E01032124","Total",691,674,17
"2011","Bromsgrove 009D","E01032125","Total",623,615,8
"2011","Bromsgrove 010A","E01032154","Total",679,663,16
"2011","Bromsgrove 010B","E01032159","Total",788,774,14
"2011","Bromsgrove 010C","E01032160","Total",786,762,24
"2011","Bromsgrove 010D","E01032161","Total",638,620,18
"2011","Bromsgrove 011A","E01032156","Total",757,722,35
"2011","Bromsgrove 011B","E01032157","Total",1098,1033,65
"2011","Bromsgrove 011C","E01032173","Total",655,648,7
"2011","Bromsgrove 011D","E01032175","Total",672,659,13
"2011","Bromsgrove 012A","E01032158","Total",663,651,12
"2011","Bromsgrove 012B","E01032162","Total",765,752,13
"2011","Bromsgrove 012D","E01033059","Total",588,582,6
"2011","Bromsgrove 012E","E01033061","Total",660,653,7
"2011","Bromsgrove 013A","E01032130","Total",1180,1148,32
"2011","Bromsgrove 013B","E01032131","Total",669,664,5
"2011","Bromsgrove 013C","E01032132","Total",982,960,22
"2011","Bromsgrove 013D","E01032174","Total",667,646,21
"2011","Bromsgrove 014C","E01032166","Total",988,955,33
"2011","Bromsgrove 014E","E01033060","Total",463,439,24
"2011","Bromsgrove 014F","E01033062","Total",920,914,6
"2011","Bromsgrove 014G","E01033243","Total",553,542,11
"2011","Malvern Hills 001A","E01032193","Total",963,912,51
"2011","Malvern Hills 001B","E01032212","Total",842,812,30
"2011","Malvern Hills 001C","E01032213","Total",707,660,47
"2011","Malvern Hills 001D","E01032214","Total",1071,1018,53
"2011","Malvern Hills 002A","E01032181","Total",985,891,94
"2011","Malvern Hills 002B","E01032190","Total",800,783,17
"2011","Malvern Hills 002C","E01032199","Total",764,737,27
"2011","Malvern Hills 002D","E01032223","Total",850,824,26
"2011","Malvern Hills 003A","E01032179","Total",724,704,20
"2011","Malvern Hills 003B","E01032180","Total",790,767,23
"2011","Malvern Hills 003C","E01032182","Total",827,801,26
"2011","Malvern Hills 003D","E01032183","Total",578,570,8
"2011","Malvern Hills 004A","E01032194","Total",689,665,24
"2011","Malvern Hills 004B","E01032195","Total",783,752,31
"2011","Malvern Hills 004C","E01032196","Total",790,750,40
"2011","Malvern Hills 004D","E01032197","Total",795,714,81
"2011","Malvern Hills 005A","E01032205","Total",490,471,19
"2011","Malvern Hills 005B","E01032206","Total",578,556,22
"2011","Malvern Hills 005C","E01032207","Total",648,622,26
"2011","Malvern Hills 005D","E01032217","Total",684,644,40
"2011","Malvern Hills 006A","E01032188","Total",820,799,21
"2011","Malvern Hills 006B","E01032189","Total",856,837,19
"2011","Malvern Hills 006C","E01032220","Total",683,668,15
"2011","Malvern Hills 006D","E01032221","Total",580,548,32
"2011","Malvern Hills 006E","E01032222","Total",616,603,13
"2011","Malvern Hills 007A","E01032201","Total",658,648,10
"2011","Malvern Hills 007B","E01032202","Total",756,739,17
"2011","Malvern Hills 007C","E01032203","Total",711,698,13
"2011","Malvern Hills 007D","E01032204","Total",669,655,14
"2011","Malvern Hills 008A","E01032191","Total",976,946,30
"2011","Malvern Hills 008B","E01032192","Total",712,688,24
"2011","Malvern Hills 008C","E01032211","Total",831,792,39
"2011","Malvern Hills 009A","E01032184","Total",822,799,23
"2011","Malvern Hills 009B","E01032185","Total",636,620,16
"2011","Malvern Hills 009C","E01032186","Total",558,526,32
"2011","Malvern Hills 009D","E01032187","Total",815,785,30
"2011","Malvern Hills 010A","E01032208","Total",844,737,107
"2011","Malvern Hills 010B","E01032209","Total",658,571,87
"2011","Malvern Hills 010C","E01032210","Total",519,498,21
"2011","Malvern Hills 010D","E01032218","Total",712,654,58
"2011","Malvern Hills 010E","E01032219","Total",812,769,43
"2011","Malvern Hills 011A","E01032198","Total",858,821,37
"2011","Malvern Hills 011B","E01032200","Total",862,833,29
"2011","Malvern Hills 011C","E01032215","Total",571,556,15
"2011","Malvern Hills 011D","E01032216","Total",824,769,55
"2011","Redditch 001A","E01032226","Total",832,814,18
"2011","Redditch 001B","E01032227","Total",476,467,9
"2011","Redditch 001C","E01032243","Total",582,579,3
"2011","Redditch 001D","E01032244","Total",546,541,5
"2011","Redditch 002A","E01032240","Total",560,554,6
"2011","Redditch 002B","E01032241","Total",508,503,5
"2011","Redditch 002C","E01032242","Total",600,590,10
"2011","Redditch 002D","E01032245","Total",672,665,7
"2011","Redditch 003A","E01032232","Total",799,781,18
"2011","Redditch 003B","E01032233","Total",1180,1171,9
"2011","Redditch 003C","E01032234","Total",747,734,13
"2011","Redditch 003D","E01032235","Total",761,755,6
"2011","Redditch 004A","E01032224","Total",714,689,25
"2011","Redditch 004B","E01032225","Total",521,503,18
"2011","Redditch 004C","E01032239","Total",730,690,40
"2011","Redditch 004D","E01032262","Total",885,860,25
"2011","Redditch 005A","E01032273","Total",577,565,12
"2011","Redditch 005B","E01032275","Total",612,606,6
"2011","Redditch 005C","E01032277","Total",524,514,10
"2011","Redditch 005D","E01032278","Total",738,726,12
"2011","Redditch 006A","E01032236","Total",838,807,31
"2011","Redditch 006B","E01032237","Total",651,635,16
"2011","Redditch 006C","E01032238","Total",525,511,14
"2011","Redditch 006D","E01032264","Total",648,641,7
"2011","Redditch 007A","E01032255","Total",566,557,9
"2011","Redditch 007B","E01032263","Total",740,725,15
"2011","Redditch 007C","E01032266","Total",688,675,13
"2011","Redditch 007D","E01032274","Total",522,518,4
"2011","Redditch 008A","E01032259","Total",654,621,33
"2011","Redditch 008B","E01032269","Total",778,758,20
"2011","Redditch 008C","E01032270","Total",532,525,7
"2011","Redditch 008D","E01032271","Total",532,522,10
"2011","Redditch 008E","E01032272","Total",542,535,7
"2011","Redditch 009A","E01032253","Total",484,476,8
"2011","Redditch 009B","E01032265","Total",651,643,8
"2011","Redditch 009C","E01032267","Total",643,637,6
"2011","Redditch 009D","E01032268","Total",484,480,4
"2011","Redditch 009E","E01032276","Total",600,595,5
"2011","Redditch 010A","E01032250","Total",519,514,5
"2011","Redditch 010B","E01032251","Total",720,702,18
"2011","Redditch 010C","E01032252","Total",596,569,27
"2011","Redditch 010D","E01032254","Total",623,606,17
"2011","Redditch 011A","E01032256","Total",650,644,6
"2011","Redditch 011B","E01032257","Total",574,573,1
"2011","Redditch 011C","E01032258","Total",729,705,24
"2011","Redditch 011D","E01032260","Total",691,675,16
"2011","Redditch 012A","E01032246","Total",561,558,3
"2011","Redditch 012B","E01032247","Total",648,637,11
"2011","Redditch 012C","E01032248","Total",546,543,3
"2011","Redditch 012D","E01032249","Total",705,686,19
"2011","Redditch 012E","E01032261","Total",596,583,13
"2011","Redditch 013A","E01032228","Total",591,566,25
"2011","Redditch 013B","E01032229","Total",646,634,12
"2011","Redditch 013C","E01032230","Total",609,596,13
"2011","Redditch 013D","E01032231","Total",793,763,30
"2011","Worcester 001A","E01032296","Total",739,724,15
"2011","Worcester 001B","E01032297","Total",690,663,27
"2011","Worcester 001C","E01032298","Total",791,777,14
"2011","Worcester 001D","E01032299","Total",694,675,19
"2011","Worcester 001E","E01032300","Total",669,655,14
"2011","Worcester 002A","E01032303","Total",488,478,10
"2011","Worcester 002B","E01032304","Total",640,627,13
"2011","Worcester 002C","E01032331","Total",669,663,6
"2011","Worcester 002D","E01032332","Total",621,611,10
"2011","Worcester 003A","E01032330","Total",611,602,9
"2011","Worcester 003B","E01032334","Total",1024,1008,16
"2011","Worcester 003C","E01032335","Total",580,575,5
"2011","Worcester 003D","E01032336","Total",654,644,10
"2011","Worcester 004A","E01032279","Total",544,532,12
"2011","Worcester 004B","E01032312","Total",696,669,27
"2011","Worcester 004C","E01032327","Total",792,767,25
"2011","Worcester 004D","E01032328","Total",640,625,15
"2011","Worcester 004E","E01032329","Total",889,871,18
"2011","Worcester 005A","E01032301","Total",637,623,14
"2011","Worcester 005B","E01032302","Total",566,544,22
"2011","Worcester 005C","E01032310","Total",616,596,20
"2011","Worcester 005D","E01032311","Total",646,626,20
"2011","Worcester 005E","E01032313","Total",515,500,15
"2011","Worcester 005F","E01032333","Total",767,760,7
"2011","Worcester 006A","E01032314","Total",457,448,9
"2011","Worcester 006B","E01032315","Total",533,512,21
"2011","Worcester 006C","E01032316","Total",507,498,9
"2011","Worcester 006D","E01032317","Total",671,648,23
"2011","Worcester 007A","E01032280","Total",859,800,59
"2011","Worcester 007B","E01032281","Total",669,632,37
"2011","Worcester 007C","E01032282","Total",959,897,62
"2011","Worcester 007E","E01033246","Total",676,625,51
"2011","Worcester 007F","E01033247","Total",676,600,76
"2011","Worcester 008A","E01032337","Total",739,729,10
"2011","Worcester 008B","E01032338","Total",821,804,17
"2011","Worcester 008C","E01032339","Total",624,618,6
"2011","Worcester 009A","E01032318","Total",638,628,10
"2011","Worcester 009B","E01032319","Total",722,703,19
"2011","Worcester 009C","E01032320","Total",673,655,18
"2011","Worcester 009D","E01032321","Total",613,601,12
"2011","Worcester 009E","E01032322","Total",997,957,40
"2011","Worcester 010A","E01032305","Total",703,688,15
"2011","Worcester 010B","E01032306","Total",619,608,11
"2011","Worcester 010C","E01032307","Total",653,642,11
"2011","Worcester 010D","E01032309","Total",660,641,19
"2011","Worcester 011A","E01032285","Total",774,739,35
"2011","Worcester 011B","E01032292","Total",645,616,29
"2011","Worcester 011D","E01032294","Total",615,580,35
"2011","Worcester 011E","E01033248","Total",709,658,51
"2011","Worcester 011F","E01033249","Total",728,669,59
"2011","Worcester 012A","E01032286","Total",662,650,12
"2011","Worcester 012B","E01032287","Total",682,664,18
"2011","Worcester 012C","E01032288","Total",664,647,17
"2011","Worcester 012D","E01032289","Total",636,625,11
"2011","Worcester 012E","E01032290","Total",677,666,11
"2011","Worcester 013A","E01032283","Total",717,694,23
"2011","Worcester 013B","E01032284","Total",850,826,24
"2011","Worcester 013C","E01032295","Total",1245,1157,88
"2011","Worcester 013D","E01032308","Total",628,620,8
"2011","Worcester 014A","E01032323","Total",624,606,18
"2011","Worcester 014B","E01032324","Total",620,613,7
"2011","Worcester 014C","E01032325","Total",676,659,17
"2011","Worcester 014D","E01032326","Total",616,604,12
"2011","Wychavon 001A","E01032354","Total",1029,987,42
"2011","Wychavon 001B","E01032386","Total",581,533,48
"2011","Wychavon 001C","E01032387","Total",631,598,33
"2011","Wychavon 001D","E01032401","Total",687,647,40
"2011","Wychavon 002A","E01032368","Total",533,505,28
"2011","Wychavon 002B","E01032369","Total",642,601,41
"2011","Wychavon 002C","E01032370","Total",509,498,11
"2011","Wychavon 002D","E01032371","Total",601,581,20
"2011","Wychavon 003A","E01032359","Total",1086,1034,52
"2011","Wychavon 003B","E01032360","Total",828,811,17
"2011","Wychavon 003C","E01032361","Total",758,742,16
"2011","Wychavon 004A","E01032357","Total",515,510,5
"2011","Wychavon 004B","E01032358","Total",658,650,8
"2011","Wychavon 004C","E01032365","Total",789,765,24
"2011","Wychavon 004D","E01032367","Total",678,636,42
"2011","Wychavon 005A","E01032362","Total",762,748,14
"2011","Wychavon 005B","E01032363","Total",614,606,8
"2011","Wychavon 005C","E01032364","Total",652,643,9
"2011","Wychavon 005D","E01032366","Total",760,733,27
"2011","Wychavon 006A","E01032399","Total",742,713,29
"2011","Wychavon 006B","E01032400","Total",918,879,39
"2011","Wychavon 006C","E01032404","Total",1127,1003,124
"2011","Wychavon 007A","E01032345","Total",647,585,62
"2011","Wychavon 007B","E01032346","Total",559,539,20
"2011","Wychavon 007C","E01032395","Total",555,502,53
"2011","Wychavon 007D","E01032417","Total",646,617,29
"2011","Wychavon 008A","E01032392","Total",700,653,47
"2011","Wychavon 008B","E01032393","Total",655,639,16
"2011","Wychavon 008C","E01032394","Total",534,487,47
"2011","Wychavon 008D","E01032416","Total",457,433,24
"2011","Wychavon 009A","E01032355","Total",519,493,26
"2011","Wychavon 009B","E01032356","Total",470,459,11
"2011","Wychavon 009C","E01032402","Total",551,538,13
"2011","Wychavon 009D","E01032403","Total",613,595,18
"2011","Wychavon 010A","E01032375","Total",540,509,31
"2011","Wychavon 010B","E01032382","Total",562,532,30
"2011","Wychavon 010C","E01032383","Total",639,594,45
"2011","Wychavon 010D","E01032410","Total",610,570,40
"2011","Wychavon 010E","E01032411","Total",700,649,51
"2011","Wychavon 011A","E01032390","Total",577,538,39
"2011","Wychavon 011B","E01032391","Total",461,444,17
"2011","Wychavon 011C","E01032414","Total",666,647,19
"2011","Wychavon 011D","E01032415","Total",528,505,23
"2011","Wychavon 012A","E01032405","Total",618,600,18
"2011","Wychavon 012B","E01032406","Total",838,781,57
"2011","Wychavon 012C","E01032407","Total",643,618,25
"2011","Wychavon 012D","E01032408","Total",622,613,9
"2011","Wychavon 012E","E01032409","Total",695,673,22
"2011","Wychavon 013A","E01032340","Total",610,585,25
"2011","Wychavon 013B","E01032341","Total",538,522,16
"2011","Wychavon 013C","E01032349","Total",666,631,35
"2011","Wychavon 013D","E01032350","Total",487,465,22
"2011","Wychavon 013E","E01032388","Total",582,555,27
"2011","Wychavon 013F","E01032389","Total",571,535,36
"2011","Wychavon 014A","E01032343","Total",1255,1139,116
"2011","Wychavon 014B","E01032377","Total",923,889,34
"2011","Wychavon 014C","E01032378","Total",796,748,48
"2011","Wychavon 015A","E01032376","Total",652,631,21
"2011","Wychavon 015B","E01032384","Total",570,546,24
"2011","Wychavon 015C","E01032385","Total",647,622,25
"2011","Wychavon 015D","E01032396","Total",643,623,20
"2011","Wychavon 016A","E01032342","Total",631,601,30
"2011","Wychavon 016B","E01032344","Total",618,606,12
"2011","Wychavon 016C","E01032379","Total",746,729,17
"2011","Wychavon 016D","E01032380","Total",702,683,19
"2011","Wychavon 017A","E01032381","Total",821,798,23
"2011","Wychavon 017B","E01032397","Total",776,748,28
"2011","Wychavon 017C","E01032398","Total",674,664,10
"2011","Wychavon 018A","E01032351","Total",853,748,105
"2011","Wychavon 018B","E01032352","Total",684,653,31
"2011","Wychavon 018C","E01032353","Total",865,763,102
"2011","Wychavon 018D","E01032374","Total",552,532,20
"2011","Wychavon 019A","E01032347","Total",559,547,12
"2011","Wychavon 019B","E01032348","Total",546,513,33
"2011","Wychavon 019C","E01032372","Total",646,610,36
"2011","Wychavon 019D","E01032373","Total",579,533,46
"2011","Wychavon 019E","E01032412","Total",600,557,43
"2011","Wychavon 019F","E01032413","Total",471,454,17
"2011","Wyre Forest 001A","E01032431","Total",679,656,23
"2011","Wyre Forest 001B","E01032432","Total",572,556,16
"2011","Wyre Forest 001C","E01032433","Total",549,526,23
"2011","Wyre Forest 001D","E01032439","Total",609,599,10
"2011","Wyre Forest 001E","E01032440","Total",560,532,28
"2011","Wyre Forest 001F","E01032479","Total",969,935,34
"2011","Wyre Forest 002A","E01032441","Total",531,527,4
"2011","Wyre Forest 002B","E01032442","Total",604,596,8
"2011","Wyre Forest 002C","E01032443","Total",628,619,9
"2011","Wyre Forest 002D","E01032444","Total",535,511,24
"2011","Wyre Forest 002E","E01032445","Total",673,657,16
"2011","Wyre Forest 003A","E01032436","Total",678,660,18
"2011","Wyre Forest 003B","E01032438","Total",677,657,20
"2011","Wyre Forest 003C","E01032446","Total",627,615,12
"2011","Wyre Forest 003D","E01032447","Total",661,639,22
"2011","Wyre Forest 003E","E01032448","Total",484,476,8
"2011","Wyre Forest 004A","E01032434","Total",734,711,23
"2011","Wyre Forest 004B","E01032435","Total",680,649,31
"2011","Wyre Forest 004C","E01032437","Total",755,735,20
"2011","Wyre Forest 004D","E01032450","Total",1143,1101,42
"2011","Wyre Forest 005A","E01032430","Total",765,731,34
"2011","Wyre Forest 005B","E01032480","Total",806,780,26
"2011","Wyre Forest 005C","E01032481","Total",942,796,146
"2011","Wyre Forest 005D","E01032482","Total",682,626,56
"2011","Wyre Forest 006A","E01032451","Total",669,658,11
"2011","Wyre Forest 006B","E01032452","Total",644,636,8
"2011","Wyre Forest 006C","E01032453","Total",773,755,18
"2011","Wyre Forest 006D","E01032454","Total",819,766,53
"2011","Wyre Forest 007A","E01032449","Total",751,721,30
"2011","Wyre Forest 007B","E01032464","Total",769,762,7
"2011","Wyre Forest 007C","E01032465","Total",623,613,10
"2011","Wyre Forest 007D","E01032466","Total",681,661,20
"2011","Wyre Forest 007E","E01032467","Total",534,523,11
"2011","Wyre Forest 007F","E01032468","Total",518,510,8
"2011","Wyre Forest 008A","E01032474","Total",885,832,53
"2011","Wyre Forest 008B","E01032475","Total",759,729,30
"2011","Wyre Forest 008C","E01032476","Total",638,624,14
"2011","Wyre Forest 008D","E01032477","Total",524,519,5
"2011","Wyre Forest 008E","E01032478","Total",660,643,17
"2011","Wyre Forest 009A","E01032469","Total",660,652,8
"2011","Wyre Forest 009B","E01032470","Total",813,784,29
"2011","Wyre Forest 009C","E01032471","Total",653,634,19
"2011","Wyre Forest 010A","E01032418","Total",631,604,27
"2011","Wyre Forest 010B","E01032419","Total",591,576,15
"2011","Wyre Forest 010C","E01032420","Total",519,511,8
"2011","Wyre Forest 010D","E01032421","Total",485,482,3
"2011","Wyre Forest 010E","E01032422","Total",660,644,16
"2011","Wyre Forest 011A","E01032427","Total",693,676,17
"2011","Wyre Forest 011B","E01032428","Total",1216,880,336
"2011","Wyre Forest 011C","E01032429","Total",691,679,12
"2011","Wyre Forest 011D","E01032472","Total",526,500,26
"2011","Wyre Forest 011E","E01032473","Total",543,513,30
"2011","Wyre Forest 012A","E01032455","Total",641,631,10
"2011","Wyre Forest 012B","E01032456","Total",532,514,18
"2011","Wyre Forest 012C","E01032457","Total",549,530,19
"2011","Wyre Forest 012D","E01032458","Total",630,611,19
"2011","Wyre Forest 012E","E01032459","Total",621,608,13
"2011","Wyre Forest 013A","E01032460","Total",914,885,29
"2011","Wyre Forest 013B","E01032461","Total",1071,926,145
"2011","Wyre Forest 013C","E01032462","Total",979,942,37
"2011","Wyre Forest 013D","E01032463","Total",771,744,27
"2011","Wyre Forest 014A","E01032423","Total",879,669,210
"2011","Wyre Forest 014B","E01032424","Total",657,638,19
"2011","Wyre Forest 014C","E01032425","Total",665,644,21
"2011","Wyre Forest 014D","E01032426","Total",679,666,13
"2011","Bedford 001A","E01017540","Total",621,591,30
"2011","Bedford 001B","E01017541","Total",558,520,38
"2011","Bedford 001C","E01017544","Total",606,577,29
"2011","Bedford 001D","E01017545","Total",634,587,47
"2011","Bedford 002A","E01017464","Total",655,620,35
"2011","Bedford 002B","E01017465","Total",651,616,35
"2011","Bedford 002C","E01017503","Total",529,507,22
"2011","Bedford 002D","E01017504","Total",868,833,35
"2011","Bedford 002E","E01017546","Total",525,505,20
"2011","Bedford 002F","E01017547","Total",657,633,24
"2011","Bedford 003A","E01017478","Total",756,718,38
"2011","Bedford 003B","E01017479","Total",663,624,39
"2011","Bedford 003C","E01017480","Total",766,746,20
"2011","Bedford 003D","E01017481","Total",500,485,15
"2011","Bedford 003E","E01017528","Total",974,948,26
"2011","Bedford 004B","E01017495","Total",881,829,52
"2011","Bedford 004C","E01017496","Total",666,642,24
"2011","Bedford 004D","E01017542","Total",630,589,41
"2011","Bedford 004E","E01017543","Total",627,590,37
"2011","Bedford 004F","E01033431","Total",508,482,26
"2011","Bedford 004G","E01033432","Total",969,925,44
"2011","Bedford 005A","E01017453","Total",655,623,32
"2011","Bedford 005B","E01017454","Total",607,588,19
"2011","Bedford 005C","E01017455","Total",674,651,23
"2011","Bedford 005D","E01017456","Total",645,634,11
"2011","Bedford 005E","E01017457","Total",500,487,13
"2011","Bedford 005F","E01017458","Total",518,514,4
"2011","Bedford 006A","E01017529","Total",525,509,16
"2011","Bedford 006B","E01017530","Total",591,578,13
"2011","Bedford 006C","E01017531","Total",612,583,29
"2011","Bedford 006D","E01017532","Total",514,505,9
"2011","Bedford 006E","E01017533","Total",488,485,3
"2011","Bedford 006F","E01017534","Total",661,644,17
"2011","Bedford 007A","E01017488","Total",651,637,14
"2011","Bedford 007B","E01017489","Total",636,614,22
"2011","Bedford 007C","E01017490","Total",633,611,22
"2011","Bedford 007D","E01017491","Total",662,641,21
"2011","Bedford 007E","E01017492","Total",648,606,42
"2011","Bedford 007F","E01017493","Total",670,653,17
"2011","Bedford 008A","E01017459","Total",697,687,10
"2011","Bedford 008B","E01017460","Total",680,650,30
"2011","Bedford 008C","E01017461","Total",886,734,152
"2011","Bedford 008D","E01017462","Total",623,613,10
"2011","Bedford 008E","E01017463","Total",618,601,17
"2011","Bedford 009A","E01017482","Total",654,621,33
"2011","Bedford 009B","E01017483","Total",615,600,15
"2011","Bedford 009C","E01017484","Total",561,503,58
"2011","Bedford 009D","E01017485","Total",670,622,48
"2011","Bedford 010A","E01017497","Total",631,581,50
"2011","Bedford 010B","E01017498","Total",513,505,8
"2011","Bedford 010C","E01017499","Total",675,599,76
"2011","Bedford 010D","E01017500","Total",651,591,60
"2011","Bedford 010E","E01017501","Total",698,619,79
"2011","Bedford 010F","E01017502","Total",919,842,77
"2011","Bedford 011A","E01017524","Total",648,632,16
"2011","Bedford 011B","E01017525","Total",519,493,26
"2011","Bedford 011C","E01017526","Total",616,604,12
"2011","Bedford 011D","E01017527","Total",547,530,17
"2011","Bedford 012A","E01017466","Total",955,754,201
"2011","Bedford 012B","E01017467","Total",665,613,52
"2011","Bedford 012C","E01017468","Total",619,596,23
"2011","Bedford 012D","E01017469","Total",1030,842,188
"2011","Bedford 012E","E01017470","Total",528,503,25
"2011","Bedford 012F","E01017471","Total",875,772,103
"2011","Bedford 013A","E01017535","Total",495,475,20
"2011","Bedford 013B","E01017536","Total",858,820,38
"2011","Bedford 013C","E01017537","Total",505,480,25
"2011","Bedford 013D","E01017538","Total",537,524,13
"2011","Bedford 013E","E01017539","Total",554,502,52
"2011","Bedford 014A","E01017518","Total",641,604,37
"2011","Bedford 014B","E01017519","Total",664,642,22
"2011","Bedford 014C","E01017520","Total",652,625,27
"2011","Bedford 014D","E01017521","Total",651,622,29
"2011","Bedford 014E","E01017522","Total",968,858,110
"2011","Bedford 014F","E01017523","Total",640,589,51
"2011","Bedford 015A","E01017472","Total",549,510,39
"2011","Bedford 015B","E01017473","Total",1027,929,98
"2011","Bedford 015C","E01017474","Total",705,628,77
"2011","Bedford 015D","E01017475","Total",584,553,31
"2011","Bedford 015E","E01017476","Total",567,543,24
"2011","Bedford 015F","E01017477","Total",544,518,26
"2011","Bedford 016A","E01017509","Total",534,501,33
"2011","Bedford 016B","E01017510","Total",690,657,33
"2011","Bedford 016C","E01017511","Total",501,485,16
"2011","Bedford 016D","E01017512","Total",564,537,27
"2011","Bedford 017A","E01017505","Total",671,645,26
"2011","Bedford 017B","E01017506","Total",690,664,26
"2011","Bedford 017C","E01017507","Total",540,519,21
"2011","Bedford 017D","E01017508","Total",702,663,39
"2011","Bedford 018A","E01017513","Total",555,549,6
"2011","Bedford 018B","E01017514","Total",688,650,38
"2011","Bedford 018C","E01017515","Total",693,626,67
"2011","Bedford 018D","E01017516","Total",663,559,104
"2011","Bedford 018E","E01017517","Total",610,598,12
"2011","Bedford 019A","E01017486","Total",725,685,40
"2011","Bedford 019B","E01017487","Total",712,672,40
"2011","Bedford 019C","E01017548","Total",788,750,38
"2011","Bedford 019D","E01017549","Total",678,652,26
"2011","Bedford 019E","E01017550","Total",1036,988,48
"2011","Bedford 020A","E01017551","Total",558,532,26
"2011","Bedford 020B","E01017552","Total",524,499,25
"2011","Bedford 020C","E01017553","Total",489,482,7
"2011","Bedford 020D","E01017554","Total",674,640,34
"2011","Central Bedfordshire 001A","E01017433","Total",667,648,19
"2011","Central Bedfordshire 001B","E01017434","Total",705,694,11
"2011","Central Bedfordshire 001C","E01017436","Total",915,894,21
"2011","Central Bedfordshire 002A","E01017430","Total",631,600,31
"2011","Central Bedfordshire 002B","E01017431","Total",716,678,38
"2011","Central Bedfordshire 002C","E01017432","Total",578,565,13
"2011","Central Bedfordshire 002D","E01017435","Total",744,713,31
"2011","Central Bedfordshire 003A","E01017425","Total",451,430,21
"2011","Central Bedfordshire 003B","E01017426","Total",597,574,23
"2011","Central Bedfordshire 003C","E01017427","Total",744,719,25
"2011","Central Bedfordshire 003D","E01017428","Total",700,681,19
"2011","Central Bedfordshire 003E","E01017429","Total",657,625,32
"2011","Central Bedfordshire 004A","E01017412","Total",632,611,21
"2011","Central Bedfordshire 004B","E01017422","Total",637,626,11
"2011","Central Bedfordshire 004C","E01017423","Total",661,639,22
"2011","Central Bedfordshire 004D","E01017424","Total",591,568,23
"2011","Central Bedfordshire 005A","E01017383","Total",870,848,22
"2011","Central Bedfordshire 005B","E01017384","Total",692,670,22
"2011","Central Bedfordshire 005C","E01017385","Total",962,849,113
"2011","Central Bedfordshire 005D","E01017386","Total",798,756,42
"2011","Central Bedfordshire 005E","E01017387","Total",517,508,9
"2011","Central Bedfordshire 005F","E01017388","Total",571,555,16
"2011","Central Bedfordshire 006A","E01017381","Total",630,616,14
"2011","Central Bedfordshire 006B","E01017382","Total",588,573,15
"2011","Central Bedfordshire 006C","E01017389","Total",766,739,27
"2011","Central Bedfordshire 006D","E01017390","Total",828,801,27
"2011","Central Bedfordshire 007A","E01017379","Total",543,520,23
"2011","Central Bedfordshire 007B","E01017380","Total",547,517,30
"2011","Central Bedfordshire 007C","E01017394","Total",593,584,9
"2011","Central Bedfordshire 007F","E01017397","Total",691,670,21
"2011","Central Bedfordshire 007G","E01033194","Total",836,775,61
"2011","Central Bedfordshire 008A","E01017410","Total",502,485,17
"2011","Central Bedfordshire 008B","E01017411","Total",640,624,16
"2011","Central Bedfordshire 008C","E01017419","Total",629,604,25
"2011","Central Bedfordshire 008D","E01017420","Total",665,649,16
"2011","Central Bedfordshire 008E","E01017421","Total",720,706,14
"2011","Central Bedfordshire 009A","E01017416","Total",792,781,11
"2011","Central Bedfordshire 009B","E01017417","Total",921,905,16
"2011","Central Bedfordshire 009C","E01017418","Total",655,650,5
"2011","Central Bedfordshire 009D","E01017451","Total",633,582,51
"2011","Central Bedfordshire 009E","E01017452","Total",629,581,48
"2011","Central Bedfordshire 010A","E01017376","Total",847,811,36
"2011","Central Bedfordshire 010B","E01017377","Total",772,760,12
"2011","Central Bedfordshire 010C","E01017378","Total",803,773,30
"2011","Central Bedfordshire 010D","E01017413","Total",738,722,16
"2011","Central Bedfordshire 010E","E01017414","Total",744,720,24
"2011","Central Bedfordshire 010F","E01017415","Total",797,776,21
"2011","Central Bedfordshire 011A","E01017437","Total",691,665,26
"2011","Central Bedfordshire 011B","E01017438","Total",718,670,48
"2011","Central Bedfordshire 011C","E01017439","Total",656,632,24
"2011","Central Bedfordshire 011D","E01017440","Total",647,622,25
"2011","Central Bedfordshire 011E","E01017441","Total",680,620,60
"2011","Central Bedfordshire 011F","E01017444","Total",836,792,44
"2011","Central Bedfordshire 012A","E01017371","Total",558,547,11
"2011","Central Bedfordshire 012B","E01017372","Total",656,647,9
"2011","Central Bedfordshire 012C","E01017373","Total",577,560,17
"2011","Central Bedfordshire 012D","E01017374","Total",592,573,19
"2011","Central Bedfordshire 012E","E01017375","Total",673,639,34
"2011","Central Bedfordshire 013A","E01017391","Total",568,538,30
"2011","Central Bedfordshire 013B","E01017392","Total",633,623,10
"2011","Central Bedfordshire 013C","E01017393","Total",693,680,13
"2011","Central Bedfordshire 013D","E01017442","Total",840,814,26
"2011","Central Bedfordshire 013E","E01017443","Total",873,698,175
"2011","Central Bedfordshire 014A","E01017446","Total",755,726,29
"2011","Central Bedfordshire 014B","E01017447","Total",895,843,52
"2011","Central Bedfordshire 014D","E01017449","Total",643,625,18
"2011","Central Bedfordshire 014E","E01033188","Total",593,577,16
"2011","Central Bedfordshire 014F","E01033189","Total",640,611,29
"2011","Central Bedfordshire 014G","E01033190","Total",630,596,34
"2011","Central Bedfordshire 015A","E01017399","Total",599,570,29
"2011","Central Bedfordshire 015B","E01017400","Total",664,641,23
"2011","Central Bedfordshire 015C","E01017401","Total",527,522,5
"2011","Central Bedfordshire 015D","E01017402","Total",674,654,20
"2011","Central Bedfordshire 016A","E01017403","Total",621,604,17
"2011","Central Bedfordshire 016B","E01017404","Total",495,493,2
"2011","Central Bedfordshire 016C","E01017405","Total",622,611,11
"2011","Central Bedfordshire 016D","E01017406","Total",646,631,15
"2011","Central Bedfordshire 016E","E01017407","Total",687,681,6
"2011","Central Bedfordshire 017A","E01017398","Total",951,932,19
"2011","Central Bedfordshire 017B","E01017408","Total",425,416,9
"2011","Central Bedfordshire 017C","E01017409","Total",518,505,13
"2011","Central Bedfordshire 017D","E01017445","Total",812,732,80
"2011","Central Bedfordshire 017E","E01017450","Total",904,866,38
"2011","Central Bedfordshire 018A","E01017558","Total",758,737,21
"2011","Central Bedfordshire 018B","E01017559","Total",683,666,17
"2011","Central Bedfordshire 018C","E01017560","Total",633,619,14
"2011","Central Bedfordshire 018D","E01017616","Total",978,952,26
"2011","Central Bedfordshire 019A","E01017577","Total",1019,928,91
"2011","Central Bedfordshire 019B","E01017615","Total",958,878,80
"2011","Central Bedfordshire 019C","E01017620","Total",788,740,48
"2011","Central Bedfordshire 019D","E01017621","Total",654,651,3
"2011","Central Bedfordshire 019E","E01017622","Total",712,681,31
"2011","Central Bedfordshire 020A","E01017603","Total",652,641,11
"2011","Central Bedfordshire 020B","E01017604","Total",648,641,7
"2011","Central Bedfordshire 020C","E01017605","Total",519,500,19
"2011","Central Bedfordshire 020D","E01017606","Total",695,644,51
"2011","Central Bedfordshire 020E","E01017607","Total",516,507,9
"2011","Central Bedfordshire 021A","E01017555","Total",1043,955,88
"2011","Central Bedfordshire 021B","E01017556","Total",720,672,48
"2011","Central Bedfordshire 021C","E01017557","Total",982,919,63
"2011","Central Bedfordshire 021D","E01017608","Total",763,719,44
"2011","Central Bedfordshire 021E","E01017609","Total",812,683,129
"2011","Central Bedfordshire 022A","E01017589","Total",828,787,41
"2011","Central Bedfordshire 022B","E01017590","Total",682,655,27
"2011","Central Bedfordshire 022C","E01017591","Total",762,733,29
"2011","Central Bedfordshire 022D","E01017610","Total",453,446,7
"2011","Central Bedfordshire 023A","E01017611","Total",518,510,8
"2011","Central Bedfordshire 023B","E01017612","Total",542,531,11
"2011","Central Bedfordshire 023C","E01017613","Total",617,604,13
"2011","Central Bedfordshire 023D","E01017614","Total",595,588,7
"2011","Central Bedfordshire 025A","E01017600","Total",863,817,46
"2011","Central Bedfordshire 025B","E01017601","Total",514,490,24
"2011","Central Bedfordshire 025C","E01017602","Total",641,620,21
"2011","Central Bedfordshire 025D","E01017618","Total",640,611,29
"2011","Central Bedfordshire 025E","E01017619","Total",795,787,8
"2011","Central Bedfordshire 024A","E01017573","Total",608,586,22
"2011","Central Bedfordshire 024C","E01017575","Total",1116,1076,40
"2011","Central Bedfordshire 024D","E01017576","Total",556,547,9
"2011","Central Bedfordshire 024E","E01033191","Total",577,564,13
"2011","Central Bedfordshire 024F","E01033192","Total",589,571,18
"2011","Central Bedfordshire 024G","E01033193","Total",623,602,21
"2011","Central Bedfordshire 026A","E01017578","Total",695,684,11
"2011","Central Bedfordshire 026B","E01017579","Total",606,597,9
"2011","Central Bedfordshire 026C","E01017580","Total",911,885,26
"2011","Central Bedfordshire 026D","E01017581","Total",818,798,20
"2011","Central Bedfordshire 026E","E01017617","Total",519,509,10
"2011","Central Bedfordshire 027A","E01017582","Total",617,601,16
"2011","Central Bedfordshire 027B","E01017583","Total",748,720,28
"2011","Central Bedfordshire 027C","E01017584","Total",830,787,43
"2011","Central Bedfordshire 027D","E01017585","Total",547,540,7
"2011","Central Bedfordshire 028A","E01017566","Total",614,605,9
"2011","Central Bedfordshire 028B","E01017595","Total",474,464,10
"2011","Central Bedfordshire 028C","E01017596","Total",627,605,22
"2011","Central Bedfordshire 028D","E01017597","Total",624,612,12
"2011","Central Bedfordshire 028E","E01017598","Total",418,408,10
"2011","Central Bedfordshire 028F","E01017599","Total",942,863,79
"2011","Central Bedfordshire 029A","E01017565","Total",631,618,13
"2011","Central Bedfordshire 029B","E01017567","Total",718,695,23
"2011","Central Bedfordshire 029C","E01017568","Total",945,874,71
"2011","Central Bedfordshire 029D","E01017569","Total",798,750,48
"2011","Central Bedfordshire 029E","E01017570","Total",978,925,53
"2011","Central Bedfordshire 030A","E01017592","Total",732,699,33
"2011","Central Bedfordshire 030B","E01017593","Total",650,643,7
"2011","Central Bedfordshire 030C","E01017594","Total",935,864,71
"2011","Central Bedfordshire 031A","E01017623","Total",781,751,30
"2011","Central Bedfordshire 031B","E01017624","Total",739,723,16
"2011","Central Bedfordshire 031C","E01017625","Total",661,647,14
"2011","Central Bedfordshire 031D","E01017626","Total",675,665,10
"2011","Central Bedfordshire 032A","E01017571","Total",542,527,15
"2011","Central Bedfordshire 032B","E01017572","Total",595,569,26
"2011","Central Bedfordshire 032C","E01017586","Total",636,614,22
"2011","Central Bedfordshire 032D","E01017587","Total",702,666,36
"2011","Central Bedfordshire 032E","E01017588","Total",561,538,23
"2011","Central Bedfordshire 033A","E01017561","Total",617,591,26
"2011","Central Bedfordshire 033B","E01017562","Total",731,697,34
"2011","Central Bedfordshire 033C","E01017563","Total",697,672,25
"2011","Central Bedfordshire 033D","E01017564","Total",630,604,26
"2011","Luton 001A","E01015706","Total",615,604,11
"2011","Luton 001B","E01015707","Total",604,585,19
"2011","Luton 001C","E01015708","Total",523,510,13
"2011","Luton 001D","E01015709","Total",642,629,13
"2011","Luton 001E","E01015710","Total",667,643,24
"2011","Luton 001F","E01015770","Total",503,491,12
"2011","Luton 002A","E01015801","Total",763,746,17
"2011","Luton 002B","E01015803","Total",602,592,10
"2011","Luton 002C","E01015804","Total",742,713,29
"2011","Luton 002D","E01015805","Total",504,491,13
"2011","Luton 003A","E01015769","Total",506,496,10
"2011","Luton 003B","E01015771","Total",647,577,70
"2011","Luton 003C","E01015772","Total",551,534,17
"2011","Luton 003D","E01015773","Total",466,461,5
"2011","Luton 003E","E01015774","Total",541,518,23
"2011","Luton 003F","E01015802","Total",618,608,10
"2011","Luton 004A","E01015744","Total",651,643,8
"2011","Luton 004B","E01015746","Total",630,621,9
"2011","Luton 004C","E01015747","Total",487,486,1
"2011","Luton 004D","E01015748","Total",735,720,15
"2011","Luton 005A","E01015749","Total",703,700,3
"2011","Luton 005B","E01015751","Total",639,624,15
"2011","Luton 005C","E01015752","Total",490,478,12
"2011","Luton 005D","E01015753","Total",624,615,9
"2011","Luton 005E","E01015754","Total",796,768,28
"2011","Luton 005F","E01015755","Total",700,687,13
"2011","Luton 006A","E01015764","Total",602,593,9
"2011","Luton 006B","E01015765","Total",674,658,16
"2011","Luton 006C","E01015766","Total",565,555,10
"2011","Luton 006D","E01015767","Total",611,595,16
"2011","Luton 006E","E01015768","Total",589,580,9
"2011","Luton 006F","E01015783","Total",539,524,15
"2011","Luton 006G","E01015785","Total",857,820,37
"2011","Luton 007A","E01015693","Total",528,514,14
"2011","Luton 007B","E01015694","Total",512,497,15
"2011","Luton 007C","E01015695","Total",502,494,8
"2011","Luton 007D","E01015696","Total",515,505,10
"2011","Luton 007E","E01015697","Total",671,659,12
"2011","Luton 007F","E01015745","Total",565,557,8
"2011","Luton 008A","E01015797","Total",509,506,3
"2011","Luton 008B","E01015798","Total",542,539,3
"2011","Luton 008C","E01015799","Total",579,574,5
"2011","Luton 008D","E01015800","Total",634,627,7
"2011","Luton 008E","E01015812","Total",525,524,1
"2011","Luton 008F","E01015813","Total",702,688,14
"2011","Luton 009A","E01015756","Total",664,647,17
"2011","Luton 009B","E01015757","Total",624,613,11
"2011","Luton 009C","E01015758","Total",545,524,21
"2011","Luton 009D","E01015759","Total",626,617,9
"2011","Luton 009E","E01015760","Total",618,611,7
"2011","Luton 009F","E01015761","Total",619,606,13
"2011","Luton 010A","E01015700","Total",810,773,37
"2011","Luton 010B","E01015701","Total",523,509,14
"2011","Luton 010C","E01015704","Total",576,570,6
"2011","Luton 010D","E01015782","Total",661,636,25
"2011","Luton 010E","E01015784","Total",543,532,11
"2011","Luton 010F","E01015786","Total",579,564,15
"2011","Luton 011A","E01015711","Total",532,514,18
"2011","Luton 011B","E01015712","Total",647,631,16
"2011","Luton 011C","E01015715","Total",511,496,15
"2011","Luton 011D","E01015716","Total",623,616,7
"2011","Luton 011E","E01015717","Total",529,512,17
"2011","Luton 011F","E01015750","Total",732,718,14
"2011","Luton 012A","E01015740","Total",583,568,15
"2011","Luton 012B","E01015775","Total",716,704,12
"2011","Luton 012C","E01015776","Total",752,736,16
"2011","Luton 012D","E01015777","Total",705,683,22
"2011","Luton 012E","E01015778","Total",694,682,12
"2011","Luton 012F","E01015796","Total",680,667,13
"2011","Luton 013A","E01015713","Total",531,517,14
"2011","Luton 013B","E01015714","Total",653,631,22
"2011","Luton 013C","E01015718","Total",727,680,47
"2011","Luton 013D","E01015762","Total",690,670,20
"2011","Luton 013E","E01015763","Total",649,639,10
"2011","Luton 014A","E01015721","Total",668,656,12
"2011","Luton 014B","E01015722","Total",535,522,13
"2011","Luton 014C","E01015806","Total",560,554,6
"2011","Luton 014D","E01015808","Total",634,626,8
"2011","Luton 014E","E01015809","Total",507,502,5
"2011","Luton 014F","E01015810","Total",521,514,7
"2011","Luton 014G","E01015811","Total",585,580,5
"2011","Luton 015A","E01015703","Total",499,490,9
"2011","Luton 015B","E01015726","Total",586,574,12
"2011","Luton 015C","E01015731","Total",559,553,6
"2011","Luton 015D","E01015787","Total",588,570,18
"2011","Luton 015E","E01015788","Total",466,456,10
"2011","Luton 016A","E01015719","Total",554,552,2
"2011","Luton 016B","E01015720","Total",572,554,18
"2011","Luton 016C","E01015723","Total",510,494,16
"2011","Luton 016D","E01015779","Total",498,494,4
"2011","Luton 016E","E01015780","Total",641,630,11
"2011","Luton 016F","E01015781","Total",545,533,12
"2011","Luton 016G","E01015807","Total",532,532,0
"2011","Luton 017A","E01015698","Total",547,532,15
"2011","Luton 017B","E01015699","Total",640,617,23
"2011","Luton 017C","E01015702","Total",481,472,9
"2011","Luton 017D","E01015705","Total",584,561,23
"2011","Luton 017E","E01015725","Total",513,496,17
"2011","Luton 017F","E01015727","Total",469,450,19
"2011","Luton 018A","E01015739","Total",1008,963,45
"2011","Luton 018B","E01015741","Total",1054,1022,32
"2011","Luton 018C","E01015742","Total",759,739,20
"2011","Luton 018D","E01015743","Total",711,687,24
"2011","Luton 018E","E01015789","Total",854,832,22
"2011","Luton 018F","E01015794","Total",1158,1054,104
"2011","Luton 019A","E01015724","Total",669,658,11
"2011","Luton 019B","E01015728","Total",524,515,9
"2011","Luton 019C","E01015729","Total",636,595,41
"2011","Luton 019D","E01015730","Total",801,743,58
"2011","Luton 020A","E01015732","Total",517,514,3
"2011","Luton 020B","E01015733","Total",610,608,2
"2011","Luton 020C","E01015734","Total",730,716,14
"2011","Luton 020D","E01015735","Total",718,690,28
"2011","Luton 020E","E01015736","Total",700,689,11
"2011","Luton 020F","E01015737","Total",511,503,8
"2011","Luton 021A","E01015738","Total",823,788,35
"2011","Luton 021B","E01015790","Total",631,613,18
"2011","Luton 021C","E01015791","Total",1153,1115,38
"2011","Luton 021D","E01015792","Total",714,691,23
"2011","Luton 021E","E01015793","Total",659,644,15
"2011","Luton 021F","E01015795","Total",1049,985,64
"2011","Peterborough 001A","E01015629","Total",680,671,9
"2011","Peterborough 001B","E01015635","Total",650,632,18
"2011","Peterborough 001C","E01015636","Total",485,474,11
"2011","Peterborough 001D","E01015679","Total",843,823,20
"2011","Peterborough 002A","E01015678","Total",582,568,14
"2011","Peterborough 002B","E01015680","Total",659,640,19
"2011","Peterborough 002C","E01015681","Total",600,594,6
"2011","Peterborough 002D","E01015682","Total",686,664,22
"2011","Peterborough 003A","E01015630","Total",654,612,42
"2011","Peterborough 003B","E01015631","Total",529,524,5
"2011","Peterborough 003C","E01015659","Total",852,839,13
"2011","Peterborough 003D","E01015684","Total",612,607,5
"2011","Peterborough 003E","E01015685","Total",708,693,15
"2011","Peterborough 004A","E01015589","Total",717,668,49
"2011","Peterborough 004B","E01015590","Total",560,531,29
"2011","Peterborough 004C","E01015626","Total",616,535,81
"2011","Peterborough 004D","E01015628","Total",848,746,102
"2011","Peterborough 005A","E01015617","Total",598,560,38
"2011","Peterborough 005B","E01015618","Total",466,451,15
"2011","Peterborough 005C","E01015619","Total",922,871,51
"2011","Peterborough 005D","E01015620","Total",701,685,16
"2011","Peterborough 006A","E01015674","Total",686,669,17
"2011","Peterborough 006B","E01015675","Total",676,665,11
"2011","Peterborough 006C","E01015676","Total",701,690,11
"2011","Peterborough 006D","E01015683","Total",871,849,22
"2011","Peterborough 006E","E01015686","Total",731,711,20
"2011","Peterborough 007A","E01015607","Total",643,633,10
"2011","Peterborough 007B","E01015609","Total",673,664,9
"2011","Peterborough 007C","E01015656","Total",684,666,18
"2011","Peterborough 007D","E01015657","Total",794,735,59
"2011","Peterborough 007E","E01015658","Total",650,633,17
"2011","Peterborough 007F","E01015660","Total",756,740,16
"2011","Peterborough 008A","E01015605","Total",645,641,4
"2011","Peterborough 008B","E01015608","Total",648,633,15
"2011","Peterborough 008C","E01015610","Total",667,664,3
"2011","Peterborough 008D","E01015633","Total",1003,982,21
"2011","Peterborough 008E","E01015634","Total",778,765,13
"2011","Peterborough 009A","E01015593","Total",605,571,34
"2011","Peterborough 009B","E01015596","Total",631,594,37
"2011","Peterborough 009C","E01015662","Total",499,485,14
"2011","Peterborough 009D","E01015663","Total",663,649,14
"2011","Peterborough 009E","E01015664","Total",674,668,6
"2011","Peterborough 010A","E01015603","Total",846,772,74
"2011","Peterborough 010B","E01015604","Total",540,506,34
"2011","Peterborough 010C","E01015632","Total",760,731,29
"2011","Peterborough 010D","E01015661","Total",632,611,21
"2011","Peterborough 010E","E01015677","Total",502,474,28
"2011","Peterborough 011A","E01015591","Total",608,587,21
"2011","Peterborough 011B","E01015592","Total",654,644,10
"2011","Peterborough 011C","E01015594","Total",801,752,49
"2011","Peterborough 011D","E01015595","Total",684,677,7
"2011","Peterborough 011E","E01015597","Total",618,612,6
"2011","Peterborough 012A","E01015601","Total",571,514,57
"2011","Peterborough 012B","E01015651","Total",688,658,30
"2011","Peterborough 012C","E01015652","Total",650,596,54
"2011","Peterborough 012D","E01015653","Total",660,650,10
"2011","Peterborough 012E","E01015654","Total",956,866,90
"2011","Peterborough 013A","E01015606","Total",738,721,17
"2011","Peterborough 013B","E01015611","Total",941,914,27
"2011","Peterborough 013C","E01015613","Total",683,666,17
"2011","Peterborough 013D","E01015614","Total",769,737,32
"2011","Peterborough 013E","E01015615","Total",689,678,11
"2011","Peterborough 013F","E01015616","Total",680,652,28
"2011","Peterborough 014A","E01015599","Total",760,729,31
"2011","Peterborough 014B","E01015600","Total",593,547,46
"2011","Peterborough 014C","E01015602","Total",1031,892,139
"2011","Peterborough 014D","E01015612","Total",963,859,104
"2011","Peterborough 014E","E01015655","Total",869,808,61
"2011","Peterborough 015A","E01015598","Total",638,633,5
"2011","Peterborough 015B","E01015687","Total",651,640,11
"2011","Peterborough 015C","E01015689","Total",625,617,8
"2011","Peterborough 015D","E01015690","Total",476,462,14
"2011","Peterborough 015E","E01015691","Total",513,500,13
"2011","Peterborough 016A","E01015622","Total",1127,1093,34
"2011","Peterborough 016C","E01015665","Total",586,574,12
"2011","Peterborough 016D","E01015688","Total",679,658,21
"2011","Peterborough 016E","E01015692","Total",484,469,15
"2011","Peterborough 016F","E01033173","Total",745,733,12
"2011","Peterborough 016G","E01033182","Total",651,636,15
"2011","Peterborough 017A","E01015621","Total",989,929,60
"2011","Peterborough 017B","E01015623","Total",764,744,20
"2011","Peterborough 017C","E01015624","Total",772,729,43
"2011","Peterborough 017D","E01015666","Total",667,622,45
"2011","Peterborough 017E","E01015668","Total",863,817,46
"2011","Peterborough 018A","E01015627","Total",766,749,17
"2011","Peterborough 018B","E01015644","Total",803,787,16
"2011","Peterborough 018C","E01015645","Total",719,708,11
"2011","Peterborough 018D","E01015646","Total",898,881,17
"2011","Peterborough 018E","E01015648","Total",611,607,4
"2011","Peterborough 019A","E01015667","Total",556,550,6
"2011","Peterborough 019B","E01015669","Total",611,602,9
"2011","Peterborough 019C","E01015670","Total",611,601,10
"2011","Peterborough 019D","E01015671","Total",751,719,32
"2011","Peterborough 019E","E01015672","Total",666,657,9
"2011","Peterborough 019F","E01015673","Total",654,648,6
"2011","Peterborough 021A","E01015637","Total",564,562,2
"2011","Peterborough 021B","E01015639","Total",688,678,10
"2011","Peterborough 021C","E01015640","Total",599,590,9
"2011","Peterborough 021D","E01015641","Total",499,497,2
"2011","Peterborough 021E","E01015642","Total",585,576,9
"2011","Peterborough 021F","E01015647","Total",759,629,130
"2011","Peterborough 022A","E01015638","Total",617,609,8
"2011","Peterborough 022B","E01015650","Total",882,863,19
"2011","Peterborough 022C","E01033174","Total",585,549,36
"2011","Peterborough 022D","E01033179","Total",632,620,12
"2011","Peterborough 022E","E01033181","Total",574,564,10
"2011","Peterborough 023A","E01015643","Total",584,583,1
"2011","Peterborough 023B","E01033175","Total",539,529,10
"2011","Peterborough 023C","E01033176","Total",588,575,13
"2011","Peterborough 023D","E01033177","Total",556,546,10
"2011","Peterborough 023E","E01033178","Total",573,559,14
"2011","Peterborough 023F","E01033180","Total",594,581,13
"2011","Southend-on-Sea 001A","E01015833","Total",641,623,18
"2011","Southend-on-Sea 001B","E01015834","Total",640,622,18
"2011","Southend-on-Sea 001C","E01015835","Total",775,723,52
"2011","Southend-on-Sea 001D","E01015836","Total",657,635,22
"2011","Southend-on-Sea 001E","E01015837","Total",754,730,24
"2011","Southend-on-Sea 001F","E01015838","Total",655,649,6
"2011","Southend-on-Sea 002A","E01015863","Total",1050,999,51
"2011","Southend-on-Sea 002B","E01015864","Total",615,596,19
"2011","Southend-on-Sea 002C","E01015865","Total",668,649,19
"2011","Southend-on-Sea 002D","E01015866","Total",693,669,24
"2011","Southend-on-Sea 002E","E01015867","Total",667,640,27
"2011","Southend-on-Sea 002F","E01015868","Total",679,652,27
"2011","Southend-on-Sea 003A","E01015814","Total",644,624,20
"2011","Southend-on-Sea 003B","E01015815","Total",633,625,8
"2011","Southend-on-Sea 003C","E01015816","Total",823,770,53
"2011","Southend-on-Sea 003D","E01015817","Total",759,730,29
"2011","Southend-on-Sea 003E","E01015818","Total",834,797,37
"2011","Southend-on-Sea 003F","E01015819","Total",640,627,13
"2011","Southend-on-Sea 004A","E01015857","Total",670,663,7
"2011","Southend-on-Sea 004B","E01015858","Total",743,714,29
"2011","Southend-on-Sea 004C","E01015859","Total",852,800,52
"2011","Southend-on-Sea 004D","E01015860","Total",646,626,20
"2011","Southend-on-Sea 004E","E01015861","Total",820,753,67
"2011","Southend-on-Sea 004F","E01015862","Total",712,652,60
"2011","Southend-on-Sea 005A","E01015820","Total",631,613,18
"2011","Southend-on-Sea 005B","E01015821","Total",743,720,23
"2011","Southend-on-Sea 005C","E01015822","Total",496,485,11
"2011","Southend-on-Sea 005D","E01015823","Total",689,673,16
"2011","Southend-on-Sea 005E","E01015824","Total",632,615,17
"2011","Southend-on-Sea 005F","E01015825","Total",607,600,7
"2011","Southend-on-Sea 005G","E01015826","Total",586,573,13
"2011","Southend-on-Sea 006A","E01015869","Total",655,634,21
"2011","Southend-on-Sea 006B","E01015870","Total",667,663,4
"2011","Southend-on-Sea 006C","E01015871","Total",665,657,8
"2011","Southend-on-Sea 006D","E01015872","Total",705,685,20
"2011","Southend-on-Sea 006E","E01015873","Total",562,540,22
"2011","Southend-on-Sea 006F","E01015874","Total",748,716,32
"2011","Southend-on-Sea 006G","E01015875","Total",766,751,15
"2011","Southend-on-Sea 007A","E01015901","Total",640,589,51
"2011","Southend-on-Sea 007B","E01015902","Total",707,647,60
"2011","Southend-on-Sea 007C","E01015903","Total",721,675,46
"2011","Southend-on-Sea 007D","E01015904","Total",737,695,42
"2011","Southend-on-Sea 007E","E01015905","Total",633,583,50
"2011","Southend-on-Sea 007F","E01015906","Total",631,605,26
"2011","Southend-on-Sea 007G","E01015907","Total",652,592,60
"2011","Southend-on-Sea 008A","E01015908","Total",667,647,20
"2011","Southend-on-Sea 008B","E01015909","Total",643,627,16
"2011","Southend-on-Sea 008C","E01015910","Total",640,623,17
"2011","Southend-on-Sea 008D","E01015911","Total",515,511,4
"2011","Southend-on-Sea 008E","E01015912","Total",657,639,18
"2011","Southend-on-Sea 008F","E01015913","Total",826,793,33
"2011","Southend-on-Sea 009A","E01015883","Total",580,566,14
"2011","Southend-on-Sea 009B","E01015884","Total",1011,923,88
"2011","Southend-on-Sea 009C","E01015885","Total",729,711,18
"2011","Southend-on-Sea 009D","E01015886","Total",656,638,18
"2011","Southend-on-Sea 009E","E01015887","Total",642,583,59
"2011","Southend-on-Sea 009F","E01015888","Total",674,644,30
"2011","Southend-on-Sea 010A","E01015895","Total",1105,1053,52
"2011","Southend-on-Sea 010B","E01015896","Total",908,853,55
"2011","Southend-on-Sea 010C","E01015897","Total",899,884,15
"2011","Southend-on-Sea 010D","E01015898","Total",826,757,69
"2011","Southend-on-Sea 010E","E01015899","Total",846,800,46
"2011","Southend-on-Sea 010F","E01015900","Total",721,618,103
"2011","Southend-on-Sea 011A","E01015845","Total",709,683,26
"2011","Southend-on-Sea 011B","E01015846","Total",858,797,61
"2011","Southend-on-Sea 011C","E01015847","Total",849,797,52
"2011","Southend-on-Sea 011D","E01015848","Total",979,902,77
"2011","Southend-on-Sea 011E","E01015849","Total",800,754,46
"2011","Southend-on-Sea 011F","E01015850","Total",703,675,28
"2011","Southend-on-Sea 012A","E01015827","Total",693,662,31
"2011","Southend-on-Sea 012B","E01015828","Total",940,826,114
"2011","Southend-on-Sea 012C","E01015829","Total",661,643,18
"2011","Southend-on-Sea 012D","E01015830","Total",646,625,21
"2011","Southend-on-Sea 012E","E01015831","Total",873,840,33
"2011","Southend-on-Sea 012F","E01015832","Total",821,773,48
"2011","Southend-on-Sea 013A","E01015876","Total",927,884,43
"2011","Southend-on-Sea 013B","E01015877","Total",891,819,72
"2011","Southend-on-Sea 013C","E01015878","Total",592,581,11
"2011","Southend-on-Sea 013D","E01015879","Total",611,587,24
"2011","Southend-on-Sea 013E","E01015880","Total",681,660,21
"2011","Southend-on-Sea 013F","E01015881","Total",588,566,22
"2011","Southend-on-Sea 013G","E01015882","Total",710,685,25
"2011","Southend-on-Sea 014A","E01015839","Total",818,761,57
"2011","Southend-on-Sea 014B","E01015840","Total",824,714,110
"2011","Southend-on-Sea 014C","E01015841","Total",1303,1071,232
"2011","Southend-on-Sea 014D","E01015842","Total",1010,905,105
"2011","Southend-on-Sea 014E","E01015843","Total",756,714,42
"2011","Southend-on-Sea 014F","E01015844","Total",1010,922,88
"2011","Southend-on-Sea 015A","E01015851","Total",1205,1016,189
"2011","Southend-on-Sea 015B","E01015852","Total",1105,860,245
"2011","Southend-on-Sea 015C","E01015853","Total",1030,907,123
"2011","Southend-on-Sea 015D","E01015854","Total",793,748,45
"2011","Southend-on-Sea 015E","E01015855","Total",1005,888,117
"2011","Southend-on-Sea 015F","E01015856","Total",850,780,70
"2011","Southend-on-Sea 016A","E01015889","Total",637,610,27
"2011","Southend-on-Sea 016B","E01015890","Total",658,626,32
"2011","Southend-on-Sea 016C","E01015891","Total",734,658,76
"2011","Southend-on-Sea 016D","E01015892","Total",653,636,17
"2011","Southend-on-Sea 016E","E01015893","Total",826,793,33
"2011","Southend-on-Sea 016F","E01015894","Total",613,598,15
"2011","Southend-on-Sea 017A","E01015914","Total",506,502,4
"2011","Southend-on-Sea 017B","E01015915","Total",634,621,13
"2011","Southend-on-Sea 017C","E01015916","Total",552,544,8
"2011","Southend-on-Sea 017D","E01015917","Total",650,622,28
"2011","Southend-on-Sea 017E","E01015918","Total",562,531,31
"2011","Southend-on-Sea 017F","E01015919","Total",513,505,8
"2011","Southend-on-Sea 017G","E01015920","Total",659,638,21
"2011","Thurrock 001A","E01015943","Total",612,601,11
"2011","Thurrock 001B","E01015944","Total",532,525,7
"2011","Thurrock 001C","E01015946","Total",643,624,19
"2011","Thurrock 001D","E01015997","Total",505,503,2
"2011","Thurrock 001E","E01015999","Total",493,490,3
"2011","Thurrock 002A","E01015945","Total",509,490,19
"2011","Thurrock 002B","E01015983","Total",639,624,15
"2011","Thurrock 002C","E01015987","Total",584,576,8
"2011","Thurrock 002D","E01015988","Total",613,610,3
"2011","Thurrock 002E","E01015998","Total",600,595,5
"2011","Thurrock 003A","E01015984","Total",498,488,10
"2011","Thurrock 003B","E01015985","Total",646,636,10
"2011","Thurrock 003C","E01015986","Total",630,620,10
"2011","Thurrock 003D","E01015990","Total",591,581,10
"2011","Thurrock 003E","E01016001","Total",529,513,16
"2011","Thurrock 004A","E01015977","Total",749,728,21
"2011","Thurrock 004B","E01015978","Total",527,491,36
"2011","Thurrock 004C","E01015979","Total",543,528,15
"2011","Thurrock 004D","E01015980","Total",639,623,16
"2011","Thurrock 005A","E01015989","Total",708,672,36
"2011","Thurrock 005B","E01015991","Total",600,585,15
"2011","Thurrock 005C","E01015992","Total",815,784,31
"2011","Thurrock 005D","E01016000","Total",609,600,9
"2011","Thurrock 005E","E01016002","Total",528,521,7
"2011","Thurrock 006A","E01015932","Total",600,569,31
"2011","Thurrock 006B","E01015971","Total",703,681,22
"2011","Thurrock 006C","E01015972","Total",711,697,14
"2011","Thurrock 006D","E01015973","Total",726,696,30
"2011","Thurrock 006E","E01015974","Total",560,557,3
"2011","Thurrock 006F","E01015975","Total",636,627,9
"2011","Thurrock 007A","E01015927","Total",666,663,3
"2011","Thurrock 007B","E01015928","Total",656,653,3
"2011","Thurrock 007C","E01015929","Total",677,654,23
"2011","Thurrock 007D","E01015930","Total",673,664,9
"2011","Thurrock 007E","E01015931","Total",684,663,21
"2011","Thurrock 007F","E01015976","Total",804,785,19
"2011","Thurrock 008A","E01015922","Total",598,591,7
"2011","Thurrock 008B","E01015923","Total",681,653,28
"2011","Thurrock 008C","E01015924","Total",611,600,11
"2011","Thurrock 008D","E01015925","Total",634,624,10
"2011","Thurrock 008E","E01015926","Total",666,658,8
"2011","Thurrock 009A","E01015957","Total",597,593,4
"2011","Thurrock 009B","E01015958","Total",490,480,10
"2011","Thurrock 009C","E01015993","Total",655,646,9
"2011","Thurrock 009D","E01015994","Total",655,643,12
"2011","Thurrock 009E","E01015995","Total",624,615,9
"2011","Thurrock 009F","E01015996","Total",633,622,11
"2011","Thurrock 010A","E01015963","Total",506,494,12
"2011","Thurrock 010B","E01015964","Total",618,598,20
"2011","Thurrock 010C","E01015965","Total",605,597,8
"2011","Thurrock 010D","E01015966","Total",640,630,10
"2011","Thurrock 012A","E01015933","Total",642,635,7
"2011","Thurrock 012B","E01015934","Total",530,523,7
"2011","Thurrock 012C","E01015935","Total",618,607,11
"2011","Thurrock 012D","E01015936","Total",693,686,7
"2011","Thurrock 012E","E01015937","Total",700,688,12
"2011","Thurrock 012F","E01015938","Total",806,796,10
"2011","Thurrock 013A","E01015947","Total",566,548,18
"2011","Thurrock 013B","E01015948","Total",621,605,16
"2011","Thurrock 013C","E01015949","Total",625,612,13
"2011","Thurrock 013D","E01015950","Total",693,682,11
"2011","Thurrock 014A","E01015960","Total",564,544,20
"2011","Thurrock 014B","E01015967","Total",600,591,9
"2011","Thurrock 014C","E01015968","Total",628,607,21
"2011","Thurrock 014D","E01015969","Total",778,766,12
"2011","Thurrock 014E","E01015970","Total",509,491,18
"2011","Thurrock 015A","E01015921","Total",575,548,27
"2011","Thurrock 015B","E01016011","Total",704,677,27
"2011","Thurrock 015C","E01016012","Total",1014,928,86
"2011","Thurrock 015D","E01016013","Total",1060,1015,45
"2011","Thurrock 015E","E01016014","Total",1087,1009,78
"2011","Thurrock 015F","E01016015","Total",623,606,17
"2011","Thurrock 016A","E01015955","Total",646,641,5
"2011","Thurrock 016B","E01015956","Total",825,807,18
"2011","Thurrock 016C","E01015959","Total",651,634,17
"2011","Thurrock 016D","E01015961","Total",630,617,13
"2011","Thurrock 016E","E01015962","Total",647,621,26
"2011","Thurrock 017A","E01015951","Total",673,657,16
"2011","Thurrock 017B","E01015952","Total",843,818,25
"2011","Thurrock 017C","E01015953","Total",1037,1002,35
"2011","Thurrock 017D","E01015954","Total",1019,989,30
"2011","Thurrock 018A","E01016003","Total",801,774,27
"2011","Thurrock 018B","E01016004","Total",695,677,18
"2011","Thurrock 018C","E01016005","Total",558,553,5
"2011","Thurrock 018D","E01016006","Total",663,648,15
"2011","Thurrock 018E","E01016007","Total",530,522,8
"2011","Thurrock 018F","E01016008","Total",601,592,9
"2011","Thurrock 018G","E01016009","Total",664,652,12
"2011","Thurrock 018H","E01016010","Total",506,503,3
"2011","Thurrock 019A","E01015982","Total",915,895,20
"2011","Thurrock 019B","E01033610","Total",569,563,6
"2011","Thurrock 019C","E01033611","Total",658,637,21
"2011","Thurrock 019D","E01033613","Total",590,585,5
"2011","Thurrock 020A","E01015939","Total",562,557,5
"2011","Thurrock 020B","E01015941","Total",524,513,11
"2011","Thurrock 020C","E01015942","Total",569,563,6
"2011","Thurrock 020D","E01033612","Total",605,595,10
"2011","Thurrock 020E","E01033614","Total",621,613,8
"2011","Cambridge 001A","E01017975","Total",702,687,15
"2011","Cambridge 001B","E01017976","Total",650,636,14
"2011","Cambridge 001C","E01017977","Total",796,769,27
"2011","Cambridge 001D","E01017978","Total",667,657,10
"2011","Cambridge 001E","E01017979","Total",681,671,10
"2011","Cambridge 001F","E01017980","Total",507,498,9
"2011","Cambridge 002A","E01017949","Total",750,683,67
"2011","Cambridge 002B","E01017950","Total",587,568,19
"2011","Cambridge 002C","E01017951","Total",666,660,6
"2011","Cambridge 002D","E01017952","Total",693,684,9
"2011","Cambridge 002E","E01017953","Total",704,690,14
"2011","Cambridge 002F","E01017954","Total",614,601,13
"2011","Cambridge 003B","E01017971","Total",680,666,14
"2011","Cambridge 003C","E01017972","Total",699,676,23
"2011","Cambridge 003D","E01017973","Total",738,729,9
"2011","Cambridge 003E","E01017974","Total",718,694,24
"2011","Cambridge 003F","E01032792","Total",650,617,33
"2011","Cambridge 003G","E01032802","Total",691,656,35
"2011","Cambridge 004A","E01018006","Total",803,773,30
"2011","Cambridge 004B","E01018007","Total",602,585,17
"2011","Cambridge 004C","E01018008","Total",696,654,42
"2011","Cambridge 004D","E01018009","Total",884,833,51
"2011","Cambridge 004E","E01018010","Total",940,884,56
"2011","Cambridge 005A","E01017955","Total",667,647,20
"2011","Cambridge 005B","E01017956","Total",573,536,37
"2011","Cambridge 005C","E01017957","Total",534,507,27
"2011","Cambridge 005D","E01017958","Total",437,392,45
"2011","Cambridge 006A","E01017943","Total",772,740,32
"2011","Cambridge 006B","E01017944","Total",584,575,9
"2011","Cambridge 006C","E01017945","Total",806,768,38
"2011","Cambridge 006D","E01017946","Total",652,643,9
"2011","Cambridge 006E","E01017947","Total",691,682,9
"2011","Cambridge 006F","E01017948","Total",704,698,6
"2011","Cambridge 007C","E01017983","Total",981,906,75
"2011","Cambridge 007D","E01017984","Total",754,701,53
"2011","Cambridge 007E","E01017985","Total",754,706,48
"2011","Cambridge 007F","E01017986","Total",349,304,45
"2011","Cambridge 007G","E01032797","Total",829,755,74
"2011","Cambridge 008A","E01017987","Total",715,678,37
"2011","Cambridge 008B","E01017988","Total",579,557,22
"2011","Cambridge 008C","E01017989","Total",974,933,41
"2011","Cambridge 008D","E01017990","Total",620,598,22
"2011","Cambridge 008E","E01017991","Total",633,600,33
"2011","Cambridge 009A","E01017997","Total",979,957,22
"2011","Cambridge 009B","E01017998","Total",738,720,18
"2011","Cambridge 009C","E01017999","Total",717,696,21
"2011","Cambridge 009D","E01018000","Total",762,725,37
"2011","Cambridge 009E","E01018001","Total",782,759,23
"2011","Cambridge 010A","E01017965","Total",770,745,25
"2011","Cambridge 010B","E01017966","Total",1169,1107,62
"2011","Cambridge 010C","E01017967","Total",662,650,12
"2011","Cambridge 010D","E01017968","Total",685,668,17
"2011","Cambridge 010E","E01017969","Total",635,618,17
"2011","Cambridge 011A","E01017959","Total",710,686,24
"2011","Cambridge 011B","E01017960","Total",577,555,22
"2011","Cambridge 011C","E01017961","Total",591,583,8
"2011","Cambridge 011D","E01017962","Total",674,662,12
"2011","Cambridge 011E","E01017963","Total",678,678,0
"2011","Cambridge 011F","E01017964","Total",518,512,6
"2011","Cambridge 012A","E01018002","Total",796,754,42
"2011","Cambridge 012B","E01018003","Total",641,621,20
"2011","Cambridge 012D","E01018005","Total",829,772,57
"2011","Cambridge 012E","E01032794","Total",695,644,51
"2011","Cambridge 012F","E01032795","Total",735,681,54
"2011","Cambridge 013A","E01017992","Total",742,727,15
"2011","Cambridge 013B","E01017993","Total",1239,967,272
"2011","Cambridge 013C","E01017994","Total",646,640,6
"2011","Cambridge 013D","E01017995","Total",591,563,28
"2011","Cambridge 013E","E01017996","Total",548,527,21
"2011","East Cambridgeshire 001A","E01018042","Total",660,643,17
"2011","East Cambridgeshire 001B","E01018043","Total",884,836,48
"2011","East Cambridgeshire 001C","E01018044","Total",789,744,45
"2011","East Cambridgeshire 001D","E01018045","Total",551,526,25
"2011","East Cambridgeshire 001E","E01018046","Total",857,835,22
"2011","East Cambridgeshire 002A","E01018020","Total",603,586,17
"2011","East Cambridgeshire 002B","E01018021","Total",613,595,18
"2011","East Cambridgeshire 002C","E01018022","Total",613,592,21
"2011","East Cambridgeshire 002D","E01018055","Total",866,849,17
"2011","East Cambridgeshire 002E","E01018056","Total",811,792,19
"2011","East Cambridgeshire 003A","E01018027","Total",779,736,43
"2011","East Cambridgeshire 003C","E01018029","Total",1151,1105,46
"2011","East Cambridgeshire 003D","E01018032","Total",1076,1034,42
"2011","East Cambridgeshire 003E","E01018033","Total",951,911,40
"2011","East Cambridgeshire 003F","E01033426","Total",520,514,6
"2011","East Cambridgeshire 003G","E01033430","Total",612,597,15
"2011","East Cambridgeshire 004A","E01018024","Total",537,515,22
"2011","East Cambridgeshire 004B","E01018025","Total",775,722,53
"2011","East Cambridgeshire 004C","E01018026","Total",695,662,33
"2011","East Cambridgeshire 004D","E01018030","Total",423,416,7
"2011","East Cambridgeshire 004F","E01033425","Total",717,700,17
"2011","East Cambridgeshire 004G","E01033428","Total",645,627,18
"2011","East Cambridgeshire 005A","E01018036","Total",730,714,16
"2011","East Cambridgeshire 005B","E01018037","Total",556,542,14
"2011","East Cambridgeshire 005C","E01018038","Total",628,616,12
"2011","East Cambridgeshire 005D","E01018039","Total",544,533,11
"2011","East Cambridgeshire 005E","E01018053","Total",707,697,10
"2011","East Cambridgeshire 005F","E01018054","Total",949,922,27
"2011","East Cambridgeshire 006A","E01018047","Total",786,768,18
"2011","East Cambridgeshire 006C","E01018049","Total",711,677,34
"2011","East Cambridgeshire 006D","E01018050","Total",563,549,14
"2011","East Cambridgeshire 006E","E01018051","Total",699,687,12
"2011","East Cambridgeshire 006F","E01018052","Total",841,808,33
"2011","East Cambridgeshire 006G","E01033427","Total",488,482,6
"2011","East Cambridgeshire 006H","E01033429","Total",837,811,26
"2011","East Cambridgeshire 007A","E01018034","Total",636,616,20
"2011","East Cambridgeshire 007B","E01018035","Total",995,965,30
"2011","East Cambridgeshire 007C","E01018040","Total",520,502,18
"2011","East Cambridgeshire 007D","E01018041","Total",462,451,11
"2011","East Cambridgeshire 008A","E01018013","Total",762,739,23
"2011","East Cambridgeshire 008B","E01018014","Total",769,747,22
"2011","East Cambridgeshire 008C","E01018015","Total",581,563,18
"2011","East Cambridgeshire 008D","E01018016","Total",592,582,10
"2011","East Cambridgeshire 009A","E01018011","Total",1025,1003,22
"2011","East Cambridgeshire 009B","E01018012","Total",583,563,20
"2011","East Cambridgeshire 009C","E01018057","Total",858,827,31
"2011","East Cambridgeshire 011A","E01018017","Total",621,599,22
"2011","East Cambridgeshire 011B","E01018019","Total",458,444,14
"2011","East Cambridgeshire 011C","E01018023","Total",956,919,37
"2011","East Cambridgeshire 011D","E01032611","Total",775,751,24
"2011","Fenland 001A","E01018094","Total",789,778,11
"2011","Fenland 001B","E01018095","Total",693,656,37
"2011","Fenland 001C","E01018096","Total",757,730,27
"2011","Fenland 001D","E01018097","Total",625,611,14
"2011","Fenland 002A","E01018063","Total",982,950,32
"2011","Fenland 002B","E01018073","Total",945,926,19
"2011","Fenland 002C","E01018107","Total",651,641,10
"2011","Fenland 002D","E01018108","Total",802,776,26
"2011","Fenland 002E","E01018109","Total",803,773,30
"2011","Fenland 003A","E01018069","Total",757,744,13
"2011","Fenland 003B","E01018070","Total",774,748,26
"2011","Fenland 003C","E01018071","Total",810,787,23
"2011","Fenland 003E","E01018093","Total",1078,1008,70
"2011","Fenland 003F","E01018103","Total",491,469,22
"2011","Fenland 003G","E01018104","Total",521,511,10
"2011","Fenland 003H","E01033111","Total",684,656,28
"2011","Fenland 003I","E01033112","Total",675,594,81
"2011","Fenland 004A","E01018066","Total",652,636,16
"2011","Fenland 004B","E01018067","Total",785,764,21
"2011","Fenland 004C","E01018068","Total",625,594,31
"2011","Fenland 004D","E01018090","Total",784,740,44
"2011","Fenland 004E","E01018091","Total",607,588,19
"2011","Fenland 004F","E01018092","Total",755,728,27
"2011","Fenland 005A","E01018081","Total",601,579,22
"2011","Fenland 005B","E01018082","Total",833,811,22
"2011","Fenland 005C","E01018083","Total",788,772,16
"2011","Fenland 005D","E01018084","Total",920,904,16
"2011","Fenland 006A","E01018064","Total",860,836,24
"2011","Fenland 006B","E01018072","Total",690,669,21
"2011","Fenland 006C","E01018074","Total",536,522,14
"2011","Fenland 006D","E01018075","Total",530,525,5
"2011","Fenland 006E","E01018098","Total",618,593,25
"2011","Fenland 006F","E01018099","Total",538,524,14
"2011","Fenland 006G","E01018100","Total",642,600,42
"2011","Fenland 006H","E01018101","Total",633,592,41
"2011","Fenland 007A","E01018077","Total",925,873,52
"2011","Fenland 007B","E01018078","Total",823,805,18
"2011","Fenland 007C","E01018079","Total",812,789,23
"2011","Fenland 007D","E01018080","Total",1010,977,33
"2011","Fenland 008A","E01018058","Total",717,700,17
"2011","Fenland 008B","E01018059","Total",576,550,26
"2011","Fenland 008C","E01018060","Total",791,753,38
"2011","Fenland 008D","E01018061","Total",525,506,19
"2011","Fenland 009A","E01018085","Total",713,701,12
"2011","Fenland 009B","E01018086","Total",733,723,10
"2011","Fenland 009C","E01018087","Total",978,941,37
"2011","Fenland 009D","E01018088","Total",711,703,8
"2011","Fenland 010A","E01018065","Total",953,920,33
"2011","Fenland 010B","E01018076","Total",912,866,46
"2011","Fenland 010C","E01018111","Total",979,941,38
"2011","Fenland 011A","E01018062","Total",1087,1056,31
"2011","Fenland 011B","E01018102","Total",1236,1148,88
"2011","Fenland 011C","E01018105","Total",559,544,15
"2011","Fenland 011D","E01018106","Total",712,693,19
"2011","Fenland 011E","E01018110","Total",1138,1096,42
"2011","Huntingdonshire 001A","E01018212","Total",695,679,16
"2011","Huntingdonshire 001B","E01018213","Total",770,741,29
"2011","Huntingdonshire 001C","E01018214","Total",829,798,31
"2011","Huntingdonshire 001D","E01018215","Total",572,559,13
"2011","Huntingdonshire 001E","E01018216","Total",957,934,23
"2011","Huntingdonshire 001F","E01018217","Total",753,737,16
"2011","Huntingdonshire 002A","E01018127","Total",648,633,15
"2011","Huntingdonshire 002B","E01018128","Total",551,511,40
"2011","Huntingdonshire 002C","E01018200","Total",655,637,18
"2011","Huntingdonshire 002D","E01018201","Total",615,600,15
"2011","Huntingdonshire 003A","E01018156","Total",700,678,22
"2011","Huntingdonshire 003B","E01018157","Total",812,795,17
"2011","Huntingdonshire 003C","E01018158","Total",916,844,72
"2011","Huntingdonshire 003D","E01018159","Total",576,553,23
"2011","Huntingdonshire 003E","E01018160","Total",708,689,19
"2011","Huntingdonshire 004A","E01018191","Total",485,473,12
"2011","Huntingdonshire 004B","E01018192","Total",573,556,17
"2011","Huntingdonshire 004C","E01018193","Total",511,492,19
"2011","Huntingdonshire 004D","E01018194","Total",602,581,21
"2011","Huntingdonshire 004E","E01018195","Total",547,539,8
"2011","Huntingdonshire 005A","E01018208","Total",696,674,22
"2011","Huntingdonshire 005B","E01018209","Total",617,598,19
"2011","Huntingdonshire 005C","E01018210","Total",614,592,22
"2011","Huntingdonshire 005D","E01018211","Total",712,689,23
"2011","Huntingdonshire 006A","E01018196","Total",524,510,14
"2011","Huntingdonshire 006B","E01018197","Total",670,656,14
"2011","Huntingdonshire 006C","E01018198","Total",699,674,25
"2011","Huntingdonshire 006D","E01018199","Total",627,604,23
"2011","Huntingdonshire 006E","E01018206","Total",829,714,115
"2011","Huntingdonshire 006F","E01018207","Total",642,617,25
"2011","Huntingdonshire 007A","E01018121","Total",523,513,10
"2011","Huntingdonshire 007B","E01018122","Total",501,494,7
"2011","Huntingdonshire 007C","E01018123","Total",659,641,18
"2011","Huntingdonshire 007D","E01018124","Total",778,766,12
"2011","Huntingdonshire 008A","E01018143","Total",702,692,10
"2011","Huntingdonshire 008B","E01018144","Total",571,565,6
"2011","Huntingdonshire 008C","E01018145","Total",487,481,6
"2011","Huntingdonshire 008D","E01018146","Total",773,764,9
"2011","Huntingdonshire 008E","E01018147","Total",594,579,15
"2011","Huntingdonshire 009A","E01018139","Total",588,571,17
"2011","Huntingdonshire 009B","E01018140","Total",514,507,7
"2011","Huntingdonshire 009C","E01018141","Total",691,682,9
"2011","Huntingdonshire 009D","E01018142","Total",639,626,13
"2011","Huntingdonshire 010B","E01018113","Total",597,583,14
"2011","Huntingdonshire 010D","E01018116","Total",544,492,52
"2011","Huntingdonshire 010E","E01018117","Total",781,761,20
"2011","Huntingdonshire 010F","E01018118","Total",803,787,16
"2011","Huntingdonshire 010G","E01033433","Total",819,808,11
"2011","Huntingdonshire 011A","E01018161","Total",590,578,12
"2011","Huntingdonshire 011B","E01018162","Total",622,619,3
"2011","Huntingdonshire 011C","E01018163","Total",613,597,16
"2011","Huntingdonshire 011D","E01018164","Total",545,534,11
"2011","Huntingdonshire 011E","E01018165","Total",572,557,15
"2011","Huntingdonshire 011F","E01018170","Total",615,601,14
"2011","Huntingdonshire 011G","E01018171","Total",591,586,5
"2011","Huntingdonshire 012A","E01018138","Total",972,924,48
"2011","Huntingdonshire 012B","E01018148","Total",917,896,21
"2011","Huntingdonshire 012C","E01018149","Total",553,539,14
"2011","Huntingdonshire 012D","E01018150","Total",688,665,23
"2011","Huntingdonshire 012E","E01018151","Total",976,905,71
"2011","Huntingdonshire 013A","E01018166","Total",666,652,14
"2011","Huntingdonshire 013B","E01018167","Total",596,584,12
"2011","Huntingdonshire 013C","E01018168","Total",1137,1081,56
"2011","Huntingdonshire 013D","E01018169","Total",630,621,9
"2011","Huntingdonshire 014A","E01018131","Total",647,634,13
"2011","Huntingdonshire 014B","E01018132","Total",836,809,27
"2011","Huntingdonshire 014C","E01018133","Total",679,662,17
"2011","Huntingdonshire 014D","E01018134","Total",781,774,7
"2011","Huntingdonshire 015A","E01018125","Total",630,605,25
"2011","Huntingdonshire 015B","E01018126","Total",668,631,37
"2011","Huntingdonshire 015C","E01018152","Total",604,598,6
"2011","Huntingdonshire 015D","E01018153","Total",794,757,37
"2011","Huntingdonshire 016A","E01018129","Total",679,649,30
"2011","Huntingdonshire 016B","E01018130","Total",714,698,16
"2011","Huntingdonshire 016C","E01018202","Total",658,639,19
"2011","Huntingdonshire 016D","E01018203","Total",636,621,15
"2011","Huntingdonshire 016E","E01018204","Total",551,541,10
"2011","Huntingdonshire 016F","E01018205","Total",877,826,51
"2011","Huntingdonshire 017A","E01018115","Total",582,567,15
"2011","Huntingdonshire 017B","E01018119","Total",657,638,19
"2011","Huntingdonshire 017C","E01018120","Total",770,757,13
"2011","Huntingdonshire 017D","E01018137","Total",706,695,11
"2011","Huntingdonshire 018A","E01018135","Total",1200,1151,49
"2011","Huntingdonshire 018B","E01018136","Total",712,690,22
"2011","Huntingdonshire 018C","E01018154","Total",748,720,28
"2011","Huntingdonshire 018D","E01018155","Total",650,641,9
"2011","Huntingdonshire 019A","E01018187","Total",1076,1022,54
"2011","Huntingdonshire 019B","E01018188","Total",646,634,12
"2011","Huntingdonshire 019C","E01018189","Total",502,502,0
"2011","Huntingdonshire 019D","E01018190","Total",634,627,7
"2011","Huntingdonshire 020A","E01018172","Total",644,625,19
"2011","Huntingdonshire 020B","E01018173","Total",524,509,15
"2011","Huntingdonshire 020C","E01018174","Total",703,689,14
"2011","Huntingdonshire 020D","E01018175","Total",560,549,11
"2011","Huntingdonshire 020E","E01018176","Total",486,484,2
"2011","Huntingdonshire 021A","E01018181","Total",1187,1167,20
"2011","Huntingdonshire 021B","E01018182","Total",597,583,14
"2011","Huntingdonshire 021C","E01018183","Total",631,618,13
"2011","Huntingdonshire 021D","E01018184","Total",512,508,4
"2011","Huntingdonshire 021E","E01018185","Total",749,724,25
"2011","Huntingdonshire 021F","E01018186","Total",743,734,9
"2011","Huntingdonshire 022A","E01018177","Total",664,647,17
"2011","Huntingdonshire 022B","E01018178","Total",637,629,8
"2011","Huntingdonshire 022C","E01018179","Total",608,598,10
"2011","Huntingdonshire 022D","E01018180","Total",580,573,7
"2011","South Cambridgeshire 001A","E01018304","Total",803,781,22
"2011","South Cambridgeshire 001B","E01018305","Total",544,539,5
"2011","South Cambridgeshire 001C","E01018306","Total",616,583,33
"2011","South Cambridgeshire 001D","E01018307","Total",863,847,16
"2011","South Cambridgeshire 002A","E01018233","Total",681,658,23
"2011","South Cambridgeshire 002B","E01018234","Total",679,655,24
"2011","South Cambridgeshire 002C","E01018235","Total",708,702,6
"2011","South Cambridgeshire 002D","E01018236","Total",661,643,18
"2011","South Cambridgeshire 003A","E01018237","Total",649,624,25
"2011","South Cambridgeshire 003B","E01018266","Total",1146,1095,51
"2011","South Cambridgeshire 003C","E01018284","Total",536,522,14
"2011","South Cambridgeshire 003D","E01018285","Total",477,474,3
"2011","South Cambridgeshire 004A","E01018298","Total",552,493,59
"2011","South Cambridgeshire 004B","E01018299","Total",767,731,36
"2011","South Cambridgeshire 004C","E01018300","Total",518,501,17
"2011","South Cambridgeshire 004D","E01018301","Total",581,565,16
"2011","South Cambridgeshire 005A","E01018221","Total",756,749,7
"2011","South Cambridgeshire 005B","E01018222","Total",598,591,7
"2011","South Cambridgeshire 005C","E01018223","Total",817,799,18
"2011","South Cambridgeshire 006A","E01018257","Total",609,585,24
"2011","South Cambridgeshire 006B","E01018258","Total",698,683,15
"2011","South Cambridgeshire 006C","E01018259","Total",549,534,15
"2011","South Cambridgeshire 006D","E01018260","Total",793,772,21
"2011","South Cambridgeshire 006F","E01018262","Total",562,549,13
"2011","South Cambridgeshire 006G","E01033120","Total",546,530,16
"2011","South Cambridgeshire 006H","E01033121","Total",613,558,55
"2011","South Cambridgeshire 007A","E01018272","Total",517,503,14
"2011","South Cambridgeshire 007B","E01018273","Total",702,683,19
"2011","South Cambridgeshire 007C","E01018274","Total",717,703,14
"2011","South Cambridgeshire 007D","E01018297","Total",753,737,16
"2011","South Cambridgeshire 009A","E01018224","Total",614,591,23
"2011","South Cambridgeshire 009B","E01018225","Total",513,494,19
"2011","South Cambridgeshire 009C","E01018248","Total",731,712,19
"2011","South Cambridgeshire 009D","E01018249","Total",477,453,24
"2011","South Cambridgeshire 009E","E01018250","Total",536,522,14
"2011","South Cambridgeshire 010A","E01018231","Total",1001,972,29
"2011","South Cambridgeshire 010B","E01018232","Total",975,948,27
"2011","South Cambridgeshire 010C","E01018251","Total",495,484,11
"2011","South Cambridgeshire 010D","E01018252","Total",540,533,7
"2011","South Cambridgeshire 010E","E01018255","Total",469,458,11
"2011","South Cambridgeshire 011A","E01018242","Total",575,564,11
"2011","South Cambridgeshire 011B","E01018243","Total",680,659,21
"2011","South Cambridgeshire 011C","E01018244","Total",680,662,18
"2011","South Cambridgeshire 011D","E01018286","Total",683,667,16
"2011","South Cambridgeshire 011E","E01018287","Total",604,586,18
"2011","South Cambridgeshire 011F","E01018296","Total",477,464,13
"2011","South Cambridgeshire 012A","E01018292","Total",574,556,18
"2011","South Cambridgeshire 012B","E01018293","Total",658,628,30
"2011","South Cambridgeshire 012C","E01018294","Total",865,844,21
"2011","South Cambridgeshire 012D","E01018295","Total",660,645,15
"2011","South Cambridgeshire 013A","E01018245","Total",709,694,15
"2011","South Cambridgeshire 013B","E01018246","Total",733,714,19
"2011","South Cambridgeshire 013C","E01018247","Total",663,637,26
"2011","South Cambridgeshire 013D","E01018275","Total",995,974,21
"2011","South Cambridgeshire 014A","E01018240","Total",492,483,9
"2011","South Cambridgeshire 014B","E01018253","Total",446,428,18
"2011","South Cambridgeshire 014C","E01018254","Total",575,563,12
"2011","South Cambridgeshire 014D","E01018256","Total",639,626,13
"2011","South Cambridgeshire 014E","E01018291","Total",506,492,14
"2011","South Cambridgeshire 015A","E01018279","Total",693,673,20
"2011","South Cambridgeshire 015B","E01018280","Total",622,611,11
"2011","South Cambridgeshire 015C","E01018281","Total",701,692,9
"2011","South Cambridgeshire 015D","E01018282","Total",533,522,11
"2011","South Cambridgeshire 015E","E01018283","Total",495,494,1
"2011","South Cambridgeshire 016A","E01018218","Total",734,718,16
"2011","South Cambridgeshire 016B","E01018219","Total",574,563,11
"2011","South Cambridgeshire 016C","E01018220","Total",610,596,14
"2011","South Cambridgeshire 016D","E01018263","Total",620,598,22
"2011","South Cambridgeshire 016E","E01018264","Total",663,653,10
"2011","South Cambridgeshire 016F","E01018265","Total",725,703,22
"2011","South Cambridgeshire 017A","E01018238","Total",598,578,20
"2011","South Cambridgeshire 017B","E01018239","Total",565,546,19
"2011","South Cambridgeshire 017C","E01018288","Total",514,494,20
"2011","South Cambridgeshire 017D","E01018289","Total",499,472,27
"2011","South Cambridgeshire 017E","E01018302","Total",628,614,14
"2011","South Cambridgeshire 017F","E01018303","Total",530,511,19
"2011","South Cambridgeshire 018A","E01018241","Total",500,485,15
"2011","South Cambridgeshire 018B","E01018267","Total",1025,1003,22
"2011","South Cambridgeshire 018C","E01018268","Total",751,733,18
"2011","South Cambridgeshire 018D","E01018269","Total",606,597,9
"2011","South Cambridgeshire 018E","E01018270","Total",452,445,7
"2011","South Cambridgeshire 018F","E01018271","Total",590,566,24
"2011","South Cambridgeshire 019A","E01018226","Total",503,474,29
"2011","South Cambridgeshire 019B","E01018227","Total",764,747,17
"2011","South Cambridgeshire 019C","E01018228","Total",677,663,14
"2011","South Cambridgeshire 019D","E01018290","Total",1010,987,23
"2011","South Cambridgeshire 020A","E01033113","Total",477,452,25
"2011","South Cambridgeshire 020B","E01033114","Total",573,561,12
"2011","South Cambridgeshire 020C","E01033115","Total",475,467,8
"2011","South Cambridgeshire 020D","E01033117","Total",476,468,8
"2011","South Cambridgeshire 020E","E01033119","Total",733,660,73
"2011","South Cambridgeshire 021A","E01018276","Total",600,583,17
"2011","South Cambridgeshire 021B","E01018277","Total",730,709,21
"2011","South Cambridgeshire 021C","E01018278","Total",680,664,16
"2011","South Cambridgeshire 021D","E01033116","Total",663,641,22
"2011","South Cambridgeshire 021E","E01033118","Total",586,575,11
"2011","Basildon 001A","E01021237","Total",526,518,8
"2011","Basildon 001B","E01021238","Total",522,520,2
"2011","Basildon 001C","E01021242","Total",489,482,7
"2011","Basildon 001D","E01021250","Total",640,632,8
"2011","Basildon 001E","E01021251","Total",613,603,10
"2011","Basildon 002A","E01021245","Total",646,638,8
"2011","Basildon 002B","E01021246","Total",667,652,15
"2011","Basildon 002C","E01021248","Total",630,620,10
"2011","Basildon 002D","E01021249","Total",629,622,7
"2011","Basildon 002E","E01021252","Total",659,637,22
"2011","Basildon 003A","E01021239","Total",539,522,17
"2011","Basildon 003B","E01021240","Total",820,787,33
"2011","Basildon 003C","E01021241","Total",664,650,14
"2011","Basildon 003D","E01021243","Total",676,668,8
"2011","Basildon 003E","E01021247","Total",672,657,15
"2011","Basildon 004A","E01021244","Total",656,633,23
"2011","Basildon 004B","E01021253","Total",690,675,15
"2011","Basildon 004C","E01021255","Total",649,632,17
"2011","Basildon 004D","E01021256","Total",616,608,8
"2011","Basildon 004E","E01021258","Total",804,785,19
"2011","Basildon 005A","E01021334","Total",699,690,9
"2011","Basildon 005B","E01021336","Total",764,740,24
"2011","Basildon 005C","E01021338","Total",629,615,14
"2011","Basildon 005D","E01021339","Total",660,649,11
"2011","Basildon 006A","E01021264","Total",534,519,15
"2011","Basildon 006B","E01021329","Total",708,691,17
"2011","Basildon 006C","E01021330","Total",669,656,13
"2011","Basildon 006D","E01021332","Total",619,608,11
"2011","Basildon 006E","E01021333","Total",650,637,13
"2011","Basildon 007A","E01021335","Total",521,515,6
"2011","Basildon 007B","E01021337","Total",632,615,17
"2011","Basildon 007C","E01021340","Total",674,659,15
"2011","Basildon 007D","E01021341","Total",671,653,18
"2011","Basildon 007E","E01021345","Total",767,764,3
"2011","Basildon 008A","E01021331","Total",660,639,21
"2011","Basildon 008B","E01021342","Total",729,714,15
"2011","Basildon 008C","E01021343","Total",753,746,7
"2011","Basildon 008D","E01021344","Total",872,859,13
"2011","Basildon 008E","E01021346","Total",865,856,9
"2011","Basildon 009A","E01021254","Total",568,550,18
"2011","Basildon 009B","E01021257","Total",631,615,16
"2011","Basildon 009C","E01021259","Total",646,636,10
"2011","Basildon 009D","E01021260","Total",819,803,16
"2011","Basildon 010A","E01021261","Total",691,687,4
"2011","Basildon 010B","E01021262","Total",754,747,7
"2011","Basildon 010C","E01021263","Total",795,789,6
"2011","Basildon 010D","E01021274","Total",815,806,9
"2011","Basildon 010E","E01021279","Total",668,662,6
"2011","Basildon 011A","E01021301","Total",629,618,11
"2011","Basildon 011B","E01021303","Total",599,592,7
"2011","Basildon 011C","E01021307","Total",594,586,8
"2011","Basildon 011D","E01021308","Total",496,489,7
"2011","Basildon 011E","E01021309","Total",627,610,17
"2011","Basildon 011F","E01021312","Total",577,559,18
"2011","Basildon 012A","E01021265","Total",640,630,10
"2011","Basildon 012B","E01021267","Total",774,766,8
"2011","Basildon 012C","E01021269","Total",659,653,6
"2011","Basildon 012D","E01021270","Total",652,625,27
"2011","Basildon 012E","E01021272","Total",657,650,7
"2011","Basildon 013A","E01021271","Total",727,685,42
"2011","Basildon 013B","E01021302","Total",630,623,7
"2011","Basildon 013C","E01021304","Total",624,612,12
"2011","Basildon 013D","E01021305","Total",619,613,6
"2011","Basildon 013E","E01021306","Total",618,609,9
"2011","Basildon 014A","E01021273","Total",776,763,13
"2011","Basildon 014B","E01021275","Total",681,676,5
"2011","Basildon 014C","E01021276","Total",700,690,10
"2011","Basildon 014D","E01021277","Total",672,664,8
"2011","Basildon 014E","E01021278","Total",799,790,9
"2011","Basildon 015A","E01021266","Total",740,735,5
"2011","Basildon 015B","E01021268","Total",659,651,8
"2011","Basildon 015C","E01021318","Total",954,925,29
"2011","Basildon 015D","E01021320","Total",658,652,6
"2011","Basildon 015E","E01021321","Total",700,697,3
"2011","Basildon 016A","E01021286","Total",716,706,10
"2011","Basildon 016B","E01021288","Total",611,606,5
"2011","Basildon 016C","E01021289","Total",715,707,8
"2011","Basildon 016D","E01021290","Total",672,669,3
"2011","Basildon 016E","E01021291","Total",797,784,13
"2011","Basildon 017A","E01021287","Total",619,613,6
"2011","Basildon 017B","E01021292","Total",641,632,9
"2011","Basildon 017C","E01021293","Total",745,736,9
"2011","Basildon 017D","E01021298","Total",664,656,8
"2011","Basildon 017E","E01021319","Total",728,717,11
"2011","Basildon 018A","E01021313","Total",597,588,9
"2011","Basildon 018B","E01021314","Total",583,572,11
"2011","Basildon 018C","E01021315","Total",685,679,6
"2011","Basildon 018D","E01021316","Total",714,702,12
"2011","Basildon 018E","E01021317","Total",673,668,5
"2011","Basildon 019A","E01021322","Total",635,627,8
"2011","Basildon 019B","E01021323","Total",677,673,4
"2011","Basildon 019C","E01021324","Total",683,667,16
"2011","Basildon 019D","E01021325","Total",651,642,9
"2011","Basildon 019E","E01021327","Total",772,741,31
"2011","Basildon 020A","E01021294","Total",654,645,9
"2011","Basildon 020B","E01021295","Total",709,705,4
"2011","Basildon 020C","E01021296","Total",856,772,84
"2011","Basildon 020D","E01021297","Total",703,693,10
"2011","Basildon 020E","E01021299","Total",606,600,6
"2011","Basildon 021A","E01021280","Total",634,627,7
"2011","Basildon 021B","E01021281","Total",603,598,5
"2011","Basildon 021C","E01021282","Total",629,619,10
"2011","Basildon 021D","E01021283","Total",655,647,8
"2011","Basildon 021E","E01021284","Total",585,579,6
"2011","Basildon 021F","E01021285","Total",539,532,7
"2011","Basildon 022A","E01021300","Total",867,852,15
"2011","Basildon 022B","E01021310","Total",712,700,12
"2011","Basildon 022C","E01021311","Total",618,613,5
"2011","Basildon 022D","E01021326","Total",724,720,4
"2011","Basildon 022E","E01021328","Total",636,635,1
"2011","Braintree 001A","E01021375","Total",485,473,12
"2011","Braintree 001B","E01021376","Total",563,556,7
"2011","Braintree 001C","E01021414","Total",915,884,31
"2011","Braintree 001D","E01021430","Total",852,836,16
"2011","Braintree 002A","E01021398","Total",649,627,22
"2011","Braintree 002B","E01021406","Total",993,952,41
"2011","Braintree 002C","E01021407","Total",966,921,45
"2011","Braintree 003A","E01021382","Total",543,524,19
"2011","Braintree 003B","E01021397","Total",769,742,27
"2011","Braintree 003C","E01021399","Total",695,675,20
"2011","Braintree 003D","E01021400","Total",771,747,24
"2011","Braintree 004A","E01021387","Total",1077,1015,62
"2011","Braintree 004B","E01021388","Total",743,720,23
"2011","Braintree 004C","E01021391","Total",696,692,4
"2011","Braintree 004D","E01021392","Total",788,754,34
"2011","Braintree 004E","E01021393","Total",662,650,12
"2011","Braintree 005A","E01021404","Total",930,892,38
"2011","Braintree 005B","E01021411","Total",556,536,20
"2011","Braintree 005C","E01021412","Total",625,595,30
"2011","Braintree 005D","E01021413","Total",549,525,24
"2011","Braintree 006A","E01021389","Total",747,719,28
"2011","Braintree 006B","E01021390","Total",675,664,11
"2011","Braintree 006C","E01021408","Total",727,699,28
"2011","Braintree 006D","E01021409","Total",744,720,24
"2011","Braintree 006E","E01021410","Total",743,719,24
"2011","Braintree 007A","E01021349","Total",495,491,4
"2011","Braintree 007B","E01021351","Total",569,559,10
"2011","Braintree 007C","E01021352","Total",598,589,9
"2011","Braintree 007D","E01021355","Total",856,825,31
"2011","Braintree 007E","E01021356","Total",557,545,12
"2011","Braintree 007F","E01021381","Total",535,513,22
"2011","Braintree 008A","E01021354","Total",555,548,7
"2011","Braintree 008B","E01021357","Total",648,636,12
"2011","Braintree 008C","E01021358","Total",937,919,18
"2011","Braintree 008D","E01021359","Total",877,866,11
"2011","Braintree 009A","E01021350","Total",737,712,25
"2011","Braintree 009B","E01021353","Total",816,807,9
"2011","Braintree 009D","E01021365","Total",1196,1133,63
"2011","Braintree 009E","E01033458","Total",707,691,16
"2011","Braintree 009F","E01033459","Total",919,876,43
"2011","Braintree 010A","E01021364","Total",698,677,21
"2011","Braintree 010B","E01021366","Total",605,597,8
"2011","Braintree 010C","E01021383","Total",721,712,9
"2011","Braintree 010D","E01021405","Total",914,898,16
"2011","Braintree 011A","E01021368","Total",703,682,21
"2011","Braintree 011B","E01021370","Total",732,717,15
"2011","Braintree 011C","E01021372","Total",778,769,9
"2011","Braintree 011D","E01021373","Total",1082,1041,41
"2011","Braintree 011E","E01021374","Total",633,600,33
"2011","Braintree 012A","E01021360","Total",793,781,12
"2011","Braintree 012B","E01021361","Total",664,647,17
"2011","Braintree 012C","E01021367","Total",579,572,7
"2011","Braintree 012D","E01021369","Total",1093,1078,15
"2011","Braintree 012E","E01021380","Total",999,963,36
"2011","Braintree 013A","E01021347","Total",938,918,20
"2011","Braintree 013B","E01021371","Total",711,698,13
"2011","Braintree 013C","E01021384","Total",861,845,16
"2011","Braintree 013D","E01021385","Total",523,515,8
"2011","Braintree 013E","E01021386","Total",571,564,7
"2011","Braintree 014A","E01021377","Total",761,729,32
"2011","Braintree 014B","E01021378","Total",831,792,39
"2011","Braintree 014C","E01021379","Total",728,707,21
"2011","Braintree 014D","E01021401","Total",681,661,20
"2011","Braintree 014E","E01021402","Total",842,824,18
"2011","Braintree 014F","E01021403","Total",636,626,10
"2011","Braintree 015A","E01021362","Total",591,577,14
"2011","Braintree 015B","E01021417","Total",671,657,14
"2011","Braintree 015C","E01021418","Total",567,549,18
"2011","Braintree 015D","E01021419","Total",722,712,10
"2011","Braintree 015E","E01021426","Total",596,588,8
"2011","Braintree 015F","E01021428","Total",636,623,13
"2011","Braintree 016A","E01021423","Total",602,596,6
"2011","Braintree 016B","E01021425","Total",600,596,4
"2011","Braintree 016C","E01021427","Total",542,538,4
"2011","Braintree 016D","E01021429","Total",530,528,2
"2011","Braintree 017A","E01021415","Total",787,743,44
"2011","Braintree 017B","E01021416","Total",806,769,37
"2011","Braintree 017C","E01021420","Total",745,730,15
"2011","Braintree 017E","E01021422","Total",795,787,8
"2011","Braintree 017F","E01033460","Total",583,567,16
"2011","Braintree 017G","E01033461","Total",592,580,12
"2011","Braintree 017H","E01033462","Total",492,479,13
"2011","Braintree 018A","E01021348","Total",654,640,14
"2011","Braintree 018B","E01021394","Total",694,664,30
"2011","Braintree 018C","E01021395","Total",626,614,12
"2011","Braintree 018D","E01021396","Total",546,535,11
"2011","Braintree 018E","E01021424","Total",824,811,13
"2011","Brentwood 001A","E01021441","Total",590,573,17
"2011","Brentwood 001B","E01021442","Total",523,514,9
"2011","Brentwood 001C","E01021443","Total",586,541,45
"2011","Brentwood 001D","E01021444","Total",667,633,34
"2011","Brentwood 001E","E01021469","Total",489,462,27
"2011","Brentwood 001F","E01021470","Total",433,406,27
"2011","Brentwood 001G","E01021471","Total",627,613,14
"2011","Brentwood 002A","E01021457","Total",655,611,44
"2011","Brentwood 002B","E01021458","Total",831,777,54
"2011","Brentwood 002C","E01021459","Total",533,525,8
"2011","Brentwood 002D","E01021460","Total",699,675,24
"2011","Brentwood 003A","E01021448","Total",661,640,21
"2011","Brentwood 003B","E01021449","Total",651,638,13
"2011","Brentwood 003C","E01021450","Total",813,793,20
"2011","Brentwood 003D","E01021451","Total",655,623,32
"2011","Brentwood 003E","E01021452","Total",632,620,12
"2011","Brentwood 004A","E01021431","Total",649,633,16
"2011","Brentwood 004B","E01021432","Total",727,698,29
"2011","Brentwood 004C","E01021434","Total",533,512,21
"2011","Brentwood 004D","E01021461","Total",659,620,39
"2011","Brentwood 004E","E01021464","Total",624,599,25
"2011","Brentwood 005A","E01021447","Total",999,966,33
"2011","Brentwood 005B","E01021453","Total",537,519,18
"2011","Brentwood 005C","E01021455","Total",538,519,19
"2011","Brentwood 005D","E01021465","Total",894,816,78
"2011","Brentwood 005E","E01021466","Total",678,656,22
"2011","Brentwood 005F","E01021467","Total",690,668,22
"2011","Brentwood 006A","E01021438","Total",804,784,20
"2011","Brentwood 006B","E01021462","Total",589,568,21
"2011","Brentwood 006C","E01021463","Total",652,629,23
"2011","Brentwood 006D","E01021468","Total",828,768,60
"2011","Brentwood 007A","E01021433","Total",979,919,60
"2011","Brentwood 007B","E01021436","Total",1249,1138,111
"2011","Brentwood 007C","E01021439","Total",1218,1149,69
"2011","Brentwood 007E","E01021475","Total",689,666,23
"2011","Brentwood 007F","E01033063","Total",601,569,32
"2011","Brentwood 007G","E01033064","Total",728,686,42
"2011","Brentwood 008A","E01021435","Total",804,777,27
"2011","Brentwood 008B","E01021437","Total",760,728,32
"2011","Brentwood 008C","E01021472","Total",788,725,63
"2011","Brentwood 008D","E01021473","Total",544,517,27
"2011","Brentwood 008E","E01021474","Total",629,613,16
"2011","Brentwood 009A","E01021445","Total",875,842,33
"2011","Brentwood 009B","E01021446","Total",698,671,27
"2011","Brentwood 009C","E01021454","Total",544,536,8
"2011","Brentwood 009D","E01021456","Total",536,511,25
"2011","Castle Point 001A","E01021513","Total",651,643,8
"2011","Castle Point 001B","E01021514","Total",626,610,16
"2011","Castle Point 001C","E01021515","Total",496,493,3
"2011","Castle Point 001D","E01021525","Total",691,668,23
"2011","Castle Point 001E","E01021527","Total",686,674,12
"2011","Castle Point 002A","E01021509","Total",672,649,23
"2011","Castle Point 002B","E01021510","Total",692,670,22
"2011","Castle Point 002C","E01021511","Total",540,533,7
"2011","Castle Point 002D","E01021528","Total",613,586,27
"2011","Castle Point 002E","E01021531","Total",566,556,10
"2011","Castle Point 003A","E01021476","Total",790,770,20
"2011","Castle Point 003B","E01021477","Total",647,629,18
"2011","Castle Point 003C","E01021478","Total",681,666,15
"2011","Castle Point 003D","E01021516","Total",558,542,16
"2011","Castle Point 004A","E01021479","Total",598,592,6
"2011","Castle Point 004B","E01021481","Total",572,562,10
"2011","Castle Point 004C","E01021483","Total",719,688,31
"2011","Castle Point 004D","E01021512","Total",666,648,18
"2011","Castle Point 004E","E01021526","Total",658,650,8
"2011","Castle Point 005A","E01021517","Total",742,711,31
"2011","Castle Point 005B","E01021519","Total",653,636,17
"2011","Castle Point 005C","E01021530","Total",632,614,18
"2011","Castle Point 005D","E01021532","Total",661,645,16
"2011","Castle Point 006A","E01021482","Total",624,607,17
"2011","Castle Point 006B","E01021518","Total",1042,940,102
"2011","Castle Point 006C","E01021520","Total",685,671,14
"2011","Castle Point 006D","E01021529","Total",651,646,5
"2011","Castle Point 007A","E01021480","Total",722,706,16
"2011","Castle Point 007B","E01021521","Total",618,607,11
"2011","Castle Point 007C","E01021522","Total",753,711,42
"2011","Castle Point 007D","E01021523","Total",609,602,7
"2011","Castle Point 007E","E01021524","Total",654,644,10
"2011","Castle Point 008A","E01021487","Total",609,593,16
"2011","Castle Point 008B","E01021494","Total",604,598,6
"2011","Castle Point 008C","E01021504","Total",512,503,9
"2011","Castle Point 008D","E01021505","Total",501,496,5
"2011","Castle Point 008E","E01021506","Total",528,519,9
"2011","Castle Point 009A","E01021492","Total",772,761,11
"2011","Castle Point 009B","E01021493","Total",718,702,16
"2011","Castle Point 009C","E01021495","Total",1188,1141,47
"2011","Castle Point 009D","E01021496","Total",615,590,25
"2011","Castle Point 010A","E01021485","Total",507,494,13
"2011","Castle Point 010B","E01021486","Total",477,462,15
"2011","Castle Point 010C","E01021488","Total",645,611,34
"2011","Castle Point 010D","E01021503","Total",551,519,32
"2011","Castle Point 010E","E01021507","Total",629,619,10
"2011","Castle Point 010F","E01021508","Total",449,442,7
"2011","Castle Point 011A","E01021484","Total",606,589,17
"2011","Castle Point 011B","E01021498","Total",625,596,29
"2011","Castle Point 011C","E01021499","Total",672,660,12
"2011","Castle Point 011D","E01021501","Total",650,630,20
"2011","Castle Point 011E","E01021502","Total",1072,985,87
"2011","Castle Point 012A","E01021489","Total",638,623,15
"2011","Castle Point 012B","E01021490","Total",683,663,20
"2011","Castle Point 012C","E01021491","Total",675,662,13
"2011","Castle Point 012D","E01021497","Total",683,659,24
"2011","Castle Point 012E","E01021500","Total",916,754,162
"2011","Chelmsford 001A","E01021538","Total",1022,998,24
"2011","Chelmsford 001B","E01021539","Total",557,534,23
"2011","Chelmsford 001C","E01021540","Total",662,636,26
"2011","Chelmsford 001D","E01021541","Total",649,637,12
"2011","Chelmsford 002A","E01021542","Total",867,839,28
"2011","Chelmsford 002B","E01021543","Total",655,650,5
"2011","Chelmsford 002C","E01021587","Total",636,616,20
"2011","Chelmsford 002D","E01021590","Total",598,588,10
"2011","Chelmsford 002E","E01021591","Total",668,643,25
"2011","Chelmsford 003A","E01021550","Total",586,570,16
"2011","Chelmsford 003B","E01021597","Total",605,590,15
"2011","Chelmsford 003C","E01021598","Total",678,660,18
"2011","Chelmsford 003D","E01021600","Total",446,441,5
"2011","Chelmsford 003E","E01021601","Total",699,685,14
"2011","Chelmsford 004A","E01021616","Total",559,553,6
"2011","Chelmsford 004B","E01021617","Total",602,599,3
"2011","Chelmsford 004C","E01021619","Total",643,634,9
"2011","Chelmsford 004D","E01021620","Total",650,643,7
"2011","Chelmsford 004E","E01021623","Total",523,514,9
"2011","Chelmsford 004F","E01021624","Total",512,503,9
"2011","Chelmsford 005A","E01021536","Total",718,700,18
"2011","Chelmsford 005B","E01021537","Total",797,787,10
"2011","Chelmsford 005D","E01021568","Total",642,627,15
"2011","Chelmsford 005E","E01033142","Total",752,747,5
"2011","Chelmsford 005F","E01033144","Total",629,619,10
"2011","Chelmsford 006A","E01021576","Total",624,611,13
"2011","Chelmsford 006B","E01021588","Total",644,623,21
"2011","Chelmsford 006C","E01021589","Total",675,665,10
"2011","Chelmsford 006D","E01021592","Total",690,678,12
"2011","Chelmsford 006E","E01021596","Total",709,698,11
"2011","Chelmsford 007A","E01021618","Total",578,572,6
"2011","Chelmsford 007B","E01021621","Total",627,616,11
"2011","Chelmsford 007C","E01021622","Total",640,632,8
"2011","Chelmsford 007D","E01021625","Total",620,615,5
"2011","Chelmsford 007E","E01021626","Total",565,554,11
"2011","Chelmsford 008A","E01021544","Total",638,617,21
"2011","Chelmsford 008B","E01021545","Total",652,641,11
"2011","Chelmsford 008C","E01021546","Total",618,608,10
"2011","Chelmsford 008D","E01021547","Total",720,702,18
"2011","Chelmsford 008E","E01021628","Total",675,665,10
"2011","Chelmsford 008F","E01021629","Total",689,677,12
"2011","Chelmsford 009A","E01021573","Total",721,700,21
"2011","Chelmsford 009B","E01021575","Total",730,717,13
"2011","Chelmsford 009C","E01021599","Total",739,728,11
"2011","Chelmsford 009E","E01021631","Total",797,787,10
"2011","Chelmsford 009F","E01033138","Total",649,638,11
"2011","Chelmsford 009G","E01033139","Total",648,639,9
"2011","Chelmsford 010A","E01021574","Total",1049,1010,39
"2011","Chelmsford 010B","E01021578","Total",874,859,15
"2011","Chelmsford 010D","E01021582","Total",1035,976,59
"2011","Chelmsford 010E","E01021627","Total",600,588,12
"2011","Chelmsford 010F","E01033140","Total",666,627,39
"2011","Chelmsford 010G","E01033141","Total",659,604,55
"2011","Chelmsford 011A","E01021551","Total",572,557,15
"2011","Chelmsford 011B","E01021632","Total",606,601,5
"2011","Chelmsford 011C","E01021633","Total",526,514,12
"2011","Chelmsford 011D","E01021634","Total",629,614,15
"2011","Chelmsford 011E","E01021635","Total",635,625,10
"2011","Chelmsford 011F","E01021636","Total",520,510,10
"2011","Chelmsford 012A","E01021556","Total",691,677,14
"2011","Chelmsford 012B","E01021577","Total",623,613,10
"2011","Chelmsford 012C","E01021579","Total",621,608,13
"2011","Chelmsford 012D","E01021580","Total",517,505,12
"2011","Chelmsford 012E","E01021584","Total",480,471,9
"2011","Chelmsford 013A","E01021548","Total",552,542,10
"2011","Chelmsford 013B","E01021560","Total",806,781,25
"2011","Chelmsford 013C","E01021561","Total",763,752,11
"2011","Chelmsford 013D","E01021564","Total",654,638,16
"2011","Chelmsford 013E","E01021571","Total",616,595,21
"2011","Chelmsford 014A","E01021562","Total",813,800,13
"2011","Chelmsford 014B","E01021563","Total",824,809,15
"2011","Chelmsford 014C","E01021565","Total",689,681,8
"2011","Chelmsford 014D","E01021566","Total",704,697,7
"2011","Chelmsford 014F","E01033137","Total",677,647,30
"2011","Chelmsford 014G","E01033145","Total",587,575,12
"2011","Chelmsford 015A","E01021557","Total",495,487,8
"2011","Chelmsford 015B","E01021558","Total",509,502,7
"2011","Chelmsford 015C","E01021583","Total",607,603,4
"2011","Chelmsford 015D","E01021585","Total",502,492,10
"2011","Chelmsford 015E","E01021586","Total",628,614,14
"2011","Chelmsford 016A","E01021533","Total",939,926,13
"2011","Chelmsford 016B","E01021535","Total",700,685,15
"2011","Chelmsford 016C","E01021569","Total",654,640,14
"2011","Chelmsford 016D","E01021570","Total",789,763,26
"2011","Chelmsford 016E","E01021572","Total",643,633,10
"2011","Chelmsford 017A","E01021552","Total",691,673,18
"2011","Chelmsford 017B","E01021553","Total",575,570,5
"2011","Chelmsford 017C","E01021554","Total",660,653,7
"2011","Chelmsford 017D","E01021555","Total",538,532,6
"2011","Chelmsford 017E","E01021559","Total",588,578,10
"2011","Chelmsford 018B","E01021602","Total",779,754,25
"2011","Chelmsford 018D","E01021604","Total",883,861,22
"2011","Chelmsford 018E","E01033143","Total",1254,1176,78
"2011","Chelmsford 019A","E01021611","Total",531,528,3
"2011","Chelmsford 019B","E01021612","Total",616,608,8
"2011","Chelmsford 019C","E01021613","Total",889,853,36
"2011","Chelmsford 019D","E01021614","Total",662,646,16
"2011","Chelmsford 019E","E01021615","Total",631,622,9
"2011","Chelmsford 020A","E01021605","Total",473,469,4
"2011","Chelmsford 020B","E01021606","Total",601,593,8
"2011","Chelmsford 020C","E01021607","Total",659,648,11
"2011","Chelmsford 020D","E01021608","Total",556,547,9
"2011","Chelmsford 020E","E01021609","Total",518,515,3
"2011","Chelmsford 020F","E01021610","Total",579,571,8
"2011","Chelmsford 021A","E01021593","Total",680,666,14
"2011","Chelmsford 021B","E01021594","Total",706,679,27
"2011","Chelmsford 021C","E01021595","Total",747,708,39
"2011","Colchester 001A","E01021655","Total",560,529,31
"2011","Colchester 001B","E01021656","Total",757,682,75
"2011","Colchester 001C","E01021659","Total",862,826,36
"2011","Colchester 001D","E01021661","Total",692,659,33
"2011","Colchester 002A","E01021668","Total",817,801,16
"2011","Colchester 002B","E01021669","Total",733,716,17
"2011","Colchester 002C","E01021670","Total",637,630,7
"2011","Colchester 002D","E01021671","Total",605,596,9
"2011","Colchester 002F","E01033720","Total",780,775,5
"2011","Colchester 002G","E01033721","Total",666,654,12
"2011","Colchester 003A","E01021660","Total",607,574,33
"2011","Colchester 003B","E01021728","Total",676,656,20
"2011","Colchester 003C","E01021729","Total",722,708,14
"2011","Colchester 003D","E01021730","Total",722,682,40
"2011","Colchester 004A","E01021679","Total",1022,991,31
"2011","Colchester 004B","E01021680","Total",1121,1090,31
"2011","Colchester 004C","E01021681","Total",1238,1184,54
"2011","Colchester 004D","E01021682","Total",1201,1148,53
"2011","Colchester 007A","E01021646","Total",1075,1019,56
"2011","Colchester 007B","E01021647","Total",836,811,25
"2011","Colchester 007C","E01021648","Total",1191,1127,64
"2011","Colchester 007D","E01021649","Total",1167,1050,117
"2011","Colchester 007E","E01021650","Total",991,954,37
"2011","Colchester 008A","E01021696","Total",774,747,27
"2011","Colchester 008B","E01021697","Total",729,705,24
"2011","Colchester 008C","E01021698","Total",465,457,8
"2011","Colchester 008D","E01021699","Total",661,647,14
"2011","Colchester 008E","E01021700","Total",594,582,12
"2011","Colchester 008G","E01033719","Total",619,544,75
"2011","Colchester 008H","E01033722","Total",628,586,42
"2011","Colchester 009A","E01021673","Total",657,623,34
"2011","Colchester 009B","E01021674","Total",532,519,13
"2011","Colchester 009C","E01021675","Total",547,526,21
"2011","Colchester 009D","E01021676","Total",665,643,22
"2011","Colchester 010A","E01021654","Total",751,733,18
"2011","Colchester 010B","E01021662","Total",657,636,21
"2011","Colchester 010C","E01021663","Total",485,458,27
"2011","Colchester 010D","E01021677","Total",502,494,8
"2011","Colchester 010E","E01021678","Total",586,559,27
"2011","Colchester 011A","E01021683","Total",620,558,62
"2011","Colchester 011B","E01021684","Total",727,703,24
"2011","Colchester 011C","E01021685","Total",950,838,112
"2011","Colchester 011D","E01021686","Total",1062,981,81
"2011","Colchester 011E","E01021687","Total",817,757,60
"2011","Colchester 011F","E01021688","Total",632,600,32
"2011","Colchester 012A","E01021718","Total",672,665,7
"2011","Colchester 012B","E01021719","Total",683,663,20
"2011","Colchester 012C","E01021720","Total",730,704,26
"2011","Colchester 012D","E01021721","Total",801,773,28
"2011","Colchester 012E","E01021722","Total",715,701,14
"2011","Colchester 013A","E01021651","Total",785,731,54
"2011","Colchester 013B","E01021652","Total",680,647,33
"2011","Colchester 013C","E01021653","Total",507,486,21
"2011","Colchester 013D","E01021717","Total",741,719,22
"2011","Colchester 014A","E01021689","Total",633,614,19
"2011","Colchester 014B","E01021690","Total",506,500,6
"2011","Colchester 014C","E01021691","Total",670,641,29
"2011","Colchester 014D","E01021692","Total",615,603,12
"2011","Colchester 014E","E01021693","Total",730,718,12
"2011","Colchester 015A","E01021711","Total",600,577,23
"2011","Colchester 015C","E01021713","Total",482,474,8
"2011","Colchester 015D","E01021714","Total",682,671,11
"2011","Colchester 015E","E01021715","Total",595,578,17
"2011","Colchester 015G","E01033723","Total",927,863,64
"2011","Colchester 016A","E01021657","Total",742,720,22
"2011","Colchester 016B","E01021658","Total",452,442,10
"2011","Colchester 016C","E01021664","Total",915,884,31
"2011","Colchester 016D","E01021665","Total",628,612,16
"2011","Colchester 016E","E01021666","Total",650,627,23
"2011","Colchester 016F","E01021667","Total",645,619,26
"2011","Colchester 017A","E01021736","Total",530,516,14
"2011","Colchester 017B","E01021737","Total",597,582,15
"2011","Colchester 017C","E01021738","Total",1055,967,88
"2011","Colchester 017D","E01021739","Total",668,648,20
"2011","Colchester 017E","E01021740","Total",760,744,16
"2011","Colchester 018A","E01021637","Total",477,471,6
"2011","Colchester 018B","E01021638","Total",525,506,19
"2011","Colchester 018C","E01021639","Total",801,750,51
"2011","Colchester 018D","E01021640","Total",487,481,6
"2011","Colchester 018E","E01021641","Total",609,590,19
"2011","Colchester 018F","E01021642","Total",852,836,16
"2011","Colchester 019A","E01021643","Total",961,927,34
"2011","Colchester 019B","E01021644","Total",692,670,22
"2011","Colchester 019C","E01021645","Total",592,583,9
"2011","Colchester 019D","E01021694","Total",637,592,45
"2011","Colchester 019E","E01021695","Total",491,459,32
"2011","Colchester 020A","E01021723","Total",763,720,43
"2011","Colchester 020B","E01021724","Total",769,739,30
"2011","Colchester 020C","E01021725","Total",548,528,20
"2011","Colchester 020D","E01021726","Total",688,679,9
"2011","Colchester 020E","E01021727","Total",651,627,24
"2011","Colchester 021A","E01021731","Total",696,638,58
"2011","Colchester 021B","E01021732","Total",740,705,35
"2011","Colchester 021C","E01021733","Total",702,657,45
"2011","Colchester 021D","E01021734","Total",662,631,31
"2011","Colchester 021E","E01021735","Total",751,669,82
"2011","Colchester 022D","E01021702","Total",615,591,24
"2011","Colchester 022E","E01021703","Total",500,491,9
"2011","Colchester 022F","E01021704","Total",688,661,27
"2011","Colchester 022G","E01021705","Total",785,765,20
"2011","Colchester 022H","E01021706","Total",624,598,26
"2011","Colchester 022I","E01021707","Total",607,591,16
"2011","Colchester 022A","E01021708","Total",647,629,18
"2011","Colchester 022B","E01021709","Total",652,632,20
"2011","Colchester 022C","E01021710","Total",785,771,14
"2011","Epping Forest 001A","E01021768","Total",940,865,75
"2011","Epping Forest 001B","E01021795","Total",978,935,43
"2011","Epping Forest 001C","E01021797","Total",534,523,11
"2011","Epping Forest 001D","E01021798","Total",660,638,22
"2011","Epping Forest 001E","E01021799","Total",843,706,137
"2011","Epping Forest 002A","E01021741","Total",832,784,48
"2011","Epping Forest 002B","E01021792","Total",497,482,15
"2011","Epping Forest 002C","E01021793","Total",636,616,20
"2011","Epping Forest 002D","E01021794","Total",499,484,15
"2011","Epping Forest 002E","E01021801","Total",928,876,52
"2011","Epping Forest 003A","E01021769","Total",883,852,31
"2011","Epping Forest 003B","E01021796","Total",954,868,86
"2011","Epping Forest 003C","E01021800","Total",964,862,102
"2011","Epping Forest 004A","E01021753","Total",689,629,60
"2011","Epping Forest 004B","E01021754","Total",632,615,17
"2011","Epping Forest 004C","E01021755","Total",506,479,27
"2011","Epping Forest 004D","E01021802","Total",979,903,76
"2011","Epping Forest 005A","E01021760","Total",673,655,18
"2011","Epping Forest 005B","E01021761","Total",835,744,91
"2011","Epping Forest 005C","E01021762","Total",652,611,41
"2011","Epping Forest 005D","E01021763","Total",711,653,58
"2011","Epping Forest 006A","E01021756","Total",624,612,12
"2011","Epping Forest 006B","E01021757","Total",825,795,30
"2011","Epping Forest 006C","E01021758","Total",781,749,32
"2011","Epping Forest 006D","E01021759","Total",612,608,4
"2011","Epping Forest 007A","E01021811","Total",613,602,11
"2011","Epping Forest 007B","E01021813","Total",606,581,25
"2011","Epping Forest 007C","E01021814","Total",621,604,17
"2011","Epping Forest 007D","E01021815","Total",611,603,8
"2011","Epping Forest 007E","E01021816","Total",637,609,28
"2011","Epping Forest 008A","E01021807","Total",600,591,9
"2011","Epping Forest 008B","E01021808","Total",628,617,11
"2011","Epping Forest 008C","E01021809","Total",640,616,24
"2011","Epping Forest 008D","E01021810","Total",810,788,22
"2011","Epping Forest 008E","E01021817","Total",1115,1066,49
"2011","Epping Forest 009A","E01021806","Total",1051,1002,49
"2011","Epping Forest 009B","E01021812","Total",594,579,15
"2011","Epping Forest 009C","E01021818","Total",960,912,48
"2011","Epping Forest 010A","E01021770","Total",940,907,33
"2011","Epping Forest 010B","E01021803","Total",545,536,9
"2011","Epping Forest 010C","E01021804","Total",628,586,42
"2011","Epping Forest 010D","E01021805","Total",506,491,15
"2011","Epping Forest 011A","E01021774","Total",624,617,7
"2011","Epping Forest 011B","E01021775","Total",661,631,30
"2011","Epping Forest 011C","E01021776","Total",749,717,32
"2011","Epping Forest 011D","E01021777","Total",579,567,12
"2011","Epping Forest 011E","E01021778","Total",580,571,9
"2011","Epping Forest 011F","E01021779","Total",743,702,41
"2011","Epping Forest 012A","E01021786","Total",544,520,24
"2011","Epping Forest 012B","E01021787","Total",668,629,39
"2011","Epping Forest 012C","E01021788","Total",646,624,22
"2011","Epping Forest 012D","E01021789","Total",554,526,28
"2011","Epping Forest 012E","E01021790","Total",569,556,13
"2011","Epping Forest 012F","E01021791","Total",680,660,20
"2011","Epping Forest 013A","E01021771","Total",759,713,46
"2011","Epping Forest 013B","E01021772","Total",614,599,15
"2011","Epping Forest 013C","E01021773","Total",619,595,24
"2011","Epping Forest 013D","E01021783","Total",650,639,11
"2011","Epping Forest 013E","E01021784","Total",649,642,7
"2011","Epping Forest 014A","E01021780","Total",539,523,16
"2011","Epping Forest 014B","E01021781","Total",654,633,21
"2011","Epping Forest 014C","E01021782","Total",662,639,23
"2011","Epping Forest 014D","E01021785","Total",672,662,10
"2011","Epping Forest 015A","E01021742","Total",520,513,7
"2011","Epping Forest 015B","E01021743","Total",845,824,21
"2011","Epping Forest 015C","E01021744","Total",669,648,21
"2011","Epping Forest 015D","E01021745","Total",690,655,35
"2011","Epping Forest 015E","E01021746","Total",913,859,54
"2011","Epping Forest 015F","E01021747","Total",664,643,21
"2011","Epping Forest 015G","E01021748","Total",816,752,64
"2011","Epping Forest 016A","E01021749","Total",932,912,20
"2011","Epping Forest 016B","E01021750","Total",528,476,52
"2011","Epping Forest 016C","E01021751","Total",478,444,34
"2011","Epping Forest 016D","E01021752","Total",586,564,22
"2011","Epping Forest 017A","E01021764","Total",731,720,11
"2011","Epping Forest 017B","E01021765","Total",671,646,25
"2011","Epping Forest 017C","E01021766","Total",529,498,31
"2011","Epping Forest 017D","E01021767","Total",674,638,36
"2011","Harlow 001A","E01021854","Total",747,732,15
"2011","Harlow 001B","E01021855","Total",623,601,22
"2011","Harlow 001C","E01021856","Total",639,610,29
"2011","Harlow 001D","E01021857","Total",1196,1069,127
"2011","Harlow 002A","E01021844","Total",531,525,6
"2011","Harlow 002B","E01021845","Total",646,621,25
"2011","Harlow 002C","E01021846","Total",592,573,19
"2011","Harlow 002D","E01021847","Total",656,616,40
"2011","Harlow 002E","E01021848","Total",717,690,27
"2011","Harlow 003A","E01021849","Total",691,670,21
"2011","Harlow 003B","E01021850","Total",624,617,7
"2011","Harlow 003C","E01021851","Total",729,713,16
"2011","Harlow 003D","E01021852","Total",681,670,11
"2011","Harlow 003E","E01021853","Total",605,590,15
"2011","Harlow 004A","E01021839","Total",696,633,63
"2011","Harlow 004B","E01021840","Total",685,623,62
"2011","Harlow 004C","E01021841","Total",559,539,20
"2011","Harlow 004D","E01021842","Total",680,634,46
"2011","Harlow 004E","E01021843","Total",1034,940,94
"2011","Harlow 005A","E01021824","Total",646,641,5
"2011","Harlow 005B","E01021825","Total",655,648,7
"2011","Harlow 005C","E01021826","Total",649,645,4
"2011","Harlow 005D","E01021827","Total",729,715,14
"2011","Harlow 005E","E01021828","Total",880,864,16
"2011","Harlow 006A","E01021819","Total",649,638,11
"2011","Harlow 006B","E01021820","Total",651,644,7
"2011","Harlow 006C","E01021822","Total",637,626,11
"2011","Harlow 006D","E01021823","Total",781,759,22
"2011","Harlow 006E","E01021870","Total",584,577,7
"2011","Harlow 007A","E01021831","Total",646,641,5
"2011","Harlow 007B","E01021868","Total",678,674,4
"2011","Harlow 007C","E01021869","Total",564,558,6
"2011","Harlow 007D","E01021871","Total",641,629,12
"2011","Harlow 007E","E01021872","Total",911,829,82
"2011","Harlow 008A","E01021821","Total",653,640,13
"2011","Harlow 008B","E01021834","Total",667,654,13
"2011","Harlow 008C","E01021835","Total",620,607,13
"2011","Harlow 008D","E01021836","Total",655,644,11
"2011","Harlow 008E","E01021837","Total",647,635,12
"2011","Harlow 009A","E01021829","Total",659,651,8
"2011","Harlow 009B","E01021830","Total",507,493,14
"2011","Harlow 009C","E01021832","Total",531,514,17
"2011","Harlow 009D","E01021833","Total",536,522,14
"2011","Harlow 009E","E01021865","Total",585,568,17
"2011","Harlow 010A","E01021838","Total",614,605,9
"2011","Harlow 010B","E01021858","Total",648,640,8
"2011","Harlow 010C","E01021859","Total",635,615,20
"2011","Harlow 010D","E01021860","Total",609,598,11
"2011","Harlow 010E","E01021861","Total",498,491,7
"2011","Harlow 011A","E01021862","Total",633,626,7
"2011","Harlow 011B","E01021863","Total",633,621,12
"2011","Harlow 011C","E01021864","Total",568,549,19
"2011","Harlow 011D","E01021866","Total",625,609,16
"2011","Harlow 011E","E01021867","Total",597,584,13
"2011","Maldon 001A","E01021908","Total",906,857,49
"2011","Maldon 001B","E01021909","Total",711,536,175
"2011","Maldon 001C","E01021910","Total",672,637,35
"2011","Maldon 001D","E01021911","Total",496,473,23
"2011","Maldon 002A","E01021882","Total",882,842,40
"2011","Maldon 002B","E01021883","Total",668,651,17
"2011","Maldon 002C","E01021912","Total",865,830,35
"2011","Maldon 002D","E01021913","Total",613,589,24
"2011","Maldon 003A","E01021884","Total",628,604,24
"2011","Maldon 003B","E01021885","Total",506,475,31
"2011","Maldon 003C","E01021886","Total",631,601,30
"2011","Maldon 003D","E01021887","Total",877,864,13
"2011","Maldon 003E","E01021888","Total",836,821,15
"2011","Maldon 004A","E01021889","Total",963,930,33
"2011","Maldon 004B","E01021890","Total",991,905,86
"2011","Maldon 004C","E01021891","Total",784,743,41
"2011","Maldon 004D","E01021892","Total",512,481,31
"2011","Maldon 005A","E01021893","Total",596,592,4
"2011","Maldon 005B","E01021894","Total",507,498,9
"2011","Maldon 005C","E01021895","Total",494,492,2
"2011","Maldon 005D","E01021896","Total",501,494,7
"2011","Maldon 005E","E01021897","Total",489,484,5
"2011","Maldon 005F","E01021898","Total",605,587,18
"2011","Maldon 006A","E01021901","Total",865,794,71
"2011","Maldon 006B","E01021904","Total",575,562,13
"2011","Maldon 006C","E01021905","Total",517,499,18
"2011","Maldon 006D","E01021906","Total",686,642,44
"2011","Maldon 006E","E01021907","Total",968,886,82
"2011","Maldon 007A","E01021873","Total",531,513,18
"2011","Maldon 007B","E01021874","Total",546,530,16
"2011","Maldon 007C","E01021875","Total",692,639,53
"2011","Maldon 007D","E01021899","Total",527,513,14
"2011","Maldon 007E","E01021900","Total",508,442,66
"2011","Maldon 007F","E01021902","Total",685,668,17
"2011","Maldon 007G","E01021903","Total",651,624,27
"2011","Maldon 008C","E01021878","Total",657,633,24
"2011","Maldon 008D","E01021879","Total",662,628,34
"2011","Maldon 008E","E01021880","Total",867,782,85
"2011","Maldon 008F","E01021881","Total",557,526,31
"2011","Maldon 008G","E01033057","Total",985,950,35
"2011","Rochford 001A","E01021942","Total",868,825,43
"2011","Rochford 001B","E01021943","Total",714,707,7
"2011","Rochford 001C","E01021944","Total",644,633,11
"2011","Rochford 001D","E01021945","Total",632,621,11
"2011","Rochford 002A","E01021914","Total",819,800,19
"2011","Rochford 002B","E01021927","Total",495,490,5
"2011","Rochford 002C","E01021928","Total",683,668,15
"2011","Rochford 002D","E01021929","Total",589,579,10
"2011","Rochford 002E","E01021931","Total",591,585,6
"2011","Rochford 003A","E01021933","Total",517,509,8
"2011","Rochford 003B","E01021934","Total",536,528,8
"2011","Rochford 003C","E01021935","Total",542,533,9
"2011","Rochford 003D","E01021936","Total",814,784,30
"2011","Rochford 003E","E01021937","Total",708,700,8
"2011","Rochford 003F","E01021938","Total",654,641,13
"2011","Rochford 003G","E01021939","Total",683,671,12
"2011","Rochford 003H","E01021940","Total",798,789,9
"2011","Rochford 003I","E01021941","Total",789,774,15
"2011","Rochford 004A","E01021915","Total",543,515,28
"2011","Rochford 004B","E01021916","Total",424,415,9
"2011","Rochford 004C","E01021953","Total",573,564,9
"2011","Rochford 004D","E01021955","Total",943,885,58
"2011","Rochford 005A","E01021918","Total",574,568,6
"2011","Rochford 005B","E01021919","Total",529,517,12
"2011","Rochford 005C","E01021925","Total",679,653,26
"2011","Rochford 005D","E01021960","Total",772,759,13
"2011","Rochford 005E","E01021961","Total",647,636,11
"2011","Rochford 006A","E01021920","Total",750,737,13
"2011","Rochford 006B","E01021926","Total",884,860,24
"2011","Rochford 006C","E01021957","Total",633,622,11
"2011","Rochford 006D","E01021958","Total",529,518,11
"2011","Rochford 006E","E01021959","Total",646,635,11
"2011","Rochford 007A","E01021930","Total",684,665,19
"2011","Rochford 007B","E01021932","Total",648,634,14
"2011","Rochford 007C","E01021952","Total",625,602,23
"2011","Rochford 007D","E01021954","Total",636,604,32
"2011","Rochford 007E","E01021956","Total",651,628,23
"2011","Rochford 008A","E01021950","Total",606,594,12
"2011","Rochford 008B","E01021951","Total",521,509,12
"2011","Rochford 008C","E01021962","Total",538,507,31
"2011","Rochford 008D","E01021963","Total",542,520,22
"2011","Rochford 008E","E01021964","Total",692,667,25
"2011","Rochford 008F","E01021966","Total",840,794,46
"2011","Rochford 009A","E01021946","Total",560,551,9
"2011","Rochford 009B","E01021947","Total",511,499,12
"2011","Rochford 009C","E01021948","Total",530,524,6
"2011","Rochford 009D","E01021949","Total",609,604,5
"2011","Rochford 009E","E01021965","Total",987,963,24
"2011","Rochford 010A","E01021917","Total",720,704,16
"2011","Rochford 010B","E01021921","Total",606,591,15
"2011","Rochford 010C","E01021922","Total",711,669,42
"2011","Rochford 010D","E01021923","Total",538,520,18
"2011","Rochford 010E","E01021924","Total",504,494,10
"2011","Tendring 001A","E01021997","Total",727,663,64
"2011","Tendring 001B","E01021998","Total",681,631,50
"2011","Tendring 001C","E01021999","Total",790,752,38
"2011","Tendring 001D","E01022001","Total",908,827,81
"2011","Tendring 002A","E01022000","Total",666,646,20
"2011","Tendring 002C","E01022006","Total",754,732,22
"2011","Tendring 002D","E01022007","Total",673,653,20
"2011","Tendring 002F","E01033051","Total",1145,1096,49
"2011","Tendring 003A","E01021978","Total",952,906,46
"2011","Tendring 003B","E01022013","Total",674,650,24
"2011","Tendring 003C","E01022014","Total",602,584,18
"2011","Tendring 003D","E01022015","Total",619,608,11
"2011","Tendring 003E","E01022019","Total",576,560,16
"2011","Tendring 003F","E01022020","Total",973,901,72
"2011","Tendring 003G","E01022021","Total",622,603,19
"2011","Tendring 004A","E01021991","Total",439,418,21
"2011","Tendring 004B","E01021992","Total",498,476,22
"2011","Tendring 004C","E01022002","Total",811,791,20
"2011","Tendring 004D","E01022004","Total",798,748,50
"2011","Tendring 004E","E01022005","Total",784,757,27
"2011","Tendring 004F","E01022028","Total",575,546,29
"2011","Tendring 005A","E01021971","Total",434,416,18
"2011","Tendring 005B","E01021972","Total",518,491,27
"2011","Tendring 005C","E01022051","Total",603,575,28
"2011","Tendring 005D","E01022052","Total",612,600,12
"2011","Tendring 006A","E01021985","Total",803,660,143
"2011","Tendring 006B","E01021986","Total",1020,726,294
"2011","Tendring 006C","E01022054","Total",744,629,115
"2011","Tendring 006D","E01022055","Total",689,642,47
"2011","Tendring 006E","E01022056","Total",949,766,183
"2011","Tendring 007A","E01021973","Total",498,471,27
"2011","Tendring 007B","E01021974","Total",521,483,38
"2011","Tendring 007C","E01022016","Total",868,839,29
"2011","Tendring 007D","E01022017","Total",621,575,46
"2011","Tendring 007E","E01022018","Total",664,624,40
"2011","Tendring 008A","E01021987","Total",669,593,76
"2011","Tendring 008B","E01021994","Total",659,606,53
"2011","Tendring 008C","E01021995","Total",663,634,29
"2011","Tendring 008D","E01021996","Total",643,615,28
"2011","Tendring 008E","E01022009","Total",671,640,31
"2011","Tendring 008F","E01022010","Total",743,704,39
"2011","Tendring 008G","E01022011","Total",776,742,34
"2011","Tendring 008H","E01022012","Total",1078,1001,77
"2011","Tendring 009A","E01021967","Total",873,836,37
"2011","Tendring 009B","E01021983","Total",638,611,27
"2011","Tendring 009C","E01021993","Total",978,944,34
"2011","Tendring 009D","E01022053","Total",744,710,34
"2011","Tendring 010A","E01021984","Total",1058,1004,54
"2011","Tendring 010B","E01022039","Total",689,657,32
"2011","Tendring 010C","E01022040","Total",872,816,56
"2011","Tendring 010D","E01022041","Total",752,711,41
"2011","Tendring 011A","E01021979","Total",645,624,21
"2011","Tendring 011B","E01021980","Total",855,770,85
"2011","Tendring 011C","E01021981","Total",834,793,41
"2011","Tendring 011D","E01021982","Total",927,830,97
"2011","Tendring 011E","E01022046","Total",836,686,150
"2011","Tendring 012A","E01022008","Total",1085,1002,83
"2011","Tendring 012B","E01022033","Total",788,733,55
"2011","Tendring 012C","E01022034","Total",833,772,61
"2011","Tendring 012D","E01022035","Total",774,698,76
"2011","Tendring 013A","E01021975","Total",661,644,17
"2011","Tendring 013B","E01021976","Total",632,613,19
"2011","Tendring 013C","E01021977","Total",745,710,35
"2011","Tendring 013D","E01022022","Total",628,602,26
"2011","Tendring 013E","E01022044","Total",778,743,35
"2011","Tendring 014A","E01022042","Total",762,687,75
"2011","Tendring 014B","E01022043","Total",811,751,60
"2011","Tendring 014C","E01022048","Total",736,705,31
"2011","Tendring 014D","E01022049","Total",645,618,27
"2011","Tendring 014E","E01022050","Total",916,870,46
"2011","Tendring 015A","E01022023","Total",664,645,19
"2011","Tendring 015B","E01022024","Total",653,642,11
"2011","Tendring 015C","E01022030","Total",811,759,52
"2011","Tendring 015D","E01022031","Total",622,577,45
"2011","Tendring 015E","E01022032","Total",752,715,37
"2011","Tendring 016A","E01021970","Total",939,825,114
"2011","Tendring 016B","E01022025","Total",916,776,140
"2011","Tendring 016C","E01022026","Total",707,630,77
"2011","Tendring 016D","E01022027","Total",891,788,103
"2011","Tendring 017A","E01021968","Total",775,729,46
"2011","Tendring 017B","E01021969","Total",640,587,53
"2011","Tendring 017C","E01022036","Total",611,571,40
"2011","Tendring 017D","E01022037","Total",665,622,43
"2011","Tendring 017E","E01022038","Total",657,632,25
"2011","Tendring 018A","E01021988","Total",1273,1029,244
"2011","Tendring 018B","E01021989","Total",810,757,53
"2011","Tendring 018C","E01021990","Total",923,842,81
"2011","Tendring 018D","E01022045","Total",880,681,199
"2011","Tendring 018E","E01022047","Total",639,578,61
"2011","Uttlesford 001A","E01022057","Total",692,674,18
"2011","Uttlesford 001B","E01022075","Total",737,715,22
"2011","Uttlesford 001C","E01022077","Total",649,637,12
"2011","Uttlesford 001D","E01022094","Total",714,679,35
"2011","Uttlesford 002A","E01022074","Total",596,584,12
"2011","Uttlesford 002B","E01022076","Total",1020,939,81
"2011","Uttlesford 002C","E01022078","Total",636,622,14
"2011","Uttlesford 002D","E01022079","Total",784,750,34
"2011","Uttlesford 002E","E01022080","Total",646,633,13
"2011","Uttlesford 002F","E01022081","Total",1006,963,43
"2011","Uttlesford 002G","E01022082","Total",690,667,23
"2011","Uttlesford 003A","E01022061","Total",600,568,32
"2011","Uttlesford 003B","E01022071","Total",676,652,24
"2011","Uttlesford 003C","E01022072","Total",757,733,24
"2011","Uttlesford 003D","E01022073","Total",659,628,31
"2011","Uttlesford 003E","E01022098","Total",640,609,31
"2011","Uttlesford 004A","E01022092","Total",758,716,42
"2011","Uttlesford 004B","E01022093","Total",755,719,36
"2011","Uttlesford 004C","E01022097","Total",746,713,33
"2011","Uttlesford 004D","E01022099","Total",829,785,44
"2011","Uttlesford 005A","E01022062","Total",830,786,44
"2011","Uttlesford 005B","E01022063","Total",636,622,14
"2011","Uttlesford 005C","E01022083","Total",727,684,43
"2011","Uttlesford 005D","E01022084","Total",627,610,17
"2011","Uttlesford 005E","E01022085","Total",745,691,54
"2011","Uttlesford 005F","E01022087","Total",740,715,25
"2011","Uttlesford 005G","E01022089","Total",629,603,26
"2011","Uttlesford 006A","E01022086","Total",586,524,62
"2011","Uttlesford 006B","E01022090","Total",982,923,59
"2011","Uttlesford 006C","E01022091","Total",964,910,54
"2011","Uttlesford 006D","E01022095","Total",639,602,37
"2011","Uttlesford 007B","E01022067","Total",1021,926,95
"2011","Uttlesford 007C","E01022068","Total",637,618,19
"2011","Uttlesford 007D","E01033054","Total",510,468,42
"2011","Uttlesford 007E","E01033055","Total",554,542,12
"2011","Uttlesford 007F","E01033056","Total",542,521,21
"2011","Uttlesford 008A","E01022058","Total",653,636,17
"2011","Uttlesford 008B","E01022064","Total",697,676,21
"2011","Uttlesford 008D","E01022069","Total",697,661,36
"2011","Uttlesford 008E","E01022088","Total",648,609,39
"2011","Uttlesford 008F","E01033052","Total",654,621,33
"2011","Uttlesford 008G","E01033053","Total",641,622,19
"2011","Uttlesford 009A","E01022059","Total",665,622,43
"2011","Uttlesford 009B","E01022060","Total",730,696,34
"2011","Uttlesford 009C","E01022070","Total",747,712,35
"2011","Uttlesford 009D","E01022096","Total",771,730,41
"2011","Broxbourne 001A","E01023316","Total",518,512,6
"2011","Broxbourne 001B","E01023317","Total",924,906,18
"2011","Broxbourne 001C","E01023318","Total",604,597,7
"2011","Broxbourne 001D","E01023319","Total",642,633,9
"2011","Broxbourne 002A","E01023327","Total",576,551,25
"2011","Broxbourne 002B","E01023328","Total",524,509,15
"2011","Broxbourne 002C","E01023329","Total",518,502,16
"2011","Broxbourne 002D","E01023330","Total",649,607,42
"2011","Broxbourne 002E","E01023331","Total",645,598,47
"2011","Broxbourne 003A","E01023320","Total",1071,982,89
"2011","Broxbourne 003B","E01023321","Total",886,842,44
"2011","Broxbourne 003C","E01023322","Total",775,745,30
"2011","Broxbourne 003D","E01023323","Total",836,798,38
"2011","Broxbourne 004A","E01023289","Total",532,525,7
"2011","Broxbourne 004B","E01023290","Total",645,632,13
"2011","Broxbourne 004C","E01023291","Total",638,612,26
"2011","Broxbourne 004D","E01023292","Total",658,629,29
"2011","Broxbourne 005A","E01023340","Total",769,722,47
"2011","Broxbourne 005B","E01023341","Total",730,719,11
"2011","Broxbourne 005C","E01023342","Total",1157,1109,48
"2011","Broxbourne 005D","E01023343","Total",759,728,31
"2011","Broxbourne 005E","E01023344","Total",787,762,25
"2011","Broxbourne 006A","E01023307","Total",548,539,9
"2011","Broxbourne 006B","E01023308","Total",635,632,3
"2011","Broxbourne 006C","E01023309","Total",626,621,5
"2011","Broxbourne 006D","E01023310","Total",934,881,53
"2011","Broxbourne 007A","E01023311","Total",673,653,20
"2011","Broxbourne 007B","E01023312","Total",586,576,10
"2011","Broxbourne 007C","E01023313","Total",641,630,11
"2011","Broxbourne 007D","E01023315","Total",633,627,6
"2011","Broxbourne 008A","E01023302","Total",706,685,21
"2011","Broxbourne 008B","E01023303","Total",656,618,38
"2011","Broxbourne 008C","E01023304","Total",671,638,33
"2011","Broxbourne 008D","E01023305","Total",524,504,20
"2011","Broxbourne 008E","E01023306","Total",631,619,12
"2011","Broxbourne 009A","E01023314","Total",523,510,13
"2011","Broxbourne 009B","E01023324","Total",531,519,12
"2011","Broxbourne 009C","E01023325","Total",648,620,28
"2011","Broxbourne 009D","E01023326","Total",688,666,22
"2011","Broxbourne 010A","E01023297","Total",514,507,7
"2011","Broxbourne 010B","E01023298","Total",664,651,13
"2011","Broxbourne 010C","E01023299","Total",767,671,96
"2011","Broxbourne 010D","E01023300","Total",671,632,39
"2011","Broxbourne 010E","E01023301","Total",731,683,48
"2011","Broxbourne 011A","E01023293","Total",669,661,8
"2011","Broxbourne 011B","E01023294","Total",754,712,42
"2011","Broxbourne 011C","E01023295","Total",577,567,10
"2011","Broxbourne 011D","E01023296","Total",666,636,30
"2011","Broxbourne 012A","E01023332","Total",964,888,76
"2011","Broxbourne 012B","E01023333","Total",828,786,42
"2011","Broxbourne 012C","E01023334","Total",725,688,37
"2011","Broxbourne 012D","E01023335","Total",685,655,30
"2011","Broxbourne 013A","E01023336","Total",846,821,25
"2011","Broxbourne 013B","E01023337","Total",683,650,33
"2011","Broxbourne 013C","E01023338","Total",1143,1098,45
"2011","Broxbourne 013D","E01023339","Total",623,594,29
"2011","Dacorum 001A","E01023430","Total",504,490,14
"2011","Dacorum 001B","E01023431","Total",515,502,13
"2011","Dacorum 001C","E01023432","Total",583,579,4
"2011","Dacorum 001D","E01023433","Total",697,676,21
"2011","Dacorum 002A","E01023423","Total",568,549,19
"2011","Dacorum 002B","E01023424","Total",577,564,13
"2011","Dacorum 002C","E01023425","Total",531,522,9
"2011","Dacorum 002D","E01023426","Total",750,715,35
"2011","Dacorum 003A","E01023418","Total",640,628,12
"2011","Dacorum 003B","E01023419","Total",842,830,12
"2011","Dacorum 003C","E01023420","Total",630,611,19
"2011","Dacorum 004A","E01023352","Total",1044,1015,29
"2011","Dacorum 004B","E01023421","Total",661,642,19
"2011","Dacorum 004C","E01023422","Total",499,484,15
"2011","Dacorum 005A","E01023434","Total",677,663,14
"2011","Dacorum 005B","E01023435","Total",709,690,19
"2011","Dacorum 005C","E01023436","Total",494,483,11
"2011","Dacorum 005D","E01023437","Total",695,680,15
"2011","Dacorum 006A","E01023355","Total",639,620,19
"2011","Dacorum 006B","E01023356","Total",478,457,21
"2011","Dacorum 006C","E01023416","Total",668,652,16
"2011","Dacorum 006D","E01023417","Total",692,665,27
"2011","Dacorum 007A","E01023393","Total",906,884,22
"2011","Dacorum 007B","E01023394","Total",517,506,11
"2011","Dacorum 007C","E01023395","Total",644,628,16
"2011","Dacorum 007D","E01023396","Total",601,594,7
"2011","Dacorum 007E","E01023397","Total",522,518,4
"2011","Dacorum 008A","E01023401","Total",728,720,8
"2011","Dacorum 008B","E01023402","Total",665,654,11
"2011","Dacorum 008C","E01023403","Total",684,670,14
"2011","Dacorum 008D","E01023404","Total",534,529,5
"2011","Dacorum 008E","E01023405","Total",626,621,5
"2011","Dacorum 009A","E01023361","Total",979,924,55
"2011","Dacorum 009B","E01023362","Total",825,790,35
"2011","Dacorum 009C","E01023363","Total",643,629,14
"2011","Dacorum 009D","E01023364","Total",517,509,8
"2011","Dacorum 010A","E01023390","Total",890,874,16
"2011","Dacorum 010B","E01023391","Total",701,693,8
"2011","Dacorum 010C","E01023399","Total",892,848,44
"2011","Dacorum 011A","E01023392","Total",642,633,9
"2011","Dacorum 011B","E01023427","Total",656,649,7
"2011","Dacorum 011C","E01023428","Total",637,625,12
"2011","Dacorum 011D","E01023429","Total",826,800,26
"2011","Dacorum 012A","E01023369","Total",633,622,11
"2011","Dacorum 012B","E01023370","Total",786,726,60
"2011","Dacorum 012C","E01023371","Total",525,514,11
"2011","Dacorum 012D","E01023372","Total",547,539,8
"2011","Dacorum 013A","E01023345","Total",674,651,23
"2011","Dacorum 013B","E01023346","Total",548,534,14
"2011","Dacorum 013C","E01023347","Total",519,514,5
"2011","Dacorum 013D","E01023348","Total",706,688,18
"2011","Dacorum 014A","E01023365","Total",598,566,32
"2011","Dacorum 014B","E01023366","Total",659,645,14
"2011","Dacorum 014C","E01023367","Total",420,405,15
"2011","Dacorum 014D","E01023368","Total",706,677,29
"2011","Dacorum 015A","E01023349","Total",793,780,13
"2011","Dacorum 015B","E01023350","Total",673,661,12
"2011","Dacorum 015C","E01023351","Total",669,663,6
"2011","Dacorum 015D","E01023398","Total",1442,1077,365
"2011","Dacorum 015E","E01023400","Total",1044,878,166
"2011","Dacorum 016A","E01023383","Total",607,597,10
"2011","Dacorum 016B","E01023384","Total",792,780,12
"2011","Dacorum 016C","E01023385","Total",693,687,6
"2011","Dacorum 017A","E01023409","Total",646,633,13
"2011","Dacorum 017B","E01023410","Total",545,540,5
"2011","Dacorum 017C","E01023411","Total",604,594,10
"2011","Dacorum 017D","E01023412","Total",500,498,2
"2011","Dacorum 017E","E01023413","Total",538,536,2
"2011","Dacorum 018B","E01023354","Total",703,691,12
"2011","Dacorum 018C","E01023379","Total",700,675,25
"2011","Dacorum 018D","E01023380","Total",488,481,7
"2011","Dacorum 018E","E01023381","Total",532,516,16
"2011","Dacorum 018F","E01023382","Total",737,678,59
"2011","Dacorum 018G","E01033022","Total",684,663,21
"2011","Dacorum 018H","E01033023","Total",765,736,29
"2011","Dacorum 019A","E01023386","Total",614,608,6
"2011","Dacorum 019B","E01023387","Total",509,502,7
"2011","Dacorum 019C","E01023388","Total",663,652,11
"2011","Dacorum 019D","E01023389","Total",670,659,11
"2011","Dacorum 020A","E01023357","Total",687,675,12
"2011","Dacorum 020B","E01023358","Total",528,521,7
"2011","Dacorum 020C","E01023359","Total",677,670,7
"2011","Dacorum 020D","E01023360","Total",557,543,14
"2011","Dacorum 020E","E01023414","Total",607,595,12
"2011","Dacorum 020F","E01023415","Total",554,537,17
"2011","Dacorum 021A","E01023373","Total",518,505,13
"2011","Dacorum 021B","E01023374","Total",633,612,21
"2011","Dacorum 021C","E01023375","Total",661,641,20
"2011","Dacorum 021D","E01023376","Total",540,534,6
"2011","Dacorum 021E","E01023377","Total",524,499,25
"2011","Dacorum 021F","E01023378","Total",633,590,43
"2011","Dacorum 022A","E01023406","Total",905,872,33
"2011","Dacorum 022B","E01023407","Total",655,640,15
"2011","Dacorum 022C","E01023408","Total",630,623,7
"2011","East Hertfordshire 001A","E01023462","Total",552,524,28
"2011","East Hertfordshire 001B","E01023464","Total",838,806,32
"2011","East Hertfordshire 001C","E01023465","Total",571,559,12
"2011","East Hertfordshire 001D","E01023466","Total",794,764,30
"2011","East Hertfordshire 002A","E01023467","Total",1004,975,29
"2011","East Hertfordshire 002B","E01023494","Total",519,481,38
"2011","East Hertfordshire 002C","E01023495","Total",518,498,20
"2011","East Hertfordshire 002D","E01023508","Total",601,578,23
"2011","East Hertfordshire 002E","E01023509","Total",565,552,13
"2011","East Hertfordshire 003A","E01023452","Total",484,482,2
"2011","East Hertfordshire 003B","E01023453","Total",557,538,19
"2011","East Hertfordshire 003C","E01023454","Total",511,504,7
"2011","East Hertfordshire 003D","E01023455","Total",550,538,12
"2011","East Hertfordshire 003E","E01023463","Total",514,497,17
"2011","East Hertfordshire 003F","E01023493","Total",977,933,44
"2011","East Hertfordshire 004A","E01023449","Total",684,669,15
"2011","East Hertfordshire 004B","E01023450","Total",1094,989,105
"2011","East Hertfordshire 004C","E01023451","Total",960,929,31
"2011","East Hertfordshire 005A","E01023438","Total",606,583,23
"2011","East Hertfordshire 005B","E01023439","Total",524,504,20
"2011","East Hertfordshire 005C","E01023440","Total",650,647,3
"2011","East Hertfordshire 005D","E01023441","Total",520,491,29
"2011","East Hertfordshire 005E","E01023442","Total",822,798,24
"2011","East Hertfordshire 006A","E01023498","Total",1114,1103,11
"2011","East Hertfordshire 006B","E01023506","Total",590,578,12
"2011","East Hertfordshire 006C","E01023507","Total",654,627,27
"2011","East Hertfordshire 007A","E01023443","Total",654,647,7
"2011","East Hertfordshire 007B","E01023444","Total",713,681,32
"2011","East Hertfordshire 007C","E01023445","Total",715,701,14
"2011","East Hertfordshire 007D","E01023446","Total",1205,1135,70
"2011","East Hertfordshire 007E","E01023447","Total",492,484,8
"2011","East Hertfordshire 007F","E01023448","Total",588,585,3
"2011","East Hertfordshire 008A","E01023456","Total",512,511,1
"2011","East Hertfordshire 008B","E01023457","Total",614,610,4
"2011","East Hertfordshire 008C","E01023458","Total",534,520,14
"2011","East Hertfordshire 008D","E01023459","Total",522,518,4
"2011","East Hertfordshire 008E","E01023460","Total",558,548,10
"2011","East Hertfordshire 008F","E01023461","Total",518,515,3
"2011","East Hertfordshire 009A","E01023491","Total",537,528,9
"2011","East Hertfordshire 009B","E01023492","Total",596,586,10
"2011","East Hertfordshire 009C","E01023496","Total",469,442,27
"2011","East Hertfordshire 009D","E01023497","Total",679,648,31
"2011","East Hertfordshire 010A","E01023485","Total",982,954,28
"2011","East Hertfordshire 010B","E01023486","Total",1021,989,32
"2011","East Hertfordshire 010E","E01033609","Total",980,971,9
"2011","East Hertfordshire 011A","E01023499","Total",786,755,31
"2011","East Hertfordshire 011B","E01023500","Total",627,615,12
"2011","East Hertfordshire 011C","E01023501","Total",686,679,7
"2011","East Hertfordshire 011D","E01023502","Total",839,799,40
"2011","East Hertfordshire 011E","E01023503","Total",828,739,89
"2011","East Hertfordshire 012A","E01023512","Total",855,834,21
"2011","East Hertfordshire 012B","E01023513","Total",599,590,9
"2011","East Hertfordshire 012C","E01023514","Total",943,907,36
"2011","East Hertfordshire 012D","E01023518","Total",711,705,6
"2011","East Hertfordshire 012E","E01023519","Total",674,668,6
"2011","East Hertfordshire 012F","E01023520","Total",666,664,2
"2011","East Hertfordshire 013A","E01023510","Total",636,605,31
"2011","East Hertfordshire 013B","E01023511","Total",837,815,22
"2011","East Hertfordshire 013C","E01023515","Total",679,670,9
"2011","East Hertfordshire 013D","E01023516","Total",884,874,10
"2011","East Hertfordshire 013E","E01023517","Total",685,679,6
"2011","East Hertfordshire 014A","E01023470","Total",934,906,28
"2011","East Hertfordshire 014B","E01023471","Total",550,536,14
"2011","East Hertfordshire 014C","E01023472","Total",614,606,8
"2011","East Hertfordshire 014D","E01023473","Total",609,598,11
"2011","East Hertfordshire 014E","E01023474","Total",640,624,16
"2011","East Hertfordshire 015A","E01023487","Total",640,624,16
"2011","East Hertfordshire 015B","E01023488","Total",747,706,41
"2011","East Hertfordshire 015C","E01023489","Total",645,641,4
"2011","East Hertfordshire 015D","E01023490","Total",481,478,3
"2011","East Hertfordshire 016A","E01023482","Total",757,751,6
"2011","East Hertfordshire 016B","E01023483","Total",762,740,22
"2011","East Hertfordshire 016C","E01023484","Total",648,638,10
"2011","East Hertfordshire 017A","E01023475","Total",635,623,12
"2011","East Hertfordshire 017B","E01023476","Total",642,599,43
"2011","East Hertfordshire 017C","E01023477","Total",958,922,36
"2011","East Hertfordshire 017D","E01023478","Total",1069,961,108
"2011","East Hertfordshire 017E","E01023479","Total",725,705,20
"2011","East Hertfordshire 018A","E01023468","Total",554,532,22
"2011","East Hertfordshire 018B","E01023469","Total",617,606,11
"2011","East Hertfordshire 018C","E01023480","Total",689,675,14
"2011","East Hertfordshire 018D","E01023481","Total",497,480,17
"2011","East Hertfordshire 018E","E01023504","Total",598,574,24
"2011","East Hertfordshire 018F","E01023505","Total",748,734,14
"2011","Hertsmere 001A","E01023576","Total",611,599,12
"2011","Hertsmere 001B","E01023577","Total",731,719,12
"2011","Hertsmere 001C","E01023578","Total",675,651,24
"2011","Hertsmere 001D","E01023579","Total",630,586,44
"2011","Hertsmere 001E","E01023580","Total",734,708,26
"2011","Hertsmere 002A","E01023567","Total",765,743,22
"2011","Hertsmere 002B","E01023568","Total",652,634,18
"2011","Hertsmere 002C","E01023569","Total",611,601,10
"2011","Hertsmere 002D","E01023570","Total",632,610,22
"2011","Hertsmere 003A","E01023571","Total",622,597,25
"2011","Hertsmere 003B","E01023572","Total",644,618,26
"2011","Hertsmere 003C","E01023573","Total",541,524,17
"2011","Hertsmere 003D","E01023574","Total",667,654,13
"2011","Hertsmere 003E","E01023575","Total",669,647,22
"2011","Hertsmere 004A","E01023581","Total",493,488,5
"2011","Hertsmere 004B","E01023582","Total",630,617,13
"2011","Hertsmere 004C","E01023583","Total",584,563,21
"2011","Hertsmere 004D","E01023584","Total",462,433,29
"2011","Hertsmere 005A","E01023523","Total",622,613,9
"2011","Hertsmere 005B","E01023524","Total",541,516,25
"2011","Hertsmere 005C","E01023525","Total",799,748,51
"2011","Hertsmere 005D","E01023526","Total",693,665,28
"2011","Hertsmere 005E","E01023527","Total",627,601,26
"2011","Hertsmere 006A","E01023534","Total",640,613,27
"2011","Hertsmere 006B","E01023535","Total",680,667,13
"2011","Hertsmere 006C","E01023536","Total",808,786,22
"2011","Hertsmere 006D","E01023537","Total",653,645,8
"2011","Hertsmere 006E","E01023538","Total",802,774,28
"2011","Hertsmere 007A","E01023529","Total",572,559,13
"2011","Hertsmere 007B","E01023530","Total",567,557,10
"2011","Hertsmere 007C","E01023531","Total",793,779,14
"2011","Hertsmere 007D","E01023532","Total",674,661,13
"2011","Hertsmere 007E","E01023533","Total",629,617,12
"2011","Hertsmere 008A","E01023552","Total",619,599,20
"2011","Hertsmere 008B","E01023553","Total",598,584,14
"2011","Hertsmere 008C","E01023554","Total",710,695,15
"2011","Hertsmere 008D","E01023555","Total",724,713,11
"2011","Hertsmere 009A","E01023544","Total",498,489,9
"2011","Hertsmere 009B","E01023545","Total",591,580,11
"2011","Hertsmere 009C","E01023546","Total",752,722,30
"2011","Hertsmere 009D","E01023547","Total",720,695,25
"2011","Hertsmere 010A","E01023528","Total",666,629,37
"2011","Hertsmere 010B","E01023564","Total",661,641,20
"2011","Hertsmere 010C","E01023565","Total",651,621,30
"2011","Hertsmere 010D","E01023566","Total",525,514,11
"2011","Hertsmere 011A","E01023539","Total",1191,1163,28
"2011","Hertsmere 011B","E01023540","Total",650,634,16
"2011","Hertsmere 011C","E01023541","Total",733,712,21
"2011","Hertsmere 011D","E01023542","Total",677,652,25
"2011","Hertsmere 011E","E01023543","Total",585,577,8
"2011","Hertsmere 012A","E01023558","Total",772,752,20
"2011","Hertsmere 012B","E01023559","Total",600,586,14
"2011","Hertsmere 012C","E01023560","Total",621,604,17
"2011","Hertsmere 012D","E01023561","Total",658,641,17
"2011","Hertsmere 012E","E01023562","Total",572,557,15
"2011","Hertsmere 012F","E01023563","Total",648,634,14
"2011","Hertsmere 013A","E01023548","Total",810,790,20
"2011","Hertsmere 013B","E01023549","Total",821,782,39
"2011","Hertsmere 013C","E01023550","Total",701,648,53
"2011","Hertsmere 013D","E01023551","Total",561,542,19
"2011","Hertsmere 013E","E01023556","Total",644,623,21
"2011","Hertsmere 013F","E01023557","Total",622,606,16
"2011","North Hertfordshire 001A","E01023660","Total",1103,1047,56
"2011","North Hertfordshire 001B","E01023661","Total",527,521,6
"2011","North Hertfordshire 001C","E01023662","Total",625,607,18
"2011","North Hertfordshire 002A","E01023654","Total",671,647,24
"2011","North Hertfordshire 002B","E01023655","Total",633,623,10
"2011","North Hertfordshire 002C","E01023656","Total",1041,999,42
"2011","North Hertfordshire 002D","E01023657","Total",1044,1018,26
"2011","North Hertfordshire 002E","E01023658","Total",645,638,7
"2011","North Hertfordshire 002F","E01023659","Total",511,506,5
"2011","North Hertfordshire 003A","E01023635","Total",617,616,1
"2011","North Hertfordshire 003B","E01023636","Total",804,783,21
"2011","North Hertfordshire 003C","E01023637","Total",875,870,5
"2011","North Hertfordshire 003D","E01023638","Total",670,666,4
"2011","North Hertfordshire 004A","E01023587","Total",504,497,7
"2011","North Hertfordshire 004B","E01023588","Total",560,544,16
"2011","North Hertfordshire 004C","E01023589","Total",852,800,52
"2011","North Hertfordshire 004D","E01023590","Total",759,738,21
"2011","North Hertfordshire 004E","E01023591","Total",635,627,8
"2011","North Hertfordshire 004F","E01023592","Total",569,556,13
"2011","North Hertfordshire 004G","E01023593","Total",616,613,3
"2011","North Hertfordshire 005A","E01023585","Total",487,465,22
"2011","North Hertfordshire 005B","E01023586","Total",688,646,42
"2011","North Hertfordshire 005C","E01023597","Total",515,491,24
"2011","North Hertfordshire 005D","E01023598","Total",570,549,21
"2011","North Hertfordshire 005F","E01023600","Total",584,574,10
"2011","North Hertfordshire 005G","E01023663","Total",890,839,51
"2011","North Hertfordshire 005H","E01033024","Total",541,535,6
"2011","North Hertfordshire 005I","E01033025","Total",529,519,10
"2011","North Hertfordshire 005J","E01033026","Total",581,573,8
"2011","North Hertfordshire 005K","E01033027","Total",615,605,10
"2011","North Hertfordshire 006A","E01023630","Total",633,618,15
"2011","North Hertfordshire 006B","E01023631","Total",717,712,5
"2011","North Hertfordshire 006C","E01023632","Total",573,560,13
"2011","North Hertfordshire 006D","E01023633","Total",629,616,13
"2011","North Hertfordshire 006E","E01023634","Total",615,609,6
"2011","North Hertfordshire 007A","E01023649","Total",666,641,25
"2011","North Hertfordshire 007B","E01023650","Total",625,606,19
"2011","North Hertfordshire 007C","E01023651","Total",494,483,11
"2011","North Hertfordshire 007D","E01023652","Total",608,605,3
"2011","North Hertfordshire 008A","E01023644","Total",765,717,48
"2011","North Hertfordshire 008B","E01023645","Total",657,642,15
"2011","North Hertfordshire 008C","E01023646","Total",515,507,8
"2011","North Hertfordshire 008D","E01023647","Total",607,597,10
"2011","North Hertfordshire 008E","E01023648","Total",486,470,16
"2011","North Hertfordshire 009A","E01023639","Total",554,541,13
"2011","North Hertfordshire 009B","E01023640","Total",570,560,10
"2011","North Hertfordshire 009C","E01023641","Total",590,579,11
"2011","North Hertfordshire 009D","E01023642","Total",502,497,5
"2011","North Hertfordshire 009E","E01023643","Total",499,495,4
"2011","North Hertfordshire 010A","E01023601","Total",1182,1103,79
"2011","North Hertfordshire 010B","E01023602","Total",670,637,33
"2011","North Hertfordshire 010C","E01023603","Total",623,611,12
"2011","North Hertfordshire 010D","E01023604","Total",549,536,13
"2011","North Hertfordshire 010E","E01023605","Total",757,728,29
"2011","North Hertfordshire 011A","E01023617","Total",637,622,15
"2011","North Hertfordshire 011B","E01023618","Total",611,602,9
"2011","North Hertfordshire 011C","E01023619","Total",746,730,16
"2011","North Hertfordshire 011D","E01023620","Total",534,528,6
"2011","North Hertfordshire 011E","E01023621","Total",594,591,3
"2011","North Hertfordshire 012A","E01023611","Total",679,664,15
"2011","North Hertfordshire 012B","E01023612","Total",769,739,30
"2011","North Hertfordshire 012C","E01023613","Total",789,763,26
"2011","North Hertfordshire 012D","E01023614","Total",819,806,13
"2011","North Hertfordshire 012E","E01023615","Total",671,652,19
"2011","North Hertfordshire 012F","E01023616","Total",1134,1036,98
"2011","North Hertfordshire 013A","E01023606","Total",799,780,19
"2011","North Hertfordshire 013B","E01023607","Total",601,588,13
"2011","North Hertfordshire 013C","E01023608","Total",644,634,10
"2011","North Hertfordshire 013D","E01023609","Total",730,714,16
"2011","North Hertfordshire 013E","E01023610","Total",510,500,10
"2011","North Hertfordshire 014A","E01023594","Total",1008,972,36
"2011","North Hertfordshire 014B","E01023622","Total",470,455,15
"2011","North Hertfordshire 014C","E01023623","Total",608,596,12
"2011","North Hertfordshire 014D","E01023624","Total",551,524,27
"2011","North Hertfordshire 014E","E01023625","Total",435,425,10
"2011","North Hertfordshire 014F","E01023653","Total",923,887,36
"2011","North Hertfordshire 015A","E01023595","Total",707,679,28
"2011","North Hertfordshire 015B","E01023596","Total",506,492,14
"2011","North Hertfordshire 015C","E01023626","Total",884,862,22
"2011","North Hertfordshire 015D","E01023627","Total",692,671,21
"2011","North Hertfordshire 015E","E01023628","Total",805,750,55
"2011","North Hertfordshire 015F","E01023629","Total",792,782,10
"2011","St Albans 001A","E01023690","Total",630,608,22
"2011","St Albans 001B","E01023691","Total",508,502,6
"2011","St Albans 001C","E01023692","Total",515,502,13
"2011","St Albans 001D","E01023693","Total",531,523,8
"2011","St Albans 001E","E01023694","Total",523,509,14
"2011","St Albans 002A","E01023685","Total",660,645,15
"2011","St Albans 002B","E01023686","Total",527,523,4
"2011","St Albans 002C","E01023687","Total",610,604,6
"2011","St Albans 002D","E01023688","Total",641,626,15
"2011","St Albans 002E","E01023689","Total",524,509,15
"2011","St Albans 003A","E01023699","Total",618,597,21
"2011","St Albans 003B","E01023700","Total",481,472,9
"2011","St Albans 003C","E01023701","Total",885,845,40
"2011","St Albans 003D","E01023702","Total",704,682,22
"2011","St Albans 003E","E01023703","Total",528,518,10
"2011","St Albans 004A","E01023746","Total",634,626,8
"2011","St Albans 004B","E01023747","Total",755,735,20
"2011","St Albans 004C","E01023748","Total",581,565,16
"2011","St Albans 004D","E01023749","Total",663,656,7
"2011","St Albans 005A","E01023695","Total",619,613,6
"2011","St Albans 005B","E01023696","Total",664,633,31
"2011","St Albans 005C","E01023697","Total",825,792,33
"2011","St Albans 005D","E01023698","Total",607,601,6
"2011","St Albans 006A","E01023722","Total",629,582,47
"2011","St Albans 006B","E01023723","Total",689,677,12
"2011","St Albans 006C","E01023724","Total",726,703,23
"2011","St Albans 006D","E01023725","Total",597,572,25
"2011","St Albans 007A","E01023713","Total",687,680,7
"2011","St Albans 007B","E01023734","Total",661,651,10
"2011","St Albans 007C","E01023735","Total",810,799,11
"2011","St Albans 007D","E01023736","Total",671,648,23
"2011","St Albans 008A","E01023709","Total",740,728,12
"2011","St Albans 008B","E01023710","Total",544,542,2
"2011","St Albans 008C","E01023711","Total",633,605,28
"2011","St Albans 008D","E01023712","Total",761,738,23
"2011","St Albans 009A","E01023669","Total",690,670,20
"2011","St Albans 009B","E01023670","Total",837,811,26
"2011","St Albans 009C","E01023671","Total",754,735,19
"2011","St Albans 009D","E01023672","Total",683,664,19
"2011","St Albans 010A","E01023673","Total",509,501,8
"2011","St Albans 010B","E01023714","Total",650,638,12
"2011","St Albans 010C","E01023715","Total",536,525,11
"2011","St Albans 010D","E01023716","Total",873,841,32
"2011","St Albans 011A","E01023666","Total",806,773,33
"2011","St Albans 011B","E01023674","Total",745,723,22
"2011","St Albans 011C","E01023675","Total",516,501,15
"2011","St Albans 011D","E01023676","Total",1097,1000,97
"2011","St Albans 012A","E01023726","Total",877,827,50
"2011","St Albans 012B","E01023727","Total",1081,1024,57
"2011","St Albans 012C","E01023728","Total",1000,956,44
"2011","St Albans 012D","E01023729","Total",900,854,46
"2011","St Albans 013A","E01023664","Total",662,649,13
"2011","St Albans 013B","E01023665","Total",622,592,30
"2011","St Albans 013C","E01023667","Total",591,568,23
"2011","St Albans 013D","E01023668","Total",479,475,4
"2011","St Albans 014A","E01023742","Total",564,557,7
"2011","St Albans 014B","E01023743","Total",817,777,40
"2011","St Albans 014C","E01023744","Total",632,614,18
"2011","St Albans 014D","E01023745","Total",803,759,44
"2011","St Albans 015A","E01023677","Total",475,458,17
"2011","St Albans 015B","E01023678","Total",751,725,26
"2011","St Albans 015C","E01023679","Total",632,593,39
"2011","St Albans 015D","E01023680","Total",513,506,7
"2011","St Albans 016A","E01023681","Total",711,689,22
"2011","St Albans 016B","E01023682","Total",662,651,11
"2011","St Albans 016C","E01023683","Total",679,670,9
"2011","St Albans 016D","E01023684","Total",684,672,12
"2011","St Albans 017A","E01023737","Total",519,509,10
"2011","St Albans 017B","E01023738","Total",657,635,22
"2011","St Albans 017C","E01023739","Total",554,544,10
"2011","St Albans 017D","E01023740","Total",697,654,43
"2011","St Albans 017E","E01023741","Total",640,633,7
"2011","St Albans 018A","E01023704","Total",793,755,38
"2011","St Albans 018B","E01023705","Total",642,613,29
"2011","St Albans 018C","E01023706","Total",673,649,24
"2011","St Albans 018E","E01023708","Total",659,647,12
"2011","St Albans 018F","E01033028","Total",544,515,29
"2011","St Albans 018G","E01033029","Total",595,584,11
"2011","St Albans 019A","E01023718","Total",736,698,38
"2011","St Albans 019B","E01023719","Total",480,471,9
"2011","St Albans 019C","E01023720","Total",826,804,22
"2011","St Albans 019D","E01023721","Total",555,540,15
"2011","St Albans 020A","E01023717","Total",515,487,28
"2011","St Albans 020B","E01023730","Total",689,672,17
"2011","St Albans 020C","E01023731","Total",653,610,43
"2011","St Albans 020D","E01023732","Total",693,666,27
"2011","St Albans 020E","E01023733","Total",668,645,23
"2011","Stevenage 001A","E01023787","Total",551,546,5
"2011","Stevenage 001B","E01023788","Total",641,629,12
"2011","Stevenage 001C","E01023789","Total",796,751,45
"2011","Stevenage 001D","E01023790","Total",641,633,8
"2011","Stevenage 002A","E01023776","Total",1140,1122,18
"2011","Stevenage 002B","E01023777","Total",774,759,15
"2011","Stevenage 002C","E01023778","Total",675,664,11
"2011","Stevenage 002D","E01023799","Total",506,504,2
"2011","Stevenage 002E","E01023800","Total",807,793,14
"2011","Stevenage 002F","E01023801","Total",926,914,12
"2011","Stevenage 003A","E01023771","Total",687,683,4
"2011","Stevenage 003B","E01023772","Total",766,755,11
"2011","Stevenage 003C","E01023773","Total",533,526,7
"2011","Stevenage 003D","E01023774","Total",687,668,19
"2011","Stevenage 004A","E01023767","Total",616,613,3
"2011","Stevenage 004B","E01023768","Total",684,679,5
"2011","Stevenage 004C","E01023769","Total",712,704,8
"2011","Stevenage 004D","E01023770","Total",644,636,8
"2011","Stevenage 005A","E01023795","Total",692,676,16
"2011","Stevenage 005B","E01023796","Total",740,724,16
"2011","Stevenage 005C","E01023797","Total",578,569,9
"2011","Stevenage 005D","E01023798","Total",661,642,19
"2011","Stevenage 006A","E01023775","Total",986,940,46
"2011","Stevenage 006B","E01023779","Total",695,678,17
"2011","Stevenage 006C","E01023780","Total",666,650,16
"2011","Stevenage 006D","E01023781","Total",793,782,11
"2011","Stevenage 006E","E01023782","Total",651,639,12
"2011","Stevenage 007A","E01023759","Total",599,591,8
"2011","Stevenage 007B","E01023760","Total",623,615,8
"2011","Stevenage 007C","E01023761","Total",879,866,13
"2011","Stevenage 007D","E01023762","Total",647,638,9
"2011","Stevenage 008A","E01023755","Total",644,630,14
"2011","Stevenage 008B","E01023756","Total",612,602,10
"2011","Stevenage 008C","E01023757","Total",764,753,11
"2011","Stevenage 008D","E01023758","Total",1116,1056,60
"2011","Stevenage 009A","E01023750","Total",638,615,23
"2011","Stevenage 009B","E01023751","Total",474,467,7
"2011","Stevenage 009C","E01023752","Total",513,505,8
"2011","Stevenage 009D","E01023753","Total",644,636,8
"2011","Stevenage 009E","E01023754","Total",477,471,6
"2011","Stevenage 010A","E01023791","Total",637,620,17
"2011","Stevenage 010B","E01023792","Total",614,608,6
"2011","Stevenage 010C","E01023793","Total",622,616,6
"2011","Stevenage 010D","E01023794","Total",631,623,8
"2011","Stevenage 011A","E01023783","Total",711,694,17
"2011","Stevenage 011B","E01023784","Total",687,680,7
"2011","Stevenage 011C","E01023785","Total",688,675,13
"2011","Stevenage 011D","E01023786","Total",639,624,15
"2011","Stevenage 012A","E01023763","Total",603,594,9
"2011","Stevenage 012B","E01023764","Total",648,632,16
"2011","Stevenage 012C","E01023765","Total",607,596,11
"2011","Stevenage 012D","E01023766","Total",619,612,7
"2011","Three Rivers 001A","E01023802","Total",764,739,25
"2011","Three Rivers 001B","E01023803","Total",623,610,13
"2011","Three Rivers 001C","E01023804","Total",635,627,8
"2011","Three Rivers 001D","E01023807","Total",628,611,17
"2011","Three Rivers 001E","E01023808","Total",1179,1151,28
"2011","Three Rivers 002A","E01023829","Total",631,620,11
"2011","Three Rivers 002B","E01023830","Total",761,748,13
"2011","Three Rivers 002C","E01023832","Total",700,683,17
"2011","Three Rivers 002D","E01023833","Total",921,912,9
"2011","Three Rivers 002E","E01023834","Total",579,573,6
"2011","Three Rivers 003A","E01023823","Total",603,586,17
"2011","Three Rivers 003B","E01023824","Total",749,738,11
"2011","Three Rivers 003C","E01023831","Total",764,749,15
"2011","Three Rivers 003D","E01023854","Total",834,788,46
"2011","Three Rivers 004A","E01023812","Total",508,486,22
"2011","Three Rivers 004B","E01023813","Total",514,489,25
"2011","Three Rivers 004C","E01023814","Total",527,500,27
"2011","Three Rivers 004D","E01023851","Total",818,762,56
"2011","Three Rivers 005A","E01023815","Total",607,590,17
"2011","Three Rivers 005B","E01023816","Total",514,496,18
"2011","Three Rivers 005C","E01023817","Total",611,592,19
"2011","Three Rivers 005D","E01023818","Total",517,506,11
"2011","Three Rivers 006A","E01023819","Total",699,678,21
"2011","Three Rivers 006B","E01023820","Total",552,537,15
"2011","Three Rivers 006C","E01023821","Total",499,493,6
"2011","Three Rivers 006D","E01023822","Total",542,528,14
"2011","Three Rivers 006E","E01023825","Total",913,898,15
"2011","Three Rivers 006F","E01023826","Total",552,547,5
"2011","Three Rivers 007A","E01023847","Total",796,783,13
"2011","Three Rivers 007B","E01023848","Total",633,624,9
"2011","Three Rivers 007C","E01023850","Total",819,775,44
"2011","Three Rivers 007D","E01023852","Total",608,591,17
"2011","Three Rivers 007E","E01023853","Total",762,744,18
"2011","Three Rivers 008A","E01023827","Total",877,860,17
"2011","Three Rivers 008B","E01023828","Total",624,612,12
"2011","Three Rivers 008C","E01023845","Total",717,695,22
"2011","Three Rivers 008D","E01023846","Total",588,569,19
"2011","Three Rivers 009A","E01023835","Total",545,534,11
"2011","Three Rivers 009B","E01023836","Total",642,629,13
"2011","Three Rivers 009C","E01023837","Total",665,649,16
"2011","Three Rivers 009D","E01023838","Total",514,502,12
"2011","Three Rivers 010A","E01023805","Total",656,638,18
"2011","Three Rivers 010B","E01023809","Total",781,761,20
"2011","Three Rivers 010C","E01023810","Total",759,731,28
"2011","Three Rivers 010D","E01023811","Total",639,624,15
"2011","Three Rivers 011A","E01023839","Total",791,764,27
"2011","Three Rivers 011B","E01023840","Total",621,560,61
"2011","Three Rivers 011C","E01023841","Total",591,541,50
"2011","Three Rivers 011D","E01023849","Total",628,600,28
"2011","Three Rivers 012A","E01023806","Total",874,861,13
"2011","Three Rivers 012B","E01023842","Total",637,618,19
"2011","Three Rivers 012C","E01023843","Total",855,829,26
"2011","Three Rivers 012D","E01023844","Total",793,777,16
"2011","Watford 001A","E01023904","Total",783,777,6
"2011","Watford 001B","E01023905","Total",855,842,13
"2011","Watford 001C","E01023906","Total",638,630,8
"2011","Watford 001D","E01023907","Total",765,753,12
"2011","Watford 002A","E01023890","Total",520,511,9
"2011","Watford 002B","E01023891","Total",519,513,6
"2011","Watford 002C","E01023892","Total",515,506,9
"2011","Watford 002D","E01023893","Total",749,728,21
"2011","Watford 002E","E01023894","Total",544,534,10
"2011","Watford 003A","E01023873","Total",545,539,6
"2011","Watford 003B","E01023874","Total",495,493,2
"2011","Watford 003C","E01023875","Total",833,813,20
"2011","Watford 003D","E01023876","Total",737,723,14
"2011","Watford 003E","E01023877","Total",674,661,13
"2011","Watford 004A","E01023868","Total",686,678,8
"2011","Watford 004B","E01023869","Total",489,481,8
"2011","Watford 004C","E01023870","Total",479,475,4
"2011","Watford 004D","E01023871","Total",521,507,14
"2011","Watford 004E","E01023872","Total",641,633,8
"2011","Watford 005A","E01023895","Total",775,753,22
"2011","Watford 005B","E01023896","Total",484,472,12
"2011","Watford 005C","E01023897","Total",680,673,7
"2011","Watford 005D","E01023898","Total",568,558,10
"2011","Watford 006A","E01023855","Total",823,808,15
"2011","Watford 006B","E01023856","Total",1015,994,21
"2011","Watford 006C","E01023857","Total",584,578,6
"2011","Watford 006D","E01023858","Total",802,781,21
"2011","Watford 007A","E01023878","Total",782,764,18
"2011","Watford 007B","E01023879","Total",997,969,28
"2011","Watford 007C","E01023880","Total",881,855,26
"2011","Watford 007D","E01023881","Total",601,585,16
"2011","Watford 008A","E01023886","Total",1137,1108,29
"2011","Watford 008B","E01023887","Total",633,621,12
"2011","Watford 008C","E01023888","Total",624,580,44
"2011","Watford 008D","E01023889","Total",635,629,6
"2011","Watford 009A","E01023859","Total",1025,989,36
"2011","Watford 009B","E01023860","Total",918,889,29
"2011","Watford 009C","E01023861","Total",1214,1117,97
"2011","Watford 009D","E01023862","Total",992,953,39
"2011","Watford 010A","E01023899","Total",562,532,30
"2011","Watford 010B","E01023900","Total",570,557,13
"2011","Watford 010C","E01023901","Total",743,720,23
"2011","Watford 010D","E01023902","Total",627,613,14
"2011","Watford 010E","E01023903","Total",561,549,12
"2011","Watford 011A","E01023863","Total",700,686,14
"2011","Watford 011B","E01023864","Total",659,649,10
"2011","Watford 011C","E01023865","Total",634,626,8
"2011","Watford 011D","E01023866","Total",624,618,6
"2011","Watford 011E","E01023867","Total",901,881,20
"2011","Watford 012A","E01023882","Total",658,649,9
"2011","Watford 012B","E01023883","Total",672,661,11
"2011","Watford 012C","E01023884","Total",814,789,25
"2011","Watford 012D","E01023885","Total",694,678,16
"2011","Welwyn Hatfield 001A","E01023965","Total",541,531,10
"2011","Welwyn Hatfield 001B","E01023966","Total",670,654,16
"2011","Welwyn Hatfield 001C","E01023967","Total",589,576,13
"2011","Welwyn Hatfield 001D","E01023971","Total",639,626,13
"2011","Welwyn Hatfield 002B","E01023968","Total",526,506,20
"2011","Welwyn Hatfield 002C","E01023969","Total",676,617,59
"2011","Welwyn Hatfield 002D","E01023970","Total",627,596,31
"2011","Welwyn Hatfield 002E","E01033310","Total",649,630,19
"2011","Welwyn Hatfield 002F","E01033313","Total",559,534,25
"2011","Welwyn Hatfield 003A","E01023959","Total",587,567,20
"2011","Welwyn Hatfield 003B","E01023960","Total",659,646,13
"2011","Welwyn Hatfield 003C","E01023961","Total",626,621,5
"2011","Welwyn Hatfield 003D","E01023962","Total",587,574,13
"2011","Welwyn Hatfield 004A","E01023912","Total",620,607,13
"2011","Welwyn Hatfield 004B","E01023913","Total",573,568,5
"2011","Welwyn Hatfield 004C","E01023914","Total",765,754,11
"2011","Welwyn Hatfield 004D","E01023915","Total",661,652,9
"2011","Welwyn Hatfield 005A","E01023950","Total",624,620,4
"2011","Welwyn Hatfield 005B","E01023951","Total",815,784,31
"2011","Welwyn Hatfield 005C","E01023952","Total",875,861,14
"2011","Welwyn Hatfield 005D","E01023953","Total",632,613,19
"2011","Welwyn Hatfield 006A","E01023916","Total",717,700,17
"2011","Welwyn Hatfield 006B","E01023917","Total",786,763,23
"2011","Welwyn Hatfield 006C","E01023918","Total",1006,963,43
"2011","Welwyn Hatfield 006D","E01023919","Total",596,571,25
"2011","Welwyn Hatfield 007A","E01023954","Total",742,711,31
"2011","Welwyn Hatfield 007B","E01023955","Total",531,516,15
"2011","Welwyn Hatfield 007C","E01023956","Total",524,511,13
"2011","Welwyn Hatfield 007D","E01023957","Total",678,633,45
"2011","Welwyn Hatfield 007E","E01023958","Total",600,564,36
"2011","Welwyn Hatfield 008A","E01023943","Total",604,590,14
"2011","Welwyn Hatfield 008B","E01023944","Total",864,839,25
"2011","Welwyn Hatfield 008C","E01023945","Total",657,638,19
"2011","Welwyn Hatfield 008D","E01023946","Total",807,665,142
"2011","Welwyn Hatfield 009A","E01023939","Total",535,526,9
"2011","Welwyn Hatfield 009B","E01023940","Total",731,718,13
"2011","Welwyn Hatfield 009C","E01023941","Total",1276,1168,108
"2011","Welwyn Hatfield 009D","E01023942","Total",623,606,17
"2011","Welwyn Hatfield 010A","E01023929","Total",670,642,28
"2011","Welwyn Hatfield 010B","E01023930","Total",710,678,32
"2011","Welwyn Hatfield 010D","E01023938","Total",617,603,14
"2011","Welwyn Hatfield 010E","E01033308","Total",733,649,84
"2011","Welwyn Hatfield 010F","E01033311","Total",638,614,24
"2011","Welwyn Hatfield 010G","E01033314","Total",712,645,67
"2011","Welwyn Hatfield 011A","E01023924","Total",651,639,12
"2011","Welwyn Hatfield 011B","E01023925","Total",637,549,88
"2011","Welwyn Hatfield 011C","E01023926","Total",775,740,35
"2011","Welwyn Hatfield 011D","E01023927","Total",715,685,30
"2011","Welwyn Hatfield 012A","E01023920","Total",789,762,27
"2011","Welwyn Hatfield 012B","E01023921","Total",941,881,60
"2011","Welwyn Hatfield 012C","E01023922","Total",661,635,26
"2011","Welwyn Hatfield 012D","E01023923","Total",709,687,22
"2011","Welwyn Hatfield 013A","E01023932","Total",625,587,38
"2011","Welwyn Hatfield 013B","E01023934","Total",511,485,26
"2011","Welwyn Hatfield 013C","E01023935","Total",462,449,13
"2011","Welwyn Hatfield 013D","E01023936","Total",790,783,7
"2011","Welwyn Hatfield 013E","E01023937","Total",497,491,6
"2011","Welwyn Hatfield 014A","E01023933","Total",655,635,20
"2011","Welwyn Hatfield 014B","E01023963","Total",1042,1021,21
"2011","Welwyn Hatfield 014C","E01023964","Total",662,617,45
"2011","Welwyn Hatfield 015A","E01023908","Total",643,599,44
"2011","Welwyn Hatfield 015B","E01023909","Total",435,418,17
"2011","Welwyn Hatfield 015C","E01023910","Total",540,520,20
"2011","Welwyn Hatfield 015D","E01023911","Total",718,687,31
"2011","Welwyn Hatfield 016A","E01023947","Total",758,702,56
"2011","Welwyn Hatfield 016B","E01023948","Total",672,644,28
"2011","Welwyn Hatfield 016C","E01023949","Total",800,747,53
"2011","Breckland 001A","E01026436","Total",1029,968,61
"2011","Breckland 001C","E01026461","Total",618,573,45
"2011","Breckland 001E","E01026483","Total",513,491,22
"2011","Breckland 001F","E01033042","Total",992,864,128
"2011","Breckland 002A","E01026442","Total",1024,922,102
"2011","Breckland 002B","E01026443","Total",894,834,60
"2011","Breckland 002C","E01026445","Total",1059,1001,58
"2011","Breckland 002D","E01026462","Total",997,937,60
"2011","Breckland 003A","E01026428","Total",1102,1070,32
"2011","Breckland 003B","E01026429","Total",727,701,26
"2011","Breckland 003C","E01026430","Total",716,692,24
"2011","Breckland 003D","E01026431","Total",513,492,21
"2011","Breckland 004A","E01026446","Total",924,877,47
"2011","Breckland 004B","E01026452","Total",734,711,23
"2011","Breckland 004C","E01026453","Total",669,628,41
"2011","Breckland 004D","E01026454","Total",633,627,6
"2011","Breckland 005A","E01026425","Total",869,851,18
"2011","Breckland 005B","E01026426","Total",1226,1179,47
"2011","Breckland 005C","E01026427","Total",985,939,46
"2011","Breckland 005D","E01026432","Total",644,633,11
"2011","Breckland 005E","E01026433","Total",628,613,15
"2011","Breckland 005F","E01026434","Total",939,915,24
"2011","Breckland 006A","E01026479","Total",662,640,22
"2011","Breckland 006B","E01026480","Total",670,658,12
"2011","Breckland 006C","E01026481","Total",502,481,21
"2011","Breckland 006D","E01026484","Total",632,583,49
"2011","Breckland 006E","E01026485","Total",482,452,30
"2011","Breckland 007A","E01026455","Total",884,825,59
"2011","Breckland 007B","E01026456","Total",532,493,39
"2011","Breckland 007C","E01026457","Total",626,605,21
"2011","Breckland 007D","E01026458","Total",721,673,48
"2011","Breckland 007E","E01026459","Total",703,662,41
"2011","Breckland 008A","E01026437","Total",574,540,34
"2011","Breckland 008B","E01026438","Total",471,432,39
"2011","Breckland 008C","E01026451","Total",931,891,40
"2011","Breckland 008D","E01026495","Total",610,572,38
"2011","Breckland 008E","E01026496","Total",519,496,23
"2011","Breckland 009A","E01026486","Total",751,705,46
"2011","Breckland 009B","E01026487","Total",675,618,57
"2011","Breckland 009C","E01026488","Total",592,548,44
"2011","Breckland 009D","E01026489","Total",653,625,28
"2011","Breckland 009E","E01026490","Total",781,730,51
"2011","Breckland 010A","E01026419","Total",510,481,29
"2011","Breckland 010B","E01026420","Total",487,470,17
"2011","Breckland 010D","E01026464","Total",547,499,48
"2011","Breckland 010E","E01026491","Total",979,907,72
"2011","Breckland 010F","E01033040","Total",425,398,27
"2011","Breckland 010G","E01033041","Total",420,400,20
"2011","Breckland 011A","E01026422","Total",944,911,33
"2011","Breckland 011B","E01026423","Total",770,751,19
"2011","Breckland 011C","E01026447","Total",737,716,21
"2011","Breckland 011D","E01026449","Total",823,793,30
"2011","Breckland 011E","E01026450","Total",744,722,22
"2011","Breckland 012A","E01026424","Total",961,884,77
"2011","Breckland 012B","E01026444","Total",964,894,70
"2011","Breckland 012C","E01026492","Total",587,563,24
"2011","Breckland 012D","E01026493","Total",540,499,41
"2011","Breckland 013A","E01026421","Total",782,738,44
"2011","Breckland 013B","E01026435","Total",911,866,45
"2011","Breckland 013C","E01026448","Total",885,867,18
"2011","Breckland 014A","E01026439","Total",714,692,22
"2011","Breckland 014B","E01026440","Total",497,463,34
"2011","Breckland 014C","E01026441","Total",684,651,33
"2011","Breckland 014D","E01026494","Total",1008,936,72
"2011","Breckland 015A","E01026465","Total",796,771,25
"2011","Breckland 015B","E01026466","Total",755,719,36
"2011","Breckland 015C","E01026467","Total",796,765,31
"2011","Breckland 016A","E01026468","Total",1089,1042,47
"2011","Breckland 016B","E01026469","Total",683,665,18
"2011","Breckland 016C","E01026470","Total",1094,1062,32
"2011","Breckland 016D","E01026471","Total",521,507,14
"2011","Breckland 016E","E01026472","Total",504,489,15
"2011","Breckland 016F","E01026473","Total",575,564,11
"2011","Breckland 017A","E01026474","Total",804,673,131
"2011","Breckland 017B","E01026475","Total",650,628,22
"2011","Breckland 017C","E01026476","Total",596,566,30
"2011","Breckland 017D","E01026477","Total",592,579,13
"2011","Breckland 017E","E01026478","Total",658,641,17
"2011","Broadland 001A","E01026499","Total",805,764,41
"2011","Broadland 001B","E01026500","Total",751,736,15
"2011","Broadland 001C","E01026501","Total",715,680,35
"2011","Broadland 001D","E01026502","Total",557,518,39
"2011","Broadland 001E","E01026503","Total",672,649,23
"2011","Broadland 002A","E01026522","Total",628,595,33
"2011","Broadland 002B","E01026523","Total",809,769,40
"2011","Broadland 002C","E01026524","Total",642,616,26
"2011","Broadland 002D","E01026525","Total",491,451,40
"2011","Broadland 002E","E01026547","Total",662,636,26
"2011","Broadland 002F","E01026548","Total",554,533,21
"2011","Broadland 003A","E01026514","Total",662,630,32
"2011","Broadland 003B","E01026515","Total",469,451,18
"2011","Broadland 003C","E01026516","Total",576,563,13
"2011","Broadland 003D","E01026517","Total",637,602,35
"2011","Broadland 004A","E01026533","Total",539,521,18
"2011","Broadland 004B","E01026534","Total",641,628,13
"2011","Broadland 004C","E01026535","Total",682,663,19
"2011","Broadland 004D","E01026536","Total",664,653,11
"2011","Broadland 004E","E01026537","Total",579,573,6
"2011","Broadland 005A","E01026549","Total",820,797,23
"2011","Broadland 005B","E01026550","Total",451,437,14
"2011","Broadland 005C","E01026551","Total",506,496,10
"2011","Broadland 005D","E01026552","Total",617,606,11
"2011","Broadland 006A","E01026562","Total",460,453,7
"2011","Broadland 006B","E01026563","Total",570,556,14
"2011","Broadland 006C","E01026564","Total",579,564,15
"2011","Broadland 006D","E01026565","Total",521,511,10
"2011","Broadland 006E","E01026566","Total",644,634,10
"2011","Broadland 006F","E01026567","Total",769,758,11
"2011","Broadland 006G","E01026568","Total",630,625,5
"2011","Broadland 007A","E01026518","Total",538,535,3
"2011","Broadland 007B","E01026519","Total",750,735,15
"2011","Broadland 007C","E01026520","Total",512,503,9
"2011","Broadland 007D","E01026521","Total",527,505,22
"2011","Broadland 008A","E01026545","Total",652,644,8
"2011","Broadland 008B","E01026546","Total",601,584,17
"2011","Broadland 008C","E01026578","Total",779,762,17
"2011","Broadland 008D","E01026579","Total",651,638,13
"2011","Broadland 008E","E01026580","Total",770,708,62
"2011","Broadland 009A","E01026540","Total",662,644,18
"2011","Broadland 009B","E01026541","Total",1042,1027,15
"2011","Broadland 009C","E01026542","Total",659,651,8
"2011","Broadland 009D","E01026543","Total",651,634,17
"2011","Broadland 009E","E01026544","Total",725,722,3
"2011","Broadland 010A","E01026526","Total",663,649,14
"2011","Broadland 010B","E01026527","Total",676,664,12
"2011","Broadland 010C","E01026528","Total",613,602,11
"2011","Broadland 010D","E01026529","Total",743,722,21
"2011","Broadland 011A","E01026530","Total",773,747,26
"2011","Broadland 011B","E01026531","Total",776,748,28
"2011","Broadland 011C","E01026532","Total",756,738,18
"2011","Broadland 012A","E01026553","Total",628,611,17
"2011","Broadland 012B","E01026554","Total",512,504,8
"2011","Broadland 012C","E01026555","Total",623,610,13
"2011","Broadland 012D","E01026556","Total",662,639,23
"2011","Broadland 013A","E01026557","Total",648,637,11
"2011","Broadland 013B","E01026558","Total",633,614,19
"2011","Broadland 013C","E01026559","Total",640,626,14
"2011","Broadland 013D","E01026560","Total",647,633,14
"2011","Broadland 013E","E01026561","Total",668,650,18
"2011","Broadland 014A","E01026504","Total",671,627,44
"2011","Broadland 014B","E01026505","Total",615,605,10
"2011","Broadland 014C","E01026506","Total",602,590,12
"2011","Broadland 014D","E01026507","Total",578,568,10
"2011","Broadland 014E","E01026512","Total",566,553,13
"2011","Broadland 014F","E01026513","Total",586,578,8
"2011","Broadland 015A","E01026569","Total",750,719,31
"2011","Broadland 015B","E01026570","Total",747,727,20
"2011","Broadland 015C","E01026571","Total",670,655,15
"2011","Broadland 015D","E01026572","Total",650,638,12
"2011","Broadland 015E","E01026573","Total",633,623,10
"2011","Broadland 016A","E01026574","Total",690,683,7
"2011","Broadland 016B","E01026575","Total",756,732,24
"2011","Broadland 016C","E01026576","Total",816,808,8
"2011","Broadland 016D","E01026577","Total",807,775,32
"2011","Broadland 017A","E01026508","Total",651,641,10
"2011","Broadland 017B","E01026509","Total",696,684,12
"2011","Broadland 017C","E01026510","Total",711,700,11
"2011","Broadland 017D","E01026511","Total",477,467,10
"2011","Broadland 018A","E01026497","Total",703,679,24
"2011","Broadland 018B","E01026498","Total",627,606,21
"2011","Broadland 018C","E01026538","Total",700,648,52
"2011","Broadland 018D","E01026539","Total",701,676,25
"2011","Great Yarmouth 001A","E01026605","Total",743,699,44
"2011","Great Yarmouth 001B","E01026606","Total",803,708,95
"2011","Great Yarmouth 001C","E01026607","Total",807,710,97
"2011","Great Yarmouth 001D","E01026627","Total",643,617,26
"2011","Great Yarmouth 001E","E01026628","Total",665,595,70
"2011","Great Yarmouth 001F","E01026629","Total",647,630,17
"2011","Great Yarmouth 002A","E01026608","Total",544,522,22
"2011","Great Yarmouth 002B","E01026609","Total",515,496,19
"2011","Great Yarmouth 002C","E01026636","Total",761,674,87
"2011","Great Yarmouth 002D","E01026637","Total",878,822,56
"2011","Great Yarmouth 002E","E01026638","Total",672,639,33
"2011","Great Yarmouth 003A","E01026589","Total",632,614,18
"2011","Great Yarmouth 003B","E01026590","Total",684,670,14
"2011","Great Yarmouth 003C","E01026591","Total",830,803,27
"2011","Great Yarmouth 003D","E01026592","Total",733,700,33
"2011","Great Yarmouth 003E","E01026593","Total",613,590,23
"2011","Great Yarmouth 003F","E01026594","Total",788,761,27
"2011","Great Yarmouth 004A","E01026599","Total",626,574,52
"2011","Great Yarmouth 004B","E01026639","Total",634,598,36
"2011","Great Yarmouth 004C","E01026640","Total",764,756,8
"2011","Great Yarmouth 004D","E01026641","Total",629,625,4
"2011","Great Yarmouth 005A","E01026595","Total",805,789,16
"2011","Great Yarmouth 005B","E01026596","Total",755,683,72
"2011","Great Yarmouth 005C","E01026597","Total",996,888,108
"2011","Great Yarmouth 005D","E01026598","Total",767,707,60
"2011","Great Yarmouth 006A","E01026622","Total",646,632,14
"2011","Great Yarmouth 006B","E01026623","Total",833,663,170
"2011","Great Yarmouth 006C","E01026624","Total",968,829,139
"2011","Great Yarmouth 006D","E01026625","Total",781,773,8
"2011","Great Yarmouth 006E","E01026626","Total",959,866,93
"2011","Great Yarmouth 007A","E01026600","Total",642,628,14
"2011","Great Yarmouth 007B","E01026633","Total",772,729,43
"2011","Great Yarmouth 007C","E01026634","Total",648,612,36
"2011","Great Yarmouth 007D","E01026635","Total",1037,958,79
"2011","Great Yarmouth 008A","E01026581","Total",667,656,11
"2011","Great Yarmouth 008B","E01026582","Total",870,842,28
"2011","Great Yarmouth 008C","E01026583","Total",577,565,12
"2011","Great Yarmouth 008D","E01026584","Total",687,669,18
"2011","Great Yarmouth 009A","E01026601","Total",692,664,28
"2011","Great Yarmouth 009B","E01026602","Total",717,702,15
"2011","Great Yarmouth 009C","E01026603","Total",751,742,9
"2011","Great Yarmouth 009D","E01026604","Total",739,726,13
"2011","Great Yarmouth 009E","E01026632","Total",812,786,26
"2011","Great Yarmouth 010A","E01026610","Total",690,666,24
"2011","Great Yarmouth 010B","E01026611","Total",700,648,52
"2011","Great Yarmouth 010C","E01026612","Total",1109,1065,44
"2011","Great Yarmouth 010D","E01026630","Total",690,670,20
"2011","Great Yarmouth 010E","E01026631","Total",828,777,51
"2011","Great Yarmouth 011A","E01026617","Total",590,581,9
"2011","Great Yarmouth 011B","E01026618","Total",704,685,19
"2011","Great Yarmouth 011C","E01026619","Total",608,596,12
"2011","Great Yarmouth 011D","E01026620","Total",653,641,12
"2011","Great Yarmouth 011E","E01026621","Total",566,553,13
"2011","Great Yarmouth 012A","E01026613","Total",582,561,21
"2011","Great Yarmouth 012B","E01026614","Total",824,713,111
"2011","Great Yarmouth 012C","E01026615","Total",574,558,16
"2011","Great Yarmouth 012D","E01026616","Total",507,491,16
"2011","Great Yarmouth 013A","E01026585","Total",602,589,13
"2011","Great Yarmouth 013B","E01026586","Total",505,499,6
"2011","Great Yarmouth 013C","E01026587","Total",794,729,65
"2011","Great Yarmouth 013D","E01026588","Total",1180,1145,35
"2011","King's Lynn and West Norfolk 001A","E01026680","Total",878,769,109
"2011","King's Lynn and West Norfolk 001B","E01026681","Total",1291,686,605
"2011","King's Lynn and West Norfolk 001C","E01026682","Total",747,552,195
"2011","King's Lynn and West Norfolk 001D","E01026683","Total",2085,654,1431
"2011","King's Lynn and West Norfolk 002A","E01026645","Total",1372,665,707
"2011","King's Lynn and West Norfolk 002B","E01026646","Total",1475,844,631
"2011","King's Lynn and West Norfolk 002C","E01026656","Total",1092,837,255
"2011","King's Lynn and West Norfolk 002D","E01026695","Total",1255,984,271
"2011","King's Lynn and West Norfolk 003A","E01026676","Total",959,818,141
"2011","King's Lynn and West Norfolk 003B","E01026677","Total",824,727,97
"2011","King's Lynn and West Norfolk 003C","E01026678","Total",2637,755,1882
"2011","King's Lynn and West Norfolk 003D","E01026701","Total",843,779,64
"2011","King's Lynn and West Norfolk 003E","E01026702","Total",695,617,78
"2011","King's Lynn and West Norfolk 003F","E01026703","Total",1397,532,865
"2011","King's Lynn and West Norfolk 004A","E01026653","Total",888,840,48
"2011","King's Lynn and West Norfolk 004B","E01026654","Total",783,741,42
"2011","King's Lynn and West Norfolk 004C","E01026655","Total",723,659,64
"2011","King's Lynn and West Norfolk 004D","E01026718","Total",1127,1008,119
"2011","King's Lynn and West Norfolk 005A","E01026691","Total",478,457,21
"2011","King's Lynn and West Norfolk 005B","E01026692","Total",525,519,6
"2011","King's Lynn and West Norfolk 005C","E01026708","Total",565,551,14
"2011","King's Lynn and West Norfolk 005D","E01026709","Total",783,765,18
"2011","King's Lynn and West Norfolk 005E","E01026710","Total",507,485,22
"2011","King's Lynn and West Norfolk 006A","E01026669","Total",768,746,22
"2011","King's Lynn and West Norfolk 006B","E01026670","Total",594,586,8
"2011","King's Lynn and West Norfolk 006C","E01026671","Total",543,532,11
"2011","King's Lynn and West Norfolk 006D","E01026672","Total",636,625,11
"2011","King's Lynn and West Norfolk 006E","E01026673","Total",638,633,5
"2011","King's Lynn and West Norfolk 007A","E01026687","Total",722,661,61
"2011","King's Lynn and West Norfolk 007B","E01026688","Total",569,526,43
"2011","King's Lynn and West Norfolk 007C","E01026689","Total",724,640,84
"2011","King's Lynn and West Norfolk 007D","E01026690","Total",624,586,38
"2011","King's Lynn and West Norfolk 008A","E01026647","Total",963,925,38
"2011","King's Lynn and West Norfolk 008B","E01026711","Total",636,602,34
"2011","King's Lynn and West Norfolk 008C","E01026712","Total",727,690,37
"2011","King's Lynn and West Norfolk 008D","E01026713","Total",663,629,34
"2011","King's Lynn and West Norfolk 009A","E01026666","Total",777,726,51
"2011","King's Lynn and West Norfolk 009B","E01026667","Total",705,673,32
"2011","King's Lynn and West Norfolk 009C","E01026668","Total",681,634,47
"2011","King's Lynn and West Norfolk 009D","E01026693","Total",869,814,55
"2011","King's Lynn and West Norfolk 010A","E01026662","Total",973,923,50
"2011","King's Lynn and West Norfolk 010B","E01026663","Total",753,714,39
"2011","King's Lynn and West Norfolk 010C","E01026664","Total",989,949,40
"2011","King's Lynn and West Norfolk 010D","E01026714","Total",825,793,32
"2011","King's Lynn and West Norfolk 011A","E01026698","Total",1244,1024,220
"2011","King's Lynn and West Norfolk 011B","E01026699","Total",1007,848,159
"2011","King's Lynn and West Norfolk 011C","E01026700","Total",781,689,92
"2011","King's Lynn and West Norfolk 011D","E01026704","Total",713,686,27
"2011","King's Lynn and West Norfolk 011E","E01026705","Total",667,638,29
"2011","King's Lynn and West Norfolk 011F","E01026706","Total",690,633,57
"2011","King's Lynn and West Norfolk 012A","E01026665","Total",1042,984,58
"2011","King's Lynn and West Norfolk 012B","E01026674","Total",505,482,23
"2011","King's Lynn and West Norfolk 012C","E01026675","Total",538,508,30
"2011","King's Lynn and West Norfolk 012D","E01026694","Total",1201,1078,123
"2011","King's Lynn and West Norfolk 013A","E01026684","Total",517,461,56
"2011","King's Lynn and West Norfolk 013B","E01026685","Total",603,554,49
"2011","King's Lynn and West Norfolk 013C","E01026719","Total",944,907,37
"2011","King's Lynn and West Norfolk 013D","E01026720","Total",551,526,25
"2011","King's Lynn and West Norfolk 013E","E01026721","Total",540,513,27
"2011","King's Lynn and West Norfolk 014A","E01026642","Total",608,561,47
"2011","King's Lynn and West Norfolk 014B","E01026643","Total",631,596,35
"2011","King's Lynn and West Norfolk 014C","E01026644","Total",716,644,72
"2011","King's Lynn and West Norfolk 014D","E01026723","Total",675,661,14
"2011","King's Lynn and West Norfolk 014E","E01026724","Total",758,724,34
"2011","King's Lynn and West Norfolk 014F","E01026725","Total",670,615,55
"2011","King's Lynn and West Norfolk 015A","E01026696","Total",472,449,23
"2011","King's Lynn and West Norfolk 015B","E01026697","Total",602,550,52
"2011","King's Lynn and West Norfolk 015C","E01026722","Total",1074,1021,53
"2011","King's Lynn and West Norfolk 015D","E01026726","Total",907,858,49
"2011","King's Lynn and West Norfolk 016A","E01026659","Total",729,675,54
"2011","King's Lynn and West Norfolk 016B","E01026660","Total",724,697,27
"2011","King's Lynn and West Norfolk 016C","E01026661","Total",646,606,40
"2011","King's Lynn and West Norfolk 016D","E01026715","Total",663,595,68
"2011","King's Lynn and West Norfolk 016E","E01026716","Total",879,793,86
"2011","King's Lynn and West Norfolk 016F","E01026717","Total",656,603,53
"2011","King's Lynn and West Norfolk 017C","E01026686","Total",1056,1014,42
"2011","King's Lynn and West Norfolk 017D","E01026707","Total",1214,1148,66
"2011","King's Lynn and West Norfolk 017E","E01033036","Total",640,621,19
"2011","King's Lynn and West Norfolk 017F","E01033037","Total",644,608,36
"2011","King's Lynn and West Norfolk 017G","E01033038","Total",841,779,62
"2011","King's Lynn and West Norfolk 017H","E01033039","Total",488,467,21
"2011","King's Lynn and West Norfolk 018A","E01026679","Total",1104,996,108
"2011","King's Lynn and West Norfolk 018B","E01026727","Total",1161,1096,65
"2011","King's Lynn and West Norfolk 018C","E01026728","Total",1053,967,86
"2011","King's Lynn and West Norfolk 019A","E01026648","Total",724,655,69
"2011","King's Lynn and West Norfolk 019B","E01026649","Total",714,661,53
"2011","King's Lynn and West Norfolk 019C","E01026650","Total",487,439,48
"2011","King's Lynn and West Norfolk 019D","E01026651","Total",1057,971,86
"2011","King's Lynn and West Norfolk 019E","E01026652","Total",572,525,47
"2011","North Norfolk 001A","E01026770","Total",1442,1003,439
"2011","North Norfolk 001B","E01026771","Total",844,748,96
"2011","North Norfolk 001C","E01026772","Total",848,786,62
"2011","North Norfolk 001D","E01026773","Total",1027,950,77
"2011","North Norfolk 002A","E01026739","Total",1430,964,466
"2011","North Norfolk 002B","E01026763","Total",803,628,175
"2011","North Norfolk 002C","E01026764","Total",1016,648,368
"2011","North Norfolk 002D","E01026765","Total",885,618,267
"2011","North Norfolk 003A","E01026734","Total",823,619,204
"2011","North Norfolk 003B","E01026735","Total",873,675,198
"2011","North Norfolk 003C","E01026736","Total",652,603,49
"2011","North Norfolk 003D","E01026777","Total",559,532,27
"2011","North Norfolk 003E","E01026778","Total",907,726,181
"2011","North Norfolk 003F","E01026779","Total",599,568,31
"2011","North Norfolk 004A","E01026741","Total",1304,927,377
"2011","North Norfolk 004B","E01026742","Total",803,693,110
"2011","North Norfolk 004C","E01026743","Total",1291,1114,177
"2011","North Norfolk 005A","E01026762","Total",1251,1054,197
"2011","North Norfolk 005B","E01026766","Total",1084,975,109
"2011","North Norfolk 005C","E01026781","Total",1138,984,154
"2011","North Norfolk 006A","E01026731","Total",524,493,31
"2011","North Norfolk 006B","E01026732","Total",644,566,78
"2011","North Norfolk 006C","E01026733","Total",1193,1033,160
"2011","North Norfolk 006D","E01026737","Total",1118,1011,107
"2011","North Norfolk 007A","E01026738","Total",1177,1082,95
"2011","North Norfolk 007B","E01026750","Total",770,639,131
"2011","North Norfolk 007C","E01026751","Total",800,674,126
"2011","North Norfolk 007D","E01026752","Total",768,625,143
"2011","North Norfolk 008A","E01026729","Total",1061,934,127
"2011","North Norfolk 008B","E01026730","Total",1151,1067,84
"2011","North Norfolk 008C","E01026788","Total",685,569,116
"2011","North Norfolk 009A","E01026780","Total",1274,1123,151
"2011","North Norfolk 009B","E01026782","Total",1275,1008,267
"2011","North Norfolk 009C","E01026787","Total",486,442,44
"2011","North Norfolk 010A","E01026753","Total",762,732,30
"2011","North Norfolk 010B","E01026754","Total",627,616,11
"2011","North Norfolk 010C","E01026755","Total",575,555,20
"2011","North Norfolk 010D","E01026756","Total",566,529,37
"2011","North Norfolk 010E","E01026757","Total",709,677,32
"2011","North Norfolk 010F","E01026758","Total",675,648,27
"2011","North Norfolk 010G","E01026759","Total",559,551,8
"2011","North Norfolk 010H","E01026760","Total",634,584,50
"2011","North Norfolk 010I","E01026761","Total",738,705,33
"2011","North Norfolk 011A","E01026745","Total",791,760,31
"2011","North Norfolk 011B","E01026746","Total",795,747,48
"2011","North Norfolk 011C","E01026747","Total",702,628,74
"2011","North Norfolk 011D","E01026748","Total",689,667,22
"2011","North Norfolk 011E","E01026749","Total",705,682,23
"2011","North Norfolk 012A","E01026740","Total",1308,1085,223
"2011","North Norfolk 012B","E01026767","Total",574,528,46
"2011","North Norfolk 012C","E01026768","Total",567,508,59
"2011","North Norfolk 012D","E01026789","Total",525,495,30
"2011","North Norfolk 012E","E01026790","Total",503,479,24
"2011","North Norfolk 013A","E01026774","Total",682,640,42
"2011","North Norfolk 013B","E01026775","Total",594,575,19
"2011","North Norfolk 013C","E01026776","Total",852,776,76
"2011","North Norfolk 013D","E01026786","Total",1178,957,221
"2011","North Norfolk 014A","E01026744","Total",1055,952,103
"2011","North Norfolk 014B","E01026769","Total",1193,982,211
"2011","North Norfolk 014C","E01026783","Total",990,836,154
"2011","North Norfolk 014D","E01026784","Total",514,464,50
"2011","North Norfolk 014E","E01026785","Total",676,607,69
"2011","Norwich 001A","E01026797","Total",1145,1070,75
"2011","Norwich 001B","E01026798","Total",700,670,30
"2011","Norwich 001C","E01026799","Total",656,626,30
"2011","Norwich 001D","E01026800","Total",945,901,44
"2011","Norwich 001E","E01026801","Total",693,684,9
"2011","Norwich 001F","E01026802","Total",808,785,23
"2011","Norwich 002A","E01026828","Total",682,664,18
"2011","Norwich 002B","E01026829","Total",914,857,57
"2011","Norwich 002C","E01026830","Total",703,682,21
"2011","Norwich 002D","E01026831","Total",709,632,77
"2011","Norwich 002E","E01026832","Total",521,498,23
"2011","Norwich 002F","E01026833","Total",724,696,28
"2011","Norwich 002G","E01026834","Total",673,644,29
"2011","Norwich 003A","E01026841","Total",767,726,41
"2011","Norwich 003B","E01026842","Total",863,818,45
"2011","Norwich 003C","E01026843","Total",934,902,32
"2011","Norwich 003D","E01026844","Total",853,823,30
"2011","Norwich 003E","E01026845","Total",825,786,39
"2011","Norwich 003F","E01026846","Total",883,811,72
"2011","Norwich 004A","E01026803","Total",645,638,7
"2011","Norwich 004B","E01026804","Total",651,633,18
"2011","Norwich 004C","E01026805","Total",657,639,18
"2011","Norwich 004D","E01026806","Total",516,508,8
"2011","Norwich 004E","E01026807","Total",538,523,15
"2011","Norwich 004F","E01026808","Total",531,516,15
"2011","Norwich 004G","E01026809","Total",784,762,22
"2011","Norwich 005A","E01026791","Total",698,661,37
"2011","Norwich 005B","E01026792","Total",642,627,15
"2011","Norwich 005C","E01026793","Total",655,625,30
"2011","Norwich 005D","E01026794","Total",870,844,26
"2011","Norwich 005F","E01026796","Total",674,650,24
"2011","Norwich 005G","E01033435","Total",746,705,41
"2011","Norwich 005H","E01033436","Total",625,596,29
"2011","Norwich 006A","E01026863","Total",814,771,43
"2011","Norwich 006B","E01026864","Total",672,657,15
"2011","Norwich 006C","E01026865","Total",824,805,19
"2011","Norwich 006D","E01026866","Total",830,767,63
"2011","Norwich 006E","E01026867","Total",574,562,12
"2011","Norwich 006F","E01026868","Total",590,565,25
"2011","Norwich 006G","E01026869","Total",681,657,24
"2011","Norwich 007A","E01026822","Total",1396,1228,168
"2011","Norwich 007B","E01026823","Total",1270,1099,171
"2011","Norwich 007C","E01026824","Total",933,868,65
"2011","Norwich 007D","E01026825","Total",765,718,47
"2011","Norwich 007E","E01026826","Total",971,864,107
"2011","Norwich 007F","E01026827","Total",973,931,42
"2011","Norwich 009A","E01026835","Total",683,643,40
"2011","Norwich 009B","E01026836","Total",663,646,17
"2011","Norwich 009C","E01026837","Total",812,735,77
"2011","Norwich 009D","E01026838","Total",670,645,25
"2011","Norwich 009E","E01026839","Total",698,668,30
"2011","Norwich 009F","E01026840","Total",804,759,45
"2011","Norwich 010A","E01026858","Total",762,745,17
"2011","Norwich 010B","E01026859","Total",656,640,16
"2011","Norwich 010C","E01026860","Total",493,470,23
"2011","Norwich 010D","E01026861","Total",576,549,27
"2011","Norwich 010E","E01026862","Total",513,497,16
"2011","Norwich 011A","E01026852","Total",621,598,23
"2011","Norwich 011B","E01026853","Total",1034,1011,23
"2011","Norwich 011D","E01026855","Total",815,773,42
"2011","Norwich 011E","E01026856","Total",917,847,70
"2011","Norwich 011F","E01026857","Total",779,751,28
"2011","Norwich 011G","E01033434","Total",660,615,45
"2011","Norwich 011H","E01033437","Total",825,786,39
"2011","Norwich 012A","E01026810","Total",658,635,23
"2011","Norwich 012B","E01026811","Total",747,723,24
"2011","Norwich 012C","E01026812","Total",656,639,17
"2011","Norwich 012D","E01026813","Total",649,635,14
"2011","Norwich 012E","E01026814","Total",677,653,24
"2011","Norwich 012F","E01026815","Total",675,648,27
"2011","Norwich 013A","E01026816","Total",962,934,28
"2011","Norwich 013B","E01026817","Total",725,706,19
"2011","Norwich 013C","E01026818","Total",636,626,10
"2011","Norwich 013D","E01026819","Total",636,625,11
"2011","Norwich 013E","E01026820","Total",765,755,10
"2011","Norwich 013F","E01026821","Total",724,712,12
"2011","Norwich 014A","E01033438","Total",1018,878,140
"2011","Norwich 014B","E01033439","Total",850,763,87
"2011","Norwich 014C","E01033440","Total",723,662,61
"2011","Norwich 014D","E01033441","Total",934,773,161
"2011","Norwich 015A","E01026848","Total",1039,1015,24
"2011","Norwich 015B","E01026849","Total",969,913,56
"2011","Norwich 015C","E01026850","Total",991,952,39
"2011","South Norfolk 001A","E01026916","Total",925,896,29
"2011","South Norfolk 001B","E01026917","Total",693,668,25
"2011","South Norfolk 001C","E01026918","Total",788,770,18
"2011","South Norfolk 001E","E01026924","Total",694,674,20
"2011","South Norfolk 001F","E01026925","Total",946,923,23
"2011","South Norfolk 001G","E01033538","Total",911,860,51
"2011","South Norfolk 001H","E01033540","Total",683,666,17
"2011","South Norfolk 002A","E01026881","Total",677,626,51
"2011","South Norfolk 002B","E01026882","Total",875,855,20
"2011","South Norfolk 002C","E01026883","Total",707,680,27
"2011","South Norfolk 002D","E01026895","Total",609,598,11
"2011","South Norfolk 002E","E01026896","Total",514,486,28
"2011","South Norfolk 003A","E01026905","Total",532,521,11
"2011","South Norfolk 003B","E01026906","Total",612,593,19
"2011","South Norfolk 003C","E01026907","Total",816,795,21
"2011","South Norfolk 003D","E01026908","Total",616,598,18
"2011","South Norfolk 004A","E01026909","Total",681,650,31
"2011","South Norfolk 004B","E01026910","Total",673,649,24
"2011","South Norfolk 004C","E01026947","Total",534,509,25
"2011","South Norfolk 004D","E01026948","Total",507,486,21
"2011","South Norfolk 005A","E01026870","Total",920,873,47
"2011","South Norfolk 005B","E01026871","Total",580,570,10
"2011","South Norfolk 005C","E01026921","Total",650,631,19
"2011","South Norfolk 005D","E01026922","Total",700,689,11
"2011","South Norfolk 006A","E01026875","Total",455,448,7
"2011","South Norfolk 006B","E01026876","Total",675,652,23
"2011","South Norfolk 006C","E01026926","Total",681,662,19
"2011","South Norfolk 006D","E01026927","Total",804,788,16
"2011","South Norfolk 006E","E01026928","Total",641,629,12
"2011","South Norfolk 006F","E01026936","Total",638,625,13
"2011","South Norfolk 006G","E01026937","Total",653,629,24
"2011","South Norfolk 007A","E01026884","Total",498,486,12
"2011","South Norfolk 007B","E01026885","Total",577,555,22
"2011","South Norfolk 007C","E01026933","Total",1140,1113,27
"2011","South Norfolk 007D","E01026945","Total",888,870,18
"2011","South Norfolk 007E","E01026946","Total",515,496,19
"2011","South Norfolk 008A","E01026879","Total",526,499,27
"2011","South Norfolk 008B","E01026880","Total",622,605,17
"2011","South Norfolk 008C","E01026911","Total",559,529,30
"2011","South Norfolk 008D","E01026912","Total",674,650,24
"2011","South Norfolk 008E","E01026929","Total",571,553,18
"2011","South Norfolk 008F","E01026930","Total",640,615,25
"2011","South Norfolk 009A","E01026913","Total",731,714,17
"2011","South Norfolk 009B","E01026914","Total",629,614,15
"2011","South Norfolk 009C","E01026915","Total",808,796,12
"2011","South Norfolk 009D","E01026919","Total",640,625,15
"2011","South Norfolk 009E","E01026920","Total",483,469,14
"2011","South Norfolk 009F","E01026941","Total",528,506,22
"2011","South Norfolk 009G","E01026942","Total",463,449,14
"2011","South Norfolk 010A","E01026898","Total",648,601,47
"2011","South Norfolk 010B","E01026899","Total",621,602,19
"2011","South Norfolk 010C","E01026943","Total",687,654,33
"2011","South Norfolk 010D","E01026944","Total",477,461,16
"2011","South Norfolk 011A","E01026877","Total",665,638,27
"2011","South Norfolk 011B","E01026878","Total",484,473,11
"2011","South Norfolk 011C","E01026897","Total",1128,1099,29
"2011","South Norfolk 011D","E01026938","Total",882,852,30
"2011","South Norfolk 011E","E01026939","Total",722,703,19
"2011","South Norfolk 011F","E01026940","Total",729,719,10
"2011","South Norfolk 012A","E01026892","Total",587,557,30
"2011","South Norfolk 012B","E01026893","Total",481,460,21
"2011","South Norfolk 012C","E01026894","Total",1076,1033,43
"2011","South Norfolk 012D","E01026903","Total",495,480,15
"2011","South Norfolk 012E","E01026904","Total",579,562,17
"2011","South Norfolk 013A","E01026872","Total",1024,980,44
"2011","South Norfolk 013B","E01026900","Total",721,692,29
"2011","South Norfolk 013C","E01026901","Total",624,606,18
"2011","South Norfolk 013D","E01026902","Total",914,878,36
"2011","South Norfolk 014A","E01026873","Total",535,511,24
"2011","South Norfolk 014B","E01026874","Total",640,610,30
"2011","South Norfolk 014C","E01026886","Total",583,564,19
"2011","South Norfolk 014D","E01026887","Total",638,607,31
"2011","South Norfolk 014E","E01026934","Total",475,463,12
"2011","South Norfolk 014F","E01026935","Total",597,566,31
"2011","South Norfolk 015A","E01026888","Total",801,778,23
"2011","South Norfolk 015B","E01026889","Total",741,719,22
"2011","South Norfolk 015D","E01026891","Total",843,815,28
"2011","South Norfolk 015E","E01026931","Total",479,471,8
"2011","South Norfolk 015F","E01026932","Total",549,535,14
"2011","South Norfolk 015G","E01033539","Total",641,620,21
"2011","South Norfolk 015H","E01033541","Total",672,657,15
"2011","Babergh 001A","E01029876","Total",972,899,73
"2011","Babergh 001B","E01029898","Total",987,884,103
"2011","Babergh 001C","E01029907","Total",1028,955,73
"2011","Babergh 002A","E01029881","Total",885,833,52
"2011","Babergh 002B","E01029884","Total",693,666,27
"2011","Babergh 002C","E01029885","Total",969,939,30
"2011","Babergh 003A","E01029900","Total",758,734,24
"2011","Babergh 003B","E01029901","Total",1096,1025,71
"2011","Babergh 003C","E01029917","Total",832,812,20
"2011","Babergh 004A","E01029892","Total",891,848,43
"2011","Babergh 004B","E01029893","Total",1060,1018,42
"2011","Babergh 004C","E01029894","Total",527,517,10
"2011","Babergh 004D","E01029895","Total",484,476,8
"2011","Babergh 004E","E01029896","Total",629,615,14
"2011","Babergh 004F","E01029911","Total",965,918,47
"2011","Babergh 005A","E01029877","Total",532,513,19
"2011","Babergh 005B","E01029878","Total",532,514,18
"2011","Babergh 005C","E01029879","Total",642,624,18
"2011","Babergh 005D","E01029908","Total",689,686,3
"2011","Babergh 005E","E01029909","Total",742,733,9
"2011","Babergh 005F","E01029910","Total",513,504,9
"2011","Babergh 006A","E01029880","Total",778,743,35
"2011","Babergh 006B","E01029921","Total",549,537,12
"2011","Babergh 006C","E01029922","Total",574,544,30
"2011","Babergh 006D","E01029923","Total",592,582,10
"2011","Babergh 007A","E01029912","Total",750,726,24
"2011","Babergh 007B","E01029913","Total",561,546,15
"2011","Babergh 007C","E01029914","Total",680,666,14
"2011","Babergh 007D","E01029915","Total",525,514,11
"2011","Babergh 007E","E01029916","Total",513,506,7
"2011","Babergh 007F","E01029918","Total",566,544,22
"2011","Babergh 007G","E01029919","Total",712,668,44
"2011","Babergh 007H","E01029920","Total",1076,1004,72
"2011","Babergh 008A","E01029886","Total",516,507,9
"2011","Babergh 008B","E01029887","Total",822,792,30
"2011","Babergh 008C","E01029888","Total",498,495,3
"2011","Babergh 008D","E01029889","Total",515,503,12
"2011","Babergh 008E","E01029890","Total",487,485,2
"2011","Babergh 008F","E01029891","Total",811,782,29
"2011","Babergh 009A","E01029875","Total",938,901,37
"2011","Babergh 009B","E01029899","Total",786,764,22
"2011","Babergh 009C","E01029902","Total",942,896,46
"2011","Babergh 009D","E01029906","Total",874,819,55
"2011","Babergh 010A","E01029870","Total",490,479,11
"2011","Babergh 010B","E01029872","Total",596,585,11
"2011","Babergh 010C","E01029882","Total",645,621,24
"2011","Babergh 010D","E01029883","Total",887,850,37
"2011","Babergh 010E","E01029903","Total",571,561,10
"2011","Babergh 010F","E01029904","Total",620,608,12
"2011","Babergh 010G","E01029905","Total",480,464,16
"2011","Babergh 011A","E01029871","Total",651,622,29
"2011","Babergh 011B","E01029873","Total",1018,965,53
"2011","Babergh 011C","E01029874","Total",744,727,17
"2011","Babergh 011D","E01029897","Total",833,803,30
"2011","Forest Heath 001A","E01029926","Total",827,796,31
"2011","Forest Heath 001B","E01029927","Total",1085,1015,70
"2011","Forest Heath 001C","E01029928","Total",891,804,87
"2011","Forest Heath 001D","E01029929","Total",1052,1019,33
"2011","Forest Heath 001E","E01029930","Total",681,644,37
"2011","Forest Heath 002C","E01029942","Total",719,660,59
"2011","Forest Heath 002E","E01029944","Total",791,752,39
"2011","Forest Heath 002F","E01033453","Total",1175,938,237
"2011","Forest Heath 003E","E01029945","Total",868,796,72
"2011","Forest Heath 003F","E01032523","Total",538,426,112
"2011","Forest Heath 003G","E01032524","Total",486,411,75
"2011","Forest Heath 003H","E01032525","Total",1158,1003,155
"2011","Forest Heath 003I","E01032526","Total",817,701,116
"2011","Forest Heath 004A","E01029938","Total",554,528,26
"2011","Forest Heath 004B","E01029939","Total",686,640,46
"2011","Forest Heath 004C","E01029940","Total",636,617,19
"2011","Forest Heath 004D","E01029946","Total",978,906,72
"2011","Forest Heath 004E","E01029947","Total",1166,1064,102
"2011","Forest Heath 005A","E01029941","Total",809,775,34
"2011","Forest Heath 005C","E01029957","Total",789,728,61
"2011","Forest Heath 005D","E01033451","Total",689,622,67
"2011","Forest Heath 005E","E01033452","Total",648,583,65
"2011","Forest Heath 005F","E01033454","Total",607,543,64
"2011","Forest Heath 006A","E01029937","Total",913,871,42
"2011","Forest Heath 006B","E01029953","Total",635,613,22
"2011","Forest Heath 006C","E01029954","Total",1219,1122,97
"2011","Forest Heath 006D","E01029955","Total",899,874,25
"2011","Forest Heath 006E","E01029956","Total",559,544,15
"2011","Forest Heath 008A","E01029925","Total",975,870,105
"2011","Forest Heath 008B","E01029949","Total",692,637,55
"2011","Forest Heath 008C","E01029950","Total",835,795,40
"2011","Forest Heath 008D","E01029951","Total",639,616,23
"2011","Forest Heath 008E","E01029952","Total",543,524,19
"2011","Forest Heath 008F","E01032612","Total",1002,939,63
"2011","Ipswich 001A","E01030032","Total",520,511,9
"2011","Ipswich 001B","E01030033","Total",664,654,10
"2011","Ipswich 001C","E01030034","Total",640,630,10
"2011","Ipswich 001D","E01030035","Total",654,647,7
"2011","Ipswich 001E","E01030036","Total",785,776,9
"2011","Ipswich 002A","E01029973","Total",644,631,13
"2011","Ipswich 002B","E01029974","Total",629,613,16
"2011","Ipswich 002C","E01029975","Total",528,518,10
"2011","Ipswich 002D","E01029976","Total",657,639,18
"2011","Ipswich 002E","E01029977","Total",648,633,15
"2011","Ipswich 003A","E01030027","Total",936,906,30
"2011","Ipswich 003B","E01030028","Total",682,668,14
"2011","Ipswich 003C","E01030029","Total",667,658,9
"2011","Ipswich 003D","E01030030","Total",916,898,18
"2011","Ipswich 003E","E01030031","Total",679,647,32
"2011","Ipswich 004A","E01029997","Total",637,630,7
"2011","Ipswich 004B","E01029998","Total",767,758,9
"2011","Ipswich 004C","E01029999","Total",633,624,9
"2011","Ipswich 004D","E01030000","Total",654,637,17
"2011","Ipswich 004E","E01030001","Total",662,647,15
"2011","Ipswich 005A","E01030007","Total",695,662,33
"2011","Ipswich 005B","E01030008","Total",543,520,23
"2011","Ipswich 005C","E01030009","Total",633,591,42
"2011","Ipswich 005D","E01030010","Total",1053,955,98
"2011","Ipswich 005E","E01030011","Total",684,675,9
"2011","Ipswich 006A","E01030022","Total",962,930,32
"2011","Ipswich 006B","E01030023","Total",890,835,55
"2011","Ipswich 006C","E01030024","Total",1137,1057,80
"2011","Ipswich 006D","E01030025","Total",900,834,66
"2011","Ipswich 006E","E01030026","Total",731,707,24
"2011","Ipswich 007A","E01029958","Total",666,645,21
"2011","Ipswich 007C","E01029960","Total",886,839,47
"2011","Ipswich 007D","E01029961","Total",629,603,26
"2011","Ipswich 007E","E01029962","Total",748,696,52
"2011","Ipswich 007F","E01033124","Total",499,440,59
"2011","Ipswich 007G","E01033125","Total",740,632,108
"2011","Ipswich 007H","E01033129","Total",713,646,67
"2011","Ipswich 008A","E01030002","Total",970,937,33
"2011","Ipswich 008B","E01030003","Total",737,713,24
"2011","Ipswich 008C","E01030004","Total",505,498,7
"2011","Ipswich 008D","E01030005","Total",964,930,34
"2011","Ipswich 008E","E01030006","Total",863,843,20
"2011","Ipswich 009A","E01029963","Total",663,640,23
"2011","Ipswich 009B","E01029964","Total",538,522,16
"2011","Ipswich 009C","E01029965","Total",635,621,14
"2011","Ipswich 009D","E01029966","Total",684,621,63
"2011","Ipswich 009E","E01029967","Total",631,613,18
"2011","Ipswich 010A","E01029984","Total",621,613,8
"2011","Ipswich 010B","E01029985","Total",1126,1078,48
"2011","Ipswich 010C","E01029986","Total",676,665,11
"2011","Ipswich 010D","E01029987","Total",635,622,13
"2011","Ipswich 010E","E01029988","Total",995,920,75
"2011","Ipswich 011B","E01029990","Total",733,713,20
"2011","Ipswich 011C","E01029991","Total",691,675,16
"2011","Ipswich 011D","E01029992","Total",626,608,18
"2011","Ipswich 011E","E01033123","Total",842,809,33
"2011","Ipswich 011F","E01033126","Total",868,768,100
"2011","Ipswich 012A","E01029968","Total",708,674,34
"2011","Ipswich 012B","E01029969","Total",570,555,15
"2011","Ipswich 012C","E01029970","Total",767,757,10
"2011","Ipswich 012D","E01029971","Total",644,637,7
"2011","Ipswich 012F","E01033122","Total",702,664,38
"2011","Ipswich 012G","E01033130","Total",679,633,46
"2011","Ipswich 013A","E01030012","Total",636,624,12
"2011","Ipswich 013B","E01030013","Total",609,604,5
"2011","Ipswich 013C","E01030014","Total",612,602,10
"2011","Ipswich 013D","E01030015","Total",535,530,5
"2011","Ipswich 013E","E01030016","Total",644,633,11
"2011","Ipswich 014B","E01029994","Total",643,636,7
"2011","Ipswich 014C","E01029995","Total",676,654,22
"2011","Ipswich 014D","E01029996","Total",649,637,12
"2011","Ipswich 014E","E01033127","Total",615,604,11
"2011","Ipswich 014F","E01033128","Total",506,485,21
"2011","Ipswich 014G","E01033131","Total",561,554,7
"2011","Ipswich 015A","E01030017","Total",667,633,34
"2011","Ipswich 015B","E01030018","Total",676,667,9
"2011","Ipswich 015C","E01030019","Total",662,644,18
"2011","Ipswich 015D","E01030020","Total",624,609,15
"2011","Ipswich 015E","E01030021","Total",689,673,16
"2011","Ipswich 016A","E01029978","Total",554,547,7
"2011","Ipswich 016B","E01029979","Total",660,645,15
"2011","Ipswich 016C","E01029980","Total",712,701,11
"2011","Ipswich 016D","E01029981","Total",522,513,9
"2011","Ipswich 016E","E01029982","Total",528,526,2
"2011","Ipswich 016F","E01029983","Total",684,656,28
"2011","Mid Suffolk 001A","E01030052","Total",1023,969,54
"2011","Mid Suffolk 001B","E01030058","Total",926,868,58
"2011","Mid Suffolk 001C","E01030064","Total",975,922,53
"2011","Mid Suffolk 001D","E01030088","Total",502,475,27
"2011","Mid Suffolk 002A","E01030039","Total",579,557,22
"2011","Mid Suffolk 002B","E01030054","Total",545,508,37
"2011","Mid Suffolk 002C","E01030055","Total",600,577,23
"2011","Mid Suffolk 002D","E01030066","Total",725,680,45
"2011","Mid Suffolk 002E","E01030067","Total",607,566,41
"2011","Mid Suffolk 002F","E01030068","Total",754,717,37
"2011","Mid Suffolk 003A","E01030053","Total",1067,985,82
"2011","Mid Suffolk 003B","E01030082","Total",1215,1136,79
"2011","Mid Suffolk 003C","E01030090","Total",1039,969,70
"2011","Mid Suffolk 004A","E01030040","Total",517,489,28
"2011","Mid Suffolk 004B","E01030049","Total",696,673,23
"2011","Mid Suffolk 004C","E01030050","Total",866,836,30
"2011","Mid Suffolk 004D","E01030084","Total",652,646,6
"2011","Mid Suffolk 004E","E01030085","Total",703,681,22
"2011","Mid Suffolk 005A","E01030037","Total",531,512,19
"2011","Mid Suffolk 005B","E01030038","Total",513,499,14
"2011","Mid Suffolk 005C","E01030059","Total",1000,961,39
"2011","Mid Suffolk 005D","E01030081","Total",1027,1008,19
"2011","Mid Suffolk 006A","E01030051","Total",742,726,16
"2011","Mid Suffolk 006B","E01030056","Total",974,949,25
"2011","Mid Suffolk 006C","E01030065","Total",888,866,22
"2011","Mid Suffolk 006D","E01030086","Total",494,472,22
"2011","Mid Suffolk 006E","E01030089","Total",852,835,17
"2011","Mid Suffolk 007A","E01030048","Total",1078,1029,49
"2011","Mid Suffolk 007B","E01030057","Total",956,910,46
"2011","Mid Suffolk 007C","E01030083","Total",949,918,31
"2011","Mid Suffolk 007D","E01030087","Total",554,514,40
"2011","Mid Suffolk 008A","E01030073","Total",774,747,27
"2011","Mid Suffolk 008B","E01030077","Total",703,680,23
"2011","Mid Suffolk 008C","E01030079","Total",645,642,3
"2011","Mid Suffolk 008D","E01030080","Total",683,667,16
"2011","Mid Suffolk 009A","E01030063","Total",960,903,57
"2011","Mid Suffolk 009B","E01030069","Total",566,543,23
"2011","Mid Suffolk 009C","E01030072","Total",766,747,19
"2011","Mid Suffolk 009D","E01030075","Total",626,618,8
"2011","Mid Suffolk 010A","E01030060","Total",756,738,18
"2011","Mid Suffolk 010B","E01030071","Total",709,684,25
"2011","Mid Suffolk 010D","E01030076","Total",652,640,12
"2011","Mid Suffolk 010E","E01030078","Total",740,724,16
"2011","Mid Suffolk 010F","E01033316","Total",637,624,13
"2011","Mid Suffolk 010G","E01033317","Total",687,651,36
"2011","Mid Suffolk 010H","E01033319","Total",741,726,15
"2011","Mid Suffolk 011A","E01030041","Total",952,921,31
"2011","Mid Suffolk 011B","E01030043","Total",545,536,9
"2011","Mid Suffolk 011C","E01030061","Total",796,761,35
"2011","Mid Suffolk 011D","E01030062","Total",642,624,18
"2011","Mid Suffolk 011E","E01030070","Total",571,539,32
"2011","Mid Suffolk 012A","E01030042","Total",694,667,27
"2011","Mid Suffolk 012B","E01030044","Total",571,563,8
"2011","Mid Suffolk 012C","E01030045","Total",729,706,23
"2011","Mid Suffolk 012D","E01030046","Total",672,647,25
"2011","Mid Suffolk 012E","E01030047","Total",563,555,8
"2011","St Edmundsbury 001A","E01030095","Total",498,485,13
"2011","St Edmundsbury 001B","E01030096","Total",628,608,20
"2011","St Edmundsbury 001C","E01030097","Total",527,504,23
"2011","St Edmundsbury 001D","E01030145","Total",612,598,14
"2011","St Edmundsbury 001E","E01030146","Total",529,500,29
"2011","St Edmundsbury 002A","E01030094","Total",623,594,29
"2011","St Edmundsbury 002B","E01030121","Total",909,889,20
"2011","St Edmundsbury 002C","E01030132","Total",476,438,38
"2011","St Edmundsbury 002D","E01030133","Total",633,606,27
"2011","St Edmundsbury 003A","E01030130","Total",562,543,19
"2011","St Edmundsbury 003B","E01030131","Total",518,507,11
"2011","St Edmundsbury 003C","E01030139","Total",775,765,10
"2011","St Edmundsbury 003D","E01030140","Total",505,503,2
"2011","St Edmundsbury 003E","E01030141","Total",650,638,12
"2011","St Edmundsbury 004A","E01030103","Total",874,861,13
"2011","St Edmundsbury 004B","E01030104","Total",916,894,22
"2011","St Edmundsbury 004C","E01030138","Total",1014,975,39
"2011","St Edmundsbury 005B","E01030127","Total",529,514,15
"2011","St Edmundsbury 005C","E01030128","Total",618,610,8
"2011","St Edmundsbury 005D","E01030129","Total",590,581,9
"2011","St Edmundsbury 005E","E01033044","Total",527,520,7
"2011","St Edmundsbury 005F","E01033045","Total",407,402,5
"2011","St Edmundsbury 005G","E01033050","Total",530,521,9
"2011","St Edmundsbury 006A","E01030091","Total",1023,950,73
"2011","St Edmundsbury 006B","E01030093","Total",811,776,35
"2011","St Edmundsbury 006D","E01030137","Total",766,737,29
"2011","St Edmundsbury 006E","E01033043","Total",634,616,18
"2011","St Edmundsbury 006F","E01033046","Total",635,605,30
"2011","St Edmundsbury 006G","E01033047","Total",519,500,19
"2011","St Edmundsbury 007A","E01030092","Total",831,813,18
"2011","St Edmundsbury 007B","E01030123","Total",657,646,11
"2011","St Edmundsbury 007C","E01030124","Total",751,731,20
"2011","St Edmundsbury 007D","E01030125","Total",640,635,5
"2011","St Edmundsbury 007E","E01030148","Total",526,515,11
"2011","St Edmundsbury 007F","E01030149","Total",636,625,11
"2011","St Edmundsbury 008A","E01030098","Total",990,966,24
"2011","St Edmundsbury 008B","E01030100","Total",902,868,34
"2011","St Edmundsbury 008C","E01030119","Total",982,934,48
"2011","St Edmundsbury 008D","E01030134","Total",483,470,13
"2011","St Edmundsbury 008E","E01030135","Total",554,538,16
"2011","St Edmundsbury 009B","E01030142","Total",757,736,21
"2011","St Edmundsbury 009C","E01030143","Total",672,661,11
"2011","St Edmundsbury 009D","E01030144","Total",556,535,21
"2011","St Edmundsbury 009E","E01030147","Total",698,681,17
"2011","St Edmundsbury 009F","E01033048","Total",690,650,40
"2011","St Edmundsbury 009G","E01033049","Total",685,653,32
"2011","St Edmundsbury 010A","E01030099","Total",926,863,63
"2011","St Edmundsbury 010B","E01030101","Total",994,950,44
"2011","St Edmundsbury 010C","E01030150","Total",938,909,29
"2011","St Edmundsbury 011A","E01030120","Total",961,923,38
"2011","St Edmundsbury 011B","E01030122","Total",834,798,36
"2011","St Edmundsbury 011C","E01030151","Total",867,822,45
"2011","St Edmundsbury 012A","E01030109","Total",762,753,9
"2011","St Edmundsbury 012B","E01030110","Total",1174,1152,22
"2011","St Edmundsbury 012C","E01030111","Total",533,530,3
"2011","St Edmundsbury 012D","E01030112","Total",754,741,13
"2011","St Edmundsbury 013A","E01030115","Total",891,877,14
"2011","St Edmundsbury 013B","E01030116","Total",848,828,20
"2011","St Edmundsbury 013C","E01030117","Total",662,652,10
"2011","St Edmundsbury 013D","E01030118","Total",663,654,9
"2011","St Edmundsbury 014A","E01030105","Total",730,713,17
"2011","St Edmundsbury 014B","E01030106","Total",1033,1018,15
"2011","St Edmundsbury 014C","E01030107","Total",643,638,5
"2011","St Edmundsbury 014D","E01030108","Total",722,710,12
"2011","St Edmundsbury 014E","E01030113","Total",851,828,23
"2011","St Edmundsbury 014F","E01030114","Total",554,546,8
"2011","Suffolk Coastal 001A","E01030201","Total",1066,913,153
"2011","Suffolk Coastal 001B","E01030219","Total",1221,903,318
"2011","Suffolk Coastal 001C","E01030222","Total",1179,905,274
"2011","Suffolk Coastal 002A","E01030154","Total",972,877,95
"2011","Suffolk Coastal 002B","E01030172","Total",776,713,63
"2011","Suffolk Coastal 002C","E01030173","Total",738,686,52
"2011","Suffolk Coastal 002D","E01030174","Total",601,545,56
"2011","Suffolk Coastal 002E","E01030176","Total",958,852,106
"2011","Suffolk Coastal 003A","E01030186","Total",653,598,55
"2011","Suffolk Coastal 003B","E01030208","Total",673,586,87
"2011","Suffolk Coastal 003C","E01030209","Total",847,763,84
"2011","Suffolk Coastal 003D","E01030210","Total",885,860,25
"2011","Suffolk Coastal 003E","E01030212","Total",1037,863,174
"2011","Suffolk Coastal 004A","E01030152","Total",1466,1043,423
"2011","Suffolk Coastal 004B","E01030153","Total",1175,665,510
"2011","Suffolk Coastal 004C","E01030187","Total",691,656,35
"2011","Suffolk Coastal 004D","E01030188","Total",858,783,75
"2011","Suffolk Coastal 004E","E01030189","Total",772,712,60
"2011","Suffolk Coastal 005A","E01030193","Total",733,677,56
"2011","Suffolk Coastal 005B","E01030194","Total",879,812,67
"2011","Suffolk Coastal 005C","E01030195","Total",686,670,16
"2011","Suffolk Coastal 005D","E01030220","Total",1006,959,47
"2011","Suffolk Coastal 006A","E01030175","Total",1015,967,48
"2011","Suffolk Coastal 006B","E01030200","Total",970,894,76
"2011","Suffolk Coastal 006C","E01030221","Total",878,833,45
"2011","Suffolk Coastal 007C","E01030199","Total",1124,836,288
"2011","Suffolk Coastal 007F","E01033443","Total",592,527,65
"2011","Suffolk Coastal 007G","E01033445","Total",664,649,15
"2011","Suffolk Coastal 007H","E01033446","Total",960,871,89
"2011","Suffolk Coastal 007I","E01033448","Total",642,544,98
"2011","Suffolk Coastal 007J","E01033449","Total",710,662,48
"2011","Suffolk Coastal 008A","E01030155","Total",887,855,32
"2011","Suffolk Coastal 008B","E01030185","Total",927,886,41
"2011","Suffolk Coastal 008C","E01030203","Total",1049,948,101
"2011","Suffolk Coastal 008D","E01030211","Total",1227,1103,124
"2011","Suffolk Coastal 009A","E01030179","Total",1038,1015,23
"2011","Suffolk Coastal 009B","E01030180","Total",563,553,10
"2011","Suffolk Coastal 009C","E01030183","Total",913,883,30
"2011","Suffolk Coastal 009D","E01030184","Total",842,818,24
"2011","Suffolk Coastal 009E","E01030207","Total",699,673,26
"2011","Suffolk Coastal 010A","E01030181","Total",748,724,24
"2011","Suffolk Coastal 010C","E01030190","Total",840,806,34
"2011","Suffolk Coastal 010D","E01030191","Total",802,783,19
"2011","Suffolk Coastal 010E","E01030192","Total",619,609,10
"2011","Suffolk Coastal 010F","E01030198","Total",624,570,54
"2011","Suffolk Coastal 010G","E01033442","Total",558,546,12
"2011","Suffolk Coastal 010H","E01033444","Total",527,512,15
"2011","Suffolk Coastal 010I","E01033447","Total",594,585,9
"2011","Suffolk Coastal 011A","E01030196","Total",691,677,14
"2011","Suffolk Coastal 011B","E01030197","Total",731,691,40
"2011","Suffolk Coastal 011C","E01030204","Total",747,728,19
"2011","Suffolk Coastal 011D","E01030205","Total",466,463,3
"2011","Suffolk Coastal 011E","E01030206","Total",650,634,16
"2011","Suffolk Coastal 012A","E01030171","Total",795,784,11
"2011","Suffolk Coastal 012B","E01030214","Total",540,531,9
"2011","Suffolk Coastal 012C","E01030215","Total",645,633,12
"2011","Suffolk Coastal 012D","E01030216","Total",644,627,17
"2011","Suffolk Coastal 012E","E01030217","Total",582,564,18
"2011","Suffolk Coastal 012F","E01030218","Total",641,625,16
"2011","Suffolk Coastal 013C","E01030158","Total",714,679,35
"2011","Suffolk Coastal 013D","E01030159","Total",673,648,25
"2011","Suffolk Coastal 013E","E01030164","Total",679,650,29
"2011","Suffolk Coastal 013F","E01030166","Total",698,674,24
"2011","Suffolk Coastal 013G","E01033450","Total",1146,1119,27
"2011","Suffolk Coastal 014A","E01030160","Total",729,699,30
"2011","Suffolk Coastal 014B","E01030161","Total",626,611,15
"2011","Suffolk Coastal 014C","E01030168","Total",669,662,7
"2011","Suffolk Coastal 014D","E01030169","Total",768,746,22
"2011","Suffolk Coastal 014E","E01030170","Total",768,759,9
"2011","Suffolk Coastal 015A","E01030162","Total",703,634,69
"2011","Suffolk Coastal 015B","E01030163","Total",687,656,31
"2011","Suffolk Coastal 015C","E01030165","Total",845,762,83
"2011","Suffolk Coastal 015D","E01030167","Total",664,609,55
"2011","Waveney 001A","E01030240","Total",786,745,41
"2011","Waveney 001B","E01030241","Total",706,659,47
"2011","Waveney 001C","E01030242","Total",628,594,34
"2011","Waveney 001D","E01030259","Total",492,470,22
"2011","Waveney 001E","E01030260","Total",451,427,24
"2011","Waveney 002A","E01030261","Total",642,606,36
"2011","Waveney 002B","E01030262","Total",597,566,31
"2011","Waveney 002C","E01030277","Total",503,480,23
"2011","Waveney 002D","E01030279","Total",623,591,32
"2011","Waveney 002E","E01030281","Total",971,948,23
"2011","Waveney 003A","E01030266","Total",740,711,29
"2011","Waveney 003B","E01030267","Total",587,570,17
"2011","Waveney 003C","E01030271","Total",715,687,28
"2011","Waveney 003D","E01030278","Total",732,714,18
"2011","Waveney 003E","E01030280","Total",641,624,17
"2011","Waveney 004A","E01030246","Total",667,609,58
"2011","Waveney 004B","E01030248","Total",653,618,35
"2011","Waveney 004C","E01030249","Total",829,747,82
"2011","Waveney 004D","E01030250","Total",997,881,116
"2011","Waveney 004E","E01030264","Total",661,612,49
"2011","Waveney 004F","E01030265","Total",654,612,42
"2011","Waveney 005A","E01030255","Total",527,503,24
"2011","Waveney 005B","E01030263","Total",695,666,29
"2011","Waveney 005C","E01030270","Total",740,683,57
"2011","Waveney 005D","E01030289","Total",705,674,31
"2011","Waveney 005E","E01030290","Total",705,677,28
"2011","Waveney 006A","E01030233","Total",650,641,9
"2011","Waveney 006B","E01030235","Total",661,631,30
"2011","Waveney 006C","E01030268","Total",539,529,10
"2011","Waveney 006D","E01030269","Total",799,752,47
"2011","Waveney 006E","E01030288","Total",637,619,18
"2011","Waveney 007A","E01030247","Total",956,859,97
"2011","Waveney 007B","E01030254","Total",648,615,33
"2011","Waveney 007C","E01030256","Total",727,623,104
"2011","Waveney 007D","E01030258","Total",955,809,146
"2011","Waveney 007E","E01030276","Total",648,590,58
"2011","Waveney 008A","E01030257","Total",663,637,26
"2011","Waveney 008B","E01030274","Total",631,619,12
"2011","Waveney 008C","E01030275","Total",514,487,27
"2011","Waveney 008D","E01030287","Total",670,657,13
"2011","Waveney 008E","E01030291","Total",607,589,18
"2011","Waveney 009A","E01030234","Total",676,662,14
"2011","Waveney 009B","E01030236","Total",824,793,31
"2011","Waveney 009C","E01030237","Total",1140,1118,22
"2011","Waveney 009D","E01030238","Total",736,717,19
"2011","Waveney 010A","E01030223","Total",855,816,39
"2011","Waveney 010B","E01030224","Total",816,770,46
"2011","Waveney 010C","E01030225","Total",911,846,65
"2011","Waveney 010D","E01030227","Total",631,620,11
"2011","Waveney 010E","E01030228","Total",787,776,11
"2011","Waveney 011A","E01030226","Total",789,774,15
"2011","Waveney 011B","E01030286","Total",940,896,44
"2011","Waveney 011C","E01030292","Total",658,645,13
"2011","Waveney 011D","E01030293","Total",712,693,19
"2011","Waveney 011E","E01030294","Total",663,641,22
"2011","Waveney 012A","E01030239","Total",741,727,14
"2011","Waveney 012B","E01030251","Total",785,700,85
"2011","Waveney 012C","E01030252","Total",874,815,59
"2011","Waveney 012D","E01030253","Total",818,787,31
"2011","Waveney 012E","E01030272","Total",810,752,58
"2011","Waveney 012F","E01030273","Total",759,739,20
"2011","Waveney 013A","E01030230","Total",991,926,65
"2011","Waveney 013B","E01030231","Total",671,657,14
"2011","Waveney 013C","E01030232","Total",698,682,16
"2011","Waveney 013D","E01030285","Total",986,925,61
"2011","Waveney 014A","E01030282","Total",1335,661,674
"2011","Waveney 014B","E01030283","Total",694,577,117
"2011","Waveney 014C","E01030284","Total",763,609,154
"2011","Waveney 014D","E01030295","Total",1100,981,119
"2011","Waveney 015A","E01030229","Total",1072,949,123
"2011","Waveney 015B","E01030243","Total",692,656,36
"2011","Waveney 015C","E01030244","Total",959,879,80
"2011","Waveney 015D","E01030245","Total",790,763,27
"2011","Camden 001A","E01000907","Total",630,627,3
"2011","Camden 001B","E01000908","Total",869,827,42
"2011","Camden 001C","E01000909","Total",677,661,16
"2011","Camden 001D","E01000912","Total",710,700,10
"2011","Camden 001E","E01000913","Total",805,722,83
"2011","Camden 002A","E01000893","Total",774,715,59
"2011","Camden 002B","E01000894","Total",667,619,48
"2011","Camden 002C","E01000895","Total",896,841,55
"2011","Camden 002D","E01000896","Total",802,756,46
"2011","Camden 002E","E01000899","Total",761,698,63
"2011","Camden 003A","E01000910","Total",612,588,24
"2011","Camden 003B","E01000911","Total",678,663,15
"2011","Camden 003C","E01000921","Total",976,946,30
"2011","Camden 003D","E01000923","Total",665,656,9
"2011","Camden 003E","E01000928","Total",691,682,9
"2011","Camden 004A","E01000878","Total",590,550,40
"2011","Camden 004B","E01000879","Total",638,602,36
"2011","Camden 004C","E01000880","Total",673,621,52
"2011","Camden 004D","E01000884","Total",629,577,52
"2011","Camden 004E","E01000885","Total",648,592,56
"2011","Camden 005A","E01000871","Total",678,632,46
"2011","Camden 005B","E01000872","Total",964,913,51
"2011","Camden 005C","E01000873","Total",731,710,21
"2011","Camden 005D","E01000874","Total",734,704,30
"2011","Camden 005E","E01000877","Total",768,726,42
"2011","Camden 006A","E01000886","Total",637,606,31
"2011","Camden 006B","E01000887","Total",714,690,24
"2011","Camden 006C","E01000888","Total",716,697,19
"2011","Camden 006D","E01000892","Total",849,823,26
"2011","Camden 006E","E01000903","Total",714,686,28
"2011","Camden 007A","E01000889","Total",662,657,5
"2011","Camden 007B","E01000890","Total",776,767,9
"2011","Camden 007C","E01000891","Total",682,672,10
"2011","Camden 007D","E01000901","Total",714,703,11
"2011","Camden 007E","E01000922","Total",668,653,15
"2011","Camden 007F","E01000927","Total",750,734,16
"2011","Camden 008A","E01000881","Total",685,632,53
"2011","Camden 008B","E01000882","Total",757,728,29
"2011","Camden 008C","E01000883","Total",672,638,34
"2011","Camden 008D","E01000897","Total",769,721,48
"2011","Camden 008E","E01000898","Total",879,850,29
"2011","Camden 009A","E01000866","Total",942,926,16
"2011","Camden 009B","E01000870","Total",790,774,16
"2011","Camden 009C","E01000924","Total",818,795,23
"2011","Camden 009D","E01000925","Total",638,629,9
"2011","Camden 009E","E01000926","Total",710,698,12
"2011","Camden 010A","E01000969","Total",991,954,37
"2011","Camden 010B","E01000970","Total",862,831,31
"2011","Camden 010C","E01000971","Total",668,649,19
"2011","Camden 010D","E01000972","Total",973,949,24
"2011","Camden 010E","E01000973","Total",945,894,51
"2011","Camden 011A","E01000842","Total",771,724,47
"2011","Camden 011B","E01000844","Total",914,870,44
"2011","Camden 011C","E01000848","Total",857,805,52
"2011","Camden 011D","E01000849","Total",909,862,47
"2011","Camden 012A","E01000900","Total",770,757,13
"2011","Camden 012B","E01000902","Total",606,590,16
"2011","Camden 012C","E01000904","Total",943,918,25
"2011","Camden 012D","E01000905","Total",825,812,13
"2011","Camden 012E","E01000906","Total",836,788,48
"2011","Camden 013A","E01000875","Total",874,839,35
"2011","Camden 013B","E01000876","Total",809,800,9
"2011","Camden 013C","E01000931","Total",893,873,20
"2011","Camden 013D","E01000932","Total",970,947,23
"2011","Camden 013E","E01000974","Total",832,821,11
"2011","Camden 014A","E01000843","Total",900,846,54
"2011","Camden 014B","E01000845","Total",770,731,39
"2011","Camden 014C","E01000846","Total",641,616,25
"2011","Camden 014D","E01000847","Total",718,677,41
"2011","Camden 015A","E01000864","Total",750,717,33
"2011","Camden 015B","E01000865","Total",477,451,26
"2011","Camden 015C","E01000867","Total",691,675,16
"2011","Camden 015D","E01000868","Total",591,584,7
"2011","Camden 015E","E01000869","Total",1035,967,68
"2011","Camden 016A","E01000962","Total",773,745,28
"2011","Camden 016B","E01000964","Total",725,713,12
"2011","Camden 016C","E01000965","Total",785,764,21
"2011","Camden 016D","E01000966","Total",703,675,28
"2011","Camden 016E","E01000968","Total",785,760,25
"2011","Camden 017A","E01000960","Total",859,841,18
"2011","Camden 017B","E01000961","Total",669,652,17
"2011","Camden 017C","E01000963","Total",1006,851,155
"2011","Camden 017D","E01000967","Total",690,619,71
"2011","Camden 018A","E01000857","Total",725,686,39
"2011","Camden 018B","E01000858","Total",802,775,27
"2011","Camden 018C","E01000859","Total",896,807,89
"2011","Camden 018D","E01000860","Total",858,797,61
"2011","Camden 018E","E01000862","Total",921,816,105
"2011","Camden 019A","E01000856","Total",641,628,13
"2011","Camden 019B","E01000861","Total",768,729,39
"2011","Camden 019C","E01000957","Total",781,765,16
"2011","Camden 019D","E01000958","Total",852,835,17
"2011","Camden 019E","E01000959","Total",704,698,6
"2011","Camden 020A","E01000929","Total",704,685,19
"2011","Camden 020B","E01000930","Total",1212,1076,136
"2011","Camden 020C","E01000933","Total",856,821,35
"2011","Camden 020D","E01000934","Total",751,732,19
"2011","Camden 020E","E01000935","Total",629,624,5
"2011","Camden 021A","E01000863","Total",723,667,56
"2011","Camden 021B","E01000946","Total",853,715,138
"2011","Camden 021C","E01000947","Total",945,871,74
"2011","Camden 021D","E01000948","Total",909,846,63
"2011","Camden 022A","E01000952","Total",685,675,10
"2011","Camden 022B","E01000953","Total",717,708,9
"2011","Camden 022C","E01000954","Total",651,642,9
"2011","Camden 022D","E01000955","Total",665,657,8
"2011","Camden 022E","E01000956","Total",643,608,35
"2011","Camden 023A","E01000944","Total",683,667,16
"2011","Camden 023B","E01000945","Total",644,611,33
"2011","Camden 023C","E01000949","Total",752,739,13
"2011","Camden 023D","E01000950","Total",558,550,8
"2011","Camden 023E","E01000951","Total",614,603,11
"2011","Camden 024A","E01000936","Total",557,536,21
"2011","Camden 024B","E01000938","Total",769,737,32
"2011","Camden 024C","E01000939","Total",451,446,5
"2011","Camden 024D","E01000940","Total",573,534,39
"2011","Camden 025A","E01000853","Total",864,840,24
"2011","Camden 025B","E01000937","Total",562,502,60
"2011","Camden 025C","E01000941","Total",562,557,5
"2011","Camden 025D","E01000942","Total",761,686,75
"2011","Camden 025E","E01000943","Total",687,596,91
"2011","Camden 026A","E01000850","Total",739,664,75
"2011","Camden 026B","E01000851","Total",967,861,106
"2011","Camden 026C","E01000852","Total",795,625,170
"2011","Camden 026D","E01000854","Total",759,718,41
"2011","Camden 027A","E01000915","Total",652,635,17
"2011","Camden 027B","E01000916","Total",944,881,63
"2011","Camden 027C","E01000917","Total",941,913,28
"2011","Camden 027D","E01000920","Total",1006,946,60
"2011","Camden 028A","E01000855","Total",1299,1111,188
"2011","Camden 028B","E01000914","Total",1106,970,136
"2011","Camden 028C","E01000918","Total",1020,935,85
"2011","Camden 028D","E01000919","Total",923,834,89
"2011","City of London 001A","E01000001","Total",1012,876,136
"2011","City of London 001B","E01000002","Total",976,830,146
"2011","City of London 001C","E01000003","Total",887,817,70
"2011","City of London 001E","E01000005","Total",528,467,61
"2011","City of London 001F","E01032739","Total",1067,676,391
"2011","City of London 001G","E01032740","Total",1060,719,341
"2011","Hackney 001A","E01001808","Total",582,558,24
"2011","Hackney 001B","E01001809","Total",640,610,30
"2011","Hackney 001C","E01001814","Total",579,559,20
"2011","Hackney 001D","E01001823","Total",547,538,9
"2011","Hackney 001E","E01001825","Total",436,428,8
"2011","Hackney 002A","E01001714","Total",646,632,14
"2011","Hackney 002D","E01001811","Total",694,646,48
"2011","Hackney 002E","E01001813","Total",569,525,44
"2011","Hackney 002F","E01033701","Total",974,760,214
"2011","Hackney 003A","E01001799","Total",498,485,13
"2011","Hackney 003B","E01001802","Total",501,471,30
"2011","Hackney 003C","E01001804","Total",478,464,14
"2011","Hackney 003D","E01001807","Total",718,693,25
"2011","Hackney 003E","E01001812","Total",655,614,41
"2011","Hackney 004A","E01001725","Total",581,573,8
"2011","Hackney 004B","E01001726","Total",466,464,2
"2011","Hackney 004C","E01001800","Total",650,643,7
"2011","Hackney 004D","E01001824","Total",553,539,14
"2011","Hackney 004E","E01001826","Total",597,585,12
"2011","Hackney 006A","E01001723","Total",694,671,23
"2011","Hackney 006B","E01001724","Total",1002,980,22
"2011","Hackney 006C","E01001727","Total",603,573,30
"2011","Hackney 006D","E01001768","Total",740,719,21
"2011","Hackney 006E","E01001769","Total",681,662,19
"2011","Hackney 007A","E01001715","Total",703,673,30
"2011","Hackney 007B","E01001716","Total",644,633,11
"2011","Hackney 007C","E01001717","Total",434,427,7
"2011","Hackney 007D","E01001718","Total",860,824,36
"2011","Hackney 007E","E01001719","Total",505,484,21
"2011","Hackney 007F","E01001720","Total",809,785,24
"2011","Hackney 008A","E01001742","Total",808,789,19
"2011","Hackney 008B","E01001801","Total",600,588,12
"2011","Hackney 008C","E01001803","Total",730,719,11
"2011","Hackney 008D","E01001806","Total",722,714,8
"2011","Hackney 009A","E01001741","Total",610,599,11
"2011","Hackney 009B","E01001805","Total",517,510,7
"2011","Hackney 009C","E01001829","Total",715,696,19
"2011","Hackney 009D","E01001831","Total",768,745,23
"2011","Hackney 009E","E01001832","Total",665,642,23
"2011","Hackney 010A","E01001764","Total",733,696,37
"2011","Hackney 010B","E01001765","Total",768,722,46
"2011","Hackney 010D","E01001767","Total",650,628,22
"2011","Hackney 010E","E01001770","Total",812,784,28
"2011","Hackney 010F","E01033703","Total",642,625,17
"2011","Hackney 010G","E01033713","Total",615,601,14
"2011","Hackney 011A","E01001792","Total",635,620,15
"2011","Hackney 011B","E01001793","Total",674,656,18
"2011","Hackney 011C","E01001794","Total",673,656,17
"2011","Hackney 011D","E01001795","Total",585,571,14
"2011","Hackney 011E","E01001796","Total",764,737,27
"2011","Hackney 012A","E01001736","Total",732,707,25
"2011","Hackney 012B","E01001737","Total",792,754,38
"2011","Hackney 012C","E01001738","Total",805,785,20
"2011","Hackney 012D","E01001739","Total",935,898,37
"2011","Hackney 013A","E01001786","Total",729,717,12
"2011","Hackney 013B","E01001787","Total",635,628,7
"2011","Hackney 013C","E01001788","Total",676,670,6
"2011","Hackney 013D","E01001790","Total",500,492,8
"2011","Hackney 014A","E01001740","Total",634,624,10
"2011","Hackney 014B","E01001747","Total",968,943,25
"2011","Hackney 014C","E01001830","Total",950,932,18
"2011","Hackney 014D","E01001833","Total",950,931,19
"2011","Hackney 014E","E01001834","Total",877,862,15
"2011","Hackney 014F","E01001835","Total",497,483,14
"2011","Hackney 015A","E01001733","Total",715,701,14
"2011","Hackney 015B","E01001785","Total",586,569,17
"2011","Hackney 015C","E01001789","Total",659,646,13
"2011","Hackney 015D","E01001791","Total",505,500,5
"2011","Hackney 016A","E01001745","Total",970,958,12
"2011","Hackney 016B","E01001746","Total",636,632,4
"2011","Hackney 016C","E01001757","Total",665,654,11
"2011","Hackney 016D","E01001758","Total",911,884,27
"2011","Hackney 016E","E01001759","Total",768,750,18
"2011","Hackney 016F","E01001761","Total",893,869,24
"2011","Hackney 017A","E01001731","Total",1075,1033,42
"2011","Hackney 017B","E01001734","Total",865,849,16
"2011","Hackney 017C","E01001760","Total",784,765,19
"2011","Hackney 017D","E01001762","Total",845,820,25
"2011","Hackney 018A","E01001846","Total",542,535,7
"2011","Hackney 018B","E01001847","Total",480,467,13
"2011","Hackney 018C","E01001848","Total",668,655,13
"2011","Hackney 018D","E01001849","Total",996,977,19
"2011","Hackney 019A","E01001729","Total",875,863,12
"2011","Hackney 019B","E01001730","Total",818,801,17
"2011","Hackney 019C","E01001732","Total",701,696,5
"2011","Hackney 019D","E01001735","Total",683,661,22
"2011","Hackney 019E","E01001838","Total",709,705,4
"2011","Hackney 019F","E01001850","Total",688,676,12
"2011","Hackney 020A","E01001748","Total",1125,1090,35
"2011","Hackney 020B","E01001749","Total",757,743,14
"2011","Hackney 020C","E01001763","Total",752,742,10
"2011","Hackney 020D","E01001816","Total",646,640,6
"2011","Hackney 020E","E01001819","Total",695,684,11
"2011","Hackney 021B","E01001744","Total",807,786,21
"2011","Hackney 021C","E01001750","Total",795,782,13
"2011","Hackney 021D","E01001751","Total",686,676,10
"2011","Hackney 021E","E01001756","Total",997,987,10
"2011","Hackney 021F","E01033698","Total",625,613,12
"2011","Hackney 021G","E01033699","Total",612,585,27
"2011","Hackney 021H","E01033700","Total",733,697,36
"2011","Hackney 021I","E01033707","Total",632,614,18
"2011","Hackney 022A","E01001836","Total",869,857,12
"2011","Hackney 022B","E01001840","Total",720,715,5
"2011","Hackney 022C","E01001841","Total",640,626,14
"2011","Hackney 022D","E01001844","Total",841,812,29
"2011","Hackney 022E","E01001845","Total",689,680,9
"2011","Hackney 023B","E01001837","Total",674,665,9
"2011","Hackney 023C","E01001839","Total",955,941,14
"2011","Hackney 023D","E01001842","Total",637,631,6
"2011","Hackney 023E","E01001843","Total",519,502,17
"2011","Hackney 023F","E01033704","Total",779,763,16
"2011","Hackney 023G","E01033712","Total",671,661,10
"2011","Hackney 024A","E01001772","Total",461,459,2
"2011","Hackney 024B","E01001774","Total",883,875,8
"2011","Hackney 024C","E01001775","Total",771,759,12
"2011","Hackney 024D","E01001815","Total",706,692,14
"2011","Hackney 024E","E01001820","Total",609,599,10
"2011","Hackney 024F","E01001821","Total",649,644,5
"2011","Hackney 025A","E01001752","Total",1075,1060,15
"2011","Hackney 025B","E01001753","Total",691,687,4
"2011","Hackney 025C","E01001754","Total",1155,1135,20
"2011","Hackney 025D","E01001755","Total",739,724,15
"2011","Hackney 025E","E01001773","Total",869,860,9
"2011","Hackney 025F","E01001776","Total",638,634,4
"2011","Hackney 026A","E01001779","Total",1135,1121,14
"2011","Hackney 026B","E01001781","Total",737,731,6
"2011","Hackney 026C","E01001782","Total",1081,1053,28
"2011","Hackney 026D","E01001783","Total",870,863,7
"2011","Hackney 027B","E01001777","Total",1061,1043,18
"2011","Hackney 027D","E01001780","Total",926,916,10
"2011","Hackney 027E","E01001784","Total",805,797,8
"2011","Hackney 027F","E01033706","Total",791,764,27
"2011","Hackney 027G","E01033708","Total",903,862,41
"2011","Hackney 027H","E01033709","Total",805,789,16
"2011","Hackney 027I","E01033711","Total",509,501,8
"2011","Hackney 028A","E01001798","Total",721,694,27
"2011","Hackney 028B","E01001828","Total",852,831,21
"2011","Hackney 028C","E01033702","Total",507,480,27
"2011","Hackney 028D","E01033705","Total",585,576,9
"2011","Hackney 028E","E01033710","Total",544,532,12
"2011","Hackney 029A","E01001722","Total",871,860,11
"2011","Hackney 029B","E01001728","Total",643,627,16
"2011","Hackney 029C","E01001822","Total",723,706,17
"2011","Hackney 029D","E01001827","Total",743,716,27
"2011","Hammersmith and Fulham 001A","E01001874","Total",979,966,13
"2011","Hammersmith and Fulham 001B","E01001875","Total",682,666,16
"2011","Hammersmith and Fulham 001C","E01001876","Total",864,834,30
"2011","Hammersmith and Fulham 001D","E01001877","Total",665,603,62
"2011","Hammersmith and Fulham 001E","E01001878","Total",615,605,10
"2011","Hammersmith and Fulham 002A","E01001955","Total",681,674,7
"2011","Hammersmith and Fulham 002B","E01001957","Total",613,605,8
"2011","Hammersmith and Fulham 002C","E01001958","Total",617,614,3
"2011","Hammersmith and Fulham 002D","E01001961","Total",544,540,4
"2011","Hammersmith and Fulham 003A","E01001954","Total",669,649,20
"2011","Hammersmith and Fulham 003B","E01001956","Total",622,603,19
"2011","Hammersmith and Fulham 003C","E01001959","Total",601,588,13
"2011","Hammersmith and Fulham 003D","E01001960","Total",779,750,29
"2011","Hammersmith and Fulham 004A","E01001943","Total",967,905,62
"2011","Hammersmith and Fulham 004B","E01001944","Total",878,869,9
"2011","Hammersmith and Fulham 004C","E01001945","Total",793,754,39
"2011","Hammersmith and Fulham 004D","E01001946","Total",722,702,20
"2011","Hammersmith and Fulham 005A","E01001862","Total",870,830,40
"2011","Hammersmith and Fulham 005B","E01001940","Total",770,740,30
"2011","Hammersmith and Fulham 005C","E01001941","Total",745,717,28
"2011","Hammersmith and Fulham 005D","E01001942","Total",899,865,34
"2011","Hammersmith and Fulham 006A","E01001858","Total",744,732,12
"2011","Hammersmith and Fulham 006B","E01001860","Total",815,795,20
"2011","Hammersmith and Fulham 006C","E01001861","Total",689,654,35
"2011","Hammersmith and Fulham 006D","E01001863","Total",687,671,16
"2011","Hammersmith and Fulham 006E","E01001864","Total",783,761,22
"2011","Hammersmith and Fulham 007A","E01001852","Total",991,956,35
"2011","Hammersmith and Fulham 007B","E01001853","Total",706,695,11
"2011","Hammersmith and Fulham 007C","E01001854","Total",909,887,22
"2011","Hammersmith and Fulham 007D","E01001857","Total",757,733,24
"2011","Hammersmith and Fulham 008A","E01001859","Total",1206,1140,66
"2011","Hammersmith and Fulham 008B","E01001865","Total",676,651,25
"2011","Hammersmith and Fulham 008C","E01001927","Total",580,557,23
"2011","Hammersmith and Fulham 008D","E01001930","Total",894,842,52
"2011","Hammersmith and Fulham 009A","E01001895","Total",694,674,20
"2011","Hammersmith and Fulham 009B","E01001896","Total",694,669,25
"2011","Hammersmith and Fulham 009C","E01001897","Total",680,619,61
"2011","Hammersmith and Fulham 009D","E01001929","Total",610,597,13
"2011","Hammersmith and Fulham 010A","E01001851","Total",708,696,12
"2011","Hammersmith and Fulham 010B","E01001855","Total",929,894,35
"2011","Hammersmith and Fulham 010C","E01001856","Total",743,730,13
"2011","Hammersmith and Fulham 010D","E01001869","Total",617,574,43
"2011","Hammersmith and Fulham 010E","E01001873","Total",706,689,17
"2011","Hammersmith and Fulham 011A","E01001928","Total",734,722,12
"2011","Hammersmith and Fulham 011B","E01001931","Total",740,709,31
"2011","Hammersmith and Fulham 011C","E01001932","Total",780,757,23
"2011","Hammersmith and Fulham 011D","E01001933","Total",667,635,32
"2011","Hammersmith and Fulham 012A","E01001866","Total",757,704,53
"2011","Hammersmith and Fulham 012B","E01001867","Total",644,612,32
"2011","Hammersmith and Fulham 012C","E01001868","Total",666,603,63
"2011","Hammersmith and Fulham 012D","E01001870","Total",1057,1009,48
"2011","Hammersmith and Fulham 012E","E01001871","Total",871,769,102
"2011","Hammersmith and Fulham 012F","E01001872","Total",810,759,51
"2011","Hammersmith and Fulham 013A","E01001893","Total",528,504,24
"2011","Hammersmith and Fulham 013B","E01001894","Total",639,602,37
"2011","Hammersmith and Fulham 013C","E01001898","Total",784,736,48
"2011","Hammersmith and Fulham 013D","E01001899","Total",703,691,12
"2011","Hammersmith and Fulham 013E","E01001900","Total",739,723,16
"2011","Hammersmith and Fulham 014A","E01001889","Total",608,593,15
"2011","Hammersmith and Fulham 014B","E01001910","Total",861,840,21
"2011","Hammersmith and Fulham 014C","E01001913","Total",795,774,21
"2011","Hammersmith and Fulham 014D","E01001914","Total",972,887,85
"2011","Hammersmith and Fulham 015A","E01001885","Total",615,538,77
"2011","Hammersmith and Fulham 015B","E01001908","Total",910,875,35
"2011","Hammersmith and Fulham 015C","E01001909","Total",837,821,16
"2011","Hammersmith and Fulham 015D","E01001911","Total",759,751,8
"2011","Hammersmith and Fulham 015E","E01001912","Total",611,600,11
"2011","Hammersmith and Fulham 016A","E01001886","Total",633,628,5
"2011","Hammersmith and Fulham 016B","E01001887","Total",662,658,4
"2011","Hammersmith and Fulham 016C","E01001890","Total",975,950,25
"2011","Hammersmith and Fulham 016D","E01001892","Total",612,605,7
"2011","Hammersmith and Fulham 017A","E01001880","Total",796,757,39
"2011","Hammersmith and Fulham 017B","E01001881","Total",709,681,28
"2011","Hammersmith and Fulham 017C","E01001882","Total",750,702,48
"2011","Hammersmith and Fulham 017D","E01001883","Total",771,734,37
"2011","Hammersmith and Fulham 017E","E01001884","Total",988,931,57
"2011","Hammersmith and Fulham 018A","E01001888","Total",655,644,11
"2011","Hammersmith and Fulham 018B","E01001891","Total",922,863,59
"2011","Hammersmith and Fulham 018C","E01001917","Total",711,684,27
"2011","Hammersmith and Fulham 018D","E01001918","Total",637,622,15
"2011","Hammersmith and Fulham 018E","E01001919","Total",680,639,41
"2011","Hammersmith and Fulham 019A","E01001879","Total",657,633,24
"2011","Hammersmith and Fulham 019B","E01001901","Total",754,695,59
"2011","Hammersmith and Fulham 019C","E01001902","Total",849,814,35
"2011","Hammersmith and Fulham 019D","E01001903","Total",696,681,15
"2011","Hammersmith and Fulham 020A","E01001920","Total",873,828,45
"2011","Hammersmith and Fulham 020B","E01001921","Total",718,663,55
"2011","Hammersmith and Fulham 020C","E01001922","Total",705,671,34
"2011","Hammersmith and Fulham 020D","E01001923","Total",684,653,31
"2011","Hammersmith and Fulham 020E","E01001924","Total",666,604,62
"2011","Hammersmith and Fulham 021A","E01001947","Total",603,591,12
"2011","Hammersmith and Fulham 021B","E01001948","Total",969,922,47
"2011","Hammersmith and Fulham 021C","E01001949","Total",706,658,48
"2011","Hammersmith and Fulham 021D","E01001950","Total",677,636,41
"2011","Hammersmith and Fulham 021E","E01001951","Total",736,705,31
"2011","Hammersmith and Fulham 021F","E01001953","Total",659,610,49
"2011","Hammersmith and Fulham 022A","E01001904","Total",710,681,29
"2011","Hammersmith and Fulham 022B","E01001905","Total",776,750,26
"2011","Hammersmith and Fulham 022C","E01001906","Total",673,656,17
"2011","Hammersmith and Fulham 022D","E01001907","Total",594,563,31
"2011","Hammersmith and Fulham 023A","E01001935","Total",978,927,51
"2011","Hammersmith and Fulham 023C","E01001939","Total",1063,985,78
"2011","Hammersmith and Fulham 023D","E01032788","Total",542,496,46
"2011","Hammersmith and Fulham 023E","E01032789","Total",633,586,47
"2011","Hammersmith and Fulham 023F","E01032790","Total",630,557,73
"2011","Hammersmith and Fulham 024A","E01001915","Total",637,608,29
"2011","Hammersmith and Fulham 024B","E01001916","Total",765,689,76
"2011","Hammersmith and Fulham 024C","E01001926","Total",647,613,34
"2011","Hammersmith and Fulham 024D","E01001952","Total",861,809,52
"2011","Hammersmith and Fulham 025A","E01001925","Total",660,624,36
"2011","Hammersmith and Fulham 025B","E01001934","Total",710,699,11
"2011","Hammersmith and Fulham 025C","E01001937","Total",782,760,22
"2011","Hammersmith and Fulham 025D","E01001938","Total",620,616,4
"2011","Haringey 001A","E01001969","Total",868,857,11
"2011","Haringey 001B","E01001971","Total",790,784,6
"2011","Haringey 001C","E01001974","Total",992,959,33
"2011","Haringey 001D","E01001975","Total",802,776,26
"2011","Haringey 002A","E01002036","Total",674,637,37
"2011","Haringey 002B","E01002037","Total",735,697,38
"2011","Haringey 002C","E01002039","Total",645,639,6
"2011","Haringey 002D","E01002040","Total",824,740,84
"2011","Haringey 004A","E01001962","Total",650,641,9
"2011","Haringey 004B","E01001970","Total",735,728,7
"2011","Haringey 004C","E01001972","Total",758,749,9
"2011","Haringey 004D","E01001973","Total",972,943,29
"2011","Haringey 005A","E01002090","Total",538,531,7
"2011","Haringey 005B","E01002093","Total",655,645,10
"2011","Haringey 005C","E01002096","Total",592,583,9
"2011","Haringey 005D","E01002097","Total",602,592,10
"2011","Haringey 006A","E01002091","Total",653,635,18
"2011","Haringey 006B","E01002092","Total",696,689,7
"2011","Haringey 006C","E01002094","Total",548,541,7
"2011","Haringey 006D","E01002095","Total",622,604,18
"2011","Haringey 007A","E01002098","Total",613,604,9
"2011","Haringey 007B","E01002101","Total",725,698,27
"2011","Haringey 007C","E01002102","Total",765,752,13
"2011","Haringey 007D","E01002105","Total",878,861,17
"2011","Haringey 008A","E01002099","Total",825,813,12
"2011","Haringey 008B","E01002100","Total",699,680,19
"2011","Haringey 008C","E01002103","Total",657,646,11
"2011","Haringey 008D","E01002104","Total",513,501,12
"2011","Haringey 009A","E01001963","Total",699,691,8
"2011","Haringey 009B","E01001964","Total",685,667,18
"2011","Haringey 009C","E01001965","Total",666,657,9
"2011","Haringey 009D","E01001966","Total",542,535,7
"2011","Haringey 010A","E01002027","Total",562,552,10
"2011","Haringey 010B","E01002028","Total",654,645,9
"2011","Haringey 010C","E01002032","Total",779,759,20
"2011","Haringey 010D","E01002033","Total",714,709,5
"2011","Haringey 011A","E01001976","Total",684,635,49
"2011","Haringey 011B","E01001977","Total",657,605,52
"2011","Haringey 011C","E01001978","Total",854,819,35
"2011","Haringey 011D","E01001979","Total",878,846,32
"2011","Haringey 012A","E01002074","Total",867,849,18
"2011","Haringey 012B","E01002077","Total",717,686,31
"2011","Haringey 012C","E01002079","Total",553,539,14
"2011","Haringey 012D","E01002081","Total",635,615,20
"2011","Haringey 013A","E01002082","Total",568,568,0
"2011","Haringey 013B","E01002086","Total",640,605,35
"2011","Haringey 013C","E01002088","Total",698,688,10
"2011","Haringey 013D","E01002089","Total",646,644,2
"2011","Haringey 014A","E01001967","Total",657,633,24
"2011","Haringey 014B","E01001968","Total",796,778,18
"2011","Haringey 014C","E01001996","Total",716,698,18
"2011","Haringey 014D","E01001997","Total",759,730,29
"2011","Haringey 015A","E01002075","Total",632,595,37
"2011","Haringey 015B","E01002076","Total",649,639,10
"2011","Haringey 015C","E01002078","Total",970,951,19
"2011","Haringey 015D","E01002080","Total",523,510,13
"2011","Haringey 016A","E01002026","Total",717,711,6
"2011","Haringey 016B","E01002029","Total",758,740,18
"2011","Haringey 016C","E01002030","Total",672,658,14
"2011","Haringey 016D","E01002031","Total",795,764,31
"2011","Haringey 017A","E01001991","Total",784,766,18
"2011","Haringey 017B","E01001992","Total",709,672,37
"2011","Haringey 017C","E01001993","Total",621,609,12
"2011","Haringey 017D","E01001995","Total",909,898,11
"2011","Haringey 018A","E01001980","Total",738,673,65
"2011","Haringey 018B","E01001981","Total",642,601,41
"2011","Haringey 018C","E01001982","Total",791,676,115
"2011","Haringey 018D","E01001983","Total",668,612,56
"2011","Haringey 019A","E01002083","Total",557,543,14
"2011","Haringey 019B","E01002084","Total",660,619,41
"2011","Haringey 019C","E01002085","Total",837,821,16
"2011","Haringey 019D","E01002087","Total",800,714,86
"2011","Haringey 020B","E01002014","Total",839,797,42
"2011","Haringey 020C","E01002015","Total",680,668,12
"2011","Haringey 020D","E01002018","Total",617,602,15
"2011","Haringey 020E","E01033085","Total",928,908,20
"2011","Haringey 020F","E01033086","Total",494,488,6
"2011","Haringey 021A","E01002020","Total",724,706,18
"2011","Haringey 021B","E01002022","Total",899,867,32
"2011","Haringey 021C","E01002023","Total",632,609,23
"2011","Haringey 021D","E01002025","Total",700,670,30
"2011","Haringey 022A","E01002013","Total",610,595,15
"2011","Haringey 022B","E01002019","Total",512,503,9
"2011","Haringey 022C","E01002021","Total",616,603,13
"2011","Haringey 022D","E01002024","Total",539,534,5
"2011","Haringey 023A","E01001998","Total",940,865,75
"2011","Haringey 023B","E01001999","Total",939,819,120
"2011","Haringey 023C","E01002003","Total",982,929,53
"2011","Haringey 023D","E01002004","Total",733,710,23
"2011","Haringey 024A","E01002067","Total",736,700,36
"2011","Haringey 024B","E01002069","Total",937,880,57
"2011","Haringey 024C","E01002070","Total",803,789,14
"2011","Haringey 024D","E01002073","Total",695,681,14
"2011","Haringey 025A","E01002066","Total",794,781,13
"2011","Haringey 025B","E01002068","Total",771,739,32
"2011","Haringey 025C","E01002071","Total",710,675,35
"2011","Haringey 025D","E01002072","Total",695,680,15
"2011","Haringey 026A","E01002043","Total",765,742,23
"2011","Haringey 026B","E01002045","Total",818,803,15
"2011","Haringey 026C","E01002046","Total",690,676,14
"2011","Haringey 026D","E01002049","Total",716,705,11
"2011","Haringey 027A","E01002042","Total",564,541,23
"2011","Haringey 027B","E01002044","Total",730,693,37
"2011","Haringey 027C","E01002047","Total",605,592,13
"2011","Haringey 027D","E01002048","Total",705,690,15
"2011","Haringey 028A","E01002016","Total",913,864,49
"2011","Haringey 028B","E01002017","Total",770,751,19
"2011","Haringey 028C","E01002059","Total",757,710,47
"2011","Haringey 028D","E01002060","Total",776,763,13
"2011","Haringey 029A","E01002050","Total",502,467,35
"2011","Haringey 029B","E01002051","Total",728,667,61
"2011","Haringey 029C","E01002052","Total",550,526,24
"2011","Haringey 029D","E01002055","Total",507,456,51
"2011","Haringey 030A","E01001994","Total",791,760,31
"2011","Haringey 030B","E01002008","Total",706,643,63
"2011","Haringey 030C","E01002010","Total",745,718,27
"2011","Haringey 030D","E01002011","Total",777,761,16
"2011","Haringey 031A","E01002000","Total",784,690,94
"2011","Haringey 031B","E01002001","Total",767,677,90
"2011","Haringey 031C","E01002002","Total",899,781,118
"2011","Haringey 031D","E01002058","Total",705,681,24
"2011","Haringey 032A","E01002053","Total",728,663,65
"2011","Haringey 032B","E01002054","Total",707,697,10
"2011","Haringey 032C","E01002056","Total",869,841,28
"2011","Haringey 032D","E01002057","Total",580,557,23
"2011","Haringey 033A","E01001984","Total",893,867,26
"2011","Haringey 033B","E01001985","Total",797,769,28
"2011","Haringey 033C","E01001987","Total",831,805,26
"2011","Haringey 033D","E01001989","Total",789,766,23
"2011","Haringey 034A","E01001986","Total",753,744,9
"2011","Haringey 034B","E01001988","Total",901,881,20
"2011","Haringey 034C","E01001990","Total",1016,982,34
"2011","Haringey 034D","E01002062","Total",924,855,69
"2011","Haringey 035A","E01002005","Total",858,818,40
"2011","Haringey 035B","E01002006","Total",837,808,29
"2011","Haringey 035C","E01002007","Total",828,799,29
"2011","Haringey 035D","E01002009","Total",730,708,22
"2011","Haringey 036A","E01002061","Total",806,703,103
"2011","Haringey 036B","E01002063","Total",768,713,55
"2011","Haringey 036C","E01002064","Total",695,648,47
"2011","Haringey 036D","E01002065","Total",880,815,65
"2011","Haringey 037A","E01002034","Total",827,811,16
"2011","Haringey 037B","E01002038","Total",759,692,67
"2011","Haringey 037C","E01002041","Total",748,736,12
"2011","Haringey 037D","E01032575","Total",696,672,24
"2011","Islington 001A","E01002755","Total",650,635,15
"2011","Islington 001B","E01002756","Total",628,610,18
"2011","Islington 001C","E01002758","Total",729,709,20
"2011","Islington 001D","E01002804","Total",778,754,24
"2011","Islington 001E","E01002807","Total",847,824,23
"2011","Islington 001F","E01002811","Total",720,694,26
"2011","Islington 002A","E01002753","Total",635,626,9
"2011","Islington 002B","E01002754","Total",643,614,29
"2011","Islington 002C","E01002757","Total",599,590,9
"2011","Islington 002D","E01002759","Total",686,659,27
"2011","Islington 002E","E01002760","Total",639,626,13
"2011","Islington 002F","E01002772","Total",906,871,35
"2011","Islington 003A","E01002735","Total",801,777,24
"2011","Islington 003B","E01002805","Total",799,758,41
"2011","Islington 003C","E01002806","Total",743,721,22
"2011","Islington 003D","E01002808","Total",900,857,43
"2011","Islington 003E","E01002809","Total",721,700,21
"2011","Islington 003F","E01002810","Total",761,748,13
"2011","Islington 004A","E01002768","Total",884,851,33
"2011","Islington 004B","E01002770","Total",741,718,23
"2011","Islington 004C","E01002771","Total",670,659,11
"2011","Islington 004D","E01002773","Total",713,696,17
"2011","Islington 004E","E01002774","Total",1068,1005,63
"2011","Islington 005A","E01002732","Total",864,821,43
"2011","Islington 005B","E01002734","Total",735,696,39
"2011","Islington 005C","E01002736","Total",608,595,13
"2011","Islington 005D","E01002737","Total",800,788,12
"2011","Islington 005E","E01002751","Total",895,880,15
"2011","Islington 006A","E01002742","Total",717,675,42
"2011","Islington 006B","E01002747","Total",699,675,24
"2011","Islington 006C","E01002748","Total",689,667,22
"2011","Islington 006D","E01002749","Total",543,534,9
"2011","Islington 006F","E01033493","Total",752,701,51
"2011","Islington 006G","E01033494","Total",664,630,34
"2011","Islington 007A","E01002730","Total",850,812,38
"2011","Islington 007B","E01002731","Total",1213,1164,49
"2011","Islington 007C","E01002733","Total",622,598,24
"2011","Islington 007D","E01002763","Total",614,603,11
"2011","Islington 008A","E01002769","Total",900,847,53
"2011","Islington 008B","E01002785","Total",865,840,25
"2011","Islington 008C","E01002788","Total",967,916,51
"2011","Islington 008D","E01002789","Total",841,810,31
"2011","Islington 009A","E01002738","Total",855,839,16
"2011","Islington 009B","E01002741","Total",661,656,5
"2011","Islington 009C","E01002743","Total",753,726,27
"2011","Islington 009D","E01002744","Total",734,722,12
"2011","Islington 009E","E01002752","Total",683,651,32
"2011","Islington 010A","E01002764","Total",844,796,48
"2011","Islington 010B","E01002783","Total",766,718,48
"2011","Islington 010C","E01002784","Total",752,732,20
"2011","Islington 010D","E01002786","Total",840,828,12
"2011","Islington 010E","E01002787","Total",596,578,18
"2011","Islington 011C","E01002762","Total",927,889,38
"2011","Islington 011D","E01002767","Total",1005,982,23
"2011","Islington 011E","E01033486","Total",441,425,16
"2011","Islington 011F","E01033487","Total",636,595,41
"2011","Islington 011G","E01033488","Total",575,557,18
"2011","Islington 011H","E01033491","Total",1007,869,138
"2011","Islington 011I","E01033492","Total",720,687,33
"2011","Islington 012A","E01002777","Total",884,833,51
"2011","Islington 012B","E01002778","Total",752,743,9
"2011","Islington 012C","E01002779","Total",843,820,23
"2011","Islington 012D","E01002781","Total",607,598,9
"2011","Islington 012E","E01002782","Total",629,616,13
"2011","Islington 013A","E01002739","Total",844,816,28
"2011","Islington 013B","E01002740","Total",827,806,21
"2011","Islington 013C","E01002745","Total",724,681,43
"2011","Islington 013D","E01002795","Total",954,863,91
"2011","Islington 013E","E01002796","Total",524,496,28
"2011","Islington 014A","E01002716","Total",1096,1079,17
"2011","Islington 014B","E01002718","Total",833,799,34
"2011","Islington 014C","E01002721","Total",855,839,16
"2011","Islington 014D","E01002775","Total",737,683,54
"2011","Islington 014E","E01002776","Total",809,774,35
"2011","Islington 014F","E01002780","Total",803,763,40
"2011","Islington 015A","E01002708","Total",951,917,34
"2011","Islington 015B","E01002712","Total",574,535,39
"2011","Islington 015C","E01002713","Total",830,820,10
"2011","Islington 015D","E01002765","Total",1018,980,38
"2011","Islington 015E","E01002766","Total",852,811,41
"2011","Islington 016A","E01002717","Total",615,590,25
"2011","Islington 016B","E01002719","Total",782,737,45
"2011","Islington 016C","E01002720","Total",1007,993,14
"2011","Islington 016D","E01002790","Total",747,706,41
"2011","Islington 016E","E01002791","Total",831,762,69
"2011","Islington 016F","E01002793","Total",993,957,36
"2011","Islington 017A","E01002698","Total",1114,1056,58
"2011","Islington 017B","E01002699","Total",832,775,57
"2011","Islington 017C","E01002700","Total",690,640,50
"2011","Islington 017D","E01002714","Total",816,771,45
"2011","Islington 017E","E01002792","Total",978,877,101
"2011","Islington 018A","E01002722","Total",687,668,19
"2011","Islington 018B","E01002797","Total",887,872,15
"2011","Islington 018C","E01002798","Total",947,922,25
"2011","Islington 018D","E01002799","Total",902,880,22
"2011","Islington 018E","E01002800","Total",437,435,2
"2011","Islington 019A","E01002694","Total",691,669,22
"2011","Islington 019B","E01002697","Total",744,709,35
"2011","Islington 019C","E01002709","Total",761,751,10
"2011","Islington 019D","E01002710","Total",692,679,13
"2011","Islington 019E","E01002715","Total",699,682,17
"2011","Islington 020A","E01002696","Total",976,895,81
"2011","Islington 020B","E01002794","Total",932,862,70
"2011","Islington 020C","E01002801","Total",837,806,31
"2011","Islington 020D","E01002802","Total",743,706,37
"2011","Islington 020E","E01002803","Total",987,935,52
"2011","Islington 021A","E01002695","Total",846,795,51
"2011","Islington 021B","E01002711","Total",1084,963,121
"2011","Islington 021C","E01002727","Total",947,871,76
"2011","Islington 021D","E01002728","Total",531,509,22
"2011","Islington 021E","E01002729","Total",777,702,75
"2011","Islington 022B","E01002707","Total",979,901,78
"2011","Islington 022C","E01002723","Total",841,781,60
"2011","Islington 022D","E01002724","Total",1171,1025,146
"2011","Islington 022E","E01002725","Total",589,572,17
"2011","Islington 022F","E01002726","Total",877,825,52
"2011","Islington 022G","E01033489","Total",943,776,167
"2011","Islington 022H","E01033490","Total",808,703,105
"2011","Islington 023A","E01002701","Total",745,718,27
"2011","Islington 023B","E01002702","Total",922,870,52
"2011","Islington 023C","E01002703","Total",802,774,28
"2011","Islington 023D","E01002704","Total",1206,1035,171
"2011","Islington 023E","E01002706","Total",961,925,36
"2011","Kensington and Chelsea 001A","E01002852","Total",871,861,10
"2011","Kensington and Chelsea 001B","E01002853","Total",473,470,3
"2011","Kensington and Chelsea 001C","E01002854","Total",496,488,8
"2011","Kensington and Chelsea 001D","E01002855","Total",770,764,6
"2011","Kensington and Chelsea 001E","E01002857","Total",582,580,2
"2011","Kensington and Chelsea 002A","E01002904","Total",527,524,3
"2011","Kensington and Chelsea 002B","E01002905","Total",691,672,19
"2011","Kensington and Chelsea 002C","E01002906","Total",726,707,19
"2011","Kensington and Chelsea 002D","E01002907","Total",558,551,7
"2011","Kensington and Chelsea 003A","E01002876","Total",771,744,27
"2011","Kensington and Chelsea 003B","E01002877","Total",652,647,5
"2011","Kensington and Chelsea 003C","E01002878","Total",899,868,31
"2011","Kensington and Chelsea 003D","E01002908","Total",644,602,42
"2011","Kensington and Chelsea 003E","E01002909","Total",1210,1152,58
"2011","Kensington and Chelsea 004A","E01002829","Total",848,788,60
"2011","Kensington and Chelsea 004B","E01002830","Total",957,917,40
"2011","Kensington and Chelsea 004C","E01002831","Total",1021,961,60
"2011","Kensington and Chelsea 004D","E01002832","Total",979,910,69
"2011","Kensington and Chelsea 004E","E01002856","Total",982,941,41
"2011","Kensington and Chelsea 005A","E01002870","Total",709,693,16
"2011","Kensington and Chelsea 005B","E01002872","Total",748,726,22
"2011","Kensington and Chelsea 005C","E01002879","Total",703,695,8
"2011","Kensington and Chelsea 005D","E01002880","Total",660,653,7
"2011","Kensington and Chelsea 005E","E01002881","Total",552,544,8
"2011","Kensington and Chelsea 006A","E01002882","Total",771,703,68
"2011","Kensington and Chelsea 006B","E01002883","Total",900,802,98
"2011","Kensington and Chelsea 006C","E01002884","Total",801,710,91
"2011","Kensington and Chelsea 006D","E01002885","Total",1036,950,86
"2011","Kensington and Chelsea 006E","E01002886","Total",910,781,129
"2011","Kensington and Chelsea 007A","E01002833","Total",896,793,103
"2011","Kensington and Chelsea 007B","E01002871","Total",830,742,88
"2011","Kensington and Chelsea 007C","E01002873","Total",691,632,59
"2011","Kensington and Chelsea 007D","E01002874","Total",689,648,41
"2011","Kensington and Chelsea 007E","E01002875","Total",741,681,60
"2011","Kensington and Chelsea 008A","E01002824","Total",780,684,96
"2011","Kensington and Chelsea 008B","E01002825","Total",1007,827,180
"2011","Kensington and Chelsea 008C","E01002826","Total",949,798,151
"2011","Kensington and Chelsea 008D","E01002827","Total",1019,903,116
"2011","Kensington and Chelsea 008E","E01002828","Total",795,710,85
"2011","Kensington and Chelsea 009A","E01002864","Total",696,580,116
"2011","Kensington and Chelsea 009B","E01002866","Total",915,848,67
"2011","Kensington and Chelsea 009C","E01002867","Total",1086,998,88
"2011","Kensington and Chelsea 009D","E01002868","Total",824,725,99
"2011","Kensington and Chelsea 009E","E01002869","Total",831,768,63
"2011","Kensington and Chelsea 010A","E01002887","Total",938,807,131
"2011","Kensington and Chelsea 010B","E01002889","Total",732,579,153
"2011","Kensington and Chelsea 010C","E01002890","Total",792,705,87
"2011","Kensington and Chelsea 010D","E01002891","Total",848,718,130
"2011","Kensington and Chelsea 010E","E01002892","Total",1079,920,159
"2011","Kensington and Chelsea 011A","E01002813","Total",925,835,90
"2011","Kensington and Chelsea 011B","E01002815","Total",839,755,84
"2011","Kensington and Chelsea 011C","E01002816","Total",808,693,115
"2011","Kensington and Chelsea 011D","E01002817","Total",769,709,60
"2011","Kensington and Chelsea 011E","E01002865","Total",634,544,90
"2011","Kensington and Chelsea 012A","E01002818","Total",1647,1170,477
"2011","Kensington and Chelsea 012B","E01002819","Total",1141,853,288
"2011","Kensington and Chelsea 012C","E01002859","Total",1142,866,276
"2011","Kensington and Chelsea 012D","E01002860","Total",1008,777,231
"2011","Kensington and Chelsea 012E","E01002863","Total",1055,792,263
"2011","Kensington and Chelsea 013A","E01002812","Total",1028,895,133
"2011","Kensington and Chelsea 013B","E01002834","Total",776,718,58
"2011","Kensington and Chelsea 013C","E01002839","Total",1053,978,75
"2011","Kensington and Chelsea 013D","E01002850","Total",721,682,39
"2011","Kensington and Chelsea 013E","E01002888","Total",1256,1149,107
"2011","Kensington and Chelsea 014A","E01002821","Total",780,692,88
"2011","Kensington and Chelsea 014B","E01002823","Total",770,701,69
"2011","Kensington and Chelsea 014C","E01002858","Total",1061,749,312
"2011","Kensington and Chelsea 014D","E01002861","Total",877,771,106
"2011","Kensington and Chelsea 014E","E01002862","Total",1410,977,433
"2011","Kensington and Chelsea 015A","E01002814","Total",1030,905,125
"2011","Kensington and Chelsea 015B","E01002847","Total",928,872,56
"2011","Kensington and Chelsea 015C","E01002848","Total",934,894,40
"2011","Kensington and Chelsea 015D","E01002851","Total",954,918,36
"2011","Kensington and Chelsea 016A","E01002820","Total",766,666,100
"2011","Kensington and Chelsea 016B","E01002822","Total",736,621,115
"2011","Kensington and Chelsea 016C","E01002835","Total",878,784,94
"2011","Kensington and Chelsea 016D","E01002836","Total",861,795,66
"2011","Kensington and Chelsea 016E","E01002837","Total",847,717,130
"2011","Kensington and Chelsea 017A","E01002846","Total",808,781,27
"2011","Kensington and Chelsea 017B","E01002849","Total",862,787,75
"2011","Kensington and Chelsea 017C","E01002893","Total",1067,987,80
"2011","Kensington and Chelsea 017D","E01002894","Total",857,773,84
"2011","Kensington and Chelsea 017E","E01002898","Total",825,739,86
"2011","Kensington and Chelsea 018A","E01002899","Total",828,768,60
"2011","Kensington and Chelsea 018B","E01002900","Total",756,682,74
"2011","Kensington and Chelsea 018C","E01002901","Total",615,560,55
"2011","Kensington and Chelsea 018D","E01002902","Total",1193,1009,184
"2011","Kensington and Chelsea 018E","E01002903","Total",774,691,83
"2011","Kensington and Chelsea 019A","E01002844","Total",823,745,78
"2011","Kensington and Chelsea 019B","E01002845","Total",787,738,49
"2011","Kensington and Chelsea 019C","E01002910","Total",837,756,81
"2011","Kensington and Chelsea 019D","E01002911","Total",854,767,87
"2011","Kensington and Chelsea 019E","E01002914","Total",887,741,146
"2011","Kensington and Chelsea 020A","E01002838","Total",690,579,111
"2011","Kensington and Chelsea 020B","E01002895","Total",697,610,87
"2011","Kensington and Chelsea 020C","E01002896","Total",979,875,104
"2011","Kensington and Chelsea 020D","E01002897","Total",777,732,45
"2011","Kensington and Chelsea 020E","E01002912","Total",873,809,64
"2011","Kensington and Chelsea 021A","E01002840","Total",723,691,32
"2011","Kensington and Chelsea 021B","E01002841","Total",738,712,26
"2011","Kensington and Chelsea 021C","E01002842","Total",519,514,5
"2011","Kensington and Chelsea 021D","E01002843","Total",640,610,30
"2011","Kensington and Chelsea 021E","E01002913","Total",1077,932,145
"2011","Lambeth 002A","E01003015","Total",756,730,26
"2011","Lambeth 002B","E01003108","Total",797,755,42
"2011","Lambeth 002C","E01003110","Total",898,849,49
"2011","Lambeth 002D","E01003111","Total",661,638,23
"2011","Lambeth 002E","E01003112","Total",841,771,70
"2011","Lambeth 003A","E01003101","Total",700,685,15
"2011","Lambeth 003B","E01003105","Total",801,780,21
"2011","Lambeth 003C","E01003106","Total",942,911,31
"2011","Lambeth 003D","E01003107","Total",966,929,37
"2011","Lambeth 003E","E01003109","Total",1212,1093,119
"2011","Lambeth 004A","E01003102","Total",869,844,25
"2011","Lambeth 004C","E01003104","Total",834,777,57
"2011","Lambeth 004D","E01003122","Total",926,870,56
"2011","Lambeth 004E","E01003129","Total",824,808,16
"2011","Lambeth 004F","E01033207","Total",793,766,27
"2011","Lambeth 004G","E01033208","Total",1154,1018,136
"2011","Lambeth 005A","E01003098","Total",663,645,18
"2011","Lambeth 005B","E01003099","Total",694,666,28
"2011","Lambeth 005C","E01003100","Total",903,878,25
"2011","Lambeth 005D","E01003180","Total",684,662,22
"2011","Lambeth 005E","E01003183","Total",670,631,39
"2011","Lambeth 006A","E01003097","Total",733,724,9
"2011","Lambeth 006B","E01003121","Total",696,691,5
"2011","Lambeth 006C","E01003123","Total",709,683,26
"2011","Lambeth 006D","E01003124","Total",633,619,14
"2011","Lambeth 006E","E01003125","Total",702,692,10
"2011","Lambeth 007A","E01003181","Total",653,644,9
"2011","Lambeth 007B","E01003184","Total",600,586,14
"2011","Lambeth 007C","E01003185","Total",795,768,27
"2011","Lambeth 007D","E01003186","Total",892,876,16
"2011","Lambeth 007E","E01003187","Total",678,626,52
"2011","Lambeth 008A","E01003089","Total",700,689,11
"2011","Lambeth 008B","E01003091","Total",680,668,12
"2011","Lambeth 008C","E01003092","Total",730,717,13
"2011","Lambeth 008D","E01003126","Total",653,645,8
"2011","Lambeth 008E","E01003128","Total",670,664,6
"2011","Lambeth 009A","E01003046","Total",752,743,9
"2011","Lambeth 009B","E01003048","Total",747,741,6
"2011","Lambeth 009C","E01003075","Total",701,685,16
"2011","Lambeth 009D","E01003182","Total",754,720,34
"2011","Lambeth 009E","E01003188","Total",564,554,10
"2011","Lambeth 010A","E01003088","Total",747,737,10
"2011","Lambeth 010B","E01003093","Total",957,949,8
"2011","Lambeth 010C","E01003094","Total",689,675,14
"2011","Lambeth 010D","E01003096","Total",970,926,44
"2011","Lambeth 010E","E01003127","Total",769,755,14
"2011","Lambeth 011A","E01003045","Total",743,728,15
"2011","Lambeth 011B","E01003047","Total",769,751,18
"2011","Lambeth 011C","E01003049","Total",681,668,13
"2011","Lambeth 011D","E01003059","Total",637,625,12
"2011","Lambeth 011E","E01003060","Total",649,632,17
"2011","Lambeth 011F","E01003061","Total",581,568,13
"2011","Lambeth 012A","E01003034","Total",736,723,13
"2011","Lambeth 012B","E01003035","Total",729,710,19
"2011","Lambeth 012C","E01003036","Total",755,737,18
"2011","Lambeth 012D","E01003090","Total",1060,1043,17
"2011","Lambeth 012E","E01003095","Total",771,760,11
"2011","Lambeth 013A","E01003037","Total",615,606,9
"2011","Lambeth 013B","E01003038","Total",718,689,29
"2011","Lambeth 013C","E01003039","Total",976,945,31
"2011","Lambeth 013D","E01003040","Total",620,594,26
"2011","Lambeth 013E","E01003042","Total",515,502,13
"2011","Lambeth 014A","E01003072","Total",796,769,27
"2011","Lambeth 014B","E01003073","Total",712,698,14
"2011","Lambeth 014C","E01003076","Total",888,836,52
"2011","Lambeth 014D","E01003077","Total",811,786,25
"2011","Lambeth 014E","E01003078","Total",643,634,9
"2011","Lambeth 015A","E01003019","Total",931,914,17
"2011","Lambeth 015B","E01003053","Total",793,757,36
"2011","Lambeth 015C","E01003054","Total",832,819,13
"2011","Lambeth 015D","E01003056","Total",841,838,3
"2011","Lambeth 015E","E01003058","Total",833,820,13
"2011","Lambeth 016A","E01003020","Total",790,771,19
"2011","Lambeth 016B","E01003050","Total",794,773,21
"2011","Lambeth 016C","E01003052","Total",775,758,17
"2011","Lambeth 016D","E01003055","Total",806,790,16
"2011","Lambeth 016E","E01003176","Total",787,780,7
"2011","Lambeth 017A","E01003029","Total",880,860,20
"2011","Lambeth 017B","E01003032","Total",770,759,11
"2011","Lambeth 017C","E01003041","Total",684,678,6
"2011","Lambeth 017D","E01003057","Total",738,724,14
"2011","Lambeth 018A","E01003043","Total",706,685,21
"2011","Lambeth 018B","E01003044","Total",612,606,6
"2011","Lambeth 018C","E01003051","Total",694,675,19
"2011","Lambeth 018D","E01003071","Total",1015,1004,11
"2011","Lambeth 018E","E01003074","Total",1122,1096,26
"2011","Lambeth 019A","E01003026","Total",664,656,8
"2011","Lambeth 019B","E01003027","Total",493,480,13
"2011","Lambeth 019C","E01003028","Total",578,563,15
"2011","Lambeth 019D","E01003030","Total",800,783,17
"2011","Lambeth 019E","E01003033","Total",611,594,17
"2011","Lambeth 020A","E01003018","Total",1022,999,23
"2011","Lambeth 020B","E01003171","Total",852,827,25
"2011","Lambeth 020C","E01003173","Total",713,694,19
"2011","Lambeth 020D","E01003177","Total",725,703,22
"2011","Lambeth 020E","E01003178","Total",728,712,16
"2011","Lambeth 021A","E01003021","Total",670,663,7
"2011","Lambeth 021B","E01003022","Total",795,770,25
"2011","Lambeth 021C","E01003023","Total",1091,1063,28
"2011","Lambeth 021D","E01003024","Total",780,766,14
"2011","Lambeth 021E","E01003025","Total",868,842,26
"2011","Lambeth 022A","E01003136","Total",743,735,8
"2011","Lambeth 022B","E01003137","Total",687,676,11
"2011","Lambeth 022C","E01003159","Total",608,599,9
"2011","Lambeth 022D","E01003160","Total",563,558,5
"2011","Lambeth 022E","E01003162","Total",844,830,14
"2011","Lambeth 023A","E01003031","Total",729,720,9
"2011","Lambeth 023B","E01003156","Total",675,665,10
"2011","Lambeth 023C","E01003157","Total",587,577,10
"2011","Lambeth 023D","E01003158","Total",745,737,8
"2011","Lambeth 023E","E01003161","Total",512,498,14
"2011","Lambeth 023F","E01003163","Total",597,588,9
"2011","Lambeth 024A","E01003132","Total",547,536,11
"2011","Lambeth 024B","E01003172","Total",828,815,13
"2011","Lambeth 024C","E01003174","Total",845,829,16
"2011","Lambeth 024D","E01003175","Total",612,608,4
"2011","Lambeth 024E","E01003179","Total",668,654,14
"2011","Lambeth 025A","E01003164","Total",960,935,25
"2011","Lambeth 025B","E01003165","Total",729,712,17
"2011","Lambeth 025C","E01003168","Total",649,647,2
"2011","Lambeth 025D","E01003169","Total",1084,1071,13
"2011","Lambeth 025E","E01003170","Total",814,797,17
"2011","Lambeth 026A","E01003130","Total",751,739,12
"2011","Lambeth 026B","E01003131","Total",630,617,13
"2011","Lambeth 026C","E01003135","Total",744,724,20
"2011","Lambeth 026D","E01003138","Total",703,689,14
"2011","Lambeth 026E","E01003151","Total",834,820,14
"2011","Lambeth 027A","E01003079","Total",774,757,17
"2011","Lambeth 027B","E01003080","Total",686,663,23
"2011","Lambeth 027C","E01003133","Total",779,765,14
"2011","Lambeth 027D","E01003134","Total",636,619,17
"2011","Lambeth 027E","E01003152","Total",808,761,47
"2011","Lambeth 028A","E01003064","Total",675,660,15
"2011","Lambeth 028B","E01003066","Total",760,741,19
"2011","Lambeth 028C","E01003081","Total",812,768,44
"2011","Lambeth 028D","E01003166","Total",1089,1020,69
"2011","Lambeth 028E","E01003167","Total",698,681,17
"2011","Lambeth 029A","E01003116","Total",644,634,10
"2011","Lambeth 029B","E01003117","Total",874,841,33
"2011","Lambeth 029C","E01003118","Total",715,688,27
"2011","Lambeth 029D","E01003153","Total",958,929,29
"2011","Lambeth 029E","E01003155","Total",773,750,23
"2011","Lambeth 030A","E01003083","Total",607,594,13
"2011","Lambeth 030B","E01003084","Total",695,673,22
"2011","Lambeth 030C","E01003085","Total",722,697,25
"2011","Lambeth 030D","E01003149","Total",730,694,36
"2011","Lambeth 030E","E01003154","Total",808,786,22
"2011","Lambeth 031A","E01003065","Total",679,666,13
"2011","Lambeth 031B","E01003068","Total",670,657,13
"2011","Lambeth 031C","E01003082","Total",671,651,20
"2011","Lambeth 031D","E01003086","Total",661,647,14
"2011","Lambeth 031E","E01003087","Total",621,611,10
"2011","Lambeth 032A","E01003113","Total",854,817,37
"2011","Lambeth 032B","E01003114","Total",795,765,30
"2011","Lambeth 032C","E01003119","Total",889,813,76
"2011","Lambeth 032D","E01003120","Total",1080,961,119
"2011","Lambeth 032E","E01003148","Total",845,762,83
"2011","Lambeth 032F","E01003150","Total",832,769,63
"2011","Lambeth 033A","E01003062","Total",828,795,33
"2011","Lambeth 033B","E01003063","Total",682,664,18
"2011","Lambeth 033C","E01003067","Total",617,599,18
"2011","Lambeth 033D","E01003069","Total",528,520,8
"2011","Lambeth 033E","E01003070","Total",663,655,8
"2011","Lambeth 034A","E01003115","Total",698,669,29
"2011","Lambeth 034B","E01003141","Total",744,723,21
"2011","Lambeth 034C","E01003144","Total",546,520,26
"2011","Lambeth 034D","E01003145","Total",840,783,57
"2011","Lambeth 034E","E01003147","Total",848,797,51
"2011","Lambeth 035A","E01003139","Total",559,542,17
"2011","Lambeth 035B","E01003140","Total",496,492,4
"2011","Lambeth 035C","E01003142","Total",462,453,9
"2011","Lambeth 035D","E01003143","Total",520,516,4
"2011","Lambeth 035E","E01003146","Total",541,524,17
"2011","Lambeth 036A","E01003013","Total",981,854,127
"2011","Lambeth 036B","E01003014","Total",710,678,32
"2011","Lambeth 036C","E01003016","Total",601,526,75
"2011","Lambeth 036D","E01003017","Total",905,862,43
"2011","Lambeth 036E","E01032582","Total",974,920,54
"2011","Lewisham 001A","E01003244","Total",633,618,15
"2011","Lewisham 001B","E01003245","Total",590,584,6
"2011","Lewisham 001C","E01003247","Total",716,685,31
"2011","Lewisham 001D","E01003249","Total",922,897,25
"2011","Lewisham 001E","E01003250","Total",773,763,10
"2011","Lewisham 002A","E01003246","Total",571,559,12
"2011","Lewisham 002B","E01003248","Total",727,718,9
"2011","Lewisham 002C","E01003251","Total",791,777,14
"2011","Lewisham 002D","E01003252","Total",619,613,6
"2011","Lewisham 002E","E01003253","Total",701,669,32
"2011","Lewisham 003A","E01003297","Total",786,767,19
"2011","Lewisham 003B","E01003299","Total",628,609,19
"2011","Lewisham 003C","E01003301","Total",780,767,13
"2011","Lewisham 003D","E01003302","Total",717,710,7
"2011","Lewisham 003E","E01003305","Total",544,513,31
"2011","Lewisham 005A","E01003207","Total",623,615,8
"2011","Lewisham 005B","E01003209","Total",780,778,2
"2011","Lewisham 005C","E01003210","Total",866,850,16
"2011","Lewisham 005D","E01003212","Total",880,867,13
"2011","Lewisham 005E","E01003215","Total",705,666,39
"2011","Lewisham 006A","E01003338","Total",789,771,18
"2011","Lewisham 006B","E01003339","Total",776,763,13
"2011","Lewisham 006C","E01003340","Total",835,797,38
"2011","Lewisham 006D","E01003341","Total",599,581,18
"2011","Lewisham 006E","E01003343","Total",636,626,10
"2011","Lewisham 007A","E01003199","Total",821,801,20
"2011","Lewisham 007B","E01003201","Total",699,680,19
"2011","Lewisham 007C","E01003204","Total",611,603,8
"2011","Lewisham 007D","E01003205","Total",514,502,12
"2011","Lewisham 007E","E01003206","Total",719,698,21
"2011","Lewisham 008B","E01003211","Total",773,753,20
"2011","Lewisham 008C","E01003213","Total",829,813,16
"2011","Lewisham 008D","E01003214","Total",756,745,11
"2011","Lewisham 008E","E01033324","Total",652,642,10
"2011","Lewisham 008F","E01033325","Total",731,706,25
"2011","Lewisham 009A","E01003198","Total",647,639,8
"2011","Lewisham 009B","E01003200","Total",782,756,26
"2011","Lewisham 009C","E01003202","Total",781,764,17
"2011","Lewisham 009D","E01003203","Total",997,980,17
"2011","Lewisham 010A","E01003336","Total",601,577,24
"2011","Lewisham 010B","E01003337","Total",608,600,8
"2011","Lewisham 010C","E01003342","Total",717,702,15
"2011","Lewisham 010D","E01003344","Total",731,719,12
"2011","Lewisham 010E","E01003345","Total",728,719,9
"2011","Lewisham 011A","E01003273","Total",677,666,11
"2011","Lewisham 011B","E01003277","Total",801,778,23
"2011","Lewisham 011C","E01003278","Total",819,805,14
"2011","Lewisham 011D","E01003279","Total",673,654,19
"2011","Lewisham 012A","E01003288","Total",811,794,17
"2011","Lewisham 012C","E01003290","Total",739,725,14
"2011","Lewisham 012D","E01003291","Total",695,682,13
"2011","Lewisham 012E","E01003296","Total",1081,1021,60
"2011","Lewisham 012F","E01033327","Total",716,679,37
"2011","Lewisham 012G","E01033341","Total",579,551,28
"2011","Lewisham 013A","E01003282","Total",1069,1047,22
"2011","Lewisham 013B","E01003283","Total",976,923,53
"2011","Lewisham 013C","E01003284","Total",764,748,16
"2011","Lewisham 013D","E01003286","Total",798,786,12
"2011","Lewisham 014A","E01003272","Total",823,798,25
"2011","Lewisham 014B","E01003274","Total",725,721,4
"2011","Lewisham 014C","E01003275","Total",644,640,4
"2011","Lewisham 014D","E01003276","Total",707,700,7
"2011","Lewisham 015A","E01003225","Total",604,590,14
"2011","Lewisham 015B","E01003231","Total",712,687,25
"2011","Lewisham 015C","E01003232","Total",658,649,9
"2011","Lewisham 015D","E01003233","Total",679,669,10
"2011","Lewisham 016A","E01003280","Total",665,651,14
"2011","Lewisham 016B","E01003281","Total",610,601,9
"2011","Lewisham 016C","E01003285","Total",787,767,20
"2011","Lewisham 016D","E01003287","Total",811,797,14
"2011","Lewisham 017A","E01003292","Total",713,702,11
"2011","Lewisham 017B","E01003293","Total",685,676,9
"2011","Lewisham 017D","E01003295","Total",661,653,8
"2011","Lewisham 017E","E01033320","Total",662,645,17
"2011","Lewisham 017F","E01033322","Total",598,594,4
"2011","Lewisham 018A","E01003319","Total",773,752,21
"2011","Lewisham 018B","E01003320","Total",654,650,4
"2011","Lewisham 018C","E01003323","Total",633,624,9
"2011","Lewisham 018D","E01003325","Total",736,722,14
"2011","Lewisham 019A","E01003226","Total",725,709,16
"2011","Lewisham 019B","E01003227","Total",689,678,11
"2011","Lewisham 019C","E01003228","Total",693,673,20
"2011","Lewisham 019D","E01003229","Total",768,742,26
"2011","Lewisham 019E","E01003230","Total",883,866,17
"2011","Lewisham 020A","E01003317","Total",699,688,11
"2011","Lewisham 020B","E01003318","Total",726,705,21
"2011","Lewisham 020C","E01003321","Total",825,810,15
"2011","Lewisham 020D","E01003322","Total",606,593,13
"2011","Lewisham 020E","E01003324","Total",726,713,13
"2011","Lewisham 021A","E01003254","Total",615,602,13
"2011","Lewisham 021B","E01003255","Total",989,964,25
"2011","Lewisham 021C","E01003260","Total",692,681,11
"2011","Lewisham 021D","E01003261","Total",625,619,6
"2011","Lewisham 021E","E01003262","Total",640,624,16
"2011","Lewisham 022A","E01003217","Total",631,622,9
"2011","Lewisham 022B","E01003218","Total",548,539,9
"2011","Lewisham 022C","E01003220","Total",613,604,9
"2011","Lewisham 022D","E01003222","Total",633,629,4
"2011","Lewisham 022E","E01003224","Total",629,626,3
"2011","Lewisham 023A","E01003263","Total",759,739,20
"2011","Lewisham 023B","E01003268","Total",744,718,26
"2011","Lewisham 023C","E01003269","Total",659,647,12
"2011","Lewisham 023D","E01003270","Total",690,678,12
"2011","Lewisham 023E","E01003271","Total",649,637,12
"2011","Lewisham 024A","E01003307","Total",649,627,22
"2011","Lewisham 024B","E01003308","Total",747,734,13
"2011","Lewisham 024C","E01003314","Total",705,683,22
"2011","Lewisham 024D","E01003315","Total",622,599,23
"2011","Lewisham 024E","E01003316","Total",618,609,9
"2011","Lewisham 025A","E01003216","Total",700,689,11
"2011","Lewisham 025B","E01003219","Total",641,631,10
"2011","Lewisham 025C","E01003221","Total",788,769,19
"2011","Lewisham 025D","E01003223","Total",618,603,15
"2011","Lewisham 026A","E01003346","Total",612,598,14
"2011","Lewisham 026B","E01003349","Total",548,541,7
"2011","Lewisham 026C","E01003351","Total",610,592,18
"2011","Lewisham 026D","E01003354","Total",721,701,20
"2011","Lewisham 027A","E01003309","Total",652,645,7
"2011","Lewisham 027B","E01003310","Total",772,756,16
"2011","Lewisham 027C","E01003311","Total",618,605,13
"2011","Lewisham 027D","E01003312","Total",792,779,13
"2011","Lewisham 027E","E01003313","Total",683,670,13
"2011","Lewisham 028A","E01003256","Total",956,931,25
"2011","Lewisham 028B","E01003257","Total",754,735,19
"2011","Lewisham 028C","E01003258","Total",614,594,20
"2011","Lewisham 028D","E01003259","Total",776,756,20
"2011","Lewisham 029A","E01003193","Total",678,666,12
"2011","Lewisham 029B","E01003194","Total",727,716,11
"2011","Lewisham 029C","E01003195","Total",644,637,7
"2011","Lewisham 029D","E01003196","Total",626,624,2
"2011","Lewisham 029E","E01003197","Total",628,625,3
"2011","Lewisham 030A","E01003347","Total",653,638,15
"2011","Lewisham 030B","E01003348","Total",581,571,10
"2011","Lewisham 030C","E01003350","Total",531,519,12
"2011","Lewisham 030D","E01003352","Total",747,735,12
"2011","Lewisham 030E","E01003353","Total",643,632,11
"2011","Lewisham 031A","E01003264","Total",753,728,25
"2011","Lewisham 031B","E01003265","Total",695,680,15
"2011","Lewisham 031C","E01003266","Total",771,757,14
"2011","Lewisham 031D","E01003267","Total",605,598,7
"2011","Lewisham 033A","E01003329","Total",685,666,19
"2011","Lewisham 033B","E01003330","Total",679,662,17
"2011","Lewisham 033C","E01003331","Total",586,572,14
"2011","Lewisham 033D","E01003332","Total",693,679,14
"2011","Lewisham 033E","E01003334","Total",802,778,24
"2011","Lewisham 034A","E01003189","Total",628,624,4
"2011","Lewisham 034B","E01003190","Total",822,809,13
"2011","Lewisham 034C","E01003191","Total",676,665,11
"2011","Lewisham 034D","E01003192","Total",749,741,8
"2011","Lewisham 035A","E01003326","Total",651,638,13
"2011","Lewisham 035B","E01003327","Total",735,714,21
"2011","Lewisham 035C","E01003328","Total",863,833,30
"2011","Lewisham 035D","E01003333","Total",670,657,13
"2011","Lewisham 035E","E01003335","Total",607,594,13
"2011","Lewisham 037A","E01003236","Total",661,648,13
"2011","Lewisham 037B","E01003237","Total",618,608,10
"2011","Lewisham 037C","E01003238","Total",578,565,13
"2011","Lewisham 037D","E01003239","Total",568,564,4
"2011","Lewisham 037E","E01032564","Total",510,508,2
"2011","Lewisham 038A","E01003235","Total",528,523,5
"2011","Lewisham 038B","E01003240","Total",739,725,14
"2011","Lewisham 038C","E01003241","Total",706,695,11
"2011","Lewisham 038D","E01003243","Total",592,581,11
"2011","Lewisham 038E","E01032565","Total",651,644,7
"2011","Lewisham 039A","E01003298","Total",479,475,4
"2011","Lewisham 039B","E01003300","Total",569,561,8
"2011","Lewisham 039C","E01003303","Total",575,560,15
"2011","Lewisham 039D","E01003304","Total",921,903,18
"2011","Lewisham 039E","E01032579","Total",720,711,9
"2011","Newham 001A","E01003543","Total",867,850,17
"2011","Newham 001B","E01003544","Total",670,664,6
"2011","Newham 001C","E01003546","Total",592,588,4
"2011","Newham 001D","E01003550","Total",648,631,17
"2011","Newham 002A","E01003576","Total",720,710,10
"2011","Newham 002B","E01003581","Total",496,486,10
"2011","Newham 002C","E01003582","Total",500,499,1
"2011","Newham 002D","E01003583","Total",541,539,2
"2011","Newham 003A","E01003578","Total",616,601,15
"2011","Newham 003B","E01003584","Total",649,638,11
"2011","Newham 003C","E01003586","Total",520,509,11
"2011","Newham 003D","E01003590","Total",596,572,24
"2011","Newham 004A","E01003579","Total",505,499,6
"2011","Newham 004B","E01003585","Total",410,407,3
"2011","Newham 004C","E01003587","Total",835,823,12
"2011","Newham 004D","E01003591","Total",684,671,13
"2011","Newham 005A","E01003528","Total",436,431,5
"2011","Newham 005B","E01003575","Total",497,491,6
"2011","Newham 005C","E01003577","Total",679,673,6
"2011","Newham 005D","E01003580","Total",626,615,11
"2011","Newham 006A","E01003545","Total",650,644,6
"2011","Newham 006B","E01003548","Total",896,852,44
"2011","Newham 006C","E01003549","Total",808,790,18
"2011","Newham 006D","E01003557","Total",672,651,21
"2011","Newham 007A","E01003547","Total",709,699,10
"2011","Newham 007B","E01003555","Total",507,500,7
"2011","Newham 007C","E01003561","Total",483,481,2
"2011","Newham 007D","E01003567","Total",547,540,7
"2011","Newham 008A","E01003556","Total",645,629,16
"2011","Newham 008B","E01003558","Total",503,491,12
"2011","Newham 008C","E01003570","Total",591,585,6
"2011","Newham 008D","E01003571","Total",591,586,5
"2011","Newham 008E","E01003572","Total",461,446,15
"2011","Newham 009A","E01003551","Total",603,586,17
"2011","Newham 009B","E01003553","Total",750,733,17
"2011","Newham 009C","E01003554","Total",644,623,21
"2011","Newham 009D","E01003559","Total",1022,1001,21
"2011","Newham 010A","E01003529","Total",610,597,13
"2011","Newham 010B","E01003530","Total",470,468,2
"2011","Newham 010C","E01003531","Total",529,516,13
"2011","Newham 010D","E01003532","Total",523,513,10
"2011","Newham 010E","E01003534","Total",655,643,12
"2011","Newham 011A","E01003533","Total",488,482,6
"2011","Newham 011B","E01003560","Total",451,448,3
"2011","Newham 011C","E01003563","Total",553,538,15
"2011","Newham 011D","E01003588","Total",457,454,3
"2011","Newham 011E","E01003589","Total",524,512,12
"2011","Newham 012A","E01003616","Total",669,658,11
"2011","Newham 012B","E01003617","Total",1123,1103,20
"2011","Newham 012C","E01003618","Total",843,823,20
"2011","Newham 012D","E01003619","Total",1103,1087,16
"2011","Newham 013C","E01003615","Total",655,643,12
"2011","Newham 013E","E01033578","Total",665,603,62
"2011","Newham 013F","E01033579","Total",635,618,17
"2011","Newham 013G","E01033583","Total",1274,1205,69
"2011","Newham 013H","E01033586","Total",600,597,3
"2011","Newham 014A","E01003562","Total",580,576,4
"2011","Newham 014B","E01003564","Total",679,672,7
"2011","Newham 014C","E01003565","Total",505,496,9
"2011","Newham 014D","E01003566","Total",529,507,22
"2011","Newham 015A","E01003625","Total",496,484,12
"2011","Newham 015B","E01003626","Total",432,420,12
"2011","Newham 015C","E01003627","Total",436,432,4
"2011","Newham 015D","E01003628","Total",424,420,4
"2011","Newham 015E","E01003629","Total",486,481,5
"2011","Newham 016A","E01003552","Total",552,544,8
"2011","Newham 016B","E01003596","Total",581,577,4
"2011","Newham 016C","E01003597","Total",483,475,8
"2011","Newham 016D","E01003635","Total",631,611,20
"2011","Newham 017A","E01003568","Total",613,594,19
"2011","Newham 017B","E01003569","Total",531,509,22
"2011","Newham 017C","E01003573","Total",552,542,10
"2011","Newham 017D","E01003574","Total",822,798,24
"2011","Newham 018A","E01003520","Total",587,583,4
"2011","Newham 018B","E01003521","Total",630,623,7
"2011","Newham 018C","E01003522","Total",559,550,9
"2011","Newham 018D","E01003525","Total",527,519,8
"2011","Newham 018E","E01003526","Total",554,550,4
"2011","Newham 019A","E01003488","Total",674,669,5
"2011","Newham 019B","E01003489","Total",523,520,3
"2011","Newham 019C","E01003490","Total",544,539,5
"2011","Newham 019D","E01003524","Total",606,598,8
"2011","Newham 020A","E01003631","Total",742,727,15
"2011","Newham 020B","E01003632","Total",770,749,21
"2011","Newham 020C","E01003633","Total",700,685,15
"2011","Newham 020D","E01003634","Total",608,602,6
"2011","Newham 020E","E01003636","Total",715,702,13
"2011","Newham 021A","E01003598","Total",662,658,4
"2011","Newham 021B","E01003600","Total",698,690,8
"2011","Newham 021C","E01003630","Total",751,731,20
"2011","Newham 021D","E01003637","Total",603,593,10
"2011","Newham 022A","E01003491","Total",646,637,9
"2011","Newham 022B","E01003592","Total",566,555,11
"2011","Newham 022C","E01003599","Total",498,488,10
"2011","Newham 022D","E01003606","Total",688,675,13
"2011","Newham 023A","E01003535","Total",565,548,17
"2011","Newham 023B","E01003536","Total",606,598,8
"2011","Newham 023C","E01003621","Total",449,442,7
"2011","Newham 023D","E01003622","Total",511,496,15
"2011","Newham 023E","E01003623","Total",493,490,3
"2011","Newham 024A","E01003523","Total",673,669,4
"2011","Newham 024B","E01003527","Total",581,570,11
"2011","Newham 024C","E01003537","Total",678,668,10
"2011","Newham 024D","E01003542","Total",676,668,8
"2011","Newham 024E","E01003624","Total",495,493,2
"2011","Newham 025A","E01003492","Total",540,536,4
"2011","Newham 025B","E01003493","Total",735,732,3
"2011","Newham 025C","E01003494","Total",653,645,8
"2011","Newham 025D","E01003495","Total",653,650,3
"2011","Newham 026A","E01003594","Total",559,540,19
"2011","Newham 026B","E01003595","Total",592,581,11
"2011","Newham 026C","E01003602","Total",624,605,19
"2011","Newham 026D","E01003607","Total",594,560,34
"2011","Newham 027A","E01003496","Total",596,591,5
"2011","Newham 027B","E01003498","Total",677,674,3
"2011","Newham 027C","E01003500","Total",740,732,8
"2011","Newham 027D","E01003593","Total",567,559,8
"2011","Newham 028A","E01003601","Total",723,705,18
"2011","Newham 028B","E01003603","Total",633,624,9
"2011","Newham 028C","E01003605","Total",750,724,26
"2011","Newham 028D","E01003608","Total",725,714,11
"2011","Newham 029A","E01003538","Total",666,652,14
"2011","Newham 029B","E01003539","Total",707,681,26
"2011","Newham 029C","E01003540","Total",606,595,11
"2011","Newham 029D","E01003541","Total",592,570,22
"2011","Newham 030A","E01003499","Total",869,862,7
"2011","Newham 030B","E01003501","Total",727,715,12
"2011","Newham 030C","E01003502","Total",682,669,13
"2011","Newham 030D","E01003503","Total",653,647,6
"2011","Newham 031A","E01003507","Total",831,807,24
"2011","Newham 031B","E01003508","Total",560,555,5
"2011","Newham 031C","E01003509","Total",799,795,4
"2011","Newham 031D","E01003604","Total",795,785,10
"2011","Newham 032A","E01003483","Total",514,492,22
"2011","Newham 032B","E01003484","Total",582,566,16
"2011","Newham 032C","E01003516","Total",660,652,8
"2011","Newham 032D","E01003518","Total",593,588,5
"2011","Newham 032E","E01003519","Total",486,484,2
"2011","Newham 033A","E01003480","Total",691,662,29
"2011","Newham 033B","E01003482","Total",1073,1033,40
"2011","Newham 033C","E01003486","Total",458,455,3
"2011","Newham 033D","E01003487","Total",433,424,9
"2011","Newham 034A","E01003497","Total",625,622,3
"2011","Newham 034D","E01003506","Total",495,489,6
"2011","Newham 034F","E01033574","Total",627,579,48
"2011","Newham 034G","E01033575","Total",578,545,33
"2011","Newham 034H","E01033576","Total",651,618,33
"2011","Newham 034I","E01033584","Total",568,564,4
"2011","Newham 034J","E01033585","Total",1008,954,54
"2011","Newham 035A","E01003479","Total",629,612,17
"2011","Newham 035B","E01003481","Total",509,500,9
"2011","Newham 035C","E01003485","Total",579,560,19
"2011","Newham 035D","E01003513","Total",567,558,9
"2011","Newham 036A","E01003511","Total",452,452,0
"2011","Newham 036B","E01003512","Total",689,678,11
"2011","Newham 036C","E01003514","Total",537,532,5
"2011","Newham 036D","E01003515","Total",761,755,6
"2011","Newham 036E","E01003517","Total",616,605,11
"2011","Newham 037A","E01003609","Total",1078,1058,20
"2011","Newham 037C","E01003611","Total",709,700,9
"2011","Newham 037E","E01033577","Total",626,608,18
"2011","Newham 037F","E01033580","Total",683,659,24
"2011","Newham 037G","E01033581","Total",724,714,10
"2011","Newham 037H","E01033582","Total",662,631,31
"2011","Southwark 001A","E01004029","Total",851,819,32
"2011","Southwark 001B","E01004032","Total",739,714,25
"2011","Southwark 001C","E01004053","Total",925,877,48
"2011","Southwark 001D","E01004054","Total",806,782,24
"2011","Southwark 001E","E01004055","Total",518,513,5
"2011","Southwark 002A","E01003927","Total",1032,995,37
"2011","Southwark 002B","E01003929","Total",1130,1074,56
"2011","Southwark 002C","E01003934","Total",900,811,89
"2011","Southwark 002D","E01003935","Total",480,451,29
"2011","Southwark 002E","E01003939","Total",872,836,36
"2011","Southwark 003A","E01003976","Total",968,916,52
"2011","Southwark 003E","E01004027","Total",1044,993,51
"2011","Southwark 003F","E01032637","Total",725,641,84
"2011","Southwark 003G","E01032638","Total",757,653,104
"2011","Southwark 003H","E01032640","Total",801,672,129
"2011","Southwark 003I","E01032646","Total",880,737,143
"2011","Southwark 003J","E01032803","Total",687,658,29
"2011","Southwark 003K","E01032834","Total",807,666,141
"2011","Southwark 004A","E01003975","Total",697,667,30
"2011","Southwark 004B","E01003978","Total",961,908,53
"2011","Southwark 004C","E01004022","Total",1177,1146,31
"2011","Southwark 004D","E01004023","Total",715,703,12
"2011","Southwark 004E","E01004028","Total",726,713,13
"2011","Southwark 006A","E01003938","Total",804,790,14
"2011","Southwark 006B","E01003940","Total",627,620,7
"2011","Southwark 006C","E01003941","Total",952,912,40
"2011","Southwark 006D","E01003942","Total",570,561,9
"2011","Southwark 006E","E01003979","Total",837,809,28
"2011","Southwark 006F","E01003981","Total",706,693,13
"2011","Southwark 007A","E01004030","Total",754,726,28
"2011","Southwark 007B","E01004031","Total",916,880,36
"2011","Southwark 007C","E01004033","Total",731,699,32
"2011","Southwark 007D","E01004034","Total",647,635,12
"2011","Southwark 007E","E01004036","Total",815,806,9
"2011","Southwark 008A","E01004056","Total",939,906,33
"2011","Southwark 008B","E01004057","Total",681,668,13
"2011","Southwark 008C","E01004058","Total",924,855,69
"2011","Southwark 008D","E01004059","Total",694,662,32
"2011","Southwark 008E","E01004060","Total",811,785,26
"2011","Southwark 009A","E01003936","Total",577,552,25
"2011","Southwark 009B","E01003937","Total",769,734,35
"2011","Southwark 009C","E01003943","Total",560,549,11
"2011","Southwark 009F","E01032720","Total",708,681,27
"2011","Southwark 010A","E01003977","Total",846,800,46
"2011","Southwark 010B","E01004037","Total",900,878,22
"2011","Southwark 010C","E01004038","Total",929,920,9
"2011","Southwark 010D","E01004042","Total",773,762,11
"2011","Southwark 010E","E01004043","Total",606,599,7
"2011","Southwark 011A","E01003986","Total",557,549,8
"2011","Southwark 011B","E01003987","Total",758,754,4
"2011","Southwark 011C","E01004024","Total",833,819,14
"2011","Southwark 011D","E01004035","Total",720,687,33
"2011","Southwark 012A","E01003960","Total",785,766,19
"2011","Southwark 012B","E01003961","Total",909,897,12
"2011","Southwark 012E","E01003994","Total",658,622,36
"2011","Southwark 012F","E01032722","Total",942,932,10
"2011","Southwark 013A","E01003980","Total",860,847,13
"2011","Southwark 013B","E01004039","Total",644,633,11
"2011","Southwark 013C","E01004040","Total",686,680,6
"2011","Southwark 013D","E01004041","Total",711,699,12
"2011","Southwark 013E","E01004044","Total",559,556,3
"2011","Southwark 014A","E01003992","Total",601,590,11
"2011","Southwark 014B","E01003995","Total",745,738,7
"2011","Southwark 014D","E01003998","Total",660,632,28
"2011","Southwark 014E","E01003999","Total",614,602,12
"2011","Southwark 014F","E01032639","Total",755,688,67
"2011","Southwark 014G","E01032719","Total",679,623,56
"2011","Southwark 015A","E01003964","Total",745,730,15
"2011","Southwark 015B","E01003966","Total",754,745,9
"2011","Southwark 015C","E01003968","Total",527,525,2
"2011","Southwark 015D","E01003971","Total",611,608,3
"2011","Southwark 015E","E01003974","Total",490,489,1
"2011","Southwark 016A","E01003963","Total",672,662,10
"2011","Southwark 016B","E01003967","Total",617,600,17
"2011","Southwark 016C","E01003970","Total",591,579,12
"2011","Southwark 016D","E01003972","Total",725,714,11
"2011","Southwark 016E","E01003973","Total",744,739,5
"2011","Southwark 017A","E01003923","Total",740,730,10
"2011","Southwark 017B","E01003969","Total",792,764,28
"2011","Southwark 017C","E01003991","Total",561,559,2
"2011","Southwark 017D","E01003993","Total",724,630,94
"2011","Southwark 017E","E01003997","Total",484,472,12
"2011","Southwark 018A","E01003983","Total",733,730,3
"2011","Southwark 018B","E01003988","Total",910,898,12
"2011","Southwark 018C","E01003989","Total",725,720,5
"2011","Southwark 018D","E01003990","Total",778,769,9
"2011","Southwark 018E","E01004007","Total",438,436,2
"2011","Southwark 019A","E01003912","Total",575,571,4
"2011","Southwark 019B","E01004011","Total",731,724,7
"2011","Southwark 019C","E01004012","Total",949,934,15
"2011","Southwark 019D","E01004013","Total",609,606,3
"2011","Southwark 019E","E01004014","Total",719,710,9
"2011","Southwark 020A","E01003911","Total",752,742,10
"2011","Southwark 020B","E01003916","Total",840,830,10
"2011","Southwark 020C","E01003917","Total",799,787,12
"2011","Southwark 020D","E01003918","Total",653,653,0
"2011","Southwark 020E","E01003925","Total",528,527,1
"2011","Southwark 021A","E01003919","Total",707,702,5
"2011","Southwark 021B","E01003920","Total",770,766,4
"2011","Southwark 021C","E01003921","Total",685,673,12
"2011","Southwark 021D","E01003922","Total",825,821,4
"2011","Southwark 021E","E01003924","Total",814,802,12
"2011","Southwark 021F","E01003926","Total",542,540,2
"2011","Southwark 022B","E01004008","Total",812,808,4
"2011","Southwark 022D","E01004010","Total",608,601,7
"2011","Southwark 022E","E01004067","Total",847,831,16
"2011","Southwark 022F","E01032805","Total",955,940,15
"2011","Southwark 023A","E01003984","Total",866,856,10
"2011","Southwark 023B","E01004003","Total",762,755,7
"2011","Southwark 023C","E01004004","Total",1079,1069,10
"2011","Southwark 023D","E01004005","Total",891,882,9
"2011","Southwark 023E","E01004006","Total",785,772,13
"2011","Southwark 024A","E01003913","Total",837,800,37
"2011","Southwark 024B","E01003914","Total",741,722,19
"2011","Southwark 024C","E01003915","Total",821,811,10
"2011","Southwark 024D","E01004050","Total",670,652,18
"2011","Southwark 024E","E01004052","Total",811,798,13
"2011","Southwark 025A","E01004061","Total",803,772,31
"2011","Southwark 025B","E01004062","Total",854,830,24
"2011","Southwark 025C","E01004063","Total",876,847,29
"2011","Southwark 025D","E01004065","Total",643,625,18
"2011","Southwark 025E","E01004066","Total",867,844,23
"2011","Southwark 026A","E01004000","Total",855,839,16
"2011","Southwark 026B","E01004001","Total",725,718,7
"2011","Southwark 026C","E01004019","Total",924,912,12
"2011","Southwark 026D","E01004064","Total",817,808,9
"2011","Southwark 026E","E01004068","Total",836,829,7
"2011","Southwark 027A","E01004045","Total",619,601,18
"2011","Southwark 027B","E01004047","Total",610,607,3
"2011","Southwark 027C","E01004048","Total",649,645,4
"2011","Southwark 027D","E01004049","Total",528,507,21
"2011","Southwark 027E","E01004051","Total",630,613,17
"2011","Southwark 028A","E01003953","Total",1038,980,58
"2011","Southwark 028B","E01003955","Total",849,822,27
"2011","Southwark 028C","E01004015","Total",711,690,21
"2011","Southwark 028D","E01004021","Total",1064,1032,32
"2011","Southwark 028E","E01004046","Total",696,674,22
"2011","Southwark 029A","E01004002","Total",651,639,12
"2011","Southwark 029B","E01004016","Total",951,934,17
"2011","Southwark 029C","E01004017","Total",640,627,13
"2011","Southwark 029D","E01004020","Total",749,730,19
"2011","Southwark 030A","E01003952","Total",737,692,45
"2011","Southwark 030B","E01003954","Total",689,670,19
"2011","Southwark 030C","E01003956","Total",748,720,28
"2011","Southwark 030D","E01004071","Total",681,663,18
"2011","Southwark 030E","E01004072","Total",640,617,23
"2011","Southwark 031A","E01004069","Total",518,497,21
"2011","Southwark 031B","E01004070","Total",810,779,31
"2011","Southwark 031C","E01004073","Total",753,736,17
"2011","Southwark 031D","E01004074","Total",657,631,26
"2011","Southwark 031E","E01004075","Total",674,657,17
"2011","Southwark 032A","E01003949","Total",894,871,23
"2011","Southwark 032B","E01003950","Total",807,798,9
"2011","Southwark 032C","E01003957","Total",722,714,8
"2011","Southwark 032D","E01003958","Total",720,699,21
"2011","Southwark 032E","E01004018","Total",796,780,16
"2011","Southwark 033A","E01003945","Total",744,730,14
"2011","Southwark 033B","E01003946","Total",738,726,12
"2011","Southwark 033C","E01003947","Total",623,612,11
"2011","Southwark 033D","E01003948","Total",767,742,25
"2011","Southwark 033E","E01003951","Total",584,571,13
"2011","Southwark 034A","E01003930","Total",477,458,19
"2011","Southwark 034B","E01003932","Total",690,651,39
"2011","Southwark 034C","E01003933","Total",554,537,17
"2011","Southwark 034D","E01032583","Total",664,644,20
"2011","Southwark 034E","E01032584","Total",601,577,24
"2011","Tower Hamlets 001A","E01004222","Total",1067,1048,19
"2011","Tower Hamlets 001B","E01004223","Total",949,938,11
"2011","Tower Hamlets 001C","E01004224","Total",829,806,23
"2011","Tower Hamlets 001D","E01004226","Total",685,676,9
"2011","Tower Hamlets 002A","E01004197","Total",980,964,16
"2011","Tower Hamlets 002B","E01004198","Total",614,606,8
"2011","Tower Hamlets 002C","E01004199","Total",578,574,4
"2011","Tower Hamlets 002D","E01004201","Total",627,619,8
"2011","Tower Hamlets 003A","E01004228","Total",784,769,15
"2011","Tower Hamlets 003B","E01004230","Total",812,803,9
"2011","Tower Hamlets 003C","E01004232","Total",628,603,25
"2011","Tower Hamlets 003D","E01004233","Total",766,751,15
"2011","Tower Hamlets 003E","E01004234","Total",921,903,18
"2011","Tower Hamlets 004A","E01004225","Total",1194,1147,47
"2011","Tower Hamlets 004C","E01004229","Total",567,551,16
"2011","Tower Hamlets 004D","E01004231","Total",649,629,20
"2011","Tower Hamlets 004E","E01032764","Total",766,643,123
"2011","Tower Hamlets 004F","E01032765","Total",702,645,57
"2011","Tower Hamlets 004G","E01032784","Total",709,692,17
"2011","Tower Hamlets 005A","E01004200","Total",592,585,7
"2011","Tower Hamlets 005B","E01004202","Total",722,713,9
"2011","Tower Hamlets 005C","E01004203","Total",703,689,14
"2011","Tower Hamlets 005D","E01004204","Total",634,631,3
"2011","Tower Hamlets 006A","E01004311","Total",655,644,11
"2011","Tower Hamlets 006B","E01004314","Total",507,493,14
"2011","Tower Hamlets 006C","E01004315","Total",730,718,12
"2011","Tower Hamlets 006D","E01004318","Total",652,630,22
"2011","Tower Hamlets 007A","E01004259","Total",823,812,11
"2011","Tower Hamlets 007B","E01004260","Total",642,636,6
"2011","Tower Hamlets 007C","E01004263","Total",538,529,9
"2011","Tower Hamlets 007D","E01004266","Total",589,583,6
"2011","Tower Hamlets 008A","E01004235","Total",521,513,8
"2011","Tower Hamlets 008B","E01004236","Total",500,497,3
"2011","Tower Hamlets 008C","E01004237","Total",538,506,32
"2011","Tower Hamlets 008D","E01004238","Total",1079,1058,21
"2011","Tower Hamlets 008E","E01004239","Total",535,533,2
"2011","Tower Hamlets 009A","E01004312","Total",630,628,2
"2011","Tower Hamlets 009B","E01004313","Total",822,812,10
"2011","Tower Hamlets 009C","E01004316","Total",461,455,6
"2011","Tower Hamlets 009D","E01004317","Total",1239,1193,46
"2011","Tower Hamlets 010A","E01004261","Total",570,550,20
"2011","Tower Hamlets 010B","E01004262","Total",500,495,5
"2011","Tower Hamlets 010C","E01004264","Total",463,457,6
"2011","Tower Hamlets 010E","E01032785","Total",626,616,10
"2011","Tower Hamlets 010F","E01032786","Total",680,674,6
"2011","Tower Hamlets 011A","E01004207","Total",528,515,13
"2011","Tower Hamlets 011B","E01004209","Total",476,466,10
"2011","Tower Hamlets 011D","E01004212","Total",776,720,56
"2011","Tower Hamlets 011F","E01032787","Total",804,793,11
"2011","Tower Hamlets 012A","E01004240","Total",579,574,5
"2011","Tower Hamlets 012B","E01004241","Total",577,570,7
"2011","Tower Hamlets 012C","E01004242","Total",928,898,30
"2011","Tower Hamlets 012D","E01004267","Total",743,707,36
"2011","Tower Hamlets 012E","E01004268","Total",695,688,7
"2011","Tower Hamlets 013A","E01004205","Total",706,688,18
"2011","Tower Hamlets 013B","E01004206","Total",581,554,27
"2011","Tower Hamlets 013C","E01004208","Total",809,788,21
"2011","Tower Hamlets 013D","E01004211","Total",737,720,17
"2011","Tower Hamlets 014A","E01004269","Total",741,726,15
"2011","Tower Hamlets 014B","E01004270","Total",763,745,18
"2011","Tower Hamlets 014C","E01004271","Total",553,548,5
"2011","Tower Hamlets 014D","E01004272","Total",641,639,2
"2011","Tower Hamlets 014E","E01004273","Total",720,594,126
"2011","Tower Hamlets 015A","E01004306","Total",710,687,23
"2011","Tower Hamlets 015B","E01004307","Total",1163,1014,149
"2011","Tower Hamlets 015C","E01004308","Total",513,504,9
"2011","Tower Hamlets 015D","E01004309","Total",917,902,15
"2011","Tower Hamlets 015E","E01004310","Total",820,793,27
"2011","Tower Hamlets 016A","E01004283","Total",776,756,20
"2011","Tower Hamlets 016B","E01004287","Total",858,854,4
"2011","Tower Hamlets 016C","E01004289","Total",683,670,13
"2011","Tower Hamlets 016D","E01004290","Total",593,575,18
"2011","Tower Hamlets 017A","E01004322","Total",511,502,9
"2011","Tower Hamlets 017B","E01004323","Total",493,480,13
"2011","Tower Hamlets 017C","E01004324","Total",504,485,19
"2011","Tower Hamlets 017D","E01004326","Total",636,623,13
"2011","Tower Hamlets 018A","E01004245","Total",501,433,68
"2011","Tower Hamlets 018B","E01004246","Total",769,747,22
"2011","Tower Hamlets 018C","E01004248","Total",444,441,3
"2011","Tower Hamlets 018D","E01004249","Total",773,758,15
"2011","Tower Hamlets 019A","E01004284","Total",896,884,12
"2011","Tower Hamlets 019B","E01004285","Total",667,658,9
"2011","Tower Hamlets 019C","E01004286","Total",829,817,12
"2011","Tower Hamlets 019D","E01004288","Total",541,525,16
"2011","Tower Hamlets 020A","E01004243","Total",627,614,13
"2011","Tower Hamlets 020B","E01004244","Total",689,686,3
"2011","Tower Hamlets 020C","E01004247","Total",741,714,27
"2011","Tower Hamlets 020D","E01004250","Total",878,866,12
"2011","Tower Hamlets 021A","E01004319","Total",611,595,16
"2011","Tower Hamlets 021C","E01004321","Total",736,711,25
"2011","Tower Hamlets 021D","E01004325","Total",1105,1033,72
"2011","Tower Hamlets 021E","E01032766","Total",633,601,32
"2011","Tower Hamlets 021F","E01032767","Total",849,767,82
"2011","Tower Hamlets 022A","E01004298","Total",650,635,15
"2011","Tower Hamlets 022B","E01004300","Total",533,522,11
"2011","Tower Hamlets 022C","E01004304","Total",671,653,18
"2011","Tower Hamlets 022D","E01004305","Total",720,699,21
"2011","Tower Hamlets 023A","E01004251","Total",792,779,13
"2011","Tower Hamlets 023B","E01004254","Total",1184,1046,138
"2011","Tower Hamlets 023C","E01004255","Total",662,647,15
"2011","Tower Hamlets 023D","E01004258","Total",743,713,30
"2011","Tower Hamlets 024A","E01004252","Total",1130,1107,23
"2011","Tower Hamlets 024B","E01004253","Total",841,829,12
"2011","Tower Hamlets 024C","E01004256","Total",619,611,8
"2011","Tower Hamlets 024D","E01004257","Total",628,618,10
"2011","Tower Hamlets 025B","E01004301","Total",426,413,13
"2011","Tower Hamlets 025C","E01004302","Total",654,637,17
"2011","Tower Hamlets 025D","E01004303","Total",1025,967,58
"2011","Tower Hamlets 025E","E01032768","Total",754,696,58
"2011","Tower Hamlets 025F","E01032769","Total",642,593,49
"2011","Tower Hamlets 026A","E01004292","Total",863,818,45
"2011","Tower Hamlets 026B","E01004294","Total",929,877,52
"2011","Tower Hamlets 026C","E01004295","Total",514,500,14
"2011","Tower Hamlets 026D","E01004296","Total",711,684,27
"2011","Tower Hamlets 027A","E01004291","Total",1134,1051,83
"2011","Tower Hamlets 027B","E01004293","Total",1284,1133,151
"2011","Tower Hamlets 027C","E01004297","Total",1002,909,93
"2011","Tower Hamlets 028A","E01004215","Total",1472,1168,304
"2011","Tower Hamlets 028B","E01004219","Total",887,851,36
"2011","Tower Hamlets 028D","E01004221","Total",825,802,23
"2011","Tower Hamlets 028E","E01032776","Total",703,631,72
"2011","Tower Hamlets 028F","E01032777","Total",530,514,16
"2011","Tower Hamlets 028G","E01032778","Total",603,564,39
"2011","Tower Hamlets 028H","E01032779","Total",631,565,66
"2011","Tower Hamlets 028I","E01032780","Total",706,647,59
"2011","Tower Hamlets 030A","E01004214","Total",680,665,15
"2011","Tower Hamlets 030B","E01004216","Total",761,737,24
"2011","Tower Hamlets 030C","E01004217","Total",823,779,44
"2011","Tower Hamlets 030D","E01004218","Total",768,731,37
"2011","Tower Hamlets 031A","E01004274","Total",667,654,13
"2011","Tower Hamlets 031B","E01004275","Total",799,768,31
"2011","Tower Hamlets 031C","E01004276","Total",1087,996,91
"2011","Tower Hamlets 031D","E01004281","Total",881,831,50
"2011","Tower Hamlets 031F","E01032775","Total",641,600,41
"2011","Tower Hamlets 031G","E01032783","Total",678,661,17
"2011","Tower Hamlets 032A","E01004280","Total",806,769,37
"2011","Tower Hamlets 032B","E01032770","Total",728,572,156
"2011","Tower Hamlets 032C","E01032772","Total",628,544,84
"2011","Tower Hamlets 032D","E01032773","Total",1047,852,195
"2011","Tower Hamlets 032E","E01032774","Total",652,583,69
"2011","Tower Hamlets 033A","E01004277","Total",1051,898,153
"2011","Tower Hamlets 033B","E01032771","Total",704,546,158
"2011","Tower Hamlets 033C","E01032781","Total",825,771,54
"2011","Tower Hamlets 033D","E01032782","Total",841,776,65
"2011","Wandsworth 001A","E01004560","Total",1034,959,75
"2011","Wandsworth 001B","E01004566","Total",866,821,45
"2011","Wandsworth 001C","E01004582","Total",1096,976,120
"2011","Wandsworth 001D","E01004583","Total",947,876,71
"2011","Wandsworth 002B","E01004562","Total",783,754,29
"2011","Wandsworth 002C","E01004563","Total",897,879,18
"2011","Wandsworth 002D","E01004564","Total",863,820,43
"2011","Wandsworth 002E","E01004567","Total",1013,982,31
"2011","Wandsworth 002F","E01033098","Total",748,629,119
"2011","Wandsworth 002G","E01033100","Total",666,612,54
"2011","Wandsworth 002H","E01033132","Total",673,619,54
"2011","Wandsworth 003A","E01004539","Total",808,800,8
"2011","Wandsworth 003B","E01004540","Total",1059,1002,57
"2011","Wandsworth 003C","E01004577","Total",937,907,30
"2011","Wandsworth 003D","E01004584","Total",706,703,3
"2011","Wandsworth 004B","E01004579","Total",767,744,23
"2011","Wandsworth 004C","E01004580","Total",917,892,25
"2011","Wandsworth 004D","E01004581","Total",936,892,44
"2011","Wandsworth 004E","E01033099","Total",478,456,22
"2011","Wandsworth 004F","E01033101","Total",784,663,121
"2011","Wandsworth 004G","E01033133","Total",716,636,80
"2011","Wandsworth 005A","E01004565","Total",834,815,19
"2011","Wandsworth 005B","E01004590","Total",831,807,24
"2011","Wandsworth 005C","E01004591","Total",834,811,23
"2011","Wandsworth 005D","E01004592","Total",808,795,13
"2011","Wandsworth 006A","E01004604","Total",620,593,27
"2011","Wandsworth 006B","E01004605","Total",797,785,12
"2011","Wandsworth 006C","E01004606","Total",801,754,47
"2011","Wandsworth 006D","E01004607","Total",748,718,30
"2011","Wandsworth 006E","E01004608","Total",810,785,25
"2011","Wandsworth 007A","E01004535","Total",743,731,12
"2011","Wandsworth 007B","E01004537","Total",809,799,10
"2011","Wandsworth 007C","E01004538","Total",955,909,46
"2011","Wandsworth 007D","E01004541","Total",779,762,17
"2011","Wandsworth 008A","E01004534","Total",847,825,22
"2011","Wandsworth 008B","E01004536","Total",946,928,18
"2011","Wandsworth 008C","E01004552","Total",973,913,60
"2011","Wandsworth 008D","E01004585","Total",893,858,35
"2011","Wandsworth 008E","E01004588","Total",885,858,27
"2011","Wandsworth 009A","E01004554","Total",681,653,28
"2011","Wandsworth 009B","E01004556","Total",613,590,23
"2011","Wandsworth 009C","E01004586","Total",902,848,54
"2011","Wandsworth 009D","E01004587","Total",764,735,29
"2011","Wandsworth 009E","E01004589","Total",732,706,26
"2011","Wandsworth 010A","E01004509","Total",1196,1122,74
"2011","Wandsworth 010B","E01004511","Total",730,712,18
"2011","Wandsworth 010C","E01004602","Total",733,706,27
"2011","Wandsworth 010E","E01004609","Total",1041,996,45
"2011","Wandsworth 010F","E01033093","Total",815,766,49
"2011","Wandsworth 010G","E01033135","Total",486,475,11
"2011","Wandsworth 011A","E01004506","Total",1017,955,62
"2011","Wandsworth 011B","E01004638","Total",539,519,20
"2011","Wandsworth 011C","E01004639","Total",808,783,25
"2011","Wandsworth 011D","E01004640","Total",825,797,28
"2011","Wandsworth 011E","E01004641","Total",851,818,33
"2011","Wandsworth 012A","E01004508","Total",1026,986,40
"2011","Wandsworth 012B","E01004510","Total",959,917,42
"2011","Wandsworth 012C","E01004514","Total",840,799,41
"2011","Wandsworth 012D","E01004515","Total",753,739,14
"2011","Wandsworth 012E","E01004551","Total",932,884,48
"2011","Wandsworth 013A","E01004568","Total",466,458,8
"2011","Wandsworth 013B","E01004574","Total",739,727,12
"2011","Wandsworth 013C","E01004575","Total",708,691,17
"2011","Wandsworth 013D","E01004576","Total",604,592,12
"2011","Wandsworth 014A","E01004500","Total",841,807,34
"2011","Wandsworth 014B","E01004501","Total",732,712,20
"2011","Wandsworth 014C","E01004503","Total",758,738,20
"2011","Wandsworth 014D","E01004505","Total",867,838,29
"2011","Wandsworth 014E","E01004507","Total",1007,962,45
"2011","Wandsworth 015A","E01004553","Total",798,766,32
"2011","Wandsworth 015B","E01004557","Total",675,650,25
"2011","Wandsworth 015C","E01004558","Total",693,675,18
"2011","Wandsworth 015D","E01004559","Total",517,503,14
"2011","Wandsworth 015E","E01004619","Total",554,536,18
"2011","Wandsworth 016A","E01004572","Total",736,706,30
"2011","Wandsworth 016B","E01004642","Total",789,761,28
"2011","Wandsworth 016C","E01004643","Total",888,851,37
"2011","Wandsworth 016D","E01004644","Total",992,870,122
"2011","Wandsworth 016E","E01004645","Total",857,844,13
"2011","Wandsworth 017A","E01004477","Total",626,607,19
"2011","Wandsworth 017B","E01004478","Total",555,538,17
"2011","Wandsworth 017C","E01004479","Total",630,613,17
"2011","Wandsworth 017D","E01004550","Total",595,570,25
"2011","Wandsworth 017E","E01004555","Total",606,587,19
"2011","Wandsworth 018A","E01004494","Total",787,762,25
"2011","Wandsworth 018B","E01004513","Total",853,833,20
"2011","Wandsworth 018C","E01004600","Total",965,893,72
"2011","Wandsworth 018D","E01004601","Total",1025,1006,19
"2011","Wandsworth 019A","E01004493","Total",832,803,29
"2011","Wandsworth 019B","E01004512","Total",636,618,18
"2011","Wandsworth 019C","E01004620","Total",719,702,17
"2011","Wandsworth 019D","E01004621","Total",681,659,22
"2011","Wandsworth 019E","E01004623","Total",758,712,46
"2011","Wandsworth 019F","E01004627","Total",649,631,18
"2011","Wandsworth 020A","E01004499","Total",730,713,17
"2011","Wandsworth 020B","E01004502","Total",701,670,31
"2011","Wandsworth 020C","E01004504","Total",593,566,27
"2011","Wandsworth 020D","E01004594","Total",619,590,29
"2011","Wandsworth 020E","E01004596","Total",670,646,24
"2011","Wandsworth 020F","E01004629","Total",626,609,17
"2011","Wandsworth 021A","E01004472","Total",749,742,7
"2011","Wandsworth 021B","E01004474","Total",983,918,65
"2011","Wandsworth 021C","E01004476","Total",867,824,43
"2011","Wandsworth 021D","E01004542","Total",640,618,22
"2011","Wandsworth 021E","E01004544","Total",629,606,23
"2011","Wandsworth 022A","E01004628","Total",934,911,23
"2011","Wandsworth 022B","E01004630","Total",696,679,17
"2011","Wandsworth 022C","E01004631","Total",683,643,40
"2011","Wandsworth 022D","E01004633","Total",627,623,4
"2011","Wandsworth 023A","E01004569","Total",759,737,22
"2011","Wandsworth 023B","E01004570","Total",751,745,6
"2011","Wandsworth 023C","E01004571","Total",662,651,11
"2011","Wandsworth 023D","E01004573","Total",650,631,19
"2011","Wandsworth 024A","E01004495","Total",526,523,3
"2011","Wandsworth 024B","E01004496","Total",981,951,30
"2011","Wandsworth 024C","E01004497","Total",555,541,14
"2011","Wandsworth 024D","E01004622","Total",548,533,15
"2011","Wandsworth 024E","E01004624","Total",636,624,12
"2011","Wandsworth 025A","E01004593","Total",874,852,22
"2011","Wandsworth 025B","E01004595","Total",822,796,26
"2011","Wandsworth 025C","E01004597","Total",792,779,13
"2011","Wandsworth 025D","E01004598","Total",835,818,17
"2011","Wandsworth 025E","E01004599","Total",601,575,26
"2011","Wandsworth 026A","E01004473","Total",767,746,21
"2011","Wandsworth 026B","E01004475","Total",657,622,35
"2011","Wandsworth 026C","E01004480","Total",697,678,19
"2011","Wandsworth 026D","E01004483","Total",1035,1011,24
"2011","Wandsworth 026E","E01004484","Total",682,652,30
"2011","Wandsworth 026F","E01004486","Total",826,784,42
"2011","Wandsworth 027A","E01004543","Total",757,717,40
"2011","Wandsworth 027B","E01004545","Total",898,850,48
"2011","Wandsworth 027C","E01004546","Total",654,640,14
"2011","Wandsworth 027D","E01004549","Total",707,672,35
"2011","Wandsworth 027E","E01004625","Total",484,469,15
"2011","Wandsworth 027F","E01004626","Total",758,724,34
"2011","Wandsworth 028A","E01004632","Total",610,593,17
"2011","Wandsworth 028B","E01004634","Total",731,697,34
"2011","Wandsworth 028C","E01004635","Total",706,691,15
"2011","Wandsworth 028D","E01004636","Total",668,650,18
"2011","Wandsworth 028E","E01004637","Total",621,602,19
"2011","Wandsworth 029A","E01004481","Total",745,716,29
"2011","Wandsworth 029B","E01004488","Total",658,625,33
"2011","Wandsworth 029C","E01004547","Total",579,551,28
"2011","Wandsworth 029D","E01004548","Total",1097,1054,43
"2011","Wandsworth 030A","E01004482","Total",646,626,20
"2011","Wandsworth 030B","E01004485","Total",711,691,20
"2011","Wandsworth 030C","E01004487","Total",753,715,38
"2011","Wandsworth 030D","E01004489","Total",642,612,30
"2011","Wandsworth 031A","E01004490","Total",624,614,10
"2011","Wandsworth 031B","E01004491","Total",986,971,15
"2011","Wandsworth 031C","E01004492","Total",762,744,18
"2011","Wandsworth 031D","E01004498","Total",807,784,23
"2011","Wandsworth 032A","E01004532","Total",678,644,34
"2011","Wandsworth 032B","E01004611","Total",594,570,24
"2011","Wandsworth 032C","E01004612","Total",586,558,28
"2011","Wandsworth 032D","E01004618","Total",542,527,15
"2011","Wandsworth 033A","E01004531","Total",681,649,32
"2011","Wandsworth 033B","E01004533","Total",607,569,38
"2011","Wandsworth 033C","E01004610","Total",642,632,10
"2011","Wandsworth 033D","E01004613","Total",725,677,48
"2011","Wandsworth 034A","E01004614","Total",865,855,10
"2011","Wandsworth 034B","E01004615","Total",773,757,16
"2011","Wandsworth 034C","E01004616","Total",854,816,38
"2011","Wandsworth 034D","E01004617","Total",683,638,45
"2011","Wandsworth 035A","E01004525","Total",709,659,50
"2011","Wandsworth 035B","E01004526","Total",668,655,13
"2011","Wandsworth 035C","E01004527","Total",595,578,17
"2011","Wandsworth 035D","E01004528","Total",686,655,31
"2011","Wandsworth 035E","E01004529","Total",930,902,28
"2011","Wandsworth 035F","E01004530","Total",804,789,15
"2011","Wandsworth 036A","E01004516","Total",535,510,25
"2011","Wandsworth 036B","E01004518","Total",697,650,47
"2011","Wandsworth 036C","E01004519","Total",640,632,8
"2011","Wandsworth 036D","E01004520","Total",472,459,13
"2011","Wandsworth 036E","E01004523","Total",754,722,32
"2011","Wandsworth 037A","E01004517","Total",918,810,108
"2011","Wandsworth 037B","E01004521","Total",779,768,11
"2011","Wandsworth 037C","E01004522","Total",675,628,47
"2011","Wandsworth 037D","E01004524","Total",810,774,36
"2011","Westminster 001A","E01004647","Total",777,685,92
"2011","Westminster 001B","E01004649","Total",839,716,123
"2011","Westminster 001C","E01004724","Total",960,850,110
"2011","Westminster 001D","E01004730","Total",993,804,189
"2011","Westminster 002A","E01004646","Total",655,616,39
"2011","Westminster 002B","E01004648","Total",1212,1122,90
"2011","Westminster 002C","E01004650","Total",1021,932,89
"2011","Westminster 002D","E01004710","Total",657,635,22
"2011","Westminster 002E","E01004711","Total",791,759,32
"2011","Westminster 003A","E01004651","Total",1301,1137,164
"2011","Westminster 003B","E01004725","Total",993,799,194
"2011","Westminster 003C","E01004726","Total",937,824,113
"2011","Westminster 003D","E01004728","Total",897,808,89
"2011","Westminster 003E","E01004729","Total",915,856,59
"2011","Westminster 004A","E01004718","Total",880,850,30
"2011","Westminster 004B","E01004719","Total",816,786,30
"2011","Westminster 004C","E01004720","Total",800,777,23
"2011","Westminster 004D","E01004721","Total",904,879,25
"2011","Westminster 004E","E01004722","Total",866,849,17
"2011","Westminster 005A","E01004674","Total",857,843,14
"2011","Westminster 005B","E01004675","Total",1125,1098,27
"2011","Westminster 005C","E01004677","Total",897,876,21
"2011","Westminster 005D","E01004678","Total",915,889,26
"2011","Westminster 005E","E01004679","Total",960,935,25
"2011","Westminster 005F","E01004723","Total",1036,997,39
"2011","Westminster 006A","E01004676","Total",817,794,23
"2011","Westminster 006B","E01004706","Total",764,735,29
"2011","Westminster 006C","E01004707","Total",848,798,50
"2011","Westminster 006D","E01004708","Total",813,788,25
"2011","Westminster 006E","E01004756","Total",893,866,27
"2011","Westminster 007A","E01004701","Total",938,843,95
"2011","Westminster 007B","E01004703","Total",1160,1027,133
"2011","Westminster 007D","E01004705","Total",771,700,71
"2011","Westminster 007E","E01004709","Total",788,765,23
"2011","Westminster 007F","E01033600","Total",696,644,52
"2011","Westminster 007G","E01033608","Total",770,735,35
"2011","Westminster 008A","E01004659","Total",1094,961,133
"2011","Westminster 008B","E01004660","Total",1112,873,239
"2011","Westminster 008C","E01004712","Total",979,842,137
"2011","Westminster 008D","E01004727","Total",1218,977,241
"2011","Westminster 009A","E01004670","Total",952,948,4
"2011","Westminster 009E","E01004702","Total",1022,994,28
"2011","Westminster 009F","E01033598","Total",543,502,41
"2011","Westminster 009G","E01033601","Total",609,589,20
"2011","Westminster 009H","E01033602","Total",659,645,14
"2011","Westminster 009I","E01033603","Total",643,600,43
"2011","Westminster 009J","E01033604","Total",630,620,10
"2011","Westminster 009K","E01033605","Total",830,815,15
"2011","Westminster 010A","E01004754","Total",605,600,5
"2011","Westminster 010B","E01004755","Total",986,963,23
"2011","Westminster 010C","E01004757","Total",612,600,12
"2011","Westminster 010F","E01032512","Total",1004,989,15
"2011","Westminster 010G","E01032513","Total",573,567,6
"2011","Westminster 011A","E01004713","Total",1157,939,218
"2011","Westminster 011B","E01004714","Total",1535,1177,358
"2011","Westminster 011C","E01004716","Total",890,724,166
"2011","Westminster 011D","E01004717","Total",1016,898,118
"2011","Westminster 011E","E01004762","Total",1656,1136,520
"2011","Westminster 012A","E01004657","Total",972,827,145
"2011","Westminster 012B","E01004658","Total",1119,744,375
"2011","Westminster 012C","E01004661","Total",987,892,95
"2011","Westminster 012D","E01004662","Total",1169,1040,129
"2011","Westminster 012E","E01004663","Total",1039,851,188
"2011","Westminster 013A","E01004715","Total",950,824,126
"2011","Westminster 013B","E01004763","Total",1229,1076,153
"2011","Westminster 013D","E01004765","Total",1227,1103,124
"2011","Westminster 013E","E01033595","Total",936,755,181
"2011","Westminster 013F","E01033596","Total",832,745,87
"2011","Westminster 014A","E01004653","Total",1008,929,79
"2011","Westminster 014B","E01004654","Total",1291,1204,87
"2011","Westminster 014D","E01004656","Total",1233,1178,55
"2011","Westminster 014E","E01004760","Total",798,771,27
"2011","Westminster 014F","E01033606","Total",642,614,28
"2011","Westminster 014G","E01033607","Total",644,616,28
"2011","Westminster 015A","E01004680","Total",922,708,214
"2011","Westminster 015B","E01004683","Total",943,767,176
"2011","Westminster 015C","E01004684","Total",920,701,219
"2011","Westminster 015E","E01004686","Total",1023,848,175
"2011","Westminster 015F","E01033593","Total",861,645,216
"2011","Westminster 015G","E01033594","Total",805,711,94
"2011","Westminster 016A","E01004681","Total",1287,1150,137
"2011","Westminster 016B","E01004682","Total",863,765,98
"2011","Westminster 016C","E01004694","Total",1133,949,184
"2011","Westminster 016D","E01004697","Total",872,816,56
"2011","Westminster 016E","E01004700","Total",1038,941,97
"2011","Westminster 017A","E01004652","Total",1030,958,72
"2011","Westminster 017B","E01004693","Total",827,735,92
"2011","Westminster 017C","E01004695","Total",774,669,105
"2011","Westminster 017D","E01004696","Total",778,760,18
"2011","Westminster 017E","E01004698","Total",924,754,170
"2011","Westminster 017F","E01004699","Total",1256,1165,91
"2011","Westminster 018A","E01004734","Total",1324,1104,220
"2011","Westminster 018B","E01004735","Total",1211,977,234
"2011","Westminster 018C","E01004736","Total",1032,729,303
"2011","Westminster 018D","E01004761","Total",1747,1085,662
"2011","Westminster 019A","E01004687","Total",1062,799,263
"2011","Westminster 019B","E01004688","Total",620,486,134
"2011","Westminster 019C","E01004689","Total",830,510,320
"2011","Westminster 019D","E01004690","Total",848,627,221
"2011","Westminster 019E","E01004691","Total",1109,816,293
"2011","Westminster 019F","E01004692","Total",969,644,325
"2011","Westminster 020A","E01004731","Total",1168,910,258
"2011","Westminster 020B","E01004732","Total",731,697,34
"2011","Westminster 020C","E01004733","Total",1113,926,187
"2011","Westminster 020D","E01004744","Total",814,744,70
"2011","Westminster 020E","E01004748","Total",723,615,108
"2011","Westminster 021A","E01004740","Total",798,776,22
"2011","Westminster 021B","E01004743","Total",858,713,145
"2011","Westminster 021C","E01004745","Total",1267,1125,142
"2011","Westminster 021D","E01004746","Total",795,757,38
"2011","Westminster 021E","E01004747","Total",1257,1127,130
"2011","Westminster 022A","E01004742","Total",860,779,81
"2011","Westminster 022B","E01004749","Total",1314,1185,129
"2011","Westminster 022C","E01004751","Total",1016,943,73
"2011","Westminster 022D","E01004752","Total",969,905,64
"2011","Westminster 022E","E01004753","Total",1090,1041,49
"2011","Westminster 023B","E01004666","Total",644,553,91
"2011","Westminster 023C","E01004667","Total",816,743,73
"2011","Westminster 023D","E01004668","Total",688,645,43
"2011","Westminster 023E","E01004750","Total",1083,951,132
"2011","Westminster 023F","E01033597","Total",718,621,97
"2011","Westminster 023G","E01033599","Total",716,630,86
"2011","Westminster 024A","E01004665","Total",634,611,23
"2011","Westminster 024B","E01004669","Total",781,758,23
"2011","Westminster 024C","E01004737","Total",787,683,104
"2011","Westminster 024D","E01004738","Total",862,722,140
"2011","Westminster 024E","E01004739","Total",1121,950,171
"2011","Westminster 024F","E01004741","Total",772,698,74
"2011","Barking and Dagenham 001A","E01000027","Total",661,641,20
"2011","Barking and Dagenham 001B","E01000028","Total",633,612,21
"2011","Barking and Dagenham 001C","E01000029","Total",715,690,25
"2011","Barking and Dagenham 001D","E01000030","Total",786,770,16
"2011","Barking and Dagenham 002A","E01000031","Total",618,598,20
"2011","Barking and Dagenham 002B","E01000032","Total",649,631,18
"2011","Barking and Dagenham 002C","E01000110","Total",525,501,24
"2011","Barking and Dagenham 002D","E01000111","Total",750,732,18
"2011","Barking and Dagenham 002E","E01000112","Total",749,739,10
"2011","Barking and Dagenham 002F","E01000113","Total",653,633,20
"2011","Barking and Dagenham 003A","E01000034","Total",527,517,10
"2011","Barking and Dagenham 003B","E01000037","Total",595,579,16
"2011","Barking and Dagenham 003C","E01000038","Total",574,563,11
"2011","Barking and Dagenham 003D","E01000039","Total",667,659,8
"2011","Barking and Dagenham 004A","E01000063","Total",644,635,9
"2011","Barking and Dagenham 004B","E01000100","Total",628,615,13
"2011","Barking and Dagenham 004C","E01000101","Total",586,567,19
"2011","Barking and Dagenham 004D","E01000109","Total",622,608,14
"2011","Barking and Dagenham 004E","E01000114","Total",792,758,34
"2011","Barking and Dagenham 006A","E01000033","Total",543,533,10
"2011","Barking and Dagenham 006B","E01000060","Total",791,770,21
"2011","Barking and Dagenham 006C","E01000061","Total",677,668,9
"2011","Barking and Dagenham 006D","E01000062","Total",772,761,11
"2011","Barking and Dagenham 006E","E01000064","Total",751,709,42
"2011","Barking and Dagenham 007A","E01000065","Total",783,774,9
"2011","Barking and Dagenham 007B","E01000078","Total",655,649,6
"2011","Barking and Dagenham 007C","E01000080","Total",601,594,7
"2011","Barking and Dagenham 007D","E01000081","Total",654,648,6
"2011","Barking and Dagenham 007E","E01000082","Total",679,672,7
"2011","Barking and Dagenham 007F","E01000083","Total",636,629,7
"2011","Barking and Dagenham 007G","E01000102","Total",634,625,9
"2011","Barking and Dagenham 008A","E01000021","Total",600,593,7
"2011","Barking and Dagenham 008B","E01000022","Total",481,474,7
"2011","Barking and Dagenham 008C","E01000023","Total",542,500,42
"2011","Barking and Dagenham 008D","E01000024","Total",462,456,6
"2011","Barking and Dagenham 008E","E01000025","Total",636,629,7
"2011","Barking and Dagenham 008F","E01000077","Total",571,560,11
"2011","Barking and Dagenham 009A","E01000015","Total",849,836,13
"2011","Barking and Dagenham 009B","E01000016","Total",638,626,12
"2011","Barking and Dagenham 009C","E01000017","Total",618,609,9
"2011","Barking and Dagenham 009D","E01000018","Total",623,612,11
"2011","Barking and Dagenham 009E","E01000079","Total",619,609,10
"2011","Barking and Dagenham 010A","E01000035","Total",590,567,23
"2011","Barking and Dagenham 010B","E01000036","Total",481,469,12
"2011","Barking and Dagenham 010C","E01000107","Total",612,601,11
"2011","Barking and Dagenham 010D","E01000108","Total",665,652,13
"2011","Barking and Dagenham 011A","E01000066","Total",694,683,11
"2011","Barking and Dagenham 011B","E01000067","Total",689,679,10
"2011","Barking and Dagenham 011C","E01000069","Total",523,513,10
"2011","Barking and Dagenham 011D","E01000070","Total",618,598,20
"2011","Barking and Dagenham 011E","E01000071","Total",793,785,8
"2011","Barking and Dagenham 012A","E01000057","Total",548,537,11
"2011","Barking and Dagenham 012B","E01000073","Total",637,627,10
"2011","Barking and Dagenham 012C","E01000074","Total",635,629,6
"2011","Barking and Dagenham 012D","E01000075","Total",628,622,6
"2011","Barking and Dagenham 012E","E01000076","Total",724,710,14
"2011","Barking and Dagenham 013A","E01000013","Total",672,650,22
"2011","Barking and Dagenham 013B","E01000014","Total",645,638,7
"2011","Barking and Dagenham 013C","E01000059","Total",583,578,5
"2011","Barking and Dagenham 013D","E01000084","Total",521,517,4
"2011","Barking and Dagenham 013E","E01000085","Total",652,640,12
"2011","Barking and Dagenham 013F","E01000086","Total",518,508,10
"2011","Barking and Dagenham 014A","E01000103","Total",613,600,13
"2011","Barking and Dagenham 014B","E01000104","Total",757,739,18
"2011","Barking and Dagenham 014C","E01000105","Total",929,915,14
"2011","Barking and Dagenham 014D","E01000106","Total",932,916,16
"2011","Barking and Dagenham 015A","E01000007","Total",627,612,15
"2011","Barking and Dagenham 015B","E01000008","Total",534,521,13
"2011","Barking and Dagenham 015C","E01000010","Total",1179,1103,76
"2011","Barking and Dagenham 015D","E01000012","Total",730,698,32
"2011","Barking and Dagenham 016A","E01000006","Total",558,543,15
"2011","Barking and Dagenham 016B","E01000009","Total",659,638,21
"2011","Barking and Dagenham 016C","E01000011","Total",466,457,9
"2011","Barking and Dagenham 016D","E01000044","Total",643,629,14
"2011","Barking and Dagenham 016E","E01000068","Total",471,462,9
"2011","Barking and Dagenham 017A","E01000041","Total",611,607,4
"2011","Barking and Dagenham 017B","E01000042","Total",684,679,5
"2011","Barking and Dagenham 017C","E01000045","Total",603,602,1
"2011","Barking and Dagenham 017D","E01000046","Total",658,654,4
"2011","Barking and Dagenham 017E","E01000072","Total",792,784,8
"2011","Barking and Dagenham 018A","E01000054","Total",655,638,17
"2011","Barking and Dagenham 018B","E01000055","Total",579,560,19
"2011","Barking and Dagenham 018C","E01000056","Total",585,573,12
"2011","Barking and Dagenham 018D","E01000058","Total",693,690,3
"2011","Barking and Dagenham 018E","E01000095","Total",552,549,3
"2011","Barking and Dagenham 019A","E01000040","Total",655,640,15
"2011","Barking and Dagenham 019B","E01000043","Total",467,461,6
"2011","Barking and Dagenham 019C","E01000050","Total",632,615,17
"2011","Barking and Dagenham 019D","E01000052","Total",796,769,27
"2011","Barking and Dagenham 019E","E01000092","Total",993,975,18
"2011","Barking and Dagenham 020A","E01000053","Total",653,645,8
"2011","Barking and Dagenham 020B","E01000087","Total",512,503,9
"2011","Barking and Dagenham 020C","E01000088","Total",656,640,16
"2011","Barking and Dagenham 020D","E01000089","Total",646,612,34
"2011","Barking and Dagenham 020E","E01000090","Total",592,549,43
"2011","Barking and Dagenham 021B","E01000048","Total",649,644,5
"2011","Barking and Dagenham 021C","E01000049","Total",645,643,2
"2011","Barking and Dagenham 021D","E01000051","Total",730,725,5
"2011","Barking and Dagenham 021E","E01033587","Total",635,631,4
"2011","Barking and Dagenham 021F","E01033588","Total",624,618,6
"2011","Barking and Dagenham 022A","E01000091","Total",646,633,13
"2011","Barking and Dagenham 022B","E01000093","Total",653,642,11
"2011","Barking and Dagenham 022C","E01000094","Total",523,517,6
"2011","Barking and Dagenham 022D","E01000096","Total",646,639,7
"2011","Barking and Dagenham 023A","E01000019","Total",512,504,8
"2011","Barking and Dagenham 023B","E01000020","Total",663,650,13
"2011","Barking and Dagenham 023C","E01000097","Total",717,708,9
"2011","Barking and Dagenham 023D","E01000098","Total",635,625,10
"2011","Barking and Dagenham 023E","E01000099","Total",717,666,51
"2011","Barking and Dagenham 023F","E01032580","Total",482,471,11
"2011","Barnet 001A","E01000248","Total",689,666,23
"2011","Barnet 001B","E01000249","Total",593,572,21
"2011","Barnet 001C","E01000250","Total",1027,979,48
"2011","Barnet 001D","E01000254","Total",665,622,43
"2011","Barnet 001E","E01000292","Total",651,629,22
"2011","Barnet 001F","E01000293","Total",677,642,35
"2011","Barnet 002A","E01000167","Total",535,522,13
"2011","Barnet 002B","E01000246","Total",673,654,19
"2011","Barnet 002C","E01000247","Total",765,746,19
"2011","Barnet 002D","E01000251","Total",980,947,33
"2011","Barnet 002E","E01000252","Total",773,753,20
"2011","Barnet 003A","E01000166","Total",660,648,12
"2011","Barnet 003B","E01000168","Total",584,576,8
"2011","Barnet 003C","E01000169","Total",689,670,19
"2011","Barnet 003D","E01000172","Total",607,602,5
"2011","Barnet 004A","E01000285","Total",619,610,9
"2011","Barnet 004B","E01000287","Total",629,622,7
"2011","Barnet 004C","E01000288","Total",579,568,11
"2011","Barnet 004D","E01000289","Total",645,631,14
"2011","Barnet 004E","E01000291","Total",606,602,4
"2011","Barnet 004F","E01000294","Total",690,672,18
"2011","Barnet 005A","E01000267","Total",573,567,6
"2011","Barnet 005B","E01000268","Total",754,745,9
"2011","Barnet 005C","E01000269","Total",543,535,8
"2011","Barnet 005D","E01000270","Total",636,626,10
"2011","Barnet 006A","E01000170","Total",668,656,12
"2011","Barnet 006B","E01000171","Total",871,856,15
"2011","Barnet 006C","E01000173","Total",623,617,6
"2011","Barnet 006D","E01000174","Total",777,766,11
"2011","Barnet 006E","E01000175","Total",625,618,7
"2011","Barnet 007A","E01000228","Total",491,475,16
"2011","Barnet 007B","E01000253","Total",629,597,32
"2011","Barnet 007C","E01000279","Total",554,513,41
"2011","Barnet 007D","E01000280","Total",518,497,21
"2011","Barnet 007E","E01000286","Total",671,654,17
"2011","Barnet 007F","E01000290","Total",695,674,21
"2011","Barnet 008A","E01000271","Total",602,582,20
"2011","Barnet 008B","E01000272","Total",477,468,9
"2011","Barnet 008C","E01000273","Total",663,648,15
"2011","Barnet 008D","E01000281","Total",507,480,27
"2011","Barnet 008E","E01000282","Total",648,639,9
"2011","Barnet 009A","E01000115","Total",490,485,5
"2011","Barnet 009B","E01000116","Total",632,623,9
"2011","Barnet 009C","E01000119","Total",624,607,17
"2011","Barnet 009D","E01000120","Total",510,505,5
"2011","Barnet 009E","E01000122","Total",531,522,9
"2011","Barnet 010A","E01000117","Total",776,762,14
"2011","Barnet 010B","E01000118","Total",719,709,10
"2011","Barnet 010C","E01000121","Total",505,501,4
"2011","Barnet 010D","E01000123","Total",701,685,16
"2011","Barnet 010E","E01000124","Total",698,660,38
"2011","Barnet 011A","E01000265","Total",802,791,11
"2011","Barnet 011B","E01000266","Total",522,511,11
"2011","Barnet 011C","E01000274","Total",713,699,14
"2011","Barnet 011D","E01000320","Total",634,628,6
"2011","Barnet 011E","E01000322","Total",796,774,22
"2011","Barnet 012A","E01000275","Total",657,644,13
"2011","Barnet 012B","E01000277","Total",817,777,40
"2011","Barnet 012C","E01000283","Total",488,480,8
"2011","Barnet 012D","E01000284","Total",807,780,27
"2011","Barnet 012E","E01000321","Total",717,700,17
"2011","Barnet 013A","E01000195","Total",721,697,24
"2011","Barnet 013B","E01000229","Total",610,600,10
"2011","Barnet 013C","E01000230","Total",668,650,18
"2011","Barnet 013D","E01000231","Total",665,654,11
"2011","Barnet 013E","E01000232","Total",719,706,13
"2011","Barnet 013F","E01000233","Total",656,635,21
"2011","Barnet 014A","E01000186","Total",506,501,5
"2011","Barnet 014B","E01000187","Total",603,593,10
"2011","Barnet 014C","E01000188","Total",523,516,7
"2011","Barnet 014D","E01000189","Total",741,711,30
"2011","Barnet 014E","E01000190","Total",555,546,9
"2011","Barnet 014F","E01000191","Total",544,530,14
"2011","Barnet 015A","E01000158","Total",580,564,16
"2011","Barnet 015B","E01000159","Total",656,645,11
"2011","Barnet 015C","E01000160","Total",978,923,55
"2011","Barnet 015D","E01000161","Total",730,710,20
"2011","Barnet 015E","E01000162","Total",560,552,8
"2011","Barnet 015F","E01000324","Total",660,655,5
"2011","Barnet 016A","E01000256","Total",675,656,19
"2011","Barnet 016B","E01000258","Total",723,696,27
"2011","Barnet 016C","E01000263","Total",517,499,18
"2011","Barnet 016D","E01000264","Total",675,634,41
"2011","Barnet 017A","E01000255","Total",539,527,12
"2011","Barnet 017B","E01000257","Total",743,724,19
"2011","Barnet 017C","E01000261","Total",679,646,33
"2011","Barnet 017D","E01000262","Total",790,752,38
"2011","Barnet 018A","E01000192","Total",722,683,39
"2011","Barnet 018B","E01000193","Total",618,594,24
"2011","Barnet 018C","E01000194","Total",634,610,24
"2011","Barnet 018D","E01000226","Total",633,630,3
"2011","Barnet 018E","E01000227","Total",618,603,15
"2011","Barnet 019A","E01000299","Total",814,782,32
"2011","Barnet 019B","E01000300","Total",682,667,15
"2011","Barnet 019C","E01000302","Total",860,840,20
"2011","Barnet 019D","E01000317","Total",671,657,14
"2011","Barnet 019E","E01000318","Total",616,610,6
"2011","Barnet 019F","E01000323","Total",891,865,26
"2011","Barnet 020A","E01000276","Total",512,506,6
"2011","Barnet 020B","E01000278","Total",521,498,23
"2011","Barnet 020C","E01000301","Total",546,528,18
"2011","Barnet 020D","E01000303","Total",548,540,8
"2011","Barnet 020E","E01000304","Total",636,621,15
"2011","Barnet 021A","E01000130","Total",574,570,4
"2011","Barnet 021B","E01000132","Total",506,495,11
"2011","Barnet 021C","E01000133","Total",579,565,14
"2011","Barnet 021D","E01000234","Total",672,650,22
"2011","Barnet 021E","E01000235","Total",595,582,13
"2011","Barnet 022A","E01000156","Total",776,751,25
"2011","Barnet 022B","E01000157","Total",701,689,12
"2011","Barnet 022C","E01000163","Total",772,759,13
"2011","Barnet 022D","E01000164","Total",667,648,19
"2011","Barnet 022E","E01000165","Total",716,707,9
"2011","Barnet 022F","E01000315","Total",620,614,6
"2011","Barnet 023A","E01000197","Total",726,707,19
"2011","Barnet 023B","E01000295","Total",694,686,8
"2011","Barnet 023C","E01000296","Total",751,734,17
"2011","Barnet 023D","E01000298","Total",763,733,30
"2011","Barnet 024A","E01000125","Total",1040,1015,25
"2011","Barnet 024B","E01000127","Total",523,514,9
"2011","Barnet 024C","E01000128","Total",639,624,15
"2011","Barnet 024D","E01000129","Total",646,624,22
"2011","Barnet 024E","E01000131","Total",644,634,10
"2011","Barnet 024F","E01000134","Total",633,625,8
"2011","Barnet 025A","E01000198","Total",701,685,16
"2011","Barnet 025B","E01000199","Total",693,671,22
"2011","Barnet 025C","E01000204","Total",695,687,8
"2011","Barnet 025D","E01000259","Total",1004,980,24
"2011","Barnet 025E","E01000260","Total",777,761,16
"2011","Barnet 026A","E01000126","Total",727,726,1
"2011","Barnet 026B","E01000151","Total",624,617,7
"2011","Barnet 026C","E01000152","Total",578,564,14
"2011","Barnet 026D","E01000153","Total",624,620,4
"2011","Barnet 026E","E01000154","Total",507,501,6
"2011","Barnet 027A","E01000176","Total",710,698,12
"2011","Barnet 027B","E01000178","Total",708,695,13
"2011","Barnet 027C","E01000184","Total",509,503,6
"2011","Barnet 027D","E01000297","Total",568,554,14
"2011","Barnet 027E","E01000316","Total",888,874,14
"2011","Barnet 027F","E01000319","Total",536,529,7
"2011","Barnet 028A","E01000196","Total",945,896,49
"2011","Barnet 028B","E01000200","Total",900,863,37
"2011","Barnet 028C","E01000201","Total",543,517,26
"2011","Barnet 028D","E01000202","Total",673,648,25
"2011","Barnet 028E","E01000203","Total",632,613,19
"2011","Barnet 029A","E01000177","Total",706,690,16
"2011","Barnet 029B","E01000179","Total",783,763,20
"2011","Barnet 029C","E01000180","Total",713,689,24
"2011","Barnet 029D","E01000181","Total",684,669,15
"2011","Barnet 029E","E01000182","Total",773,746,27
"2011","Barnet 029F","E01000185","Total",612,606,6
"2011","Barnet 030A","E01000147","Total",557,544,13
"2011","Barnet 030B","E01000148","Total",742,725,17
"2011","Barnet 030D","E01000155","Total",825,797,28
"2011","Barnet 030E","E01033572","Total",595,571,24
"2011","Barnet 030F","E01033573","Total",647,607,40
"2011","Barnet 031A","E01000239","Total",915,877,38
"2011","Barnet 031B","E01000240","Total",604,582,22
"2011","Barnet 031C","E01000241","Total",714,696,18
"2011","Barnet 031D","E01000309","Total",652,619,33
"2011","Barnet 032A","E01000237","Total",784,740,44
"2011","Barnet 032B","E01000242","Total",623,597,26
"2011","Barnet 032C","E01000243","Total",822,791,31
"2011","Barnet 032D","E01000244","Total",618,582,36
"2011","Barnet 032E","E01000245","Total",836,811,25
"2011","Barnet 032F","E01000314","Total",690,658,32
"2011","Barnet 033A","E01000183","Total",607,584,23
"2011","Barnet 033B","E01000206","Total",600,514,86
"2011","Barnet 033C","E01000207","Total",636,608,28
"2011","Barnet 033D","E01000208","Total",661,619,42
"2011","Barnet 033E","E01000210","Total",617,600,17
"2011","Barnet 033F","E01000213","Total",476,465,11
"2011","Barnet 034A","E01000236","Total",701,674,27
"2011","Barnet 034B","E01000238","Total",638,615,23
"2011","Barnet 034C","E01000310","Total",741,701,40
"2011","Barnet 034D","E01000311","Total",508,470,38
"2011","Barnet 035A","E01000205","Total",635,619,16
"2011","Barnet 035B","E01000209","Total",771,747,24
"2011","Barnet 035C","E01000211","Total",896,861,35
"2011","Barnet 035D","E01000212","Total",547,529,18
"2011","Barnet 035E","E01000216","Total",714,684,30
"2011","Barnet 035F","E01000217","Total",538,521,17
"2011","Barnet 036A","E01000150","Total",761,744,17
"2011","Barnet 036B","E01000305","Total",657,637,20
"2011","Barnet 036C","E01000306","Total",567,558,9
"2011","Barnet 036D","E01000308","Total",684,669,15
"2011","Barnet 036E","E01000312","Total",720,710,10
"2011","Barnet 036F","E01000313","Total",700,672,28
"2011","Barnet 037A","E01000145","Total",468,444,24
"2011","Barnet 037B","E01000215","Total",721,680,41
"2011","Barnet 037C","E01000218","Total",595,573,22
"2011","Barnet 037D","E01000219","Total",599,581,18
"2011","Barnet 037E","E01000220","Total",614,593,21
"2011","Barnet 037F","E01000225","Total",540,529,11
"2011","Barnet 038A","E01000135","Total",617,541,76
"2011","Barnet 038B","E01000136","Total",603,563,40
"2011","Barnet 038C","E01000144","Total",640,607,33
"2011","Barnet 038D","E01000146","Total",775,744,31
"2011","Barnet 038E","E01000214","Total",763,717,46
"2011","Barnet 039A","E01000141","Total",880,864,16
"2011","Barnet 039B","E01000221","Total",493,485,8
"2011","Barnet 039C","E01000223","Total",492,478,14
"2011","Barnet 039D","E01000307","Total",546,530,16
"2011","Barnet 040A","E01000138","Total",535,523,12
"2011","Barnet 040B","E01000142","Total",981,950,31
"2011","Barnet 040C","E01000222","Total",523,506,17
"2011","Barnet 040D","E01000224","Total",544,524,20
"2011","Barnet 041A","E01000137","Total",698,669,29
"2011","Barnet 041B","E01000139","Total",581,560,21
"2011","Barnet 041C","E01000140","Total",723,683,40
"2011","Barnet 041D","E01000143","Total",544,538,6
"2011","Bexley 001A","E01000466","Total",609,602,7
"2011","Bexley 001B","E01000467","Total",624,591,33
"2011","Bexley 001C","E01000468","Total",977,890,87
"2011","Bexley 001D","E01000469","Total",667,645,22
"2011","Bexley 002A","E01000416","Total",525,517,8
"2011","Bexley 002B","E01000418","Total",769,754,15
"2011","Bexley 002C","E01000422","Total",698,681,17
"2011","Bexley 002D","E01000464","Total",557,546,11
"2011","Bexley 002E","E01000465","Total",741,707,34
"2011","Bexley 002F","E01000470","Total",750,590,160
"2011","Bexley 003A","E01000333","Total",830,793,37
"2011","Bexley 003B","E01000335","Total",650,638,12
"2011","Bexley 003C","E01000336","Total",829,793,36
"2011","Bexley 003D","E01000337","Total",677,663,14
"2011","Bexley 003E","E01000338","Total",711,693,18
"2011","Bexley 004A","E01000403","Total",999,990,9
"2011","Bexley 004B","E01000404","Total",1033,959,74
"2011","Bexley 004C","E01000405","Total",541,522,19
"2011","Bexley 004D","E01000408","Total",580,570,10
"2011","Bexley 005A","E01000332","Total",632,611,21
"2011","Bexley 005B","E01000402","Total",676,660,16
"2011","Bexley 005C","E01000406","Total",620,594,26
"2011","Bexley 005D","E01000407","Total",644,630,14
"2011","Bexley 006A","E01000334","Total",659,640,19
"2011","Bexley 006B","E01000417","Total",734,713,21
"2011","Bexley 006C","E01000419","Total",608,594,14
"2011","Bexley 006D","E01000420","Total",618,604,14
"2011","Bexley 006E","E01000442","Total",641,626,15
"2011","Bexley 007A","E01000437","Total",511,498,13
"2011","Bexley 007B","E01000438","Total",616,599,17
"2011","Bexley 007C","E01000439","Total",516,496,20
"2011","Bexley 007D","E01000440","Total",526,517,9
"2011","Bexley 007E","E01000441","Total",689,672,17
"2011","Bexley 008A","E01000373","Total",702,688,14
"2011","Bexley 008B","E01000429","Total",747,719,28
"2011","Bexley 008C","E01000430","Total",688,678,10
"2011","Bexley 008D","E01000431","Total",698,681,17
"2011","Bexley 008E","E01000432","Total",655,640,15
"2011","Bexley 008F","E01000433","Total",732,720,12
"2011","Bexley 008G","E01000434","Total",601,596,5
"2011","Bexley 009A","E01000356","Total",643,628,15
"2011","Bexley 009B","E01000357","Total",496,488,8
"2011","Bexley 009C","E01000359","Total",496,488,8
"2011","Bexley 009D","E01000421","Total",614,603,11
"2011","Bexley 009E","E01000450","Total",656,645,11
"2011","Bexley 009F","E01000451","Total",633,621,12
"2011","Bexley 009G","E01000452","Total",502,495,7
"2011","Bexley 010A","E01000367","Total",625,605,20
"2011","Bexley 010B","E01000368","Total",638,632,6
"2011","Bexley 010C","E01000372","Total",606,593,13
"2011","Bexley 010D","E01000380","Total",769,758,11
"2011","Bexley 010E","E01000435","Total",602,597,5
"2011","Bexley 011A","E01000353","Total",667,662,5
"2011","Bexley 011B","E01000354","Total",629,623,6
"2011","Bexley 011C","E01000355","Total",619,613,6
"2011","Bexley 011D","E01000358","Total",682,659,23
"2011","Bexley 011E","E01000436","Total",627,615,12
"2011","Bexley 013A","E01000401","Total",658,637,21
"2011","Bexley 013B","E01000453","Total",527,513,14
"2011","Bexley 013C","E01000454","Total",644,628,16
"2011","Bexley 013D","E01000455","Total",619,605,14
"2011","Bexley 013E","E01000456","Total",492,487,5
"2011","Bexley 014A","E01000325","Total",589,583,6
"2011","Bexley 014B","E01000326","Total",550,544,6
"2011","Bexley 014C","E01000369","Total",634,626,8
"2011","Bexley 014D","E01000370","Total",660,649,11
"2011","Bexley 014E","E01000371","Total",650,634,16
"2011","Bexley 015A","E01000360","Total",691,662,29
"2011","Bexley 015B","E01000362","Total",639,626,13
"2011","Bexley 015C","E01000365","Total",717,700,17
"2011","Bexley 015D","E01000366","Total",669,655,14
"2011","Bexley 015E","E01000394","Total",643,624,19
"2011","Bexley 016A","E01000388","Total",632,621,11
"2011","Bexley 016B","E01000392","Total",730,695,35
"2011","Bexley 016C","E01000409","Total",663,649,14
"2011","Bexley 016D","E01000411","Total",561,551,10
"2011","Bexley 016E","E01000414","Total",708,674,34
"2011","Bexley 016F","E01000415","Total",521,512,9
"2011","Bexley 017A","E01000327","Total",621,604,17
"2011","Bexley 017B","E01000328","Total",608,596,12
"2011","Bexley 017C","E01000329","Total",527,517,10
"2011","Bexley 017D","E01000330","Total",787,772,15
"2011","Bexley 017E","E01000331","Total",622,617,5
"2011","Bexley 018A","E01000340","Total",633,619,14
"2011","Bexley 018B","E01000395","Total",505,499,6
"2011","Bexley 018C","E01000396","Total",514,507,7
"2011","Bexley 018D","E01000410","Total",611,594,17
"2011","Bexley 018E","E01000412","Total",647,632,15
"2011","Bexley 018F","E01000413","Total",540,505,35
"2011","Bexley 019A","E01000374","Total",537,534,3
"2011","Bexley 019B","E01000375","Total",578,565,13
"2011","Bexley 019C","E01000376","Total",618,606,12
"2011","Bexley 019D","E01000377","Total",663,649,14
"2011","Bexley 019E","E01000378","Total",998,968,30
"2011","Bexley 019F","E01000379","Total",677,663,14
"2011","Bexley 020A","E01000348","Total",531,523,8
"2011","Bexley 020B","E01000349","Total",663,650,13
"2011","Bexley 020C","E01000361","Total",614,602,12
"2011","Bexley 020D","E01000363","Total",576,565,11
"2011","Bexley 020E","E01000389","Total",732,714,18
"2011","Bexley 020F","E01000390","Total",524,515,9
"2011","Bexley 020G","E01000393","Total",651,640,11
"2011","Bexley 021A","E01000346","Total",630,625,5
"2011","Bexley 021B","E01000347","Total",641,618,23
"2011","Bexley 021C","E01000350","Total",531,521,10
"2011","Bexley 021D","E01000352","Total",707,676,31
"2011","Bexley 021E","E01000391","Total",653,644,9
"2011","Bexley 022A","E01000341","Total",621,610,11
"2011","Bexley 022B","E01000342","Total",652,644,8
"2011","Bexley 022C","E01000343","Total",558,550,8
"2011","Bexley 022D","E01000345","Total",499,487,12
"2011","Bexley 022E","E01000460","Total",503,498,5
"2011","Bexley 023A","E01000364","Total",662,651,11
"2011","Bexley 023B","E01000444","Total",632,626,6
"2011","Bexley 023C","E01000447","Total",752,713,39
"2011","Bexley 023D","E01000448","Total",513,504,9
"2011","Bexley 023E","E01000449","Total",665,648,17
"2011","Bexley 024A","E01000351","Total",632,616,16
"2011","Bexley 024B","E01000443","Total",520,510,10
"2011","Bexley 024C","E01000445","Total",697,687,10
"2011","Bexley 024D","E01000446","Total",611,602,9
"2011","Bexley 024E","E01000461","Total",576,569,7
"2011","Bexley 025A","E01000339","Total",613,602,11
"2011","Bexley 025B","E01000344","Total",657,646,11
"2011","Bexley 025C","E01000423","Total",619,609,10
"2011","Bexley 025D","E01000425","Total",594,590,4
"2011","Bexley 025E","E01000463","Total",457,452,5
"2011","Bexley 026A","E01000424","Total",775,765,10
"2011","Bexley 026B","E01000426","Total",724,712,12
"2011","Bexley 026C","E01000427","Total",942,922,20
"2011","Bexley 026D","E01000457","Total",878,825,53
"2011","Bexley 026E","E01000462","Total",775,738,37
"2011","Bexley 027A","E01000382","Total",601,587,14
"2011","Bexley 027B","E01000384","Total",793,780,13
"2011","Bexley 027C","E01000387","Total",630,618,12
"2011","Bexley 027D","E01000428","Total",963,882,81
"2011","Bexley 027E","E01000458","Total",656,631,25
"2011","Bexley 027F","E01000459","Total",806,781,25
"2011","Bexley 028A","E01000381","Total",680,660,20
"2011","Bexley 028B","E01000383","Total",652,633,19
"2011","Bexley 028C","E01000385","Total",786,770,16
"2011","Bexley 028D","E01000386","Total",668,659,9
"2011","Bexley 029A","E01000398","Total",620,611,9
"2011","Bexley 029B","E01000399","Total",628,619,9
"2011","Bexley 029C","E01000400","Total",614,590,24
"2011","Bexley 029D","E01032566","Total",770,747,23
"2011","Brent 001A","E01000587","Total",464,458,6
"2011","Brent 001B","E01000589","Total",600,592,8
"2011","Brent 001C","E01000590","Total",635,626,9
"2011","Brent 001D","E01000592","Total",540,525,15
"2011","Brent 001E","E01000593","Total",693,680,13
"2011","Brent 001F","E01000594","Total",539,527,12
"2011","Brent 002A","E01000513","Total",478,471,7
"2011","Brent 002B","E01000514","Total",508,495,13
"2011","Brent 002C","E01000516","Total",538,517,21
"2011","Brent 002D","E01000520","Total",607,586,21
"2011","Brent 002E","E01000588","Total",681,669,12
"2011","Brent 003A","E01000515","Total",650,628,22
"2011","Brent 003B","E01000517","Total",506,491,15
"2011","Brent 003E","E01000543","Total",506,500,6
"2011","Brent 003F","E01000591","Total",658,650,8
"2011","Brent 003G","E01033463","Total",865,848,17
"2011","Brent 004A","E01000536","Total",539,522,17
"2011","Brent 004B","E01000538","Total",489,478,11
"2011","Brent 004C","E01000539","Total",562,548,14
"2011","Brent 004D","E01000540","Total",480,471,9
"2011","Brent 004E","E01000541","Total",512,499,13
"2011","Brent 005A","E01000518","Total",568,557,11
"2011","Brent 005B","E01000519","Total",648,629,19
"2011","Brent 005C","E01000623","Total",544,541,3
"2011","Brent 005D","E01000624","Total",611,594,17
"2011","Brent 005E","E01000629","Total",611,605,6
"2011","Brent 006A","E01000480","Total",549,535,14
"2011","Brent 006B","E01000484","Total",432,423,9
"2011","Brent 006C","E01000485","Total",497,488,9
"2011","Brent 006D","E01000486","Total",550,532,18
"2011","Brent 006E","E01000487","Total",703,674,29
"2011","Brent 007A","E01000572","Total",470,462,8
"2011","Brent 007B","E01000573","Total",491,474,17
"2011","Brent 007C","E01000574","Total",439,428,11
"2011","Brent 007D","E01000575","Total",639,625,14
"2011","Brent 007E","E01000577","Total",811,793,18
"2011","Brent 008A","E01000562","Total",490,480,10
"2011","Brent 008B","E01000563","Total",486,474,12
"2011","Brent 008C","E01000566","Total",481,475,6
"2011","Brent 008D","E01000568","Total",903,787,116
"2011","Brent 008E","E01000569","Total",489,480,9
"2011","Brent 009A","E01000479","Total",521,510,11
"2011","Brent 009B","E01000481","Total",626,610,16
"2011","Brent 009C","E01000482","Total",1018,992,26
"2011","Brent 009D","E01000483","Total",650,643,7
"2011","Brent 009E","E01000625","Total",580,557,23
"2011","Brent 010B","E01000498","Total",465,457,8
"2011","Brent 010D","E01000622","Total",653,636,17
"2011","Brent 010E","E01000626","Total",602,590,12
"2011","Brent 010F","E01033464","Total",825,813,12
"2011","Brent 011A","E01000497","Total",598,586,12
"2011","Brent 011B","E01000499","Total",508,500,8
"2011","Brent 011C","E01000501","Total",754,734,20
"2011","Brent 011D","E01000502","Total",464,453,11
"2011","Brent 011E","E01000503","Total",743,721,22
"2011","Brent 012A","E01000570","Total",524,513,11
"2011","Brent 012B","E01000571","Total",490,477,13
"2011","Brent 012C","E01000576","Total",544,534,10
"2011","Brent 012D","E01000578","Total",710,689,21
"2011","Brent 013A","E01000564","Total",470,460,10
"2011","Brent 013B","E01000565","Total",505,497,8
"2011","Brent 013C","E01000607","Total",677,667,10
"2011","Brent 013D","E01000608","Total",744,734,10
"2011","Brent 013E","E01000613","Total",673,639,34
"2011","Brent 014A","E01000506","Total",682,657,25
"2011","Brent 014B","E01000509","Total",438,430,8
"2011","Brent 014C","E01000510","Total",550,533,17
"2011","Brent 014D","E01000511","Total",553,543,10
"2011","Brent 014E","E01000627","Total",675,653,22
"2011","Brent 014F","E01000628","Total",647,633,14
"2011","Brent 015A","E01000553","Total",716,696,20
"2011","Brent 015B","E01000554","Total",704,683,21
"2011","Brent 015C","E01000555","Total",532,512,20
"2011","Brent 015D","E01000556","Total",837,800,37
"2011","Brent 015E","E01000557","Total",769,751,18
"2011","Brent 015F","E01000558","Total",685,665,20
"2011","Brent 016A","E01000567","Total",492,486,6
"2011","Brent 016B","E01000606","Total",574,567,7
"2011","Brent 016C","E01000609","Total",654,640,14
"2011","Brent 016D","E01000611","Total",460,454,6
"2011","Brent 017B","E01000615","Total",578,563,15
"2011","Brent 017C","E01000617","Total",550,528,22
"2011","Brent 017D","E01000618","Total",512,500,12
"2011","Brent 017E","E01000619","Total",484,473,11
"2011","Brent 017F","E01033424","Total",707,638,69
"2011","Brent 017G","E01033457","Total",587,562,25
"2011","Brent 018A","E01000504","Total",693,676,17
"2011","Brent 018B","E01000505","Total",539,525,14
"2011","Brent 018C","E01000507","Total",512,508,4
"2011","Brent 018D","E01000512","Total",621,610,11
"2011","Brent 018E","E01000559","Total",660,650,10
"2011","Brent 019A","E01000610","Total",632,621,11
"2011","Brent 019B","E01000612","Total",530,521,9
"2011","Brent 019C","E01000631","Total",528,522,6
"2011","Brent 019D","E01000633","Total",571,554,17
"2011","Brent 019E","E01000634","Total",709,696,13
"2011","Brent 020A","E01000616","Total",601,586,15
"2011","Brent 020B","E01000620","Total",508,500,8
"2011","Brent 020C","E01000621","Total",524,514,10
"2011","Brent 020D","E01000635","Total",841,774,67
"2011","Brent 020E","E01000636","Total",551,518,33
"2011","Brent 021A","E01000596","Total",654,640,14
"2011","Brent 021B","E01000601","Total",485,477,8
"2011","Brent 021C","E01000602","Total",516,512,4
"2011","Brent 021D","E01000603","Total",592,576,16
"2011","Brent 021E","E01000604","Total",549,548,1
"2011","Brent 021F","E01000605","Total",556,553,3
"2011","Brent 022A","E01000488","Total",549,533,16
"2011","Brent 022B","E01000637","Total",657,636,21
"2011","Brent 022C","E01000639","Total",734,716,18
"2011","Brent 022D","E01000642","Total",947,915,32
"2011","Brent 022E","E01000644","Total",737,728,9
"2011","Brent 023A","E01000490","Total",830,787,43
"2011","Brent 023B","E01000494","Total",754,724,30
"2011","Brent 023C","E01000495","Total",876,850,26
"2011","Brent 023D","E01000560","Total",742,727,15
"2011","Brent 023E","E01000561","Total",851,823,28
"2011","Brent 024A","E01000638","Total",731,715,16
"2011","Brent 024B","E01000640","Total",816,802,14
"2011","Brent 024C","E01000641","Total",737,715,22
"2011","Brent 024D","E01000643","Total",854,840,14
"2011","Brent 025A","E01000508","Total",736,716,20
"2011","Brent 025B","E01000521","Total",941,905,36
"2011","Brent 025C","E01000522","Total",715,710,5
"2011","Brent 025D","E01000526","Total",824,813,11
"2011","Brent 025E","E01000527","Total",830,813,17
"2011","Brent 025F","E01000528","Total",608,600,8
"2011","Brent 026A","E01000471","Total",476,469,7
"2011","Brent 026B","E01000474","Total",503,501,2
"2011","Brent 026C","E01000476","Total",463,455,8
"2011","Brent 026D","E01000477","Total",676,656,20
"2011","Brent 026E","E01000630","Total",778,768,10
"2011","Brent 027A","E01000595","Total",595,582,13
"2011","Brent 027D","E01000599","Total",497,489,8
"2011","Brent 027E","E01000600","Total",800,783,17
"2011","Brent 027F","E01033456","Total",777,743,34
"2011","Brent 028A","E01000545","Total",887,856,31
"2011","Brent 028B","E01000546","Total",784,756,28
"2011","Brent 028C","E01000547","Total",789,768,21
"2011","Brent 028D","E01000548","Total",1059,1014,45
"2011","Brent 028E","E01000549","Total",904,883,21
"2011","Brent 029A","E01000472","Total",521,512,9
"2011","Brent 029B","E01000473","Total",746,520,226
"2011","Brent 029C","E01000475","Total",600,596,4
"2011","Brent 029D","E01000478","Total",459,447,12
"2011","Brent 029E","E01000632","Total",562,548,14
"2011","Brent 030A","E01000489","Total",611,593,18
"2011","Brent 030B","E01000491","Total",836,806,30
"2011","Brent 030C","E01000492","Total",480,467,13
"2011","Brent 030D","E01000493","Total",592,578,14
"2011","Brent 030E","E01000581","Total",630,603,27
"2011","Brent 031A","E01000523","Total",1014,993,21
"2011","Brent 031B","E01000524","Total",1057,1035,22
"2011","Brent 031C","E01000525","Total",796,785,11
"2011","Brent 031E","E01000533","Total",975,952,23
"2011","Brent 031F","E01000535","Total",845,829,16
"2011","Brent 031G","E01033455","Total",511,501,10
"2011","Brent 031H","E01033485","Total",801,789,12
"2011","Brent 032A","E01000579","Total",696,683,13
"2011","Brent 032B","E01000580","Total",843,821,22
"2011","Brent 032C","E01000582","Total",747,720,27
"2011","Brent 032D","E01000583","Total",1039,1017,22
"2011","Brent 032E","E01000586","Total",1126,1093,33
"2011","Brent 033A","E01000530","Total",716,700,16
"2011","Brent 033B","E01000531","Total",924,908,16
"2011","Brent 033C","E01000532","Total",744,733,11
"2011","Brent 033D","E01000534","Total",668,651,17
"2011","Brent 033E","E01000584","Total",634,619,15
"2011","Brent 033F","E01000585","Total",731,718,13
"2011","Brent 034A","E01000544","Total",751,742,9
"2011","Brent 034B","E01000550","Total",920,906,14
"2011","Brent 034C","E01000551","Total",947,940,7
"2011","Brent 034D","E01000552","Total",799,793,6
"2011","Bromley 001A","E01000779","Total",605,551,54
"2011","Bromley 001B","E01000780","Total",663,628,35
"2011","Bromley 001C","E01000781","Total",639,614,25
"2011","Bromley 001D","E01000782","Total",687,647,40
"2011","Bromley 001E","E01000783","Total",649,626,23
"2011","Bromley 001F","E01000785","Total",641,609,32
"2011","Bromley 002A","E01000689","Total",637,612,25
"2011","Bromley 002B","E01000690","Total",543,534,9
"2011","Bromley 002C","E01000691","Total",636,619,17
"2011","Bromley 002D","E01000692","Total",690,659,31
"2011","Bromley 002E","E01000784","Total",604,582,22
"2011","Bromley 004A","E01000799","Total",749,719,30
"2011","Bromley 004B","E01000802","Total",775,750,25
"2011","Bromley 004C","E01000803","Total",754,730,24
"2011","Bromley 004D","E01000804","Total",569,548,21
"2011","Bromley 004E","E01000805","Total",758,717,41
"2011","Bromley 005A","E01000740","Total",902,871,31
"2011","Bromley 005B","E01000741","Total",870,842,28
"2011","Bromley 005C","E01000742","Total",1077,1044,33
"2011","Bromley 005D","E01000745","Total",905,883,22
"2011","Bromley 005E","E01000746","Total",965,949,16
"2011","Bromley 006A","E01000709","Total",816,787,29
"2011","Bromley 006B","E01000710","Total",897,862,35
"2011","Bromley 006C","E01000711","Total",1034,1012,22
"2011","Bromley 006D","E01000714","Total",1104,1036,68
"2011","Bromley 006E","E01000718","Total",990,971,19
"2011","Bromley 007A","E01000645","Total",547,536,11
"2011","Bromley 007B","E01000649","Total",809,774,35
"2011","Bromley 007C","E01000694","Total",666,635,31
"2011","Bromley 007D","E01000695","Total",642,614,28
"2011","Bromley 007E","E01000696","Total",688,637,51
"2011","Bromley 007F","E01000697","Total",838,765,73
"2011","Bromley 008A","E01000674","Total",823,802,21
"2011","Bromley 008B","E01000676","Total",956,866,90
"2011","Bromley 008C","E01000820","Total",676,643,33
"2011","Bromley 008D","E01000822","Total",757,727,30
"2011","Bromley 008E","E01000823","Total",791,747,44
"2011","Bromley 008F","E01000824","Total",545,514,31
"2011","Bromley 008G","E01000825","Total",858,807,51
"2011","Bromley 009A","E01000743","Total",868,841,27
"2011","Bromley 009B","E01000744","Total",705,682,23
"2011","Bromley 009C","E01000796","Total",651,638,13
"2011","Bromley 009D","E01000798","Total",717,693,24
"2011","Bromley 009E","E01000800","Total",800,780,20
"2011","Bromley 009F","E01000806","Total",802,768,34
"2011","Bromley 010A","E01000693","Total",618,570,48
"2011","Bromley 010B","E01000698","Total",454,439,15
"2011","Bromley 010C","E01000736","Total",643,618,25
"2011","Bromley 010D","E01000737","Total",606,580,26
"2011","Bromley 011A","E01000672","Total",679,650,29
"2011","Bromley 011B","E01000673","Total",644,630,14
"2011","Bromley 011C","E01000716","Total",722,702,20
"2011","Bromley 011D","E01000717","Total",910,889,21
"2011","Bromley 011E","E01000828","Total",795,766,29
"2011","Bromley 012A","E01000712","Total",906,862,44
"2011","Bromley 012B","E01000713","Total",901,885,16
"2011","Bromley 012C","E01000715","Total",939,885,54
"2011","Bromley 012D","E01000770","Total",719,691,28
"2011","Bromley 012E","E01000772","Total",756,734,22
"2011","Bromley 013A","E01000700","Total",678,666,12
"2011","Bromley 013B","E01000702","Total",584,572,12
"2011","Bromley 013C","E01000703","Total",740,694,46
"2011","Bromley 013D","E01000706","Total",615,591,24
"2011","Bromley 013E","E01000797","Total",699,679,20
"2011","Bromley 014A","E01000729","Total",841,824,17
"2011","Bromley 014B","E01000730","Total",662,649,13
"2011","Bromley 014C","E01000735","Total",570,562,8
"2011","Bromley 014D","E01000738","Total",649,632,17
"2011","Bromley 014E","E01000739","Total",641,634,7
"2011","Bromley 015A","E01000699","Total",697,648,49
"2011","Bromley 015B","E01000701","Total",616,599,17
"2011","Bromley 015C","E01000704","Total",635,593,42
"2011","Bromley 015D","E01000705","Total",598,565,33
"2011","Bromley 015E","E01000801","Total",681,650,31
"2011","Bromley 016A","E01000646","Total",777,728,49
"2011","Bromley 016B","E01000647","Total",650,635,15
"2011","Bromley 016C","E01000648","Total",676,646,30
"2011","Bromley 016D","E01000653","Total",620,608,12
"2011","Bromley 016E","E01000678","Total",687,666,21
"2011","Bromley 018A","E01000670","Total",919,864,55
"2011","Bromley 018B","E01000675","Total",751,690,61
"2011","Bromley 018C","E01000677","Total",828,800,28
"2011","Bromley 018D","E01000762","Total",770,743,27
"2011","Bromley 018E","E01000829","Total",751,734,17
"2011","Bromley 019A","E01000719","Total",880,853,27
"2011","Bromley 019B","E01000720","Total",688,668,20
"2011","Bromley 019C","E01000721","Total",531,524,7
"2011","Bromley 019D","E01000724","Total",689,674,15
"2011","Bromley 019E","E01000728","Total",681,657,24
"2011","Bromley 020A","E01000651","Total",641,631,10
"2011","Bromley 020B","E01000668","Total",726,691,35
"2011","Bromley 020C","E01000669","Total",758,740,18
"2011","Bromley 020D","E01000671","Total",859,784,75
"2011","Bromley 020E","E01000679","Total",688,662,26
"2011","Bromley 021A","E01000826","Total",571,563,8
"2011","Bromley 021B","E01000827","Total",819,790,29
"2011","Bromley 021C","E01000830","Total",557,544,13
"2011","Bromley 021D","E01000831","Total",812,789,23
"2011","Bromley 021E","E01000833","Total",504,497,7
"2011","Bromley 022A","E01000650","Total",769,750,19
"2011","Bromley 022B","E01000652","Total",684,659,25
"2011","Bromley 022C","E01000807","Total",619,595,24
"2011","Bromley 022D","E01000809","Total",637,629,8
"2011","Bromley 023A","E01000722","Total",734,704,30
"2011","Bromley 023B","E01000725","Total",796,775,21
"2011","Bromley 023C","E01000731","Total",536,532,4
"2011","Bromley 023D","E01000732","Total",594,587,7
"2011","Bromley 023E","E01000733","Total",659,651,8
"2011","Bromley 024A","E01000769","Total",457,454,3
"2011","Bromley 024B","E01000773","Total",621,605,16
"2011","Bromley 024C","E01000775","Total",904,867,37
"2011","Bromley 024D","E01000777","Total",570,565,5
"2011","Bromley 024E","E01000778","Total",629,618,11
"2011","Bromley 025A","E01000808","Total",633,625,8
"2011","Bromley 025B","E01000810","Total",607,599,8
"2011","Bromley 025C","E01000811","Total",590,571,19
"2011","Bromley 025D","E01000813","Total",645,637,8
"2011","Bromley 025E","E01000815","Total",572,562,10
"2011","Bromley 026A","E01000661","Total",788,671,117
"2011","Bromley 026B","E01000662","Total",693,680,13
"2011","Bromley 026C","E01000663","Total",675,660,15
"2011","Bromley 026D","E01000664","Total",636,612,24
"2011","Bromley 027A","E01000763","Total",532,523,9
"2011","Bromley 027B","E01000764","Total",650,633,17
"2011","Bromley 027C","E01000766","Total",654,645,9
"2011","Bromley 027D","E01000767","Total",611,598,13
"2011","Bromley 027E","E01000834","Total",463,461,2
"2011","Bromley 028A","E01000727","Total",712,687,25
"2011","Bromley 028B","E01000734","Total",524,507,17
"2011","Bromley 028C","E01000790","Total",907,872,35
"2011","Bromley 028D","E01000812","Total",686,663,23
"2011","Bromley 028E","E01000814","Total",573,564,9
"2011","Bromley 029A","E01000723","Total",569,561,8
"2011","Bromley 029B","E01000726","Total",596,590,6
"2011","Bromley 029C","E01000787","Total",689,667,22
"2011","Bromley 029D","E01000788","Total",632,618,14
"2011","Bromley 029E","E01000791","Total",639,621,18
"2011","Bromley 030A","E01000832","Total",600,572,28
"2011","Bromley 030B","E01000835","Total",678,648,30
"2011","Bromley 030C","E01000836","Total",503,500,3
"2011","Bromley 030D","E01000837","Total",671,647,24
"2011","Bromley 030E","E01000838","Total",561,548,13
"2011","Bromley 030F","E01000839","Total",557,550,7
"2011","Bromley 030G","E01000840","Total",699,685,14
"2011","Bromley 030H","E01000841","Total",626,606,20
"2011","Bromley 031A","E01000753","Total",768,750,18
"2011","Bromley 031B","E01000754","Total",773,743,30
"2011","Bromley 031C","E01000755","Total",634,615,19
"2011","Bromley 031D","E01000757","Total",611,601,10
"2011","Bromley 031E","E01000758","Total",599,591,8
"2011","Bromley 032A","E01000786","Total",636,627,9
"2011","Bromley 032B","E01000789","Total",668,657,11
"2011","Bromley 032C","E01000792","Total",500,483,17
"2011","Bromley 032D","E01000793","Total",648,643,5
"2011","Bromley 032E","E01000795","Total",548,542,6
"2011","Bromley 033A","E01000665","Total",774,757,17
"2011","Bromley 033B","E01000666","Total",800,776,24
"2011","Bromley 033C","E01000667","Total",659,622,37
"2011","Bromley 033D","E01000756","Total",654,594,60
"2011","Bromley 034A","E01000759","Total",553,549,4
"2011","Bromley 034B","E01000760","Total",577,550,27
"2011","Bromley 034C","E01000761","Total",585,577,8
"2011","Bromley 034D","E01000765","Total",697,679,18
"2011","Bromley 034E","E01000768","Total",632,613,19
"2011","Bromley 035A","E01000681","Total",666,654,12
"2011","Bromley 035B","E01000682","Total",656,642,14
"2011","Bromley 035C","E01000683","Total",723,705,18
"2011","Bromley 035D","E01000684","Total",764,757,7
"2011","Bromley 035E","E01000794","Total",620,611,9
"2011","Bromley 036A","E01000749","Total",655,639,16
"2011","Bromley 036B","E01000750","Total",671,665,6
"2011","Bromley 036C","E01000751","Total",837,807,30
"2011","Bromley 036D","E01000752","Total",803,778,25
"2011","Bromley 037A","E01000680","Total",664,646,18
"2011","Bromley 037B","E01000685","Total",624,618,6
"2011","Bromley 037C","E01000686","Total",654,648,6
"2011","Bromley 037D","E01000687","Total",675,656,19
"2011","Bromley 037E","E01000688","Total",521,504,17
"2011","Bromley 039A","E01000654","Total",499,486,13
"2011","Bromley 039B","E01000655","Total",503,494,9
"2011","Bromley 039C","E01000656","Total",528,517,11
"2011","Bromley 039D","E01000657","Total",687,674,13
"2011","Bromley 039E","E01000659","Total",528,520,8
"2011","Bromley 040A","E01000816","Total",630,592,38
"2011","Bromley 040B","E01000818","Total",586,568,18
"2011","Bromley 040C","E01000819","Total",778,740,38
"2011","Bromley 040D","E01032562","Total",650,623,27
"2011","Bromley 040E","E01032563","Total",603,568,35
"2011","Bromley 041A","E01000707","Total",543,536,7
"2011","Bromley 041B","E01000708","Total",664,650,14
"2011","Bromley 041C","E01000771","Total",642,620,22
"2011","Bromley 041D","E01000774","Total",598,581,17
"2011","Bromley 041E","E01032568","Total",662,647,15
"2011","Bromley 042A","E01000658","Total",564,550,14
"2011","Bromley 042B","E01000747","Total",816,773,43
"2011","Bromley 042C","E01000748","Total",698,670,28
"2011","Bromley 042D","E01032570","Total",723,669,54
"2011","Croydon 001A","E01001137","Total",903,875,28
"2011","Croydon 001B","E01001138","Total",785,774,11
"2011","Croydon 001C","E01001156","Total",745,721,24
"2011","Croydon 001D","E01001162","Total",778,767,11
"2011","Croydon 001E","E01001164","Total",982,962,20
"2011","Croydon 002A","E01001084","Total",684,665,19
"2011","Croydon 002B","E01001157","Total",632,615,17
"2011","Croydon 002C","E01001159","Total",761,741,20
"2011","Croydon 002D","E01001160","Total",638,627,11
"2011","Croydon 002E","E01001163","Total",820,798,22
"2011","Croydon 003A","E01001083","Total",543,536,7
"2011","Croydon 003B","E01001086","Total",613,603,10
"2011","Croydon 003C","E01001087","Total",883,848,35
"2011","Croydon 003D","E01001161","Total",570,566,4
"2011","Croydon 004A","E01001085","Total",635,612,23
"2011","Croydon 004B","E01001088","Total",602,592,10
"2011","Croydon 004C","E01001089","Total",733,715,18
"2011","Croydon 004D","E01001090","Total",942,922,20
"2011","Croydon 004E","E01001091","Total",583,562,21
"2011","Croydon 005A","E01001147","Total",646,620,26
"2011","Croydon 005B","E01001148","Total",686,673,13
"2011","Croydon 005C","E01001151","Total",689,671,18
"2011","Croydon 005D","E01001152","Total",696,674,22
"2011","Croydon 005E","E01001158","Total",712,700,12
"2011","Croydon 006A","E01001146","Total",617,607,10
"2011","Croydon 006B","E01001149","Total",629,619,10
"2011","Croydon 006C","E01001150","Total",650,620,30
"2011","Croydon 006D","E01001153","Total",601,591,10
"2011","Croydon 006E","E01001154","Total",751,735,16
"2011","Croydon 007A","E01001136","Total",966,927,39
"2011","Croydon 007B","E01001139","Total",700,694,6
"2011","Croydon 007C","E01001140","Total",784,773,11
"2011","Croydon 007D","E01001142","Total",651,620,31
"2011","Croydon 007E","E01001144","Total",817,797,20
"2011","Croydon 008A","E01001141","Total",577,568,9
"2011","Croydon 008B","E01001143","Total",872,848,24
"2011","Croydon 008C","E01001145","Total",870,848,22
"2011","Croydon 008D","E01001191","Total",886,823,63
"2011","Croydon 008E","E01001192","Total",746,727,19
"2011","Croydon 009A","E01000994","Total",547,536,11
"2011","Croydon 009B","E01000995","Total",609,597,12
"2011","Croydon 009C","E01000996","Total",458,443,15
"2011","Croydon 009D","E01000997","Total",485,471,14
"2011","Croydon 009E","E01000999","Total",443,436,7
"2011","Croydon 009F","E01001002","Total",517,498,19
"2011","Croydon 010A","E01000998","Total",635,629,6
"2011","Croydon 010B","E01001000","Total",467,454,13
"2011","Croydon 010C","E01001003","Total",615,608,7
"2011","Croydon 010D","E01001111","Total",641,610,31
"2011","Croydon 010E","E01001155","Total",776,761,15
"2011","Croydon 011A","E01001174","Total",534,523,11
"2011","Croydon 011B","E01001175","Total",537,527,10
"2011","Croydon 011C","E01001176","Total",640,628,12
"2011","Croydon 011D","E01001182","Total",484,462,22
"2011","Croydon 011E","E01001183","Total",568,550,18
"2011","Croydon 011F","E01001184","Total",461,456,5
"2011","Croydon 013A","E01001001","Total",506,493,13
"2011","Croydon 013B","E01001109","Total",865,845,20
"2011","Croydon 013C","E01001112","Total",799,763,36
"2011","Croydon 013D","E01001113","Total",842,795,47
"2011","Croydon 013E","E01001114","Total",625,585,40
"2011","Croydon 013F","E01001116","Total",571,528,43
"2011","Croydon 014A","E01000992","Total",730,723,7
"2011","Croydon 014B","E01001185","Total",734,717,17
"2011","Croydon 014C","E01001186","Total",859,841,18
"2011","Croydon 014D","E01001188","Total",743,728,15
"2011","Croydon 014E","E01001193","Total",590,583,7
"2011","Croydon 015A","E01001004","Total",793,787,6
"2011","Croydon 015B","E01001115","Total",665,657,8
"2011","Croydon 015C","E01001117","Total",1152,1113,39
"2011","Croydon 015D","E01001178","Total",519,505,14
"2011","Croydon 015E","E01001181","Total",782,759,23
"2011","Croydon 016A","E01001006","Total",624,616,8
"2011","Croydon 016B","E01001007","Total",612,605,7
"2011","Croydon 016C","E01001177","Total",558,551,7
"2011","Croydon 016D","E01001179","Total",547,538,9
"2011","Croydon 016E","E01001180","Total",624,609,15
"2011","Croydon 017A","E01000980","Total",576,566,10
"2011","Croydon 017B","E01000981","Total",673,647,26
"2011","Croydon 017C","E01000982","Total",698,684,14
"2011","Croydon 017D","E01000983","Total",679,665,14
"2011","Croydon 017E","E01001187","Total",825,809,16
"2011","Croydon 018A","E01000989","Total",644,628,16
"2011","Croydon 018B","E01000991","Total",679,662,17
"2011","Croydon 018C","E01001131","Total",690,685,5
"2011","Croydon 018D","E01001132","Total",623,607,16
"2011","Croydon 018E","E01001134","Total",713,697,16
"2011","Croydon 019A","E01001005","Total",550,536,14
"2011","Croydon 019B","E01001008","Total",549,538,11
"2011","Croydon 019C","E01001009","Total",617,609,8
"2011","Croydon 019D","E01001010","Total",544,539,5
"2011","Croydon 019E","E01001011","Total",782,755,27
"2011","Croydon 020A","E01001012","Total",772,746,26
"2011","Croydon 020B","E01001013","Total",913,899,14
"2011","Croydon 020C","E01001048","Total",1038,949,89
"2011","Croydon 020D","E01001110","Total",801,771,30
"2011","Croydon 020E","E01001118","Total",809,795,14
"2011","Croydon 021A","E01000985","Total",521,515,6
"2011","Croydon 021B","E01000986","Total",694,677,17
"2011","Croydon 021C","E01000987","Total",529,513,16
"2011","Croydon 021D","E01000993","Total",626,616,10
"2011","Croydon 022A","E01000975","Total",735,710,25
"2011","Croydon 022B","E01000976","Total",855,824,31
"2011","Croydon 022C","E01000977","Total",955,918,37
"2011","Croydon 022D","E01000978","Total",974,927,47
"2011","Croydon 022E","E01000979","Total",821,790,31
"2011","Croydon 022F","E01000984","Total",843,822,21
"2011","Croydon 023A","E01001044","Total",903,871,32
"2011","Croydon 023B","E01001046","Total",886,850,36
"2011","Croydon 023C","E01001049","Total",524,505,19
"2011","Croydon 023D","E01001050","Total",838,802,36
"2011","Croydon 024A","E01001014","Total",1224,1186,38
"2011","Croydon 024B","E01001042","Total",878,836,42
"2011","Croydon 024C","E01001165","Total",690,676,14
"2011","Croydon 024D","E01001166","Total",885,835,50
"2011","Croydon 024E","E01001168","Total",764,740,24
"2011","Croydon 025A","E01001127","Total",579,574,5
"2011","Croydon 025B","E01001128","Total",567,566,1
"2011","Croydon 025C","E01001130","Total",598,598,0
"2011","Croydon 025D","E01001135","Total",640,631,9
"2011","Croydon 026A","E01001062","Total",578,571,7
"2011","Croydon 026B","E01001063","Total",599,587,12
"2011","Croydon 026C","E01001064","Total",620,613,7
"2011","Croydon 026D","E01001129","Total",508,502,6
"2011","Croydon 026E","E01001133","Total",752,726,26
"2011","Croydon 027A","E01001035","Total",866,834,32
"2011","Croydon 027B","E01001043","Total",1257,1202,55
"2011","Croydon 027C","E01001045","Total",1142,953,189
"2011","Croydon 027D","E01001047","Total",895,869,26
"2011","Croydon 027E","E01001170","Total",1036,989,47
"2011","Croydon 028A","E01001167","Total",840,829,11
"2011","Croydon 028B","E01001169","Total",659,651,8
"2011","Croydon 028C","E01001171","Total",689,681,8
"2011","Croydon 028D","E01001172","Total",655,616,39
"2011","Croydon 028E","E01001173","Total",1115,1089,26
"2011","Croydon 029A","E01001036","Total",651,628,23
"2011","Croydon 029B","E01001037","Total",652,624,28
"2011","Croydon 029C","E01001038","Total",966,941,25
"2011","Croydon 029D","E01001039","Total",601,583,18
"2011","Croydon 029E","E01001040","Total",792,763,29
"2011","Croydon 030A","E01001051","Total",595,581,14
"2011","Croydon 030B","E01001052","Total",475,470,5
"2011","Croydon 030C","E01001054","Total",597,594,3
"2011","Croydon 030D","E01001056","Total",597,593,4
"2011","Croydon 030E","E01001057","Total",661,637,24
"2011","Croydon 031A","E01001033","Total",713,694,19
"2011","Croydon 031B","E01001034","Total",679,660,19
"2011","Croydon 031C","E01001041","Total",770,752,18
"2011","Croydon 031D","E01001095","Total",609,584,25
"2011","Croydon 031E","E01001100","Total",633,619,14
"2011","Croydon 032A","E01001053","Total",538,527,11
"2011","Croydon 032B","E01001055","Total",590,585,5
"2011","Croydon 032C","E01001077","Total",528,523,5
"2011","Croydon 032D","E01001078","Total",518,513,5
"2011","Croydon 032E","E01001082","Total",564,560,4
"2011","Croydon 033A","E01001120","Total",486,480,6
"2011","Croydon 033B","E01001122","Total",518,507,11
"2011","Croydon 033C","E01001123","Total",604,598,6
"2011","Croydon 033D","E01001124","Total",615,609,6
"2011","Croydon 033E","E01001125","Total",612,602,10
"2011","Croydon 034A","E01001058","Total",527,521,6
"2011","Croydon 034B","E01001059","Total",700,692,8
"2011","Croydon 034C","E01001060","Total",662,657,5
"2011","Croydon 034D","E01001061","Total",647,642,5
"2011","Croydon 034E","E01001065","Total",685,672,13
"2011","Croydon 034F","E01001066","Total",495,493,2
"2011","Croydon 034G","E01001119","Total",578,576,2
"2011","Croydon 034H","E01001126","Total",604,598,6
"2011","Croydon 035A","E01001032","Total",528,520,8
"2011","Croydon 035B","E01001101","Total",513,509,4
"2011","Croydon 035C","E01001102","Total",624,605,19
"2011","Croydon 035D","E01001107","Total",679,662,17
"2011","Croydon 035E","E01001108","Total",637,628,9
"2011","Croydon 036A","E01001076","Total",592,581,11
"2011","Croydon 036B","E01001079","Total",650,639,11
"2011","Croydon 036C","E01001080","Total",698,687,11
"2011","Croydon 036D","E01001081","Total",511,506,5
"2011","Croydon 037A","E01001073","Total",647,618,29
"2011","Croydon 037B","E01001092","Total",608,588,20
"2011","Croydon 037C","E01001093","Total",712,694,18
"2011","Croydon 037D","E01001096","Total",535,530,5
"2011","Croydon 037E","E01001097","Total",1098,1059,39
"2011","Croydon 037F","E01001098","Total",521,515,6
"2011","Croydon 038A","E01001028","Total",537,528,9
"2011","Croydon 038B","E01001029","Total",554,541,13
"2011","Croydon 038C","E01001030","Total",469,462,7
"2011","Croydon 038D","E01001031","Total",493,491,2
"2011","Croydon 038E","E01001094","Total",538,521,17
"2011","Croydon 039A","E01001103","Total",665,651,14
"2011","Croydon 039B","E01001105","Total",635,632,3
"2011","Croydon 039C","E01001106","Total",553,540,13
"2011","Croydon 039D","E01001121","Total",502,501,1
"2011","Croydon 040A","E01001069","Total",512,500,12
"2011","Croydon 040B","E01001070","Total",667,659,8
"2011","Croydon 040C","E01001075","Total",666,646,20
"2011","Croydon 040D","E01001099","Total",597,586,11
"2011","Croydon 041A","E01001015","Total",522,515,7
"2011","Croydon 041B","E01001016","Total",679,665,14
"2011","Croydon 041C","E01001023","Total",613,575,38
"2011","Croydon 041D","E01001067","Total",584,578,6
"2011","Croydon 041E","E01001074","Total",844,828,16
"2011","Croydon 042A","E01001068","Total",801,784,17
"2011","Croydon 042B","E01001071","Total",755,735,20
"2011","Croydon 042C","E01001072","Total",543,533,10
"2011","Croydon 042D","E01001104","Total",656,642,14
"2011","Croydon 043A","E01001017","Total",645,642,3
"2011","Croydon 043B","E01001024","Total",542,532,10
"2011","Croydon 043C","E01001025","Total",496,489,7
"2011","Croydon 043D","E01001026","Total",647,641,6
"2011","Croydon 043E","E01001027","Total",547,534,13
"2011","Croydon 044A","E01001018","Total",646,639,7
"2011","Croydon 044B","E01001019","Total",605,593,12
"2011","Croydon 044C","E01001020","Total",672,657,15
"2011","Croydon 044D","E01001021","Total",596,590,6
"2011","Croydon 044E","E01001022","Total",628,611,17
"2011","Croydon 045A","E01000990","Total",548,538,10
"2011","Croydon 045B","E01001189","Total",475,465,10
"2011","Croydon 045C","E01001190","Total",622,616,6
"2011","Croydon 045D","E01001194","Total",641,624,17
"2011","Croydon 045E","E01032569","Total",664,660,4
"2011","Ealing 001A","E01001269","Total",665,646,19
"2011","Ealing 001B","E01001271","Total",613,593,20
"2011","Ealing 001C","E01001309","Total",630,614,16
"2011","Ealing 001D","E01001310","Total",679,663,16
"2011","Ealing 001E","E01001311","Total",673,663,10
"2011","Ealing 002A","E01001307","Total",639,633,6
"2011","Ealing 002B","E01001308","Total",690,679,11
"2011","Ealing 002C","E01001312","Total",615,590,25
"2011","Ealing 002D","E01001313","Total",529,516,13
"2011","Ealing 002E","E01001314","Total",517,506,11
"2011","Ealing 003A","E01001315","Total",505,495,10
"2011","Ealing 003B","E01001316","Total",631,620,11
"2011","Ealing 003C","E01001317","Total",706,686,20
"2011","Ealing 003D","E01001318","Total",685,677,8
"2011","Ealing 003E","E01001320","Total",548,534,14
"2011","Ealing 003F","E01001321","Total",779,758,21
"2011","Ealing 004A","E01001270","Total",576,565,11
"2011","Ealing 004B","E01001319","Total",499,490,9
"2011","Ealing 004C","E01001322","Total",657,627,30
"2011","Ealing 004D","E01001323","Total",698,684,14
"2011","Ealing 005A","E01001341","Total",543,529,14
"2011","Ealing 005B","E01001342","Total",653,638,15
"2011","Ealing 005C","E01001343","Total",492,483,9
"2011","Ealing 005D","E01001345","Total",514,501,13
"2011","Ealing 006A","E01001265","Total",643,627,16
"2011","Ealing 006B","E01001266","Total",587,578,9
"2011","Ealing 006C","E01001267","Total",844,814,30
"2011","Ealing 006D","E01001272","Total",560,542,18
"2011","Ealing 006E","E01001349","Total",514,507,7
"2011","Ealing 007A","E01001344","Total",901,880,21
"2011","Ealing 007B","E01001346","Total",652,634,18
"2011","Ealing 007C","E01001347","Total",537,518,19
"2011","Ealing 007D","E01001348","Total",641,626,15
"2011","Ealing 008A","E01001257","Total",665,659,6
"2011","Ealing 008B","E01001324","Total",681,662,19
"2011","Ealing 008C","E01001326","Total",683,674,9
"2011","Ealing 008D","E01001330","Total",643,636,7
"2011","Ealing 008E","E01001332","Total",584,579,5
"2011","Ealing 009A","E01001325","Total",622,602,20
"2011","Ealing 009B","E01001327","Total",608,600,8
"2011","Ealing 009C","E01001328","Total",633,620,13
"2011","Ealing 009D","E01001329","Total",639,631,8
"2011","Ealing 009E","E01001331","Total",625,618,7
"2011","Ealing 010B","E01001258","Total",661,634,27
"2011","Ealing 010C","E01001262","Total",564,558,6
"2011","Ealing 010D","E01001263","Total",659,647,12
"2011","Ealing 010E","E01001264","Total",630,612,18
"2011","Ealing 010F","E01032743","Total",843,818,25
"2011","Ealing 010G","E01032744","Total",505,486,19
"2011","Ealing 011A","E01001276","Total",659,651,8
"2011","Ealing 011B","E01001277","Total",684,668,16
"2011","Ealing 011C","E01001278","Total",844,801,43
"2011","Ealing 011D","E01001280","Total",810,782,28
"2011","Ealing 012A","E01001218","Total",706,692,14
"2011","Ealing 012B","E01001260","Total",690,660,30
"2011","Ealing 012C","E01001261","Total",793,758,35
"2011","Ealing 012D","E01001268","Total",650,629,21
"2011","Ealing 013A","E01001209","Total",658,647,11
"2011","Ealing 013B","E01001211","Total",719,705,14
"2011","Ealing 013C","E01001279","Total",578,564,14
"2011","Ealing 013D","E01001281","Total",632,625,7
"2011","Ealing 014A","E01001217","Total",470,455,15
"2011","Ealing 014B","E01001259","Total",522,510,12
"2011","Ealing 014C","E01001291","Total",502,495,7
"2011","Ealing 014D","E01001292","Total",514,504,10
"2011","Ealing 014E","E01001293","Total",500,478,22
"2011","Ealing 015A","E01001196","Total",780,762,18
"2011","Ealing 015B","E01001238","Total",1317,1236,81
"2011","Ealing 015C","E01001239","Total",563,553,10
"2011","Ealing 015D","E01001246","Total",503,492,11
"2011","Ealing 015E","E01001247","Total",687,674,13
"2011","Ealing 016A","E01001210","Total",744,740,4
"2011","Ealing 016B","E01001282","Total",640,627,13
"2011","Ealing 016C","E01001283","Total",725,712,13
"2011","Ealing 016D","E01001285","Total",582,562,20
"2011","Ealing 016E","E01001286","Total",636,620,16
"2011","Ealing 016F","E01001287","Total",492,483,9
"2011","Ealing 017A","E01001294","Total",559,538,21
"2011","Ealing 017B","E01001295","Total",524,521,3
"2011","Ealing 017C","E01001296","Total",418,404,14
"2011","Ealing 017D","E01001297","Total",516,495,21
"2011","Ealing 017E","E01001298","Total",549,529,20
"2011","Ealing 018A","E01001204","Total",595,585,10
"2011","Ealing 018B","E01001205","Total",609,598,11
"2011","Ealing 018C","E01001206","Total",601,582,19
"2011","Ealing 018D","E01001207","Total",694,668,26
"2011","Ealing 018E","E01001208","Total",506,498,8
"2011","Ealing 018F","E01001212","Total",711,691,20
"2011","Ealing 019A","E01001222","Total",1206,1150,56
"2011","Ealing 019B","E01001224","Total",585,570,15
"2011","Ealing 019C","E01001226","Total",698,668,30
"2011","Ealing 019D","E01001227","Total",616,602,14
"2011","Ealing 019E","E01001228","Total",823,792,31
"2011","Ealing 020A","E01001221","Total",995,952,43
"2011","Ealing 020B","E01001223","Total",662,643,19
"2011","Ealing 020C","E01001225","Total",843,807,36
"2011","Ealing 020D","E01001235","Total",718,691,27
"2011","Ealing 020E","E01001236","Total",760,741,19
"2011","Ealing 020F","E01001273","Total",629,597,32
"2011","Ealing 020G","E01001274","Total",614,585,29
"2011","Ealing 020H","E01001275","Total",884,857,27
"2011","Ealing 021A","E01001195","Total",620,598,22
"2011","Ealing 021B","E01001197","Total",703,668,35
"2011","Ealing 021C","E01001198","Total",607,584,23
"2011","Ealing 021D","E01001199","Total",710,694,16
"2011","Ealing 022A","E01001284","Total",556,538,18
"2011","Ealing 022B","E01001288","Total",537,531,6
"2011","Ealing 022C","E01001289","Total",487,476,11
"2011","Ealing 022D","E01001290","Total",755,738,17
"2011","Ealing 023A","E01001213","Total",517,503,14
"2011","Ealing 023B","E01001214","Total",497,477,20
"2011","Ealing 023C","E01001215","Total",601,552,49
"2011","Ealing 023D","E01001216","Total",480,476,4
"2011","Ealing 023E","E01001361","Total",563,460,103
"2011","Ealing 024A","E01001240","Total",527,512,15
"2011","Ealing 024B","E01001241","Total",528,503,25
"2011","Ealing 024C","E01001242","Total",561,524,37
"2011","Ealing 024D","E01001243","Total",661,649,12
"2011","Ealing 024E","E01001244","Total",1151,1099,52
"2011","Ealing 024F","E01001245","Total",860,823,37
"2011","Ealing 025A","E01001200","Total",608,586,22
"2011","Ealing 025B","E01001201","Total",659,642,17
"2011","Ealing 025C","E01001202","Total",906,871,35
"2011","Ealing 025D","E01001203","Total",887,861,26
"2011","Ealing 025E","E01001351","Total",848,811,37
"2011","Ealing 026A","E01001359","Total",590,562,28
"2011","Ealing 026B","E01001360","Total",534,505,29
"2011","Ealing 026C","E01001362","Total",565,511,54
"2011","Ealing 026D","E01001363","Total",493,471,22
"2011","Ealing 026E","E01001364","Total",546,516,30
"2011","Ealing 026F","E01001365","Total",635,590,45
"2011","Ealing 027A","E01001231","Total",717,696,21
"2011","Ealing 027B","E01001234","Total",665,640,25
"2011","Ealing 027C","E01001350","Total",633,621,12
"2011","Ealing 027D","E01001352","Total",631,571,60
"2011","Ealing 027E","E01001354","Total",699,677,22
"2011","Ealing 028A","E01001249","Total",1065,1025,40
"2011","Ealing 028B","E01001250","Total",1020,983,37
"2011","Ealing 028C","E01001255","Total",622,608,14
"2011","Ealing 028D","E01001383","Total",674,662,12
"2011","Ealing 028E","E01001388","Total",770,743,27
"2011","Ealing 028F","E01001389","Total",749,726,23
"2011","Ealing 029A","E01001219","Total",680,674,6
"2011","Ealing 029B","E01001220","Total",490,471,19
"2011","Ealing 029C","E01001334","Total",538,522,16
"2011","Ealing 029D","E01001337","Total",484,452,32
"2011","Ealing 029E","E01001338","Total",529,518,11
"2011","Ealing 029F","E01001339","Total",579,568,11
"2011","Ealing 029G","E01001340","Total",522,506,16
"2011","Ealing 030A","E01001251","Total",679,659,20
"2011","Ealing 030B","E01001252","Total",794,768,26
"2011","Ealing 030C","E01001253","Total",687,670,17
"2011","Ealing 030D","E01001254","Total",789,750,39
"2011","Ealing 031A","E01001229","Total",609,597,12
"2011","Ealing 031B","E01001230","Total",646,629,17
"2011","Ealing 031C","E01001232","Total",620,612,8
"2011","Ealing 031D","E01001233","Total",616,599,17
"2011","Ealing 031E","E01001237","Total",672,652,20
"2011","Ealing 031F","E01001386","Total",757,735,22
"2011","Ealing 032A","E01001303","Total",636,624,12
"2011","Ealing 032B","E01001382","Total",574,564,10
"2011","Ealing 032C","E01001384","Total",690,677,13
"2011","Ealing 032D","E01001385","Total",696,667,29
"2011","Ealing 032E","E01001387","Total",746,713,33
"2011","Ealing 033A","E01001353","Total",738,718,20
"2011","Ealing 033B","E01001355","Total",789,760,29
"2011","Ealing 033C","E01001356","Total",852,841,11
"2011","Ealing 033D","E01001357","Total",438,426,12
"2011","Ealing 033E","E01001358","Total",599,586,13
"2011","Ealing 034A","E01001375","Total",729,706,23
"2011","Ealing 034B","E01001377","Total",754,718,36
"2011","Ealing 034C","E01001379","Total",731,709,22
"2011","Ealing 034D","E01001381","Total",778,738,40
"2011","Ealing 035A","E01001248","Total",596,581,15
"2011","Ealing 035B","E01001299","Total",662,651,11
"2011","Ealing 035C","E01001305","Total",647,634,13
"2011","Ealing 035D","E01001306","Total",726,713,13
"2011","Ealing 037A","E01001366","Total",581,543,38
"2011","Ealing 037B","E01001367","Total",564,527,37
"2011","Ealing 037C","E01001368","Total",475,456,19
"2011","Ealing 037D","E01001370","Total",567,532,35
"2011","Ealing 037E","E01001371","Total",623,594,29
"2011","Ealing 037F","E01001372","Total",518,493,25
"2011","Ealing 037G","E01001373","Total",464,412,52
"2011","Ealing 038A","E01001333","Total",594,563,31
"2011","Ealing 038B","E01001335","Total",542,524,18
"2011","Ealing 038C","E01001336","Total",548,519,29
"2011","Ealing 038D","E01001369","Total",553,525,28
"2011","Ealing 039A","E01001300","Total",620,608,12
"2011","Ealing 039B","E01001301","Total",743,707,36
"2011","Ealing 039C","E01001302","Total",627,614,13
"2011","Ealing 039D","E01001304","Total",730,705,25
"2011","Ealing 040A","E01001374","Total",827,805,22
"2011","Ealing 040B","E01001376","Total",771,743,28
"2011","Ealing 040C","E01001380","Total",812,762,50
"2011","Ealing 040D","E01032572","Total",805,758,47
"2011","Enfield 001A","E01001444","Total",653,638,15
"2011","Enfield 001B","E01001446","Total",725,714,11
"2011","Enfield 001C","E01001546","Total",659,640,19
"2011","Enfield 001D","E01001552","Total",675,659,16
"2011","Enfield 002A","E01001442","Total",626,617,9
"2011","Enfield 002B","E01001545","Total",679,665,14
"2011","Enfield 002C","E01001547","Total",672,659,13
"2011","Enfield 002D","E01001548","Total",694,676,18
"2011","Enfield 002E","E01001551","Total",670,661,9
"2011","Enfield 003B","E01001445","Total",1001,980,21
"2011","Enfield 003C","E01001447","Total",794,783,11
"2011","Enfield 003D","E01001448","Total",667,655,12
"2011","Enfield 003E","E01001449","Total",582,575,7
"2011","Enfield 003F","E01033148","Total",665,661,4
"2011","Enfield 003G","E01033150","Total",709,702,7
"2011","Enfield 004A","E01001408","Total",742,731,11
"2011","Enfield 004B","E01001411","Total",775,759,16
"2011","Enfield 004C","E01001412","Total",701,677,24
"2011","Enfield 004D","E01001413","Total",626,612,14
"2011","Enfield 004E","E01001414","Total",704,687,17
"2011","Enfield 005A","E01001407","Total",620,613,7
"2011","Enfield 005B","E01001409","Total",811,806,5
"2011","Enfield 005C","E01001410","Total",765,755,10
"2011","Enfield 005D","E01001516","Total",659,648,11
"2011","Enfield 005E","E01001537","Total",721,709,12
"2011","Enfield 006A","E01001439","Total",805,790,15
"2011","Enfield 006B","E01001441","Total",642,637,5
"2011","Enfield 006C","E01001517","Total",701,696,5
"2011","Enfield 006D","E01001549","Total",838,798,40
"2011","Enfield 006E","E01001550","Total",580,570,10
"2011","Enfield 007A","E01001433","Total",594,584,10
"2011","Enfield 007B","E01001434","Total",562,551,11
"2011","Enfield 007C","E01001435","Total",494,489,5
"2011","Enfield 007D","E01001436","Total",667,653,14
"2011","Enfield 007E","E01001438","Total",575,566,9
"2011","Enfield 008A","E01001469","Total",644,633,11
"2011","Enfield 008B","E01001536","Total",808,742,66
"2011","Enfield 008C","E01001540","Total",819,794,25
"2011","Enfield 008D","E01001541","Total",664,650,14
"2011","Enfield 008E","E01001542","Total",700,678,22
"2011","Enfield 009A","E01001538","Total",608,603,5
"2011","Enfield 009B","E01001539","Total",674,657,17
"2011","Enfield 009C","E01001543","Total",602,596,6
"2011","Enfield 009D","E01001544","Total",637,610,27
"2011","Enfield 010A","E01001457","Total",824,798,26
"2011","Enfield 010B","E01001468","Total",534,524,10
"2011","Enfield 010C","E01001471","Total",969,930,39
"2011","Enfield 010D","E01001472","Total",802,771,31
"2011","Enfield 010E","E01001474","Total",879,840,39
"2011","Enfield 011A","E01001415","Total",692,677,15
"2011","Enfield 011B","E01001417","Total",624,601,23
"2011","Enfield 011C","E01001418","Total",716,703,13
"2011","Enfield 011D","E01001422","Total",583,559,24
"2011","Enfield 012A","E01001440","Total",609,597,12
"2011","Enfield 012B","E01001504","Total",519,513,6
"2011","Enfield 012C","E01001505","Total",581,567,14
"2011","Enfield 012D","E01001507","Total",793,766,27
"2011","Enfield 012E","E01001508","Total",725,718,7
"2011","Enfield 012F","E01001513","Total",634,623,11
"2011","Enfield 013A","E01001416","Total",608,598,10
"2011","Enfield 013B","E01001470","Total",663,641,22
"2011","Enfield 013C","E01001473","Total",558,547,11
"2011","Enfield 013D","E01001475","Total",647,635,12
"2011","Enfield 014A","E01001437","Total",995,990,5
"2011","Enfield 014B","E01001506","Total",577,565,12
"2011","Enfield 014C","E01001509","Total",702,688,14
"2011","Enfield 014D","E01001510","Total",618,610,8
"2011","Enfield 015A","E01001405","Total",896,862,34
"2011","Enfield 015B","E01001406","Total",695,675,20
"2011","Enfield 015C","E01001450","Total",976,924,52
"2011","Enfield 015D","E01001512","Total",807,782,25
"2011","Enfield 015E","E01001515","Total",778,755,23
"2011","Enfield 016A","E01001401","Total",508,501,7
"2011","Enfield 016B","E01001478","Total",550,544,6
"2011","Enfield 016C","E01001484","Total",522,516,6
"2011","Enfield 016D","E01001511","Total",670,648,22
"2011","Enfield 016E","E01001514","Total",699,685,14
"2011","Enfield 016F","E01001518","Total",702,684,18
"2011","Enfield 017A","E01001451","Total",673,661,12
"2011","Enfield 017B","E01001452","Total",496,488,8
"2011","Enfield 017C","E01001453","Total",676,661,15
"2011","Enfield 017D","E01001454","Total",675,660,15
"2011","Enfield 018A","E01001476","Total",616,593,23
"2011","Enfield 018B","E01001477","Total",619,607,12
"2011","Enfield 018C","E01001481","Total",562,556,6
"2011","Enfield 018D","E01001502","Total",610,599,11
"2011","Enfield 018E","E01001503","Total",662,654,8
"2011","Enfield 019A","E01001520","Total",691,673,18
"2011","Enfield 019B","E01001522","Total",762,751,11
"2011","Enfield 019C","E01001523","Total",754,738,16
"2011","Enfield 019D","E01001524","Total",558,546,12
"2011","Enfield 019E","E01001526","Total",661,639,22
"2011","Enfield 020A","E01001419","Total",810,794,16
"2011","Enfield 020B","E01001420","Total",578,569,9
"2011","Enfield 020C","E01001421","Total",745,714,31
"2011","Enfield 020D","E01001519","Total",1193,1141,52
"2011","Enfield 020E","E01001525","Total",736,723,13
"2011","Enfield 021A","E01001398","Total",500,491,9
"2011","Enfield 021B","E01001399","Total",508,499,9
"2011","Enfield 021C","E01001400","Total",599,587,12
"2011","Enfield 021D","E01001402","Total",713,691,22
"2011","Enfield 021E","E01001403","Total",653,633,20
"2011","Enfield 021F","E01001455","Total",589,581,8
"2011","Enfield 022A","E01001456","Total",487,481,6
"2011","Enfield 022B","E01001564","Total",658,646,12
"2011","Enfield 022C","E01001567","Total",645,632,13
"2011","Enfield 022D","E01001568","Total",547,538,9
"2011","Enfield 022E","E01001569","Total",802,778,24
"2011","Enfield 023A","E01001479","Total",647,639,8
"2011","Enfield 023B","E01001482","Total",696,690,6
"2011","Enfield 023C","E01001487","Total",736,723,13
"2011","Enfield 023D","E01001489","Total",675,664,11
"2011","Enfield 023E","E01001491","Total",731,722,9
"2011","Enfield 024A","E01001459","Total",564,556,8
"2011","Enfield 024B","E01001460","Total",693,660,33
"2011","Enfield 024C","E01001462","Total",545,531,14
"2011","Enfield 024D","E01001480","Total",591,588,3
"2011","Enfield 024E","E01001488","Total",678,663,15
"2011","Enfield 025A","E01001483","Total",617,609,8
"2011","Enfield 025B","E01001485","Total",697,682,15
"2011","Enfield 025C","E01001486","Total",829,818,11
"2011","Enfield 025E","E01001492","Total",689,680,9
"2011","Enfield 025F","E01033146","Total",597,593,4
"2011","Enfield 025G","E01033151","Total",547,541,6
"2011","Enfield 026A","E01001404","Total",537,525,12
"2011","Enfield 026B","E01001493","Total",747,735,12
"2011","Enfield 026C","E01001494","Total",513,510,3
"2011","Enfield 026D","E01001496","Total",607,602,5
"2011","Enfield 026E","E01001570","Total",757,751,6
"2011","Enfield 027A","E01001423","Total",654,643,11
"2011","Enfield 027B","E01001425","Total",758,737,21
"2011","Enfield 027C","E01001428","Total",616,611,5
"2011","Enfield 027D","E01001461","Total",726,707,19
"2011","Enfield 027E","E01001464","Total",427,422,5
"2011","Enfield 028A","E01001521","Total",710,698,12
"2011","Enfield 028B","E01001531","Total",550,544,6
"2011","Enfield 028C","E01001532","Total",696,687,9
"2011","Enfield 028D","E01001533","Total",542,530,12
"2011","Enfield 028E","E01001535","Total",510,505,5
"2011","Enfield 029A","E01001495","Total",746,731,15
"2011","Enfield 029B","E01001498","Total",777,746,31
"2011","Enfield 029C","E01001563","Total",686,669,17
"2011","Enfield 029D","E01001565","Total",739,709,30
"2011","Enfield 029E","E01001566","Total",636,626,10
"2011","Enfield 030A","E01001424","Total",499,496,3
"2011","Enfield 030B","E01001426","Total",634,628,6
"2011","Enfield 030C","E01001427","Total",692,683,9
"2011","Enfield 030D","E01001429","Total",1144,1134,10
"2011","Enfield 030E","E01001430","Total",660,653,7
"2011","Enfield 031A","E01001463","Total",519,513,6
"2011","Enfield 031B","E01001465","Total",517,506,11
"2011","Enfield 031C","E01001466","Total",626,620,6
"2011","Enfield 031D","E01001467","Total",643,634,9
"2011","Enfield 031E","E01001497","Total",539,531,8
"2011","Enfield 031F","E01001499","Total",570,564,6
"2011","Enfield 032A","E01001392","Total",671,665,6
"2011","Enfield 032B","E01001528","Total",557,553,4
"2011","Enfield 032C","E01001529","Total",647,635,12
"2011","Enfield 032D","E01001530","Total",477,467,10
"2011","Enfield 032E","E01001534","Total",599,588,11
"2011","Enfield 033A","E01001431","Total",633,614,19
"2011","Enfield 033B","E01001432","Total",709,700,9
"2011","Enfield 033C","E01001555","Total",639,624,15
"2011","Enfield 033D","E01001557","Total",551,546,5
"2011","Enfield 033E","E01001558","Total",571,558,13
"2011","Enfield 033F","E01001559","Total",750,743,7
"2011","Enfield 035A","E01001394","Total",662,640,22
"2011","Enfield 035B","E01001395","Total",623,620,3
"2011","Enfield 035C","E01001397","Total",788,783,5
"2011","Enfield 035D","E01001500","Total",562,554,8
"2011","Enfield 035E","E01001556","Total",546,543,3
"2011","Enfield 035F","E01001560","Total",526,516,10
"2011","Enfield 036A","E01001390","Total",777,762,15
"2011","Enfield 036B","E01001391","Total",710,687,23
"2011","Enfield 036C","E01001393","Total",845,839,6
"2011","Enfield 036D","E01001396","Total",522,511,11
"2011","Enfield 036E","E01001501","Total",837,818,19
"2011","Enfield 036F","E01001527","Total",666,645,21
"2011","Enfield 037A","E01001458","Total",667,664,3
"2011","Enfield 037B","E01001553","Total",537,530,7
"2011","Enfield 037C","E01001554","Total",761,756,5
"2011","Enfield 037D","E01001562","Total",732,711,21
"2011","Enfield 037E","E01032574","Total",705,695,10
"2011","Greenwich 001A","E01001690","Total",849,845,4
"2011","Greenwich 001B","E01001692","Total",526,522,4
"2011","Greenwich 001C","E01001693","Total",622,610,12
"2011","Greenwich 001D","E01001694","Total",603,598,5
"2011","Greenwich 002A","E01001687","Total",521,511,10
"2011","Greenwich 002B","E01001688","Total",951,937,14
"2011","Greenwich 002E","E01033739","Total",573,571,2
"2011","Greenwich 002F","E01033740","Total",553,550,3
"2011","Greenwich 002G","E01033741","Total",561,559,2
"2011","Greenwich 002H","E01033743","Total",682,663,19
"2011","Greenwich 002I","E01033745","Total",593,591,2
"2011","Greenwich 003A","E01001575","Total",612,599,13
"2011","Greenwich 003B","E01001576","Total",661,658,3
"2011","Greenwich 003C","E01001577","Total",747,737,10
"2011","Greenwich 003D","E01001578","Total",823,809,14
"2011","Greenwich 003E","E01001579","Total",647,637,10
"2011","Greenwich 004B","E01001709","Total",503,494,9
"2011","Greenwich 004C","E01001711","Total",624,612,12
"2011","Greenwich 004D","E01001712","Total",955,935,20
"2011","Greenwich 004E","E01033731","Total",574,559,15
"2011","Greenwich 004F","E01033734","Total",592,579,13
"2011","Greenwich 004G","E01033735","Total",573,555,18
"2011","Greenwich 004H","E01033736","Total",641,608,33
"2011","Greenwich 004I","E01033737","Total",614,602,12
"2011","Greenwich 005A","E01001705","Total",772,760,12
"2011","Greenwich 005B","E01001706","Total",487,479,8
"2011","Greenwich 005C","E01001708","Total",672,640,32
"2011","Greenwich 005D","E01001710","Total",699,685,14
"2011","Greenwich 005E","E01001713","Total",655,636,19
"2011","Greenwich 006A","E01001672","Total",646,630,16
"2011","Greenwich 006B","E01001673","Total",701,685,16
"2011","Greenwich 006C","E01001674","Total",682,671,11
"2011","Greenwich 006D","E01001675","Total",649,629,20
"2011","Greenwich 006E","E01001677","Total",694,668,26
"2011","Greenwich 007B","E01001631","Total",806,793,13
"2011","Greenwich 007C","E01001632","Total",647,635,12
"2011","Greenwich 007D","E01001635","Total",633,618,15
"2011","Greenwich 007E","E01001636","Total",609,593,16
"2011","Greenwich 007F","E01033742","Total",595,581,14
"2011","Greenwich 007G","E01033744","Total",662,646,16
"2011","Greenwich 008A","E01001571","Total",624,615,9
"2011","Greenwich 008B","E01001572","Total",644,628,16
"2011","Greenwich 008C","E01001573","Total",519,513,6
"2011","Greenwich 008D","E01001574","Total",776,768,8
"2011","Greenwich 009A","E01001629","Total",860,852,8
"2011","Greenwich 009B","E01001633","Total",659,652,7
"2011","Greenwich 009C","E01001634","Total",674,667,7
"2011","Greenwich 009D","E01001637","Total",736,706,30
"2011","Greenwich 011A","E01001695","Total",665,654,11
"2011","Greenwich 011B","E01001696","Total",606,506,100
"2011","Greenwich 011C","E01001697","Total",802,770,32
"2011","Greenwich 011D","E01001700","Total",728,703,25
"2011","Greenwich 011E","E01001703","Total",765,753,12
"2011","Greenwich 011F","E01001704","Total",643,615,28
"2011","Greenwich 012A","E01001588","Total",671,659,12
"2011","Greenwich 012B","E01001589","Total",635,616,19
"2011","Greenwich 012C","E01001591","Total",854,839,15
"2011","Greenwich 012D","E01001595","Total",700,693,7
"2011","Greenwich 014A","E01001590","Total",730,701,29
"2011","Greenwich 014B","E01001592","Total",748,740,8
"2011","Greenwich 014C","E01001593","Total",742,728,14
"2011","Greenwich 014D","E01001594","Total",789,763,26
"2011","Greenwich 015A","E01001698","Total",694,682,12
"2011","Greenwich 015B","E01001699","Total",620,602,18
"2011","Greenwich 015C","E01001701","Total",693,598,95
"2011","Greenwich 015D","E01001702","Total",480,475,5
"2011","Greenwich 016A","E01001581","Total",867,838,29
"2011","Greenwich 016B","E01001585","Total",642,628,14
"2011","Greenwich 016C","E01001586","Total",693,683,10
"2011","Greenwich 016D","E01001587","Total",1043,921,122
"2011","Greenwich 017A","E01001678","Total",639,628,11
"2011","Greenwich 017B","E01001683","Total",583,565,18
"2011","Greenwich 017C","E01001684","Total",579,561,18
"2011","Greenwich 017D","E01001685","Total",625,610,15
"2011","Greenwich 019A","E01001646","Total",1224,1179,45
"2011","Greenwich 019B","E01001650","Total",624,615,9
"2011","Greenwich 019C","E01001651","Total",781,761,20
"2011","Greenwich 019D","E01001652","Total",699,681,18
"2011","Greenwich 020A","E01001679","Total",537,520,17
"2011","Greenwich 020B","E01001680","Total",635,618,17
"2011","Greenwich 020C","E01001681","Total",505,488,17
"2011","Greenwich 020D","E01001682","Total",577,565,12
"2011","Greenwich 020E","E01001686","Total",807,767,40
"2011","Greenwich 021A","E01001580","Total",875,833,42
"2011","Greenwich 021B","E01001582","Total",661,641,20
"2011","Greenwich 021C","E01001583","Total",847,818,29
"2011","Greenwich 021D","E01001584","Total",752,713,39
"2011","Greenwich 022A","E01001645","Total",737,714,23
"2011","Greenwich 022B","E01001647","Total",579,573,6
"2011","Greenwich 022C","E01001648","Total",743,729,14
"2011","Greenwich 022D","E01001649","Total",581,569,12
"2011","Greenwich 023A","E01001605","Total",580,571,9
"2011","Greenwich 023B","E01001606","Total",624,618,6
"2011","Greenwich 023C","E01001610","Total",718,707,11
"2011","Greenwich 023D","E01001611","Total",755,741,14
"2011","Greenwich 025A","E01001620","Total",510,505,5
"2011","Greenwich 025B","E01001621","Total",619,611,8
"2011","Greenwich 025C","E01001623","Total",673,664,9
"2011","Greenwich 025D","E01001624","Total",636,631,5
"2011","Greenwich 025E","E01001625","Total",593,587,6
"2011","Greenwich 027A","E01001604","Total",590,568,22
"2011","Greenwich 027B","E01001607","Total",618,604,14
"2011","Greenwich 027C","E01001608","Total",603,592,11
"2011","Greenwich 027D","E01001609","Total",761,738,23
"2011","Greenwich 028A","E01001613","Total",804,775,29
"2011","Greenwich 028B","E01001614","Total",549,530,19
"2011","Greenwich 028C","E01001615","Total",785,756,29
"2011","Greenwich 028D","E01001617","Total",762,738,24
"2011","Greenwich 029A","E01001653","Total",623,610,13
"2011","Greenwich 029B","E01001654","Total",611,603,8
"2011","Greenwich 029C","E01001655","Total",653,637,16
"2011","Greenwich 029D","E01001660","Total",590,586,4
"2011","Greenwich 029E","E01001661","Total",595,588,7
"2011","Greenwich 030C","E01001618","Total",659,648,11
"2011","Greenwich 030D","E01001619","Total",844,818,26
"2011","Greenwich 030E","E01033729","Total",821,802,19
"2011","Greenwich 031A","E01001597","Total",615,607,8
"2011","Greenwich 031B","E01001598","Total",617,606,11
"2011","Greenwich 031C","E01001602","Total",724,718,6
"2011","Greenwich 031D","E01001603","Total",773,768,5
"2011","Greenwich 032A","E01001596","Total",608,597,11
"2011","Greenwich 032B","E01001599","Total",617,615,2
"2011","Greenwich 032C","E01001600","Total",673,663,10
"2011","Greenwich 032D","E01001601","Total",604,601,3
"2011","Greenwich 033A","E01001669","Total",728,689,39
"2011","Greenwich 033B","E01001671","Total",687,675,12
"2011","Greenwich 033C","E01001676","Total",658,646,12
"2011","Greenwich 033D","E01032567","Total",602,589,13
"2011","Greenwich 034A","E01001656","Total",604,582,22
"2011","Greenwich 034B","E01001657","Total",708,686,22
"2011","Greenwich 034C","E01001658","Total",766,723,43
"2011","Greenwich 034D","E01001659","Total",543,529,14
"2011","Greenwich 034E","E01033726","Total",828,818,10
"2011","Greenwich 035A","E01001640","Total",904,881,23
"2011","Greenwich 035B","E01033727","Total",829,802,27
"2011","Greenwich 035C","E01033728","Total",663,641,22
"2011","Greenwich 035D","E01033730","Total",700,653,47
"2011","Greenwich 036A","E01001666","Total",570,557,13
"2011","Greenwich 036B","E01001667","Total",775,707,68
"2011","Greenwich 036C","E01001668","Total",1073,1049,24
"2011","Greenwich 036D","E01033732","Total",485,472,13
"2011","Greenwich 036E","E01033733","Total",570,548,22
"2011","Greenwich 037A","E01001662","Total",738,715,23
"2011","Greenwich 037B","E01001664","Total",885,854,31
"2011","Greenwich 037C","E01001665","Total",808,788,20
"2011","Greenwich 037D","E01033738","Total",532,519,13
"2011","Greenwich 038A","E01001638","Total",818,806,12
"2011","Greenwich 038B","E01001641","Total",816,779,37
"2011","Greenwich 038C","E01001642","Total",824,791,33
"2011","Greenwich 038D","E01001644","Total",1062,1022,40
"2011","Greenwich 038E","E01033746","Total",743,715,28
"2011","Harrow 001A","E01002112","Total",727,697,30
"2011","Harrow 001B","E01002114","Total",1033,986,47
"2011","Harrow 001C","E01002225","Total",647,623,24
"2011","Harrow 001D","E01002226","Total",1059,1003,56
"2011","Harrow 002A","E01002113","Total",618,599,19
"2011","Harrow 002B","E01002115","Total",518,509,9
"2011","Harrow 002C","E01002116","Total",708,680,28
"2011","Harrow 002D","E01002117","Total",748,675,73
"2011","Harrow 002E","E01002118","Total",696,675,21
"2011","Harrow 003A","E01002227","Total",622,611,11
"2011","Harrow 003B","E01002228","Total",750,710,40
"2011","Harrow 003C","E01002229","Total",798,770,28
"2011","Harrow 003D","E01002230","Total",665,637,28
"2011","Harrow 004A","E01002144","Total",604,580,24
"2011","Harrow 004B","E01002146","Total",528,519,9
"2011","Harrow 004C","E01002147","Total",514,502,12
"2011","Harrow 004D","E01002149","Total",487,479,8
"2011","Harrow 005A","E01002140","Total",625,607,18
"2011","Harrow 005B","E01002141","Total",698,680,18
"2011","Harrow 005C","E01002142","Total",653,635,18
"2011","Harrow 005D","E01002143","Total",545,529,16
"2011","Harrow 005E","E01002145","Total",652,631,21
"2011","Harrow 006A","E01002139","Total",508,498,10
"2011","Harrow 006B","E01002148","Total",507,491,16
"2011","Harrow 006C","E01002150","Total",886,839,47
"2011","Harrow 006D","E01002151","Total",535,524,11
"2011","Harrow 006E","E01002152","Total",651,638,13
"2011","Harrow 007A","E01002119","Total",582,568,14
"2011","Harrow 007B","E01002120","Total",502,488,14
"2011","Harrow 007C","E01002121","Total",557,546,11
"2011","Harrow 007D","E01002122","Total",600,582,18
"2011","Harrow 007E","E01002123","Total",539,527,12
"2011","Harrow 008A","E01002106","Total",663,651,12
"2011","Harrow 008B","E01002108","Total",566,559,7
"2011","Harrow 008C","E01002109","Total",677,654,23
"2011","Harrow 008D","E01002110","Total",549,542,7
"2011","Harrow 008E","E01002111","Total",698,681,17
"2011","Harrow 009A","E01002185","Total",592,585,7
"2011","Harrow 009B","E01002186","Total",817,794,23
"2011","Harrow 009C","E01002187","Total",786,761,25
"2011","Harrow 009D","E01002190","Total",635,625,10
"2011","Harrow 010A","E01002124","Total",498,492,6
"2011","Harrow 010B","E01002125","Total",526,512,14
"2011","Harrow 010C","E01002198","Total",507,499,8
"2011","Harrow 010D","E01002200","Total",515,505,10
"2011","Harrow 010E","E01002203","Total",532,524,8
"2011","Harrow 011A","E01002232","Total",739,709,30
"2011","Harrow 011B","E01002233","Total",805,754,51
"2011","Harrow 011C","E01002234","Total",563,548,15
"2011","Harrow 011D","E01002235","Total",621,610,11
"2011","Harrow 011E","E01002236","Total",601,582,19
"2011","Harrow 012A","E01002107","Total",583,575,8
"2011","Harrow 012B","E01002197","Total",431,420,11
"2011","Harrow 012C","E01002199","Total",474,467,7
"2011","Harrow 012D","E01002201","Total",515,508,7
"2011","Harrow 012E","E01002202","Total",735,712,23
"2011","Harrow 013A","E01002179","Total",833,795,38
"2011","Harrow 013B","E01002180","Total",806,783,23
"2011","Harrow 013C","E01002183","Total",693,682,11
"2011","Harrow 013D","E01002184","Total",697,677,20
"2011","Harrow 013E","E01002231","Total",691,679,12
"2011","Harrow 015A","E01002154","Total",756,728,28
"2011","Harrow 015B","E01002156","Total",507,501,6
"2011","Harrow 015C","E01002162","Total",700,687,13
"2011","Harrow 015D","E01002163","Total",543,537,6
"2011","Harrow 016A","E01002188","Total",648,638,10
"2011","Harrow 016B","E01002189","Total",732,714,18
"2011","Harrow 016C","E01002192","Total",655,638,17
"2011","Harrow 016D","E01002193","Total",760,740,20
"2011","Harrow 017A","E01002165","Total",535,528,7
"2011","Harrow 017B","E01002166","Total",490,484,6
"2011","Harrow 017C","E01002167","Total",486,477,9
"2011","Harrow 017D","E01002168","Total",517,511,6
"2011","Harrow 017E","E01002169","Total",534,531,3
"2011","Harrow 019A","E01002153","Total",626,616,10
"2011","Harrow 019B","E01002155","Total",660,641,19
"2011","Harrow 019C","E01002157","Total",605,593,12
"2011","Harrow 019D","E01002158","Total",497,491,6
"2011","Harrow 020A","E01002128","Total",808,784,24
"2011","Harrow 020B","E01002130","Total",916,884,32
"2011","Harrow 020C","E01002181","Total",693,682,11
"2011","Harrow 020D","E01002182","Total",700,689,11
"2011","Harrow 021A","E01002159","Total",697,685,12
"2011","Harrow 021B","E01002160","Total",768,704,64
"2011","Harrow 021C","E01002161","Total",738,728,10
"2011","Harrow 021D","E01002164","Total",708,683,25
"2011","Harrow 022A","E01002191","Total",680,667,13
"2011","Harrow 022B","E01002194","Total",673,657,16
"2011","Harrow 022C","E01002195","Total",618,610,8
"2011","Harrow 022D","E01002196","Total",625,616,9
"2011","Harrow 023A","E01002126","Total",1255,1203,52
"2011","Harrow 023B","E01002127","Total",638,628,10
"2011","Harrow 023C","E01002129","Total",919,889,30
"2011","Harrow 023D","E01002131","Total",599,586,13
"2011","Harrow 024A","E01002237","Total",678,648,30
"2011","Harrow 024B","E01002238","Total",609,596,13
"2011","Harrow 024C","E01002240","Total",671,655,16
"2011","Harrow 024D","E01002242","Total",640,613,27
"2011","Harrow 025A","E01002208","Total",497,483,14
"2011","Harrow 025B","E01002209","Total",572,546,26
"2011","Harrow 025C","E01002239","Total",654,635,19
"2011","Harrow 025D","E01002241","Total",544,536,8
"2011","Harrow 027A","E01002133","Total",924,896,28
"2011","Harrow 027B","E01002136","Total",655,638,17
"2011","Harrow 027C","E01002138","Total",519,509,10
"2011","Harrow 027D","E01002213","Total",1160,1116,44
"2011","Harrow 028A","E01002211","Total",480,477,3
"2011","Harrow 028B","E01002212","Total",660,647,13
"2011","Harrow 028C","E01002216","Total",526,513,13
"2011","Harrow 028D","E01002217","Total",562,552,10
"2011","Harrow 029A","E01002132","Total",891,828,63
"2011","Harrow 029B","E01002134","Total",634,603,31
"2011","Harrow 029C","E01002135","Total",672,657,15
"2011","Harrow 029D","E01002137","Total",496,468,28
"2011","Harrow 030A","E01002218","Total",638,606,32
"2011","Harrow 030B","E01002219","Total",632,605,27
"2011","Harrow 030C","E01002221","Total",524,511,13
"2011","Harrow 030D","E01002222","Total",496,488,8
"2011","Harrow 031A","E01002214","Total",618,612,6
"2011","Harrow 031B","E01002215","Total",621,595,26
"2011","Harrow 031C","E01002220","Total",502,493,9
"2011","Harrow 031D","E01002223","Total",598,591,7
"2011","Harrow 031E","E01002224","Total",502,497,5
"2011","Harrow 032A","E01002204","Total",651,634,17
"2011","Harrow 032B","E01002206","Total",468,457,11
"2011","Harrow 032C","E01002207","Total",534,524,10
"2011","Harrow 032D","E01002210","Total",513,504,9
"2011","Harrow 032E","E01032576","Total",527,520,7
"2011","Harrow 033A","E01002170","Total",412,408,4
"2011","Harrow 033B","E01002171","Total",541,534,7
"2011","Harrow 033C","E01002172","Total",498,493,5
"2011","Harrow 033D","E01002173","Total",536,529,7
"2011","Harrow 033E","E01002174","Total",494,483,11
"2011","Harrow 033F","E01002175","Total",413,406,7
"2011","Harrow 033G","E01002176","Total",545,535,10
"2011","Harrow 033H","E01002177","Total",459,452,7
"2011","Harrow 033I","E01002178","Total",505,502,3
"2011","Havering 001A","E01002276","Total",711,694,17
"2011","Havering 001B","E01002278","Total",640,631,9
"2011","Havering 001C","E01002312","Total",672,642,30
"2011","Havering 001D","E01002313","Total",644,630,14
"2011","Havering 002A","E01002277","Total",616,608,8
"2011","Havering 002B","E01002279","Total",653,634,19
"2011","Havering 002C","E01002281","Total",771,756,15
"2011","Havering 002D","E01002283","Total",614,594,20
"2011","Havering 002E","E01002299","Total",681,664,17
"2011","Havering 003A","E01002301","Total",643,627,16
"2011","Havering 003B","E01002303","Total",832,823,9
"2011","Havering 003C","E01002304","Total",530,524,6
"2011","Havering 003D","E01002306","Total",635,625,10
"2011","Havering 003E","E01002307","Total",642,636,6
"2011","Havering 004A","E01002280","Total",629,621,8
"2011","Havering 004B","E01002282","Total",685,668,17
"2011","Havering 004C","E01002284","Total",781,765,16
"2011","Havering 004D","E01002297","Total",694,670,24
"2011","Havering 004E","E01002314","Total",631,623,8
"2011","Havering 004F","E01002316","Total",753,740,13
"2011","Havering 005A","E01002302","Total",607,598,9
"2011","Havering 005B","E01002305","Total",620,608,12
"2011","Havering 005C","E01002308","Total",672,670,2
"2011","Havering 005D","E01002326","Total",647,627,20
"2011","Havering 005E","E01002331","Total",612,596,16
"2011","Havering 006A","E01002309","Total",661,651,10
"2011","Havering 006B","E01002310","Total",718,712,6
"2011","Havering 006C","E01002311","Total",679,668,11
"2011","Havering 006D","E01002315","Total",637,633,4
"2011","Havering 007A","E01002293","Total",820,801,19
"2011","Havering 007B","E01002294","Total",640,626,14
"2011","Havering 007C","E01002296","Total",711,691,20
"2011","Havering 007D","E01002298","Total",671,654,17
"2011","Havering 007E","E01002300","Total",735,715,20
"2011","Havering 008A","E01002333","Total",521,516,5
"2011","Havering 008B","E01002334","Total",685,674,11
"2011","Havering 008C","E01002336","Total",627,612,15
"2011","Havering 008D","E01002339","Total",618,602,16
"2011","Havering 008E","E01002341","Total",562,557,5
"2011","Havering 009A","E01002327","Total",606,595,11
"2011","Havering 009B","E01002328","Total",646,642,4
"2011","Havering 009C","E01002332","Total",704,683,21
"2011","Havering 009D","E01002335","Total",610,592,18
"2011","Havering 009E","E01002338","Total",539,523,16
"2011","Havering 009F","E01002340","Total",518,509,9
"2011","Havering 010A","E01002268","Total",532,519,13
"2011","Havering 010B","E01002269","Total",693,678,15
"2011","Havering 010C","E01002295","Total",676,670,6
"2011","Havering 010D","E01002377","Total",724,711,13
"2011","Havering 010E","E01002378","Total",613,604,9
"2011","Havering 010F","E01002383","Total",670,659,11
"2011","Havering 011A","E01002244","Total",761,749,12
"2011","Havering 011B","E01002245","Total",646,630,16
"2011","Havering 011C","E01002325","Total",763,755,8
"2011","Havering 011D","E01002329","Total",659,643,16
"2011","Havering 011E","E01002330","Total",744,737,7
"2011","Havering 012A","E01002337","Total",559,512,47
"2011","Havering 012B","E01002354","Total",569,561,8
"2011","Havering 012C","E01002376","Total",528,520,8
"2011","Havering 012D","E01002379","Total",685,659,26
"2011","Havering 012E","E01002380","Total",1045,1036,9
"2011","Havering 012F","E01002381","Total",651,645,6
"2011","Havering 013A","E01002243","Total",861,847,14
"2011","Havering 013B","E01002353","Total",864,832,32
"2011","Havering 013C","E01002356","Total",1082,1037,45
"2011","Havering 013E","E01032741","Total",693,663,30
"2011","Havering 013F","E01032742","Total",658,644,14
"2011","Havering 014A","E01002272","Total",548,536,12
"2011","Havering 014B","E01002274","Total",712,692,20
"2011","Havering 014C","E01002317","Total",547,544,3
"2011","Havering 014D","E01002318","Total",620,614,6
"2011","Havering 014E","E01002355","Total",588,574,14
"2011","Havering 014F","E01002382","Total",785,765,20
"2011","Havering 015A","E01002270","Total",657,634,23
"2011","Havering 015B","E01002271","Total",526,515,11
"2011","Havering 015C","E01002273","Total",497,490,7
"2011","Havering 015D","E01002275","Total",525,517,8
"2011","Havering 016A","E01002319","Total",669,652,17
"2011","Havering 016B","E01002350","Total",734,711,23
"2011","Havering 016C","E01002351","Total",668,653,15
"2011","Havering 016D","E01002352","Total",733,722,11
"2011","Havering 016E","E01002358","Total",809,791,18
"2011","Havering 017A","E01002246","Total",649,637,12
"2011","Havering 017B","E01002247","Total",750,729,21
"2011","Havering 017C","E01002248","Total",617,592,25
"2011","Havering 017D","E01002249","Total",762,746,16
"2011","Havering 017E","E01002250","Total",656,642,14
"2011","Havering 017F","E01002251","Total",532,526,6
"2011","Havering 018A","E01002252","Total",629,617,12
"2011","Havering 018B","E01002256","Total",635,620,15
"2011","Havering 018C","E01002258","Total",811,797,14
"2011","Havering 018D","E01002259","Total",621,612,9
"2011","Havering 018E","E01002391","Total",631,608,23
"2011","Havering 019A","E01002253","Total",623,615,8
"2011","Havering 019B","E01002254","Total",650,636,14
"2011","Havering 019C","E01002257","Total",665,651,14
"2011","Havering 019D","E01002384","Total",657,644,13
"2011","Havering 020A","E01002359","Total",522,515,7
"2011","Havering 020B","E01002360","Total",767,742,25
"2011","Havering 020C","E01002361","Total",862,822,40
"2011","Havering 020D","E01002363","Total",699,686,13
"2011","Havering 020E","E01002367","Total",670,658,12
"2011","Havering 021A","E01002320","Total",548,537,11
"2011","Havering 021B","E01002321","Total",646,635,11
"2011","Havering 021C","E01002322","Total",742,731,11
"2011","Havering 021D","E01002323","Total",637,627,10
"2011","Havering 021E","E01002324","Total",666,650,16
"2011","Havering 022A","E01002255","Total",641,630,11
"2011","Havering 022B","E01002289","Total",633,621,12
"2011","Havering 022C","E01002292","Total",651,637,14
"2011","Havering 022D","E01002362","Total",624,616,8
"2011","Havering 022E","E01002386","Total",903,871,32
"2011","Havering 023A","E01002287","Total",614,602,12
"2011","Havering 023B","E01002291","Total",796,775,21
"2011","Havering 023C","E01002364","Total",555,542,13
"2011","Havering 023D","E01002365","Total",559,552,7
"2011","Havering 023E","E01002366","Total",575,568,7
"2011","Havering 024A","E01002385","Total",617,601,16
"2011","Havering 024B","E01002387","Total",614,607,7
"2011","Havering 024C","E01002388","Total",615,608,7
"2011","Havering 024D","E01002389","Total",639,623,16
"2011","Havering 024E","E01002390","Total",541,531,10
"2011","Havering 025A","E01002265","Total",644,638,6
"2011","Havering 025B","E01002285","Total",528,520,8
"2011","Havering 025C","E01002286","Total",619,614,5
"2011","Havering 025D","E01002288","Total",560,554,6
"2011","Havering 025E","E01002290","Total",651,641,10
"2011","Havering 026A","E01002260","Total",570,566,4
"2011","Havering 026B","E01002261","Total",664,645,19
"2011","Havering 026C","E01002262","Total",636,625,11
"2011","Havering 026D","E01002263","Total",613,609,4
"2011","Havering 026E","E01002264","Total",718,710,8
"2011","Havering 027A","E01002266","Total",608,600,8
"2011","Havering 027B","E01002267","Total",752,734,18
"2011","Havering 027C","E01002372","Total",612,603,9
"2011","Havering 027D","E01002373","Total",639,628,11
"2011","Havering 027E","E01002374","Total",617,604,13
"2011","Havering 028A","E01002368","Total",765,696,69
"2011","Havering 028B","E01002369","Total",752,730,22
"2011","Havering 028C","E01002370","Total",861,846,15
"2011","Havering 028D","E01002371","Total",651,643,8
"2011","Havering 028E","E01002375","Total",697,688,9
"2011","Havering 029A","E01002343","Total",649,636,13
"2011","Havering 029B","E01002344","Total",655,638,17
"2011","Havering 029C","E01002348","Total",656,642,14
"2011","Havering 029D","E01002349","Total",611,608,3
"2011","Havering 030A","E01002342","Total",642,632,10
"2011","Havering 030B","E01002345","Total",780,756,24
"2011","Havering 030C","E01002346","Total",564,557,7
"2011","Havering 030D","E01002347","Total",535,526,9
"2011","Hillingdon 001A","E01002473","Total",672,636,36
"2011","Hillingdon 001B","E01002475","Total",741,692,49
"2011","Hillingdon 001C","E01002476","Total",658,611,47
"2011","Hillingdon 001D","E01002477","Total",608,559,49
"2011","Hillingdon 001E","E01002482","Total",643,617,26
"2011","Hillingdon 002A","E01002472","Total",839,771,68
"2011","Hillingdon 002B","E01002474","Total",693,643,50
"2011","Hillingdon 002C","E01002478","Total",713,666,47
"2011","Hillingdon 002D","E01002483","Total",739,714,25
"2011","Hillingdon 002E","E01002484","Total",608,585,23
"2011","Hillingdon 002F","E01002485","Total",798,762,36
"2011","Hillingdon 003A","E01002438","Total",503,480,23
"2011","Hillingdon 003B","E01002439","Total",641,608,33
"2011","Hillingdon 003C","E01002440","Total",630,618,12
"2011","Hillingdon 003D","E01002441","Total",701,667,34
"2011","Hillingdon 003E","E01002442","Total",657,635,22
"2011","Hillingdon 004A","E01002433","Total",826,782,44
"2011","Hillingdon 004B","E01002436","Total",677,658,19
"2011","Hillingdon 004C","E01002479","Total",666,628,38
"2011","Hillingdon 004D","E01002480","Total",723,713,10
"2011","Hillingdon 004E","E01002481","Total",670,659,11
"2011","Hillingdon 005A","E01002533","Total",608,589,19
"2011","Hillingdon 005B","E01002534","Total",624,607,17
"2011","Hillingdon 005C","E01002538","Total",765,746,19
"2011","Hillingdon 005D","E01002539","Total",641,619,22
"2011","Hillingdon 006A","E01002418","Total",674,658,16
"2011","Hillingdon 006B","E01002419","Total",625,611,14
"2011","Hillingdon 006C","E01002431","Total",497,489,8
"2011","Hillingdon 006D","E01002432","Total",655,635,20
"2011","Hillingdon 006E","E01002437","Total",621,608,13
"2011","Hillingdon 007A","E01002430","Total",535,524,11
"2011","Hillingdon 007B","E01002434","Total",519,504,15
"2011","Hillingdon 007C","E01002435","Total",545,535,10
"2011","Hillingdon 007D","E01002470","Total",735,702,33
"2011","Hillingdon 007E","E01002535","Total",888,828,60
"2011","Hillingdon 008A","E01002416","Total",602,593,9
"2011","Hillingdon 008B","E01002417","Total",671,638,33
"2011","Hillingdon 008C","E01002420","Total",667,662,5
"2011","Hillingdon 008D","E01002421","Total",650,636,14
"2011","Hillingdon 008E","E01002471","Total",647,634,13
"2011","Hillingdon 009A","E01002465","Total",657,633,24
"2011","Hillingdon 009B","E01002467","Total",658,639,19
"2011","Hillingdon 009C","E01002494","Total",650,637,13
"2011","Hillingdon 009D","E01002536","Total",639,609,30
"2011","Hillingdon 009E","E01002537","Total",633,579,54
"2011","Hillingdon 010A","E01002415","Total",650,643,7
"2011","Hillingdon 010B","E01002466","Total",644,633,11
"2011","Hillingdon 010C","E01002468","Total",650,633,17
"2011","Hillingdon 010D","E01002469","Total",644,631,13
"2011","Hillingdon 010E","E01002495","Total",742,695,47
"2011","Hillingdon 011A","E01002458","Total",553,543,10
"2011","Hillingdon 011B","E01002459","Total",642,622,20
"2011","Hillingdon 011C","E01002460","Total",622,597,25
"2011","Hillingdon 011D","E01002462","Total",538,506,32
"2011","Hillingdon 011E","E01002464","Total",634,623,11
"2011","Hillingdon 013A","E01002461","Total",535,516,19
"2011","Hillingdon 013B","E01002463","Total",535,528,7
"2011","Hillingdon 013C","E01002512","Total",667,647,20
"2011","Hillingdon 013D","E01002513","Total",575,544,31
"2011","Hillingdon 013E","E01002516","Total",521,490,31
"2011","Hillingdon 014A","E01002450","Total",509,503,6
"2011","Hillingdon 014B","E01002451","Total",512,493,19
"2011","Hillingdon 014C","E01002452","Total",510,500,10
"2011","Hillingdon 014D","E01002453","Total",610,599,11
"2011","Hillingdon 014E","E01002454","Total",681,661,20
"2011","Hillingdon 015A","E01002414","Total",543,527,16
"2011","Hillingdon 015C","E01002514","Total",918,885,33
"2011","Hillingdon 015D","E01002515","Total",858,718,140
"2011","Hillingdon 015F","E01033725","Total",1028,945,83
"2011","Hillingdon 016B","E01002520","Total",631,603,28
"2011","Hillingdon 016C","E01002521","Total",978,909,69
"2011","Hillingdon 016D","E01002523","Total",567,549,18
"2011","Hillingdon 016F","E01033724","Total",1093,1051,42
"2011","Hillingdon 017A","E01002410","Total",648,638,10
"2011","Hillingdon 017B","E01002412","Total",839,822,17
"2011","Hillingdon 017C","E01002456","Total",639,621,18
"2011","Hillingdon 017D","E01002509","Total",513,502,11
"2011","Hillingdon 017E","E01002511","Total",647,613,34
"2011","Hillingdon 018A","E01002422","Total",508,494,14
"2011","Hillingdon 018B","E01002423","Total",589,568,21
"2011","Hillingdon 018C","E01002424","Total",537,526,11
"2011","Hillingdon 018D","E01002425","Total",617,613,4
"2011","Hillingdon 018E","E01002427","Total",539,514,25
"2011","Hillingdon 018F","E01002428","Total",511,496,15
"2011","Hillingdon 019A","E01002408","Total",641,629,12
"2011","Hillingdon 019B","E01002409","Total",683,672,11
"2011","Hillingdon 019C","E01002429","Total",529,498,31
"2011","Hillingdon 019D","E01002455","Total",666,652,14
"2011","Hillingdon 019E","E01002457","Total",534,517,17
"2011","Hillingdon 020A","E01002392","Total",633,618,15
"2011","Hillingdon 020B","E01002393","Total",725,705,20
"2011","Hillingdon 020C","E01002540","Total",657,621,36
"2011","Hillingdon 020D","E01002542","Total",679,665,14
"2011","Hillingdon 020E","E01002543","Total",646,625,21
"2011","Hillingdon 021A","E01002394","Total",516,508,8
"2011","Hillingdon 021B","E01002395","Total",431,424,7
"2011","Hillingdon 021C","E01002397","Total",551,514,37
"2011","Hillingdon 021D","E01002398","Total",500,493,7
"2011","Hillingdon 021E","E01002399","Total",495,474,21
"2011","Hillingdon 021F","E01002426","Total",657,631,26
"2011","Hillingdon 022A","E01002411","Total",650,632,18
"2011","Hillingdon 022B","E01002413","Total",616,594,22
"2011","Hillingdon 022C","E01002518","Total",497,490,7
"2011","Hillingdon 022D","E01002519","Total",758,719,39
"2011","Hillingdon 022E","E01002550","Total",818,795,23
"2011","Hillingdon 022F","E01002554","Total",1223,1073,150
"2011","Hillingdon 023A","E01002541","Total",822,785,37
"2011","Hillingdon 023B","E01002544","Total",573,555,18
"2011","Hillingdon 023C","E01002545","Total",499,483,16
"2011","Hillingdon 023D","E01002546","Total",464,449,15
"2011","Hillingdon 023E","E01002547","Total",513,492,21
"2011","Hillingdon 024A","E01002400","Total",611,599,12
"2011","Hillingdon 024B","E01002401","Total",630,609,21
"2011","Hillingdon 024C","E01002402","Total",500,491,9
"2011","Hillingdon 024D","E01002403","Total",555,543,12
"2011","Hillingdon 024E","E01002404","Total",682,675,7
"2011","Hillingdon 025A","E01002548","Total",666,657,9
"2011","Hillingdon 025B","E01002549","Total",684,672,12
"2011","Hillingdon 025C","E01002551","Total",650,641,9
"2011","Hillingdon 025D","E01002552","Total",529,526,3
"2011","Hillingdon 025E","E01002553","Total",611,603,8
"2011","Hillingdon 026A","E01002396","Total",580,563,17
"2011","Hillingdon 026B","E01002501","Total",513,506,7
"2011","Hillingdon 026C","E01002502","Total",494,491,3
"2011","Hillingdon 026D","E01002505","Total",693,682,11
"2011","Hillingdon 026E","E01002508","Total",662,648,14
"2011","Hillingdon 027A","E01002405","Total",655,634,21
"2011","Hillingdon 027B","E01002406","Total",701,680,21
"2011","Hillingdon 027C","E01002503","Total",505,497,8
"2011","Hillingdon 027D","E01002504","Total",737,726,11
"2011","Hillingdon 027E","E01002506","Total",673,643,30
"2011","Hillingdon 027F","E01002507","Total",479,465,14
"2011","Hillingdon 028A","E01002486","Total",710,699,11
"2011","Hillingdon 028B","E01002487","Total",622,614,8
"2011","Hillingdon 028C","E01002526","Total",668,635,33
"2011","Hillingdon 028D","E01002528","Total",586,563,23
"2011","Hillingdon 028E","E01002532","Total",933,886,47
"2011","Hillingdon 029A","E01002445","Total",607,588,19
"2011","Hillingdon 029B","E01002525","Total",662,647,15
"2011","Hillingdon 029C","E01002529","Total",817,771,46
"2011","Hillingdon 029D","E01002530","Total",643,619,24
"2011","Hillingdon 029E","E01002531","Total",665,644,21
"2011","Hillingdon 030A","E01002407","Total",751,725,26
"2011","Hillingdon 030B","E01002488","Total",538,533,5
"2011","Hillingdon 030C","E01002489","Total",551,537,14
"2011","Hillingdon 030D","E01002490","Total",683,656,27
"2011","Hillingdon 030E","E01002492","Total",499,488,11
"2011","Hillingdon 031A","E01002444","Total",708,625,83
"2011","Hillingdon 031B","E01002446","Total",637,592,45
"2011","Hillingdon 031C","E01002447","Total",661,623,38
"2011","Hillingdon 031D","E01002527","Total",639,622,17
"2011","Hillingdon 032A","E01002443","Total",557,547,10
"2011","Hillingdon 032B","E01002448","Total",791,765,26
"2011","Hillingdon 032C","E01002449","Total",743,710,33
"2011","Hillingdon 032D","E01002491","Total",526,519,7
"2011","Hillingdon 032E","E01002493","Total",608,601,7
"2011","Hillingdon 033A","E01002496","Total",791,767,24
"2011","Hillingdon 033B","E01002497","Total",788,759,29
"2011","Hillingdon 033C","E01002498","Total",525,516,9
"2011","Hillingdon 033D","E01002499","Total",696,678,18
"2011","Hillingdon 033E","E01032577","Total",610,601,9
"2011","Hounslow 001A","E01002569","Total",815,792,23
"2011","Hounslow 001B","E01002570","Total",766,732,34
"2011","Hounslow 001C","E01002573","Total",717,679,38
"2011","Hounslow 001D","E01002574","Total",677,645,32
"2011","Hounslow 001E","E01002575","Total",715,688,27
"2011","Hounslow 003A","E01002562","Total",543,518,25
"2011","Hounslow 003B","E01002564","Total",743,736,7
"2011","Hounslow 003C","E01002566","Total",1060,1027,33
"2011","Hounslow 003D","E01002568","Total",1220,1181,39
"2011","Hounslow 003F","E01033081","Total",680,649,31
"2011","Hounslow 003G","E01033082","Total",700,659,41
"2011","Hounslow 004A","E01002620","Total",685,676,9
"2011","Hounslow 004B","E01002625","Total",498,492,6
"2011","Hounslow 004C","E01002626","Total",498,490,8
"2011","Hounslow 004D","E01002627","Total",614,609,5
"2011","Hounslow 004E","E01002631","Total",512,509,3
"2011","Hounslow 005A","E01002633","Total",629,623,6
"2011","Hounslow 005B","E01002634","Total",546,546,0
"2011","Hounslow 005C","E01002637","Total",568,563,5
"2011","Hounslow 005D","E01002638","Total",585,582,3
"2011","Hounslow 006A","E01002563","Total",648,635,13
"2011","Hounslow 006B","E01002565","Total",1046,1020,26
"2011","Hounslow 006C","E01002567","Total",856,837,19
"2011","Hounslow 006D","E01002684","Total",1139,1096,43
"2011","Hounslow 006E","E01002686","Total",688,681,7
"2011","Hounslow 007A","E01002571","Total",640,611,29
"2011","Hounslow 007B","E01002572","Total",721,710,11
"2011","Hounslow 007C","E01002577","Total",685,660,25
"2011","Hounslow 007D","E01002578","Total",634,612,22
"2011","Hounslow 007E","E01002689","Total",814,796,18
"2011","Hounslow 007F","E01002690","Total",676,612,64
"2011","Hounslow 008A","E01002576","Total",767,756,11
"2011","Hounslow 008B","E01002579","Total",848,823,25
"2011","Hounslow 008C","E01002580","Total",715,675,40
"2011","Hounslow 008D","E01002581","Total",898,862,36
"2011","Hounslow 008E","E01002582","Total",742,719,23
"2011","Hounslow 009A","E01002675","Total",891,877,14
"2011","Hounslow 009B","E01002678","Total",698,669,29
"2011","Hounslow 009C","E01002679","Total",653,643,10
"2011","Hounslow 009D","E01002680","Total",745,728,17
"2011","Hounslow 010A","E01002619","Total",630,624,6
"2011","Hounslow 010B","E01002622","Total",530,526,4
"2011","Hounslow 010C","E01002632","Total",596,569,27
"2011","Hounslow 010D","E01002635","Total",534,524,10
"2011","Hounslow 010E","E01002636","Total",613,609,4
"2011","Hounslow 011A","E01002618","Total",513,512,1
"2011","Hounslow 011B","E01002621","Total",598,594,4
"2011","Hounslow 011C","E01002623","Total",492,484,8
"2011","Hounslow 011D","E01002628","Total",627,620,7
"2011","Hounslow 011E","E01002629","Total",733,715,18
"2011","Hounslow 012A","E01002630","Total",583,569,14
"2011","Hounslow 012B","E01002639","Total",516,497,19
"2011","Hounslow 012C","E01002640","Total",563,548,15
"2011","Hounslow 012D","E01002674","Total",679,668,11
"2011","Hounslow 012E","E01002676","Total",566,559,7
"2011","Hounslow 013A","E01002583","Total",522,512,10
"2011","Hounslow 013B","E01002584","Total",515,493,22
"2011","Hounslow 013C","E01002585","Total",514,509,5
"2011","Hounslow 013D","E01002586","Total",460,457,3
"2011","Hounslow 013E","E01002589","Total",692,677,15
"2011","Hounslow 014A","E01002668","Total",909,883,26
"2011","Hounslow 014B","E01002669","Total",718,711,7
"2011","Hounslow 014C","E01002681","Total",754,741,13
"2011","Hounslow 014D","E01002682","Total",953,927,26
"2011","Hounslow 014E","E01002683","Total",1068,1037,31
"2011","Hounslow 015A","E01002642","Total",755,735,20
"2011","Hounslow 015B","E01002643","Total",917,910,7
"2011","Hounslow 015C","E01002645","Total",777,766,11
"2011","Hounslow 015D","E01002658","Total",512,501,11
"2011","Hounslow 015E","E01002677","Total",665,652,13
"2011","Hounslow 016A","E01002587","Total",617,605,12
"2011","Hounslow 016B","E01002588","Total",686,677,9
"2011","Hounslow 016C","E01002660","Total",531,522,9
"2011","Hounslow 016D","E01002661","Total",524,518,6
"2011","Hounslow 016E","E01002665","Total",538,524,14
"2011","Hounslow 017A","E01002624","Total",488,480,8
"2011","Hounslow 017B","E01002646","Total",743,712,31
"2011","Hounslow 017C","E01002662","Total",643,627,16
"2011","Hounslow 017D","E01002663","Total",766,751,15
"2011","Hounslow 017E","E01002664","Total",604,596,8
"2011","Hounslow 018A","E01002641","Total",647,637,10
"2011","Hounslow 018C","E01002648","Total",923,900,23
"2011","Hounslow 018D","E01002649","Total",716,692,24
"2011","Hounslow 018E","E01002657","Total",663,650,13
"2011","Hounslow 018F","E01033083","Total",672,643,29
"2011","Hounslow 018G","E01033084","Total",672,648,24
"2011","Hounslow 019A","E01002653","Total",547,542,5
"2011","Hounslow 019B","E01002654","Total",658,646,12
"2011","Hounslow 019C","E01002655","Total",629,622,7
"2011","Hounslow 019D","E01002656","Total",483,479,4
"2011","Hounslow 019E","E01002659","Total",516,504,12
"2011","Hounslow 020A","E01002667","Total",669,651,18
"2011","Hounslow 020B","E01002670","Total",726,708,18
"2011","Hounslow 020C","E01002671","Total",644,636,8
"2011","Hounslow 020D","E01002672","Total",695,683,12
"2011","Hounslow 020E","E01002673","Total",626,621,5
"2011","Hounslow 021A","E01002647","Total",757,753,4
"2011","Hounslow 021B","E01002650","Total",805,792,13
"2011","Hounslow 021C","E01002651","Total",561,550,11
"2011","Hounslow 021D","E01002652","Total",524,516,8
"2011","Hounslow 021E","E01002666","Total",417,407,10
"2011","Hounslow 022A","E01002555","Total",697,681,16
"2011","Hounslow 022B","E01002556","Total",660,639,21
"2011","Hounslow 022C","E01002590","Total",744,726,18
"2011","Hounslow 022D","E01002592","Total",811,789,22
"2011","Hounslow 022E","E01002595","Total",723,712,11
"2011","Hounslow 023A","E01002557","Total",768,743,25
"2011","Hounslow 023B","E01002558","Total",818,773,45
"2011","Hounslow 023C","E01002559","Total",917,857,60
"2011","Hounslow 023D","E01002560","Total",626,615,11
"2011","Hounslow 023E","E01002561","Total",560,551,9
"2011","Hounslow 024A","E01002591","Total",631,626,5
"2011","Hounslow 024B","E01002593","Total",742,725,17
"2011","Hounslow 024C","E01002594","Total",659,642,17
"2011","Hounslow 024D","E01002611","Total",651,636,15
"2011","Hounslow 024E","E01002612","Total",708,699,9
"2011","Hounslow 024F","E01002613","Total",620,609,11
"2011","Hounslow 025B","E01002598","Total",659,649,10
"2011","Hounslow 025C","E01002599","Total",580,569,11
"2011","Hounslow 025D","E01002600","Total",521,520,1
"2011","Hounslow 025E","E01002603","Total",671,666,5
"2011","Hounslow 025F","E01033000","Total",668,663,5
"2011","Hounslow 025G","E01033030","Total",802,773,29
"2011","Hounslow 026A","E01002604","Total",598,588,10
"2011","Hounslow 026B","E01002605","Total",763,753,10
"2011","Hounslow 026C","E01002606","Total",678,671,7
"2011","Hounslow 026D","E01002607","Total",697,676,21
"2011","Hounslow 026E","E01002615","Total",620,606,14
"2011","Hounslow 027A","E01002596","Total",778,772,6
"2011","Hounslow 027B","E01002601","Total",646,637,9
"2011","Hounslow 027C","E01002602","Total",570,564,6
"2011","Hounslow 027D","E01002614","Total",781,758,23
"2011","Hounslow 027E","E01002616","Total",538,535,3
"2011","Hounslow 028A","E01002608","Total",691,676,15
"2011","Hounslow 028B","E01002609","Total",661,655,6
"2011","Hounslow 028C","E01002610","Total",645,632,13
"2011","Hounslow 028D","E01002617","Total",658,642,16
"2011","Hounslow 029A","E01002687","Total",864,832,32
"2011","Hounslow 029B","E01002691","Total",612,591,21
"2011","Hounslow 029C","E01002692","Total",950,911,39
"2011","Hounslow 029D","E01002693","Total",904,841,63
"2011","Hounslow 029E","E01032573","Total",915,860,55
"2011","Kingston upon Thames 001A","E01003006","Total",629,611,18
"2011","Kingston upon Thames 001B","E01003007","Total",557,549,8
"2011","Kingston upon Thames 001C","E01003008","Total",522,514,8
"2011","Kingston upon Thames 001D","E01003009","Total",813,773,40
"2011","Kingston upon Thames 001E","E01003010","Total",563,554,9
"2011","Kingston upon Thames 002A","E01002952","Total",523,486,37
"2011","Kingston upon Thames 002B","E01002953","Total",473,453,20
"2011","Kingston upon Thames 002C","E01002955","Total",531,513,18
"2011","Kingston upon Thames 002D","E01002956","Total",466,437,29
"2011","Kingston upon Thames 002E","E01002959","Total",499,479,20
"2011","Kingston upon Thames 003A","E01002935","Total",821,775,46
"2011","Kingston upon Thames 003B","E01002938","Total",811,782,29
"2011","Kingston upon Thames 003C","E01002951","Total",635,624,11
"2011","Kingston upon Thames 003D","E01002954","Total",592,565,27
"2011","Kingston upon Thames 003E","E01002957","Total",618,608,10
"2011","Kingston upon Thames 004A","E01002933","Total",826,807,19
"2011","Kingston upon Thames 004B","E01002934","Total",707,649,58
"2011","Kingston upon Thames 004D","E01002937","Total",660,645,15
"2011","Kingston upon Thames 004E","E01003011","Total",762,730,32
"2011","Kingston upon Thames 004F","E01033568","Total",767,718,49
"2011","Kingston upon Thames 004G","E01033569","Total",725,696,29
"2011","Kingston upon Thames 005A","E01002964","Total",1024,982,42
"2011","Kingston upon Thames 005B","E01002969","Total",764,756,8
"2011","Kingston upon Thames 005C","E01002971","Total",723,705,18
"2011","Kingston upon Thames 005D","E01002972","Total",849,828,21
"2011","Kingston upon Thames 005E","E01002974","Total",742,726,16
"2011","Kingston upon Thames 006A","E01002932","Total",701,678,23
"2011","Kingston upon Thames 006B","E01002960","Total",589,574,15
"2011","Kingston upon Thames 006C","E01002962","Total",527,511,16
"2011","Kingston upon Thames 006D","E01002970","Total",603,570,33
"2011","Kingston upon Thames 006E","E01002973","Total",481,465,16
"2011","Kingston upon Thames 007A","E01002929","Total",646,635,11
"2011","Kingston upon Thames 007B","E01002930","Total",698,683,15
"2011","Kingston upon Thames 007C","E01002931","Total",670,654,16
"2011","Kingston upon Thames 007D","E01002963","Total",786,768,18
"2011","Kingston upon Thames 007E","E01002985","Total",618,603,15
"2011","Kingston upon Thames 008A","E01002927","Total",640,614,26
"2011","Kingston upon Thames 008B","E01002928","Total",692,660,32
"2011","Kingston upon Thames 008C","E01002958","Total",678,659,19
"2011","Kingston upon Thames 008D","E01002961","Total",621,609,12
"2011","Kingston upon Thames 008E","E01002986","Total",483,471,12
"2011","Kingston upon Thames 009A","E01002965","Total",1113,1071,42
"2011","Kingston upon Thames 009B","E01002967","Total",1011,958,53
"2011","Kingston upon Thames 009C","E01002968","Total",1185,1123,62
"2011","Kingston upon Thames 009D","E01002990","Total",981,937,44
"2011","Kingston upon Thames 009E","E01002991","Total",740,710,30
"2011","Kingston upon Thames 010A","E01002922","Total",740,725,15
"2011","Kingston upon Thames 010B","E01002926","Total",602,590,12
"2011","Kingston upon Thames 010C","E01002966","Total",761,744,17
"2011","Kingston upon Thames 010D","E01002992","Total",451,438,13
"2011","Kingston upon Thames 011A","E01002921","Total",887,857,30
"2011","Kingston upon Thames 011B","E01002987","Total",899,844,55
"2011","Kingston upon Thames 011C","E01002988","Total",596,572,24
"2011","Kingston upon Thames 011D","E01002989","Total",941,909,32
"2011","Kingston upon Thames 012A","E01002975","Total",497,483,14
"2011","Kingston upon Thames 012B","E01002977","Total",665,654,11
"2011","Kingston upon Thames 012C","E01002980","Total",490,482,8
"2011","Kingston upon Thames 012D","E01002981","Total",529,518,11
"2011","Kingston upon Thames 012E","E01002984","Total",620,604,16
"2011","Kingston upon Thames 013A","E01002923","Total",822,777,45
"2011","Kingston upon Thames 013B","E01002925","Total",827,796,31
"2011","Kingston upon Thames 013C","E01002993","Total",901,867,34
"2011","Kingston upon Thames 013D","E01002995","Total",640,602,38
"2011","Kingston upon Thames 013E","E01002999","Total",771,743,28
"2011","Kingston upon Thames 014A","E01002915","Total",488,479,9
"2011","Kingston upon Thames 014B","E01002916","Total",529,520,9
"2011","Kingston upon Thames 014C","E01002917","Total",506,497,9
"2011","Kingston upon Thames 014D","E01002920","Total",598,593,5
"2011","Kingston upon Thames 014E","E01002924","Total",569,560,9
"2011","Kingston upon Thames 015A","E01002976","Total",655,641,14
"2011","Kingston upon Thames 015B","E01002978","Total",702,684,18
"2011","Kingston upon Thames 015C","E01002979","Total",636,614,22
"2011","Kingston upon Thames 015D","E01002982","Total",529,517,12
"2011","Kingston upon Thames 015E","E01002983","Total",613,595,18
"2011","Kingston upon Thames 016A","E01002994","Total",616,602,14
"2011","Kingston upon Thames 016B","E01002996","Total",607,589,18
"2011","Kingston upon Thames 016C","E01002997","Total",613,588,25
"2011","Kingston upon Thames 016D","E01002998","Total",628,612,16
"2011","Kingston upon Thames 016E","E01003002","Total",808,783,25
"2011","Kingston upon Thames 017A","E01002918","Total",624,615,9
"2011","Kingston upon Thames 017B","E01002919","Total",698,669,29
"2011","Kingston upon Thames 017C","E01003000","Total",596,587,9
"2011","Kingston upon Thames 017D","E01003001","Total",646,627,19
"2011","Kingston upon Thames 017E","E01003003","Total",602,574,28
"2011","Kingston upon Thames 018A","E01002939","Total",612,605,7
"2011","Kingston upon Thames 018B","E01002941","Total",652,628,24
"2011","Kingston upon Thames 018C","E01002942","Total",530,522,8
"2011","Kingston upon Thames 018D","E01003004","Total",606,591,15
"2011","Kingston upon Thames 018E","E01003005","Total",578,570,8
"2011","Kingston upon Thames 019A","E01002944","Total",513,508,5
"2011","Kingston upon Thames 019B","E01002945","Total",666,655,11
"2011","Kingston upon Thames 019C","E01002946","Total",611,603,8
"2011","Kingston upon Thames 019D","E01002947","Total",610,597,13
"2011","Kingston upon Thames 020A","E01002940","Total",613,604,9
"2011","Kingston upon Thames 020B","E01002943","Total",510,507,3
"2011","Kingston upon Thames 020C","E01002948","Total",798,784,14
"2011","Kingston upon Thames 020D","E01002949","Total",692,677,15
"2011","Kingston upon Thames 020E","E01002950","Total",735,719,16
"2011","Merton 001A","E01003472","Total",489,481,8
"2011","Merton 001B","E01003473","Total",528,505,23
"2011","Merton 001C","E01003474","Total",501,480,21
"2011","Merton 001D","E01003475","Total",1184,1162,22
"2011","Merton 001E","E01003478","Total",635,602,33
"2011","Merton 002A","E01003460","Total",721,679,42
"2011","Merton 002B","E01003462","Total",623,599,24
"2011","Merton 002C","E01003464","Total",598,550,48
"2011","Merton 002D","E01003465","Total",497,472,25
"2011","Merton 003A","E01003400","Total",689,659,30
"2011","Merton 003B","E01003454","Total",608,587,21
"2011","Merton 003C","E01003456","Total",689,667,22
"2011","Merton 003D","E01003476","Total",492,482,10
"2011","Merton 003E","E01003477","Total",590,573,17
"2011","Merton 004A","E01003401","Total",680,647,33
"2011","Merton 004B","E01003402","Total",746,705,41
"2011","Merton 004C","E01003403","Total",748,710,38
"2011","Merton 004D","E01003404","Total",1006,912,94
"2011","Merton 004E","E01003461","Total",757,712,45
"2011","Merton 005A","E01003367","Total",986,961,25
"2011","Merton 005B","E01003369","Total",790,768,22
"2011","Merton 005C","E01003370","Total",880,869,11
"2011","Merton 005D","E01003371","Total",637,626,11
"2011","Merton 005E","E01003455","Total",768,749,19
"2011","Merton 006A","E01003359","Total",834,816,18
"2011","Merton 006B","E01003360","Total",772,740,32
"2011","Merton 006C","E01003457","Total",642,623,19
"2011","Merton 006D","E01003458","Total",719,693,26
"2011","Merton 006E","E01003459","Total",969,956,13
"2011","Merton 007A","E01003394","Total",665,636,29
"2011","Merton 007B","E01003395","Total",537,503,34
"2011","Merton 007C","E01003396","Total",550,534,16
"2011","Merton 007D","E01003397","Total",582,557,25
"2011","Merton 007E","E01003398","Total",615,583,32
"2011","Merton 008A","E01003368","Total",598,578,20
"2011","Merton 008B","E01003372","Total",647,627,20
"2011","Merton 008C","E01003393","Total",690,646,44
"2011","Merton 008D","E01003406","Total",575,566,9
"2011","Merton 008E","E01003407","Total",777,768,9
"2011","Merton 009A","E01003355","Total",785,765,20
"2011","Merton 009B","E01003356","Total",711,696,15
"2011","Merton 009C","E01003358","Total",832,801,31
"2011","Merton 009D","E01003383","Total",711,692,19
"2011","Merton 009E","E01003384","Total",637,623,14
"2011","Merton 010A","E01003442","Total",741,701,40
"2011","Merton 010B","E01003443","Total",660,633,27
"2011","Merton 010C","E01003444","Total",719,695,24
"2011","Merton 010D","E01003445","Total",670,658,12
"2011","Merton 010E","E01003463","Total",474,459,15
"2011","Merton 011A","E01003380","Total",689,680,9
"2011","Merton 011B","E01003382","Total",699,676,23
"2011","Merton 011C","E01003385","Total",633,626,7
"2011","Merton 011D","E01003399","Total",651,618,33
"2011","Merton 011E","E01003423","Total",618,605,13
"2011","Merton 012A","E01003357","Total",766,750,16
"2011","Merton 012B","E01003376","Total",599,588,11
"2011","Merton 012C","E01003377","Total",533,526,7
"2011","Merton 012D","E01003408","Total",889,873,16
"2011","Merton 012E","E01003410","Total",636,630,6
"2011","Merton 013A","E01003386","Total",732,722,10
"2011","Merton 013B","E01003388","Total",618,590,28
"2011","Merton 013C","E01003389","Total",649,631,18
"2011","Merton 013D","E01003392","Total",514,501,13
"2011","Merton 013E","E01003409","Total",576,562,14
"2011","Merton 014A","E01003387","Total",648,614,34
"2011","Merton 014B","E01003391","Total",548,544,4
"2011","Merton 014C","E01003411","Total",745,719,26
"2011","Merton 014D","E01003412","Total",615,597,18
"2011","Merton 014E","E01003435","Total",520,490,30
"2011","Merton 015A","E01003361","Total",640,621,19
"2011","Merton 015B","E01003424","Total",591,574,17
"2011","Merton 015C","E01003425","Total",523,508,15
"2011","Merton 015D","E01003426","Total",634,609,25
"2011","Merton 015E","E01003428","Total",677,649,28
"2011","Merton 016A","E01003366","Total",608,595,13
"2011","Merton 016B","E01003381","Total",740,720,20
"2011","Merton 016C","E01003446","Total",839,799,40
"2011","Merton 016D","E01003447","Total",696,691,5
"2011","Merton 016E","E01003471","Total",614,604,10
"2011","Merton 017A","E01003413","Total",743,709,34
"2011","Merton 017B","E01003414","Total",578,539,39
"2011","Merton 017C","E01003415","Total",577,548,29
"2011","Merton 017D","E01003416","Total",559,534,25
"2011","Merton 017E","E01003434","Total",515,506,9
"2011","Merton 018A","E01003373","Total",545,536,9
"2011","Merton 018B","E01003378","Total",739,728,11
"2011","Merton 018C","E01003379","Total",755,742,13
"2011","Merton 018D","E01003390","Total",654,623,31
"2011","Merton 018E","E01003405","Total",654,630,24
"2011","Merton 019A","E01003429","Total",518,507,11
"2011","Merton 019B","E01003430","Total",553,545,8
"2011","Merton 019C","E01003431","Total",568,545,23
"2011","Merton 019D","E01003432","Total",517,508,9
"2011","Merton 019E","E01003433","Total",595,578,17
"2011","Merton 020A","E01003466","Total",618,599,19
"2011","Merton 020B","E01003467","Total",616,601,15
"2011","Merton 020C","E01003468","Total",651,630,21
"2011","Merton 020D","E01003469","Total",590,574,16
"2011","Merton 020E","E01003470","Total",622,607,15
"2011","Merton 021A","E01003362","Total",507,499,8
"2011","Merton 021B","E01003363","Total",599,590,9
"2011","Merton 021C","E01003364","Total",668,648,20
"2011","Merton 021D","E01003365","Total",507,497,10
"2011","Merton 021E","E01003421","Total",645,640,5
"2011","Merton 022A","E01003374","Total",553,546,7
"2011","Merton 022B","E01003375","Total",678,654,24
"2011","Merton 022C","E01003437","Total",774,764,10
"2011","Merton 022D","E01003440","Total",642,627,15
"2011","Merton 022E","E01003441","Total",622,617,5
"2011","Merton 023A","E01003427","Total",726,706,20
"2011","Merton 023B","E01003436","Total",596,588,8
"2011","Merton 023C","E01003439","Total",573,548,25
"2011","Merton 023D","E01003448","Total",659,648,11
"2011","Merton 023E","E01003453","Total",660,650,10
"2011","Merton 024A","E01003438","Total",657,650,7
"2011","Merton 024B","E01003449","Total",690,677,13
"2011","Merton 024C","E01003450","Total",607,597,10
"2011","Merton 024D","E01003451","Total",604,598,6
"2011","Merton 024E","E01003452","Total",820,806,14
"2011","Merton 025A","E01003417","Total",618,608,10
"2011","Merton 025B","E01003418","Total",537,531,6
"2011","Merton 025C","E01003419","Total",657,642,15
"2011","Merton 025D","E01003420","Total",518,506,12
"2011","Merton 025E","E01003422","Total",532,513,19
"2011","Redbridge 001A","E01003744","Total",634,592,42
"2011","Redbridge 001B","E01003745","Total",492,483,9
"2011","Redbridge 001C","E01003746","Total",689,661,28
"2011","Redbridge 001D","E01003747","Total",498,490,8
"2011","Redbridge 001E","E01003748","Total",595,572,23
"2011","Redbridge 001F","E01003749","Total",694,681,13
"2011","Redbridge 001G","E01003750","Total",828,798,30
"2011","Redbridge 002A","E01003720","Total",835,821,14
"2011","Redbridge 002B","E01003722","Total",703,690,13
"2011","Redbridge 002C","E01003723","Total",721,704,17
"2011","Redbridge 002D","E01003726","Total",665,649,16
"2011","Redbridge 003A","E01003721","Total",615,604,11
"2011","Redbridge 003B","E01003724","Total",525,511,14
"2011","Redbridge 003C","E01003725","Total",666,650,16
"2011","Redbridge 003D","E01003727","Total",668,655,13
"2011","Redbridge 004A","E01003654","Total",617,603,14
"2011","Redbridge 004B","E01003655","Total",659,642,17
"2011","Redbridge 004C","E01003658","Total",718,699,19
"2011","Redbridge 004D","E01003660","Total",678,663,15
"2011","Redbridge 005A","E01003656","Total",652,643,9
"2011","Redbridge 005B","E01003657","Total",885,870,15
"2011","Redbridge 005C","E01003659","Total",645,638,7
"2011","Redbridge 006A","E01003698","Total",525,519,6
"2011","Redbridge 006B","E01003699","Total",616,594,22
"2011","Redbridge 006C","E01003700","Total",863,849,14
"2011","Redbridge 006D","E01003701","Total",647,626,21
"2011","Redbridge 006E","E01003702","Total",759,744,15
"2011","Redbridge 006F","E01003703","Total",999,968,31
"2011","Redbridge 006G","E01003704","Total",685,666,19
"2011","Redbridge 007A","E01003668","Total",775,755,20
"2011","Redbridge 007B","E01003669","Total",619,606,13
"2011","Redbridge 007C","E01003670","Total",589,577,12
"2011","Redbridge 007D","E01003671","Total",557,552,5
"2011","Redbridge 007E","E01003672","Total",754,690,64
"2011","Redbridge 007F","E01003673","Total",809,789,20
"2011","Redbridge 007G","E01003674","Total",1027,1000,27
"2011","Redbridge 008A","E01003707","Total",478,469,9
"2011","Redbridge 008B","E01003708","Total",624,613,11
"2011","Redbridge 008C","E01003709","Total",586,570,16
"2011","Redbridge 008D","E01003710","Total",522,507,15
"2011","Redbridge 009A","E01003759","Total",564,554,10
"2011","Redbridge 009B","E01003760","Total",674,661,13
"2011","Redbridge 009C","E01003761","Total",712,698,14
"2011","Redbridge 009D","E01003762","Total",676,656,20
"2011","Redbridge 009E","E01003763","Total",671,657,14
"2011","Redbridge 009F","E01003764","Total",854,835,19
"2011","Redbridge 009G","E01003765","Total",657,642,15
"2011","Redbridge 010A","E01003705","Total",822,802,20
"2011","Redbridge 010B","E01003706","Total",627,613,14
"2011","Redbridge 010C","E01003711","Total",677,662,15
"2011","Redbridge 010D","E01003712","Total",546,536,10
"2011","Redbridge 012A","E01003646","Total",603,572,31
"2011","Redbridge 012B","E01003648","Total",544,528,16
"2011","Redbridge 012C","E01003649","Total",527,521,6
"2011","Redbridge 012D","E01003651","Total",488,466,22
"2011","Redbridge 013A","E01003639","Total",683,665,18
"2011","Redbridge 013B","E01003640","Total",657,648,9
"2011","Redbridge 013C","E01003641","Total",534,530,4
"2011","Redbridge 013D","E01003642","Total",561,542,19
"2011","Redbridge 014A","E01003774","Total",890,867,23
"2011","Redbridge 014B","E01003775","Total",703,686,17
"2011","Redbridge 014C","E01003776","Total",958,932,26
"2011","Redbridge 014D","E01003777","Total",899,856,43
"2011","Redbridge 014E","E01003778","Total",900,879,21
"2011","Redbridge 014F","E01003779","Total",731,708,23
"2011","Redbridge 014G","E01003780","Total",518,507,11
"2011","Redbridge 015A","E01003647","Total",627,612,15
"2011","Redbridge 015B","E01003650","Total",598,580,18
"2011","Redbridge 015C","E01003652","Total",495,482,13
"2011","Redbridge 015D","E01003653","Total",545,516,29
"2011","Redbridge 017A","E01003638","Total",604,590,14
"2011","Redbridge 017B","E01003643","Total",638,622,16
"2011","Redbridge 017C","E01003644","Total",509,498,11
"2011","Redbridge 017D","E01003645","Total",935,910,25
"2011","Redbridge 018A","E01003789","Total",645,625,20
"2011","Redbridge 018B","E01003794","Total",551,544,7
"2011","Redbridge 018C","E01003795","Total",443,433,10
"2011","Redbridge 018D","E01003796","Total",647,638,9
"2011","Redbridge 019A","E01003661","Total",659,651,8
"2011","Redbridge 019B","E01003662","Total",758,741,17
"2011","Redbridge 019C","E01003663","Total",674,662,12
"2011","Redbridge 019D","E01003664","Total",584,575,9
"2011","Redbridge 019E","E01003665","Total",536,529,7
"2011","Redbridge 019F","E01003666","Total",960,935,25
"2011","Redbridge 019H","E01033590","Total",441,434,7
"2011","Redbridge 019I","E01033592","Total",644,633,11
"2011","Redbridge 020A","E01003751","Total",624,611,13
"2011","Redbridge 020B","E01003753","Total",672,659,13
"2011","Redbridge 020C","E01003754","Total",551,533,18
"2011","Redbridge 020D","E01003757","Total",640,622,18
"2011","Redbridge 022A","E01003769","Total",573,557,16
"2011","Redbridge 022B","E01003770","Total",867,848,19
"2011","Redbridge 022C","E01003771","Total",593,581,12
"2011","Redbridge 022D","E01003773","Total",589,579,10
"2011","Redbridge 023A","E01003752","Total",867,838,29
"2011","Redbridge 023B","E01003755","Total",589,571,18
"2011","Redbridge 023C","E01003756","Total",610,600,10
"2011","Redbridge 023D","E01003758","Total",823,810,13
"2011","Redbridge 024A","E01003766","Total",551,548,3
"2011","Redbridge 024B","E01003767","Total",576,567,9
"2011","Redbridge 024C","E01003768","Total",583,569,14
"2011","Redbridge 024D","E01003772","Total",532,524,8
"2011","Redbridge 026A","E01003781","Total",637,602,35
"2011","Redbridge 026B","E01003782","Total",535,518,17
"2011","Redbridge 026C","E01003786","Total",453,442,11
"2011","Redbridge 026D","E01003787","Total",482,469,13
"2011","Redbridge 027A","E01003790","Total",574,557,17
"2011","Redbridge 027B","E01003791","Total",552,540,12
"2011","Redbridge 027C","E01003792","Total",516,508,8
"2011","Redbridge 027D","E01003793","Total",774,760,14
"2011","Redbridge 029A","E01003783","Total",894,858,36
"2011","Redbridge 029B","E01003784","Total",555,546,9
"2011","Redbridge 029C","E01003785","Total",714,704,10
"2011","Redbridge 029D","E01003788","Total",665,645,20
"2011","Redbridge 030A","E01003683","Total",590,576,14
"2011","Redbridge 030B","E01003684","Total",504,496,8
"2011","Redbridge 030C","E01003685","Total",521,508,13
"2011","Redbridge 030D","E01003686","Total",546,533,13
"2011","Redbridge 030F","E01003688","Total",549,532,17
"2011","Redbridge 030G","E01003689","Total",526,508,18
"2011","Redbridge 030H","E01033589","Total",696,660,36
"2011","Redbridge 030I","E01033591","Total",654,630,24
"2011","Redbridge 031A","E01003737","Total",591,575,16
"2011","Redbridge 031B","E01003738","Total",656,646,10
"2011","Redbridge 031C","E01003739","Total",667,658,9
"2011","Redbridge 031D","E01003740","Total",642,621,21
"2011","Redbridge 031E","E01003741","Total",650,643,7
"2011","Redbridge 031F","E01003742","Total",628,618,10
"2011","Redbridge 031G","E01003743","Total",512,496,16
"2011","Redbridge 032A","E01003728","Total",831,810,21
"2011","Redbridge 032B","E01003729","Total",546,526,20
"2011","Redbridge 032C","E01003730","Total",430,416,14
"2011","Redbridge 032D","E01003732","Total",604,592,12
"2011","Redbridge 032E","E01003733","Total",522,507,15
"2011","Redbridge 033A","E01003731","Total",454,447,7
"2011","Redbridge 033B","E01003734","Total",532,517,15
"2011","Redbridge 033C","E01003735","Total",818,811,7
"2011","Redbridge 033D","E01003736","Total",486,475,11
"2011","Redbridge 034A","E01003713","Total",484,481,3
"2011","Redbridge 034B","E01003714","Total",658,642,16
"2011","Redbridge 034C","E01003715","Total",578,564,14
"2011","Redbridge 034D","E01003716","Total",530,521,9
"2011","Redbridge 034E","E01003718","Total",641,630,11
"2011","Redbridge 034F","E01003719","Total",640,633,7
"2011","Redbridge 034G","E01032581","Total",711,699,12
"2011","Redbridge 035A","E01003690","Total",651,608,43
"2011","Redbridge 035B","E01003691","Total",421,413,8
"2011","Redbridge 035C","E01003692","Total",512,501,11
"2011","Redbridge 035D","E01003693","Total",433,431,2
"2011","Redbridge 035E","E01003694","Total",451,448,3
"2011","Redbridge 035F","E01003695","Total",548,534,14
"2011","Redbridge 035G","E01003696","Total",606,593,13
"2011","Redbridge 035H","E01003697","Total",499,492,7
"2011","Redbridge 036A","E01003675","Total",501,490,11
"2011","Redbridge 036B","E01003676","Total",506,495,11
"2011","Redbridge 036C","E01003677","Total",502,494,8
"2011","Redbridge 036D","E01003678","Total",491,479,12
"2011","Redbridge 036E","E01003679","Total",498,493,5
"2011","Redbridge 036F","E01003680","Total",486,475,11
"2011","Redbridge 036G","E01003681","Total",693,683,10
"2011","Redbridge 036H","E01003682","Total",504,493,11
"2011","Richmond upon Thames 001A","E01003797","Total",567,523,44
"2011","Richmond upon Thames 001B","E01003798","Total",726,691,35
"2011","Richmond upon Thames 001C","E01003799","Total",674,653,21
"2011","Richmond upon Thames 001D","E01003800","Total",661,640,21
"2011","Richmond upon Thames 001E","E01003801","Total",571,534,37
"2011","Richmond upon Thames 001F","E01003802","Total",711,623,88
"2011","Richmond upon Thames 001G","E01003803","Total",656,632,24
"2011","Richmond upon Thames 002A","E01003846","Total",638,628,10
"2011","Richmond upon Thames 002B","E01003847","Total",925,842,83
"2011","Richmond upon Thames 002C","E01003849","Total",692,653,39
"2011","Richmond upon Thames 002D","E01003851","Total",725,691,34
"2011","Richmond upon Thames 002E","E01003860","Total",865,819,46
"2011","Richmond upon Thames 002F","E01003864","Total",689,671,18
"2011","Richmond upon Thames 003A","E01003852","Total",669,652,17
"2011","Richmond upon Thames 003B","E01003853","Total",646,622,24
"2011","Richmond upon Thames 003C","E01003854","Total",685,653,32
"2011","Richmond upon Thames 003D","E01003855","Total",862,831,31
"2011","Richmond upon Thames 003E","E01003856","Total",767,749,18
"2011","Richmond upon Thames 003F","E01003857","Total",780,756,24
"2011","Richmond upon Thames 003G","E01003858","Total",695,678,17
"2011","Richmond upon Thames 004A","E01003848","Total",841,817,24
"2011","Richmond upon Thames 004C","E01003861","Total",893,855,38
"2011","Richmond upon Thames 004D","E01003862","Total",642,627,15
"2011","Richmond upon Thames 004E","E01003863","Total",663,639,24
"2011","Richmond upon Thames 004F","E01003865","Total",543,529,14
"2011","Richmond upon Thames 004G","E01033570","Total",765,709,56
"2011","Richmond upon Thames 004H","E01033571","Total",635,624,11
"2011","Richmond upon Thames 005A","E01003804","Total",787,768,19
"2011","Richmond upon Thames 005B","E01003807","Total",857,817,40
"2011","Richmond upon Thames 005C","E01003808","Total",813,793,20
"2011","Richmond upon Thames 005D","E01003809","Total",680,657,23
"2011","Richmond upon Thames 005E","E01003859","Total",648,631,17
"2011","Richmond upon Thames 006A","E01003873","Total",903,850,53
"2011","Richmond upon Thames 006B","E01003874","Total",830,787,43
"2011","Richmond upon Thames 006C","E01003875","Total",710,681,29
"2011","Richmond upon Thames 006D","E01003878","Total",665,648,17
"2011","Richmond upon Thames 007A","E01003866","Total",660,642,18
"2011","Richmond upon Thames 007B","E01003868","Total",658,639,19
"2011","Richmond upon Thames 007C","E01003871","Total",677,642,35
"2011","Richmond upon Thames 007D","E01003872","Total",713,686,27
"2011","Richmond upon Thames 008A","E01003821","Total",852,784,68
"2011","Richmond upon Thames 008B","E01003876","Total",959,865,94
"2011","Richmond upon Thames 008C","E01003877","Total",772,724,48
"2011","Richmond upon Thames 008D","E01003879","Total",637,613,24
"2011","Richmond upon Thames 009A","E01003892","Total",986,924,62
"2011","Richmond upon Thames 009B","E01003893","Total",789,759,30
"2011","Richmond upon Thames 009C","E01003894","Total",795,760,35
"2011","Richmond upon Thames 009D","E01003895","Total",792,766,26
"2011","Richmond upon Thames 010A","E01003905","Total",555,548,7
"2011","Richmond upon Thames 010B","E01003906","Total",672,649,23
"2011","Richmond upon Thames 010C","E01003907","Total",688,673,15
"2011","Richmond upon Thames 010D","E01003908","Total",684,668,16
"2011","Richmond upon Thames 010E","E01003909","Total",628,606,22
"2011","Richmond upon Thames 011A","E01003867","Total",588,576,12
"2011","Richmond upon Thames 011B","E01003869","Total",709,693,16
"2011","Richmond upon Thames 011C","E01003870","Total",739,721,18
"2011","Richmond upon Thames 011D","E01003910","Total",677,670,7
"2011","Richmond upon Thames 012A","E01003805","Total",619,593,26
"2011","Richmond upon Thames 012B","E01003806","Total",538,523,15
"2011","Richmond upon Thames 012C","E01003816","Total",657,640,17
"2011","Richmond upon Thames 012D","E01003817","Total",906,867,39
"2011","Richmond upon Thames 013A","E01003840","Total",572,560,12
"2011","Richmond upon Thames 013B","E01003841","Total",829,811,18
"2011","Richmond upon Thames 013C","E01003842","Total",627,619,8
"2011","Richmond upon Thames 013D","E01003843","Total",767,753,14
"2011","Richmond upon Thames 013E","E01003844","Total",561,553,8
"2011","Richmond upon Thames 013F","E01003845","Total",640,622,18
"2011","Richmond upon Thames 014A","E01003882","Total",810,793,17
"2011","Richmond upon Thames 014B","E01003883","Total",855,836,19
"2011","Richmond upon Thames 014C","E01003896","Total",837,796,41
"2011","Richmond upon Thames 014D","E01003897","Total",858,848,10
"2011","Richmond upon Thames 015A","E01003898","Total",696,675,21
"2011","Richmond upon Thames 015B","E01003899","Total",648,632,16
"2011","Richmond upon Thames 015C","E01003900","Total",630,614,16
"2011","Richmond upon Thames 015D","E01003901","Total",614,605,9
"2011","Richmond upon Thames 015E","E01003902","Total",508,503,5
"2011","Richmond upon Thames 015F","E01003903","Total",590,580,10
"2011","Richmond upon Thames 015G","E01003904","Total",680,671,9
"2011","Richmond upon Thames 016A","E01003880","Total",601,581,20
"2011","Richmond upon Thames 016B","E01003881","Total",513,492,21
"2011","Richmond upon Thames 016C","E01003884","Total",714,698,16
"2011","Richmond upon Thames 016D","E01003885","Total",660,647,13
"2011","Richmond upon Thames 017A","E01003818","Total",674,661,13
"2011","Richmond upon Thames 017B","E01003819","Total",764,747,17
"2011","Richmond upon Thames 017C","E01003820","Total",761,751,10
"2011","Richmond upon Thames 018A","E01003811","Total",653,640,13
"2011","Richmond upon Thames 018B","E01003812","Total",789,772,17
"2011","Richmond upon Thames 018C","E01003890","Total",663,642,21
"2011","Richmond upon Thames 018D","E01003891","Total",879,826,53
"2011","Richmond upon Thames 019A","E01003810","Total",632,613,19
"2011","Richmond upon Thames 019B","E01003813","Total",657,643,14
"2011","Richmond upon Thames 019C","E01003814","Total",781,760,21
"2011","Richmond upon Thames 019D","E01003815","Total",853,824,29
"2011","Richmond upon Thames 020A","E01003828","Total",636,630,6
"2011","Richmond upon Thames 020B","E01003829","Total",717,686,31
"2011","Richmond upon Thames 020C","E01003830","Total",745,734,11
"2011","Richmond upon Thames 020D","E01003831","Total",707,697,10
"2011","Richmond upon Thames 020E","E01003832","Total",697,681,16
"2011","Richmond upon Thames 020F","E01003833","Total",682,658,24
"2011","Richmond upon Thames 021A","E01003886","Total",698,684,14
"2011","Richmond upon Thames 021B","E01003887","Total",810,789,21
"2011","Richmond upon Thames 021C","E01003888","Total",926,896,30
"2011","Richmond upon Thames 021D","E01003889","Total",816,779,37
"2011","Richmond upon Thames 022A","E01003834","Total",905,829,76
"2011","Richmond upon Thames 022B","E01003835","Total",613,537,76
"2011","Richmond upon Thames 022C","E01003836","Total",625,613,12
"2011","Richmond upon Thames 022D","E01003837","Total",836,802,34
"2011","Richmond upon Thames 022E","E01003838","Total",779,758,21
"2011","Richmond upon Thames 022F","E01003839","Total",961,916,45
"2011","Richmond upon Thames 023A","E01003822","Total",527,516,11
"2011","Richmond upon Thames 023B","E01003823","Total",852,796,56
"2011","Richmond upon Thames 023C","E01003824","Total",665,649,16
"2011","Richmond upon Thames 023D","E01003825","Total",662,653,9
"2011","Richmond upon Thames 023E","E01003826","Total",782,760,22
"2011","Richmond upon Thames 023F","E01003827","Total",841,800,41
"2011","Sutton 001A","E01004125","Total",635,630,5
"2011","Sutton 001B","E01004183","Total",666,663,3
"2011","Sutton 001C","E01004184","Total",606,598,8
"2011","Sutton 001D","E01004185","Total",588,565,23
"2011","Sutton 001E","E01004189","Total",752,750,2
"2011","Sutton 002A","E01004123","Total",845,838,7
"2011","Sutton 002B","E01004124","Total",657,655,2
"2011","Sutton 002C","E01004126","Total",570,564,6
"2011","Sutton 002D","E01004128","Total",532,528,4
"2011","Sutton 002E","E01004129","Total",752,750,2
"2011","Sutton 003A","E01004130","Total",651,644,7
"2011","Sutton 003B","E01004131","Total",626,613,13
"2011","Sutton 003C","E01004134","Total",563,555,8
"2011","Sutton 003D","E01004135","Total",528,517,11
"2011","Sutton 003E","E01004136","Total",562,550,12
"2011","Sutton 004A","E01004164","Total",649,639,10
"2011","Sutton 004B","E01004166","Total",662,658,4
"2011","Sutton 004C","E01004169","Total",466,460,6
"2011","Sutton 004D","E01004186","Total",807,790,17
"2011","Sutton 004E","E01004188","Total",733,724,9
"2011","Sutton 005A","E01004127","Total",634,630,4
"2011","Sutton 005B","E01004163","Total",625,615,10
"2011","Sutton 005C","E01004165","Total",706,705,1
"2011","Sutton 005D","E01004167","Total",533,527,6
"2011","Sutton 005E","E01004187","Total",650,640,10
"2011","Sutton 006A","E01004117","Total",513,508,5
"2011","Sutton 006B","E01004121","Total",632,627,5
"2011","Sutton 006C","E01004192","Total",764,753,11
"2011","Sutton 006D","E01004193","Total",942,923,19
"2011","Sutton 006E","E01004195","Total",673,661,12
"2011","Sutton 007A","E01004144","Total",643,633,10
"2011","Sutton 007B","E01004145","Total",794,786,8
"2011","Sutton 007C","E01004146","Total",705,686,19
"2011","Sutton 007D","E01004147","Total",607,603,4
"2011","Sutton 008A","E01004116","Total",649,640,9
"2011","Sutton 008B","E01004122","Total",528,517,11
"2011","Sutton 008C","E01004190","Total",507,499,8
"2011","Sutton 008D","E01004191","Total",672,657,15
"2011","Sutton 008E","E01004194","Total",617,609,8
"2011","Sutton 008F","E01004196","Total",576,567,9
"2011","Sutton 009A","E01004115","Total",673,664,9
"2011","Sutton 009B","E01004118","Total",678,669,9
"2011","Sutton 009C","E01004119","Total",513,506,7
"2011","Sutton 009D","E01004132","Total",520,514,6
"2011","Sutton 009E","E01004133","Total",538,533,5
"2011","Sutton 010A","E01004171","Total",564,558,6
"2011","Sutton 010B","E01004172","Total",765,748,17
"2011","Sutton 010C","E01004173","Total",523,520,3
"2011","Sutton 010D","E01004175","Total",693,690,3
"2011","Sutton 010E","E01004176","Total",597,583,14
"2011","Sutton 011A","E01004076","Total",627,616,11
"2011","Sutton 011B","E01004077","Total",638,629,9
"2011","Sutton 011C","E01004078","Total",700,686,14
"2011","Sutton 011D","E01004079","Total",495,489,6
"2011","Sutton 011E","E01004080","Total",512,506,6
"2011","Sutton 011F","E01004081","Total",631,615,16
"2011","Sutton 011G","E01004082","Total",500,496,4
"2011","Sutton 012A","E01004137","Total",780,763,17
"2011","Sutton 012B","E01004140","Total",760,746,14
"2011","Sutton 012C","E01004141","Total",742,724,18
"2011","Sutton 012D","E01004142","Total",1085,1052,33
"2011","Sutton 012E","E01004149","Total",822,813,9
"2011","Sutton 013A","E01004101","Total",538,531,7
"2011","Sutton 013B","E01004103","Total",746,734,12
"2011","Sutton 013C","E01004138","Total",712,697,15
"2011","Sutton 013D","E01004139","Total",614,595,19
"2011","Sutton 013E","E01004168","Total",590,579,11
"2011","Sutton 014A","E01004143","Total",642,626,16
"2011","Sutton 014B","E01004148","Total",651,643,8
"2011","Sutton 014C","E01004159","Total",636,629,7
"2011","Sutton 014D","E01004160","Total",684,672,12
"2011","Sutton 014E","E01004161","Total",606,594,12
"2011","Sutton 015A","E01004097","Total",629,625,4
"2011","Sutton 015B","E01004098","Total",512,504,8
"2011","Sutton 015C","E01004099","Total",724,711,13
"2011","Sutton 015D","E01004100","Total",547,536,11
"2011","Sutton 015E","E01004102","Total",564,556,8
"2011","Sutton 016A","E01004110","Total",816,790,26
"2011","Sutton 016B","E01004111","Total",586,578,8
"2011","Sutton 016C","E01004112","Total",686,668,18
"2011","Sutton 016D","E01004120","Total",548,547,1
"2011","Sutton 016E","E01004157","Total",458,452,6
"2011","Sutton 017A","E01004087","Total",527,522,5
"2011","Sutton 017B","E01004170","Total",926,751,175
"2011","Sutton 017C","E01004174","Total",681,664,17
"2011","Sutton 017D","E01004178","Total",984,950,34
"2011","Sutton 017E","E01004179","Total",614,599,15
"2011","Sutton 018A","E01004152","Total",887,849,38
"2011","Sutton 018B","E01004155","Total",848,822,26
"2011","Sutton 018C","E01004156","Total",939,892,47
"2011","Sutton 018D","E01004158","Total",716,696,20
"2011","Sutton 018E","E01004162","Total",778,745,33
"2011","Sutton 019A","E01004083","Total",617,612,5
"2011","Sutton 019B","E01004086","Total",652,592,60
"2011","Sutton 019C","E01004088","Total",746,733,13
"2011","Sutton 019D","E01004089","Total",557,549,8
"2011","Sutton 019E","E01004182","Total",673,653,20
"2011","Sutton 020A","E01004104","Total",560,551,9
"2011","Sutton 020B","E01004107","Total",623,619,4
"2011","Sutton 020C","E01004177","Total",953,911,42
"2011","Sutton 020D","E01004180","Total",631,616,15
"2011","Sutton 020E","E01004181","Total",771,756,15
"2011","Sutton 021A","E01004090","Total",554,540,14
"2011","Sutton 021B","E01004096","Total",785,756,29
"2011","Sutton 021C","E01004150","Total",1001,936,65
"2011","Sutton 021D","E01004151","Total",838,790,48
"2011","Sutton 021E","E01004153","Total",929,903,26
"2011","Sutton 022A","E01004091","Total",481,474,7
"2011","Sutton 022B","E01004092","Total",603,585,18
"2011","Sutton 022C","E01004105","Total",659,647,12
"2011","Sutton 022D","E01004106","Total",526,522,4
"2011","Sutton 022E","E01004154","Total",574,561,13
"2011","Sutton 024A","E01004084","Total",512,504,8
"2011","Sutton 024B","E01004085","Total",590,582,8
"2011","Sutton 024C","E01004108","Total",603,595,8
"2011","Sutton 024D","E01004109","Total",643,638,5
"2011","Sutton 025A","E01004093","Total",618,598,20
"2011","Sutton 025B","E01004094","Total",787,748,39
"2011","Sutton 025C","E01004095","Total",647,635,12
"2011","Sutton 025D","E01004114","Total",611,595,16
"2011","Sutton 025E","E01032623","Total",633,619,14
"2011","Waltham Forest 001A","E01004349","Total",556,547,9
"2011","Waltham Forest 001B","E01004350","Total",936,915,21
"2011","Waltham Forest 001C","E01004351","Total",661,645,16
"2011","Waltham Forest 001D","E01004356","Total",592,590,2
"2011","Waltham Forest 001E","E01004357","Total",580,574,6
"2011","Waltham Forest 002A","E01004352","Total",832,813,19
"2011","Waltham Forest 002B","E01004353","Total",815,798,17
"2011","Waltham Forest 002C","E01004354","Total",770,749,21
"2011","Waltham Forest 002D","E01004358","Total",814,788,26
"2011","Waltham Forest 002E","E01004359","Total",620,610,10
"2011","Waltham Forest 003A","E01004384","Total",703,695,8
"2011","Waltham Forest 003B","E01004385","Total",671,650,21
"2011","Waltham Forest 003C","E01004386","Total",656,642,14
"2011","Waltham Forest 003D","E01004389","Total",711,706,5
"2011","Waltham Forest 003E","E01004390","Total",660,652,8
"2011","Waltham Forest 004A","E01004355","Total",676,673,3
"2011","Waltham Forest 004B","E01004360","Total",495,492,3
"2011","Waltham Forest 004C","E01004413","Total",689,685,4
"2011","Waltham Forest 004D","E01004415","Total",591,583,8
"2011","Waltham Forest 004E","E01004416","Total",648,632,16
"2011","Waltham Forest 005A","E01004361","Total",495,492,3
"2011","Waltham Forest 005B","E01004414","Total",621,615,6
"2011","Waltham Forest 005C","E01004417","Total",675,650,25
"2011","Waltham Forest 005D","E01004451","Total",641,641,0
"2011","Waltham Forest 005E","E01004452","Total",699,692,7
"2011","Waltham Forest 006A","E01004450","Total",609,605,4
"2011","Waltham Forest 006B","E01004453","Total",662,658,4
"2011","Waltham Forest 006C","E01004454","Total",642,640,2
"2011","Waltham Forest 006D","E01004455","Total",549,544,5
"2011","Waltham Forest 006E","E01004456","Total",540,539,1
"2011","Waltham Forest 007A","E01004379","Total",526,523,3
"2011","Waltham Forest 007B","E01004380","Total",622,607,15
"2011","Waltham Forest 007C","E01004381","Total",691,674,17
"2011","Waltham Forest 007D","E01004383","Total",586,575,11
"2011","Waltham Forest 007E","E01004387","Total",531,525,6
"2011","Waltham Forest 007F","E01004388","Total",665,649,16
"2011","Waltham Forest 008A","E01004343","Total",657,647,10
"2011","Waltham Forest 008B","E01004344","Total",677,667,10
"2011","Waltham Forest 008C","E01004382","Total",519,501,18
"2011","Waltham Forest 008D","E01004418","Total",663,649,14
"2011","Waltham Forest 008E","E01004419","Total",660,637,23
"2011","Waltham Forest 009A","E01004398","Total",686,679,7
"2011","Waltham Forest 009B","E01004399","Total",597,594,3
"2011","Waltham Forest 009C","E01004400","Total",653,641,12
"2011","Waltham Forest 009D","E01004402","Total",672,663,9
"2011","Waltham Forest 009E","E01004403","Total",619,602,17
"2011","Waltham Forest 010A","E01004345","Total",644,624,20
"2011","Waltham Forest 010B","E01004348","Total",1003,973,30
"2011","Waltham Forest 010C","E01004377","Total",635,626,9
"2011","Waltham Forest 010D","E01004378","Total",707,677,30
"2011","Waltham Forest 011A","E01004342","Total",813,789,24
"2011","Waltham Forest 011B","E01004346","Total",569,557,12
"2011","Waltham Forest 011C","E01004347","Total",821,809,12
"2011","Waltham Forest 011D","E01004460","Total",681,671,10
"2011","Waltham Forest 011E","E01004462","Total",649,639,10
"2011","Waltham Forest 012A","E01004396","Total",652,647,5
"2011","Waltham Forest 012B","E01004457","Total",749,738,11
"2011","Waltham Forest 012C","E01004458","Total",691,681,10
"2011","Waltham Forest 012D","E01004459","Total",537,535,2
"2011","Waltham Forest 012E","E01004463","Total",929,906,23
"2011","Waltham Forest 013A","E01004407","Total",493,493,0
"2011","Waltham Forest 013B","E01004410","Total",867,852,15
"2011","Waltham Forest 013C","E01004464","Total",649,643,6
"2011","Waltham Forest 013D","E01004469","Total",631,627,4
"2011","Waltham Forest 013E","E01004470","Total",608,602,6
"2011","Waltham Forest 013F","E01004471","Total",675,668,7
"2011","Waltham Forest 014A","E01004391","Total",850,846,4
"2011","Waltham Forest 014B","E01004393","Total",1031,1023,8
"2011","Waltham Forest 014C","E01004401","Total",818,803,15
"2011","Waltham Forest 014D","E01004404","Total",902,882,20
"2011","Waltham Forest 014E","E01004461","Total",807,794,13
"2011","Waltham Forest 015A","E01004412","Total",752,740,12
"2011","Waltham Forest 015B","E01004465","Total",550,543,7
"2011","Waltham Forest 015C","E01004466","Total",649,638,11
"2011","Waltham Forest 015D","E01004467","Total",903,881,22
"2011","Waltham Forest 015E","E01004468","Total",667,657,10
"2011","Waltham Forest 016A","E01004406","Total",751,731,20
"2011","Waltham Forest 016B","E01004408","Total",678,676,2
"2011","Waltham Forest 016C","E01004409","Total",726,711,15
"2011","Waltham Forest 016D","E01004411","Total",659,648,11
"2011","Waltham Forest 016E","E01004443","Total",598,586,12
"2011","Waltham Forest 016F","E01004447","Total",668,653,15
"2011","Waltham Forest 017A","E01004392","Total",905,879,26
"2011","Waltham Forest 017B","E01004394","Total",761,744,17
"2011","Waltham Forest 017C","E01004397","Total",856,849,7
"2011","Waltham Forest 017D","E01004444","Total",982,966,16
"2011","Waltham Forest 017E","E01004446","Total",694,677,17
"2011","Waltham Forest 018A","E01004395","Total",568,565,3
"2011","Waltham Forest 018B","E01004421","Total",613,604,9
"2011","Waltham Forest 018C","E01004445","Total",644,624,20
"2011","Waltham Forest 018D","E01004448","Total",785,759,26
"2011","Waltham Forest 018E","E01004449","Total",609,599,10
"2011","Waltham Forest 019A","E01004363","Total",513,506,7
"2011","Waltham Forest 019B","E01004364","Total",577,563,14
"2011","Waltham Forest 019C","E01004366","Total",655,642,13
"2011","Waltham Forest 019D","E01004367","Total",554,537,17
"2011","Waltham Forest 019E","E01004368","Total",744,720,24
"2011","Waltham Forest 020A","E01004365","Total",719,700,19
"2011","Waltham Forest 020B","E01004405","Total",583,566,17
"2011","Waltham Forest 020C","E01004420","Total",799,790,9
"2011","Waltham Forest 020D","E01004423","Total",712,697,15
"2011","Waltham Forest 020G","E01033153","Total",947,936,11
"2011","Waltham Forest 021A","E01004362","Total",686,676,10
"2011","Waltham Forest 021B","E01004436","Total",590,580,10
"2011","Waltham Forest 021C","E01004437","Total",794,762,32
"2011","Waltham Forest 021D","E01004439","Total",648,619,29
"2011","Waltham Forest 021E","E01004442","Total",683,668,15
"2011","Waltham Forest 022A","E01004422","Total",606,589,17
"2011","Waltham Forest 022B","E01004424","Total",640,627,13
"2011","Waltham Forest 022C","E01004425","Total",875,848,27
"2011","Waltham Forest 022D","E01004426","Total",596,590,6
"2011","Waltham Forest 022E","E01004427","Total",885,852,33
"2011","Waltham Forest 023A","E01004369","Total",626,615,11
"2011","Waltham Forest 023B","E01004370","Total",649,636,13
"2011","Waltham Forest 023C","E01004372","Total",756,744,12
"2011","Waltham Forest 023D","E01004432","Total",668,652,16
"2011","Waltham Forest 023E","E01004435","Total",766,749,17
"2011","Waltham Forest 024A","E01004333","Total",624,611,13
"2011","Waltham Forest 024B","E01004334","Total",648,637,11
"2011","Waltham Forest 024C","E01004438","Total",796,772,24
"2011","Waltham Forest 024D","E01004440","Total",823,794,29
"2011","Waltham Forest 024E","E01004441","Total",646,635,11
"2011","Waltham Forest 025A","E01004371","Total",632,615,17
"2011","Waltham Forest 025B","E01004373","Total",632,621,11
"2011","Waltham Forest 025C","E01004374","Total",699,688,11
"2011","Waltham Forest 025D","E01004375","Total",665,647,18
"2011","Waltham Forest 025E","E01004376","Total",673,654,19
"2011","Waltham Forest 026A","E01004336","Total",583,564,19
"2011","Waltham Forest 026B","E01004428","Total",659,653,6
"2011","Waltham Forest 026C","E01004429","Total",670,653,17
"2011","Waltham Forest 026D","E01004430","Total",838,827,11
"2011","Waltham Forest 026E","E01004434","Total",755,737,18
"2011","Waltham Forest 027A","E01004335","Total",653,645,8
"2011","Waltham Forest 027B","E01004337","Total",734,717,17
"2011","Waltham Forest 027C","E01004338","Total",592,580,12
"2011","Waltham Forest 027D","E01004339","Total",679,661,18
"2011","Waltham Forest 027E","E01004340","Total",708,698,10
"2011","Waltham Forest 027F","E01004341","Total",685,665,20
"2011","Waltham Forest 028A","E01004327","Total",473,465,8
"2011","Waltham Forest 028B","E01004328","Total",683,671,12
"2011","Waltham Forest 028C","E01004329","Total",682,671,11
"2011","Waltham Forest 028D","E01004330","Total",640,625,15
"2011","Waltham Forest 028E","E01004331","Total",692,675,17
"2011","Waltham Forest 028F","E01004332","Total",652,633,19
"2011","Bracknell Forest 001C","E01016252","Total",738,658,80
"2011","Bracknell Forest 001D","E01016253","Total",533,521,12
"2011","Bracknell Forest 001E","E01032727","Total",1350,1308,42
"2011","Bracknell Forest 002A","E01016184","Total",899,868,31
"2011","Bracknell Forest 002B","E01016185","Total",633,607,26
"2011","Bracknell Forest 002C","E01016186","Total",762,731,31
"2011","Bracknell Forest 002D","E01016187","Total",676,667,9
"2011","Bracknell Forest 002E","E01016188","Total",671,661,10
"2011","Bracknell Forest 003A","E01016190","Total",622,609,13
"2011","Bracknell Forest 003B","E01016238","Total",494,483,11
"2011","Bracknell Forest 003C","E01016243","Total",600,592,8
"2011","Bracknell Forest 003D","E01016245","Total",896,889,7
"2011","Bracknell Forest 003E","E01016246","Total",615,607,8
"2011","Bracknell Forest 003F","E01016247","Total",698,692,6
"2011","Bracknell Forest 004A","E01016239","Total",618,610,8
"2011","Bracknell Forest 004B","E01016240","Total",655,646,9
"2011","Bracknell Forest 004C","E01016241","Total",667,647,20
"2011","Bracknell Forest 004D","E01016242","Total",842,805,37
"2011","Bracknell Forest 005A","E01016180","Total",575,558,17
"2011","Bracknell Forest 005B","E01016181","Total",575,540,35
"2011","Bracknell Forest 005C","E01016182","Total",635,614,21
"2011","Bracknell Forest 005D","E01016183","Total",534,516,18
"2011","Bracknell Forest 005E","E01016222","Total",506,503,3
"2011","Bracknell Forest 006B","E01016191","Total",655,651,4
"2011","Bracknell Forest 006C","E01016223","Total",659,648,11
"2011","Bracknell Forest 006D","E01016224","Total",766,756,10
"2011","Bracknell Forest 006E","E01016226","Total",641,625,16
"2011","Bracknell Forest 006F","E01032724","Total",646,630,16
"2011","Bracknell Forest 006G","E01032728","Total",657,641,16
"2011","Bracknell Forest 007A","E01016225","Total",913,888,25
"2011","Bracknell Forest 007B","E01016233","Total",1079,1027,52
"2011","Bracknell Forest 007C","E01016248","Total",580,568,12
"2011","Bracknell Forest 007D","E01016249","Total",853,797,56
"2011","Bracknell Forest 007E","E01016250","Total",734,708,26
"2011","Bracknell Forest 008A","E01016200","Total",569,562,7
"2011","Bracknell Forest 008B","E01016201","Total",576,565,11
"2011","Bracknell Forest 008C","E01016202","Total",647,635,12
"2011","Bracknell Forest 008D","E01016203","Total",600,591,9
"2011","Bracknell Forest 008E","E01016204","Total",486,482,4
"2011","Bracknell Forest 009A","E01016209","Total",559,553,6
"2011","Bracknell Forest 009B","E01016210","Total",487,483,4
"2011","Bracknell Forest 009D","E01016213","Total",433,428,5
"2011","Bracknell Forest 009E","E01016214","Total",509,509,0
"2011","Bracknell Forest 009F","E01016215","Total",489,480,9
"2011","Bracknell Forest 009G","E01032725","Total",633,604,29
"2011","Bracknell Forest 009H","E01032726","Total",556,548,8
"2011","Bracknell Forest 010A","E01016205","Total",550,546,4
"2011","Bracknell Forest 010B","E01016217","Total",583,578,5
"2011","Bracknell Forest 010C","E01016218","Total",642,634,8
"2011","Bracknell Forest 010D","E01016231","Total",782,764,18
"2011","Bracknell Forest 010E","E01016232","Total",621,611,10
"2011","Bracknell Forest 011A","E01016212","Total",498,493,5
"2011","Bracknell Forest 011B","E01016216","Total",567,561,6
"2011","Bracknell Forest 011C","E01016219","Total",554,545,9
"2011","Bracknell Forest 011D","E01016220","Total",587,578,9
"2011","Bracknell Forest 011E","E01016221","Total",589,580,9
"2011","Bracknell Forest 012A","E01016206","Total",773,747,26
"2011","Bracknell Forest 012B","E01016208","Total",916,836,80
"2011","Bracknell Forest 012C","E01016229","Total",499,491,8
"2011","Bracknell Forest 012D","E01016230","Total",473,459,14
"2011","Bracknell Forest 013A","E01016207","Total",524,512,12
"2011","Bracknell Forest 013B","E01016234","Total",461,459,2
"2011","Bracknell Forest 013C","E01016235","Total",491,487,4
"2011","Bracknell Forest 013D","E01016236","Total",584,578,6
"2011","Bracknell Forest 013E","E01016237","Total",480,473,7
"2011","Bracknell Forest 014A","E01016192","Total",640,612,28
"2011","Bracknell Forest 014B","E01016194","Total",519,511,8
"2011","Bracknell Forest 014C","E01016195","Total",482,473,9
"2011","Bracknell Forest 014D","E01016227","Total",485,482,3
"2011","Bracknell Forest 014E","E01016228","Total",585,574,11
"2011","Bracknell Forest 015A","E01016193","Total",535,528,7
"2011","Bracknell Forest 015B","E01016196","Total",570,557,13
"2011","Bracknell Forest 015C","E01016197","Total",515,511,4
"2011","Bracknell Forest 015D","E01016198","Total",536,517,19
"2011","Bracknell Forest 015E","E01016199","Total",477,470,7
"2011","Brighton and Hove 001A","E01016924","Total",591,582,9
"2011","Brighton and Hove 001B","E01016926","Total",613,606,7
"2011","Brighton and Hove 001C","E01016927","Total",640,626,14
"2011","Brighton and Hove 001D","E01016929","Total",648,639,9
"2011","Brighton and Hove 001E","E01016931","Total",644,635,9
"2011","Brighton and Hove 002A","E01016898","Total",766,757,9
"2011","Brighton and Hove 002B","E01016899","Total",411,404,7
"2011","Brighton and Hove 002C","E01016914","Total",516,506,10
"2011","Brighton and Hove 002D","E01016915","Total",509,499,10
"2011","Brighton and Hove 003A","E01016923","Total",690,675,15
"2011","Brighton and Hove 003B","E01016928","Total",672,662,10
"2011","Brighton and Hove 003C","E01016998","Total",600,591,9
"2011","Brighton and Hove 003D","E01016999","Total",579,569,10
"2011","Brighton and Hove 003E","E01017000","Total",892,851,41
"2011","Brighton and Hove 004A","E01016925","Total",617,612,5
"2011","Brighton and Hove 004B","E01016930","Total",774,760,14
"2011","Brighton and Hove 004C","E01017001","Total",611,598,13
"2011","Brighton and Hove 004D","E01017003","Total",684,671,13
"2011","Brighton and Hove 005A","E01016916","Total",614,611,3
"2011","Brighton and Hove 005B","E01016917","Total",583,578,5
"2011","Brighton and Hove 005C","E01016918","Total",598,592,6
"2011","Brighton and Hove 005D","E01016919","Total",554,551,3
"2011","Brighton and Hove 005E","E01016920","Total",646,638,8
"2011","Brighton and Hove 006A","E01016882","Total",634,627,7
"2011","Brighton and Hove 006B","E01016883","Total",673,661,12
"2011","Brighton and Hove 006C","E01016884","Total",635,616,19
"2011","Brighton and Hove 006D","E01016885","Total",645,619,26
"2011","Brighton and Hove 006E","E01016886","Total",630,623,7
"2011","Brighton and Hove 007A","E01016980","Total",586,570,16
"2011","Brighton and Hove 007B","E01016982","Total",510,498,12
"2011","Brighton and Hove 007C","E01016983","Total",551,535,16
"2011","Brighton and Hove 007D","E01016984","Total",597,575,22
"2011","Brighton and Hove 007E","E01016985","Total",638,626,12
"2011","Brighton and Hove 008A","E01016900","Total",771,764,7
"2011","Brighton and Hove 008B","E01016902","Total",584,577,7
"2011","Brighton and Hove 008C","E01016904","Total",689,684,5
"2011","Brighton and Hove 008D","E01016905","Total",823,803,20
"2011","Brighton and Hove 008E","E01016909","Total",656,647,9
"2011","Brighton and Hove 009A","E01016906","Total",609,603,6
"2011","Brighton and Hove 009B","E01016907","Total",589,579,10
"2011","Brighton and Hove 009C","E01016908","Total",592,577,15
"2011","Brighton and Hove 009D","E01016910","Total",544,541,3
"2011","Brighton and Hove 009E","E01016911","Total",548,543,5
"2011","Brighton and Hove 010A","E01016901","Total",620,611,9
"2011","Brighton and Hove 010B","E01016903","Total",702,690,12
"2011","Brighton and Hove 010C","E01016934","Total",535,528,7
"2011","Brighton and Hove 010D","E01016939","Total",616,604,12
"2011","Brighton and Hove 010E","E01016940","Total",626,616,10
"2011","Brighton and Hove 011A","E01016981","Total",674,657,17
"2011","Brighton and Hove 011B","E01017002","Total",809,774,35
"2011","Brighton and Hove 011C","E01017004","Total",805,776,29
"2011","Brighton and Hove 011D","E01017005","Total",731,715,16
"2011","Brighton and Hove 011E","E01017006","Total",790,763,27
"2011","Brighton and Hove 012A","E01016921","Total",654,640,14
"2011","Brighton and Hove 012B","E01016922","Total",533,523,10
"2011","Brighton and Hove 012C","E01016973","Total",656,648,8
"2011","Brighton and Hove 012D","E01016977","Total",626,618,8
"2011","Brighton and Hove 012E","E01016978","Total",757,716,41
"2011","Brighton and Hove 013A","E01016879","Total",562,558,4
"2011","Brighton and Hove 013B","E01016880","Total",503,495,8
"2011","Brighton and Hove 013C","E01016881","Total",619,605,14
"2011","Brighton and Hove 013D","E01016887","Total",630,619,11
"2011","Brighton and Hove 013E","E01016888","Total",606,587,19
"2011","Brighton and Hove 013F","E01016976","Total",630,623,7
"2011","Brighton and Hove 014A","E01016932","Total",712,687,25
"2011","Brighton and Hove 014B","E01016933","Total",651,635,16
"2011","Brighton and Hove 014C","E01016935","Total",850,813,37
"2011","Brighton and Hove 014D","E01016936","Total",712,684,28
"2011","Brighton and Hove 014E","E01016937","Total",1056,1019,37
"2011","Brighton and Hove 015A","E01016890","Total",843,777,66
"2011","Brighton and Hove 015B","E01016966","Total",782,753,29
"2011","Brighton and Hove 015C","E01016970","Total",723,696,27
"2011","Brighton and Hove 015D","E01016971","Total",782,756,26
"2011","Brighton and Hove 015E","E01016972","Total",826,804,22
"2011","Brighton and Hove 016A","E01016979","Total",633,625,8
"2011","Brighton and Hove 016B","E01016990","Total",769,749,20
"2011","Brighton and Hove 016C","E01016991","Total",845,794,51
"2011","Brighton and Hove 016D","E01016996","Total",718,703,15
"2011","Brighton and Hove 017A","E01017007","Total",666,652,14
"2011","Brighton and Hove 017B","E01017008","Total",706,694,12
"2011","Brighton and Hove 017C","E01017009","Total",643,631,12
"2011","Brighton and Hove 017D","E01017010","Total",706,695,11
"2011","Brighton and Hove 017E","E01017011","Total",546,531,15
"2011","Brighton and Hove 017F","E01017012","Total",729,721,8
"2011","Brighton and Hove 018A","E01016892","Total",643,628,15
"2011","Brighton and Hove 018B","E01016893","Total",784,773,11
"2011","Brighton and Hove 018C","E01016912","Total",802,785,17
"2011","Brighton and Hove 018D","E01016913","Total",623,612,11
"2011","Brighton and Hove 018E","E01016946","Total",633,620,13
"2011","Brighton and Hove 019A","E01016860","Total",864,795,69
"2011","Brighton and Hove 019B","E01016871","Total",1103,1059,44
"2011","Brighton and Hove 019C","E01016872","Total",1002,963,39
"2011","Brighton and Hove 019D","E01016873","Total",1050,1002,48
"2011","Brighton and Hove 019E","E01016878","Total",908,876,32
"2011","Brighton and Hove 020A","E01016870","Total",729,688,41
"2011","Brighton and Hove 020B","E01016874","Total",1143,1032,111
"2011","Brighton and Hove 020C","E01016875","Total",630,600,30
"2011","Brighton and Hove 020D","E01016876","Total",884,816,68
"2011","Brighton and Hove 020E","E01016877","Total",974,919,55
"2011","Brighton and Hove 021A","E01016974","Total",742,706,36
"2011","Brighton and Hove 021B","E01016975","Total",607,592,15
"2011","Brighton and Hove 021C","E01016992","Total",696,659,37
"2011","Brighton and Hove 021D","E01016994","Total",766,730,36
"2011","Brighton and Hove 021E","E01016997","Total",647,631,16
"2011","Brighton and Hove 022A","E01016889","Total",777,761,16
"2011","Brighton and Hove 022B","E01016891","Total",833,805,28
"2011","Brighton and Hove 022C","E01016894","Total",727,709,18
"2011","Brighton and Hove 022D","E01016896","Total",717,700,17
"2011","Brighton and Hove 022E","E01016897","Total",780,761,19
"2011","Brighton and Hove 023A","E01016987","Total",799,761,38
"2011","Brighton and Hove 023B","E01016989","Total",782,744,38
"2011","Brighton and Hove 023C","E01016993","Total",765,754,11
"2011","Brighton and Hove 023D","E01016995","Total",677,648,29
"2011","Brighton and Hove 024A","E01016938","Total",983,911,72
"2011","Brighton and Hove 024B","E01016950","Total",1056,1029,27
"2011","Brighton and Hove 024C","E01016951","Total",936,883,53
"2011","Brighton and Hove 024D","E01016967","Total",1142,1109,33
"2011","Brighton and Hove 024E","E01016968","Total",956,924,32
"2011","Brighton and Hove 025A","E01016864","Total",599,584,15
"2011","Brighton and Hove 025B","E01016865","Total",584,578,6
"2011","Brighton and Hove 025C","E01016866","Total",548,542,6
"2011","Brighton and Hove 025D","E01016867","Total",666,661,5
"2011","Brighton and Hove 025E","E01016868","Total",710,707,3
"2011","Brighton and Hove 025F","E01016895","Total",594,587,7
"2011","Brighton and Hove 026A","E01016849","Total",959,893,66
"2011","Brighton and Hove 026B","E01016852","Total",1015,964,51
"2011","Brighton and Hove 026C","E01016853","Total",1132,1113,19
"2011","Brighton and Hove 026D","E01016855","Total",1075,1021,54
"2011","Brighton and Hove 026E","E01016856","Total",1056,981,75
"2011","Brighton and Hove 027A","E01016952","Total",931,805,126
"2011","Brighton and Hove 027B","E01016953","Total",917,866,51
"2011","Brighton and Hove 027C","E01016964","Total",1065,1015,50
"2011","Brighton and Hove 027E","E01016969","Total",1120,1037,83
"2011","Brighton and Hove 027F","E01033328","Total",751,717,34
"2011","Brighton and Hove 027G","E01033329","Total",845,798,47
"2011","Brighton and Hove 028A","E01016857","Total",888,811,77
"2011","Brighton and Hove 028B","E01016858","Total",928,878,50
"2011","Brighton and Hove 028C","E01016859","Total",1005,891,114
"2011","Brighton and Hove 028D","E01016986","Total",895,841,54
"2011","Brighton and Hove 028E","E01016988","Total",798,737,61
"2011","Brighton and Hove 029A","E01016850","Total",1019,912,107
"2011","Brighton and Hove 029B","E01016851","Total",1107,992,115
"2011","Brighton and Hove 029C","E01016854","Total",1086,1001,85
"2011","Brighton and Hove 029D","E01016954","Total",1166,1110,56
"2011","Brighton and Hove 029E","E01016955","Total",1144,1037,107
"2011","Brighton and Hove 030A","E01016941","Total",1214,1118,96
"2011","Brighton and Hove 030B","E01016945","Total",1039,981,58
"2011","Brighton and Hove 030C","E01016947","Total",922,900,22
"2011","Brighton and Hove 030D","E01016948","Total",808,780,28
"2011","Brighton and Hove 030E","E01016949","Total",929,911,18
"2011","Brighton and Hove 031A","E01016861","Total",1047,907,140
"2011","Brighton and Hove 031B","E01016862","Total",917,845,72
"2011","Brighton and Hove 031C","E01016942","Total",1140,1114,26
"2011","Brighton and Hove 031D","E01016943","Total",717,696,21
"2011","Brighton and Hove 031E","E01016944","Total",995,862,133
"2011","Brighton and Hove 032A","E01016863","Total",977,928,49
"2011","Brighton and Hove 032B","E01016869","Total",845,809,36
"2011","Brighton and Hove 032C","E01016957","Total",1101,889,212
"2011","Brighton and Hove 032D","E01016963","Total",1104,958,146
"2011","Brighton and Hove 033A","E01016956","Total",740,717,23
"2011","Brighton and Hove 033B","E01016958","Total",843,821,22
"2011","Brighton and Hove 033C","E01016959","Total",656,619,37
"2011","Brighton and Hove 033D","E01016960","Total",885,829,56
"2011","Brighton and Hove 033E","E01016961","Total",873,792,81
"2011","Brighton and Hove 033F","E01016962","Total",774,734,40
"2011","Isle of Wight 001A","E01017300","Total",1591,1200,391
"2011","Isle of Wight 001B","E01017303","Total",627,550,77
"2011","Isle of Wight 001C","E01017305","Total",781,652,129
"2011","Isle of Wight 001D","E01017306","Total",577,553,24
"2011","Isle of Wight 001E","E01017309","Total",760,714,46
"2011","Isle of Wight 002A","E01017301","Total",508,488,20
"2011","Isle of Wight 002B","E01017302","Total",703,671,32
"2011","Isle of Wight 002C","E01017304","Total",584,560,24
"2011","Isle of Wight 002D","E01017316","Total",992,819,173
"2011","Isle of Wight 002E","E01017329","Total",1004,978,26
"2011","Isle of Wight 003A","E01017307","Total",958,902,56
"2011","Isle of Wight 003B","E01017308","Total",783,739,44
"2011","Isle of Wight 003D","E01033229","Total",766,647,119
"2011","Isle of Wight 003E","E01033237","Total",573,559,14
"2011","Isle of Wight 004A","E01017335","Total",893,765,128
"2011","Isle of Wight 004B","E01017336","Total",977,847,130
"2011","Isle of Wight 004C","E01017337","Total",892,797,95
"2011","Isle of Wight 004D","E01017346","Total",802,740,62
"2011","Isle of Wight 005A","E01017286","Total",745,694,51
"2011","Isle of Wight 005B","E01017287","Total",766,746,20
"2011","Isle of Wight 005C","E01017367","Total",932,861,71
"2011","Isle of Wight 005D","E01017368","Total",737,717,20
"2011","Isle of Wight 006A","E01017282","Total",604,590,14
"2011","Isle of Wight 006B","E01017283","Total",686,667,19
"2011","Isle of Wight 006C","E01017338","Total",662,625,37
"2011","Isle of Wight 006D","E01017341","Total",671,660,11
"2011","Isle of Wight 006E","E01017342","Total",755,726,29
"2011","Isle of Wight 007A","E01017339","Total",690,671,19
"2011","Isle of Wight 007B","E01017340","Total",829,799,30
"2011","Isle of Wight 007C","E01017343","Total",595,575,20
"2011","Isle of Wight 007D","E01017344","Total",771,729,42
"2011","Isle of Wight 007E","E01017345","Total",861,836,25
"2011","Isle of Wight 008A","E01017310","Total",540,520,20
"2011","Isle of Wight 008B","E01017311","Total",733,713,20
"2011","Isle of Wight 008C","E01017331","Total",682,671,11
"2011","Isle of Wight 008D","E01017332","Total",544,535,9
"2011","Isle of Wight 008E","E01017334","Total",500,478,22
"2011","Isle of Wight 009A","E01017295","Total",557,539,18
"2011","Isle of Wight 009B","E01017325","Total",645,612,33
"2011","Isle of Wight 009C","E01017326","Total",920,843,77
"2011","Isle of Wight 009D","E01017328","Total",713,667,46
"2011","Isle of Wight 009E","E01017333","Total",671,659,12
"2011","Isle of Wight 010A","E01017284","Total",1027,783,244
"2011","Isle of Wight 010B","E01017285","Total",1089,920,169
"2011","Isle of Wight 010C","E01017288","Total",718,590,128
"2011","Isle of Wight 010D","E01017351","Total",1079,679,400
"2011","Isle of Wight 010E","E01017352","Total",716,577,139
"2011","Isle of Wight 011A","E01017292","Total",672,665,7
"2011","Isle of Wight 011B","E01017293","Total",789,771,18
"2011","Isle of Wight 011C","E01017296","Total",563,527,36
"2011","Isle of Wight 011D","E01017321","Total",522,494,28
"2011","Isle of Wight 011E","E01017322","Total",623,609,14
"2011","Isle of Wight 011F","E01017327","Total",715,684,31
"2011","Isle of Wight 012A","E01017312","Total",838,767,71
"2011","Isle of Wight 012D","E01017315","Total",727,685,42
"2011","Isle of Wight 012E","E01017354","Total",768,590,178
"2011","Isle of Wight 012F","E01017361","Total",777,637,140
"2011","Isle of Wight 012G","E01017362","Total",766,661,105
"2011","Isle of Wight 012H","E01033239","Total",1376,1135,241
"2011","Isle of Wight 013A","E01017290","Total",698,588,110
"2011","Isle of Wight 013B","E01017291","Total",612,563,49
"2011","Isle of Wight 013C","E01017294","Total",694,657,37
"2011","Isle of Wight 013D","E01017353","Total",604,542,62
"2011","Isle of Wight 014A","E01017289","Total",984,910,74
"2011","Isle of Wight 014B","E01017347","Total",856,724,132
"2011","Isle of Wight 014C","E01017348","Total",584,538,46
"2011","Isle of Wight 014D","E01017349","Total",1044,936,108
"2011","Isle of Wight 014E","E01017350","Total",835,802,33
"2011","Isle of Wight 015A","E01017317","Total",698,672,26
"2011","Isle of Wight 015B","E01017320","Total",584,557,27
"2011","Isle of Wight 015C","E01017323","Total",535,510,25
"2011","Isle of Wight 015D","E01017324","Total",661,622,39
"2011","Isle of Wight 015E","E01017355","Total",705,663,42
"2011","Isle of Wight 015F","E01017358","Total",624,589,35
"2011","Isle of Wight 016A","E01017318","Total",542,522,20
"2011","Isle of Wight 016B","E01017319","Total",708,670,38
"2011","Isle of Wight 016C","E01017356","Total",746,686,60
"2011","Isle of Wight 016D","E01017357","Total",681,645,36
"2011","Isle of Wight 016E","E01017359","Total",791,685,106
"2011","Isle of Wight 016F","E01017360","Total",990,812,178
"2011","Isle of Wight 017A","E01017297","Total",655,606,49
"2011","Isle of Wight 017B","E01017298","Total",750,681,69
"2011","Isle of Wight 017C","E01017299","Total",646,546,100
"2011","Isle of Wight 017D","E01017369","Total",686,631,55
"2011","Isle of Wight 018A","E01017363","Total",1075,813,262
"2011","Isle of Wight 018B","E01017364","Total",896,699,197
"2011","Isle of Wight 018C","E01017365","Total",929,711,218
"2011","Isle of Wight 018D","E01017366","Total",679,623,56
"2011","Isle of Wight 018E","E01017370","Total",839,794,45
"2011","Medway 001A","E01016070","Total",896,731,165
"2011","Medway 001B","E01016071","Total",662,630,32
"2011","Medway 001C","E01016072","Total",554,525,29
"2011","Medway 001D","E01016074","Total",951,838,113
"2011","Medway 002A","E01016142","Total",524,491,33
"2011","Medway 002B","E01016144","Total",590,575,15
"2011","Medway 002C","E01016145","Total",503,485,18
"2011","Medway 002D","E01016149","Total",602,586,16
"2011","Medway 003A","E01016073","Total",818,794,24
"2011","Medway 003B","E01016075","Total",586,576,10
"2011","Medway 003C","E01016076","Total",971,920,51
"2011","Medway 003D","E01016077","Total",666,634,32
"2011","Medway 003E","E01016143","Total",989,949,40
"2011","Medway 004A","E01016146","Total",887,852,35
"2011","Medway 004B","E01016147","Total",751,738,13
"2011","Medway 004C","E01016148","Total",739,731,8
"2011","Medway 005A","E01016133","Total",550,539,11
"2011","Medway 005B","E01016134","Total",534,526,8
"2011","Medway 005C","E01016138","Total",597,592,5
"2011","Medway 005D","E01016139","Total",636,616,20
"2011","Medway 006A","E01016135","Total",645,624,21
"2011","Medway 006B","E01016136","Total",652,624,28
"2011","Medway 006C","E01016137","Total",638,614,24
"2011","Medway 006D","E01016140","Total",630,596,34
"2011","Medway 006E","E01016141","Total",777,723,54
"2011","Medway 007A","E01016035","Total",774,737,37
"2011","Medway 007D","E01016112","Total",1197,1162,35
"2011","Medway 007E","E01032798","Total",1499,1228,271
"2011","Medway 008A","E01016151","Total",641,623,18
"2011","Medway 008B","E01016152","Total",642,632,10
"2011","Medway 008C","E01016153","Total",625,607,18
"2011","Medway 008D","E01016155","Total",630,619,11
"2011","Medway 009A","E01016033","Total",485,474,11
"2011","Medway 009B","E01016036","Total",736,715,21
"2011","Medway 009C","E01016037","Total",692,665,27
"2011","Medway 009D","E01016039","Total",751,692,59
"2011","Medway 010A","E01016030","Total",709,696,13
"2011","Medway 010B","E01016032","Total",481,466,15
"2011","Medway 010C","E01016034","Total",1056,1035,21
"2011","Medway 010D","E01016038","Total",603,586,17
"2011","Medway 011A","E01016150","Total",628,607,21
"2011","Medway 011B","E01016154","Total",716,648,68
"2011","Medway 011C","E01016156","Total",675,659,16
"2011","Medway 011D","E01016157","Total",796,778,18
"2011","Medway 011E","E01016158","Total",969,880,89
"2011","Medway 012A","E01016031","Total",901,859,42
"2011","Medway 012B","E01016041","Total",747,714,33
"2011","Medway 012C","E01016045","Total",651,630,21
"2011","Medway 012D","E01016049","Total",929,876,53
"2011","Medway 013A","E01016040","Total",725,681,44
"2011","Medway 013B","E01016042","Total",589,570,19
"2011","Medway 013C","E01016043","Total",566,561,5
"2011","Medway 013D","E01016177","Total",640,625,15
"2011","Medway 013E","E01016178","Total",567,555,12
"2011","Medway 014A","E01016117","Total",915,867,48
"2011","Medway 014B","E01016129","Total",979,948,31
"2011","Medway 014C","E01016130","Total",986,920,66
"2011","Medway 014D","E01016131","Total",823,783,40
"2011","Medway 015A","E01016016","Total",662,650,12
"2011","Medway 015B","E01016017","Total",794,750,44
"2011","Medway 015C","E01016019","Total",694,657,37
"2011","Medway 015D","E01016110","Total",1040,955,85
"2011","Medway 015E","E01016111","Total",626,568,58
"2011","Medway 016A","E01016044","Total",714,673,41
"2011","Medway 016B","E01016046","Total",673,632,41
"2011","Medway 016C","E01016047","Total",678,649,29
"2011","Medway 016D","E01016048","Total",710,683,27
"2011","Medway 017A","E01016113","Total",606,598,8
"2011","Medway 017B","E01016114","Total",673,656,17
"2011","Medway 017C","E01016115","Total",773,765,8
"2011","Medway 017D","E01016118","Total",780,752,28
"2011","Medway 018A","E01016160","Total",624,612,12
"2011","Medway 018B","E01016161","Total",762,743,19
"2011","Medway 018C","E01016162","Total",660,648,12
"2011","Medway 018D","E01016163","Total",517,505,12
"2011","Medway 018E","E01016164","Total",661,646,15
"2011","Medway 018F","E01016165","Total",530,520,10
"2011","Medway 019A","E01016159","Total",536,512,24
"2011","Medway 019B","E01016174","Total",554,514,40
"2011","Medway 019C","E01016175","Total",721,707,14
"2011","Medway 019D","E01016179","Total",519,505,14
"2011","Medway 020A","E01016061","Total",740,694,46
"2011","Medway 020B","E01016063","Total",791,741,50
"2011","Medway 020C","E01016064","Total",735,701,34
"2011","Medway 020D","E01016069","Total",858,764,94
"2011","Medway 021A","E01016020","Total",514,506,8
"2011","Medway 021B","E01016021","Total",626,595,31
"2011","Medway 021C","E01016022","Total",526,507,19
"2011","Medway 021D","E01016125","Total",656,646,10
"2011","Medway 022A","E01016018","Total",787,754,33
"2011","Medway 022B","E01016023","Total",625,603,22
"2011","Medway 022C","E01016024","Total",807,768,39
"2011","Medway 022D","E01016062","Total",612,594,18
"2011","Medway 023A","E01016093","Total",693,665,28
"2011","Medway 023B","E01016096","Total",667,633,34
"2011","Medway 023C","E01016166","Total",592,580,12
"2011","Medway 023D","E01016167","Total",596,576,20
"2011","Medway 024A","E01016116","Total",770,757,13
"2011","Medway 024B","E01016127","Total",723,705,18
"2011","Medway 024C","E01016128","Total",550,545,5
"2011","Medway 024D","E01016132","Total",651,640,11
"2011","Medway 025A","E01016094","Total",644,616,28
"2011","Medway 025B","E01016095","Total",560,523,37
"2011","Medway 025C","E01016097","Total",651,637,14
"2011","Medway 025D","E01016098","Total",712,682,30
"2011","Medway 025E","E01016102","Total",630,620,10
"2011","Medway 026A","E01016119","Total",544,532,12
"2011","Medway 026B","E01016120","Total",602,596,6
"2011","Medway 026C","E01016124","Total",689,673,16
"2011","Medway 026D","E01016126","Total",624,613,11
"2011","Medway 027A","E01016025","Total",638,629,9
"2011","Medway 027B","E01016065","Total",644,635,9
"2011","Medway 027C","E01016066","Total",621,608,13
"2011","Medway 027D","E01016067","Total",663,651,12
"2011","Medway 027E","E01016068","Total",679,667,12
"2011","Medway 028A","E01016026","Total",525,506,19
"2011","Medway 028B","E01016027","Total",585,572,13
"2011","Medway 028C","E01016028","Total",619,598,21
"2011","Medway 028D","E01016029","Total",552,535,17
"2011","Medway 029A","E01016087","Total",718,694,24
"2011","Medway 029B","E01016088","Total",606,597,9
"2011","Medway 029C","E01016089","Total",678,667,11
"2011","Medway 029D","E01016090","Total",626,609,17
"2011","Medway 030A","E01016085","Total",663,646,17
"2011","Medway 030B","E01016086","Total",531,499,32
"2011","Medway 030C","E01016091","Total",625,614,11
"2011","Medway 030D","E01016176","Total",589,575,14
"2011","Medway 031A","E01016058","Total",632,622,10
"2011","Medway 031B","E01016059","Total",542,532,10
"2011","Medway 031C","E01016079","Total",491,488,3
"2011","Medway 031D","E01016083","Total",581,570,11
"2011","Medway 031E","E01016084","Total",519,513,6
"2011","Medway 032A","E01016101","Total",573,565,8
"2011","Medway 032B","E01016103","Total",586,575,11
"2011","Medway 032C","E01016104","Total",568,566,2
"2011","Medway 032D","E01016107","Total",607,602,5
"2011","Medway 033A","E01016121","Total",648,640,8
"2011","Medway 033B","E01016122","Total",639,617,22
"2011","Medway 033C","E01016123","Total",647,635,12
"2011","Medway 033D","E01016173","Total",662,648,14
"2011","Medway 034A","E01016078","Total",680,658,22
"2011","Medway 034B","E01016080","Total",634,620,14
"2011","Medway 034C","E01016081","Total",573,567,6
"2011","Medway 034D","E01016082","Total",586,580,6
"2011","Medway 035A","E01016050","Total",675,666,9
"2011","Medway 035B","E01016051","Total",605,592,13
"2011","Medway 035C","E01016052","Total",659,648,11
"2011","Medway 035D","E01016053","Total",663,637,26
"2011","Medway 035E","E01016054","Total",615,596,19
"2011","Medway 036A","E01016092","Total",638,630,8
"2011","Medway 036B","E01016099","Total",630,621,9
"2011","Medway 036C","E01016100","Total",664,657,7
"2011","Medway 036D","E01016105","Total",604,592,12
"2011","Medway 036E","E01016106","Total",603,591,12
"2011","Medway 037A","E01016168","Total",666,658,8
"2011","Medway 037B","E01016169","Total",646,638,8
"2011","Medway 037C","E01016171","Total",648,638,10
"2011","Medway 037D","E01016172","Total",607,587,20
"2011","Medway 038A","E01016055","Total",664,651,13
"2011","Medway 038B","E01016056","Total",662,630,32
"2011","Medway 038C","E01016057","Total",650,642,8
"2011","Medway 038D","E01016060","Total",637,628,9
"2011","Medway 038E","E01016170","Total",644,634,10
"2011","Milton Keynes 001A","E01016796","Total",688,657,31
"2011","Milton Keynes 001B","E01016797","Total",851,810,41
"2011","Milton Keynes 001C","E01016798","Total",742,731,11
"2011","Milton Keynes 001D","E01016799","Total",811,778,33
"2011","Milton Keynes 001E","E01016800","Total",718,694,24
"2011","Milton Keynes 002A","E01016759","Total",595,582,13
"2011","Milton Keynes 002B","E01016760","Total",1054,975,79
"2011","Milton Keynes 002C","E01016761","Total",587,568,19
"2011","Milton Keynes 002D","E01016801","Total",580,565,15
"2011","Milton Keynes 002E","E01016802","Total",599,569,30
"2011","Milton Keynes 002F","E01016803","Total",566,547,19
"2011","Milton Keynes 003A","E01016786","Total",639,625,14
"2011","Milton Keynes 003B","E01016787","Total",685,660,25
"2011","Milton Keynes 003C","E01016788","Total",617,611,6
"2011","Milton Keynes 003D","E01016789","Total",512,502,10
"2011","Milton Keynes 003E","E01016790","Total",535,527,8
"2011","Milton Keynes 004A","E01016791","Total",611,595,16
"2011","Milton Keynes 004B","E01016792","Total",534,525,9
"2011","Milton Keynes 004C","E01016793","Total",809,792,17
"2011","Milton Keynes 004D","E01016794","Total",731,691,40
"2011","Milton Keynes 004E","E01016795","Total",710,686,24
"2011","Milton Keynes 005A","E01016762","Total",547,517,30
"2011","Milton Keynes 005B","E01016764","Total",628,604,24
"2011","Milton Keynes 005C","E01016766","Total",547,536,11
"2011","Milton Keynes 005D","E01016767","Total",534,521,13
"2011","Milton Keynes 005E","E01016771","Total",504,491,13
"2011","Milton Keynes 006A","E01016806","Total",744,697,47
"2011","Milton Keynes 006B","E01016807","Total",691,678,13
"2011","Milton Keynes 006C","E01016809","Total",534,517,17
"2011","Milton Keynes 006D","E01016835","Total",724,677,47
"2011","Milton Keynes 007A","E01016763","Total",641,632,9
"2011","Milton Keynes 007B","E01016769","Total",600,581,19
"2011","Milton Keynes 007C","E01016770","Total",693,675,18
"2011","Milton Keynes 007D","E01016773","Total",837,797,40
"2011","Milton Keynes 008A","E01016836","Total",654,619,35
"2011","Milton Keynes 008B","E01016837","Total",735,698,37
"2011","Milton Keynes 008C","E01016838","Total",618,604,14
"2011","Milton Keynes 008D","E01016841","Total",1122,984,138
"2011","Milton Keynes 009A","E01016721","Total",635,619,16
"2011","Milton Keynes 009B","E01016765","Total",663,651,12
"2011","Milton Keynes 009C","E01016772","Total",513,501,12
"2011","Milton Keynes 009D","E01016804","Total",756,719,37
"2011","Milton Keynes 010A","E01016812","Total",646,642,4
"2011","Milton Keynes 010B","E01016817","Total",680,657,23
"2011","Milton Keynes 010C","E01016818","Total",885,840,45
"2011","Milton Keynes 010D","E01016840","Total",1101,1052,49
"2011","Milton Keynes 011A","E01016719","Total",657,646,11
"2011","Milton Keynes 011B","E01016722","Total",625,621,4
"2011","Milton Keynes 011C","E01016805","Total",621,606,15
"2011","Milton Keynes 011D","E01016808","Total",543,533,10
"2011","Milton Keynes 012A","E01016810","Total",652,580,72
"2011","Milton Keynes 012B","E01016811","Total",497,490,7
"2011","Milton Keynes 012C","E01016819","Total",455,451,4
"2011","Milton Keynes 012D","E01016839","Total",655,613,42
"2011","Milton Keynes 013A","E01016717","Total",648,632,16
"2011","Milton Keynes 013B","E01016720","Total",666,650,16
"2011","Milton Keynes 013C","E01016723","Total",639,618,21
"2011","Milton Keynes 013D","E01016724","Total",651,643,8
"2011","Milton Keynes 014A","E01016718","Total",675,610,65
"2011","Milton Keynes 014B","E01016729","Total",804,784,20
"2011","Milton Keynes 014D","E01016768","Total",955,869,86
"2011","Milton Keynes 014E","E01033499","Total",919,757,162
"2011","Milton Keynes 014F","E01033500","Total",933,795,138
"2011","Milton Keynes 015A","E01016776","Total",549,539,10
"2011","Milton Keynes 015B","E01016813","Total",679,664,15
"2011","Milton Keynes 015C","E01016815","Total",536,531,5
"2011","Milton Keynes 015D","E01016816","Total",606,601,5
"2011","Milton Keynes 016A","E01016731","Total",655,644,11
"2011","Milton Keynes 016B","E01016732","Total",538,522,16
"2011","Milton Keynes 016D","E01016784","Total",685,665,20
"2011","Milton Keynes 016E","E01033501","Total",724,704,20
"2011","Milton Keynes 016F","E01033506","Total",715,703,12
"2011","Milton Keynes 017A","E01016783","Total",755,744,11
"2011","Milton Keynes 017C","E01016820","Total",647,629,18
"2011","Milton Keynes 017D","E01016821","Total",495,489,6
"2011","Milton Keynes 017E","E01016823","Total",822,788,34
"2011","Milton Keynes 017F","E01033503","Total",596,588,8
"2011","Milton Keynes 017G","E01033508","Total",648,627,21
"2011","Milton Keynes 017H","E01033509","Total",649,602,47
"2011","Milton Keynes 017I","E01033511","Total",641,595,46
"2011","Milton Keynes 017J","E01033512","Total",621,606,15
"2011","Milton Keynes 018A","E01016726","Total",613,581,32
"2011","Milton Keynes 018B","E01016733","Total",606,589,17
"2011","Milton Keynes 018C","E01016845","Total",717,709,8
"2011","Milton Keynes 018D","E01016846","Total",646,626,20
"2011","Milton Keynes 018E","E01016848","Total",590,575,15
"2011","Milton Keynes 019B","E01016780","Total",662,651,11
"2011","Milton Keynes 019C","E01016781","Total",565,553,12
"2011","Milton Keynes 019D","E01016814","Total",759,738,21
"2011","Milton Keynes 019E","E01033505","Total",534,514,20
"2011","Milton Keynes 019F","E01033522","Total",561,548,13
"2011","Milton Keynes 019G","E01033523","Total",542,528,14
"2011","Milton Keynes 019H","E01033525","Total",590,582,8
"2011","Milton Keynes 020A","E01016774","Total",689,675,14
"2011","Milton Keynes 020B","E01016775","Total",709,685,24
"2011","Milton Keynes 020C","E01016777","Total",651,641,10
"2011","Milton Keynes 020D","E01016778","Total",712,683,29
"2011","Milton Keynes 021A","E01016725","Total",597,574,23
"2011","Milton Keynes 021B","E01016727","Total",667,653,14
"2011","Milton Keynes 021C","E01016728","Total",724,707,17
"2011","Milton Keynes 021D","E01016847","Total",868,844,24
"2011","Milton Keynes 022A","E01016822","Total",671,662,9
"2011","Milton Keynes 022B","E01016824","Total",675,658,17
"2011","Milton Keynes 022C","E01016825","Total",648,635,13
"2011","Milton Keynes 022D","E01016827","Total",727,715,12
"2011","Milton Keynes 022E","E01016828","Total",750,732,18
"2011","Milton Keynes 023B","E01016842","Total",611,601,10
"2011","Milton Keynes 023C","E01016843","Total",562,528,34
"2011","Milton Keynes 023D","E01016844","Total",645,636,9
"2011","Milton Keynes 023E","E01033497","Total",632,592,40
"2011","Milton Keynes 023F","E01033498","Total",688,643,45
"2011","Milton Keynes 024A","E01016734","Total",534,517,17
"2011","Milton Keynes 024B","E01016735","Total",904,869,35
"2011","Milton Keynes 024C","E01016736","Total",616,591,25
"2011","Milton Keynes 024D","E01016826","Total",534,531,3
"2011","Milton Keynes 025B","E01016752","Total",619,609,10
"2011","Milton Keynes 025C","E01016753","Total",892,881,11
"2011","Milton Keynes 025D","E01016755","Total",731,719,12
"2011","Milton Keynes 025E","E01033514","Total",528,511,17
"2011","Milton Keynes 025F","E01033515","Total",625,620,5
"2011","Milton Keynes 025G","E01033517","Total",558,548,10
"2011","Milton Keynes 026A","E01016754","Total",740,728,12
"2011","Milton Keynes 026B","E01016756","Total",950,933,17
"2011","Milton Keynes 026C","E01016757","Total",597,593,4
"2011","Milton Keynes 026D","E01016758","Total",673,660,13
"2011","Milton Keynes 027A","E01016737","Total",619,615,4
"2011","Milton Keynes 027B","E01016738","Total",779,763,16
"2011","Milton Keynes 027C","E01016739","Total",599,594,5
"2011","Milton Keynes 027D","E01016740","Total",567,559,8
"2011","Milton Keynes 027E","E01016741","Total",722,712,10
"2011","Milton Keynes 028A","E01016748","Total",831,815,16
"2011","Milton Keynes 028C","E01016750","Total",641,634,7
"2011","Milton Keynes 028D","E01016751","Total",641,629,12
"2011","Milton Keynes 028E","E01033519","Total",711,701,10
"2011","Milton Keynes 028F","E01033520","Total",637,631,6
"2011","Milton Keynes 029A","E01016829","Total",680,664,16
"2011","Milton Keynes 029B","E01016831","Total",619,611,8
"2011","Milton Keynes 029C","E01016832","Total",506,498,8
"2011","Milton Keynes 029D","E01016833","Total",512,506,6
"2011","Milton Keynes 029E","E01016834","Total",665,651,14
"2011","Milton Keynes 030A","E01016710","Total",760,743,17
"2011","Milton Keynes 030B","E01016714","Total",805,750,55
"2011","Milton Keynes 030C","E01016716","Total",800,772,28
"2011","Milton Keynes 030D","E01016745","Total",632,616,16
"2011","Milton Keynes 031A","E01016711","Total",972,955,17
"2011","Milton Keynes 031B","E01016713","Total",733,714,19
"2011","Milton Keynes 031C","E01016715","Total",648,640,8
"2011","Milton Keynes 031D","E01016830","Total",526,515,11
"2011","Milton Keynes 032A","E01016742","Total",642,577,65
"2011","Milton Keynes 032B","E01016743","Total",851,787,64
"2011","Milton Keynes 032C","E01016744","Total",572,545,27
"2011","Milton Keynes 032D","E01016746","Total",704,681,23
"2011","Portsmouth 001A","E01017112","Total",675,664,11
"2011","Portsmouth 001B","E01017115","Total",492,485,7
"2011","Portsmouth 001C","E01017117","Total",607,600,7
"2011","Portsmouth 001D","E01017119","Total",657,648,9
"2011","Portsmouth 001E","E01017120","Total",693,679,14
"2011","Portsmouth 002A","E01017051","Total",821,789,32
"2011","Portsmouth 002B","E01017052","Total",578,572,6
"2011","Portsmouth 002C","E01017053","Total",544,535,9
"2011","Portsmouth 002D","E01017118","Total",569,563,6
"2011","Portsmouth 003A","E01017050","Total",721,690,31
"2011","Portsmouth 003B","E01017061","Total",681,664,17
"2011","Portsmouth 003C","E01017063","Total",632,626,6
"2011","Portsmouth 003D","E01017064","Total",745,707,38
"2011","Portsmouth 004A","E01017054","Total",635,624,11
"2011","Portsmouth 004B","E01017113","Total",631,621,10
"2011","Portsmouth 004C","E01017114","Total",840,702,138
"2011","Portsmouth 004D","E01017116","Total",646,624,22
"2011","Portsmouth 006A","E01017055","Total",694,676,18
"2011","Portsmouth 006B","E01017056","Total",506,497,9
"2011","Portsmouth 006C","E01017057","Total",580,570,10
"2011","Portsmouth 006D","E01017058","Total",656,651,5
"2011","Portsmouth 006E","E01017060","Total",645,633,12
"2011","Portsmouth 007A","E01017086","Total",505,500,5
"2011","Portsmouth 007B","E01017089","Total",632,629,3
"2011","Portsmouth 007C","E01017090","Total",620,607,13
"2011","Portsmouth 007D","E01017091","Total",733,723,10
"2011","Portsmouth 007E","E01017092","Total",659,642,17
"2011","Portsmouth 008A","E01017014","Total",648,634,14
"2011","Portsmouth 008B","E01017046","Total",790,780,10
"2011","Portsmouth 008C","E01017047","Total",649,636,13
"2011","Portsmouth 008D","E01017048","Total",611,593,18
"2011","Portsmouth 008E","E01017085","Total",677,671,6
"2011","Portsmouth 009A","E01017084","Total",590,565,25
"2011","Portsmouth 009B","E01017087","Total",605,596,9
"2011","Portsmouth 009C","E01017088","Total",711,687,24
"2011","Portsmouth 009D","E01017105","Total",685,639,46
"2011","Portsmouth 009E","E01017107","Total",685,662,23
"2011","Portsmouth 010A","E01017104","Total",486,473,13
"2011","Portsmouth 010B","E01017106","Total",646,627,19
"2011","Portsmouth 010C","E01017108","Total",731,709,22
"2011","Portsmouth 010D","E01017109","Total",630,599,31
"2011","Portsmouth 011A","E01017041","Total",523,517,6
"2011","Portsmouth 011B","E01017043","Total",538,524,14
"2011","Portsmouth 011C","E01017044","Total",636,617,19
"2011","Portsmouth 011D","E01017049","Total",603,594,9
"2011","Portsmouth 011E","E01017110","Total",622,605,17
"2011","Portsmouth 011F","E01017111","Total",632,612,20
"2011","Portsmouth 012A","E01017013","Total",671,649,22
"2011","Portsmouth 012B","E01017042","Total",533,528,5
"2011","Portsmouth 012C","E01017045","Total",522,510,12
"2011","Portsmouth 012D","E01017075","Total",704,672,32
"2011","Portsmouth 012E","E01017082","Total",756,728,28
"2011","Portsmouth 012F","E01017083","Total",733,723,10
"2011","Portsmouth 013A","E01017036","Total",606,593,13
"2011","Portsmouth 013B","E01017037","Total",661,649,12
"2011","Portsmouth 013C","E01017038","Total",836,820,16
"2011","Portsmouth 013D","E01017102","Total",742,713,29
"2011","Portsmouth 013E","E01017103","Total",513,502,11
"2011","Portsmouth 014A","E01017015","Total",641,627,14
"2011","Portsmouth 014B","E01017016","Total",651,634,17
"2011","Portsmouth 014C","E01017017","Total",611,602,9
"2011","Portsmouth 014D","E01017018","Total",639,620,19
"2011","Portsmouth 014E","E01017019","Total",759,746,13
"2011","Portsmouth 014F","E01017020","Total",970,953,17
"2011","Portsmouth 015A","E01017076","Total",763,742,21
"2011","Portsmouth 015B","E01017077","Total",915,886,29
"2011","Portsmouth 015C","E01017078","Total",667,638,29
"2011","Portsmouth 015D","E01017079","Total",639,627,12
"2011","Portsmouth 015E","E01017080","Total",854,827,27
"2011","Portsmouth 015F","E01017081","Total",682,666,16
"2011","Portsmouth 016A","E01017031","Total",995,970,25
"2011","Portsmouth 016B","E01017032","Total",639,612,27
"2011","Portsmouth 016D","E01017034","Total",607,582,25
"2011","Portsmouth 016E","E01017039","Total",749,746,3
"2011","Portsmouth 016F","E01017040","Total",648,644,4
"2011","Portsmouth 016G","E01033381","Total",787,724,63
"2011","Portsmouth 016H","E01033383","Total",619,594,25
"2011","Portsmouth 017A","E01017021","Total",665,637,28
"2011","Portsmouth 017B","E01017093","Total",498,495,3
"2011","Portsmouth 017C","E01017096","Total",685,670,15
"2011","Portsmouth 017D","E01017099","Total",721,706,15
"2011","Portsmouth 017E","E01017100","Total",535,521,14
"2011","Portsmouth 017F","E01017101","Total",664,656,8
"2011","Portsmouth 018A","E01017035","Total",785,765,20
"2011","Portsmouth 018B","E01017128","Total",686,653,33
"2011","Portsmouth 018C","E01017129","Total",691,664,27
"2011","Portsmouth 018D","E01017130","Total",796,777,19
"2011","Portsmouth 018E","E01017132","Total",940,925,15
"2011","Portsmouth 018F","E01017133","Total",896,847,49
"2011","Portsmouth 019A","E01017023","Total",690,669,21
"2011","Portsmouth 019B","E01017025","Total",849,818,31
"2011","Portsmouth 019C","E01017026","Total",806,771,35
"2011","Portsmouth 019D","E01017029","Total",724,706,18
"2011","Portsmouth 019E","E01017030","Total",723,705,18
"2011","Portsmouth 020A","E01017022","Total",684,661,23
"2011","Portsmouth 020B","E01017024","Total",753,725,28
"2011","Portsmouth 020C","E01017027","Total",668,626,42
"2011","Portsmouth 020D","E01017028","Total",720,690,30
"2011","Portsmouth 020E","E01017124","Total",842,801,41
"2011","Portsmouth 021A","E01017094","Total",625,611,14
"2011","Portsmouth 021B","E01017095","Total",894,869,25
"2011","Portsmouth 021C","E01017097","Total",748,725,23
"2011","Portsmouth 021D","E01017098","Total",676,646,30
"2011","Portsmouth 022A","E01017122","Total",912,854,58
"2011","Portsmouth 022B","E01017125","Total",934,866,68
"2011","Portsmouth 022C","E01017127","Total",1092,999,93
"2011","Portsmouth 022D","E01017135","Total",870,836,34
"2011","Portsmouth 023A","E01017067","Total",665,653,12
"2011","Portsmouth 023B","E01017068","Total",956,908,48
"2011","Portsmouth 023C","E01017069","Total",775,745,30
"2011","Portsmouth 023D","E01017070","Total",773,726,47
"2011","Portsmouth 023E","E01017074","Total",833,793,40
"2011","Portsmouth 024A","E01017073","Total",1032,953,79
"2011","Portsmouth 024B","E01017123","Total",1234,1129,105
"2011","Portsmouth 024C","E01017131","Total",780,735,45
"2011","Portsmouth 024E","E01033380","Total",1031,850,181
"2011","Portsmouth 024F","E01033384","Total",893,803,90
"2011","Portsmouth 025A","E01017071","Total",690,656,34
"2011","Portsmouth 025B","E01017072","Total",646,627,19
"2011","Portsmouth 025C","E01017121","Total",805,763,42
"2011","Portsmouth 025D","E01017126","Total",860,820,40
"2011","Portsmouth 026A","E01017059","Total",656,648,8
"2011","Portsmouth 026B","E01017062","Total",638,619,19
"2011","Portsmouth 026C","E01017066","Total",770,758,12
"2011","Portsmouth 026D","E01032604","Total",622,605,17
"2011","Reading 001A","E01016407","Total",679,653,26
"2011","Reading 001B","E01016408","Total",598,577,21
"2011","Reading 001C","E01016410","Total",678,659,19
"2011","Reading 001D","E01016411","Total",661,641,20
"2011","Reading 001E","E01016412","Total",589,585,4
"2011","Reading 002A","E01016386","Total",635,594,41
"2011","Reading 002B","E01016387","Total",609,585,24
"2011","Reading 002C","E01016425","Total",675,658,17
"2011","Reading 002D","E01016426","Total",521,502,19
"2011","Reading 002E","E01016430","Total",513,507,6
"2011","Reading 003A","E01016364","Total",615,578,37
"2011","Reading 003B","E01016409","Total",740,728,12
"2011","Reading 003C","E01016427","Total",684,642,42
"2011","Reading 003D","E01016428","Total",752,723,29
"2011","Reading 003E","E01016429","Total",636,615,21
"2011","Reading 004A","E01016362","Total",880,819,61
"2011","Reading 004B","E01016363","Total",726,709,17
"2011","Reading 004C","E01016365","Total",812,765,47
"2011","Reading 004D","E01016366","Total",689,667,22
"2011","Reading 004E","E01016367","Total",704,687,17
"2011","Reading 005A","E01016380","Total",688,674,14
"2011","Reading 005B","E01016383","Total",666,649,17
"2011","Reading 005C","E01016384","Total",616,604,12
"2011","Reading 005D","E01016431","Total",654,625,29
"2011","Reading 005E","E01016432","Total",653,634,19
"2011","Reading 006A","E01016381","Total",532,520,12
"2011","Reading 006B","E01016382","Total",728,697,31
"2011","Reading 006C","E01016385","Total",612,602,10
"2011","Reading 006D","E01016396","Total",567,543,24
"2011","Reading 006E","E01016397","Total",619,565,54
"2011","Reading 007A","E01016355","Total",829,790,39
"2011","Reading 007B","E01016358","Total",816,740,76
"2011","Reading 007C","E01016359","Total",848,820,28
"2011","Reading 007D","E01016360","Total",803,772,31
"2011","Reading 007E","E01016361","Total",772,739,33
"2011","Reading 008A","E01016356","Total",689,673,16
"2011","Reading 008B","E01016357","Total",777,736,41
"2011","Reading 008C","E01016395","Total",671,639,32
"2011","Reading 008D","E01016398","Total",771,743,28
"2011","Reading 008E","E01016399","Total",576,562,14
"2011","Reading 008F","E01016400","Total",668,642,26
"2011","Reading 009A","E01016394","Total",597,566,31
"2011","Reading 009B","E01016433","Total",631,601,30
"2011","Reading 009C","E01016434","Total",702,680,22
"2011","Reading 009D","E01016435","Total",589,567,22
"2011","Reading 009E","E01016436","Total",639,608,31
"2011","Reading 010B","E01016402","Total",664,643,21
"2011","Reading 010C","E01016404","Total",819,801,18
"2011","Reading 010D","E01016405","Total",671,650,21
"2011","Reading 010E","E01016406","Total",499,480,19
"2011","Reading 010F","E01033417","Total",635,598,37
"2011","Reading 010G","E01033421","Total",932,868,64
"2011","Reading 011B","E01016353","Total",904,817,87
"2011","Reading 011D","E01016378","Total",1041,966,75
"2011","Reading 011E","E01016391","Total",870,850,20
"2011","Reading 011F","E01033415","Total",829,766,63
"2011","Reading 011G","E01033418","Total",666,625,41
"2011","Reading 011H","E01033420","Total",691,645,46
"2011","Reading 011I","E01033422","Total",685,613,72
"2011","Reading 011J","E01033423","Total",663,609,54
"2011","Reading 012A","E01016401","Total",619,590,29
"2011","Reading 012B","E01016403","Total",713,678,35
"2011","Reading 012C","E01016416","Total",657,625,32
"2011","Reading 012D","E01016417","Total",594,568,26
"2011","Reading 012E","E01016418","Total",615,591,24
"2011","Reading 013A","E01016388","Total",634,602,32
"2011","Reading 013B","E01016389","Total",721,702,19
"2011","Reading 013C","E01016390","Total",819,758,61
"2011","Reading 013D","E01016392","Total",1014,968,46
"2011","Reading 013E","E01016393","Total",677,652,25
"2011","Reading 014A","E01016374","Total",728,693,35
"2011","Reading 014B","E01016375","Total",519,507,12
"2011","Reading 014C","E01016376","Total",729,665,64
"2011","Reading 014D","E01016379","Total",802,764,38
"2011","Reading 014E","E01016413","Total",466,453,13
"2011","Reading 014F","E01016414","Total",692,643,49
"2011","Reading 015A","E01016419","Total",789,762,27
"2011","Reading 015B","E01016420","Total",584,567,17
"2011","Reading 015C","E01016421","Total",540,521,19
"2011","Reading 015D","E01016422","Total",670,650,20
"2011","Reading 015E","E01016423","Total",613,602,11
"2011","Reading 015F","E01016424","Total",492,480,12
"2011","Reading 016A","E01016370","Total",521,498,23
"2011","Reading 016B","E01016371","Total",647,606,41
"2011","Reading 016C","E01016373","Total",558,535,23
"2011","Reading 016D","E01016415","Total",699,687,12
"2011","Reading 017A","E01016368","Total",545,531,14
"2011","Reading 017B","E01016372","Total",494,478,16
"2011","Reading 017C","E01016377","Total",703,635,68
"2011","Reading 017D","E01016438","Total",536,521,15
"2011","Reading 017E","E01016442","Total",1309,1106,203
"2011","Reading 017F","E01016443","Total",566,545,21
"2011","Reading 018A","E01016369","Total",652,639,13
"2011","Reading 018B","E01016437","Total",536,518,18
"2011","Reading 018C","E01016439","Total",602,584,18
"2011","Reading 018D","E01016440","Total",574,555,19
"2011","Reading 018E","E01016441","Total",618,574,44
"2011","Slough 001A","E01016450","Total",598,593,5
"2011","Slough 001B","E01016451","Total",612,607,5
"2011","Slough 001C","E01016452","Total",647,643,4
"2011","Slough 001D","E01016453","Total",662,660,2
"2011","Slough 001E","E01016454","Total",613,611,2
"2011","Slough 001F","E01016455","Total",544,534,10
"2011","Slough 002A","E01016483","Total",576,561,15
"2011","Slough 002B","E01016484","Total",561,547,14
"2011","Slough 002C","E01016485","Total",550,539,11
"2011","Slough 002D","E01016486","Total",651,640,11
"2011","Slough 002E","E01016487","Total",475,470,5
"2011","Slough 002F","E01016488","Total",720,705,15
"2011","Slough 003A","E01016493","Total",485,484,1
"2011","Slough 003B","E01016494","Total",835,825,10
"2011","Slough 003C","E01016495","Total",694,682,12
"2011","Slough 003D","E01016496","Total",578,574,4
"2011","Slough 003E","E01016497","Total",487,484,3
"2011","Slough 003F","E01016498","Total",650,647,3
"2011","Slough 003G","E01016499","Total",504,502,2
"2011","Slough 004A","E01016444","Total",479,473,6
"2011","Slough 004B","E01016445","Total",527,524,3
"2011","Slough 004C","E01016446","Total",463,453,10
"2011","Slough 004D","E01016447","Total",521,506,15
"2011","Slough 004E","E01016448","Total",778,753,25
"2011","Slough 004F","E01016449","Total",631,625,6
"2011","Slough 005A","E01016516","Total",459,456,3
"2011","Slough 005B","E01016517","Total",467,458,9
"2011","Slough 005C","E01016518","Total",607,600,7
"2011","Slough 005D","E01016519","Total",1095,1038,57
"2011","Slough 005E","E01016520","Total",583,573,10
"2011","Slough 005F","E01016521","Total",647,634,13
"2011","Slough 006A","E01016467","Total",589,576,13
"2011","Slough 006B","E01016468","Total",637,627,10
"2011","Slough 006C","E01016469","Total",688,674,14
"2011","Slough 006D","E01016470","Total",701,678,23
"2011","Slough 006E","E01016471","Total",501,494,7
"2011","Slough 006F","E01016472","Total",601,592,9
"2011","Slough 007A","E01016456","Total",668,639,29
"2011","Slough 007B","E01016457","Total",520,511,9
"2011","Slough 007C","E01016458","Total",562,557,5
"2011","Slough 007D","E01016459","Total",787,695,92
"2011","Slough 007E","E01016460","Total",560,545,15
"2011","Slough 007F","E01016461","Total",951,933,18
"2011","Slough 008A","E01016473","Total",757,746,11
"2011","Slough 008B","E01016474","Total",859,831,28
"2011","Slough 008C","E01016475","Total",643,622,21
"2011","Slough 008D","E01016476","Total",694,673,21
"2011","Slough 008E","E01016477","Total",1060,1023,37
"2011","Slough 008F","E01016478","Total",707,694,13
"2011","Slough 009A","E01016462","Total",862,830,32
"2011","Slough 009B","E01016463","Total",628,613,15
"2011","Slough 009C","E01016464","Total",632,608,24
"2011","Slough 009D","E01016465","Total",1010,967,43
"2011","Slough 009F","E01032729","Total",619,603,16
"2011","Slough 009G","E01032730","Total",665,620,45
"2011","Slough 010A","E01016506","Total",825,811,14
"2011","Slough 010B","E01016507","Total",627,614,13
"2011","Slough 010C","E01016508","Total",615,605,10
"2011","Slough 010D","E01016509","Total",639,619,20
"2011","Slough 010E","E01016510","Total",461,457,4
"2011","Slough 011A","E01016511","Total",807,775,32
"2011","Slough 011B","E01016512","Total",880,842,38
"2011","Slough 011C","E01016513","Total",607,592,15
"2011","Slough 011D","E01016514","Total",857,821,36
"2011","Slough 011E","E01016515","Total",631,624,7
"2011","Slough 012A","E01016500","Total",625,606,19
"2011","Slough 012B","E01016501","Total",606,603,3
"2011","Slough 012C","E01016502","Total",513,502,11
"2011","Slough 012D","E01016503","Total",612,601,11
"2011","Slough 012E","E01016504","Total",480,473,7
"2011","Slough 012F","E01016505","Total",667,660,7
"2011","Slough 013B","E01016490","Total",855,843,12
"2011","Slough 013C","E01016491","Total",676,665,11
"2011","Slough 013D","E01016492","Total",613,601,12
"2011","Slough 013E","E01032731","Total",517,507,10
"2011","Slough 013F","E01032732","Total",667,660,7
"2011","Slough 014A","E01016479","Total",593,579,14
"2011","Slough 014B","E01016480","Total",532,519,13
"2011","Slough 014C","E01016481","Total",737,715,22
"2011","Slough 014D","E01016482","Total",738,720,18
"2011","Southampton 001A","E01017144","Total",441,427,14
"2011","Southampton 001B","E01017145","Total",679,651,28
"2011","Southampton 001C","E01017146","Total",743,707,36
"2011","Southampton 001D","E01017148","Total",628,604,24
"2011","Southampton 001E","E01017149","Total",467,460,7
"2011","Southampton 002A","E01017180","Total",589,581,8
"2011","Southampton 002B","E01017181","Total",575,559,16
"2011","Southampton 002C","E01017183","Total",673,664,9
"2011","Southampton 002D","E01017185","Total",747,730,17
"2011","Southampton 002E","E01017187","Total",695,682,13
"2011","Southampton 003A","E01017264","Total",505,483,22
"2011","Southampton 003B","E01017265","Total",759,751,8
"2011","Southampton 003C","E01017270","Total",584,556,28
"2011","Southampton 003D","E01017271","Total",475,466,9
"2011","Southampton 004A","E01017182","Total",743,725,18
"2011","Southampton 004B","E01017184","Total",609,603,6
"2011","Southampton 004C","E01017186","Total",708,695,13
"2011","Southampton 004D","E01017188","Total",630,623,7
"2011","Southampton 005A","E01017266","Total",504,483,21
"2011","Southampton 005B","E01017267","Total",458,442,16
"2011","Southampton 005E","E01017272","Total",514,506,8
"2011","Southampton 005F","E01032756","Total",993,963,30
"2011","Southampton 006A","E01017147","Total",660,637,23
"2011","Southampton 006B","E01017150","Total",639,615,24
"2011","Southampton 006C","E01017151","Total",746,733,13
"2011","Southampton 006D","E01017152","Total",676,661,15
"2011","Southampton 007A","E01017238","Total",587,582,5
"2011","Southampton 007B","E01017241","Total",669,657,12
"2011","Southampton 007C","E01017242","Total",734,730,4
"2011","Southampton 007D","E01017243","Total",666,660,6
"2011","Southampton 007E","E01017244","Total",518,511,7
"2011","Southampton 008A","E01017174","Total",561,553,8
"2011","Southampton 008B","E01017175","Total",634,623,11
"2011","Southampton 008C","E01017176","Total",690,677,13
"2011","Southampton 008D","E01017179","Total",633,618,15
"2011","Southampton 009A","E01017226","Total",857,830,27
"2011","Southampton 009D","E01017231","Total",670,640,30
"2011","Southampton 009E","E01017232","Total",516,495,21
"2011","Southampton 009F","E01032753","Total",818,788,30
"2011","Southampton 010A","E01017246","Total",924,879,45
"2011","Southampton 010B","E01017250","Total",741,728,13
"2011","Southampton 010C","E01017251","Total",687,661,26
"2011","Southampton 010D","E01017253","Total",669,656,13
"2011","Southampton 011A","E01017247","Total",637,622,15
"2011","Southampton 011B","E01017248","Total",615,600,15
"2011","Southampton 011C","E01017249","Total",518,508,10
"2011","Southampton 011D","E01017252","Total",677,663,14
"2011","Southampton 011E","E01017254","Total",686,672,14
"2011","Southampton 012A","E01017236","Total",608,599,9
"2011","Southampton 012B","E01017237","Total",604,590,14
"2011","Southampton 012C","E01017239","Total",651,641,10
"2011","Southampton 012D","E01017240","Total",603,599,4
"2011","Southampton 012E","E01017245","Total",616,611,5
"2011","Southampton 013A","E01017227","Total",435,410,25
"2011","Southampton 013B","E01017228","Total",731,712,19
"2011","Southampton 013C","E01017233","Total",737,723,14
"2011","Southampton 013D","E01017234","Total",751,735,16
"2011","Southampton 013E","E01017235","Total",640,601,39
"2011","Southampton 014A","E01017171","Total",906,872,34
"2011","Southampton 014B","E01017172","Total",860,809,51
"2011","Southampton 014C","E01017173","Total",650,617,33
"2011","Southampton 014D","E01017177","Total",779,749,30
"2011","Southampton 014E","E01017178","Total",605,589,16
"2011","Southampton 015A","E01017207","Total",708,697,11
"2011","Southampton 015B","E01017209","Total",594,584,10
"2011","Southampton 015C","E01017211","Total",969,934,35
"2011","Southampton 015D","E01017212","Total",565,555,10
"2011","Southampton 015E","E01017213","Total",738,713,25
"2011","Southampton 016A","E01017200","Total",865,840,25
"2011","Southampton 016B","E01017201","Total",645,630,15
"2011","Southampton 016C","E01017202","Total",764,747,17
"2011","Southampton 016D","E01017203","Total",642,632,10
"2011","Southampton 016E","E01017204","Total",632,625,7
"2011","Southampton 017A","E01017157","Total",593,571,22
"2011","Southampton 017B","E01017158","Total",818,796,22
"2011","Southampton 017C","E01017159","Total",554,527,27
"2011","Southampton 017D","E01017160","Total",705,669,36
"2011","Southampton 018A","E01017198","Total",688,673,15
"2011","Southampton 018B","E01017199","Total",787,771,16
"2011","Southampton 018C","E01017205","Total",522,515,7
"2011","Southampton 018D","E01017206","Total",653,648,5
"2011","Southampton 019A","E01017208","Total",568,561,7
"2011","Southampton 019B","E01017210","Total",610,603,7
"2011","Southampton 019C","E01017214","Total",565,552,13
"2011","Southampton 019D","E01017215","Total",710,696,14
"2011","Southampton 019E","E01017216","Total",587,579,8
"2011","Southampton 020A","E01017189","Total",779,734,45
"2011","Southampton 020B","E01017190","Total",786,730,56
"2011","Southampton 020C","E01017191","Total",847,791,56
"2011","Southampton 020D","E01017196","Total",1036,1012,24
"2011","Southampton 020E","E01017197","Total",566,553,13
"2011","Southampton 021A","E01017192","Total",947,911,36
"2011","Southampton 021B","E01017193","Total",891,848,43
"2011","Southampton 021C","E01017194","Total",859,827,32
"2011","Southampton 021D","E01017195","Total",986,941,45
"2011","Southampton 022A","E01017153","Total",484,466,18
"2011","Southampton 022B","E01017154","Total",911,888,23
"2011","Southampton 022C","E01017155","Total",573,538,35
"2011","Southampton 022D","E01017156","Total",512,492,20
"2011","Southampton 022F","E01032738","Total",685,630,55
"2011","Southampton 022G","E01032750","Total",657,621,36
"2011","Southampton 023A","E01017136","Total",656,622,34
"2011","Southampton 023B","E01017137","Total",670,647,23
"2011","Southampton 023C","E01017138","Total",986,940,46
"2011","Southampton 023D","E01017140","Total",868,831,37
"2011","Southampton 024A","E01017217","Total",682,663,19
"2011","Southampton 024B","E01017223","Total",674,662,12
"2011","Southampton 024C","E01017224","Total",603,550,53
"2011","Southampton 024D","E01017225","Total",624,609,15
"2011","Southampton 025A","E01017162","Total",639,625,14
"2011","Southampton 025B","E01017163","Total",661,651,10
"2011","Southampton 025C","E01017164","Total",681,670,11
"2011","Southampton 025D","E01017165","Total",633,622,11
"2011","Southampton 025E","E01017166","Total",686,668,18
"2011","Southampton 026A","E01017256","Total",881,863,18
"2011","Southampton 026B","E01017257","Total",777,767,10
"2011","Southampton 026C","E01017259","Total",604,601,3
"2011","Southampton 026D","E01017260","Total",668,653,15
"2011","Southampton 026E","E01017262","Total",532,528,4
"2011","Southampton 027A","E01017167","Total",687,673,14
"2011","Southampton 027B","E01017168","Total",835,824,11
"2011","Southampton 027C","E01017169","Total",651,641,10
"2011","Southampton 027D","E01017170","Total",677,670,7
"2011","Southampton 028A","E01017218","Total",505,495,10
"2011","Southampton 028B","E01017219","Total",882,857,25
"2011","Southampton 028C","E01017220","Total",816,800,16
"2011","Southampton 028D","E01017221","Total",679,662,17
"2011","Southampton 028E","E01017222","Total",643,620,23
"2011","Southampton 029A","E01017139","Total",940,904,36
"2011","Southampton 029C","E01017142","Total",1127,1021,106
"2011","Southampton 029E","E01032745","Total",594,577,17
"2011","Southampton 029F","E01032746","Total",768,713,55
"2011","Southampton 029G","E01032748","Total",717,635,82
"2011","Southampton 029H","E01032751","Total",590,565,25
"2011","Southampton 029I","E01032755","Total",511,493,18
"2011","Southampton 030A","E01017255","Total",702,686,16
"2011","Southampton 030B","E01017258","Total",651,640,11
"2011","Southampton 030C","E01017261","Total",740,717,23
"2011","Southampton 030D","E01017263","Total",608,598,10
"2011","Southampton 031A","E01017273","Total",618,594,24
"2011","Southampton 031B","E01017275","Total",710,691,19
"2011","Southampton 031C","E01017276","Total",757,742,15
"2011","Southampton 031D","E01017278","Total",618,600,18
"2011","Southampton 031E","E01017279","Total",748,730,18
"2011","Southampton 032A","E01017274","Total",618,613,5
"2011","Southampton 032B","E01017277","Total",590,582,8
"2011","Southampton 032C","E01017280","Total",619,604,15
"2011","Southampton 032D","E01017281","Total",822,818,4
"2011","West Berkshire 001A","E01016277","Total",562,527,35
"2011","West Berkshire 001B","E01016286","Total",624,602,22
"2011","West Berkshire 001C","E01016287","Total",627,573,54
"2011","West Berkshire 001D","E01016288","Total",713,666,47
"2011","West Berkshire 002A","E01016303","Total",662,633,29
"2011","West Berkshire 002B","E01016304","Total",715,672,43
"2011","West Berkshire 002C","E01016305","Total",634,581,53
"2011","West Berkshire 002D","E01016306","Total",561,530,31
"2011","West Berkshire 003A","E01016256","Total",693,666,27
"2011","West Berkshire 003B","E01016257","Total",550,534,16
"2011","West Berkshire 003C","E01016313","Total",745,706,39
"2011","West Berkshire 003D","E01016314","Total",554,521,33
"2011","West Berkshire 004A","E01016315","Total",737,713,24
"2011","West Berkshire 004B","E01016316","Total",812,793,19
"2011","West Berkshire 004C","E01016317","Total",515,510,5
"2011","West Berkshire 004D","E01016318","Total",633,626,7
"2011","West Berkshire 005A","E01016258","Total",676,669,7
"2011","West Berkshire 005B","E01016261","Total",554,550,4
"2011","West Berkshire 005C","E01016349","Total",475,472,3
"2011","West Berkshire 005D","E01016350","Total",603,596,7
"2011","West Berkshire 006A","E01016259","Total",595,584,11
"2011","West Berkshire 006B","E01016260","Total",629,617,12
"2011","West Berkshire 006C","E01016262","Total",535,531,4
"2011","West Berkshire 006D","E01016272","Total",598,590,8
"2011","West Berkshire 006E","E01016273","Total",637,627,10
"2011","West Berkshire 007A","E01016263","Total",875,849,26
"2011","West Berkshire 007B","E01016278","Total",434,411,23
"2011","West Berkshire 007C","E01016283","Total",595,575,20
"2011","West Berkshire 007D","E01016284","Total",528,515,13
"2011","West Berkshire 007E","E01016285","Total",659,622,37
"2011","West Berkshire 008A","E01016271","Total",604,597,7
"2011","West Berkshire 008B","E01016274","Total",517,512,5
"2011","West Berkshire 008C","E01016275","Total",663,647,16
"2011","West Berkshire 008D","E01016276","Total",585,578,7
"2011","West Berkshire 009A","E01016327","Total",487,471,16
"2011","West Berkshire 009B","E01016328","Total",741,717,24
"2011","West Berkshire 009C","E01016344","Total",731,714,17
"2011","West Berkshire 009D","E01016345","Total",559,538,21
"2011","West Berkshire 010A","E01016296","Total",797,766,31
"2011","West Berkshire 010B","E01016297","Total",673,628,45
"2011","West Berkshire 010C","E01016298","Total",615,564,51
"2011","West Berkshire 010D","E01016299","Total",671,642,29
"2011","West Berkshire 011A","E01016254","Total",673,611,62
"2011","West Berkshire 011B","E01016255","Total",624,581,43
"2011","West Berkshire 011C","E01016264","Total",463,430,33
"2011","West Berkshire 011D","E01016265","Total",600,578,22
"2011","West Berkshire 011E","E01016266","Total",557,530,27
"2011","West Berkshire 011F","E01016339","Total",1149,1124,25
"2011","West Berkshire 012A","E01016310","Total",898,826,72
"2011","West Berkshire 012B","E01016311","Total",857,819,38
"2011","West Berkshire 012C","E01016323","Total",611,595,16
"2011","West Berkshire 012D","E01016324","Total",597,577,20
"2011","West Berkshire 012E","E01016325","Total",662,649,13
"2011","West Berkshire 013A","E01016279","Total",942,914,28
"2011","West Berkshire 013B","E01016280","Total",716,700,16
"2011","West Berkshire 013C","E01016281","Total",570,556,14
"2011","West Berkshire 013D","E01016282","Total",623,615,8
"2011","West Berkshire 014A","E01016329","Total",617,606,11
"2011","West Berkshire 014B","E01016340","Total",642,631,11
"2011","West Berkshire 014C","E01016341","Total",517,512,5
"2011","West Berkshire 014D","E01016342","Total",795,783,12
"2011","West Berkshire 014E","E01016343","Total",587,578,9
"2011","West Berkshire 015A","E01016267","Total",560,550,10
"2011","West Berkshire 015B","E01016268","Total",638,624,14
"2011","West Berkshire 015C","E01016269","Total",588,565,23
"2011","West Berkshire 015D","E01016270","Total",555,533,22
"2011","West Berkshire 016A","E01016330","Total",668,665,3
"2011","West Berkshire 016B","E01016331","Total",602,593,9
"2011","West Berkshire 016C","E01016332","Total",780,755,25
"2011","West Berkshire 016D","E01016334","Total",646,637,9
"2011","West Berkshire 016E","E01016336","Total",484,479,5
"2011","West Berkshire 017A","E01016333","Total",503,492,11
"2011","West Berkshire 017B","E01016335","Total",591,586,5
"2011","West Berkshire 017C","E01016337","Total",908,887,21
"2011","West Berkshire 017D","E01016338","Total",753,743,10
"2011","West Berkshire 018A","E01016300","Total",664,642,22
"2011","West Berkshire 018B","E01016301","Total",859,771,88
"2011","West Berkshire 018C","E01016302","Total",672,633,39
"2011","West Berkshire 018D","E01016326","Total",570,541,29
"2011","West Berkshire 019A","E01016293","Total",1077,1005,72
"2011","West Berkshire 019B","E01016346","Total",754,729,25
"2011","West Berkshire 019C","E01016347","Total",983,880,103
"2011","West Berkshire 019D","E01016348","Total",1028,978,50
"2011","West Berkshire 020A","E01016294","Total",663,650,13
"2011","West Berkshire 020B","E01016295","Total",631,616,15
"2011","West Berkshire 020C","E01016312","Total",848,825,23
"2011","West Berkshire 020D","E01016319","Total",762,737,25
"2011","West Berkshire 020E","E01016320","Total",666,637,29
"2011","West Berkshire 021A","E01016289","Total",594,579,15
"2011","West Berkshire 021B","E01016290","Total",642,629,13
"2011","West Berkshire 021C","E01016291","Total",699,688,11
"2011","West Berkshire 021D","E01016292","Total",623,615,8
"2011","West Berkshire 021E","E01016321","Total",646,609,37
"2011","West Berkshire 021F","E01016322","Total",500,491,9
"2011","West Berkshire 022A","E01016307","Total",720,679,41
"2011","West Berkshire 022B","E01016308","Total",783,759,24
"2011","West Berkshire 022C","E01016309","Total",924,888,36
"2011","Windsor and Maidenhead 001A","E01016570","Total",647,640,7
"2011","Windsor and Maidenhead 001B","E01016572","Total",567,559,8
"2011","Windsor and Maidenhead 001C","E01016582","Total",519,501,18
"2011","Windsor and Maidenhead 001D","E01016600","Total",457,448,9
"2011","Windsor and Maidenhead 002A","E01016530","Total",667,647,20
"2011","Windsor and Maidenhead 002B","E01016531","Total",664,607,57
"2011","Windsor and Maidenhead 002C","E01016532","Total",880,840,40
"2011","Windsor and Maidenhead 002D","E01016533","Total",807,770,37
"2011","Windsor and Maidenhead 002E","E01016578","Total",623,589,34
"2011","Windsor and Maidenhead 002F","E01016579","Total",741,693,48
"2011","Windsor and Maidenhead 002G","E01016581","Total",608,572,36
"2011","Windsor and Maidenhead 003A","E01016571","Total",574,562,12
"2011","Windsor and Maidenhead 003B","E01016573","Total",528,523,5
"2011","Windsor and Maidenhead 003C","E01016574","Total",613,604,9
"2011","Windsor and Maidenhead 003D","E01016599","Total",607,600,7
"2011","Windsor and Maidenhead 004A","E01016583","Total",704,680,24
"2011","Windsor and Maidenhead 004B","E01016585","Total",828,781,47
"2011","Windsor and Maidenhead 004C","E01016586","Total",553,542,11
"2011","Windsor and Maidenhead 004D","E01016591","Total",652,629,23
"2011","Windsor and Maidenhead 004E","E01016592","Total",840,798,42
"2011","Windsor and Maidenhead 005A","E01016525","Total",660,635,25
"2011","Windsor and Maidenhead 005B","E01016528","Total",650,631,19
"2011","Windsor and Maidenhead 005C","E01016529","Total",687,654,33
"2011","Windsor and Maidenhead 005D","E01016536","Total",887,848,39
"2011","Windsor and Maidenhead 005E","E01016584","Total",696,669,27
"2011","Windsor and Maidenhead 005G","E01032733","Total",713,617,96
"2011","Windsor and Maidenhead 005H","E01032734","Total",691,650,41
"2011","Windsor and Maidenhead 006A","E01016526","Total",725,713,12
"2011","Windsor and Maidenhead 006B","E01016527","Total",668,656,12
"2011","Windsor and Maidenhead 006C","E01016534","Total",607,587,20
"2011","Windsor and Maidenhead 006D","E01016598","Total",524,513,11
"2011","Windsor and Maidenhead 006E","E01016601","Total",636,616,20
"2011","Windsor and Maidenhead 006F","E01016602","Total",646,636,10
"2011","Windsor and Maidenhead 007A","E01016535","Total",506,491,15
"2011","Windsor and Maidenhead 007B","E01016537","Total",482,470,12
"2011","Windsor and Maidenhead 007C","E01016538","Total",637,625,12
"2011","Windsor and Maidenhead 007D","E01016593","Total",678,665,13
"2011","Windsor and Maidenhead 007E","E01016594","Total",590,582,8
"2011","Windsor and Maidenhead 008A","E01016559","Total",568,562,6
"2011","Windsor and Maidenhead 008B","E01016560","Total",650,646,4
"2011","Windsor and Maidenhead 008C","E01016561","Total",683,674,9
"2011","Windsor and Maidenhead 008D","E01016562","Total",521,513,8
"2011","Windsor and Maidenhead 008E","E01016563","Total",512,507,5
"2011","Windsor and Maidenhead 008F","E01016580","Total",652,643,9
"2011","Windsor and Maidenhead 009A","E01016539","Total",678,641,37
"2011","Windsor and Maidenhead 009B","E01016540","Total",670,652,18
"2011","Windsor and Maidenhead 009C","E01016541","Total",520,512,8
"2011","Windsor and Maidenhead 009D","E01016542","Total",498,491,7
"2011","Windsor and Maidenhead 009E","E01016543","Total",711,670,41
"2011","Windsor and Maidenhead 010A","E01016544","Total",895,800,95
"2011","Windsor and Maidenhead 010B","E01016567","Total",887,817,70
"2011","Windsor and Maidenhead 010C","E01016568","Total",508,499,9
"2011","Windsor and Maidenhead 010D","E01016569","Total",499,493,6
"2011","Windsor and Maidenhead 011A","E01016564","Total",664,644,20
"2011","Windsor and Maidenhead 011B","E01016565","Total",667,624,43
"2011","Windsor and Maidenhead 011C","E01016566","Total",797,764,33
"2011","Windsor and Maidenhead 011D","E01016577","Total",773,698,75
"2011","Windsor and Maidenhead 012A","E01016545","Total",1140,1069,71
"2011","Windsor and Maidenhead 012B","E01016547","Total",804,756,48
"2011","Windsor and Maidenhead 012C","E01016550","Total",534,510,24
"2011","Windsor and Maidenhead 012D","E01016552","Total",696,686,10
"2011","Windsor and Maidenhead 013A","E01016551","Total",631,623,8
"2011","Windsor and Maidenhead 013B","E01016553","Total",701,676,25
"2011","Windsor and Maidenhead 013C","E01016557","Total",845,832,13
"2011","Windsor and Maidenhead 013D","E01016558","Total",629,613,16
"2011","Windsor and Maidenhead 014A","E01016548","Total",856,830,26
"2011","Windsor and Maidenhead 014B","E01016549","Total",879,858,21
"2011","Windsor and Maidenhead 014C","E01016554","Total",654,650,4
"2011","Windsor and Maidenhead 014D","E01016555","Total",596,588,8
"2011","Windsor and Maidenhead 014E","E01016556","Total",774,762,12
"2011","Windsor and Maidenhead 015A","E01016546","Total",807,750,57
"2011","Windsor and Maidenhead 015B","E01016595","Total",724,680,44
"2011","Windsor and Maidenhead 015C","E01016596","Total",848,797,51
"2011","Windsor and Maidenhead 015D","E01016597","Total",643,617,26
"2011","Windsor and Maidenhead 016A","E01016575","Total",679,637,42
"2011","Windsor and Maidenhead 016B","E01016576","Total",719,661,58
"2011","Windsor and Maidenhead 016C","E01016587","Total",643,638,5
"2011","Windsor and Maidenhead 016D","E01016588","Total",801,777,24
"2011","Windsor and Maidenhead 016E","E01016589","Total",677,642,35
"2011","Windsor and Maidenhead 017A","E01016522","Total",732,698,34
"2011","Windsor and Maidenhead 017B","E01016523","Total",642,584,58
"2011","Windsor and Maidenhead 017C","E01016524","Total",912,864,48
"2011","Windsor and Maidenhead 017D","E01016609","Total",774,740,34
"2011","Windsor and Maidenhead 018A","E01016603","Total",812,744,68
"2011","Windsor and Maidenhead 018B","E01016604","Total",908,778,130
"2011","Windsor and Maidenhead 018C","E01016605","Total",660,613,47
"2011","Windsor and Maidenhead 018D","E01016606","Total",679,646,33
"2011","Windsor and Maidenhead 018E","E01016607","Total",566,529,37
"2011","Windsor and Maidenhead 018F","E01016608","Total",863,808,55
"2011","Wokingham 001A","E01016675","Total",564,469,95
"2011","Wokingham 001B","E01016676","Total",647,621,26
"2011","Wokingham 001C","E01016677","Total",655,619,36
"2011","Wokingham 001D","E01016678","Total",588,563,25
"2011","Wokingham 002A","E01016619","Total",591,571,20
"2011","Wokingham 002B","E01016620","Total",540,526,14
"2011","Wokingham 002C","E01016692","Total",672,653,19
"2011","Wokingham 002D","E01016693","Total",615,604,11
"2011","Wokingham 002E","E01016694","Total",715,683,32
"2011","Wokingham 002F","E01016695","Total",609,597,12
"2011","Wokingham 003A","E01016621","Total",594,582,12
"2011","Wokingham 003B","E01016623","Total",619,605,14
"2011","Wokingham 003C","E01016624","Total",533,527,6
"2011","Wokingham 003D","E01016684","Total",629,619,10
"2011","Wokingham 003E","E01016685","Total",653,621,32
"2011","Wokingham 004A","E01016622","Total",467,462,5
"2011","Wokingham 004B","E01016657","Total",559,547,12
"2011","Wokingham 004C","E01016658","Total",492,484,8
"2011","Wokingham 004D","E01016659","Total",662,643,19
"2011","Wokingham 004E","E01016660","Total",634,624,10
"2011","Wokingham 005A","E01016615","Total",624,605,19
"2011","Wokingham 005B","E01016616","Total",659,622,37
"2011","Wokingham 005C","E01016617","Total",506,502,4
"2011","Wokingham 005D","E01016662","Total",743,700,43
"2011","Wokingham 006A","E01016613","Total",490,479,11
"2011","Wokingham 006B","E01016614","Total",491,477,14
"2011","Wokingham 006C","E01016618","Total",498,486,12
"2011","Wokingham 006D","E01016664","Total",482,476,6
"2011","Wokingham 006E","E01016668","Total",621,602,19
"2011","Wokingham 006F","E01016669","Total",719,703,16
"2011","Wokingham 007A","E01016661","Total",499,493,6
"2011","Wokingham 007B","E01016663","Total",610,598,12
"2011","Wokingham 007C","E01016686","Total",491,486,5
"2011","Wokingham 007D","E01016687","Total",502,500,2
"2011","Wokingham 007E","E01016688","Total",458,454,4
"2011","Wokingham 007F","E01016689","Total",586,579,7
"2011","Wokingham 008B","E01016652","Total",475,470,5
"2011","Wokingham 008C","E01016653","Total",461,450,11
"2011","Wokingham 008D","E01016665","Total",652,642,10
"2011","Wokingham 008E","E01016666","Total",510,503,7
"2011","Wokingham 008G","E01032761","Total",1004,970,34
"2011","Wokingham 009A","E01016647","Total",636,626,10
"2011","Wokingham 009B","E01016701","Total",664,643,21
"2011","Wokingham 009C","E01016702","Total",722,697,25
"2011","Wokingham 009D","E01016703","Total",701,691,10
"2011","Wokingham 009E","E01016704","Total",825,796,29
"2011","Wokingham 010A","E01016627","Total",728,716,12
"2011","Wokingham 010B","E01016628","Total",628,619,9
"2011","Wokingham 010C","E01016656","Total",608,560,48
"2011","Wokingham 010D","E01016700","Total",744,722,22
"2011","Wokingham 011A","E01016644","Total",536,529,7
"2011","Wokingham 011B","E01016645","Total",764,745,19
"2011","Wokingham 011C","E01016646","Total",623,610,13
"2011","Wokingham 011D","E01016648","Total",656,638,18
"2011","Wokingham 011E","E01016649","Total",635,622,13
"2011","Wokingham 012A","E01016651","Total",602,587,15
"2011","Wokingham 012B","E01016654","Total",602,590,12
"2011","Wokingham 012C","E01016655","Total",508,503,5
"2011","Wokingham 012D","E01016679","Total",861,842,19
"2011","Wokingham 012E","E01016680","Total",509,496,13
"2011","Wokingham 012G","E01032758","Total",627,608,19
"2011","Wokingham 012H","E01032759","Total",605,580,25
"2011","Wokingham 013A","E01016626","Total",835,800,35
"2011","Wokingham 013B","E01016671","Total",927,869,58
"2011","Wokingham 013C","E01016673","Total",772,740,32
"2011","Wokingham 013D","E01016674","Total",593,580,13
"2011","Wokingham 013E","E01016696","Total",775,736,39
"2011","Wokingham 014A","E01016670","Total",834,821,13
"2011","Wokingham 014B","E01016672","Total",847,702,145
"2011","Wokingham 014E","E01032763","Total",936,905,31
"2011","Wokingham 015A","E01016612","Total",818,788,30
"2011","Wokingham 015B","E01016629","Total",537,523,14
"2011","Wokingham 015C","E01016630","Total",585,569,16
"2011","Wokingham 015D","E01016635","Total",514,507,7
"2011","Wokingham 016A","E01016625","Total",674,658,16
"2011","Wokingham 016B","E01016631","Total",567,558,9
"2011","Wokingham 016C","E01016632","Total",595,588,7
"2011","Wokingham 016D","E01016634","Total",620,606,14
"2011","Wokingham 016E","E01016699","Total",672,635,37
"2011","Wokingham 017A","E01016682","Total",774,748,26
"2011","Wokingham 017B","E01016683","Total",744,728,16
"2011","Wokingham 017C","E01016690","Total",776,747,29
"2011","Wokingham 017D","E01016691","Total",479,446,33
"2011","Wokingham 018A","E01016610","Total",1203,1094,109
"2011","Wokingham 018B","E01016611","Total",508,438,70
"2011","Wokingham 018C","E01016641","Total",590,548,42
"2011","Wokingham 018D","E01016642","Total",471,455,16
"2011","Wokingham 019A","E01016633","Total",502,497,5
"2011","Wokingham 019B","E01016636","Total",572,562,10
"2011","Wokingham 019C","E01016637","Total",433,408,25
"2011","Wokingham 019D","E01016638","Total",501,493,8
"2011","Wokingham 019E","E01016639","Total",626,609,17
"2011","Wokingham 019F","E01016640","Total",636,611,25
"2011","Wokingham 019G","E01016643","Total",510,499,11
"2011","Wokingham 020A","E01016705","Total",579,501,78
"2011","Wokingham 020B","E01016706","Total",642,636,6
"2011","Wokingham 020C","E01016707","Total",639,629,10
"2011","Wokingham 020D","E01016708","Total",672,653,19
"2011","Wokingham 020E","E01016709","Total",629,608,21
"2011","Aylesbury Vale 001A","E01017648","Total",694,683,11
"2011","Aylesbury Vale 001B","E01017649","Total",879,833,46
"2011","Aylesbury Vale 001C","E01017650","Total",621,609,12
"2011","Aylesbury Vale 001F","E01032960","Total",1003,954,49
"2011","Aylesbury Vale 002A","E01017644","Total",664,633,31
"2011","Aylesbury Vale 002B","E01017645","Total",646,574,72
"2011","Aylesbury Vale 002C","E01017646","Total",817,790,27
"2011","Aylesbury Vale 002D","E01017647","Total",629,619,10
"2011","Aylesbury Vale 003A","E01017671","Total",627,609,18
"2011","Aylesbury Vale 003B","E01017672","Total",603,578,25
"2011","Aylesbury Vale 003C","E01017695","Total",532,511,21
"2011","Aylesbury Vale 003D","E01017696","Total",537,510,27
"2011","Aylesbury Vale 004A","E01017693","Total",458,438,20
"2011","Aylesbury Vale 004B","E01017694","Total",851,826,25
"2011","Aylesbury Vale 004C","E01017713","Total",605,589,16
"2011","Aylesbury Vale 004D","E01017714","Total",547,521,26
"2011","Aylesbury Vale 004E","E01017717","Total",728,692,36
"2011","Aylesbury Vale 004F","E01017718","Total",690,640,50
"2011","Aylesbury Vale 005A","E01017735","Total",562,545,17
"2011","Aylesbury Vale 005B","E01017736","Total",678,662,16
"2011","Aylesbury Vale 005C","E01017737","Total",603,593,10
"2011","Aylesbury Vale 005D","E01017738","Total",735,685,50
"2011","Aylesbury Vale 006A","E01017669","Total",641,605,36
"2011","Aylesbury Vale 006B","E01017670","Total",658,633,25
"2011","Aylesbury Vale 006C","E01017715","Total",473,460,13
"2011","Aylesbury Vale 006D","E01017716","Total",740,713,27
"2011","Aylesbury Vale 007A","E01017641","Total",731,708,23
"2011","Aylesbury Vale 007B","E01017731","Total",588,550,38
"2011","Aylesbury Vale 007C","E01017732","Total",569,549,20
"2011","Aylesbury Vale 007D","E01017733","Total",541,509,32
"2011","Aylesbury Vale 007E","E01017734","Total",595,553,42
"2011","Aylesbury Vale 008A","E01017703","Total",544,523,21
"2011","Aylesbury Vale 008B","E01017704","Total",502,486,16
"2011","Aylesbury Vale 008C","E01017719","Total",519,501,18
"2011","Aylesbury Vale 008D","E01017720","Total",543,512,31
"2011","Aylesbury Vale 008F","E01032958","Total",652,622,30
"2011","Aylesbury Vale 008G","E01032959","Total",688,628,60
"2011","Aylesbury Vale 009A","E01017651","Total",624,602,22
"2011","Aylesbury Vale 009B","E01017652","Total",649,625,24
"2011","Aylesbury Vale 009C","E01017657","Total",611,584,27
"2011","Aylesbury Vale 009D","E01017658","Total",632,594,38
"2011","Aylesbury Vale 009E","E01017701","Total",839,810,29
"2011","Aylesbury Vale 009F","E01017702","Total",629,608,21
"2011","Aylesbury Vale 010A","E01017642","Total",564,539,25
"2011","Aylesbury Vale 010B","E01017643","Total",557,529,28
"2011","Aylesbury Vale 010C","E01017673","Total",503,486,17
"2011","Aylesbury Vale 010D","E01017674","Total",536,512,24
"2011","Aylesbury Vale 011A","E01017659","Total",617,607,10
"2011","Aylesbury Vale 011B","E01017660","Total",766,740,26
"2011","Aylesbury Vale 011C","E01017661","Total",622,618,4
"2011","Aylesbury Vale 011D","E01017664","Total",638,627,11
"2011","Aylesbury Vale 012A","E01017705","Total",504,483,21
"2011","Aylesbury Vale 012B","E01017706","Total",506,498,8
"2011","Aylesbury Vale 012C","E01017707","Total",473,468,5
"2011","Aylesbury Vale 012D","E01017708","Total",616,595,21
"2011","Aylesbury Vale 013A","E01017665","Total",596,584,12
"2011","Aylesbury Vale 013B","E01017666","Total",793,733,60
"2011","Aylesbury Vale 013C","E01017667","Total",516,506,10
"2011","Aylesbury Vale 013D","E01017668","Total",631,617,14
"2011","Aylesbury Vale 014A","E01017697","Total",630,621,9
"2011","Aylesbury Vale 014B","E01017698","Total",542,534,8
"2011","Aylesbury Vale 014C","E01017699","Total",452,435,17
"2011","Aylesbury Vale 014D","E01017700","Total",630,619,11
"2011","Aylesbury Vale 015B","E01017634","Total",653,634,19
"2011","Aylesbury Vale 015C","E01017662","Total",544,515,29
"2011","Aylesbury Vale 015D","E01017663","Total",627,600,27
"2011","Aylesbury Vale 015E","E01032955","Total",779,722,57
"2011","Aylesbury Vale 015F","E01032961","Total",543,503,40
"2011","Aylesbury Vale 016A","E01017653","Total",623,608,15
"2011","Aylesbury Vale 016B","E01017654","Total",586,542,44
"2011","Aylesbury Vale 016C","E01017655","Total",831,813,18
"2011","Aylesbury Vale 016E","E01032956","Total",688,670,18
"2011","Aylesbury Vale 016F","E01032957","Total",609,598,11
"2011","Aylesbury Vale 016G","E01032962","Total",666,656,10
"2011","Aylesbury Vale 017A","E01017635","Total",630,609,21
"2011","Aylesbury Vale 017B","E01017636","Total",648,637,11
"2011","Aylesbury Vale 017C","E01017637","Total",502,492,10
"2011","Aylesbury Vale 017D","E01017638","Total",516,499,17
"2011","Aylesbury Vale 017E","E01017639","Total",615,611,4
"2011","Aylesbury Vale 017F","E01017640","Total",640,624,16
"2011","Aylesbury Vale 018A","E01017709","Total",586,569,17
"2011","Aylesbury Vale 018B","E01017710","Total",528,517,11
"2011","Aylesbury Vale 018C","E01017711","Total",632,622,10
"2011","Aylesbury Vale 018D","E01017712","Total",826,798,28
"2011","Aylesbury Vale 019A","E01017687","Total",952,886,66
"2011","Aylesbury Vale 019B","E01017688","Total",527,513,14
"2011","Aylesbury Vale 019C","E01017689","Total",595,568,27
"2011","Aylesbury Vale 019D","E01017690","Total",495,483,12
"2011","Aylesbury Vale 019E","E01017691","Total",524,517,7
"2011","Aylesbury Vale 019F","E01017692","Total",706,683,23
"2011","Aylesbury Vale 020A","E01017721","Total",792,773,19
"2011","Aylesbury Vale 020B","E01017722","Total",629,624,5
"2011","Aylesbury Vale 020C","E01017723","Total",511,500,11
"2011","Aylesbury Vale 020D","E01017724","Total",511,498,13
"2011","Aylesbury Vale 021A","E01017627","Total",701,676,25
"2011","Aylesbury Vale 021B","E01017628","Total",650,633,17
"2011","Aylesbury Vale 021C","E01017629","Total",665,649,16
"2011","Aylesbury Vale 021D","E01017630","Total",627,617,10
"2011","Aylesbury Vale 021E","E01017631","Total",651,644,7
"2011","Aylesbury Vale 021F","E01017632","Total",636,618,18
"2011","Aylesbury Vale 022A","E01017675","Total",626,605,21
"2011","Aylesbury Vale 022B","E01017676","Total",593,568,25
"2011","Aylesbury Vale 022C","E01017677","Total",625,602,23
"2011","Aylesbury Vale 022D","E01017678","Total",554,547,7
"2011","Aylesbury Vale 022E","E01017679","Total",631,616,15
"2011","Aylesbury Vale 022F","E01017680","Total",484,449,35
"2011","Aylesbury Vale 023A","E01017681","Total",544,523,21
"2011","Aylesbury Vale 023B","E01017682","Total",503,481,22
"2011","Aylesbury Vale 023C","E01017683","Total",697,671,26
"2011","Aylesbury Vale 023D","E01017684","Total",482,462,20
"2011","Aylesbury Vale 024A","E01017726","Total",567,527,40
"2011","Aylesbury Vale 024B","E01017727","Total",680,661,19
"2011","Aylesbury Vale 024C","E01017728","Total",828,740,88
"2011","Aylesbury Vale 024D","E01017729","Total",691,679,12
"2011","Aylesbury Vale 024E","E01017730","Total",754,734,20
"2011","Chiltern 001A","E01017750","Total",927,883,44
"2011","Chiltern 001B","E01017752","Total",930,887,43
"2011","Chiltern 001C","E01017766","Total",965,904,61
"2011","Chiltern 001D","E01017778","Total",532,516,16
"2011","Chiltern 002A","E01017747","Total",558,533,25
"2011","Chiltern 002B","E01017748","Total",742,727,15
"2011","Chiltern 002C","E01017749","Total",682,659,23
"2011","Chiltern 002D","E01017789","Total",523,508,15
"2011","Chiltern 002E","E01017790","Total",517,495,22
"2011","Chiltern 002F","E01017795","Total",854,829,25
"2011","Chiltern 003A","E01017769","Total",648,627,21
"2011","Chiltern 003B","E01017771","Total",640,623,17
"2011","Chiltern 003C","E01017780","Total",506,490,16
"2011","Chiltern 003D","E01017781","Total",476,455,21
"2011","Chiltern 004A","E01017770","Total",672,642,30
"2011","Chiltern 004B","E01017791","Total",631,621,10
"2011","Chiltern 004C","E01017792","Total",974,923,51
"2011","Chiltern 004D","E01017793","Total",617,610,7
"2011","Chiltern 005A","E01017768","Total",1008,960,48
"2011","Chiltern 005B","E01017779","Total",434,425,9
"2011","Chiltern 005C","E01017785","Total",686,666,20
"2011","Chiltern 005D","E01017786","Total",623,603,20
"2011","Chiltern 005E","E01017787","Total",634,615,19
"2011","Chiltern 005F","E01017788","Total",783,763,20
"2011","Chiltern 006A","E01017741","Total",683,665,18
"2011","Chiltern 006B","E01017742","Total",731,701,30
"2011","Chiltern 006C","E01017743","Total",652,638,14
"2011","Chiltern 006D","E01017763","Total",795,750,45
"2011","Chiltern 006E","E01017764","Total",622,609,13
"2011","Chiltern 006F","E01017765","Total",643,619,24
"2011","Chiltern 007A","E01017739","Total",496,493,3
"2011","Chiltern 007B","E01017740","Total",542,532,10
"2011","Chiltern 007C","E01017744","Total",599,569,30
"2011","Chiltern 007D","E01017745","Total",870,813,57
"2011","Chiltern 007E","E01017746","Total",610,593,17
"2011","Chiltern 008A","E01017762","Total",554,527,27
"2011","Chiltern 008B","E01017775","Total",696,677,19
"2011","Chiltern 008C","E01017776","Total",677,661,16
"2011","Chiltern 008D","E01017777","Total",659,644,15
"2011","Chiltern 010A","E01017759","Total",833,776,57
"2011","Chiltern 010B","E01017760","Total",675,658,17
"2011","Chiltern 010C","E01017761","Total",874,862,12
"2011","Chiltern 010D","E01017794","Total",918,889,29
"2011","Chiltern 011A","E01017754","Total",569,551,18
"2011","Chiltern 011B","E01017755","Total",689,662,27
"2011","Chiltern 011C","E01017756","Total",599,584,15
"2011","Chiltern 011D","E01017757","Total",499,479,20
"2011","Chiltern 011E","E01017758","Total",440,426,14
"2011","Chiltern 012A","E01017751","Total",818,787,31
"2011","Chiltern 012B","E01017753","Total",524,516,8
"2011","Chiltern 012C","E01017767","Total",911,879,32
"2011","Chiltern 013A","E01017773","Total",645,609,36
"2011","Chiltern 013B","E01017774","Total",519,505,14
"2011","Chiltern 013C","E01017782","Total",565,544,21
"2011","Chiltern 013D","E01017783","Total",630,601,29
"2011","Chiltern 013E","E01017784","Total",673,645,28
"2011","Chiltern 013F","E01032609","Total",534,518,16
"2011","South Bucks 001A","E01017796","Total",810,776,34
"2011","South Bucks 001B","E01017797","Total",550,533,17
"2011","South Bucks 001C","E01017798","Total",746,714,32
"2011","South Bucks 001D","E01017799","Total",830,791,39
"2011","South Bucks 001E","E01017800","Total",724,684,40
"2011","South Bucks 001F","E01017801","Total",592,580,12
"2011","South Bucks 001G","E01017802","Total",668,655,13
"2011","South Bucks 002A","E01017818","Total",740,715,25
"2011","South Bucks 002B","E01017819","Total",587,552,35
"2011","South Bucks 002C","E01017820","Total",751,703,48
"2011","South Bucks 002D","E01017821","Total",623,561,62
"2011","South Bucks 002E","E01017822","Total",650,629,21
"2011","South Bucks 003A","E01017810","Total",962,902,60
"2011","South Bucks 003B","E01017811","Total",525,498,27
"2011","South Bucks 003C","E01017812","Total",688,651,37
"2011","South Bucks 003D","E01017813","Total",789,755,34
"2011","South Bucks 004A","E01017815","Total",699,679,20
"2011","South Bucks 004B","E01017816","Total",752,723,29
"2011","South Bucks 004C","E01017817","Total",754,724,30
"2011","South Bucks 004D","E01017823","Total",615,572,43
"2011","South Bucks 005A","E01017830","Total",808,779,29
"2011","South Bucks 005B","E01017831","Total",672,648,24
"2011","South Bucks 005C","E01017832","Total",644,601,43
"2011","South Bucks 005D","E01017834","Total",592,552,40
"2011","South Bucks 005E","E01017835","Total",811,774,37
"2011","South Bucks 006A","E01017803","Total",517,486,31
"2011","South Bucks 006B","E01017806","Total",656,648,8
"2011","South Bucks 006C","E01017814","Total",619,595,24
"2011","South Bucks 006D","E01017833","Total",850,791,59
"2011","South Bucks 007A","E01017804","Total",721,683,38
"2011","South Bucks 007B","E01017805","Total",799,774,25
"2011","South Bucks 007C","E01017807","Total",622,608,14
"2011","South Bucks 007D","E01017808","Total",657,642,15
"2011","South Bucks 007E","E01017809","Total",610,587,23
"2011","South Bucks 008A","E01017824","Total",708,685,23
"2011","South Bucks 008B","E01017825","Total",668,651,17
"2011","South Bucks 008C","E01017826","Total",650,623,27
"2011","South Bucks 008D","E01017827","Total",699,664,35
"2011","South Bucks 008E","E01017828","Total",674,659,15
"2011","South Bucks 008F","E01017829","Total",689,667,22
"2011","Wycombe 001A","E01017929","Total",822,785,37
"2011","Wycombe 001B","E01017930","Total",753,731,22
"2011","Wycombe 001C","E01017931","Total",618,600,18
"2011","Wycombe 001D","E01017932","Total",709,680,29
"2011","Wycombe 001E","E01017933","Total",711,704,7
"2011","Wycombe 002A","E01017885","Total",700,672,28
"2011","Wycombe 002B","E01017886","Total",645,614,31
"2011","Wycombe 002C","E01017887","Total",476,468,8
"2011","Wycombe 002D","E01017888","Total",660,630,30
"2011","Wycombe 003A","E01017869","Total",518,511,7
"2011","Wycombe 003B","E01017870","Total",487,478,9
"2011","Wycombe 003C","E01017871","Total",628,609,19
"2011","Wycombe 003D","E01017872","Total",686,673,13
"2011","Wycombe 003E","E01017873","Total",531,517,14
"2011","Wycombe 003F","E01017874","Total",576,459,117
"2011","Wycombe 004A","E01017915","Total",549,530,19
"2011","Wycombe 004B","E01017916","Total",499,480,19
"2011","Wycombe 004C","E01017917","Total",599,578,21
"2011","Wycombe 004D","E01017918","Total",721,702,19
"2011","Wycombe 006A","E01017857","Total",606,598,8
"2011","Wycombe 006B","E01017858","Total",616,601,15
"2011","Wycombe 006C","E01017859","Total",517,503,14
"2011","Wycombe 006D","E01017860","Total",495,493,2
"2011","Wycombe 006E","E01017861","Total",612,607,5
"2011","Wycombe 006F","E01017862","Total",741,706,35
"2011","Wycombe 006G","E01017863","Total",651,641,10
"2011","Wycombe 007A","E01017842","Total",1100,1053,47
"2011","Wycombe 007B","E01017853","Total",608,575,33
"2011","Wycombe 007C","E01017854","Total",521,505,16
"2011","Wycombe 007D","E01017878","Total",1173,1074,99
"2011","Wycombe 008A","E01017920","Total",484,476,8
"2011","Wycombe 008B","E01017921","Total",687,674,13
"2011","Wycombe 008C","E01017922","Total",897,676,221
"2011","Wycombe 008D","E01017923","Total",694,666,28
"2011","Wycombe 008E","E01017924","Total",580,557,23
"2011","Wycombe 009A","E01017937","Total",580,567,13
"2011","Wycombe 009B","E01017938","Total",505,503,2
"2011","Wycombe 009C","E01017940","Total",692,673,19
"2011","Wycombe 009D","E01017942","Total",591,587,4
"2011","Wycombe 010A","E01017850","Total",484,474,10
"2011","Wycombe 010B","E01017851","Total",694,678,16
"2011","Wycombe 010C","E01017852","Total",717,709,8
"2011","Wycombe 010D","E01017919","Total",661,630,31
"2011","Wycombe 011A","E01017925","Total",802,785,17
"2011","Wycombe 011B","E01017926","Total",693,669,24
"2011","Wycombe 011C","E01017927","Total",604,589,15
"2011","Wycombe 011D","E01017928","Total",625,614,11
"2011","Wycombe 012A","E01017911","Total",682,670,12
"2011","Wycombe 012B","E01017912","Total",533,523,10
"2011","Wycombe 012C","E01017913","Total",778,745,33
"2011","Wycombe 012D","E01017914","Total",512,507,5
"2011","Wycombe 013A","E01017903","Total",527,508,19
"2011","Wycombe 013B","E01017904","Total",646,607,39
"2011","Wycombe 013C","E01017905","Total",907,838,69
"2011","Wycombe 013D","E01017906","Total",509,501,8
"2011","Wycombe 013E","E01017907","Total",639,621,18
"2011","Wycombe 014A","E01017899","Total",703,688,15
"2011","Wycombe 014B","E01017900","Total",556,528,28
"2011","Wycombe 014C","E01017901","Total",466,462,4
"2011","Wycombe 014D","E01017902","Total",644,637,7
"2011","Wycombe 015A","E01017836","Total",565,551,14
"2011","Wycombe 015B","E01017837","Total",847,779,68
"2011","Wycombe 015C","E01017838","Total",524,510,14
"2011","Wycombe 015D","E01017839","Total",519,496,23
"2011","Wycombe 015E","E01017840","Total",679,666,13
"2011","Wycombe 015F","E01017841","Total",531,518,13
"2011","Wycombe 016A","E01017908","Total",1193,1167,26
"2011","Wycombe 016B","E01017909","Total",1011,938,73
"2011","Wycombe 016C","E01017910","Total",1106,1072,34
"2011","Wycombe 016D","E01017941","Total",703,671,32
"2011","Wycombe 017A","E01017843","Total",667,654,13
"2011","Wycombe 017B","E01017844","Total",745,731,14
"2011","Wycombe 017C","E01017845","Total",715,706,9
"2011","Wycombe 017D","E01017855","Total",636,617,19
"2011","Wycombe 017E","E01017856","Total",544,538,6
"2011","Wycombe 018A","E01017864","Total",529,520,9
"2011","Wycombe 018B","E01017865","Total",620,611,9
"2011","Wycombe 018C","E01017867","Total",618,610,8
"2011","Wycombe 018D","E01017868","Total",664,649,15
"2011","Wycombe 019A","E01017934","Total",768,750,18
"2011","Wycombe 019B","E01017935","Total",901,872,29
"2011","Wycombe 019C","E01017936","Total",666,649,17
"2011","Wycombe 019D","E01017939","Total",573,558,15
"2011","Wycombe 020A","E01017866","Total",623,603,20
"2011","Wycombe 020B","E01017875","Total",596,544,52
"2011","Wycombe 020C","E01017876","Total",778,775,3
"2011","Wycombe 020D","E01017877","Total",650,641,9
"2011","Wycombe 021A","E01017846","Total",663,639,24
"2011","Wycombe 021B","E01017847","Total",696,682,14
"2011","Wycombe 021C","E01017848","Total",481,474,7
"2011","Wycombe 021D","E01017849","Total",691,665,26
"2011","Wycombe 022A","E01017889","Total",539,530,9
"2011","Wycombe 022B","E01017890","Total",506,500,6
"2011","Wycombe 022C","E01017891","Total",646,635,11
"2011","Wycombe 022D","E01017892","Total",624,607,17
"2011","Wycombe 022E","E01017893","Total",832,799,33
"2011","Wycombe 022F","E01017894","Total",685,658,27
"2011","Wycombe 023A","E01017895","Total",635,606,29
"2011","Wycombe 023B","E01017896","Total",662,629,33
"2011","Wycombe 023C","E01017897","Total",654,643,11
"2011","Wycombe 023D","E01017898","Total",505,499,6
"2011","Wycombe 024A","E01017880","Total",526,519,7
"2011","Wycombe 024B","E01017881","Total",716,701,15
"2011","Wycombe 024C","E01017882","Total",655,635,20
"2011","Wycombe 024D","E01017883","Total",634,626,8
"2011","Wycombe 024E","E01017884","Total",636,627,9
"2011","Wycombe 024F","E01032610","Total",658,652,6
"2011","Eastbourne 001A","E01020924","Total",563,551,12
"2011","Eastbourne 001B","E01020925","Total",630,605,25
"2011","Eastbourne 001C","E01020927","Total",575,567,8
"2011","Eastbourne 001D","E01020928","Total",827,791,36
"2011","Eastbourne 001E","E01020930","Total",505,495,10
"2011","Eastbourne 002A","E01020917","Total",599,587,12
"2011","Eastbourne 002B","E01020918","Total",638,625,13
"2011","Eastbourne 002C","E01020919","Total",599,584,15
"2011","Eastbourne 002D","E01020923","Total",581,569,12
"2011","Eastbourne 002E","E01020949","Total",703,685,18
"2011","Eastbourne 003A","E01020926","Total",622,613,9
"2011","Eastbourne 003B","E01020929","Total",791,739,52
"2011","Eastbourne 003C","E01020955","Total",715,700,15
"2011","Eastbourne 003D","E01020956","Total",846,822,24
"2011","Eastbourne 003E","E01020957","Total",673,663,10
"2011","Eastbourne 004A","E01020920","Total",764,741,23
"2011","Eastbourne 004B","E01020921","Total",611,604,7
"2011","Eastbourne 004C","E01020922","Total",623,599,24
"2011","Eastbourne 004D","E01020945","Total",818,802,16
"2011","Eastbourne 004E","E01020950","Total",751,738,13
"2011","Eastbourne 006A","E01020940","Total",613,602,11
"2011","Eastbourne 006B","E01020941","Total",654,646,8
"2011","Eastbourne 006C","E01020942","Total",644,626,18
"2011","Eastbourne 006D","E01020946","Total",755,734,21
"2011","Eastbourne 006E","E01020947","Total",728,722,6
"2011","Eastbourne 007A","E01020914","Total",845,814,31
"2011","Eastbourne 007B","E01020915","Total",880,839,41
"2011","Eastbourne 007C","E01020952","Total",764,741,23
"2011","Eastbourne 007D","E01020953","Total",588,572,16
"2011","Eastbourne 007E","E01020954","Total",629,619,10
"2011","Eastbourne 008A","E01020948","Total",843,758,85
"2011","Eastbourne 008B","E01020963","Total",656,639,17
"2011","Eastbourne 008C","E01020965","Total",1108,1027,81
"2011","Eastbourne 008D","E01020966","Total",900,856,44
"2011","Eastbourne 009A","E01020938","Total",637,627,10
"2011","Eastbourne 009B","E01020939","Total",666,649,17
"2011","Eastbourne 009C","E01020943","Total",781,751,30
"2011","Eastbourne 009D","E01020964","Total",934,887,47
"2011","Eastbourne 009E","E01020967","Total",1054,994,60
"2011","Eastbourne 010A","E01020910","Total",910,829,81
"2011","Eastbourne 010B","E01020911","Total",1053,958,95
"2011","Eastbourne 010C","E01020912","Total",1163,1034,129
"2011","Eastbourne 010D","E01020916","Total",797,769,28
"2011","Eastbourne 011A","E01020935","Total",1190,1075,115
"2011","Eastbourne 011B","E01020936","Total",1215,1025,190
"2011","Eastbourne 011C","E01020937","Total",850,747,103
"2011","Eastbourne 011D","E01020968","Total",985,911,74
"2011","Eastbourne 012A","E01020931","Total",938,829,109
"2011","Eastbourne 012B","E01020932","Total",938,843,95
"2011","Eastbourne 012C","E01020933","Total",478,434,44
"2011","Eastbourne 012D","E01020934","Total",791,685,106
"2011","Eastbourne 012E","E01020944","Total",621,610,11
"2011","Eastbourne 013A","E01020913","Total",1065,972,93
"2011","Eastbourne 013B","E01020951","Total",668,647,21
"2011","Eastbourne 013C","E01020959","Total",624,609,15
"2011","Eastbourne 013D","E01020961","Total",673,652,21
"2011","Eastbourne 013E","E01020962","Total",1057,976,81
"2011","Eastbourne 014A","E01020960","Total",1328,1172,156
"2011","Eastbourne 014B","E01032831","Total",779,701,78
"2011","Eastbourne 014C","E01032832","Total",745,672,73
"2011","Eastbourne 014D","E01032833","Total",861,679,182
"2011","Hastings 001A","E01020969","Total",669,656,13
"2011","Hastings 001B","E01020970","Total",1051,1003,48
"2011","Hastings 001C","E01020971","Total",863,841,22
"2011","Hastings 001D","E01020987","Total",770,753,17
"2011","Hastings 002A","E01020974","Total",626,605,21
"2011","Hastings 002B","E01020986","Total",608,590,18
"2011","Hastings 002C","E01020988","Total",756,744,12
"2011","Hastings 002D","E01021007","Total",678,667,11
"2011","Hastings 002E","E01021008","Total",807,792,15
"2011","Hastings 002F","E01021009","Total",831,808,23
"2011","Hastings 003A","E01020993","Total",604,593,11
"2011","Hastings 003B","E01020994","Total",593,581,12
"2011","Hastings 003C","E01020995","Total",594,585,9
"2011","Hastings 003D","E01020996","Total",643,637,6
"2011","Hastings 003E","E01021019","Total",840,827,13
"2011","Hastings 004A","E01021004","Total",791,773,18
"2011","Hastings 004B","E01021005","Total",667,661,6
"2011","Hastings 004C","E01021006","Total",879,847,32
"2011","Hastings 004D","E01021013","Total",735,726,9
"2011","Hastings 005A","E01020972","Total",679,661,18
"2011","Hastings 005B","E01020973","Total",723,716,7
"2011","Hastings 005C","E01020977","Total",791,742,49
"2011","Hastings 005D","E01021015","Total",705,682,23
"2011","Hastings 006A","E01021010","Total",654,636,18
"2011","Hastings 006B","E01021011","Total",666,650,16
"2011","Hastings 006C","E01021012","Total",813,774,39
"2011","Hastings 006D","E01021020","Total",745,734,11
"2011","Hastings 006E","E01021021","Total",858,844,14
"2011","Hastings 007A","E01021000","Total",664,645,19
"2011","Hastings 007B","E01021001","Total",507,497,10
"2011","Hastings 007C","E01021002","Total",675,639,36
"2011","Hastings 007D","E01021003","Total",1057,941,116
"2011","Hastings 007E","E01021014","Total",846,808,38
"2011","Hastings 008A","E01020975","Total",876,838,38
"2011","Hastings 008B","E01020976","Total",919,876,43
"2011","Hastings 008C","E01020990","Total",745,697,48
"2011","Hastings 008D","E01020991","Total",684,660,24
"2011","Hastings 008E","E01020992","Total",970,902,68
"2011","Hastings 009A","E01020978","Total",1199,1113,86
"2011","Hastings 009B","E01020979","Total",1259,1171,88
"2011","Hastings 009C","E01020980","Total",859,811,48
"2011","Hastings 009D","E01020981","Total",744,698,46
"2011","Hastings 010A","E01020997","Total",660,642,18
"2011","Hastings 010B","E01020998","Total",1024,939,85
"2011","Hastings 010C","E01020999","Total",751,736,15
"2011","Hastings 010D","E01021016","Total",778,754,24
"2011","Hastings 010E","E01021017","Total",689,667,22
"2011","Hastings 010F","E01021018","Total",748,742,6
"2011","Hastings 011A","E01020982","Total",1116,1034,82
"2011","Hastings 011B","E01020983","Total",1118,1034,84
"2011","Hastings 011C","E01020984","Total",1299,1173,126
"2011","Hastings 011D","E01020985","Total",1258,1088,170
"2011","Hastings 011E","E01020989","Total",975,926,49
"2011","Lewes 001A","E01021022","Total",878,840,38
"2011","Lewes 001B","E01021024","Total",498,487,11
"2011","Lewes 001C","E01021025","Total",725,681,44
"2011","Lewes 001D","E01021052","Total",522,516,6
"2011","Lewes 001E","E01021053","Total",505,484,21
"2011","Lewes 002A","E01021023","Total",840,758,82
"2011","Lewes 002B","E01021026","Total",1137,994,143
"2011","Lewes 002C","E01021032","Total",879,847,32
"2011","Lewes 002D","E01021067","Total",455,453,2
"2011","Lewes 002E","E01021068","Total",466,439,27
"2011","Lewes 003A","E01021033","Total",830,807,23
"2011","Lewes 003B","E01021034","Total",564,559,5
"2011","Lewes 003C","E01021035","Total",1009,922,87
"2011","Lewes 003D","E01021036","Total",643,631,12
"2011","Lewes 003E","E01021037","Total",629,625,4
"2011","Lewes 003F","E01021038","Total",856,819,37
"2011","Lewes 004A","E01021054","Total",607,598,9
"2011","Lewes 004B","E01021055","Total",783,766,17
"2011","Lewes 004C","E01021056","Total",736,723,13
"2011","Lewes 004D","E01021057","Total",703,682,21
"2011","Lewes 005A","E01021039","Total",699,654,45
"2011","Lewes 005B","E01021040","Total",701,675,26
"2011","Lewes 005C","E01021041","Total",656,646,10
"2011","Lewes 005D","E01021042","Total",507,499,8
"2011","Lewes 005E","E01021043","Total",636,620,16
"2011","Lewes 006A","E01021027","Total",676,655,21
"2011","Lewes 006B","E01021028","Total",621,615,6
"2011","Lewes 006C","E01021029","Total",621,610,11
"2011","Lewes 006D","E01021030","Total",611,570,41
"2011","Lewes 006E","E01021031","Total",747,711,36
"2011","Lewes 007A","E01021061","Total",606,593,13
"2011","Lewes 007B","E01021063","Total",716,698,18
"2011","Lewes 007C","E01021064","Total",848,821,27
"2011","Lewes 007D","E01021065","Total",679,657,22
"2011","Lewes 007E","E01021066","Total",661,652,9
"2011","Lewes 008A","E01021045","Total",904,849,55
"2011","Lewes 008B","E01021046","Total",608,595,13
"2011","Lewes 008C","E01021047","Total",620,610,10
"2011","Lewes 008D","E01021048","Total",771,730,41
"2011","Lewes 009A","E01021044","Total",736,716,20
"2011","Lewes 009B","E01021049","Total",722,686,36
"2011","Lewes 009C","E01021050","Total",547,542,5
"2011","Lewes 009D","E01021051","Total",528,524,4
"2011","Lewes 010A","E01021058","Total",817,795,22
"2011","Lewes 010B","E01021059","Total",738,711,27
"2011","Lewes 010C","E01021060","Total",738,712,26
"2011","Lewes 010D","E01021062","Total",618,610,8
"2011","Lewes 011A","E01021069","Total",691,669,22
"2011","Lewes 011B","E01021075","Total",763,748,15
"2011","Lewes 011C","E01021077","Total",680,656,24
"2011","Lewes 011D","E01021081","Total",781,747,34
"2011","Lewes 011E","E01021082","Total",829,788,41
"2011","Lewes 011F","E01021083","Total",577,572,5
"2011","Lewes 012A","E01021072","Total",753,725,28
"2011","Lewes 012B","E01021073","Total",645,634,11
"2011","Lewes 012C","E01021074","Total",788,772,16
"2011","Lewes 012D","E01021076","Total",804,790,14
"2011","Lewes 012E","E01021078","Total",572,552,20
"2011","Lewes 013A","E01021070","Total",842,795,47
"2011","Lewes 013B","E01021071","Total",1118,982,136
"2011","Lewes 013C","E01021079","Total",817,759,58
"2011","Lewes 013D","E01021080","Total",633,605,28
"2011","Rother 001A","E01021132","Total",520,495,25
"2011","Rother 001B","E01021133","Total",737,707,30
"2011","Rother 001C","E01021134","Total",628,599,29
"2011","Rother 001D","E01021139","Total",588,561,27
"2011","Rother 001E","E01021140","Total",736,693,43
"2011","Rother 001F","E01021141","Total",622,584,38
"2011","Rother 002A","E01021103","Total",851,673,178
"2011","Rother 002B","E01021114","Total",735,692,43
"2011","Rother 002C","E01021115","Total",800,728,72
"2011","Rother 002D","E01021116","Total",747,670,77
"2011","Rother 003A","E01021098","Total",749,722,27
"2011","Rother 003B","E01021099","Total",743,679,64
"2011","Rother 003C","E01021100","Total",698,658,40
"2011","Rother 003D","E01021104","Total",626,588,38
"2011","Rother 003E","E01021105","Total",573,548,25
"2011","Rother 004A","E01021101","Total",940,833,107
"2011","Rother 004B","E01021102","Total",996,761,235
"2011","Rother 004C","E01021117","Total",951,783,168
"2011","Rother 004D","E01021118","Total",886,753,133
"2011","Rother 004E","E01021119","Total",524,512,12
"2011","Rother 005A","E01021087","Total",771,695,76
"2011","Rother 005B","E01021088","Total",707,673,34
"2011","Rother 005C","E01021089","Total",674,646,28
"2011","Rother 005D","E01021109","Total",741,697,44
"2011","Rother 005E","E01021110","Total",1245,1104,141
"2011","Rother 006A","E01021084","Total",991,929,62
"2011","Rother 006B","E01021085","Total",723,698,25
"2011","Rother 006C","E01021086","Total",734,714,20
"2011","Rother 006D","E01021096","Total",532,492,40
"2011","Rother 006E","E01021097","Total",552,529,23
"2011","Rother 007A","E01021111","Total",535,520,15
"2011","Rother 007B","E01021113","Total",626,603,23
"2011","Rother 007C","E01021131","Total",639,633,6
"2011","Rother 007D","E01021135","Total",752,735,17
"2011","Rother 007E","E01021136","Total",591,575,16
"2011","Rother 007F","E01021137","Total",632,613,19
"2011","Rother 008A","E01021112","Total",662,642,20
"2011","Rother 008B","E01021120","Total",838,749,89
"2011","Rother 008C","E01021126","Total",676,649,27
"2011","Rother 008D","E01021127","Total",705,686,19
"2011","Rother 008E","E01021128","Total",873,846,27
"2011","Rother 009A","E01021093","Total",713,687,26
"2011","Rother 009B","E01021095","Total",664,631,33
"2011","Rother 009C","E01021123","Total",734,714,20
"2011","Rother 009D","E01021124","Total",862,828,34
"2011","Rother 009E","E01021125","Total",620,555,65
"2011","Rother 009F","E01021129","Total",825,806,19
"2011","Rother 009G","E01021138","Total",484,476,8
"2011","Rother 010A","E01021094","Total",929,842,87
"2011","Rother 010B","E01021106","Total",960,893,67
"2011","Rother 010C","E01021107","Total",760,744,16
"2011","Rother 010D","E01021108","Total",661,638,23
"2011","Rother 010E","E01021130","Total",703,684,19
"2011","Rother 011A","E01021090","Total",913,802,111
"2011","Rother 011B","E01021091","Total",1285,1086,199
"2011","Rother 011C","E01021092","Total",1216,1146,70
"2011","Rother 011D","E01021121","Total",870,818,52
"2011","Rother 011E","E01021122","Total",1021,860,161
"2011","Wealden 001A","E01021167","Total",977,945,32
"2011","Wealden 001B","E01021168","Total",706,675,31
"2011","Wealden 001C","E01021169","Total",516,495,21
"2011","Wealden 001D","E01021186","Total",529,508,21
"2011","Wealden 002A","E01021171","Total",844,812,32
"2011","Wealden 002B","E01021172","Total",751,732,19
"2011","Wealden 002C","E01021173","Total",583,548,35
"2011","Wealden 002D","E01021218","Total",500,478,22
"2011","Wealden 003A","E01021156","Total",793,758,35
"2011","Wealden 003B","E01021157","Total",749,742,7
"2011","Wealden 003C","E01021158","Total",856,842,14
"2011","Wealden 004A","E01021159","Total",960,942,18
"2011","Wealden 004B","E01021160","Total",772,739,33
"2011","Wealden 004C","E01021161","Total",681,667,14
"2011","Wealden 004D","E01021162","Total",652,640,12
"2011","Wealden 005A","E01021202","Total",558,521,37
"2011","Wealden 005B","E01021203","Total",651,618,33
"2011","Wealden 005C","E01021229","Total",756,695,61
"2011","Wealden 005D","E01021230","Total",717,688,29
"2011","Wealden 005E","E01021231","Total",811,773,38
"2011","Wealden 006A","E01021151","Total",710,679,31
"2011","Wealden 006B","E01021152","Total",514,501,13
"2011","Wealden 006C","E01021153","Total",868,861,7
"2011","Wealden 006D","E01021154","Total",630,606,24
"2011","Wealden 006E","E01021155","Total",493,479,14
"2011","Wealden 007A","E01021163","Total",874,837,37
"2011","Wealden 007B","E01021164","Total",809,770,39
"2011","Wealden 007C","E01021187","Total",634,582,52
"2011","Wealden 008A","E01021144","Total",712,689,23
"2011","Wealden 008B","E01021145","Total",867,817,50
"2011","Wealden 008C","E01021170","Total",1151,1103,48
"2011","Wealden 008D","E01021217","Total",578,544,34
"2011","Wealden 009A","E01021219","Total",555,545,10
"2011","Wealden 009B","E01021220","Total",833,793,40
"2011","Wealden 009C","E01021223","Total",512,494,18
"2011","Wealden 009D","E01021224","Total",666,641,25
"2011","Wealden 009E","E01021225","Total",682,673,9
"2011","Wealden 009F","E01021226","Total",533,522,11
"2011","Wealden 010A","E01021150","Total",448,441,7
"2011","Wealden 010B","E01021191","Total",877,841,36
"2011","Wealden 010C","E01021192","Total",675,659,16
"2011","Wealden 010D","E01021193","Total",771,756,15
"2011","Wealden 010E","E01021194","Total",658,633,25
"2011","Wealden 011A","E01021149","Total",551,529,22
"2011","Wealden 011B","E01021189","Total",551,523,28
"2011","Wealden 011C","E01021190","Total",660,640,20
"2011","Wealden 011D","E01021200","Total",534,510,24
"2011","Wealden 011E","E01021201","Total",622,604,18
"2011","Wealden 012A","E01021221","Total",555,540,15
"2011","Wealden 012B","E01021222","Total",708,685,23
"2011","Wealden 012C","E01021227","Total",625,607,18
"2011","Wealden 012D","E01021228","Total",580,577,3
"2011","Wealden 013A","E01021146","Total",735,701,34
"2011","Wealden 013B","E01021147","Total",687,642,45
"2011","Wealden 013C","E01021148","Total",621,600,21
"2011","Wealden 013D","E01021165","Total",477,455,22
"2011","Wealden 014A","E01021188","Total",505,477,28
"2011","Wealden 014B","E01021198","Total",673,644,29
"2011","Wealden 014C","E01021199","Total",616,581,35
"2011","Wealden 014D","E01021204","Total",518,499,19
"2011","Wealden 014E","E01021205","Total",513,494,19
"2011","Wealden 015A","E01021174","Total",685,659,26
"2011","Wealden 015B","E01021175","Total",640,628,12
"2011","Wealden 015C","E01021176","Total",680,652,28
"2011","Wealden 015D","E01021177","Total",619,581,38
"2011","Wealden 016A","E01021180","Total",544,537,7
"2011","Wealden 016B","E01021181","Total",534,529,5
"2011","Wealden 016C","E01021182","Total",688,677,11
"2011","Wealden 016D","E01021183","Total",557,541,16
"2011","Wealden 017A","E01021178","Total",572,546,26
"2011","Wealden 017B","E01021179","Total",652,637,15
"2011","Wealden 017C","E01021184","Total",665,648,17
"2011","Wealden 017D","E01021185","Total",656,642,14
"2011","Wealden 018A","E01021142","Total",645,609,36
"2011","Wealden 018B","E01021143","Total",603,560,43
"2011","Wealden 018C","E01021166","Total",1136,1050,86
"2011","Wealden 018D","E01021195","Total",831,780,51
"2011","Wealden 018E","E01021196","Total",815,805,10
"2011","Wealden 018F","E01021197","Total",738,723,15
"2011","Wealden 019A","E01021212","Total",939,918,21
"2011","Wealden 019B","E01021213","Total",856,805,51
"2011","Wealden 019C","E01021214","Total",808,774,34
"2011","Wealden 019D","E01021215","Total",672,642,30
"2011","Wealden 019E","E01021216","Total",525,510,15
"2011","Wealden 020A","E01021206","Total",696,667,29
"2011","Wealden 020B","E01021207","Total",768,660,108
"2011","Wealden 020C","E01021208","Total",776,743,33
"2011","Wealden 020D","E01021209","Total",685,668,17
"2011","Wealden 020E","E01021210","Total",588,581,7
"2011","Wealden 020F","E01021211","Total",886,806,80
"2011","Wealden 021A","E01021232","Total",845,816,29
"2011","Wealden 021B","E01021233","Total",652,640,12
"2011","Wealden 021C","E01021234","Total",694,675,19
"2011","Wealden 021D","E01021235","Total",663,647,16
"2011","Wealden 021E","E01021236","Total",744,728,16
"2011","Basingstoke and Deane 001A","E01022553","Total",624,606,18
"2011","Basingstoke and Deane 001B","E01022554","Total",691,678,13
"2011","Basingstoke and Deane 001C","E01022555","Total",645,629,16
"2011","Basingstoke and Deane 001D","E01022556","Total",678,666,12
"2011","Basingstoke and Deane 001E","E01022560","Total",488,481,7
"2011","Basingstoke and Deane 002A","E01022493","Total",540,521,19
"2011","Basingstoke and Deane 002B","E01022536","Total",561,551,10
"2011","Basingstoke and Deane 002C","E01022537","Total",560,550,10
"2011","Basingstoke and Deane 002D","E01022557","Total",643,627,16
"2011","Basingstoke and Deane 002E","E01022558","Total",605,588,17
"2011","Basingstoke and Deane 002F","E01022559","Total",533,524,9
"2011","Basingstoke and Deane 003A","E01022488","Total",469,451,18
"2011","Basingstoke and Deane 003B","E01022489","Total",571,548,23
"2011","Basingstoke and Deane 003C","E01022499","Total",565,557,8
"2011","Basingstoke and Deane 003D","E01022500","Total",562,535,27
"2011","Basingstoke and Deane 003E","E01022513","Total",626,616,10
"2011","Basingstoke and Deane 004A","E01022472","Total",512,500,12
"2011","Basingstoke and Deane 004B","E01022473","Total",526,504,22
"2011","Basingstoke and Deane 004C","E01022520","Total",782,759,23
"2011","Basingstoke and Deane 004D","E01022521","Total",760,741,19
"2011","Basingstoke and Deane 004E","E01022522","Total",639,623,16
"2011","Basingstoke and Deane 005A","E01022490","Total",748,742,6
"2011","Basingstoke and Deane 005B","E01022491","Total",756,746,10
"2011","Basingstoke and Deane 005C","E01022492","Total",689,661,28
"2011","Basingstoke and Deane 005D","E01022546","Total",566,557,9
"2011","Basingstoke and Deane 005E","E01022547","Total",738,724,14
"2011","Basingstoke and Deane 006A","E01022495","Total",667,652,15
"2011","Basingstoke and Deane 006B","E01022496","Total",968,937,31
"2011","Basingstoke and Deane 006C","E01022497","Total",616,610,6
"2011","Basingstoke and Deane 006D","E01022498","Total",663,650,13
"2011","Basingstoke and Deane 007B","E01022539","Total",491,488,3
"2011","Basingstoke and Deane 007C","E01022540","Total",779,749,30
"2011","Basingstoke and Deane 007E","E01022542","Total",458,456,2
"2011","Basingstoke and Deane 007F","E01022543","Total",667,653,14
"2011","Basingstoke and Deane 007H","E01032843","Total",706,695,11
"2011","Basingstoke and Deane 007I","E01032844","Total",709,685,24
"2011","Basingstoke and Deane 007J","E01032851","Total",835,825,10
"2011","Basingstoke and Deane 008A","E01022470","Total",801,791,10
"2011","Basingstoke and Deane 008B","E01022471","Total",628,619,9
"2011","Basingstoke and Deane 008C","E01022494","Total",1045,1024,21
"2011","Basingstoke and Deane 008D","E01022523","Total",818,804,14
"2011","Basingstoke and Deane 009A","E01022524","Total",752,745,7
"2011","Basingstoke and Deane 009B","E01022525","Total",661,651,10
"2011","Basingstoke and Deane 009C","E01022526","Total",672,657,15
"2011","Basingstoke and Deane 009D","E01022527","Total",775,749,26
"2011","Basingstoke and Deane 010B","E01022566","Total",478,473,5
"2011","Basingstoke and Deane 010C","E01022567","Total",516,511,5
"2011","Basingstoke and Deane 010D","E01022568","Total",629,614,15
"2011","Basingstoke and Deane 010E","E01022570","Total",647,637,10
"2011","Basingstoke and Deane 010F","E01032840","Total",721,708,13
"2011","Basingstoke and Deane 010G","E01032841","Total",717,702,15
"2011","Basingstoke and Deane 011B","E01022502","Total",700,690,10
"2011","Basingstoke and Deane 011C","E01022506","Total",605,592,13
"2011","Basingstoke and Deane 011D","E01022507","Total",692,680,12
"2011","Basingstoke and Deane 011E","E01032842","Total",773,679,94
"2011","Basingstoke and Deane 011F","E01032847","Total",705,651,54
"2011","Basingstoke and Deane 012A","E01022481","Total",770,753,17
"2011","Basingstoke and Deane 012B","E01022482","Total",739,712,27
"2011","Basingstoke and Deane 012D","E01022503","Total",664,617,47
"2011","Basingstoke and Deane 012E","E01032845","Total",733,720,13
"2011","Basingstoke and Deane 012F","E01032846","Total",815,742,73
"2011","Basingstoke and Deane 013A","E01022484","Total",516,504,12
"2011","Basingstoke and Deane 013B","E01022485","Total",473,465,8
"2011","Basingstoke and Deane 013C","E01022486","Total",819,801,18
"2011","Basingstoke and Deane 013D","E01022487","Total",491,484,7
"2011","Basingstoke and Deane 013E","E01022569","Total",519,507,12
"2011","Basingstoke and Deane 014A","E01022548","Total",639,631,8
"2011","Basingstoke and Deane 014B","E01022549","Total",801,791,10
"2011","Basingstoke and Deane 014C","E01022550","Total",801,793,8
"2011","Basingstoke and Deane 014D","E01022551","Total",660,650,10
"2011","Basingstoke and Deane 014E","E01022552","Total",611,607,4
"2011","Basingstoke and Deane 015A","E01022528","Total",502,497,5
"2011","Basingstoke and Deane 015B","E01022529","Total",684,660,24
"2011","Basingstoke and Deane 015C","E01022530","Total",534,523,11
"2011","Basingstoke and Deane 015D","E01022531","Total",605,597,8
"2011","Basingstoke and Deane 016A","E01022475","Total",741,719,22
"2011","Basingstoke and Deane 016B","E01022476","Total",699,696,3
"2011","Basingstoke and Deane 016C","E01022480","Total",501,494,7
"2011","Basingstoke and Deane 016D","E01022504","Total",668,643,25
"2011","Basingstoke and Deane 016E","E01022505","Total",639,627,12
"2011","Basingstoke and Deane 017A","E01022467","Total",684,668,16
"2011","Basingstoke and Deane 017B","E01022468","Total",773,749,24
"2011","Basingstoke and Deane 017C","E01022469","Total",671,662,9
"2011","Basingstoke and Deane 017D","E01022561","Total",643,608,35
"2011","Basingstoke and Deane 017E","E01022562","Total",573,545,28
"2011","Basingstoke and Deane 018A","E01022515","Total",671,656,15
"2011","Basingstoke and Deane 018B","E01022516","Total",621,610,11
"2011","Basingstoke and Deane 018C","E01022517","Total",495,489,6
"2011","Basingstoke and Deane 018D","E01022518","Total",753,744,9
"2011","Basingstoke and Deane 018E","E01022519","Total",503,497,6
"2011","Basingstoke and Deane 019A","E01022474","Total",624,614,10
"2011","Basingstoke and Deane 019B","E01022477","Total",641,633,8
"2011","Basingstoke and Deane 019C","E01022478","Total",635,621,14
"2011","Basingstoke and Deane 019D","E01022479","Total",604,599,5
"2011","Basingstoke and Deane 019E","E01022509","Total",580,574,6
"2011","Basingstoke and Deane 020A","E01022514","Total",648,631,17
"2011","Basingstoke and Deane 020B","E01022563","Total",745,731,14
"2011","Basingstoke and Deane 020C","E01022564","Total",809,783,26
"2011","Basingstoke and Deane 020D","E01022565","Total",737,727,10
"2011","Basingstoke and Deane 021B","E01022510","Total",582,577,5
"2011","Basingstoke and Deane 021C","E01022511","Total",449,446,3
"2011","Basingstoke and Deane 021D","E01022512","Total",472,468,4
"2011","Basingstoke and Deane 021E","E01032848","Total",579,573,6
"2011","Basingstoke and Deane 021F","E01032849","Total",573,564,9
"2011","Basingstoke and Deane 021G","E01032850","Total",614,607,7
"2011","Basingstoke and Deane 022A","E01022532","Total",553,537,16
"2011","Basingstoke and Deane 022B","E01022533","Total",708,694,14
"2011","Basingstoke and Deane 022C","E01022534","Total",733,724,9
"2011","Basingstoke and Deane 022D","E01022535","Total",697,689,8
"2011","East Hampshire 001A","E01022581","Total",596,573,23
"2011","East Hampshire 001B","E01022582","Total",602,558,44
"2011","East Hampshire 001C","E01022604","Total",525,485,40
"2011","East Hampshire 001D","E01022605","Total",629,607,22
"2011","East Hampshire 002A","E01022574","Total",649,621,28
"2011","East Hampshire 002B","E01022575","Total",581,573,8
"2011","East Hampshire 002C","E01022576","Total",845,803,42
"2011","East Hampshire 002D","E01022579","Total",515,506,9
"2011","East Hampshire 003A","E01022571","Total",480,475,5
"2011","East Hampshire 003B","E01022572","Total",516,507,9
"2011","East Hampshire 003C","E01022573","Total",1086,1066,20
"2011","East Hampshire 003D","E01022577","Total",760,736,24
"2011","East Hampshire 003E","E01022578","Total",1203,1174,29
"2011","East Hampshire 003F","E01022580","Total",491,484,7
"2011","East Hampshire 004A","E01022603","Total",565,534,31
"2011","East Hampshire 004B","E01022634","Total",517,498,19
"2011","East Hampshire 004C","E01022639","Total",688,567,121
"2011","East Hampshire 004D","E01022640","Total",601,571,30
"2011","East Hampshire 006A","E01022615","Total",1137,1101,36
"2011","East Hampshire 006B","E01022633","Total",624,608,16
"2011","East Hampshire 006C","E01022635","Total",530,514,16
"2011","East Hampshire 006D","E01022636","Total",515,499,16
"2011","East Hampshire 006E","E01022641","Total",534,519,15
"2011","East Hampshire 007A","E01022591","Total",1028,961,67
"2011","East Hampshire 007B","E01022593","Total",496,482,14
"2011","East Hampshire 007C","E01022594","Total",607,587,20
"2011","East Hampshire 007D","E01022595","Total",761,728,33
"2011","East Hampshire 007E","E01022596","Total",568,537,31
"2011","East Hampshire 007F","E01022627","Total",919,880,39
"2011","East Hampshire 008A","E01022630","Total",991,939,52
"2011","East Hampshire 008D","E01022642","Total",436,420,16
"2011","East Hampshire 008E","E01032663","Total",994,966,28
"2011","East Hampshire 009A","E01022583","Total",717,699,18
"2011","East Hampshire 009B","E01022584","Total",844,785,59
"2011","East Hampshire 009C","E01022585","Total",685,653,32
"2011","East Hampshire 009D","E01022586","Total",695,634,61
"2011","East Hampshire 009E","E01022587","Total",803,761,42
"2011","East Hampshire 010A","E01022616","Total",747,735,12
"2011","East Hampshire 010B","E01022617","Total",671,657,14
"2011","East Hampshire 010C","E01022618","Total",696,671,25
"2011","East Hampshire 010D","E01022631","Total",534,514,20
"2011","East Hampshire 010E","E01022632","Total",459,453,6
"2011","East Hampshire 011A","E01022592","Total",984,929,55
"2011","East Hampshire 011B","E01022597","Total",1070,993,77
"2011","East Hampshire 011C","E01022619","Total",526,517,9
"2011","East Hampshire 011D","E01022624","Total",1020,1000,20
"2011","East Hampshire 011E","E01022625","Total",1112,1090,22
"2011","East Hampshire 012A","E01022620","Total",510,489,21
"2011","East Hampshire 012B","E01022621","Total",616,607,9
"2011","East Hampshire 012C","E01022622","Total",582,568,14
"2011","East Hampshire 012D","E01022623","Total",954,940,14
"2011","East Hampshire 012F","E01032664","Total",702,656,46
"2011","East Hampshire 012G","E01032665","Total",683,658,25
"2011","East Hampshire 013A","E01022588","Total",662,647,15
"2011","East Hampshire 013B","E01022589","Total",777,741,36
"2011","East Hampshire 013C","E01022590","Total",599,595,4
"2011","East Hampshire 013D","E01022607","Total",524,515,9
"2011","East Hampshire 013E","E01022608","Total",530,522,8
"2011","East Hampshire 014A","E01022606","Total",974,943,31
"2011","East Hampshire 014B","E01022611","Total",651,634,17
"2011","East Hampshire 014C","E01022613","Total",527,518,9
"2011","East Hampshire 014D","E01022614","Total",484,474,10
"2011","East Hampshire 016A","E01022610","Total",557,536,21
"2011","East Hampshire 016B","E01022628","Total",531,520,11
"2011","East Hampshire 016C","E01022629","Total",630,618,12
"2011","East Hampshire 016D","E01032615","Total",473,466,7
"2011","East Hampshire 016E","E01032616","Total",640,632,8
"2011","East Hampshire 017A","E01022599","Total",637,597,40
"2011","East Hampshire 017B","E01022600","Total",673,640,33
"2011","East Hampshire 017C","E01022601","Total",619,597,22
"2011","East Hampshire 017D","E01022602","Total",543,520,23
"2011","East Hampshire 017E","E01032625","Total",484,455,29
"2011","Eastleigh 001A","E01022705","Total",674,652,22
"2011","Eastleigh 001B","E01022706","Total",654,647,7
"2011","Eastleigh 001C","E01022707","Total",778,761,17
"2011","Eastleigh 001D","E01022708","Total",752,736,16
"2011","Eastleigh 001E","E01022709","Total",708,691,17
"2011","Eastleigh 002A","E01022659","Total",638,630,8
"2011","Eastleigh 002B","E01022660","Total",671,663,8
"2011","Eastleigh 002C","E01022675","Total",576,566,10
"2011","Eastleigh 002D","E01022676","Total",629,608,21
"2011","Eastleigh 002E","E01022704","Total",755,745,10
"2011","Eastleigh 003A","E01022661","Total",819,799,20
"2011","Eastleigh 003B","E01022662","Total",553,543,10
"2011","Eastleigh 003C","E01022663","Total",655,635,20
"2011","Eastleigh 003D","E01022664","Total",662,646,16
"2011","Eastleigh 003E","E01022665","Total",766,748,18
"2011","Eastleigh 004A","E01022648","Total",624,612,12
"2011","Eastleigh 004B","E01022667","Total",626,614,12
"2011","Eastleigh 004C","E01022672","Total",652,623,29
"2011","Eastleigh 004D","E01022673","Total",883,864,19
"2011","Eastleigh 004E","E01022674","Total",727,716,11
"2011","Eastleigh 005A","E01022643","Total",679,667,12
"2011","Eastleigh 005B","E01022644","Total",514,511,3
"2011","Eastleigh 005C","E01022646","Total",661,650,11
"2011","Eastleigh 005D","E01022647","Total",623,618,5
"2011","Eastleigh 005E","E01022649","Total",662,656,6
"2011","Eastleigh 005F","E01022650","Total",475,461,14
"2011","Eastleigh 006A","E01022668","Total",1036,1010,26
"2011","Eastleigh 006B","E01022677","Total",870,849,21
"2011","Eastleigh 006C","E01022678","Total",730,718,12
"2011","Eastleigh 006D","E01022680","Total",803,779,24
"2011","Eastleigh 006E","E01022681","Total",644,640,4
"2011","Eastleigh 007A","E01022666","Total",969,930,39
"2011","Eastleigh 007B","E01022669","Total",765,740,25
"2011","Eastleigh 007C","E01022670","Total",678,671,7
"2011","Eastleigh 007D","E01022671","Total",738,719,19
"2011","Eastleigh 007E","E01022679","Total",755,736,19
"2011","Eastleigh 008A","E01022645","Total",503,494,9
"2011","Eastleigh 008B","E01022682","Total",513,508,5
"2011","Eastleigh 008C","E01022683","Total",557,544,13
"2011","Eastleigh 008D","E01022684","Total",596,592,4
"2011","Eastleigh 008E","E01022685","Total",568,553,15
"2011","Eastleigh 008F","E01022686","Total",622,615,7
"2011","Eastleigh 008G","E01022687","Total",682,671,11
"2011","Eastleigh 009A","E01022713","Total",716,695,21
"2011","Eastleigh 009B","E01022714","Total",730,720,10
"2011","Eastleigh 009C","E01022715","Total",768,747,21
"2011","Eastleigh 009D","E01022716","Total",784,765,19
"2011","Eastleigh 009E","E01022717","Total",533,523,10
"2011","Eastleigh 009F","E01022718","Total",626,605,21
"2011","Eastleigh 009G","E01022719","Total",725,693,32
"2011","Eastleigh 010A","E01022653","Total",629,616,13
"2011","Eastleigh 010B","E01022691","Total",636,627,9
"2011","Eastleigh 010C","E01022692","Total",1142,1110,32
"2011","Eastleigh 010D","E01022693","Total",550,544,6
"2011","Eastleigh 010E","E01022694","Total",682,672,10
"2011","Eastleigh 011A","E01022652","Total",759,746,13
"2011","Eastleigh 011B","E01022695","Total",611,594,17
"2011","Eastleigh 011C","E01022700","Total",693,677,16
"2011","Eastleigh 011D","E01022701","Total",422,416,6
"2011","Eastleigh 011E","E01022703","Total",674,665,9
"2011","Eastleigh 012A","E01022651","Total",811,794,17
"2011","Eastleigh 012B","E01022696","Total",652,644,8
"2011","Eastleigh 012C","E01022697","Total",623,610,13
"2011","Eastleigh 012D","E01022698","Total",672,652,20
"2011","Eastleigh 012E","E01022699","Total",626,620,6
"2011","Eastleigh 012F","E01022702","Total",505,496,9
"2011","Eastleigh 013A","E01022654","Total",583,572,11
"2011","Eastleigh 013B","E01022655","Total",565,558,7
"2011","Eastleigh 013C","E01022656","Total",619,604,15
"2011","Eastleigh 013D","E01022657","Total",768,745,23
"2011","Eastleigh 013E","E01022658","Total",736,721,15
"2011","Eastleigh 014A","E01022710","Total",1005,964,41
"2011","Eastleigh 014B","E01022711","Total",770,749,21
"2011","Eastleigh 014C","E01022712","Total",703,685,18
"2011","Eastleigh 015A","E01022688","Total",1124,1037,87
"2011","Eastleigh 015B","E01022689","Total",686,659,27
"2011","Eastleigh 015C","E01022690","Total",842,821,21
"2011","Fareham 001A","E01022758","Total",610,600,10
"2011","Fareham 001B","E01022771","Total",615,601,14
"2011","Fareham 001C","E01022772","Total",812,793,19
"2011","Fareham 001D","E01022773","Total",673,651,22
"2011","Fareham 001E","E01022774","Total",772,739,33
"2011","Fareham 002A","E01022749","Total",543,536,7
"2011","Fareham 002B","E01022753","Total",500,493,7
"2011","Fareham 002C","E01022754","Total",799,760,39
"2011","Fareham 002D","E01022780","Total",630,614,16
"2011","Fareham 002E","E01022787","Total",565,541,24
"2011","Fareham 002F","E01022788","Total",541,528,13
"2011","Fareham 003A","E01022730","Total",644,631,13
"2011","Fareham 003B","E01022731","Total",520,515,5
"2011","Fareham 003C","E01022732","Total",676,666,10
"2011","Fareham 003D","E01022733","Total",749,735,14
"2011","Fareham 003E","E01022734","Total",524,515,9
"2011","Fareham 004A","E01022720","Total",528,525,3
"2011","Fareham 004B","E01022725","Total",503,496,7
"2011","Fareham 004C","E01022726","Total",614,607,7
"2011","Fareham 004D","E01022727","Total",668,655,13
"2011","Fareham 004E","E01022729","Total",464,455,9
"2011","Fareham 004F","E01022743","Total",820,806,14
"2011","Fareham 005A","E01022750","Total",664,631,33
"2011","Fareham 005B","E01022751","Total",670,652,18
"2011","Fareham 005C","E01022752","Total",551,542,9
"2011","Fareham 005D","E01022757","Total",709,695,14
"2011","Fareham 005E","E01022790","Total",726,712,14
"2011","Fareham 006A","E01022755","Total",620,610,10
"2011","Fareham 006B","E01022756","Total",533,524,9
"2011","Fareham 006C","E01022791","Total",867,838,29
"2011","Fareham 006D","E01022792","Total",646,626,20
"2011","Fareham 006E","E01022793","Total",691,681,10
"2011","Fareham 007A","E01022781","Total",602,564,38
"2011","Fareham 007B","E01022782","Total",680,646,34
"2011","Fareham 007C","E01022785","Total",619,614,5
"2011","Fareham 007D","E01022786","Total",799,653,146
"2011","Fareham 007E","E01022789","Total",652,634,18
"2011","Fareham 008A","E01022721","Total",657,634,23
"2011","Fareham 008B","E01022722","Total",732,703,29
"2011","Fareham 008C","E01022723","Total",772,723,49
"2011","Fareham 008D","E01022724","Total",590,577,13
"2011","Fareham 008E","E01022737","Total",670,652,18
"2011","Fareham 008F","E01022766","Total",539,529,10
"2011","Fareham 008G","E01022769","Total",568,552,16
"2011","Fareham 009A","E01022740","Total",739,727,12
"2011","Fareham 009B","E01022741","Total",562,466,96
"2011","Fareham 009C","E01022742","Total",884,872,12
"2011","Fareham 009D","E01022783","Total",648,641,7
"2011","Fareham 009E","E01022784","Total",504,500,4
"2011","Fareham 010A","E01022759","Total",677,660,17
"2011","Fareham 010B","E01022763","Total",701,686,15
"2011","Fareham 010C","E01022765","Total",782,760,22
"2011","Fareham 010D","E01022768","Total",606,599,7
"2011","Fareham 010E","E01022770","Total",704,693,11
"2011","Fareham 011A","E01022728","Total",874,841,33
"2011","Fareham 011B","E01022735","Total",634,619,15
"2011","Fareham 011C","E01022736","Total",678,662,16
"2011","Fareham 011D","E01022738","Total",492,483,9
"2011","Fareham 011E","E01022739","Total",696,673,23
"2011","Fareham 012A","E01022760","Total",652,644,8
"2011","Fareham 012B","E01022761","Total",674,657,17
"2011","Fareham 012C","E01022762","Total",646,639,7
"2011","Fareham 012D","E01022764","Total",785,761,24
"2011","Fareham 012E","E01022767","Total",518,511,7
"2011","Fareham 013B","E01022776","Total",636,627,9
"2011","Fareham 013C","E01022777","Total",792,769,23
"2011","Fareham 013D","E01022778","Total",602,598,4
"2011","Fareham 013F","E01032877","Total",940,919,21
"2011","Fareham 014A","E01022744","Total",577,567,10
"2011","Fareham 014B","E01022745","Total",663,633,30
"2011","Fareham 014C","E01022746","Total",721,703,18
"2011","Fareham 014D","E01022747","Total",600,586,14
"2011","Fareham 014E","E01022748","Total",636,629,7
"2011","Gosport 001A","E01022800","Total",658,645,13
"2011","Gosport 001B","E01022801","Total",655,644,11
"2011","Gosport 001C","E01022802","Total",611,607,4
"2011","Gosport 001D","E01022803","Total",691,626,65
"2011","Gosport 001E","E01022836","Total",648,639,9
"2011","Gosport 002A","E01022804","Total",688,680,8
"2011","Gosport 002B","E01022805","Total",660,646,14
"2011","Gosport 002C","E01022834","Total",622,614,8
"2011","Gosport 002D","E01022835","Total",636,627,9
"2011","Gosport 002E","E01022840","Total",667,664,3
"2011","Gosport 003A","E01022813","Total",555,546,9
"2011","Gosport 003B","E01022814","Total",776,762,14
"2011","Gosport 003C","E01022815","Total",630,619,11
"2011","Gosport 003D","E01022823","Total",653,644,9
"2011","Gosport 003E","E01022825","Total",601,591,10
"2011","Gosport 004A","E01022819","Total",691,671,20
"2011","Gosport 004B","E01022820","Total",644,610,34
"2011","Gosport 004E","E01022841","Total",626,608,18
"2011","Gosport 004F","E01022842","Total",657,607,50
"2011","Gosport 004G","E01032882","Total",763,755,8
"2011","Gosport 005A","E01022807","Total",780,760,20
"2011","Gosport 005B","E01022816","Total",625,615,10
"2011","Gosport 005C","E01022817","Total",728,709,19
"2011","Gosport 005D","E01022818","Total",613,606,7
"2011","Gosport 005E","E01022824","Total",1298,1210,88
"2011","Gosport 006A","E01022826","Total",686,675,11
"2011","Gosport 006C","E01022828","Total",831,764,67
"2011","Gosport 006D","E01022829","Total",840,805,35
"2011","Gosport 006E","E01022830","Total",667,639,28
"2011","Gosport 006F","E01032880","Total",509,506,3
"2011","Gosport 006G","E01032881","Total",603,595,8
"2011","Gosport 006H","E01032883","Total",648,632,16
"2011","Gosport 007A","E01022806","Total",607,602,5
"2011","Gosport 007D","E01022832","Total",712,697,15
"2011","Gosport 007E","E01022839","Total",658,639,19
"2011","Gosport 007F","E01032884","Total",1020,976,44
"2011","Gosport 008A","E01022810","Total",789,731,58
"2011","Gosport 008B","E01022811","Total",1255,1093,162
"2011","Gosport 008C","E01022833","Total",890,867,23
"2011","Gosport 008D","E01022843","Total",720,703,17
"2011","Gosport 008F","E01032878","Total",644,607,37
"2011","Gosport 008G","E01032879","Total",832,766,66
"2011","Gosport 009A","E01022794","Total",655,626,29
"2011","Gosport 009B","E01022795","Total",783,740,43
"2011","Gosport 009C","E01022796","Total",508,496,12
"2011","Gosport 009D","E01022837","Total",692,676,16
"2011","Gosport 009E","E01022838","Total",531,520,11
"2011","Gosport 010A","E01022797","Total",460,451,9
"2011","Gosport 010B","E01022798","Total",507,497,10
"2011","Gosport 010C","E01022799","Total",608,582,26
"2011","Gosport 010D","E01022812","Total",541,529,12
"2011","Gosport 010E","E01022831","Total",648,636,12
"2011","Gosport 010F","E01022845","Total",692,675,17
"2011","Hart 001A","E01022890","Total",628,612,16
"2011","Hart 001B","E01022891","Total",658,650,8
"2011","Hart 001C","E01022892","Total",793,782,11
"2011","Hart 001D","E01022893","Total",640,627,13
"2011","Hart 001E","E01022894","Total",624,622,2
"2011","Hart 002A","E01022859","Total",650,622,28
"2011","Hart 002B","E01022895","Total",744,738,6
"2011","Hart 002C","E01022896","Total",601,594,7
"2011","Hart 002D","E01022897","Total",636,627,9
"2011","Hart 002E","E01022898","Total",587,581,6
"2011","Hart 003A","E01022846","Total",467,456,11
"2011","Hart 003B","E01022847","Total",764,746,18
"2011","Hart 003C","E01022848","Total",636,631,5
"2011","Hart 003D","E01022874","Total",497,491,6
"2011","Hart 003E","E01022875","Total",488,485,3
"2011","Hart 003F","E01022876","Total",507,499,8
"2011","Hart 003G","E01022877","Total",556,543,13
"2011","Hart 004A","E01022858","Total",436,410,26
"2011","Hart 004B","E01022878","Total",724,705,19
"2011","Hart 004C","E01022879","Total",859,806,53
"2011","Hart 004D","E01022880","Total",641,628,13
"2011","Hart 005A","E01022860","Total",911,889,22
"2011","Hart 005B","E01022862","Total",1000,945,55
"2011","Hart 005D","E01022867","Total",656,645,11
"2011","Hart 005E","E01032852","Total",626,619,7
"2011","Hart 005F","E01032853","Total",629,616,13
"2011","Hart 005G","E01032854","Total",616,604,12
"2011","Hart 005H","E01032857","Total",420,410,10
"2011","Hart 006A","E01022881","Total",945,915,30
"2011","Hart 006B","E01022882","Total",584,565,19
"2011","Hart 006C","E01022883","Total",539,524,15
"2011","Hart 006D","E01022884","Total",698,666,32
"2011","Hart 006E","E01022885","Total",558,544,14
"2011","Hart 007A","E01022861","Total",654,643,11
"2011","Hart 007B","E01022863","Total",639,631,8
"2011","Hart 007C","E01022865","Total",637,628,9
"2011","Hart 007D","E01022868","Total",681,674,7
"2011","Hart 007E","E01022870","Total",595,584,11
"2011","Hart 008A","E01022864","Total",652,636,16
"2011","Hart 008B","E01022871","Total",582,562,20
"2011","Hart 008C","E01022872","Total",730,714,16
"2011","Hart 008D","E01022873","Total",666,638,28
"2011","Hart 008E","E01022887","Total",591,550,41
"2011","Hart 009A","E01022849","Total",654,646,8
"2011","Hart 009B","E01022850","Total",645,631,14
"2011","Hart 009C","E01022851","Total",666,662,4
"2011","Hart 009D","E01022853","Total",714,693,21
"2011","Hart 009E","E01022869","Total",622,607,15
"2011","Hart 010A","E01022852","Total",779,754,25
"2011","Hart 010B","E01022854","Total",656,648,8
"2011","Hart 010C","E01022855","Total",513,504,9
"2011","Hart 010D","E01022856","Total",616,591,25
"2011","Hart 010E","E01022857","Total",506,444,62
"2011","Hart 011B","E01022888","Total",781,739,42
"2011","Hart 011C","E01022889","Total",679,638,41
"2011","Hart 011D","E01032855","Total",462,440,22
"2011","Hart 011E","E01032856","Total",489,456,33
"2011","Havant 003A","E01022930","Total",763,753,10
"2011","Havant 003B","E01022931","Total",647,641,6
"2011","Havant 003C","E01022935","Total",671,650,21
"2011","Havant 003D","E01022975","Total",702,688,14
"2011","Havant 003E","E01022976","Total",695,689,6
"2011","Havant 004A","E01022922","Total",680,675,5
"2011","Havant 004B","E01022971","Total",746,722,24
"2011","Havant 004C","E01022972","Total",657,646,11
"2011","Havant 004D","E01022974","Total",608,597,11
"2011","Havant 005A","E01022959","Total",564,556,8
"2011","Havant 005B","E01022962","Total",618,608,10
"2011","Havant 005C","E01022965","Total",611,601,10
"2011","Havant 005D","E01022973","Total",904,867,37
"2011","Havant 006A","E01022901","Total",663,643,20
"2011","Havant 006B","E01022902","Total",582,575,7
"2011","Havant 006C","E01022966","Total",524,516,8
"2011","Havant 006D","E01022967","Total",523,513,10
"2011","Havant 007A","E01022960","Total",513,508,5
"2011","Havant 007B","E01022961","Total",497,492,5
"2011","Havant 007C","E01022963","Total",633,621,12
"2011","Havant 007D","E01022964","Total",662,653,9
"2011","Havant 008A","E01022903","Total",784,776,8
"2011","Havant 008B","E01022906","Total",576,570,6
"2011","Havant 008C","E01022968","Total",533,525,8
"2011","Havant 008D","E01022969","Total",616,607,9
"2011","Havant 009A","E01022913","Total",553,549,4
"2011","Havant 009B","E01022914","Total",549,543,6
"2011","Havant 009C","E01022915","Total",637,621,16
"2011","Havant 009D","E01022916","Total",649,639,10
"2011","Havant 009E","E01022917","Total",529,528,1
"2011","Havant 010A","E01022900","Total",761,747,14
"2011","Havant 010B","E01022904","Total",772,766,6
"2011","Havant 010C","E01022905","Total",852,823,29
"2011","Havant 010D","E01022908","Total",599,593,6
"2011","Havant 010E","E01022970","Total",700,692,8
"2011","Havant 011A","E01022947","Total",646,633,13
"2011","Havant 011B","E01022948","Total",703,687,16
"2011","Havant 011C","E01022949","Total",768,757,11
"2011","Havant 011D","E01022950","Total",601,584,17
"2011","Havant 011E","E01022951","Total",576,562,14
"2011","Havant 011F","E01022952","Total",647,629,18
"2011","Havant 013A","E01022924","Total",737,719,18
"2011","Havant 013B","E01022925","Total",602,594,8
"2011","Havant 013C","E01022926","Total",641,625,16
"2011","Havant 013D","E01022927","Total",732,719,13
"2011","Havant 013E","E01022928","Total",848,815,33
"2011","Havant 013F","E01022929","Total",940,857,83
"2011","Havant 014A","E01022953","Total",1126,1030,96
"2011","Havant 014B","E01022954","Total",724,693,31
"2011","Havant 014C","E01022955","Total",635,615,20
"2011","Havant 014D","E01022956","Total",498,496,2
"2011","Havant 014E","E01022957","Total",531,522,9
"2011","Havant 014F","E01022958","Total",628,613,15
"2011","Havant 015A","E01022937","Total",598,585,13
"2011","Havant 015B","E01022943","Total",734,650,84
"2011","Havant 015C","E01022944","Total",548,536,12
"2011","Havant 015D","E01022946","Total",796,775,21
"2011","Havant 016A","E01022940","Total",770,729,41
"2011","Havant 016B","E01022942","Total",880,830,50
"2011","Havant 016C","E01022945","Total",1095,1049,46
"2011","Havant 017A","E01022936","Total",876,776,100
"2011","Havant 017B","E01022938","Total",669,638,31
"2011","Havant 017C","E01022939","Total",745,697,48
"2011","Havant 017D","E01022941","Total",772,694,78
"2011","Havant 018A","E01022899","Total",509,503,6
"2011","Havant 018B","E01022907","Total",650,632,18
"2011","Havant 018C","E01022909","Total",644,628,16
"2011","Havant 018D","E01022910","Total",678,654,24
"2011","Havant 018E","E01022911","Total",650,638,12
"2011","Havant 018F","E01032605","Total",549,547,2
"2011","Havant 019A","E01022919","Total",654,644,10
"2011","Havant 019B","E01022933","Total",725,711,14
"2011","Havant 019C","E01022934","Total",805,798,7
"2011","Havant 019D","E01032618","Total",627,618,9
"2011","Havant 020A","E01022918","Total",679,667,12
"2011","Havant 020B","E01022920","Total",674,657,17
"2011","Havant 020C","E01022921","Total",657,651,6
"2011","Havant 020D","E01032617","Total",674,661,13
"2011","New Forest 001A","E01023011","Total",650,614,36
"2011","New Forest 001B","E01023012","Total",625,593,32
"2011","New Forest 001C","E01023021","Total",640,625,15
"2011","New Forest 001D","E01023022","Total",953,888,65
"2011","New Forest 001E","E01023023","Total",785,754,31
"2011","New Forest 001F","E01023024","Total",649,629,20
"2011","New Forest 001G","E01023025","Total",641,588,53
"2011","New Forest 002A","E01023076","Total",644,637,7
"2011","New Forest 002B","E01023082","Total",624,617,7
"2011","New Forest 002C","E01023083","Total",663,660,3
"2011","New Forest 002D","E01023088","Total",641,636,5
"2011","New Forest 003A","E01023073","Total",519,518,1
"2011","New Forest 003B","E01023080","Total",531,526,5
"2011","New Forest 003C","E01023081","Total",757,749,8
"2011","New Forest 003D","E01023089","Total",731,716,15
"2011","New Forest 003E","E01023090","Total",838,823,15
"2011","New Forest 004A","E01023074","Total",669,649,20
"2011","New Forest 004B","E01023077","Total",748,712,36
"2011","New Forest 004C","E01023078","Total",641,633,8
"2011","New Forest 004D","E01023079","Total",706,693,13
"2011","New Forest 004E","E01023085","Total",653,635,18
"2011","New Forest 005A","E01023072","Total",558,547,11
"2011","New Forest 005B","E01023075","Total",489,486,3
"2011","New Forest 005C","E01023084","Total",636,627,9
"2011","New Forest 005D","E01023086","Total",649,640,9
"2011","New Forest 005E","E01023087","Total",631,624,7
"2011","New Forest 006A","E01022977","Total",622,609,13
"2011","New Forest 006B","E01022978","Total",653,633,20
"2011","New Forest 006C","E01022979","Total",504,498,6
"2011","New Forest 006D","E01022980","Total",559,549,10
"2011","New Forest 007A","E01022992","Total",496,484,12
"2011","New Forest 007B","E01022993","Total",608,564,44
"2011","New Forest 007C","E01023045","Total",780,716,64
"2011","New Forest 007D","E01023046","Total",729,658,71
"2011","New Forest 008A","E01023007","Total",527,507,20
"2011","New Forest 008B","E01023010","Total",665,655,10
"2011","New Forest 008C","E01023047","Total",557,546,11
"2011","New Forest 008D","E01023048","Total",532,525,7
"2011","New Forest 008E","E01023049","Total",700,682,18
"2011","New Forest 008F","E01023050","Total",708,693,15
"2011","New Forest 009A","E01023008","Total",951,859,92
"2011","New Forest 009B","E01023009","Total",658,648,10
"2011","New Forest 009C","E01023038","Total",639,634,5
"2011","New Forest 009D","E01023039","Total",680,666,14
"2011","New Forest 009E","E01023040","Total",682,673,9
"2011","New Forest 010A","E01023026","Total",514,476,38
"2011","New Forest 010B","E01023062","Total",585,564,21
"2011","New Forest 010C","E01023064","Total",547,536,11
"2011","New Forest 010D","E01023066","Total",711,695,16
"2011","New Forest 010E","E01023067","Total",628,616,12
"2011","New Forest 011A","E01023003","Total",789,779,10
"2011","New Forest 011B","E01023004","Total",722,709,13
"2011","New Forest 011C","E01023005","Total",633,627,6
"2011","New Forest 011D","E01023006","Total",505,501,4
"2011","New Forest 011E","E01023028","Total",874,859,15
"2011","New Forest 011F","E01023037","Total",965,931,34
"2011","New Forest 012A","E01023065","Total",689,680,9
"2011","New Forest 012B","E01023068","Total",537,525,12
"2011","New Forest 012C","E01023069","Total",679,669,10
"2011","New Forest 012D","E01023070","Total",985,925,60
"2011","New Forest 012E","E01023071","Total",670,646,24
"2011","New Forest 013A","E01023029","Total",636,621,15
"2011","New Forest 013B","E01023030","Total",515,507,8
"2011","New Forest 013C","E01023032","Total",559,549,10
"2011","New Forest 013D","E01023033","Total",527,524,3
"2011","New Forest 014A","E01023013","Total",662,650,12
"2011","New Forest 014B","E01023014","Total",744,720,24
"2011","New Forest 014C","E01023015","Total",616,599,17
"2011","New Forest 014D","E01023016","Total",630,614,16
"2011","New Forest 014E","E01023027","Total",600,592,8
"2011","New Forest 014F","E01023031","Total",555,548,7
"2011","New Forest 015A","E01022989","Total",747,719,28
"2011","New Forest 015B","E01022991","Total",964,891,73
"2011","New Forest 015C","E01022998","Total",735,680,55
"2011","New Forest 015D","E01023000","Total",860,791,69
"2011","New Forest 016A","E01022994","Total",683,670,13
"2011","New Forest 016B","E01022995","Total",605,589,16
"2011","New Forest 016C","E01022996","Total",542,515,27
"2011","New Forest 016D","E01022997","Total",672,585,87
"2011","New Forest 016E","E01023063","Total",477,466,11
"2011","New Forest 017A","E01022990","Total",708,651,57
"2011","New Forest 017B","E01022999","Total",1058,906,152
"2011","New Forest 017C","E01023041","Total",838,743,95
"2011","New Forest 017D","E01023042","Total",1070,893,177
"2011","New Forest 017E","E01023043","Total",922,835,87
"2011","New Forest 018A","E01022984","Total",686,654,32
"2011","New Forest 018B","E01022985","Total",540,528,12
"2011","New Forest 018C","E01023020","Total",648,624,24
"2011","New Forest 018D","E01023034","Total",820,785,35
"2011","New Forest 018E","E01023035","Total",759,732,27
"2011","New Forest 018F","E01023036","Total",974,936,38
"2011","New Forest 019A","E01023001","Total",894,861,33
"2011","New Forest 019B","E01023002","Total",798,777,21
"2011","New Forest 019C","E01023058","Total",660,645,15
"2011","New Forest 019D","E01023060","Total",622,590,32
"2011","New Forest 019E","E01023061","Total",684,667,17
"2011","New Forest 020A","E01023017","Total",834,810,24
"2011","New Forest 020B","E01023018","Total",707,679,28
"2011","New Forest 020C","E01023019","Total",680,668,12
"2011","New Forest 020D","E01023055","Total",517,511,6
"2011","New Forest 021A","E01022986","Total",655,642,13
"2011","New Forest 021B","E01022988","Total",699,676,23
"2011","New Forest 021C","E01023054","Total",882,849,33
"2011","New Forest 021D","E01023056","Total",855,811,44
"2011","New Forest 021E","E01023057","Total",963,903,60
"2011","New Forest 022A","E01022981","Total",942,909,33
"2011","New Forest 022B","E01022982","Total",1037,935,102
"2011","New Forest 022C","E01022983","Total",862,808,54
"2011","New Forest 022D","E01022987","Total",970,909,61
"2011","New Forest 023A","E01023044","Total",564,535,29
"2011","New Forest 023B","E01023051","Total",726,658,68
"2011","New Forest 023C","E01023052","Total",1020,890,130
"2011","New Forest 023D","E01023053","Total",1034,859,175
"2011","New Forest 023E","E01023059","Total",821,774,47
"2011","Rushmoor 001A","E01023099","Total",627,609,18
"2011","Rushmoor 001B","E01023104","Total",604,601,3
"2011","Rushmoor 001C","E01023106","Total",580,567,13
"2011","Rushmoor 001D","E01023121","Total",781,770,11
"2011","Rushmoor 002A","E01023105","Total",610,602,8
"2011","Rushmoor 002B","E01023119","Total",476,466,10
"2011","Rushmoor 002C","E01023120","Total",623,608,15
"2011","Rushmoor 002D","E01023122","Total",510,500,10
"2011","Rushmoor 002E","E01023146","Total",477,472,5
"2011","Rushmoor 003A","E01023100","Total",490,484,6
"2011","Rushmoor 003B","E01023101","Total",497,487,10
"2011","Rushmoor 003C","E01023102","Total",554,541,13
"2011","Rushmoor 003D","E01023134","Total",710,703,7
"2011","Rushmoor 003E","E01023147","Total",572,565,7
"2011","Rushmoor 004A","E01023096","Total",952,910,42
"2011","Rushmoor 004B","E01023097","Total",587,570,17
"2011","Rushmoor 004C","E01023103","Total",654,631,23
"2011","Rushmoor 004D","E01023111","Total",774,756,18
"2011","Rushmoor 004E","E01023112","Total",478,467,11
"2011","Rushmoor 005A","E01023092","Total",573,569,4
"2011","Rushmoor 005B","E01023093","Total",529,524,5
"2011","Rushmoor 005C","E01023132","Total",625,614,11
"2011","Rushmoor 005D","E01023133","Total",536,525,11
"2011","Rushmoor 005E","E01023135","Total",965,945,20
"2011","Rushmoor 006A","E01023091","Total",706,670,36
"2011","Rushmoor 006B","E01023094","Total",580,558,22
"2011","Rushmoor 006C","E01023095","Total",773,743,30
"2011","Rushmoor 006D","E01023098","Total",706,669,37
"2011","Rushmoor 006E","E01023148","Total",608,602,6
"2011","Rushmoor 006F","E01023149","Total",557,543,14
"2011","Rushmoor 007A","E01023113","Total",699,668,31
"2011","Rushmoor 007B","E01023114","Total",551,547,4
"2011","Rushmoor 007C","E01023136","Total",734,657,77
"2011","Rushmoor 007D","E01023137","Total",541,520,21
"2011","Rushmoor 007E","E01023138","Total",690,654,36
"2011","Rushmoor 007F","E01023139","Total",544,531,13
"2011","Rushmoor 007G","E01023140","Total",656,603,53
"2011","Rushmoor 008A","E01023141","Total",671,630,41
"2011","Rushmoor 008B","E01023142","Total",946,853,93
"2011","Rushmoor 008C","E01023143","Total",735,699,36
"2011","Rushmoor 008D","E01023144","Total",724,674,50
"2011","Rushmoor 009A","E01023118","Total",713,675,38
"2011","Rushmoor 009B","E01023124","Total",506,486,20
"2011","Rushmoor 009C","E01023125","Total",947,920,27
"2011","Rushmoor 009F","E01032858","Total",931,864,67
"2011","Rushmoor 010A","E01023128","Total",632,607,25
"2011","Rushmoor 010B","E01023129","Total",569,531,38
"2011","Rushmoor 010C","E01023130","Total",558,549,9
"2011","Rushmoor 010D","E01023131","Total",599,585,14
"2011","Rushmoor 010E","E01023145","Total",1034,938,96
"2011","Rushmoor 011A","E01023109","Total",610,592,18
"2011","Rushmoor 011B","E01023115","Total",479,464,15
"2011","Rushmoor 011C","E01023116","Total",710,665,45
"2011","Rushmoor 011D","E01023117","Total",686,674,12
"2011","Rushmoor 012A","E01023107","Total",616,611,5
"2011","Rushmoor 012B","E01023108","Total",605,592,13
"2011","Rushmoor 012C","E01023110","Total",723,705,18
"2011","Rushmoor 012D","E01023123","Total",601,579,22
"2011","Test Valley 001A","E01023165","Total",932,867,65
"2011","Test Valley 001B","E01023169","Total",853,839,14
"2011","Test Valley 001C","E01023181","Total",517,513,4
"2011","Test Valley 001D","E01023182","Total",648,642,6
"2011","Test Valley 002A","E01023153","Total",754,742,12
"2011","Test Valley 002B","E01023154","Total",640,636,4
"2011","Test Valley 002C","E01023156","Total",482,470,12
"2011","Test Valley 002D","E01023157","Total",543,534,9
"2011","Test Valley 002E","E01023205","Total",464,455,9
"2011","Test Valley 003A","E01023155","Total",1141,1086,55
"2011","Test Valley 003B","E01023201","Total",640,625,15
"2011","Test Valley 003C","E01023202","Total",1003,971,32
"2011","Test Valley 003D","E01023215","Total",679,669,10
"2011","Test Valley 003E","E01023219","Total",621,617,4
"2011","Test Valley 004A","E01023179","Total",716,706,10
"2011","Test Valley 004B","E01023183","Total",598,583,15
"2011","Test Valley 004C","E01023190","Total",577,561,16
"2011","Test Valley 004D","E01023203","Total",678,668,10
"2011","Test Valley 004E","E01023204","Total",755,741,14
"2011","Test Valley 005B","E01023180","Total",713,701,12
"2011","Test Valley 005C","E01023186","Total",727,721,6
"2011","Test Valley 005D","E01023189","Total",633,609,24
"2011","Test Valley 005E","E01023196","Total",720,692,28
"2011","Test Valley 005F","E01032870","Total",752,732,20
"2011","Test Valley 005G","E01032871","Total",648,637,11
"2011","Test Valley 006A","E01023187","Total",648,632,16
"2011","Test Valley 006B","E01023188","Total",520,515,5
"2011","Test Valley 006C","E01023216","Total",874,847,27
"2011","Test Valley 006D","E01023217","Total",693,670,23
"2011","Test Valley 006E","E01023218","Total",635,627,8
"2011","Test Valley 007A","E01023159","Total",970,931,39
"2011","Test Valley 007B","E01023195","Total",755,722,33
"2011","Test Valley 007C","E01023197","Total",612,584,28
"2011","Test Valley 007D","E01023198","Total",637,619,18
"2011","Test Valley 008A","E01023160","Total",619,600,19
"2011","Test Valley 008B","E01023168","Total",687,644,43
"2011","Test Valley 008C","E01023178","Total",970,917,53
"2011","Test Valley 009A","E01023166","Total",691,646,45
"2011","Test Valley 009B","E01023167","Total",748,697,51
"2011","Test Valley 009C","E01023177","Total",947,883,64
"2011","Test Valley 009D","E01023184","Total",559,516,43
"2011","Test Valley 009E","E01023185","Total",525,513,12
"2011","Test Valley 010A","E01023174","Total",736,721,15
"2011","Test Valley 010B","E01023175","Total",710,701,9
"2011","Test Valley 010C","E01023176","Total",738,719,19
"2011","Test Valley 010D","E01023207","Total",660,645,15
"2011","Test Valley 010E","E01023208","Total",487,484,3
"2011","Test Valley 010F","E01023209","Total",552,544,8
"2011","Test Valley 011A","E01023150","Total",746,727,19
"2011","Test Valley 011B","E01023151","Total",820,782,38
"2011","Test Valley 011C","E01023152","Total",900,858,42
"2011","Test Valley 011D","E01023206","Total",509,497,12
"2011","Test Valley 012A","E01023158","Total",958,916,42
"2011","Test Valley 012B","E01023191","Total",793,778,15
"2011","Test Valley 012C","E01023192","Total",838,822,16
"2011","Test Valley 012D","E01023193","Total",668,660,8
"2011","Test Valley 012E","E01023194","Total",663,642,21
"2011","Test Valley 012F","E01023200","Total",607,598,9
"2011","Test Valley 013A","E01023162","Total",718,669,49
"2011","Test Valley 013B","E01023163","Total",686,663,23
"2011","Test Valley 013C","E01023164","Total",670,654,16
"2011","Test Valley 013D","E01023199","Total",664,634,30
"2011","Test Valley 014A","E01023210","Total",539,532,7
"2011","Test Valley 014B","E01023211","Total",685,679,6
"2011","Test Valley 014C","E01023212","Total",604,592,12
"2011","Test Valley 014D","E01023213","Total",503,498,5
"2011","Test Valley 014E","E01023214","Total",535,530,5
"2011","Test Valley 015A","E01023170","Total",806,703,103
"2011","Test Valley 015B","E01023171","Total",629,595,34
"2011","Test Valley 015C","E01023172","Total",623,615,8
"2011","Test Valley 015D","E01023173","Total",593,588,5
"2011","Winchester 001A","E01023286","Total",624,591,33
"2011","Winchester 001B","E01023287","Total",1143,1068,75
"2011","Winchester 001C","E01023288","Total",604,577,27
"2011","Winchester 002A","E01023236","Total",870,804,66
"2011","Winchester 002B","E01023237","Total",584,563,21
"2011","Winchester 002C","E01023238","Total",610,587,23
"2011","Winchester 002D","E01023239","Total",676,654,22
"2011","Winchester 003A","E01023240","Total",912,879,33
"2011","Winchester 003B","E01023241","Total",538,518,20
"2011","Winchester 003C","E01023248","Total",705,685,20
"2011","Winchester 003D","E01023253","Total",732,709,23
"2011","Winchester 003E","E01023274","Total",677,626,51
"2011","Winchester 004A","E01023225","Total",882,830,52
"2011","Winchester 004B","E01023278","Total",746,727,19
"2011","Winchester 004C","E01023279","Total",620,613,7
"2011","Winchester 004D","E01023280","Total",627,588,39
"2011","Winchester 004E","E01023281","Total",882,833,49
"2011","Winchester 005A","E01023247","Total",707,631,76
"2011","Winchester 005B","E01023249","Total",541,524,17
"2011","Winchester 005C","E01023250","Total",694,681,13
"2011","Winchester 005D","E01023268","Total",503,485,18
"2011","Winchester 005E","E01023269","Total",682,651,31
"2011","Winchester 005F","E01023270","Total",470,456,14
"2011","Winchester 006A","E01023251","Total",679,635,44
"2011","Winchester 006B","E01023255","Total",716,700,16
"2011","Winchester 006C","E01023256","Total",633,620,13
"2011","Winchester 006D","E01023257","Total",708,688,20
"2011","Winchester 006E","E01023258","Total",545,524,21
"2011","Winchester 007A","E01023252","Total",1078,961,117
"2011","Winchester 007B","E01023254","Total",881,831,50
"2011","Winchester 007C","E01023263","Total",660,596,64
"2011","Winchester 007D","E01023264","Total",742,680,62
"2011","Winchester 007E","E01023265","Total",873,816,57
"2011","Winchester 007F","E01023267","Total",573,534,39
"2011","Winchester 008A","E01023260","Total",504,493,11
"2011","Winchester 008B","E01023261","Total",624,616,8
"2011","Winchester 008C","E01023262","Total",507,499,8
"2011","Winchester 008D","E01023266","Total",592,569,23
"2011","Winchester 009A","E01023229","Total",838,776,62
"2011","Winchester 009B","E01023242","Total",498,491,7
"2011","Winchester 009C","E01023243","Total",625,617,8
"2011","Winchester 009D","E01023244","Total",673,655,18
"2011","Winchester 009E","E01023259","Total",562,553,9
"2011","Winchester 010A","E01023226","Total",676,638,38
"2011","Winchester 010B","E01023227","Total",816,796,20
"2011","Winchester 010C","E01023228","Total",890,869,21
"2011","Winchester 010D","E01023230","Total",838,807,31
"2011","Winchester 010E","E01023246","Total",616,575,41
"2011","Winchester 011A","E01023235","Total",935,841,94
"2011","Winchester 011B","E01023275","Total",599,580,19
"2011","Winchester 011C","E01023276","Total",592,585,7
"2011","Winchester 011D","E01023277","Total",515,494,21
"2011","Winchester 011E","E01023282","Total",891,814,77
"2011","Winchester 012A","E01023220","Total",868,838,30
"2011","Winchester 012B","E01023221","Total",866,819,47
"2011","Winchester 012C","E01023222","Total",668,631,37
"2011","Winchester 012D","E01023223","Total",615,599,16
"2011","Winchester 012E","E01023272","Total",546,520,26
"2011","Winchester 012F","E01023273","Total",603,579,24
"2011","Winchester 013A","E01023245","Total",953,917,36
"2011","Winchester 013B","E01023271","Total",458,454,4
"2011","Winchester 013D","E01023284","Total",1231,1170,61
"2011","Winchester 013E","E01023285","Total",714,696,18
"2011","Winchester 013F","E01032859","Total",668,645,23
"2011","Winchester 013G","E01032860","Total",706,635,71
"2011","Winchester 014A","E01023224","Total",533,502,31
"2011","Winchester 014B","E01023231","Total",716,695,21
"2011","Winchester 014C","E01023232","Total",787,737,50
"2011","Winchester 014D","E01023233","Total",654,630,24
"2011","Winchester 014E","E01023234","Total",674,665,9
"2011","Ashford 001B","E01023987","Total",472,453,19
"2011","Ashford 001C","E01023988","Total",607,558,49
"2011","Ashford 001D","E01024040","Total",567,548,19
"2011","Ashford 001E","E01024041","Total",568,507,61
"2011","Ashford 001F","E01032810","Total",639,596,43
"2011","Ashford 001G","E01032812","Total",698,669,29
"2011","Ashford 002A","E01023985","Total",540,508,32
"2011","Ashford 002B","E01023986","Total",595,563,32
"2011","Ashford 002C","E01023989","Total",469,454,15
"2011","Ashford 002D","E01023990","Total",560,504,56
"2011","Ashford 002E","E01024033","Total",720,679,41
"2011","Ashford 002F","E01024035","Total",485,453,32
"2011","Ashford 003A","E01023983","Total",623,606,17
"2011","Ashford 003B","E01023999","Total",943,904,39
"2011","Ashford 003D","E01032811","Total",607,596,11
"2011","Ashford 003E","E01032822","Total",580,563,17
"2011","Ashford 004A","E01023980","Total",523,516,7
"2011","Ashford 004B","E01023981","Total",512,507,5
"2011","Ashford 004C","E01023984","Total",498,493,5
"2011","Ashford 004E","E01023992","Total",649,624,25
"2011","Ashford 004F","E01023993","Total",544,528,16
"2011","Ashford 004G","E01024021","Total",655,614,41
"2011","Ashford 004H","E01024022","Total",639,610,29
"2011","Ashford 004I","E01032820","Total",639,625,14
"2011","Ashford 004J","E01032821","Total",624,619,5
"2011","Ashford 005A","E01023973","Total",730,712,18
"2011","Ashford 005B","E01024002","Total",608,566,42
"2011","Ashford 005C","E01024023","Total",1015,994,21
"2011","Ashford 005D","E01024027","Total",768,713,55
"2011","Ashford 005E","E01024029","Total",964,937,27
"2011","Ashford 006A","E01023972","Total",514,508,6
"2011","Ashford 006B","E01023995","Total",489,479,10
"2011","Ashford 006C","E01023996","Total",484,481,3
"2011","Ashford 006D","E01024003","Total",775,757,18
"2011","Ashford 006E","E01024004","Total",745,705,40
"2011","Ashford 006F","E01024005","Total",663,645,18
"2011","Ashford 007A","E01023974","Total",534,520,14
"2011","Ashford 007B","E01023975","Total",622,614,8
"2011","Ashford 007C","E01023977","Total",553,530,23
"2011","Ashford 007D","E01024016","Total",661,655,6
"2011","Ashford 007E","E01024017","Total",801,779,22
"2011","Ashford 007F","E01024028","Total",712,697,15
"2011","Ashford 008A","E01023976","Total",681,672,9
"2011","Ashford 008B","E01024019","Total",486,484,2
"2011","Ashford 008C","E01024020","Total",687,634,53
"2011","Ashford 008E","E01032816","Total",700,672,28
"2011","Ashford 008F","E01032823","Total",621,607,14
"2011","Ashford 009A","E01024001","Total",662,650,12
"2011","Ashford 009B","E01024006","Total",459,445,14
"2011","Ashford 009D","E01024008","Total",730,720,10
"2011","Ashford 009F","E01032815","Total",429,420,9
"2011","Ashford 009G","E01032817","Total",463,449,14
"2011","Ashford 009H","E01032818","Total",565,553,12
"2011","Ashford 009I","E01032819","Total",661,648,13
"2011","Ashford 009J","E01032824","Total",603,588,15
"2011","Ashford 010A","E01024013","Total",730,709,21
"2011","Ashford 010B","E01024014","Total",730,650,80
"2011","Ashford 010C","E01024015","Total",680,651,29
"2011","Ashford 010D","E01024034","Total",975,942,33
"2011","Ashford 011A","E01023978","Total",550,510,40
"2011","Ashford 011B","E01023979","Total",553,534,19
"2011","Ashford 011C","E01024032","Total",657,623,34
"2011","Ashford 011D","E01024036","Total",562,526,36
"2011","Ashford 012B","E01024031","Total",664,629,35
"2011","Ashford 012C","E01024038","Total",866,818,48
"2011","Ashford 012D","E01024039","Total",598,577,21
"2011","Ashford 012E","E01032813","Total",747,730,17
"2011","Ashford 012F","E01032814","Total",767,740,27
"2011","Ashford 013A","E01024009","Total",514,482,32
"2011","Ashford 013B","E01024010","Total",620,577,43
"2011","Ashford 013C","E01024011","Total",516,497,19
"2011","Ashford 013D","E01024012","Total",470,453,17
"2011","Ashford 013E","E01024024","Total",1164,1105,59
"2011","Ashford 013F","E01024025","Total",613,572,41
"2011","Ashford 014A","E01023997","Total",656,609,47
"2011","Ashford 014B","E01023998","Total",531,474,57
"2011","Ashford 014C","E01024026","Total",526,503,23
"2011","Ashford 014D","E01024037","Total",776,745,31
"2011","Canterbury 001A","E01024078","Total",1100,920,180
"2011","Canterbury 001B","E01024080","Total",712,608,104
"2011","Canterbury 001C","E01024081","Total",849,789,60
"2011","Canterbury 001D","E01024082","Total",628,598,30
"2011","Canterbury 001E","E01024095","Total",645,607,38
"2011","Canterbury 002A","E01024094","Total",1074,989,85
"2011","Canterbury 002B","E01024096","Total",775,756,19
"2011","Canterbury 002C","E01024097","Total",773,748,25
"2011","Canterbury 002D","E01024098","Total",676,659,17
"2011","Canterbury 003A","E01024064","Total",945,913,32
"2011","Canterbury 003B","E01024066","Total",658,647,11
"2011","Canterbury 003C","E01024079","Total",655,627,28
"2011","Canterbury 003D","E01024083","Total",678,654,24
"2011","Canterbury 003E","E01024118","Total",788,762,26
"2011","Canterbury 004A","E01024059","Total",792,752,40
"2011","Canterbury 004B","E01024065","Total",815,789,26
"2011","Canterbury 004C","E01024117","Total",690,633,57
"2011","Canterbury 004D","E01024119","Total",628,618,10
"2011","Canterbury 004E","E01024120","Total",834,766,68
"2011","Canterbury 005A","E01024056","Total",815,788,27
"2011","Canterbury 005B","E01024057","Total",837,802,35
"2011","Canterbury 005C","E01024058","Total",679,666,13
"2011","Canterbury 005D","E01024114","Total",863,786,77
"2011","Canterbury 005E","E01024115","Total",663,646,17
"2011","Canterbury 006A","E01024073","Total",825,808,17
"2011","Canterbury 006B","E01024074","Total",551,542,9
"2011","Canterbury 006C","E01024075","Total",709,685,24
"2011","Canterbury 006D","E01024076","Total",761,752,9
"2011","Canterbury 006E","E01024077","Total",593,565,28
"2011","Canterbury 007A","E01024055","Total",715,691,24
"2011","Canterbury 007B","E01024061","Total",687,658,29
"2011","Canterbury 007C","E01024063","Total",642,622,20
"2011","Canterbury 007D","E01024071","Total",730,706,24
"2011","Canterbury 007E","E01024116","Total",712,640,72
"2011","Canterbury 008A","E01024060","Total",713,663,50
"2011","Canterbury 008B","E01024069","Total",665,602,63
"2011","Canterbury 008C","E01024070","Total",864,694,170
"2011","Canterbury 008D","E01024072","Total",814,656,158
"2011","Canterbury 008E","E01024106","Total",726,688,38
"2011","Canterbury 009A","E01024062","Total",644,620,24
"2011","Canterbury 009B","E01024105","Total",737,696,41
"2011","Canterbury 009C","E01024107","Total",607,589,18
"2011","Canterbury 009D","E01024108","Total",588,532,56
"2011","Canterbury 009E","E01024109","Total",1005,956,49
"2011","Canterbury 010A","E01024084","Total",516,469,47
"2011","Canterbury 010B","E01024085","Total",690,645,45
"2011","Canterbury 010C","E01024086","Total",819,795,24
"2011","Canterbury 010D","E01024087","Total",507,471,36
"2011","Canterbury 011A","E01024091","Total",506,495,11
"2011","Canterbury 011B","E01024110","Total",594,557,37
"2011","Canterbury 011C","E01024111","Total",619,613,6
"2011","Canterbury 011D","E01024112","Total",671,662,9
"2011","Canterbury 011E","E01024113","Total",586,538,48
"2011","Canterbury 012C","E01024067","Total",463,456,7
"2011","Canterbury 012D","E01024068","Total",604,590,14
"2011","Canterbury 012E","E01024123","Total",641,631,10
"2011","Canterbury 012F","E01032809","Total",988,958,30
"2011","Canterbury 013A","E01024099","Total",558,545,13
"2011","Canterbury 013B","E01024100","Total",523,511,12
"2011","Canterbury 013C","E01024101","Total",626,617,9
"2011","Canterbury 013D","E01024102","Total",670,657,13
"2011","Canterbury 013E","E01024103","Total",635,629,6
"2011","Canterbury 014A","E01024047","Total",526,495,31
"2011","Canterbury 014B","E01024049","Total",558,551,7
"2011","Canterbury 014C","E01024090","Total",789,751,38
"2011","Canterbury 014D","E01024092","Total",642,627,15
"2011","Canterbury 014E","E01024093","Total",774,734,40
"2011","Canterbury 016A","E01024044","Total",908,857,51
"2011","Canterbury 016B","E01024045","Total",680,661,19
"2011","Canterbury 016C","E01024046","Total",833,781,52
"2011","Canterbury 016D","E01024048","Total",548,535,13
"2011","Canterbury 016E","E01024131","Total",692,661,31
"2011","Canterbury 017A","E01024052","Total",929,910,19
"2011","Canterbury 017B","E01024053","Total",778,743,35
"2011","Canterbury 017C","E01024054","Total",787,732,55
"2011","Canterbury 017D","E01024127","Total",681,661,20
"2011","Canterbury 018A","E01024042","Total",561,535,26
"2011","Canterbury 018B","E01024043","Total",583,565,18
"2011","Canterbury 018C","E01024088","Total",670,621,49
"2011","Canterbury 018D","E01024089","Total",517,482,35
"2011","Canterbury 019A","E01024128","Total",650,631,19
"2011","Canterbury 019B","E01024129","Total",671,641,30
"2011","Canterbury 019C","E01024130","Total",1121,1084,37
"2011","Canterbury 020A","E01024104","Total",982,956,26
"2011","Canterbury 020B","E01024121","Total",691,666,25
"2011","Canterbury 020C","E01024122","Total",642,619,23
"2011","Canterbury 020D","E01024124","Total",584,543,41
"2011","Canterbury 020E","E01024126","Total",534,532,2
"2011","Canterbury 020F","E01032807","Total",858,755,103
"2011","Canterbury 020G","E01032808","Total",776,715,61
"2011","Dartford 001A","E01024148","Total",880,849,31
"2011","Dartford 001B","E01024149","Total",1305,1220,85
"2011","Dartford 001C","E01024154","Total",515,512,3
"2011","Dartford 001D","E01024155","Total",583,575,8
"2011","Dartford 002A","E01024140","Total",1231,1175,56
"2011","Dartford 002B","E01024141","Total",655,633,22
"2011","Dartford 002C","E01024143","Total",1146,999,147
"2011","Dartford 002D","E01024179","Total",1246,1214,32
"2011","Dartford 003A","E01024180","Total",705,673,32
"2011","Dartford 003B","E01024181","Total",508,499,9
"2011","Dartford 003C","E01024182","Total",809,773,36
"2011","Dartford 003D","E01024183","Total",544,521,23
"2011","Dartford 003E","E01024184","Total",787,771,16
"2011","Dartford 003F","E01024185","Total",897,856,41
"2011","Dartford 004A","E01024142","Total",1299,1249,50
"2011","Dartford 004B","E01024176","Total",808,787,21
"2011","Dartford 004C","E01024177","Total",608,599,9
"2011","Dartford 004D","E01024178","Total",630,623,7
"2011","Dartford 005A","E01024156","Total",796,784,12
"2011","Dartford 005B","E01024161","Total",825,800,25
"2011","Dartford 005C","E01024162","Total",843,818,25
"2011","Dartford 005D","E01024163","Total",745,728,17
"2011","Dartford 005E","E01024164","Total",829,801,28
"2011","Dartford 006A","E01024169","Total",638,629,9
"2011","Dartford 006B","E01024170","Total",676,668,8
"2011","Dartford 006C","E01024171","Total",634,620,14
"2011","Dartford 006D","E01024172","Total",1010,980,30
"2011","Dartford 007A","E01024144","Total",550,544,6
"2011","Dartford 007B","E01024145","Total",603,594,9
"2011","Dartford 007C","E01024146","Total",544,538,6
"2011","Dartford 007D","E01024147","Total",666,653,13
"2011","Dartford 007E","E01024186","Total",526,514,12
"2011","Dartford 008A","E01024133","Total",466,460,6
"2011","Dartford 008B","E01024136","Total",698,679,19
"2011","Dartford 008C","E01024137","Total",562,552,10
"2011","Dartford 008D","E01024138","Total",673,657,16
"2011","Dartford 008E","E01024139","Total",701,690,11
"2011","Dartford 009A","E01024165","Total",678,675,3
"2011","Dartford 009B","E01024166","Total",625,620,5
"2011","Dartford 009C","E01024167","Total",827,773,54
"2011","Dartford 009D","E01024168","Total",499,488,11
"2011","Dartford 010A","E01024150","Total",656,643,13
"2011","Dartford 010B","E01024151","Total",640,625,15
"2011","Dartford 010C","E01024152","Total",950,931,19
"2011","Dartford 010D","E01024153","Total",551,543,8
"2011","Dartford 011A","E01024173","Total",713,698,15
"2011","Dartford 011B","E01024187","Total",449,442,7
"2011","Dartford 011C","E01024188","Total",527,508,19
"2011","Dartford 011D","E01024189","Total",695,685,10
"2011","Dartford 012A","E01024132","Total",493,489,4
"2011","Dartford 012B","E01024134","Total",662,650,12
"2011","Dartford 012C","E01024135","Total",548,541,7
"2011","Dartford 012D","E01024174","Total",503,498,5
"2011","Dartford 012E","E01024175","Total",526,514,12
"2011","Dartford 013A","E01024157","Total",684,674,10
"2011","Dartford 013B","E01024158","Total",670,650,20
"2011","Dartford 013C","E01024159","Total",655,647,8
"2011","Dartford 013D","E01024160","Total",558,550,8
"2011","Dover 001A","E01024206","Total",756,717,39
"2011","Dover 001B","E01024207","Total",770,719,51
"2011","Dover 001C","E01024208","Total",692,666,26
"2011","Dover 001D","E01024209","Total",781,749,32
"2011","Dover 002A","E01024202","Total",826,800,26
"2011","Dover 002B","E01024242","Total",781,730,51
"2011","Dover 002C","E01024243","Total",776,761,15
"2011","Dover 002D","E01024244","Total",1100,960,140
"2011","Dover 002E","E01024245","Total",778,748,30
"2011","Dover 003A","E01024219","Total",573,562,11
"2011","Dover 003B","E01024220","Total",782,754,28
"2011","Dover 003C","E01024221","Total",654,635,19
"2011","Dover 003D","E01024227","Total",701,675,26
"2011","Dover 003E","E01024229","Total",754,727,27
"2011","Dover 004A","E01024228","Total",959,801,158
"2011","Dover 004B","E01024230","Total",905,761,144
"2011","Dover 004C","E01024231","Total",830,743,87
"2011","Dover 004D","E01024252","Total",1312,1141,171
"2011","Dover 005A","E01024201","Total",637,613,24
"2011","Dover 005B","E01024217","Total",772,754,18
"2011","Dover 005C","E01024223","Total",635,625,10
"2011","Dover 005D","E01024225","Total",693,680,13
"2011","Dover 005E","E01024226","Total",647,626,21
"2011","Dover 006A","E01024190","Total",616,594,22
"2011","Dover 006B","E01024191","Total",702,687,15
"2011","Dover 006C","E01024192","Total",696,681,15
"2011","Dover 006D","E01024204","Total",671,657,14
"2011","Dover 007A","E01024218","Total",540,528,12
"2011","Dover 007B","E01024222","Total",693,670,23
"2011","Dover 007C","E01024224","Total",666,647,19
"2011","Dover 007D","E01024250","Total",816,777,39
"2011","Dover 007E","E01024251","Total",765,732,33
"2011","Dover 008A","E01024200","Total",829,715,114
"2011","Dover 008B","E01024203","Total",682,649,33
"2011","Dover 008C","E01024205","Total",656,643,13
"2011","Dover 008D","E01024255","Total",679,671,8
"2011","Dover 009A","E01024232","Total",1147,913,234
"2011","Dover 009B","E01024236","Total",945,742,203
"2011","Dover 009C","E01024237","Total",1026,758,268
"2011","Dover 009D","E01024253","Total",841,787,54
"2011","Dover 010C","E01024233","Total",661,646,15
"2011","Dover 010D","E01024235","Total",726,699,27
"2011","Dover 010E","E01024254","Total",832,805,27
"2011","Dover 010F","E01024256","Total",614,608,6
"2011","Dover 010G","E01033210","Total",994,961,33
"2011","Dover 011A","E01024193","Total",732,723,9
"2011","Dover 011B","E01024194","Total",657,638,19
"2011","Dover 011C","E01024195","Total",542,528,14
"2011","Dover 011D","E01024196","Total",641,628,13
"2011","Dover 011E","E01024197","Total",693,686,7
"2011","Dover 011F","E01024240","Total",667,651,16
"2011","Dover 011G","E01024241","Total",842,810,32
"2011","Dover 011H","E01024248","Total",863,850,13
"2011","Dover 012B","E01024238","Total",589,566,23
"2011","Dover 012C","E01024239","Total",912,873,39
"2011","Dover 012D","E01024247","Total",985,909,76
"2011","Dover 012E","E01033209","Total",641,574,67
"2011","Dover 012F","E01033211","Total",752,668,84
"2011","Dover 013A","E01024214","Total",783,726,57
"2011","Dover 013B","E01024215","Total",758,674,84
"2011","Dover 013C","E01024216","Total",625,604,21
"2011","Dover 013D","E01024246","Total",969,894,75
"2011","Dover 013E","E01024249","Total",943,915,28
"2011","Dover 014A","E01024198","Total",1274,1076,198
"2011","Dover 014B","E01024212","Total",682,663,19
"2011","Dover 014C","E01024213","Total",582,572,10
"2011","Dover 014D","E01024234","Total",572,565,7
"2011","Gravesham 001A","E01024276","Total",930,916,14
"2011","Gravesham 001B","E01024277","Total",815,769,46
"2011","Gravesham 001C","E01024278","Total",918,863,55
"2011","Gravesham 001D","E01024279","Total",653,619,34
"2011","Gravesham 002A","E01024257","Total",980,890,90
"2011","Gravesham 002C","E01024290","Total",602,584,18
"2011","Gravesham 002D","E01024291","Total",828,793,35
"2011","Gravesham 002E","E01024295","Total",1018,934,84
"2011","Gravesham 002F","E01032799","Total",714,660,54
"2011","Gravesham 002G","E01032800","Total",710,689,21
"2011","Gravesham 003A","E01024258","Total",641,625,16
"2011","Gravesham 003B","E01024261","Total",968,946,22
"2011","Gravesham 003C","E01024293","Total",614,599,15
"2011","Gravesham 003D","E01024294","Total",829,811,18
"2011","Gravesham 003E","E01024296","Total",1204,1165,39
"2011","Gravesham 004A","E01024262","Total",733,715,18
"2011","Gravesham 004B","E01024263","Total",605,593,12
"2011","Gravesham 004C","E01024282","Total",616,580,36
"2011","Gravesham 004D","E01024283","Total",499,491,8
"2011","Gravesham 004E","E01024284","Total",621,595,26
"2011","Gravesham 005A","E01024259","Total",571,560,11
"2011","Gravesham 005B","E01024260","Total",843,808,35
"2011","Gravesham 005C","E01024292","Total",583,557,26
"2011","Gravesham 005D","E01024313","Total",640,631,9
"2011","Gravesham 005E","E01024317","Total",654,641,13
"2011","Gravesham 005F","E01024318","Total",633,622,11
"2011","Gravesham 006A","E01024280","Total",697,682,15
"2011","Gravesham 006B","E01024281","Total",543,528,15
"2011","Gravesham 006C","E01024285","Total",535,525,10
"2011","Gravesham 006D","E01024287","Total",652,645,7
"2011","Gravesham 006E","E01024288","Total",503,499,4
"2011","Gravesham 007A","E01024308","Total",618,612,6
"2011","Gravesham 007B","E01024310","Total",639,627,12
"2011","Gravesham 007C","E01024311","Total",465,457,8
"2011","Gravesham 007D","E01024314","Total",494,485,9
"2011","Gravesham 007E","E01024315","Total",641,596,45
"2011","Gravesham 008A","E01024297","Total",576,564,12
"2011","Gravesham 008B","E01024298","Total",545,537,8
"2011","Gravesham 008C","E01024299","Total",563,553,10
"2011","Gravesham 008D","E01024309","Total",481,478,3
"2011","Gravesham 008E","E01024312","Total",481,474,7
"2011","Gravesham 009A","E01024264","Total",622,612,10
"2011","Gravesham 009B","E01024286","Total",623,620,3
"2011","Gravesham 009C","E01024316","Total",700,683,17
"2011","Gravesham 009D","E01024319","Total",568,554,14
"2011","Gravesham 010A","E01024265","Total",512,499,13
"2011","Gravesham 010B","E01024266","Total",496,482,14
"2011","Gravesham 010C","E01024267","Total",634,623,11
"2011","Gravesham 010D","E01024300","Total",590,580,10
"2011","Gravesham 010E","E01024301","Total",535,518,17
"2011","Gravesham 011A","E01024303","Total",679,668,11
"2011","Gravesham 011B","E01024304","Total",625,610,15
"2011","Gravesham 011C","E01024305","Total",563,547,16
"2011","Gravesham 011D","E01024306","Total",453,436,17
"2011","Gravesham 011E","E01024307","Total",658,643,15
"2011","Gravesham 012A","E01024268","Total",646,631,15
"2011","Gravesham 012B","E01024269","Total",767,758,9
"2011","Gravesham 012C","E01024270","Total",605,586,19
"2011","Gravesham 012D","E01024271","Total",601,579,22
"2011","Gravesham 012E","E01024272","Total",608,592,16
"2011","Gravesham 013A","E01024273","Total",609,552,57
"2011","Gravesham 013B","E01024274","Total",636,616,20
"2011","Gravesham 013C","E01024275","Total",535,526,9
"2011","Gravesham 013D","E01024302","Total",624,598,26
"2011","Maidstone 001A","E01024333","Total",532,521,11
"2011","Maidstone 001B","E01024334","Total",417,412,5
"2011","Maidstone 001C","E01024335","Total",631,605,26
"2011","Maidstone 001D","E01024338","Total",522,513,9
"2011","Maidstone 001E","E01024347","Total",695,655,40
"2011","Maidstone 002A","E01024353","Total",740,720,20
"2011","Maidstone 002B","E01024354","Total",612,602,10
"2011","Maidstone 002C","E01024355","Total",862,823,39
"2011","Maidstone 002D","E01024385","Total",645,623,22
"2011","Maidstone 002E","E01024386","Total",720,697,23
"2011","Maidstone 003A","E01024320","Total",496,492,4
"2011","Maidstone 003B","E01024321","Total",748,736,12
"2011","Maidstone 003C","E01024322","Total",499,494,5
"2011","Maidstone 003D","E01024323","Total",601,593,8
"2011","Maidstone 003E","E01024324","Total",647,637,10
"2011","Maidstone 003F","E01024341","Total",714,698,16
"2011","Maidstone 004A","E01024352","Total",923,868,55
"2011","Maidstone 004C","E01024382","Total",671,641,30
"2011","Maidstone 004D","E01024383","Total",918,868,50
"2011","Maidstone 004E","E01024384","Total",797,783,14
"2011","Maidstone 004F","E01033090","Total",724,632,92
"2011","Maidstone 004G","E01033092","Total",667,631,36
"2011","Maidstone 005A","E01024330","Total",649,641,8
"2011","Maidstone 005B","E01024336","Total",639,624,15
"2011","Maidstone 005C","E01024337","Total",617,606,11
"2011","Maidstone 005D","E01024348","Total",526,518,8
"2011","Maidstone 005E","E01024351","Total",674,666,8
"2011","Maidstone 006A","E01024339","Total",907,850,57
"2011","Maidstone 006B","E01024340","Total",1107,1034,73
"2011","Maidstone 006C","E01024356","Total",668,625,43
"2011","Maidstone 006E","E01024373","Total",816,790,26
"2011","Maidstone 006F","E01033087","Total",739,699,40
"2011","Maidstone 006G","E01033091","Total",739,715,24
"2011","Maidstone 007A","E01024326","Total",798,784,14
"2011","Maidstone 007B","E01024327","Total",682,672,10
"2011","Maidstone 007C","E01024328","Total",722,673,49
"2011","Maidstone 007D","E01024329","Total",629,604,25
"2011","Maidstone 007E","E01024349","Total",615,603,12
"2011","Maidstone 008A","E01024357","Total",685,670,15
"2011","Maidstone 008B","E01024358","Total",770,748,22
"2011","Maidstone 008C","E01024367","Total",554,543,11
"2011","Maidstone 008E","E01024369","Total",636,615,21
"2011","Maidstone 008F","E01033088","Total",568,549,19
"2011","Maidstone 008G","E01033089","Total",594,575,19
"2011","Maidstone 009A","E01024360","Total",641,636,5
"2011","Maidstone 009B","E01024372","Total",837,801,36
"2011","Maidstone 009C","E01024374","Total",597,580,17
"2011","Maidstone 009D","E01024401","Total",674,640,34
"2011","Maidstone 009E","E01024403","Total",797,777,20
"2011","Maidstone 010A","E01024371","Total",659,648,11
"2011","Maidstone 010B","E01024392","Total",616,608,8
"2011","Maidstone 010C","E01024393","Total",643,607,36
"2011","Maidstone 010D","E01024395","Total",537,528,9
"2011","Maidstone 010E","E01024396","Total",638,630,8
"2011","Maidstone 011A","E01024361","Total",753,725,28
"2011","Maidstone 011B","E01024362","Total",743,699,44
"2011","Maidstone 011C","E01024363","Total",862,824,38
"2011","Maidstone 011D","E01024387","Total",1046,982,64
"2011","Maidstone 012A","E01024331","Total",595,580,15
"2011","Maidstone 012B","E01024394","Total",532,521,11
"2011","Maidstone 012C","E01024402","Total",605,601,4
"2011","Maidstone 012D","E01024404","Total",633,615,18
"2011","Maidstone 012E","E01024405","Total",947,924,23
"2011","Maidstone 013A","E01024389","Total",954,920,34
"2011","Maidstone 013B","E01024390","Total",577,573,4
"2011","Maidstone 013C","E01024391","Total",497,494,3
"2011","Maidstone 013D","E01024397","Total",666,654,12
"2011","Maidstone 013E","E01024398","Total",725,711,14
"2011","Maidstone 013F","E01024399","Total",628,620,8
"2011","Maidstone 013G","E01024400","Total",567,558,9
"2011","Maidstone 014A","E01024325","Total",1025,1002,23
"2011","Maidstone 014B","E01024346","Total",585,560,25
"2011","Maidstone 014C","E01024377","Total",752,717,35
"2011","Maidstone 014D","E01024378","Total",594,582,12
"2011","Maidstone 015A","E01024332","Total",541,496,45
"2011","Maidstone 015B","E01024350","Total",577,566,11
"2011","Maidstone 015C","E01024375","Total",1009,977,32
"2011","Maidstone 015D","E01024388","Total",1168,1146,22
"2011","Maidstone 015E","E01024410","Total",662,635,27
"2011","Maidstone 016A","E01024342","Total",771,749,22
"2011","Maidstone 016B","E01024343","Total",534,522,12
"2011","Maidstone 016C","E01024344","Total",625,616,9
"2011","Maidstone 016D","E01024376","Total",941,921,20
"2011","Maidstone 017A","E01024364","Total",725,699,26
"2011","Maidstone 017B","E01024365","Total",840,760,80
"2011","Maidstone 017C","E01024366","Total",692,652,40
"2011","Maidstone 017D","E01024411","Total",494,468,26
"2011","Maidstone 018A","E01024345","Total",626,605,21
"2011","Maidstone 018B","E01024379","Total",693,658,35
"2011","Maidstone 018C","E01024380","Total",717,689,28
"2011","Maidstone 018D","E01024381","Total",631,612,19
"2011","Maidstone 019A","E01024406","Total",572,547,25
"2011","Maidstone 019B","E01024407","Total",590,567,23
"2011","Maidstone 019C","E01024408","Total",592,580,12
"2011","Maidstone 019D","E01024409","Total",633,617,16
"2011","Sevenoaks 001A","E01024445","Total",501,498,3
"2011","Sevenoaks 001B","E01024446","Total",589,586,3
"2011","Sevenoaks 001C","E01024447","Total",582,578,4
"2011","Sevenoaks 001D","E01024472","Total",534,526,8
"2011","Sevenoaks 001E","E01024479","Total",625,616,9
"2011","Sevenoaks 002A","E01024476","Total",594,593,1
"2011","Sevenoaks 002B","E01024477","Total",619,614,5
"2011","Sevenoaks 002C","E01024478","Total",585,579,6
"2011","Sevenoaks 002D","E01024480","Total",814,809,5
"2011","Sevenoaks 002E","E01024481","Total",673,660,13
"2011","Sevenoaks 002F","E01024482","Total",664,661,3
"2011","Sevenoaks 003A","E01024421","Total",821,801,20
"2011","Sevenoaks 003B","E01024473","Total",642,637,5
"2011","Sevenoaks 003C","E01024474","Total",478,472,6
"2011","Sevenoaks 003D","E01024475","Total",640,623,17
"2011","Sevenoaks 004A","E01024441","Total",640,630,10
"2011","Sevenoaks 004B","E01024442","Total",611,596,15
"2011","Sevenoaks 004C","E01024443","Total",667,654,13
"2011","Sevenoaks 004D","E01024444","Total",530,525,5
"2011","Sevenoaks 005A","E01024431","Total",834,799,35
"2011","Sevenoaks 005B","E01024432","Total",627,611,16
"2011","Sevenoaks 005C","E01024433","Total",561,552,9
"2011","Sevenoaks 005D","E01024434","Total",960,934,26
"2011","Sevenoaks 007A","E01024435","Total",598,579,19
"2011","Sevenoaks 007B","E01024436","Total",723,700,23
"2011","Sevenoaks 007C","E01024437","Total",615,603,12
"2011","Sevenoaks 007D","E01024438","Total",639,623,16
"2011","Sevenoaks 008A","E01024422","Total",790,769,21
"2011","Sevenoaks 008B","E01024423","Total",781,758,23
"2011","Sevenoaks 008C","E01024439","Total",652,628,24
"2011","Sevenoaks 008D","E01024440","Total",811,769,42
"2011","Sevenoaks 008E","E01024452","Total",608,590,18
"2011","Sevenoaks 009A","E01024448","Total",520,504,16
"2011","Sevenoaks 009B","E01024449","Total",571,563,8
"2011","Sevenoaks 009C","E01024450","Total",643,621,22
"2011","Sevenoaks 009D","E01024453","Total",648,644,4
"2011","Sevenoaks 009E","E01024454","Total",630,618,12
"2011","Sevenoaks 010A","E01024457","Total",535,519,16
"2011","Sevenoaks 010B","E01024460","Total",680,669,11
"2011","Sevenoaks 010C","E01024461","Total",1077,1049,28
"2011","Sevenoaks 010D","E01024465","Total",635,617,18
"2011","Sevenoaks 010E","E01024466","Total",531,526,5
"2011","Sevenoaks 010F","E01024468","Total",653,629,24
"2011","Sevenoaks 011A","E01024416","Total",639,621,18
"2011","Sevenoaks 011B","E01024418","Total",522,514,8
"2011","Sevenoaks 011C","E01024424","Total",499,486,13
"2011","Sevenoaks 011D","E01024463","Total",541,519,22
"2011","Sevenoaks 011E","E01024464","Total",599,577,22
"2011","Sevenoaks 011F","E01024467","Total",658,645,13
"2011","Sevenoaks 012A","E01024458","Total",555,526,29
"2011","Sevenoaks 012B","E01024459","Total",665,637,28
"2011","Sevenoaks 012C","E01024462","Total",670,659,11
"2011","Sevenoaks 012D","E01024469","Total",743,709,34
"2011","Sevenoaks 012E","E01024470","Total",671,642,29
"2011","Sevenoaks 012F","E01024471","Total",790,741,49
"2011","Sevenoaks 013A","E01024417","Total",676,650,26
"2011","Sevenoaks 013B","E01024419","Total",781,731,50
"2011","Sevenoaks 013C","E01024483","Total",720,682,38
"2011","Sevenoaks 013D","E01024484","Total",534,500,34
"2011","Sevenoaks 013E","E01024485","Total",716,702,14
"2011","Sevenoaks 014A","E01024425","Total",756,724,32
"2011","Sevenoaks 014B","E01024426","Total",797,770,27
"2011","Sevenoaks 014C","E01024427","Total",518,508,10
"2011","Sevenoaks 014D","E01024428","Total",537,532,5
"2011","Sevenoaks 014E","E01024429","Total",683,651,32
"2011","Sevenoaks 014F","E01024430","Total",625,600,25
"2011","Sevenoaks 015A","E01024420","Total",880,831,49
"2011","Sevenoaks 015B","E01024451","Total",908,873,35
"2011","Sevenoaks 015C","E01024455","Total",508,472,36
"2011","Sevenoaks 015D","E01024456","Total",559,518,41
"2011","Sevenoaks 016A","E01024413","Total",741,719,22
"2011","Sevenoaks 016B","E01024414","Total",618,606,12
"2011","Sevenoaks 016C","E01024415","Total",510,507,3
"2011","Sevenoaks 016D","E01032619","Total",650,636,14
"2011","Shepway 001A","E01024490","Total",932,883,49
"2011","Shepway 001B","E01024544","Total",588,574,14
"2011","Shepway 001C","E01024545","Total",653,625,28
"2011","Shepway 001D","E01024547","Total",643,613,30
"2011","Shepway 002A","E01024492","Total",651,639,12
"2011","Shepway 002B","E01024541","Total",922,899,23
"2011","Shepway 002C","E01024542","Total",807,802,5
"2011","Shepway 002E","E01033213","Total",672,643,29
"2011","Shepway 002F","E01033214","Total",627,619,8
"2011","Shepway 003A","E01024496","Total",668,660,8
"2011","Shepway 003B","E01024497","Total",670,653,17
"2011","Shepway 003C","E01024498","Total",646,638,8
"2011","Shepway 003D","E01024503","Total",790,760,30
"2011","Shepway 003E","E01024518","Total",688,677,11
"2011","Shepway 004A","E01024499","Total",675,654,21
"2011","Shepway 004B","E01024500","Total",553,532,21
"2011","Shepway 004C","E01024501","Total",648,635,13
"2011","Shepway 004D","E01024502","Total",635,605,30
"2011","Shepway 004E","E01024505","Total",882,828,54
"2011","Shepway 005A","E01024491","Total",562,551,11
"2011","Shepway 005B","E01024493","Total",626,575,51
"2011","Shepway 005C","E01024494","Total",658,649,9
"2011","Shepway 005D","E01024495","Total",696,677,19
"2011","Shepway 005E","E01024520","Total",638,626,12
"2011","Shepway 005F","E01024528","Total",554,530,24
"2011","Shepway 006A","E01024511","Total",564,538,26
"2011","Shepway 006B","E01024512","Total",719,698,21
"2011","Shepway 006C","E01024513","Total",675,651,24
"2011","Shepway 006D","E01024514","Total",525,511,14
"2011","Shepway 006E","E01024515","Total",662,639,23
"2011","Shepway 006F","E01024516","Total",556,552,4
"2011","Shepway 006G","E01024519","Total",711,622,89
"2011","Shepway 006H","E01024521","Total",959,857,102
"2011","Shepway 008A","E01024523","Total",694,677,17
"2011","Shepway 008B","E01024526","Total",693,663,30
"2011","Shepway 008C","E01024527","Total",729,695,34
"2011","Shepway 008D","E01024550","Total",894,858,36
"2011","Shepway 009A","E01024489","Total",844,795,49
"2011","Shepway 009B","E01024530","Total",608,587,21
"2011","Shepway 009C","E01024536","Total",833,809,24
"2011","Shepway 009D","E01024546","Total",679,662,17
"2011","Shepway 010A","E01024522","Total",769,688,81
"2011","Shepway 010B","E01024524","Total",813,780,33
"2011","Shepway 010C","E01024525","Total",979,860,119
"2011","Shepway 010D","E01024529","Total",704,680,24
"2011","Shepway 010E","E01024531","Total",667,640,27
"2011","Shepway 011A","E01024486","Total",930,874,56
"2011","Shepway 011B","E01024487","Total",602,559,43
"2011","Shepway 011C","E01024488","Total",685,664,21
"2011","Shepway 011D","E01024548","Total",517,500,17
"2011","Shepway 011E","E01024549","Total",464,450,14
"2011","Shepway 012A","E01024537","Total",815,750,65
"2011","Shepway 012B","E01024538","Total",755,705,50
"2011","Shepway 012C","E01024539","Total",920,889,31
"2011","Shepway 012D","E01024540","Total",660,640,20
"2011","Shepway 013A","E01024532","Total",703,639,64
"2011","Shepway 013B","E01024533","Total",626,558,68
"2011","Shepway 013C","E01024534","Total",623,609,14
"2011","Shepway 013D","E01024535","Total",1043,1008,35
"2011","Shepway 014A","E01024504","Total",1159,1078,81
"2011","Shepway 014B","E01024507","Total",1119,1060,59
"2011","Shepway 014C","E01033212","Total",980,913,67
"2011","Shepway 014D","E01033215","Total",901,791,110
"2011","Shepway 015A","E01024508","Total",1206,1110,96
"2011","Shepway 015B","E01024509","Total",1063,957,106
"2011","Shepway 015C","E01024510","Total",959,874,85
"2011","Shepway 015D","E01024517","Total",782,742,40
"2011","Swale 001A","E01024609","Total",625,530,95
"2011","Swale 001B","E01024610","Total",701,660,41
"2011","Swale 001C","E01024611","Total",654,617,37
"2011","Swale 001D","E01024612","Total",669,634,35
"2011","Swale 002A","E01024613","Total",689,615,74
"2011","Swale 002B","E01024614","Total",653,639,14
"2011","Swale 002C","E01024615","Total",624,613,11
"2011","Swale 002D","E01024616","Total",713,700,13
"2011","Swale 003A","E01024585","Total",620,607,13
"2011","Swale 003B","E01024587","Total",665,638,27
"2011","Swale 003C","E01024588","Total",603,585,18
"2011","Swale 003D","E01024589","Total",677,662,15
"2011","Swale 004A","E01024595","Total",662,635,27
"2011","Swale 004B","E01024598","Total",630,610,20
"2011","Swale 004D","E01024619","Total",613,602,11
"2011","Swale 004E","E01024621","Total",489,478,11
"2011","Swale 004F","E01032653","Total",687,662,25
"2011","Swale 004G","E01032654","Total",742,709,33
"2011","Swale 005A","E01024594","Total",613,593,20
"2011","Swale 005B","E01024596","Total",729,689,40
"2011","Swale 005C","E01024597","Total",636,612,24
"2011","Swale 005D","E01024620","Total",573,544,29
"2011","Swale 006A","E01024580","Total",1060,797,263
"2011","Swale 006B","E01024581","Total",580,539,41
"2011","Swale 006C","E01024586","Total",700,662,38
"2011","Swale 006D","E01024618","Total",815,731,84
"2011","Swale 007B","E01024576","Total",689,673,16
"2011","Swale 007C","E01024577","Total",526,521,5
"2011","Swale 007D","E01024578","Total",671,659,12
"2011","Swale 007E","E01024579","Total",1073,1056,17
"2011","Swale 007F","E01024583","Total",647,640,7
"2011","Swale 007G","E01032655","Total",600,586,14
"2011","Swale 007H","E01032656","Total",591,571,20
"2011","Swale 008A","E01024570","Total",709,679,30
"2011","Swale 008B","E01024571","Total",685,658,27
"2011","Swale 008C","E01024572","Total",494,447,47
"2011","Swale 008D","E01024573","Total",547,538,9
"2011","Swale 008E","E01024575","Total",499,473,26
"2011","Swale 009A","E01024554","Total",1023,988,35
"2011","Swale 009B","E01024561","Total",563,543,20
"2011","Swale 009C","E01024567","Total",1159,1133,26
"2011","Swale 009D","E01024568","Total",1080,1035,45
"2011","Swale 009E","E01024582","Total",651,629,22
"2011","Swale 010A","E01024559","Total",687,650,37
"2011","Swale 010B","E01024584","Total",726,707,19
"2011","Swale 010C","E01024590","Total",712,685,27
"2011","Swale 010D","E01024599","Total",881,835,46
"2011","Swale 010E","E01024608","Total",866,815,51
"2011","Swale 011A","E01024591","Total",845,768,77
"2011","Swale 011B","E01024592","Total",527,512,15
"2011","Swale 011C","E01024593","Total",510,504,6
"2011","Swale 011D","E01024600","Total",625,618,7
"2011","Swale 011E","E01024601","Total",731,718,13
"2011","Swale 012A","E01024560","Total",518,503,15
"2011","Swale 012B","E01024562","Total",586,571,15
"2011","Swale 012C","E01024569","Total",731,707,24
"2011","Swale 012D","E01024630","Total",770,755,15
"2011","Swale 012E","E01024632","Total",659,648,11
"2011","Swale 013A","E01024606","Total",538,523,15
"2011","Swale 013C","E01024628","Total",627,605,22
"2011","Swale 013D","E01024629","Total",458,452,6
"2011","Swale 013E","E01024631","Total",661,648,13
"2011","Swale 013F","E01032735","Total",607,595,12
"2011","Swale 013G","E01032737","Total",628,583,45
"2011","Swale 014A","E01024564","Total",449,441,8
"2011","Swale 014B","E01024603","Total",526,510,16
"2011","Swale 014C","E01024604","Total",490,478,12
"2011","Swale 014D","E01024605","Total",589,583,6
"2011","Swale 014E","E01024626","Total",631,620,11
"2011","Swale 014F","E01024627","Total",834,817,17
"2011","Swale 015A","E01024551","Total",1026,987,39
"2011","Swale 015B","E01024552","Total",776,760,16
"2011","Swale 015C","E01024553","Total",1086,1002,84
"2011","Swale 015D","E01024563","Total",670,655,15
"2011","Swale 015E","E01024602","Total",725,699,26
"2011","Swale 015F","E01024625","Total",801,793,8
"2011","Swale 016A","E01024565","Total",552,520,32
"2011","Swale 016B","E01024566","Total",645,603,42
"2011","Swale 016C","E01024622","Total",736,712,24
"2011","Swale 016D","E01024623","Total",812,785,27
"2011","Swale 016E","E01024624","Total",779,738,41
"2011","Swale 017A","E01024555","Total",548,519,29
"2011","Swale 017B","E01024556","Total",518,494,24
"2011","Swale 017C","E01024557","Total",632,611,21
"2011","Swale 017D","E01024558","Total",706,664,42
"2011","Thanet 001A","E01024657","Total",1255,1009,246
"2011","Thanet 001B","E01024658","Total",1179,949,230
"2011","Thanet 001C","E01024659","Total",684,641,43
"2011","Thanet 001D","E01024660","Total",909,756,153
"2011","Thanet 001E","E01024678","Total",1292,1038,254
"2011","Thanet 002A","E01024653","Total",755,722,33
"2011","Thanet 002B","E01024654","Total",763,737,26
"2011","Thanet 002C","E01024655","Total",650,628,22
"2011","Thanet 002D","E01024656","Total",850,779,71
"2011","Thanet 002E","E01024675","Total",1017,873,144
"2011","Thanet 003A","E01024676","Total",1000,822,178
"2011","Thanet 003B","E01024677","Total",727,677,50
"2011","Thanet 003C","E01024695","Total",516,488,28
"2011","Thanet 003D","E01024697","Total",530,504,26
"2011","Thanet 003E","E01024710","Total",724,588,136
"2011","Thanet 004A","E01024661","Total",723,643,80
"2011","Thanet 004B","E01024664","Total",619,604,15
"2011","Thanet 004C","E01024665","Total",609,594,15
"2011","Thanet 004D","E01024694","Total",866,786,80
"2011","Thanet 004E","E01024696","Total",618,595,23
"2011","Thanet 005A","E01024672","Total",619,598,21
"2011","Thanet 005B","E01024673","Total",824,804,20
"2011","Thanet 005C","E01024674","Total",633,607,26
"2011","Thanet 005D","E01024711","Total",579,542,37
"2011","Thanet 005E","E01024712","Total",655,625,30
"2011","Thanet 006A","E01024633","Total",671,659,12
"2011","Thanet 006B","E01024634","Total",554,546,8
"2011","Thanet 006C","E01024662","Total",666,649,17
"2011","Thanet 006D","E01024663","Total",631,617,14
"2011","Thanet 006E","E01024666","Total",750,734,16
"2011","Thanet 007A","E01024641","Total",894,730,164
"2011","Thanet 007B","E01024713","Total",738,708,30
"2011","Thanet 007C","E01024714","Total",831,735,96
"2011","Thanet 007D","E01024715","Total",1166,967,199
"2011","Thanet 007E","E01024716","Total",888,845,43
"2011","Thanet 008A","E01024636","Total",1229,1088,141
"2011","Thanet 008B","E01024637","Total",808,748,60
"2011","Thanet 008C","E01024638","Total",827,780,47
"2011","Thanet 008D","E01024639","Total",878,826,52
"2011","Thanet 008E","E01024640","Total",807,772,35
"2011","Thanet 009A","E01024635","Total",735,695,40
"2011","Thanet 009B","E01024642","Total",852,730,122
"2011","Thanet 009C","E01024644","Total",629,597,32
"2011","Thanet 009D","E01024692","Total",843,810,33
"2011","Thanet 009E","E01024693","Total",631,597,34
"2011","Thanet 010A","E01024643","Total",763,616,147
"2011","Thanet 010B","E01024705","Total",827,612,215
"2011","Thanet 010C","E01024706","Total",703,644,59
"2011","Thanet 010D","E01024707","Total",652,587,65
"2011","Thanet 010E","E01024708","Total",722,674,48
"2011","Thanet 011A","E01024686","Total",732,717,15
"2011","Thanet 011B","E01024688","Total",763,734,29
"2011","Thanet 011C","E01024689","Total",555,536,19
"2011","Thanet 011D","E01024690","Total",674,643,31
"2011","Thanet 011E","E01024691","Total",491,478,13
"2011","Thanet 012A","E01024669","Total",752,717,35
"2011","Thanet 012B","E01024698","Total",667,633,34
"2011","Thanet 012C","E01024699","Total",782,762,20
"2011","Thanet 012D","E01024700","Total",759,735,24
"2011","Thanet 012E","E01024709","Total",644,603,41
"2011","Thanet 013A","E01024682","Total",740,717,23
"2011","Thanet 013B","E01024683","Total",693,691,2
"2011","Thanet 013C","E01024684","Total",660,642,18
"2011","Thanet 013D","E01024685","Total",780,764,16
"2011","Thanet 013E","E01024687","Total",642,626,16
"2011","Thanet 014A","E01024701","Total",1310,853,457
"2011","Thanet 014B","E01024702","Total",652,623,29
"2011","Thanet 014C","E01024703","Total",881,753,128
"2011","Thanet 014D","E01024704","Total",758,719,39
"2011","Thanet 015A","E01024645","Total",635,612,23
"2011","Thanet 015B","E01024647","Total",681,649,32
"2011","Thanet 015C","E01024668","Total",514,485,29
"2011","Thanet 015D","E01024670","Total",748,687,61
"2011","Thanet 015E","E01024681","Total",730,697,33
"2011","Thanet 016A","E01024646","Total",1093,943,150
"2011","Thanet 016B","E01024648","Total",786,715,71
"2011","Thanet 016C","E01024649","Total",1102,913,189
"2011","Thanet 016D","E01024667","Total",1099,972,127
"2011","Thanet 016E","E01024671","Total",1099,912,187
"2011","Thanet 017A","E01024650","Total",663,626,37
"2011","Thanet 017B","E01024651","Total",742,685,57
"2011","Thanet 017C","E01024652","Total",806,772,34
"2011","Thanet 017D","E01024679","Total",635,621,14
"2011","Thanet 017E","E01024680","Total",717,703,14
"2011","Tonbridge and Malling 001A","E01024719","Total",812,780,32
"2011","Tonbridge and Malling 001B","E01024720","Total",560,542,18
"2011","Tonbridge and Malling 001C","E01024721","Total",535,507,28
"2011","Tonbridge and Malling 001D","E01024722","Total",564,556,8
"2011","Tonbridge and Malling 001E","E01024727","Total",1174,1106,68
"2011","Tonbridge and Malling 001F","E01024728","Total",705,676,29
"2011","Tonbridge and Malling 002C","E01024771","Total",808,764,44
"2011","Tonbridge and Malling 002D","E01024772","Total",668,650,18
"2011","Tonbridge and Malling 002E","E01024773","Total",752,736,16
"2011","Tonbridge and Malling 002F","E01024774","Total",1208,1127,81
"2011","Tonbridge and Malling 002G","E01032830","Total",1038,1011,27
"2011","Tonbridge and Malling 003A","E01024741","Total",565,557,8
"2011","Tonbridge and Malling 003B","E01024761","Total",905,884,21
"2011","Tonbridge and Malling 003C","E01024762","Total",852,826,26
"2011","Tonbridge and Malling 003D","E01024763","Total",532,529,3
"2011","Tonbridge and Malling 003E","E01024764","Total",528,517,11
"2011","Tonbridge and Malling 003F","E01024765","Total",530,523,7
"2011","Tonbridge and Malling 003G","E01024782","Total",492,481,11
"2011","Tonbridge and Malling 003H","E01024785","Total",631,615,16
"2011","Tonbridge and Malling 005A","E01024717","Total",707,689,18
"2011","Tonbridge and Malling 005B","E01024718","Total",530,522,8
"2011","Tonbridge and Malling 005C","E01024735","Total",622,608,14
"2011","Tonbridge and Malling 005D","E01024736","Total",721,704,17
"2011","Tonbridge and Malling 005E","E01024737","Total",977,937,40
"2011","Tonbridge and Malling 006A","E01024723","Total",677,625,52
"2011","Tonbridge and Malling 006B","E01024724","Total",802,769,33
"2011","Tonbridge and Malling 006C","E01024725","Total",685,656,29
"2011","Tonbridge and Malling 006D","E01024726","Total",766,738,28
"2011","Tonbridge and Malling 006E","E01024755","Total",805,763,42
"2011","Tonbridge and Malling 006F","E01024786","Total",819,782,37
"2011","Tonbridge and Malling 007A","E01024746","Total",460,427,33
"2011","Tonbridge and Malling 007C","E01024760","Total",556,538,18
"2011","Tonbridge and Malling 007D","E01024781","Total",858,810,48
"2011","Tonbridge and Malling 007E","E01032825","Total",587,564,23
"2011","Tonbridge and Malling 007F","E01032826","Total",590,572,18
"2011","Tonbridge and Malling 007G","E01032827","Total",595,571,24
"2011","Tonbridge and Malling 007H","E01032828","Total",450,438,12
"2011","Tonbridge and Malling 008A","E01024743","Total",783,753,30
"2011","Tonbridge and Malling 008B","E01024744","Total",813,793,20
"2011","Tonbridge and Malling 008C","E01024745","Total",755,723,32
"2011","Tonbridge and Malling 008D","E01024747","Total",660,646,14
"2011","Tonbridge and Malling 009A","E01024730","Total",567,548,19
"2011","Tonbridge and Malling 009B","E01024731","Total",495,472,23
"2011","Tonbridge and Malling 009C","E01024775","Total",659,641,18
"2011","Tonbridge and Malling 009D","E01024776","Total",518,509,9
"2011","Tonbridge and Malling 009E","E01024777","Total",515,507,8
"2011","Tonbridge and Malling 010A","E01024734","Total",691,666,25
"2011","Tonbridge and Malling 010B","E01024752","Total",658,639,19
"2011","Tonbridge and Malling 010C","E01024753","Total",640,621,19
"2011","Tonbridge and Malling 010D","E01024754","Total",664,624,40
"2011","Tonbridge and Malling 011A","E01024729","Total",737,712,25
"2011","Tonbridge and Malling 011B","E01024748","Total",542,534,8
"2011","Tonbridge and Malling 011C","E01024749","Total",628,622,6
"2011","Tonbridge and Malling 011D","E01024750","Total",640,630,10
"2011","Tonbridge and Malling 011E","E01024751","Total",654,647,7
"2011","Tonbridge and Malling 012A","E01024732","Total",708,662,46
"2011","Tonbridge and Malling 012B","E01024733","Total",729,704,25
"2011","Tonbridge and Malling 012C","E01024756","Total",651,639,12
"2011","Tonbridge and Malling 012D","E01024766","Total",986,915,71
"2011","Tonbridge and Malling 012E","E01024767","Total",552,546,6
"2011","Tonbridge and Malling 012F","E01024768","Total",789,744,45
"2011","Tonbridge and Malling 013A","E01024757","Total",702,684,18
"2011","Tonbridge and Malling 013B","E01024758","Total",634,625,9
"2011","Tonbridge and Malling 013C","E01024778","Total",674,650,24
"2011","Tonbridge and Malling 013D","E01024779","Total",815,775,40
"2011","Tonbridge and Malling 013E","E01024780","Total",606,598,8
"2011","Tonbridge and Malling 014A","E01024740","Total",790,752,38
"2011","Tonbridge and Malling 014B","E01024742","Total",718,705,13
"2011","Tonbridge and Malling 014C","E01024783","Total",770,726,44
"2011","Tonbridge and Malling 014D","E01024784","Total",625,583,42
"2011","Tonbridge and Malling 014E","E01032620","Total",976,904,72
"2011","Tonbridge and Malling 014F","E01032829","Total",574,541,33
"2011","Tunbridge Wells 001A","E01024798","Total",954,918,36
"2011","Tunbridge Wells 001B","E01024811","Total",489,481,8
"2011","Tunbridge Wells 001C","E01024812","Total",520,501,19
"2011","Tunbridge Wells 001D","E01024813","Total",852,789,63
"2011","Tunbridge Wells 001E","E01024814","Total",521,512,9
"2011","Tunbridge Wells 001F","E01024815","Total",506,501,5
"2011","Tunbridge Wells 001G","E01024816","Total",502,496,6
"2011","Tunbridge Wells 002A","E01024837","Total",659,651,8
"2011","Tunbridge Wells 002B","E01024844","Total",677,660,17
"2011","Tunbridge Wells 002C","E01024846","Total",664,641,23
"2011","Tunbridge Wells 002D","E01024849","Total",700,670,30
"2011","Tunbridge Wells 002E","E01024850","Total",481,475,6
"2011","Tunbridge Wells 003A","E01024836","Total",724,710,14
"2011","Tunbridge Wells 003B","E01024839","Total",758,743,15
"2011","Tunbridge Wells 003C","E01024845","Total",538,529,9
"2011","Tunbridge Wells 003D","E01024847","Total",714,700,14
"2011","Tunbridge Wells 003E","E01024848","Total",653,636,17
"2011","Tunbridge Wells 004A","E01024793","Total",703,677,26
"2011","Tunbridge Wells 004B","E01024825","Total",535,522,13
"2011","Tunbridge Wells 004C","E01024826","Total",644,626,18
"2011","Tunbridge Wells 004D","E01024827","Total",624,614,10
"2011","Tunbridge Wells 004E","E01024828","Total",656,638,18
"2011","Tunbridge Wells 005A","E01024840","Total",721,696,25
"2011","Tunbridge Wells 005B","E01024841","Total",879,856,23
"2011","Tunbridge Wells 005C","E01024842","Total",722,706,16
"2011","Tunbridge Wells 005D","E01024843","Total",586,581,5
"2011","Tunbridge Wells 006A","E01024829","Total",667,654,13
"2011","Tunbridge Wells 006B","E01024851","Total",681,666,15
"2011","Tunbridge Wells 006C","E01024852","Total",515,505,10
"2011","Tunbridge Wells 006D","E01024853","Total",558,538,20
"2011","Tunbridge Wells 006E","E01024854","Total",617,594,23
"2011","Tunbridge Wells 007A","E01024799","Total",987,937,50
"2011","Tunbridge Wells 007B","E01024800","Total",676,657,19
"2011","Tunbridge Wells 007C","E01024835","Total",853,830,23
"2011","Tunbridge Wells 007D","E01024838","Total",692,673,19
"2011","Tunbridge Wells 008A","E01024801","Total",1490,1405,85
"2011","Tunbridge Wells 008B","E01024802","Total",1132,1082,50
"2011","Tunbridge Wells 008C","E01024823","Total",981,896,85
"2011","Tunbridge Wells 008D","E01024833","Total",1382,1247,135
"2011","Tunbridge Wells 009A","E01024821","Total",1026,970,56
"2011","Tunbridge Wells 009B","E01024822","Total",910,844,66
"2011","Tunbridge Wells 009C","E01024824","Total",631,617,14
"2011","Tunbridge Wells 009D","E01024832","Total",704,674,30
"2011","Tunbridge Wells 009E","E01024834","Total",954,923,31
"2011","Tunbridge Wells 010A","E01024795","Total",630,591,39
"2011","Tunbridge Wells 010B","E01024796","Total",641,629,12
"2011","Tunbridge Wells 010C","E01024830","Total",870,804,66
"2011","Tunbridge Wells 010D","E01024831","Total",640,618,22
"2011","Tunbridge Wells 011A","E01024792","Total",723,697,26
"2011","Tunbridge Wells 011B","E01024794","Total",682,662,20
"2011","Tunbridge Wells 011C","E01024804","Total",587,546,41
"2011","Tunbridge Wells 011D","E01024805","Total",702,667,35
"2011","Tunbridge Wells 011E","E01024806","Total",668,641,27
"2011","Tunbridge Wells 012A","E01024797","Total",759,743,16
"2011","Tunbridge Wells 012B","E01024817","Total",777,755,22
"2011","Tunbridge Wells 012C","E01024818","Total",746,716,30
"2011","Tunbridge Wells 012D","E01024819","Total",924,859,65
"2011","Tunbridge Wells 012E","E01024820","Total",681,661,20
"2011","Tunbridge Wells 013A","E01024787","Total",481,459,22
"2011","Tunbridge Wells 013B","E01024788","Total",616,606,10
"2011","Tunbridge Wells 013C","E01024790","Total",541,500,41
"2011","Tunbridge Wells 013D","E01024791","Total",563,549,14
"2011","Tunbridge Wells 013E","E01024803","Total",897,847,50
"2011","Tunbridge Wells 014A","E01024789","Total",842,803,39
"2011","Tunbridge Wells 014B","E01024807","Total",696,675,21
"2011","Tunbridge Wells 014C","E01024808","Total",740,709,31
"2011","Tunbridge Wells 014D","E01024809","Total",603,583,20
"2011","Tunbridge Wells 014E","E01024810","Total",638,613,25
"2011","Cherwell 001A","E01028479","Total",581,552,29
"2011","Cherwell 001B","E01028480","Total",671,609,62
"2011","Cherwell 001C","E01028508","Total",474,442,32
"2011","Cherwell 001D","E01028509","Total",680,645,35
"2011","Cherwell 002A","E01028441","Total",1022,997,25
"2011","Cherwell 002C","E01028443","Total",592,586,6
"2011","Cherwell 002D","E01028444","Total",591,586,5
"2011","Cherwell 002E","E01032943","Total",629,623,6
"2011","Cherwell 002F","E01032944","Total",632,612,20
"2011","Cherwell 003A","E01028445","Total",517,510,7
"2011","Cherwell 003B","E01028446","Total",643,619,24
"2011","Cherwell 003C","E01028447","Total",573,541,32
"2011","Cherwell 003D","E01028448","Total",649,631,18
"2011","Cherwell 004A","E01028435","Total",1064,922,142
"2011","Cherwell 004C","E01028437","Total",585,568,17
"2011","Cherwell 004D","E01028438","Total",847,773,74
"2011","Cherwell 004E","E01028439","Total",579,569,10
"2011","Cherwell 004F","E01028440","Total",774,734,40
"2011","Cherwell 004G","E01032941","Total",652,629,23
"2011","Cherwell 004H","E01032942","Total",687,657,30
"2011","Cherwell 005A","E01028449","Total",548,529,19
"2011","Cherwell 005B","E01028450","Total",539,533,6
"2011","Cherwell 005C","E01028451","Total",484,478,6
"2011","Cherwell 005D","E01028452","Total",509,493,16
"2011","Cherwell 005E","E01028453","Total",504,498,6
"2011","Cherwell 005F","E01028454","Total",626,608,18
"2011","Cherwell 006A","E01028430","Total",709,659,50
"2011","Cherwell 006B","E01028431","Total",668,650,18
"2011","Cherwell 006C","E01028432","Total",658,637,21
"2011","Cherwell 006D","E01028433","Total",763,751,12
"2011","Cherwell 006E","E01028434","Total",529,513,16
"2011","Cherwell 007A","E01028426","Total",572,562,10
"2011","Cherwell 007B","E01028427","Total",713,668,45
"2011","Cherwell 007C","E01028428","Total",526,518,8
"2011","Cherwell 007D","E01028429","Total",490,471,19
"2011","Cherwell 008A","E01028422","Total",648,621,27
"2011","Cherwell 008B","E01028423","Total",636,612,24
"2011","Cherwell 008C","E01028475","Total",906,872,34
"2011","Cherwell 008D","E01028476","Total",905,870,35
"2011","Cherwell 009A","E01028474","Total",708,657,51
"2011","Cherwell 009B","E01028485","Total",555,531,24
"2011","Cherwell 009C","E01028486","Total",599,540,59
"2011","Cherwell 009D","E01028503","Total",528,496,32
"2011","Cherwell 009E","E01028504","Total",636,590,46
"2011","Cherwell 010A","E01028481","Total",644,617,27
"2011","Cherwell 010B","E01028482","Total",512,490,22
"2011","Cherwell 010C","E01028505","Total",747,713,34
"2011","Cherwell 010D","E01028506","Total",761,721,40
"2011","Cherwell 010E","E01028507","Total",613,582,31
"2011","Cherwell 011A","E01028425","Total",734,687,47
"2011","Cherwell 011B","E01028477","Total",603,581,22
"2011","Cherwell 011C","E01028478","Total",542,483,59
"2011","Cherwell 011D","E01028483","Total",531,501,30
"2011","Cherwell 011E","E01028484","Total",480,455,25
"2011","Cherwell 011F","E01028499","Total",638,618,20
"2011","Cherwell 012A","E01028459","Total",667,652,15
"2011","Cherwell 012B","E01028460","Total",734,726,8
"2011","Cherwell 012C","E01028461","Total",686,678,8
"2011","Cherwell 012D","E01028462","Total",639,627,12
"2011","Cherwell 013A","E01028455","Total",540,529,11
"2011","Cherwell 013B","E01028456","Total",612,601,11
"2011","Cherwell 013C","E01028457","Total",508,503,5
"2011","Cherwell 013D","E01028458","Total",620,613,7
"2011","Cherwell 013E","E01028467","Total",725,704,21
"2011","Cherwell 014A","E01028466","Total",705,690,15
"2011","Cherwell 014B","E01028469","Total",612,596,16
"2011","Cherwell 014C","E01028470","Total",690,676,14
"2011","Cherwell 014D","E01028471","Total",488,481,7
"2011","Cherwell 014E","E01028472","Total",486,481,5
"2011","Cherwell 014F","E01028473","Total",614,607,7
"2011","Cherwell 015A","E01028463","Total",1052,1029,23
"2011","Cherwell 015B","E01028464","Total",585,576,9
"2011","Cherwell 015C","E01028465","Total",540,531,9
"2011","Cherwell 015D","E01028468","Total",1075,986,89
"2011","Cherwell 016A","E01028424","Total",665,639,26
"2011","Cherwell 016B","E01028497","Total",630,589,41
"2011","Cherwell 016C","E01028498","Total",678,638,40
"2011","Cherwell 016D","E01028500","Total",520,505,15
"2011","Cherwell 016E","E01028501","Total",497,467,30
"2011","Cherwell 016F","E01028502","Total",522,497,25
"2011","Cherwell 017A","E01028487","Total",543,532,11
"2011","Cherwell 017B","E01028489","Total",646,617,29
"2011","Cherwell 017C","E01028490","Total",517,496,21
"2011","Cherwell 017D","E01028491","Total",693,665,28
"2011","Cherwell 017E","E01028494","Total",468,458,10
"2011","Cherwell 018A","E01028492","Total",632,600,32
"2011","Cherwell 018B","E01028493","Total",543,531,12
"2011","Cherwell 018C","E01028495","Total",528,517,11
"2011","Cherwell 018D","E01028496","Total",524,501,23
"2011","Cherwell 019A","E01028488","Total",644,625,19
"2011","Cherwell 019B","E01028510","Total",677,636,41
"2011","Cherwell 019C","E01028511","Total",751,716,35
"2011","Cherwell 019D","E01028512","Total",617,603,14
"2011","Oxford 001A","E01028594","Total",695,661,34
"2011","Oxford 001B","E01028595","Total",637,622,15
"2011","Oxford 001C","E01028596","Total",713,673,40
"2011","Oxford 001D","E01028597","Total",655,637,18
"2011","Oxford 002C","E01028591","Total",587,548,39
"2011","Oxford 002D","E01028592","Total",536,504,32
"2011","Oxford 002F","E01032554","Total",1061,991,70
"2011","Oxford 002G","E01032555","Total",826,792,34
"2011","Oxford 003A","E01028565","Total",549,511,38
"2011","Oxford 003B","E01028583","Total",472,443,29
"2011","Oxford 003C","E01028584","Total",1175,1101,74
"2011","Oxford 003D","E01028585","Total",448,403,45
"2011","Oxford 004A","E01028560","Total",702,672,30
"2011","Oxford 004B","E01028561","Total",656,645,11
"2011","Oxford 004C","E01028562","Total",644,612,32
"2011","Oxford 004D","E01028563","Total",616,587,29
"2011","Oxford 005A","E01028513","Total",943,929,14
"2011","Oxford 005B","E01028514","Total",553,551,2
"2011","Oxford 005C","E01028516","Total",725,703,22
"2011","Oxford 005D","E01028538","Total",642,630,12
"2011","Oxford 006A","E01028534","Total",477,459,18
"2011","Oxford 006B","E01028535","Total",688,661,27
"2011","Oxford 006C","E01028536","Total",646,627,19
"2011","Oxford 006D","E01028537","Total",858,809,49
"2011","Oxford 006E","E01028539","Total",686,666,20
"2011","Oxford 006F","E01028540","Total",574,550,24
"2011","Oxford 007A","E01028515","Total",687,667,20
"2011","Oxford 007B","E01028571","Total",699,676,23
"2011","Oxford 007C","E01028572","Total",685,669,16
"2011","Oxford 007D","E01028573","Total",686,674,12
"2011","Oxford 007E","E01028574","Total",628,620,8
"2011","Oxford 008A","E01028521","Total",805,668,137
"2011","Oxford 008B","E01028522","Total",824,746,78
"2011","Oxford 008E","E01033282","Total",1426,1291,135
"2011","Oxford 009A","E01028548","Total",801,760,41
"2011","Oxford 009B","E01028549","Total",824,778,46
"2011","Oxford 009C","E01028550","Total",742,695,47
"2011","Oxford 009D","E01028551","Total",690,623,67
"2011","Oxford 010A","E01028523","Total",662,638,24
"2011","Oxford 010B","E01028524","Total",638,632,6
"2011","Oxford 010C","E01028525","Total",714,706,8
"2011","Oxford 010D","E01028526","Total",570,551,19
"2011","Oxford 011A","E01028579","Total",552,529,23
"2011","Oxford 011B","E01028580","Total",602,573,29
"2011","Oxford 011C","E01028581","Total",502,484,18
"2011","Oxford 011D","E01028582","Total",630,588,42
"2011","Oxford 011E","E01028586","Total",727,684,43
"2011","Oxford 011F","E01028587","Total",797,755,42
"2011","Oxford 011G","E01028588","Total",508,467,41
"2011","Oxford 012A","E01028541","Total",638,616,22
"2011","Oxford 012B","E01028542","Total",773,755,18
"2011","Oxford 012C","E01028543","Total",645,621,24
"2011","Oxford 012D","E01028544","Total",662,600,62
"2011","Oxford 013A","E01028531","Total",887,867,20
"2011","Oxford 013B","E01028532","Total",1037,1004,33
"2011","Oxford 013C","E01028533","Total",858,820,38
"2011","Oxford 013D","E01028556","Total",706,696,10
"2011","Oxford 013E","E01028557","Total",708,699,9
"2011","Oxford 013F","E01028558","Total",598,588,10
"2011","Oxford 013G","E01028559","Total",661,643,18
"2011","Oxford 014A","E01028545","Total",659,612,47
"2011","Oxford 014B","E01028546","Total",764,745,19
"2011","Oxford 014C","E01028547","Total",854,830,24
"2011","Oxford 015A","E01028527","Total",697,685,12
"2011","Oxford 015B","E01028528","Total",558,537,21
"2011","Oxford 015C","E01028529","Total",640,632,8
"2011","Oxford 015D","E01028530","Total",651,633,18
"2011","Oxford 015E","E01028575","Total",706,675,31
"2011","Oxford 015F","E01028578","Total",655,638,17
"2011","Oxford 016A","E01028552","Total",742,731,11
"2011","Oxford 016B","E01028553","Total",774,752,22
"2011","Oxford 016C","E01028554","Total",558,546,12
"2011","Oxford 016D","E01028555","Total",679,665,14
"2011","Oxford 016E","E01028576","Total",503,489,14
"2011","Oxford 016F","E01028577","Total",783,753,30
"2011","Oxford 017A","E01028517","Total",516,509,7
"2011","Oxford 017B","E01028518","Total",686,676,10
"2011","Oxford 017C","E01028519","Total",555,544,11
"2011","Oxford 017D","E01028567","Total",665,661,4
"2011","Oxford 018A","E01028520","Total",637,632,5
"2011","Oxford 018B","E01028568","Total",626,623,3
"2011","Oxford 018C","E01028569","Total",666,664,2
"2011","Oxford 018D","E01028570","Total",785,773,12
"2011","South Oxfordshire 001A","E01028666","Total",715,685,30
"2011","South Oxfordshire 001B","E01028667","Total",537,525,12
"2011","South Oxfordshire 001C","E01028668","Total",558,552,6
"2011","South Oxfordshire 001D","E01028669","Total",558,539,19
"2011","South Oxfordshire 002A","E01028638","Total",607,563,44
"2011","South Oxfordshire 002B","E01028639","Total",529,500,29
"2011","South Oxfordshire 002C","E01028640","Total",610,583,27
"2011","South Oxfordshire 002D","E01028683","Total",597,568,29
"2011","South Oxfordshire 003A","E01028670","Total",564,554,10
"2011","South Oxfordshire 003B","E01028671","Total",705,669,36
"2011","South Oxfordshire 003C","E01028672","Total",720,695,25
"2011","South Oxfordshire 003D","E01028673","Total",520,504,16
"2011","South Oxfordshire 004A","E01028646","Total",512,466,46
"2011","South Oxfordshire 004B","E01028647","Total",664,617,47
"2011","South Oxfordshire 004C","E01028681","Total",531,522,9
"2011","South Oxfordshire 004D","E01028682","Total",519,503,16
"2011","South Oxfordshire 004E","E01028684","Total",652,637,15
"2011","South Oxfordshire 005A","E01028598","Total",1014,951,63
"2011","South Oxfordshire 005B","E01028613","Total",529,523,6
"2011","South Oxfordshire 005C","E01028614","Total",624,601,23
"2011","South Oxfordshire 005D","E01028615","Total",694,677,17
"2011","South Oxfordshire 005E","E01028616","Total",542,533,9
"2011","South Oxfordshire 006A","E01028604","Total",562,552,10
"2011","South Oxfordshire 006B","E01028605","Total",654,637,17
"2011","South Oxfordshire 006C","E01028607","Total",521,496,25
"2011","South Oxfordshire 006D","E01028641","Total",543,503,40
"2011","South Oxfordshire 006E","E01028657","Total",562,548,14
"2011","South Oxfordshire 006F","E01028658","Total",513,490,23
"2011","South Oxfordshire 007A","E01028600","Total",646,629,17
"2011","South Oxfordshire 007B","E01028603","Total",481,458,23
"2011","South Oxfordshire 007C","E01028606","Total",795,756,39
"2011","South Oxfordshire 007D","E01028609","Total",500,490,10
"2011","South Oxfordshire 007E","E01028610","Total",620,601,19
"2011","South Oxfordshire 008A","E01028678","Total",701,631,70
"2011","South Oxfordshire 008B","E01028679","Total",905,853,52
"2011","South Oxfordshire 008C","E01028680","Total",815,768,47
"2011","South Oxfordshire 009A","E01028625","Total",780,772,8
"2011","South Oxfordshire 009B","E01028626","Total",625,618,7
"2011","South Oxfordshire 009C","E01028627","Total",626,611,15
"2011","South Oxfordshire 009D","E01028628","Total",549,540,9
"2011","South Oxfordshire 009E","E01028629","Total",644,632,12
"2011","South Oxfordshire 010A","E01028621","Total",532,508,24
"2011","South Oxfordshire 010B","E01028622","Total",537,529,8
"2011","South Oxfordshire 010C","E01028623","Total",691,656,35
"2011","South Oxfordshire 010D","E01028624","Total",594,572,22
"2011","South Oxfordshire 011A","E01028599","Total",632,598,34
"2011","South Oxfordshire 011B","E01028601","Total",513,469,44
"2011","South Oxfordshire 011C","E01028602","Total",563,519,44
"2011","South Oxfordshire 011D","E01028620","Total",1016,973,43
"2011","South Oxfordshire 012A","E01028608","Total",479,465,14
"2011","South Oxfordshire 012B","E01028617","Total",815,789,26
"2011","South Oxfordshire 012C","E01028674","Total",552,542,10
"2011","South Oxfordshire 012D","E01028675","Total",519,505,14
"2011","South Oxfordshire 012E","E01028676","Total",851,826,25
"2011","South Oxfordshire 012F","E01028677","Total",841,774,67
"2011","South Oxfordshire 013A","E01028630","Total",714,703,11
"2011","South Oxfordshire 013B","E01028631","Total",488,458,30
"2011","South Oxfordshire 013C","E01028632","Total",545,534,11
"2011","South Oxfordshire 013D","E01028633","Total",722,689,33
"2011","South Oxfordshire 014A","E01028634","Total",518,509,9
"2011","South Oxfordshire 014B","E01028635","Total",627,616,11
"2011","South Oxfordshire 014C","E01028636","Total",585,566,19
"2011","South Oxfordshire 014D","E01028637","Total",624,620,4
"2011","South Oxfordshire 015A","E01028618","Total",733,702,31
"2011","South Oxfordshire 015B","E01028619","Total",759,740,19
"2011","South Oxfordshire 015C","E01028644","Total",767,701,66
"2011","South Oxfordshire 015D","E01028648","Total",486,472,14
"2011","South Oxfordshire 015E","E01028649","Total",623,595,28
"2011","South Oxfordshire 016A","E01028650","Total",857,820,37
"2011","South Oxfordshire 016B","E01028651","Total",807,754,53
"2011","South Oxfordshire 016C","E01028652","Total",1185,1042,143
"2011","South Oxfordshire 017A","E01028653","Total",680,633,47
"2011","South Oxfordshire 017B","E01028654","Total",648,615,33
"2011","South Oxfordshire 017C","E01028655","Total",964,860,104
"2011","South Oxfordshire 017D","E01028656","Total",546,533,13
"2011","South Oxfordshire 018A","E01028611","Total",479,445,34
"2011","South Oxfordshire 018B","E01028642","Total",526,492,34
"2011","South Oxfordshire 018C","E01028643","Total",582,560,22
"2011","South Oxfordshire 018D","E01028645","Total",671,627,44
"2011","South Oxfordshire 018E","E01028685","Total",515,485,30
"2011","South Oxfordshire 018F","E01028686","Total",497,473,24
"2011","South Oxfordshire 019A","E01028612","Total",567,511,56
"2011","South Oxfordshire 019B","E01028660","Total",740,687,53
"2011","South Oxfordshire 019C","E01028661","Total",613,577,36
"2011","South Oxfordshire 019D","E01028662","Total",540,503,37
"2011","South Oxfordshire 020A","E01028659","Total",644,624,20
"2011","South Oxfordshire 020B","E01028663","Total",632,611,21
"2011","South Oxfordshire 020C","E01028664","Total",558,543,15
"2011","South Oxfordshire 020D","E01028665","Total",543,527,16
"2011","Vale of White Horse 001A","E01028708","Total",782,747,35
"2011","Vale of White Horse 001B","E01028709","Total",677,658,19
"2011","Vale of White Horse 001C","E01028710","Total",675,667,8
"2011","Vale of White Horse 001D","E01028711","Total",691,667,24
"2011","Vale of White Horse 002A","E01028733","Total",569,547,22
"2011","Vale of White Horse 002B","E01028734","Total",668,655,13
"2011","Vale of White Horse 002C","E01028735","Total",648,641,7
"2011","Vale of White Horse 002D","E01028740","Total",672,657,15
"2011","Vale of White Horse 002E","E01028741","Total",514,502,12
"2011","Vale of White Horse 002F","E01028742","Total",759,726,33
"2011","Vale of White Horse 003A","E01028738","Total",515,474,41
"2011","Vale of White Horse 003B","E01028739","Total",730,699,31
"2011","Vale of White Horse 003C","E01028743","Total",487,478,9
"2011","Vale of White Horse 003D","E01028744","Total",532,524,8
"2011","Vale of White Horse 003E","E01028750","Total",602,589,13
"2011","Vale of White Horse 003F","E01028751","Total",627,585,42
"2011","Vale of White Horse 003G","E01028752","Total",677,656,21
"2011","Vale of White Horse 004A","E01028693","Total",608,603,5
"2011","Vale of White Horse 004B","E01028694","Total",622,607,15
"2011","Vale of White Horse 004C","E01028701","Total",646,638,8
"2011","Vale of White Horse 004D","E01028705","Total",499,490,9
"2011","Vale of White Horse 004E","E01028706","Total",611,599,12
"2011","Vale of White Horse 004F","E01028707","Total",612,607,5
"2011","Vale of White Horse 005A","E01028688","Total",514,507,7
"2011","Vale of White Horse 005B","E01028689","Total",655,637,18
"2011","Vale of White Horse 005C","E01028695","Total",667,656,11
"2011","Vale of White Horse 005D","E01028699","Total",663,650,13
"2011","Vale of White Horse 006B","E01028696","Total",533,519,14
"2011","Vale of White Horse 006C","E01028697","Total",688,674,14
"2011","Vale of White Horse 006D","E01028698","Total",692,669,23
"2011","Vale of White Horse 006E","E01028700","Total",706,699,7
"2011","Vale of White Horse 006F","E01028703","Total",847,816,31
"2011","Vale of White Horse 006G","E01033305","Total",694,664,30
"2011","Vale of White Horse 006H","E01033306","Total",850,804,46
"2011","Vale of White Horse 007A","E01028726","Total",967,929,38
"2011","Vale of White Horse 007B","E01028736","Total",950,935,15
"2011","Vale of White Horse 007C","E01028737","Total",1005,948,57
"2011","Vale of White Horse 008A","E01028690","Total",731,712,19
"2011","Vale of White Horse 008B","E01028691","Total",615,611,4
"2011","Vale of White Horse 008C","E01028692","Total",519,507,12
"2011","Vale of White Horse 008D","E01028702","Total",520,518,2
"2011","Vale of White Horse 008E","E01028704","Total",888,853,35
"2011","Vale of White Horse 009A","E01028716","Total",772,749,23
"2011","Vale of White Horse 009B","E01028717","Total",872,820,52
"2011","Vale of White Horse 009C","E01028718","Total",635,609,26
"2011","Vale of White Horse 009D","E01028719","Total",666,654,12
"2011","Vale of White Horse 009E","E01028749","Total",1024,990,34
"2011","Vale of White Horse 010A","E01028714","Total",978,958,20
"2011","Vale of White Horse 010B","E01028731","Total",548,542,6
"2011","Vale of White Horse 010C","E01028732","Total",518,502,16
"2011","Vale of White Horse 010D","E01028753","Total",597,585,12
"2011","Vale of White Horse 010E","E01028754","Total",592,569,23
"2011","Vale of White Horse 011A","E01028721","Total",521,517,4
"2011","Vale of White Horse 011B","E01028722","Total",707,690,17
"2011","Vale of White Horse 011C","E01028723","Total",592,590,2
"2011","Vale of White Horse 011D","E01028724","Total",508,505,3
"2011","Vale of White Horse 011E","E01028725","Total",623,616,7
"2011","Vale of White Horse 014A","E01028755","Total",701,686,15
"2011","Vale of White Horse 014B","E01028756","Total",1258,1167,91
"2011","Vale of White Horse 014C","E01028758","Total",624,609,15
"2011","Vale of White Horse 014D","E01028759","Total",628,623,5
"2011","Vale of White Horse 014E","E01028760","Total",485,479,6
"2011","Vale of White Horse 014F","E01028761","Total",512,510,2
"2011","Vale of White Horse 015A","E01028712","Total",900,880,20
"2011","Vale of White Horse 015B","E01028727","Total",679,661,18
"2011","Vale of White Horse 015C","E01028728","Total",486,479,7
"2011","Vale of White Horse 015D","E01028729","Total",442,437,5
"2011","Vale of White Horse 015E","E01028730","Total",673,648,25
"2011","Vale of White Horse 015F","E01028757","Total",659,643,16
"2011","Vale of White Horse 016E","E01028713","Total",1033,972,61
"2011","Vale of White Horse 016F","E01028715","Total",587,554,33
"2011","Vale of White Horse 016G","E01028720","Total",972,910,62
"2011","Vale of White Horse 016A","E01028745","Total",581,546,35
"2011","Vale of White Horse 016B","E01028746","Total",529,510,19
"2011","Vale of White Horse 016C","E01028747","Total",522,450,72
"2011","Vale of White Horse 016D","E01028748","Total",485,423,62
"2011","West Oxfordshire 001A","E01028780","Total",966,909,57
"2011","West Oxfordshire 001B","E01028781","Total",549,516,33
"2011","West Oxfordshire 001C","E01028782","Total",685,643,42
"2011","West Oxfordshire 001D","E01028783","Total",809,747,62
"2011","West Oxfordshire 002A","E01028795","Total",774,658,116
"2011","West Oxfordshire 002B","E01028796","Total",588,518,70
"2011","West Oxfordshire 002C","E01028797","Total",501,453,48
"2011","West Oxfordshire 002D","E01028806","Total",870,816,54
"2011","West Oxfordshire 003A","E01028763","Total",963,831,132
"2011","West Oxfordshire 003B","E01028776","Total",917,809,108
"2011","West Oxfordshire 003C","E01028798","Total",980,871,109
"2011","West Oxfordshire 004B","E01028804","Total",569,544,25
"2011","West Oxfordshire 004D","E01028823","Total",699,634,65
"2011","West Oxfordshire 004E","E01028824","Total",690,664,26
"2011","West Oxfordshire 004F","E01028825","Total",533,497,36
"2011","West Oxfordshire 004G","E01032954","Total",1202,1130,72
"2011","West Oxfordshire 005A","E01028777","Total",582,530,52
"2011","West Oxfordshire 005B","E01028778","Total",685,658,27
"2011","West Oxfordshire 005C","E01028779","Total",470,452,18
"2011","West Oxfordshire 005D","E01028799","Total",812,779,33
"2011","West Oxfordshire 006A","E01028788","Total",737,700,37
"2011","West Oxfordshire 006B","E01028789","Total",626,605,21
"2011","West Oxfordshire 006C","E01028790","Total",472,465,7
"2011","West Oxfordshire 006D","E01028791","Total",601,587,14
"2011","West Oxfordshire 007A","E01028784","Total",876,853,23
"2011","West Oxfordshire 007B","E01028792","Total",484,459,25
"2011","West Oxfordshire 007C","E01028793","Total",654,620,34
"2011","West Oxfordshire 007D","E01028794","Total",612,578,34
"2011","West Oxfordshire 008A","E01028810","Total",595,587,8
"2011","West Oxfordshire 008B","E01028811","Total",602,592,10
"2011","West Oxfordshire 008D","E01028813","Total",497,489,8
"2011","West Oxfordshire 008E","E01028814","Total",626,606,20
"2011","West Oxfordshire 008F","E01028815","Total",506,497,9
"2011","West Oxfordshire 008G","E01032947","Total",701,693,8
"2011","West Oxfordshire 008H","E01032948","Total",715,706,9
"2011","West Oxfordshire 008I","E01032952","Total",644,620,24
"2011","West Oxfordshire 009A","E01028809","Total",528,522,6
"2011","West Oxfordshire 009B","E01028820","Total",529,525,4
"2011","West Oxfordshire 009C","E01028821","Total",633,626,7
"2011","West Oxfordshire 009D","E01028822","Total",588,578,10
"2011","West Oxfordshire 010A","E01028807","Total",1056,1005,51
"2011","West Oxfordshire 010B","E01028808","Total",742,725,17
"2011","West Oxfordshire 010C","E01028816","Total",496,491,5
"2011","West Oxfordshire 010D","E01028817","Total",604,591,13
"2011","West Oxfordshire 010E","E01028818","Total",879,836,43
"2011","West Oxfordshire 010F","E01028819","Total",744,732,12
"2011","West Oxfordshire 011A","E01028785","Total",675,658,17
"2011","West Oxfordshire 011B","E01028786","Total",527,518,9
"2011","West Oxfordshire 011C","E01028787","Total",576,542,34
"2011","West Oxfordshire 011D","E01028800","Total",541,518,23
"2011","West Oxfordshire 012A","E01028762","Total",849,749,100
"2011","West Oxfordshire 012B","E01028766","Total",903,834,69
"2011","West Oxfordshire 012C","E01028767","Total",1004,863,141
"2011","West Oxfordshire 013D","E01028772","Total",764,748,16
"2011","West Oxfordshire 013E","E01032949","Total",583,577,6
"2011","West Oxfordshire 013F","E01032950","Total",685,679,6
"2011","West Oxfordshire 013G","E01032951","Total",734,710,24
"2011","West Oxfordshire 013H","E01032953","Total",903,850,53
"2011","West Oxfordshire 014A","E01028771","Total",672,653,19
"2011","West Oxfordshire 014B","E01028773","Total",600,578,22
"2011","West Oxfordshire 014C","E01028774","Total",549,531,18
"2011","West Oxfordshire 014D","E01028775","Total",580,559,21
"2011","West Oxfordshire 015A","E01028764","Total",796,760,36
"2011","West Oxfordshire 015B","E01028765","Total",859,822,37
"2011","West Oxfordshire 015C","E01028801","Total",563,545,18
"2011","West Oxfordshire 015D","E01028802","Total",643,600,43
"2011","Elmbridge 001A","E01030330","Total",674,655,19
"2011","Elmbridge 001B","E01030331","Total",697,679,18
"2011","Elmbridge 001C","E01030332","Total",608,593,15
"2011","Elmbridge 001D","E01030333","Total",598,582,16
"2011","Elmbridge 002A","E01030326","Total",843,785,58
"2011","Elmbridge 002B","E01030327","Total",679,642,37
"2011","Elmbridge 002C","E01030328","Total",636,630,6
"2011","Elmbridge 002D","E01030329","Total",659,628,31
"2011","Elmbridge 003A","E01030334","Total",554,543,11
"2011","Elmbridge 003B","E01030335","Total",769,755,14
"2011","Elmbridge 003C","E01030336","Total",815,795,20
"2011","Elmbridge 003D","E01030337","Total",760,731,29
"2011","Elmbridge 004A","E01030361","Total",828,811,17
"2011","Elmbridge 004B","E01030362","Total",499,481,18
"2011","Elmbridge 004C","E01030363","Total",828,785,43
"2011","Elmbridge 004D","E01030364","Total",760,710,50
"2011","Elmbridge 005A","E01030350","Total",728,686,42
"2011","Elmbridge 005B","E01030351","Total",650,634,16
"2011","Elmbridge 005C","E01030352","Total",602,581,21
"2011","Elmbridge 005D","E01030353","Total",561,550,11
"2011","Elmbridge 006A","E01030322","Total",776,751,25
"2011","Elmbridge 006B","E01030323","Total",541,524,17
"2011","Elmbridge 006C","E01030324","Total",652,639,13
"2011","Elmbridge 006D","E01030325","Total",614,590,24
"2011","Elmbridge 007A","E01030357","Total",767,729,38
"2011","Elmbridge 007B","E01030358","Total",637,618,19
"2011","Elmbridge 007C","E01030359","Total",1150,1054,96
"2011","Elmbridge 007D","E01030360","Total",707,662,45
"2011","Elmbridge 008A","E01030354","Total",582,541,41
"2011","Elmbridge 008B","E01030355","Total",533,515,18
"2011","Elmbridge 008C","E01030356","Total",516,507,9
"2011","Elmbridge 008D","E01030365","Total",626,603,23
"2011","Elmbridge 008E","E01030368","Total",624,607,17
"2011","Elmbridge 009A","E01030319","Total",651,608,43
"2011","Elmbridge 009B","E01030320","Total",726,678,48
"2011","Elmbridge 009C","E01030321","Total",587,573,14
"2011","Elmbridge 009D","E01030369","Total",787,775,12
"2011","Elmbridge 009E","E01030370","Total",608,592,16
"2011","Elmbridge 010A","E01030313","Total",673,644,29
"2011","Elmbridge 010B","E01030314","Total",694,645,49
"2011","Elmbridge 010C","E01030366","Total",865,815,50
"2011","Elmbridge 010D","E01030367","Total",646,618,28
"2011","Elmbridge 011A","E01030338","Total",657,619,38
"2011","Elmbridge 011B","E01030339","Total",736,683,53
"2011","Elmbridge 011C","E01030340","Total",666,620,46
"2011","Elmbridge 011D","E01030341","Total",781,740,41
"2011","Elmbridge 012A","E01030371","Total",744,711,33
"2011","Elmbridge 012B","E01030372","Total",584,546,38
"2011","Elmbridge 012C","E01030373","Total",693,657,36
"2011","Elmbridge 012D","E01030374","Total",847,771,76
"2011","Elmbridge 012E","E01030375","Total",824,781,43
"2011","Elmbridge 012F","E01030376","Total",577,536,41
"2011","Elmbridge 013A","E01030307","Total",699,646,53
"2011","Elmbridge 013B","E01030308","Total",714,645,69
"2011","Elmbridge 013C","E01030309","Total",710,619,91
"2011","Elmbridge 013D","E01030310","Total",781,728,53
"2011","Elmbridge 014A","E01030311","Total",679,662,17
"2011","Elmbridge 014B","E01030312","Total",546,518,28
"2011","Elmbridge 014C","E01030315","Total",648,636,12
"2011","Elmbridge 014D","E01030316","Total",656,635,21
"2011","Elmbridge 014E","E01030317","Total",785,749,36
"2011","Elmbridge 014F","E01030318","Total",719,644,75
"2011","Elmbridge 015A","E01030296","Total",665,649,16
"2011","Elmbridge 015B","E01030297","Total",849,823,26
"2011","Elmbridge 015C","E01030298","Total",688,679,9
"2011","Elmbridge 015D","E01030299","Total",646,637,9
"2011","Elmbridge 016A","E01030346","Total",605,519,86
"2011","Elmbridge 016B","E01030347","Total",706,681,25
"2011","Elmbridge 016C","E01030348","Total",729,664,65
"2011","Elmbridge 016D","E01030349","Total",755,703,52
"2011","Elmbridge 017A","E01030300","Total",790,756,34
"2011","Elmbridge 017B","E01030301","Total",641,601,40
"2011","Elmbridge 017C","E01030302","Total",798,711,87
"2011","Elmbridge 017D","E01030304","Total",708,696,12
"2011","Elmbridge 017E","E01030305","Total",554,520,34
"2011","Elmbridge 017F","E01030306","Total",526,481,45
"2011","Elmbridge 018A","E01030303","Total",728,690,38
"2011","Elmbridge 018B","E01030342","Total",703,613,90
"2011","Elmbridge 018C","E01030343","Total",681,637,44
"2011","Elmbridge 018D","E01030344","Total",566,526,40
"2011","Elmbridge 018E","E01030345","Total",680,646,34
"2011","Epsom and Ewell 001A","E01030386","Total",536,533,3
"2011","Epsom and Ewell 001B","E01030387","Total",650,643,7
"2011","Epsom and Ewell 001C","E01030388","Total",528,520,8
"2011","Epsom and Ewell 001D","E01030389","Total",688,670,18
"2011","Epsom and Ewell 001E","E01030393","Total",845,821,24
"2011","Epsom and Ewell 002A","E01030394","Total",643,636,7
"2011","Epsom and Ewell 002B","E01030399","Total",932,911,21
"2011","Epsom and Ewell 002C","E01030400","Total",602,599,3
"2011","Epsom and Ewell 002D","E01030414","Total",534,524,10
"2011","Epsom and Ewell 003A","E01030377","Total",911,901,10
"2011","Epsom and Ewell 003B","E01030378","Total",634,611,23
"2011","Epsom and Ewell 003C","E01030406","Total",631,613,18
"2011","Epsom and Ewell 003D","E01030407","Total",547,537,10
"2011","Epsom and Ewell 003E","E01030408","Total",649,641,8
"2011","Epsom and Ewell 004A","E01030395","Total",775,763,12
"2011","Epsom and Ewell 004B","E01030413","Total",757,743,14
"2011","Epsom and Ewell 004C","E01030415","Total",613,607,6
"2011","Epsom and Ewell 004D","E01030416","Total",533,525,8
"2011","Epsom and Ewell 005A","E01030383","Total",922,903,19
"2011","Epsom and Ewell 005B","E01030384","Total",1003,980,23
"2011","Epsom and Ewell 005C","E01030401","Total",1033,1015,18
"2011","Epsom and Ewell 005D","E01030402","Total",491,481,10
"2011","Epsom and Ewell 007A","E01030385","Total",693,684,9
"2011","Epsom and Ewell 007B","E01030391","Total",858,829,29
"2011","Epsom and Ewell 007C","E01030403","Total",642,591,51
"2011","Epsom and Ewell 007D","E01030404","Total",643,626,17
"2011","Epsom and Ewell 007E","E01030409","Total",535,524,11
"2011","Epsom and Ewell 007F","E01030410","Total",615,592,23
"2011","Epsom and Ewell 008A","E01030381","Total",667,646,21
"2011","Epsom and Ewell 008B","E01030411","Total",1167,1077,90
"2011","Epsom and Ewell 008C","E01030412","Total",1014,961,53
"2011","Epsom and Ewell 008D","E01030419","Total",753,708,45
"2011","Epsom and Ewell 009A","E01030379","Total",518,502,16
"2011","Epsom and Ewell 009B","E01030380","Total",519,509,10
"2011","Epsom and Ewell 009C","E01030405","Total",665,650,15
"2011","Epsom and Ewell 009D","E01030417","Total",534,523,11
"2011","Epsom and Ewell 009E","E01030418","Total",582,566,16
"2011","Epsom and Ewell 009F","E01030420","Total",500,489,11
"2011","Epsom and Ewell 010A","E01030382","Total",613,591,22
"2011","Epsom and Ewell 010B","E01030390","Total",826,811,15
"2011","Epsom and Ewell 010C","E01030392","Total",820,799,21
"2011","Epsom and Ewell 010D","E01030396","Total",655,646,9
"2011","Epsom and Ewell 010E","E01030398","Total",632,626,6
"2011","Epsom and Ewell 010F","E01032624","Total",672,657,15
"2011","Guildford 001A","E01030440","Total",638,617,21
"2011","Guildford 001B","E01030458","Total",573,524,49
"2011","Guildford 001C","E01030459","Total",515,485,30
"2011","Guildford 001D","E01030475","Total",523,505,18
"2011","Guildford 001E","E01030476","Total",461,456,5
"2011","Guildford 001F","E01030477","Total",716,704,12
"2011","Guildford 002A","E01030465","Total",596,584,12
"2011","Guildford 002B","E01030466","Total",743,726,17
"2011","Guildford 002C","E01030473","Total",696,655,41
"2011","Guildford 002D","E01030474","Total",495,446,49
"2011","Guildford 003A","E01030441","Total",531,514,17
"2011","Guildford 003B","E01030442","Total",572,557,15
"2011","Guildford 003C","E01030443","Total",545,534,11
"2011","Guildford 003D","E01030444","Total",611,597,14
"2011","Guildford 003E","E01030445","Total",652,606,46
"2011","Guildford 003F","E01030446","Total",532,508,24
"2011","Guildford 003G","E01030447","Total",557,546,11
"2011","Guildford 004A","E01030426","Total",624,614,10
"2011","Guildford 004B","E01030427","Total",621,610,11
"2011","Guildford 004C","E01030428","Total",519,510,9
"2011","Guildford 004D","E01030429","Total",735,718,17
"2011","Guildford 004E","E01030430","Total",641,627,14
"2011","Guildford 005A","E01030499","Total",662,645,17
"2011","Guildford 005B","E01030500","Total",623,605,18
"2011","Guildford 005C","E01030501","Total",667,642,25
"2011","Guildford 005D","E01030502","Total",525,500,25
"2011","Guildford 005E","E01030503","Total",581,572,9
"2011","Guildford 005F","E01030504","Total",503,492,11
"2011","Guildford 006A","E01030485","Total",786,741,45
"2011","Guildford 006B","E01030487","Total",683,638,45
"2011","Guildford 006C","E01030488","Total",802,780,22
"2011","Guildford 006D","E01030489","Total",958,947,11
"2011","Guildford 007A","E01030481","Total",644,632,12
"2011","Guildford 007B","E01030482","Total",537,513,24
"2011","Guildford 007C","E01030483","Total",621,587,34
"2011","Guildford 007D","E01030484","Total",713,668,45
"2011","Guildford 008A","E01030434","Total",749,738,11
"2011","Guildford 008B","E01030435","Total",656,647,9
"2011","Guildford 008C","E01030462","Total",758,746,12
"2011","Guildford 008D","E01030463","Total",638,628,10
"2011","Guildford 008E","E01030464","Total",649,645,4
"2011","Guildford 009A","E01030486","Total",622,611,11
"2011","Guildford 009B","E01030493","Total",531,510,21
"2011","Guildford 009C","E01030495","Total",672,643,29
"2011","Guildford 009D","E01030498","Total",522,510,12
"2011","Guildford 010A","E01030424","Total",678,661,17
"2011","Guildford 010B","E01030431","Total",633,627,6
"2011","Guildford 010C","E01030432","Total",641,630,11
"2011","Guildford 010D","E01030433","Total",709,694,15
"2011","Guildford 011A","E01030436","Total",1017,982,35
"2011","Guildford 011B","E01030437","Total",732,694,38
"2011","Guildford 011C","E01030439","Total",666,639,27
"2011","Guildford 011D","E01030460","Total",642,633,9
"2011","Guildford 011E","E01030461","Total",664,651,13
"2011","Guildford 012A","E01030470","Total",530,514,16
"2011","Guildford 012B","E01030494","Total",665,651,14
"2011","Guildford 012C","E01030496","Total",629,597,32
"2011","Guildford 012D","E01030497","Total",629,606,23
"2011","Guildford 013A","E01030438","Total",815,730,85
"2011","Guildford 013B","E01030450","Total",1044,993,51
"2011","Guildford 013C","E01030451","Total",968,864,104
"2011","Guildford 013D","E01030453","Total",879,774,105
"2011","Guildford 013E","E01030455","Total",958,836,122
"2011","Guildford 013F","E01030457","Total",835,780,55
"2011","Guildford 014A","E01030421","Total",629,617,12
"2011","Guildford 014B","E01030422","Total",658,650,8
"2011","Guildford 014C","E01030423","Total",722,712,10
"2011","Guildford 014D","E01030425","Total",669,657,12
"2011","Guildford 015A","E01030452","Total",927,834,93
"2011","Guildford 015B","E01030467","Total",647,633,14
"2011","Guildford 015C","E01030468","Total",512,497,15
"2011","Guildford 015D","E01030469","Total",517,508,9
"2011","Guildford 016A","E01030448","Total",646,614,32
"2011","Guildford 016B","E01030449","Total",725,674,51
"2011","Guildford 016C","E01030454","Total",768,729,39
"2011","Guildford 016D","E01030456","Total",566,542,24
"2011","Guildford 017A","E01030471","Total",500,482,18
"2011","Guildford 017B","E01030472","Total",528,508,20
"2011","Guildford 017C","E01030478","Total",705,686,19
"2011","Guildford 017D","E01030479","Total",781,759,22
"2011","Guildford 017E","E01030480","Total",814,785,29
"2011","Guildford 018A","E01030490","Total",688,662,26
"2011","Guildford 018B","E01030491","Total",856,789,67
"2011","Guildford 018C","E01030492","Total",830,796,34
"2011","Mole Valley 001A","E01030506","Total",493,486,7
"2011","Mole Valley 001B","E01030508","Total",526,513,13
"2011","Mole Valley 001C","E01030509","Total",546,519,27
"2011","Mole Valley 001D","E01030513","Total",524,520,4
"2011","Mole Valley 001E","E01030514","Total",661,639,22
"2011","Mole Valley 002A","E01030505","Total",644,630,14
"2011","Mole Valley 002B","E01030507","Total",516,501,15
"2011","Mole Valley 002C","E01030511","Total",557,545,12
"2011","Mole Valley 002D","E01030512","Total",679,664,15
"2011","Mole Valley 003A","E01030548","Total",742,709,33
"2011","Mole Valley 003B","E01030549","Total",857,826,31
"2011","Mole Valley 003C","E01030550","Total",1030,958,72
"2011","Mole Valley 003D","E01030551","Total",696,684,12
"2011","Mole Valley 004A","E01030510","Total",647,622,25
"2011","Mole Valley 004B","E01030552","Total",730,680,50
"2011","Mole Valley 004C","E01030553","Total",832,786,46
"2011","Mole Valley 004D","E01030554","Total",467,447,20
"2011","Mole Valley 005A","E01030539","Total",708,694,14
"2011","Mole Valley 005B","E01030540","Total",827,814,13
"2011","Mole Valley 005C","E01030541","Total",520,515,5
"2011","Mole Valley 005D","E01030542","Total",497,485,12
"2011","Mole Valley 005E","E01030543","Total",622,604,18
"2011","Mole Valley 006A","E01030516","Total",660,644,16
"2011","Mole Valley 006B","E01030517","Total",646,634,12
"2011","Mole Valley 006C","E01030518","Total",551,544,7
"2011","Mole Valley 006D","E01030519","Total",642,622,20
"2011","Mole Valley 007A","E01030520","Total",669,655,14
"2011","Mole Valley 007B","E01030521","Total",700,684,16
"2011","Mole Valley 007C","E01030522","Total",541,524,17
"2011","Mole Valley 007D","E01030523","Total",538,533,5
"2011","Mole Valley 008A","E01030524","Total",1073,1013,60
"2011","Mole Valley 008B","E01030525","Total",656,643,13
"2011","Mole Valley 008C","E01030526","Total",559,548,11
"2011","Mole Valley 008D","E01030527","Total",692,662,30
"2011","Mole Valley 009A","E01030532","Total",657,639,18
"2011","Mole Valley 009B","E01030533","Total",525,517,8
"2011","Mole Valley 009C","E01030534","Total",722,686,36
"2011","Mole Valley 009D","E01030556","Total",847,804,43
"2011","Mole Valley 010A","E01030535","Total",843,802,41
"2011","Mole Valley 010B","E01030536","Total",808,786,22
"2011","Mole Valley 010C","E01030537","Total",768,745,23
"2011","Mole Valley 010D","E01030538","Total",730,692,38
"2011","Mole Valley 011A","E01030544","Total",656,643,13
"2011","Mole Valley 011B","E01030545","Total",705,695,10
"2011","Mole Valley 011C","E01030546","Total",702,679,23
"2011","Mole Valley 011D","E01030547","Total",688,686,2
"2011","Mole Valley 012A","E01030529","Total",696,684,12
"2011","Mole Valley 012B","E01030555","Total",707,680,27
"2011","Mole Valley 012C","E01030557","Total",787,757,30
"2011","Mole Valley 012D","E01030558","Total",951,918,33
"2011","Mole Valley 013A","E01030515","Total",893,863,30
"2011","Mole Valley 013B","E01030528","Total",616,597,19
"2011","Mole Valley 013C","E01030530","Total",510,497,13
"2011","Mole Valley 013D","E01030531","Total",930,911,19
"2011","Reigate and Banstead 001A","E01030603","Total",556,549,7
"2011","Reigate and Banstead 001B","E01030604","Total",652,636,16
"2011","Reigate and Banstead 001C","E01030605","Total",543,528,15
"2011","Reigate and Banstead 001D","E01030607","Total",682,668,14
"2011","Reigate and Banstead 002A","E01030559","Total",510,503,7
"2011","Reigate and Banstead 002B","E01030560","Total",796,764,32
"2011","Reigate and Banstead 002C","E01030561","Total",604,591,13
"2011","Reigate and Banstead 002D","E01030562","Total",581,567,14
"2011","Reigate and Banstead 002E","E01030563","Total",409,408,1
"2011","Reigate and Banstead 002F","E01030564","Total",522,516,6
"2011","Reigate and Banstead 003A","E01030606","Total",512,507,5
"2011","Reigate and Banstead 003B","E01030641","Total",631,625,6
"2011","Reigate and Banstead 003C","E01030642","Total",662,650,12
"2011","Reigate and Banstead 003D","E01030644","Total",511,505,6
"2011","Reigate and Banstead 004A","E01030565","Total",585,567,18
"2011","Reigate and Banstead 004B","E01030566","Total",554,550,4
"2011","Reigate and Banstead 004C","E01030567","Total",634,615,19
"2011","Reigate and Banstead 004D","E01030568","Total",578,568,10
"2011","Reigate and Banstead 004E","E01030569","Total",1047,1025,22
"2011","Reigate and Banstead 005A","E01030608","Total",592,587,5
"2011","Reigate and Banstead 005B","E01030609","Total",598,589,9
"2011","Reigate and Banstead 005C","E01030640","Total",727,722,5
"2011","Reigate and Banstead 005D","E01030643","Total",635,621,14
"2011","Reigate and Banstead 006A","E01030635","Total",661,643,18
"2011","Reigate and Banstead 006B","E01030636","Total",457,449,8
"2011","Reigate and Banstead 006C","E01030637","Total",468,458,10
"2011","Reigate and Banstead 006D","E01030638","Total",614,602,12
"2011","Reigate and Banstead 006E","E01030639","Total",700,646,54
"2011","Reigate and Banstead 007A","E01030589","Total",674,646,28
"2011","Reigate and Banstead 007B","E01030590","Total",758,740,18
"2011","Reigate and Banstead 007C","E01030591","Total",561,538,23
"2011","Reigate and Banstead 007D","E01030592","Total",873,843,30
"2011","Reigate and Banstead 008A","E01030599","Total",685,670,15
"2011","Reigate and Banstead 008B","E01030600","Total",618,603,15
"2011","Reigate and Banstead 008C","E01030601","Total",606,591,15
"2011","Reigate and Banstead 008D","E01030602","Total",728,710,18
"2011","Reigate and Banstead 009A","E01030598","Total",666,651,15
"2011","Reigate and Banstead 009B","E01030623","Total",929,904,25
"2011","Reigate and Banstead 009C","E01030624","Total",570,523,47
"2011","Reigate and Banstead 009D","E01030625","Total",483,470,13
"2011","Reigate and Banstead 009E","E01030626","Total",454,442,12
"2011","Reigate and Banstead 009F","E01030627","Total",910,846,64
"2011","Reigate and Banstead 010A","E01030615","Total",755,650,105
"2011","Reigate and Banstead 010B","E01030616","Total",711,685,26
"2011","Reigate and Banstead 010C","E01030617","Total",713,697,16
"2011","Reigate and Banstead 010D","E01030618","Total",797,765,32
"2011","Reigate and Banstead 010E","E01030619","Total",630,624,6
"2011","Reigate and Banstead 010F","E01030622","Total",814,776,38
"2011","Reigate and Banstead 011A","E01030610","Total",567,543,24
"2011","Reigate and Banstead 011B","E01030611","Total",1204,1097,107
"2011","Reigate and Banstead 011C","E01030612","Total",1221,1182,39
"2011","Reigate and Banstead 011D","E01030613","Total",895,856,39
"2011","Reigate and Banstead 011E","E01030614","Total",610,606,4
"2011","Reigate and Banstead 012A","E01030593","Total",616,594,22
"2011","Reigate and Banstead 012B","E01030596","Total",524,518,6
"2011","Reigate and Banstead 012C","E01030597","Total",634,616,18
"2011","Reigate and Banstead 012D","E01030620","Total",832,792,40
"2011","Reigate and Banstead 012E","E01030621","Total",666,644,22
"2011","Reigate and Banstead 013A","E01030594","Total",717,704,13
"2011","Reigate and Banstead 013B","E01030595","Total",607,603,4
"2011","Reigate and Banstead 013C","E01030630","Total",639,629,10
"2011","Reigate and Banstead 013D","E01030631","Total",655,649,6
"2011","Reigate and Banstead 014A","E01030570","Total",657,643,14
"2011","Reigate and Banstead 014B","E01030571","Total",613,600,13
"2011","Reigate and Banstead 014C","E01030572","Total",908,872,36
"2011","Reigate and Banstead 014D","E01030573","Total",742,719,23
"2011","Reigate and Banstead 014E","E01030574","Total",753,719,34
"2011","Reigate and Banstead 015A","E01030628","Total",581,561,20
"2011","Reigate and Banstead 015B","E01030629","Total",533,514,19
"2011","Reigate and Banstead 015C","E01030632","Total",537,532,5
"2011","Reigate and Banstead 015D","E01030633","Total",573,564,9
"2011","Reigate and Banstead 015E","E01030634","Total",578,576,2
"2011","Reigate and Banstead 016A","E01030584","Total",644,636,8
"2011","Reigate and Banstead 016B","E01030585","Total",630,627,3
"2011","Reigate and Banstead 016C","E01030586","Total",668,654,14
"2011","Reigate and Banstead 016D","E01030587","Total",613,603,10
"2011","Reigate and Banstead 016E","E01030588","Total",626,614,12
"2011","Reigate and Banstead 017A","E01030580","Total",816,764,52
"2011","Reigate and Banstead 017B","E01030581","Total",501,493,8
"2011","Reigate and Banstead 017C","E01030582","Total",541,523,18
"2011","Reigate and Banstead 017D","E01030583","Total",589,556,33
"2011","Reigate and Banstead 018A","E01030575","Total",1019,975,44
"2011","Reigate and Banstead 018B","E01030576","Total",673,664,9
"2011","Reigate and Banstead 018C","E01030577","Total",759,734,25
"2011","Reigate and Banstead 018D","E01030578","Total",621,611,10
"2011","Reigate and Banstead 018E","E01030579","Total",632,603,29
"2011","Runnymede 001A","E01030667","Total",806,751,55
"2011","Runnymede 001B","E01030668","Total",931,869,62
"2011","Runnymede 001C","E01030669","Total",637,599,38
"2011","Runnymede 001D","E01030670","Total",494,490,4
"2011","Runnymede 002A","E01030671","Total",458,424,34
"2011","Runnymede 002B","E01030672","Total",835,789,46
"2011","Runnymede 002C","E01030673","Total",491,426,65
"2011","Runnymede 002D","E01030674","Total",674,651,23
"2011","Runnymede 002E","E01030675","Total",580,547,33
"2011","Runnymede 002F","E01030676","Total",519,496,23
"2011","Runnymede 003A","E01030663","Total",666,642,24
"2011","Runnymede 003B","E01030664","Total",726,706,20
"2011","Runnymede 003C","E01030665","Total",640,624,16
"2011","Runnymede 003D","E01030666","Total",772,741,31
"2011","Runnymede 003E","E01030687","Total",499,483,16
"2011","Runnymede 003F","E01030688","Total",615,604,11
"2011","Runnymede 004A","E01030656","Total",591,588,3
"2011","Runnymede 004B","E01030658","Total",801,738,63
"2011","Runnymede 004C","E01030685","Total",530,511,19
"2011","Runnymede 004D","E01030686","Total",614,589,25
"2011","Runnymede 005A","E01030689","Total",634,575,59
"2011","Runnymede 005B","E01030690","Total",744,662,82
"2011","Runnymede 005C","E01030691","Total",630,600,30
"2011","Runnymede 005D","E01030692","Total",590,486,104
"2011","Runnymede 006A","E01030652","Total",749,708,41
"2011","Runnymede 006B","E01030653","Total",642,633,9
"2011","Runnymede 006C","E01030654","Total",643,622,21
"2011","Runnymede 006D","E01030657","Total",668,648,20
"2011","Runnymede 006E","E01030659","Total",795,737,58
"2011","Runnymede 007A","E01030647","Total",793,763,30
"2011","Runnymede 007B","E01030648","Total",650,628,22
"2011","Runnymede 007C","E01030649","Total",881,807,74
"2011","Runnymede 007D","E01030650","Total",531,519,12
"2011","Runnymede 007E","E01030651","Total",582,562,20
"2011","Runnymede 007F","E01030655","Total",706,688,18
"2011","Runnymede 007G","E01030662","Total",630,607,23
"2011","Runnymede 008A","E01030677","Total",762,677,85
"2011","Runnymede 008B","E01030678","Total",599,583,16
"2011","Runnymede 008C","E01030679","Total",531,480,51
"2011","Runnymede 008D","E01030680","Total",645,634,11
"2011","Runnymede 009A","E01030645","Total",938,911,27
"2011","Runnymede 009B","E01030646","Total",978,928,50
"2011","Runnymede 009C","E01030660","Total",810,799,11
"2011","Runnymede 009D","E01030661","Total",681,669,12
"2011","Runnymede 009E","E01030684","Total",656,651,5
"2011","Runnymede 010A","E01030681","Total",689,650,39
"2011","Runnymede 010B","E01030682","Total",521,515,6
"2011","Runnymede 010C","E01030683","Total",558,551,7
"2011","Runnymede 010D","E01030693","Total",519,507,12
"2011","Runnymede 010E","E01030694","Total",540,530,10
"2011","Runnymede 010F","E01030695","Total",506,496,10
"2011","Runnymede 010G","E01030696","Total",636,620,16
"2011","Spelthorne 001A","E01030743","Total",683,651,32
"2011","Spelthorne 001B","E01030744","Total",864,844,20
"2011","Spelthorne 001C","E01030745","Total",597,577,20
"2011","Spelthorne 001D","E01030747","Total",583,550,33
"2011","Spelthorne 002A","E01030709","Total",578,562,16
"2011","Spelthorne 002B","E01030710","Total",670,648,22
"2011","Spelthorne 002C","E01030711","Total",660,638,22
"2011","Spelthorne 002D","E01030746","Total",644,628,16
"2011","Spelthorne 003A","E01030707","Total",707,674,33
"2011","Spelthorne 003B","E01030708","Total",636,618,18
"2011","Spelthorne 003C","E01030712","Total",593,545,48
"2011","Spelthorne 003D","E01030713","Total",520,489,31
"2011","Spelthorne 003E","E01030714","Total",482,476,6
"2011","Spelthorne 003F","E01030715","Total",617,600,17
"2011","Spelthorne 003G","E01030716","Total",605,593,12
"2011","Spelthorne 004A","E01030734","Total",556,551,5
"2011","Spelthorne 004B","E01030735","Total",699,670,29
"2011","Spelthorne 004C","E01030736","Total",1017,937,80
"2011","Spelthorne 004D","E01030737","Total",713,681,32
"2011","Spelthorne 004E","E01030738","Total",735,689,46
"2011","Spelthorne 005A","E01030701","Total",641,625,16
"2011","Spelthorne 005B","E01030702","Total",513,489,24
"2011","Spelthorne 005C","E01030703","Total",638,627,11
"2011","Spelthorne 005D","E01030704","Total",683,647,36
"2011","Spelthorne 005E","E01030705","Total",673,643,30
"2011","Spelthorne 005F","E01030706","Total",565,553,12
"2011","Spelthorne 006A","E01030697","Total",651,639,12
"2011","Spelthorne 006B","E01030698","Total",673,655,18
"2011","Spelthorne 006C","E01030699","Total",634,627,7
"2011","Spelthorne 006D","E01030700","Total",819,778,41
"2011","Spelthorne 006E","E01030725","Total",826,787,39
"2011","Spelthorne 007A","E01030729","Total",629,623,6
"2011","Spelthorne 007B","E01030739","Total",703,690,13
"2011","Spelthorne 007C","E01030740","Total",749,745,4
"2011","Spelthorne 007D","E01030741","Total",662,654,8
"2011","Spelthorne 008A","E01030748","Total",683,669,14
"2011","Spelthorne 008B","E01030749","Total",617,608,9
"2011","Spelthorne 008C","E01030750","Total",628,618,10
"2011","Spelthorne 008D","E01030751","Total",667,653,14
"2011","Spelthorne 008E","E01030752","Total",633,615,18
"2011","Spelthorne 009A","E01030726","Total",645,638,7
"2011","Spelthorne 009B","E01030727","Total",891,862,29
"2011","Spelthorne 009C","E01030728","Total",744,723,21
"2011","Spelthorne 009D","E01030742","Total",831,810,21
"2011","Spelthorne 010A","E01030753","Total",796,746,50
"2011","Spelthorne 010B","E01030754","Total",664,625,39
"2011","Spelthorne 010C","E01030755","Total",826,794,32
"2011","Spelthorne 010D","E01030756","Total",684,666,18
"2011","Spelthorne 011A","E01030717","Total",747,730,17
"2011","Spelthorne 011B","E01030718","Total",526,506,20
"2011","Spelthorne 011C","E01030719","Total",639,619,20
"2011","Spelthorne 011D","E01030720","Total",686,641,45
"2011","Spelthorne 012A","E01030721","Total",649,619,30
"2011","Spelthorne 012B","E01030722","Total",663,656,7
"2011","Spelthorne 012C","E01030723","Total",625,617,8
"2011","Spelthorne 012D","E01030724","Total",668,647,21
"2011","Spelthorne 013A","E01030730","Total",825,783,42
"2011","Spelthorne 013B","E01030731","Total",792,767,25
"2011","Spelthorne 013C","E01030732","Total",733,689,44
"2011","Spelthorne 013D","E01030733","Total",865,808,57
"2011","Surrey Heath 001A","E01030763","Total",551,509,42
"2011","Surrey Heath 001B","E01030764","Total",540,506,34
"2011","Surrey Heath 001C","E01030765","Total",637,601,36
"2011","Surrey Heath 001D","E01030809","Total",667,643,24
"2011","Surrey Heath 001E","E01030810","Total",577,542,35
"2011","Surrey Heath 001F","E01030811","Total",652,597,55
"2011","Surrey Heath 002A","E01030757","Total",684,675,9
"2011","Surrey Heath 002B","E01030758","Total",447,439,8
"2011","Surrey Heath 002C","E01030759","Total",759,725,34
"2011","Surrey Heath 002D","E01030760","Total",519,493,26
"2011","Surrey Heath 003A","E01030778","Total",753,741,12
"2011","Surrey Heath 003B","E01030779","Total",768,745,23
"2011","Surrey Heath 003C","E01030780","Total",669,652,17
"2011","Surrey Heath 003D","E01030781","Total",658,640,18
"2011","Surrey Heath 004A","E01030786","Total",798,754,44
"2011","Surrey Heath 004B","E01030787","Total",543,528,15
"2011","Surrey Heath 004C","E01030788","Total",502,487,15
"2011","Surrey Heath 004D","E01030801","Total",686,638,48
"2011","Surrey Heath 004E","E01030802","Total",703,672,31
"2011","Surrey Heath 005A","E01030796","Total",537,522,15
"2011","Surrey Heath 005B","E01030797","Total",529,519,10
"2011","Surrey Heath 005C","E01030798","Total",565,547,18
"2011","Surrey Heath 005D","E01030799","Total",514,501,13
"2011","Surrey Heath 005E","E01030800","Total",763,699,64
"2011","Surrey Heath 006A","E01030761","Total",580,575,5
"2011","Surrey Heath 006B","E01030762","Total",746,735,11
"2011","Surrey Heath 006C","E01030806","Total",551,544,7
"2011","Surrey Heath 006D","E01030807","Total",532,510,22
"2011","Surrey Heath 006E","E01030808","Total",654,634,20
"2011","Surrey Heath 007A","E01030774","Total",543,531,12
"2011","Surrey Heath 007B","E01030775","Total",567,556,11
"2011","Surrey Heath 007C","E01030776","Total",623,616,7
"2011","Surrey Heath 007D","E01030777","Total",646,641,5
"2011","Surrey Heath 008A","E01030793","Total",673,608,65
"2011","Surrey Heath 008B","E01030794","Total",661,613,48
"2011","Surrey Heath 008C","E01030795","Total",1035,960,75
"2011","Surrey Heath 008D","E01030803","Total",688,656,32
"2011","Surrey Heath 008E","E01030804","Total",686,668,18
"2011","Surrey Heath 008F","E01030805","Total",617,606,11
"2011","Surrey Heath 009A","E01030789","Total",585,562,23
"2011","Surrey Heath 009B","E01030790","Total",669,663,6
"2011","Surrey Heath 009C","E01030791","Total",660,643,17
"2011","Surrey Heath 009D","E01030792","Total",496,492,4
"2011","Surrey Heath 010A","E01030766","Total",683,662,21
"2011","Surrey Heath 010B","E01030767","Total",619,609,10
"2011","Surrey Heath 010C","E01030768","Total",518,513,5
"2011","Surrey Heath 010D","E01030769","Total",574,570,4
"2011","Surrey Heath 011A","E01030770","Total",632,616,16
"2011","Surrey Heath 011B","E01030771","Total",489,485,4
"2011","Surrey Heath 011C","E01030772","Total",634,623,11
"2011","Surrey Heath 011D","E01030773","Total",549,542,7
"2011","Surrey Heath 012A","E01030782","Total",670,659,11
"2011","Surrey Heath 012B","E01030783","Total",664,636,28
"2011","Surrey Heath 012C","E01030784","Total",838,803,35
"2011","Surrey Heath 012D","E01030785","Total",654,640,14
"2011","Tandridge 002A","E01030855","Total",783,753,30
"2011","Tandridge 002B","E01030856","Total",642,613,29
"2011","Tandridge 002C","E01030859","Total",873,848,25
"2011","Tandridge 002D","E01030860","Total",971,935,36
"2011","Tandridge 003A","E01030844","Total",702,679,23
"2011","Tandridge 003B","E01030845","Total",516,497,19
"2011","Tandridge 003C","E01030846","Total",564,550,14
"2011","Tandridge 003D","E01030857","Total",887,876,11
"2011","Tandridge 003E","E01030858","Total",893,871,22
"2011","Tandridge 004A","E01030828","Total",514,494,20
"2011","Tandridge 004B","E01030829","Total",708,672,36
"2011","Tandridge 004C","E01030830","Total",530,513,17
"2011","Tandridge 004D","E01030850","Total",1116,1031,85
"2011","Tandridge 004E","E01030851","Total",826,811,15
"2011","Tandridge 004F","E01030861","Total",806,744,62
"2011","Tandridge 005A","E01030820","Total",673,644,29
"2011","Tandridge 005B","E01030847","Total",728,698,30
"2011","Tandridge 005C","E01030848","Total",880,851,29
"2011","Tandridge 006A","E01030831","Total",899,875,24
"2011","Tandridge 006B","E01030832","Total",583,555,28
"2011","Tandridge 006C","E01030836","Total",771,728,43
"2011","Tandridge 006D","E01030837","Total",562,549,13
"2011","Tandridge 006E","E01030838","Total",530,507,23
"2011","Tandridge 006F","E01030839","Total",572,546,26
"2011","Tandridge 007A","E01030840","Total",581,572,9
"2011","Tandridge 007B","E01030841","Total",503,489,14
"2011","Tandridge 007C","E01030842","Total",699,687,12
"2011","Tandridge 007D","E01030843","Total",628,610,18
"2011","Tandridge 008A","E01030812","Total",654,633,21
"2011","Tandridge 008B","E01030813","Total",676,652,24
"2011","Tandridge 008C","E01030814","Total",495,473,22
"2011","Tandridge 008D","E01030815","Total",642,603,39
"2011","Tandridge 009A","E01030824","Total",638,612,26
"2011","Tandridge 009B","E01030825","Total",614,594,20
"2011","Tandridge 009C","E01030826","Total",582,567,15
"2011","Tandridge 009D","E01030827","Total",656,613,43
"2011","Tandridge 010A","E01030821","Total",806,772,34
"2011","Tandridge 010B","E01030822","Total",712,678,34
"2011","Tandridge 010C","E01030833","Total",634,602,32
"2011","Tandridge 010D","E01030834","Total",578,566,12
"2011","Tandridge 010E","E01030835","Total",604,581,23
"2011","Tandridge 011A","E01030816","Total",653,609,44
"2011","Tandridge 011B","E01030817","Total",613,582,31
"2011","Tandridge 011C","E01030818","Total",539,522,17
"2011","Tandridge 011D","E01030819","Total",663,609,54
"2011","Tandridge 011E","E01030823","Total",882,829,53
"2011","Tandridge 012A","E01030852","Total",828,801,27
"2011","Tandridge 012B","E01030853","Total",724,703,21
"2011","Tandridge 012C","E01030854","Total",837,804,33
"2011","Tandridge 012D","E01032571","Total",771,739,32
"2011","Waverley 001A","E01030890","Total",666,647,19
"2011","Waverley 001B","E01030902","Total",545,534,11
"2011","Waverley 001C","E01030903","Total",700,670,30
"2011","Waverley 001D","E01030904","Total",651,639,12
"2011","Waverley 002A","E01030891","Total",661,637,24
"2011","Waverley 002B","E01030892","Total",532,522,10
"2011","Waverley 002C","E01030899","Total",691,672,19
"2011","Waverley 002D","E01030900","Total",519,501,18
"2011","Waverley 002E","E01030901","Total",522,512,10
"2011","Waverley 003A","E01030884","Total",758,707,51
"2011","Waverley 003B","E01030885","Total",805,682,123
"2011","Waverley 003C","E01030886","Total",511,490,21
"2011","Waverley 003D","E01030893","Total",790,777,13
"2011","Waverley 003E","E01030895","Total",682,640,42
"2011","Waverley 004A","E01030881","Total",564,544,20
"2011","Waverley 004B","E01030883","Total",552,522,30
"2011","Waverley 004C","E01030888","Total",641,627,14
"2011","Waverley 004D","E01030894","Total",642,597,45
"2011","Waverley 005A","E01030911","Total",629,618,11
"2011","Waverley 005B","E01030912","Total",555,547,8
"2011","Waverley 005C","E01030913","Total",514,506,8
"2011","Waverley 005D","E01030920","Total",658,636,22
"2011","Waverley 005E","E01030921","Total",884,834,50
"2011","Waverley 006A","E01030882","Total",532,519,13
"2011","Waverley 006B","E01030887","Total",541,529,12
"2011","Waverley 006C","E01030889","Total",657,634,23
"2011","Waverley 006D","E01030896","Total",528,514,14
"2011","Waverley 006E","E01030897","Total",533,522,11
"2011","Waverley 007A","E01030916","Total",874,799,75
"2011","Waverley 007B","E01030917","Total",539,518,21
"2011","Waverley 007C","E01030918","Total",566,536,30
"2011","Waverley 007D","E01030919","Total",534,521,13
"2011","Waverley 007E","E01030922","Total",643,621,22
"2011","Waverley 008A","E01030863","Total",781,748,33
"2011","Waverley 008B","E01030865","Total",675,622,53
"2011","Waverley 008C","E01030866","Total",653,629,24
"2011","Waverley 008D","E01030940","Total",776,731,45
"2011","Waverley 009A","E01030898","Total",638,626,12
"2011","Waverley 009B","E01030905","Total",627,606,21
"2011","Waverley 009C","E01030906","Total",736,709,27
"2011","Waverley 009D","E01030907","Total",489,471,18
"2011","Waverley 010A","E01030914","Total",554,531,23
"2011","Waverley 010B","E01030915","Total",662,654,8
"2011","Waverley 010C","E01030923","Total",565,558,7
"2011","Waverley 010D","E01030924","Total",517,504,13
"2011","Waverley 010E","E01030925","Total",575,571,4
"2011","Waverley 011A","E01030877","Total",536,517,19
"2011","Waverley 011B","E01030878","Total",656,635,21
"2011","Waverley 011C","E01030937","Total",668,653,15
"2011","Waverley 011D","E01030938","Total",654,621,33
"2011","Waverley 011E","E01030939","Total",481,468,13
"2011","Waverley 012A","E01030864","Total",617,545,72
"2011","Waverley 012B","E01030879","Total",503,459,44
"2011","Waverley 012C","E01030941","Total",522,488,34
"2011","Waverley 012D","E01030942","Total",588,557,31
"2011","Waverley 012E","E01030943","Total",531,514,17
"2011","Waverley 013A","E01030870","Total",655,645,10
"2011","Waverley 013B","E01030871","Total",668,658,10
"2011","Waverley 013C","E01030872","Total",838,812,26
"2011","Waverley 013D","E01030873","Total",634,608,26
"2011","Waverley 013E","E01030874","Total",529,511,18
"2011","Waverley 013F","E01030875","Total",666,601,65
"2011","Waverley 013G","E01030876","Total",554,537,17
"2011","Waverley 015A","E01030862","Total",983,861,122
"2011","Waverley 015B","E01030867","Total",645,596,49
"2011","Waverley 015C","E01030868","Total",497,487,10
"2011","Waverley 015D","E01030869","Total",499,477,22
"2011","Waverley 015E","E01030880","Total",886,814,72
"2011","Waverley 016A","E01030930","Total",678,642,36
"2011","Waverley 016B","E01030931","Total",807,761,46
"2011","Waverley 016C","E01030932","Total",615,591,24
"2011","Waverley 016D","E01030933","Total",807,772,35
"2011","Waverley 017A","E01030926","Total",623,604,19
"2011","Waverley 017B","E01030927","Total",543,528,15
"2011","Waverley 017C","E01030928","Total",871,819,52
"2011","Waverley 017D","E01030929","Total",516,494,22
"2011","Waverley 018A","E01030908","Total",626,590,36
"2011","Waverley 018B","E01030909","Total",550,499,51
"2011","Waverley 018C","E01030910","Total",521,494,27
"2011","Waverley 018D","E01030934","Total",596,568,28
"2011","Waverley 018E","E01030935","Total",528,505,23
"2011","Waverley 018F","E01032626","Total",639,615,24
"2011","Woking 001A","E01030946","Total",632,607,25
"2011","Woking 001B","E01030947","Total",538,532,6
"2011","Woking 001C","E01030948","Total",643,620,23
"2011","Woking 001D","E01030949","Total",720,705,15
"2011","Woking 001E","E01030950","Total",734,710,24
"2011","Woking 002A","E01030996","Total",585,577,8
"2011","Woking 002B","E01030998","Total",731,718,13
"2011","Woking 002C","E01031002","Total",693,678,15
"2011","Woking 002D","E01031003","Total",669,648,21
"2011","Woking 002E","E01031004","Total",1041,994,47
"2011","Woking 003A","E01030963","Total",541,530,11
"2011","Woking 003B","E01030964","Total",777,741,36
"2011","Woking 003C","E01030965","Total",570,556,14
"2011","Woking 003D","E01030966","Total",514,507,7
"2011","Woking 003E","E01030967","Total",652,631,21
"2011","Woking 003F","E01030968","Total",558,533,25
"2011","Woking 004A","E01030980","Total",575,556,19
"2011","Woking 004B","E01030981","Total",473,464,9
"2011","Woking 004C","E01030982","Total",608,596,12
"2011","Woking 004D","E01030983","Total",713,681,32
"2011","Woking 004E","E01030984","Total",702,694,8
"2011","Woking 004F","E01030985","Total",648,627,21
"2011","Woking 005A","E01030951","Total",621,611,10
"2011","Woking 005B","E01030952","Total",614,602,12
"2011","Woking 005C","E01030953","Total",661,650,11
"2011","Woking 005D","E01030956","Total",512,509,3
"2011","Woking 005E","E01030957","Total",500,493,7
"2011","Woking 005F","E01030958","Total",618,609,9
"2011","Woking 005G","E01030959","Total",481,471,10
"2011","Woking 006A","E01030988","Total",854,821,33
"2011","Woking 006B","E01030989","Total",680,604,76
"2011","Woking 006C","E01030990","Total",599,581,18
"2011","Woking 006D","E01030997","Total",713,690,23
"2011","Woking 007A","E01030974","Total",648,629,19
"2011","Woking 007B","E01030975","Total",564,554,10
"2011","Woking 007C","E01030976","Total",646,631,15
"2011","Woking 007D","E01030977","Total",712,693,19
"2011","Woking 007E","E01030979","Total",839,832,7
"2011","Woking 008A","E01030954","Total",1066,979,87
"2011","Woking 008B","E01030969","Total",554,539,15
"2011","Woking 008C","E01030970","Total",639,628,11
"2011","Woking 008D","E01030991","Total",1099,1031,68
"2011","Woking 008E","E01030993","Total",1282,1216,66
"2011","Woking 009A","E01030960","Total",760,742,18
"2011","Woking 009B","E01030961","Total",726,717,9
"2011","Woking 009C","E01030962","Total",777,768,9
"2011","Woking 009D","E01031000","Total",670,655,15
"2011","Woking 010A","E01030955","Total",590,578,12
"2011","Woking 010B","E01030992","Total",713,698,15
"2011","Woking 010C","E01030999","Total",514,495,19
"2011","Woking 010D","E01031001","Total",754,738,16
"2011","Woking 011A","E01030971","Total",749,737,12
"2011","Woking 011B","E01030972","Total",700,688,12
"2011","Woking 011C","E01030973","Total",704,694,10
"2011","Woking 011D","E01030994","Total",707,687,20
"2011","Woking 011E","E01030995","Total",574,549,25
"2011","Woking 012A","E01030944","Total",522,497,25
"2011","Woking 012B","E01030945","Total",477,463,14
"2011","Woking 012C","E01030978","Total",519,510,9
"2011","Woking 012D","E01030986","Total",472,449,23
"2011","Woking 012E","E01030987","Total",544,524,20
"2011","Adur 001A","E01031349","Total",560,552,8
"2011","Adur 001B","E01031350","Total",498,496,2
"2011","Adur 001C","E01031351","Total",659,647,12
"2011","Adur 001D","E01031352","Total",646,635,11
"2011","Adur 001E","E01031370","Total",575,568,7
"2011","Adur 001F","E01031374","Total",656,646,10
"2011","Adur 002A","E01031338","Total",508,497,11
"2011","Adur 002B","E01031339","Total",527,519,8
"2011","Adur 002C","E01031340","Total",635,628,7
"2011","Adur 002D","E01031365","Total",650,639,11
"2011","Adur 002E","E01031367","Total",553,546,7
"2011","Adur 003A","E01031345","Total",657,648,9
"2011","Adur 003B","E01031353","Total",487,469,18
"2011","Adur 003C","E01031354","Total",558,543,15
"2011","Adur 003D","E01031355","Total",699,692,7
"2011","Adur 003E","E01031359","Total",534,523,11
"2011","Adur 004A","E01031347","Total",671,656,15
"2011","Adur 004B","E01031348","Total",688,675,13
"2011","Adur 004C","E01031366","Total",507,495,12
"2011","Adur 004D","E01031371","Total",626,610,16
"2011","Adur 004E","E01031372","Total",548,539,9
"2011","Adur 004F","E01031373","Total",645,628,17
"2011","Adur 004G","E01031375","Total",722,701,21
"2011","Adur 005A","E01031356","Total",1073,1035,38
"2011","Adur 005B","E01031357","Total",1096,1035,61
"2011","Adur 005C","E01031364","Total",863,797,66
"2011","Adur 005D","E01031368","Total",565,552,13
"2011","Adur 005E","E01031369","Total",669,640,29
"2011","Adur 006A","E01031344","Total",615,608,7
"2011","Adur 006B","E01031346","Total",652,640,12
"2011","Adur 006C","E01031361","Total",637,631,6
"2011","Adur 006D","E01031362","Total",520,507,13
"2011","Adur 006E","E01031363","Total",761,746,15
"2011","Adur 007A","E01031358","Total",656,647,9
"2011","Adur 007B","E01031360","Total",670,649,21
"2011","Adur 007C","E01031376","Total",648,630,18
"2011","Adur 007D","E01031378","Total",685,663,22
"2011","Adur 008A","E01031341","Total",651,629,22
"2011","Adur 008B","E01031342","Total",862,829,33
"2011","Adur 008C","E01031343","Total",626,611,15
"2011","Adur 008D","E01031377","Total",847,807,40
"2011","Adur 008E","E01031379","Total",768,749,19
"2011","Arun 001A","E01031390","Total",614,591,23
"2011","Arun 001B","E01031391","Total",799,730,69
"2011","Arun 001C","E01031392","Total",856,730,126
"2011","Arun 001D","E01031465","Total",606,578,28
"2011","Arun 002A","E01031386","Total",615,592,23
"2011","Arun 002B","E01031387","Total",713,696,17
"2011","Arun 002C","E01031425","Total",634,610,24
"2011","Arun 002D","E01031426","Total",562,534,28
"2011","Arun 003A","E01031393","Total",788,751,37
"2011","Arun 003B","E01031394","Total",692,680,12
"2011","Arun 003C","E01031395","Total",822,637,185
"2011","Arun 003D","E01031396","Total",820,791,29
"2011","Arun 003E","E01031397","Total",712,679,33
"2011","Arun 003F","E01031466","Total",626,590,36
"2011","Arun 004A","E01031427","Total",628,615,13
"2011","Arun 004B","E01031429","Total",565,558,7
"2011","Arun 004C","E01031430","Total",616,602,14
"2011","Arun 004D","E01031467","Total",758,743,15
"2011","Arun 004E","E01031468","Total",958,940,18
"2011","Arun 005A","E01031388","Total",1093,1067,26
"2011","Arun 005B","E01031389","Total",934,912,22
"2011","Arun 005C","E01031414","Total",645,636,9
"2011","Arun 005D","E01031415","Total",810,776,34
"2011","Arun 005E","E01031459","Total",829,810,19
"2011","Arun 006A","E01031470","Total",664,629,35
"2011","Arun 006B","E01031471","Total",534,520,14
"2011","Arun 006C","E01031472","Total",677,658,19
"2011","Arun 006D","E01031473","Total",502,493,9
"2011","Arun 007A","E01031407","Total",618,611,7
"2011","Arun 007B","E01031408","Total",838,823,15
"2011","Arun 007C","E01031410","Total",606,600,6
"2011","Arun 007D","E01031462","Total",657,636,21
"2011","Arun 007E","E01031463","Total",656,650,6
"2011","Arun 007F","E01031464","Total",848,813,35
"2011","Arun 008A","E01031412","Total",689,638,51
"2011","Arun 008B","E01031422","Total",839,764,75
"2011","Arun 008C","E01031423","Total",801,776,25
"2011","Arun 008D","E01031424","Total",721,686,35
"2011","Arun 009A","E01031398","Total",617,604,13
"2011","Arun 009B","E01031399","Total",776,753,23
"2011","Arun 009C","E01031409","Total",520,510,10
"2011","Arun 009D","E01031455","Total",677,644,33
"2011","Arun 009E","E01031461","Total",887,848,39
"2011","Arun 009F","E01031469","Total",777,759,18
"2011","Arun 010A","E01031411","Total",701,674,27
"2011","Arun 010B","E01031413","Total",718,640,78
"2011","Arun 010C","E01031457","Total",917,868,49
"2011","Arun 010D","E01031458","Total",974,909,65
"2011","Arun 010E","E01031460","Total",1094,958,136
"2011","Arun 011A","E01031400","Total",940,839,101
"2011","Arun 011B","E01031428","Total",673,654,19
"2011","Arun 011C","E01031454","Total",1103,999,104
"2011","Arun 011D","E01031456","Total",1049,970,79
"2011","Arun 012A","E01031401","Total",704,666,38
"2011","Arun 012B","E01031402","Total",733,713,20
"2011","Arun 012C","E01031403","Total",657,634,23
"2011","Arun 012D","E01031405","Total",654,626,28
"2011","Arun 012E","E01031406","Total",508,500,8
"2011","Arun 013A","E01031417","Total",703,693,10
"2011","Arun 013B","E01031438","Total",760,739,21
"2011","Arun 013C","E01031439","Total",1063,938,125
"2011","Arun 013D","E01031440","Total",863,770,93
"2011","Arun 014A","E01031404","Total",502,490,12
"2011","Arun 014B","E01031433","Total",630,610,20
"2011","Arun 014C","E01031434","Total",759,711,48
"2011","Arun 014D","E01031441","Total",774,746,28
"2011","Arun 014E","E01031442","Total",672,607,65
"2011","Arun 015A","E01031416","Total",677,643,34
"2011","Arun 015B","E01031418","Total",784,766,18
"2011","Arun 015C","E01031419","Total",871,784,87
"2011","Arun 015D","E01031420","Total",790,736,54
"2011","Arun 015E","E01031421","Total",747,730,17
"2011","Arun 016A","E01031443","Total",518,507,11
"2011","Arun 016B","E01031444","Total",717,654,63
"2011","Arun 016C","E01031450","Total",531,518,13
"2011","Arun 016D","E01031451","Total",640,621,19
"2011","Arun 016E","E01031452","Total",534,528,6
"2011","Arun 017A","E01031431","Total",538,488,50
"2011","Arun 017B","E01031432","Total",1011,937,74
"2011","Arun 017C","E01031435","Total",808,724,84
"2011","Arun 017D","E01031436","Total",1111,998,113
"2011","Arun 017E","E01031437","Total",1085,991,94
"2011","Arun 017F","E01031453","Total",774,712,62
"2011","Arun 018A","E01031380","Total",798,749,49
"2011","Arun 018B","E01031381","Total",810,768,42
"2011","Arun 018C","E01031382","Total",817,795,22
"2011","Arun 018D","E01031383","Total",793,745,48
"2011","Arun 018E","E01031384","Total",814,774,40
"2011","Arun 019A","E01031385","Total",787,763,24
"2011","Arun 019B","E01031445","Total",812,766,46
"2011","Arun 019C","E01031446","Total",639,623,16
"2011","Arun 019D","E01031447","Total",765,733,32
"2011","Arun 019E","E01031448","Total",861,766,95
"2011","Arun 019F","E01031449","Total",690,670,20
"2011","Chichester 001A","E01031502","Total",613,592,21
"2011","Chichester 001B","E01031503","Total",588,567,21
"2011","Chichester 001C","E01031504","Total",967,935,32
"2011","Chichester 001D","E01031519","Total",592,542,50
"2011","Chichester 002A","E01031517","Total",760,734,26
"2011","Chichester 002B","E01031518","Total",657,619,38
"2011","Chichester 002C","E01031544","Total",568,519,49
"2011","Chichester 002D","E01031545","Total",542,515,27
"2011","Chichester 003A","E01031508","Total",941,874,67
"2011","Chichester 003B","E01031520","Total",593,548,45
"2011","Chichester 003C","E01031521","Total",517,453,64
"2011","Chichester 003D","E01031536","Total",573,517,56
"2011","Chichester 004A","E01031497","Total",600,565,35
"2011","Chichester 004C","E01031511","Total",774,749,25
"2011","Chichester 004D","E01031512","Total",902,882,20
"2011","Chichester 004F","E01032717","Total",1348,1228,120
"2011","Chichester 005A","E01031478","Total",551,464,87
"2011","Chichester 005B","E01031479","Total",495,442,53
"2011","Chichester 005C","E01031498","Total",552,482,70
"2011","Chichester 005D","E01031514","Total",855,758,97
"2011","Chichester 005E","E01031515","Total",740,702,38
"2011","Chichester 005F","E01031516","Total",720,654,66
"2011","Chichester 006A","E01031477","Total",1072,1002,70
"2011","Chichester 006B","E01031485","Total",699,675,24
"2011","Chichester 006C","E01031487","Total",709,675,34
"2011","Chichester 006D","E01031509","Total",1067,1004,63
"2011","Chichester 007A","E01031506","Total",570,529,41
"2011","Chichester 007B","E01031507","Total",647,588,59
"2011","Chichester 007C","E01031531","Total",534,524,10
"2011","Chichester 007D","E01031533","Total",516,508,8
"2011","Chichester 007E","E01031543","Total",1040,1000,40
"2011","Chichester 008A","E01031482","Total",703,683,20
"2011","Chichester 008B","E01031483","Total",1017,1006,11
"2011","Chichester 008C","E01031486","Total",947,841,106
"2011","Chichester 008D","E01031488","Total",824,771,53
"2011","Chichester 008E","E01031494","Total",738,730,8
"2011","Chichester 008F","E01031495","Total",795,760,35
"2011","Chichester 009A","E01031475","Total",525,505,20
"2011","Chichester 009B","E01031476","Total",871,692,179
"2011","Chichester 009C","E01031532","Total",505,456,49
"2011","Chichester 009D","E01031534","Total",916,867,49
"2011","Chichester 009E","E01031535","Total",703,677,26
"2011","Chichester 010A","E01031480","Total",617,605,12
"2011","Chichester 010B","E01031481","Total",767,740,27
"2011","Chichester 010C","E01031484","Total",954,905,49
"2011","Chichester 010D","E01031490","Total",1117,956,161
"2011","Chichester 010E","E01031491","Total",966,924,42
"2011","Chichester 011A","E01031474","Total",670,636,34
"2011","Chichester 011B","E01031493","Total",815,786,29
"2011","Chichester 011C","E01031496","Total",967,933,34
"2011","Chichester 011D","E01031505","Total",1016,988,28
"2011","Chichester 012A","E01031489","Total",666,645,21
"2011","Chichester 012B","E01031492","Total",644,614,30
"2011","Chichester 012C","E01031513","Total",977,907,70
"2011","Chichester 012D","E01031530","Total",546,535,11
"2011","Chichester 012E","E01031538","Total",650,615,35
"2011","Chichester 012F","E01031539","Total",506,491,15
"2011","Chichester 013A","E01031499","Total",949,797,152
"2011","Chichester 013B","E01031500","Total",857,766,91
"2011","Chichester 013C","E01031501","Total",819,692,127
"2011","Chichester 013D","E01031529","Total",541,479,62
"2011","Chichester 013E","E01031540","Total",890,664,226
"2011","Chichester 013F","E01031541","Total",850,688,162
"2011","Chichester 013G","E01031542","Total",932,785,147
"2011","Chichester 014A","E01031522","Total",962,925,37
"2011","Chichester 014B","E01031523","Total",798,697,101
"2011","Chichester 014C","E01031524","Total",817,712,105
"2011","Chichester 014D","E01031525","Total",666,627,39
"2011","Chichester 014E","E01031526","Total",576,543,33
"2011","Chichester 014F","E01031527","Total",721,678,43
"2011","Chichester 014G","E01031528","Total",774,681,93
"2011","Crawley 001A","E01031573","Total",651,642,9
"2011","Crawley 001B","E01031574","Total",661,649,12
"2011","Crawley 001C","E01031575","Total",657,647,10
"2011","Crawley 001D","E01031576","Total",572,564,8
"2011","Crawley 001E","E01031577","Total",448,440,8
"2011","Crawley 002A","E01031586","Total",734,726,8
"2011","Crawley 002B","E01031587","Total",655,650,5
"2011","Crawley 002C","E01031588","Total",619,606,13
"2011","Crawley 002D","E01031590","Total",654,649,5
"2011","Crawley 002E","E01031593","Total",610,597,13
"2011","Crawley 003A","E01031570","Total",516,510,6
"2011","Crawley 003B","E01031571","Total",684,674,10
"2011","Crawley 003C","E01031572","Total",657,637,20
"2011","Crawley 003D","E01031609","Total",694,684,10
"2011","Crawley 003E","E01031610","Total",814,796,18
"2011","Crawley 004A","E01031583","Total",959,931,28
"2011","Crawley 004B","E01031584","Total",661,655,6
"2011","Crawley 004C","E01031585","Total",690,673,17
"2011","Crawley 004D","E01031601","Total",500,487,13
"2011","Crawley 004F","E01032835","Total",794,758,36
"2011","Crawley 004G","E01032836","Total",655,637,18
"2011","Crawley 005A","E01031589","Total",728,707,21
"2011","Crawley 005B","E01031591","Total",782,766,16
"2011","Crawley 005C","E01031594","Total",584,577,7
"2011","Crawley 005D","E01031600","Total",636,624,12
"2011","Crawley 005E","E01031603","Total",609,595,14
"2011","Crawley 006A","E01031564","Total",619,614,5
"2011","Crawley 006B","E01031565","Total",855,846,9
"2011","Crawley 006C","E01031566","Total",678,668,10
"2011","Crawley 006D","E01031567","Total",532,518,14
"2011","Crawley 006E","E01031568","Total",647,635,12
"2011","Crawley 007A","E01031596","Total",805,788,17
"2011","Crawley 007B","E01031597","Total",603,587,16
"2011","Crawley 007C","E01031598","Total",802,765,37
"2011","Crawley 007D","E01031599","Total",791,772,19
"2011","Crawley 007E","E01031608","Total",764,738,26
"2011","Crawley 008A","E01031578","Total",750,743,7
"2011","Crawley 008B","E01031580","Total",870,860,10
"2011","Crawley 008C","E01031581","Total",622,619,3
"2011","Crawley 008D","E01031592","Total",804,786,18
"2011","Crawley 009A","E01031560","Total",629,624,5
"2011","Crawley 009B","E01031561","Total",602,597,5
"2011","Crawley 009C","E01031562","Total",615,604,11
"2011","Crawley 009D","E01031563","Total",489,484,5
"2011","Crawley 009E","E01031579","Total",710,701,9
"2011","Crawley 009F","E01031582","Total",822,799,23
"2011","Crawley 010A","E01031547","Total",531,518,13
"2011","Crawley 010B","E01031548","Total",703,698,5
"2011","Crawley 010C","E01031549","Total",529,523,6
"2011","Crawley 010D","E01031550","Total",530,522,8
"2011","Crawley 010E","E01031569","Total",643,639,4
"2011","Crawley 011A","E01031595","Total",654,642,12
"2011","Crawley 011B","E01031604","Total",686,674,12
"2011","Crawley 011C","E01031605","Total",608,599,9
"2011","Crawley 011D","E01031606","Total",616,611,5
"2011","Crawley 011E","E01031607","Total",575,570,5
"2011","Crawley 012A","E01031546","Total",484,477,7
"2011","Crawley 012B","E01031551","Total",497,496,1
"2011","Crawley 012C","E01031553","Total",507,504,3
"2011","Crawley 012D","E01031554","Total",707,700,7
"2011","Crawley 012E","E01031555","Total",493,485,8
"2011","Crawley 013A","E01031552","Total",767,753,14
"2011","Crawley 013B","E01031556","Total",669,663,6
"2011","Crawley 013C","E01031557","Total",877,862,15
"2011","Crawley 013D","E01031558","Total",652,648,4
"2011","Crawley 013E","E01031559","Total",523,514,9
"2011","Horsham 001A","E01031670","Total",735,702,33
"2011","Horsham 001B","E01031671","Total",813,798,15
"2011","Horsham 001C","E01031673","Total",652,645,7
"2011","Horsham 001D","E01031676","Total",1103,1053,50
"2011","Horsham 002A","E01031644","Total",563,559,4
"2011","Horsham 002B","E01031645","Total",554,550,4
"2011","Horsham 002C","E01031646","Total",607,603,4
"2011","Horsham 002D","E01031647","Total",527,508,19
"2011","Horsham 002E","E01031649","Total",465,455,10
"2011","Horsham 002F","E01031650","Total",494,490,4
"2011","Horsham 002G","E01031666","Total",652,646,6
"2011","Horsham 002H","E01031668","Total",662,654,8
"2011","Horsham 003A","E01031620","Total",692,680,12
"2011","Horsham 003B","E01031648","Total",796,783,13
"2011","Horsham 003C","E01031651","Total",656,646,10
"2011","Horsham 003D","E01031658","Total",912,874,38
"2011","Horsham 003E","E01031689","Total",678,663,15
"2011","Horsham 004A","E01031654","Total",661,650,11
"2011","Horsham 004B","E01031655","Total",635,619,16
"2011","Horsham 004C","E01031667","Total",666,652,14
"2011","Horsham 004D","E01031669","Total",694,685,9
"2011","Horsham 004E","E01031672","Total",843,822,21
"2011","Horsham 005A","E01031657","Total",819,789,30
"2011","Horsham 005B","E01031659","Total",578,555,23
"2011","Horsham 005C","E01031674","Total",564,545,19
"2011","Horsham 005D","E01031675","Total",559,541,18
"2011","Horsham 006A","E01031636","Total",1164,1091,73
"2011","Horsham 006B","E01031652","Total",640,631,9
"2011","Horsham 006C","E01031653","Total",820,779,41
"2011","Horsham 006D","E01031656","Total",840,817,23
"2011","Horsham 006E","E01031688","Total",614,603,11
"2011","Horsham 006F","E01031691","Total",789,776,13
"2011","Horsham 007A","E01031619","Total",651,643,8
"2011","Horsham 007B","E01031637","Total",828,812,16
"2011","Horsham 007C","E01031638","Total",807,796,11
"2011","Horsham 007D","E01031690","Total",651,641,10
"2011","Horsham 008A","E01031639","Total",810,798,12
"2011","Horsham 008B","E01031640","Total",723,713,10
"2011","Horsham 008C","E01031660","Total",547,515,32
"2011","Horsham 008D","E01031661","Total",654,630,24
"2011","Horsham 008E","E01031679","Total",535,498,37
"2011","Horsham 009A","E01031677","Total",615,604,11
"2011","Horsham 009B","E01031678","Total",573,571,2
"2011","Horsham 009C","E01031680","Total",497,493,4
"2011","Horsham 009D","E01031681","Total",583,581,2
"2011","Horsham 009E","E01031682","Total",471,470,1
"2011","Horsham 009F","E01031683","Total",640,623,17
"2011","Horsham 010A","E01031611","Total",713,669,44
"2011","Horsham 010B","E01031612","Total",882,874,8
"2011","Horsham 010C","E01031613","Total",863,842,21
"2011","Horsham 010D","E01031614","Total",880,839,41
"2011","Horsham 010E","E01031615","Total",752,721,31
"2011","Horsham 011A","E01031632","Total",646,615,31
"2011","Horsham 011B","E01031633","Total",540,524,16
"2011","Horsham 011C","E01031634","Total",512,493,19
"2011","Horsham 011D","E01031635","Total",563,552,11
"2011","Horsham 012A","E01031621","Total",806,793,13
"2011","Horsham 012B","E01031623","Total",773,752,21
"2011","Horsham 012C","E01031627","Total",848,838,10
"2011","Horsham 012D","E01031664","Total",692,666,26
"2011","Horsham 013A","E01031626","Total",723,669,54
"2011","Horsham 013B","E01031630","Total",862,825,37
"2011","Horsham 013C","E01031631","Total",819,791,28
"2011","Horsham 013D","E01031662","Total",747,719,28
"2011","Horsham 013E","E01031663","Total",796,777,19
"2011","Horsham 013F","E01031665","Total",580,543,37
"2011","Horsham 014A","E01031618","Total",555,542,13
"2011","Horsham 014B","E01031641","Total",787,749,38
"2011","Horsham 014C","E01031642","Total",794,772,22
"2011","Horsham 014D","E01031643","Total",733,725,8
"2011","Horsham 014E","E01031687","Total",692,676,16
"2011","Horsham 015A","E01031622","Total",657,637,20
"2011","Horsham 015B","E01031624","Total",619,599,20
"2011","Horsham 015C","E01031625","Total",565,547,18
"2011","Horsham 015D","E01031628","Total",534,507,27
"2011","Horsham 015E","E01031629","Total",655,631,24
"2011","Horsham 016A","E01031616","Total",714,685,29
"2011","Horsham 016B","E01031617","Total",1021,993,28
"2011","Horsham 016C","E01031684","Total",649,631,18
"2011","Horsham 016D","E01031685","Total",900,842,58
"2011","Horsham 016E","E01031686","Total",647,633,14
"2011","Mid Sussex 001A","E01031731","Total",886,860,26
"2011","Mid Sussex 001B","E01031732","Total",713,699,14
"2011","Mid Sussex 001C","E01031733","Total",776,755,21
"2011","Mid Sussex 001D","E01031734","Total",632,620,12
"2011","Mid Sussex 001E","E01031741","Total",846,819,27
"2011","Mid Sussex 001F","E01031742","Total",1056,971,85
"2011","Mid Sussex 001G","E01031743","Total",801,769,32
"2011","Mid Sussex 002A","E01031718","Total",692,685,7
"2011","Mid Sussex 002B","E01031719","Total",737,722,15
"2011","Mid Sussex 002C","E01031720","Total",554,548,6
"2011","Mid Sussex 002D","E01031722","Total",487,474,13
"2011","Mid Sussex 003A","E01031695","Total",577,565,12
"2011","Mid Sussex 003B","E01031696","Total",572,563,9
"2011","Mid Sussex 003C","E01031729","Total",717,706,11
"2011","Mid Sussex 003D","E01031730","Total",791,781,10
"2011","Mid Sussex 003E","E01031735","Total",704,695,9
"2011","Mid Sussex 004A","E01031736","Total",639,620,19
"2011","Mid Sussex 004B","E01031737","Total",592,580,12
"2011","Mid Sussex 004C","E01031738","Total",518,512,6
"2011","Mid Sussex 004D","E01031739","Total",734,724,10
"2011","Mid Sussex 004E","E01031740","Total",557,545,12
"2011","Mid Sussex 005A","E01031721","Total",721,698,23
"2011","Mid Sussex 005B","E01031723","Total",563,551,12
"2011","Mid Sussex 005C","E01031724","Total",508,506,2
"2011","Mid Sussex 005D","E01031725","Total",601,588,13
"2011","Mid Sussex 006A","E01031694","Total",716,689,27
"2011","Mid Sussex 006B","E01031764","Total",615,596,19
"2011","Mid Sussex 006C","E01031765","Total",643,611,32
"2011","Mid Sussex 006D","E01031766","Total",860,833,27
"2011","Mid Sussex 007A","E01031692","Total",930,897,33
"2011","Mid Sussex 007B","E01031693","Total",786,755,31
"2011","Mid Sussex 007C","E01031697","Total",507,488,19
"2011","Mid Sussex 007D","E01031727","Total",673,644,29
"2011","Mid Sussex 008A","E01031758","Total",510,507,3
"2011","Mid Sussex 008B","E01031760","Total",695,683,12
"2011","Mid Sussex 008C","E01031772","Total",762,724,38
"2011","Mid Sussex 008D","E01031773","Total",835,815,20
"2011","Mid Sussex 008E","E01031774","Total",674,661,13
"2011","Mid Sussex 008F","E01031775","Total",795,775,20
"2011","Mid Sussex 009A","E01031751","Total",1179,1156,23
"2011","Mid Sussex 009B","E01031759","Total",727,710,17
"2011","Mid Sussex 009C","E01031761","Total",1158,1103,55
"2011","Mid Sussex 009E","E01032837","Total",554,552,2
"2011","Mid Sussex 009F","E01032838","Total",574,562,12
"2011","Mid Sussex 009G","E01032839","Total",581,573,8
"2011","Mid Sussex 010A","E01031752","Total",563,558,5
"2011","Mid Sussex 010B","E01031753","Total",602,590,12
"2011","Mid Sussex 010C","E01031754","Total",655,646,9
"2011","Mid Sussex 010D","E01031755","Total",546,533,13
"2011","Mid Sussex 010E","E01031757","Total",703,701,2
"2011","Mid Sussex 011A","E01031726","Total",605,596,9
"2011","Mid Sussex 011B","E01031728","Total",872,840,32
"2011","Mid Sussex 011C","E01031749","Total",609,603,6
"2011","Mid Sussex 011D","E01031750","Total",645,637,8
"2011","Mid Sussex 011E","E01031756","Total",791,778,13
"2011","Mid Sussex 011F","E01031763","Total",706,695,11
"2011","Mid Sussex 012A","E01031699","Total",688,685,3
"2011","Mid Sussex 012B","E01031700","Total",610,607,3
"2011","Mid Sussex 012C","E01031701","Total",765,752,13
"2011","Mid Sussex 012D","E01031714","Total",567,564,3
"2011","Mid Sussex 013A","E01031704","Total",727,717,10
"2011","Mid Sussex 013B","E01031706","Total",682,669,13
"2011","Mid Sussex 013C","E01031711","Total",690,683,7
"2011","Mid Sussex 013D","E01031712","Total",658,639,19
"2011","Mid Sussex 013E","E01031713","Total",564,556,8
"2011","Mid Sussex 014A","E01031705","Total",666,658,8
"2011","Mid Sussex 014B","E01031707","Total",655,647,8
"2011","Mid Sussex 014C","E01031708","Total",788,751,37
"2011","Mid Sussex 014D","E01031709","Total",801,779,22
"2011","Mid Sussex 014E","E01031716","Total",483,476,7
"2011","Mid Sussex 014F","E01031717","Total",584,566,18
"2011","Mid Sussex 015A","E01031702","Total",532,527,5
"2011","Mid Sussex 015B","E01031703","Total",652,646,6
"2011","Mid Sussex 015C","E01031710","Total",596,592,4
"2011","Mid Sussex 015D","E01031715","Total",616,612,4
"2011","Mid Sussex 016A","E01031698","Total",643,624,19
"2011","Mid Sussex 016B","E01031767","Total",549,537,12
"2011","Mid Sussex 016C","E01031769","Total",724,707,17
"2011","Mid Sussex 016D","E01031770","Total",754,719,35
"2011","Mid Sussex 016E","E01031771","Total",616,605,11
"2011","Mid Sussex 017A","E01031744","Total",601,587,14
"2011","Mid Sussex 017B","E01031745","Total",804,788,16
"2011","Mid Sussex 017C","E01031746","Total",744,727,17
"2011","Mid Sussex 017D","E01031747","Total",684,670,14
"2011","Mid Sussex 017E","E01031748","Total",581,569,12
"2011","Mid Sussex 017F","E01031768","Total",691,683,8
"2011","Worthing 001A","E01031793","Total",613,604,9
"2011","Worthing 001B","E01031820","Total",816,796,20
"2011","Worthing 001C","E01031821","Total",795,771,24
"2011","Worthing 001D","E01031828","Total",562,538,24
"2011","Worthing 001E","E01031829","Total",637,621,16
"2011","Worthing 002A","E01031822","Total",670,657,13
"2011","Worthing 002B","E01031825","Total",801,784,17
"2011","Worthing 002C","E01031826","Total",628,613,15
"2011","Worthing 002D","E01031827","Total",673,650,23
"2011","Worthing 002E","E01031839","Total",783,762,21
"2011","Worthing 003A","E01031792","Total",639,621,18
"2011","Worthing 003B","E01031794","Total",683,660,23
"2011","Worthing 003C","E01031795","Total",661,647,14
"2011","Worthing 003D","E01031818","Total",771,758,13
"2011","Worthing 003E","E01031830","Total",664,654,10
"2011","Worthing 004A","E01031778","Total",695,677,18
"2011","Worthing 004B","E01031797","Total",517,512,5
"2011","Worthing 004C","E01031800","Total",639,629,10
"2011","Worthing 004D","E01031823","Total",543,533,10
"2011","Worthing 004E","E01031824","Total",515,511,4
"2011","Worthing 005A","E01031776","Total",713,690,23
"2011","Worthing 005B","E01031777","Total",747,725,22
"2011","Worthing 005C","E01031780","Total",556,553,3
"2011","Worthing 005D","E01031781","Total",640,632,8
"2011","Worthing 005E","E01031798","Total",710,695,15
"2011","Worthing 006A","E01031783","Total",617,614,3
"2011","Worthing 006B","E01031785","Total",656,647,9
"2011","Worthing 006C","E01031786","Total",634,626,8
"2011","Worthing 006D","E01031817","Total",648,640,8
"2011","Worthing 006E","E01031819","Total",480,474,6
"2011","Worthing 007A","E01031782","Total",784,776,8
"2011","Worthing 007B","E01031784","Total",805,780,25
"2011","Worthing 007C","E01031836","Total",784,772,12
"2011","Worthing 007D","E01031838","Total",671,659,12
"2011","Worthing 007E","E01031840","Total",782,771,11
"2011","Worthing 008A","E01031791","Total",1032,1002,30
"2011","Worthing 008B","E01031796","Total",695,667,28
"2011","Worthing 008C","E01031799","Total",689,666,23
"2011","Worthing 008D","E01031801","Total",869,823,46
"2011","Worthing 008E","E01031837","Total",828,811,17
"2011","Worthing 009A","E01031779","Total",544,536,8
"2011","Worthing 009B","E01031831","Total",692,667,25
"2011","Worthing 009C","E01031832","Total",895,866,29
"2011","Worthing 009D","E01031833","Total",690,664,26
"2011","Worthing 009E","E01031834","Total",670,658,12
"2011","Worthing 010A","E01031790","Total",1019,963,56
"2011","Worthing 010B","E01031807","Total",888,853,35
"2011","Worthing 010C","E01031809","Total",971,887,84
"2011","Worthing 010D","E01031810","Total",852,787,65
"2011","Worthing 010E","E01031811","Total",708,674,34
"2011","Worthing 011A","E01031787","Total",1193,1086,107
"2011","Worthing 011B","E01031788","Total",1092,1011,81
"2011","Worthing 011C","E01031789","Total",1148,1025,123
"2011","Worthing 011D","E01031808","Total",918,856,62
"2011","Worthing 011E","E01031835","Total",1047,967,80
"2011","Worthing 012A","E01031812","Total",837,813,24
"2011","Worthing 012B","E01031813","Total",819,799,20
"2011","Worthing 012C","E01031814","Total",754,729,25
"2011","Worthing 012D","E01031815","Total",831,790,41
"2011","Worthing 012E","E01031816","Total",656,652,4
"2011","Worthing 013A","E01031802","Total",860,836,24
"2011","Worthing 013B","E01031803","Total",663,648,15
"2011","Worthing 013C","E01031804","Total",749,732,17
"2011","Worthing 013D","E01031805","Total",816,802,14
"2011","Worthing 013E","E01031806","Total",733,722,11
"2011","Bath and North East Somerset 001A","E01014399","Total",675,660,15
"2011","Bath and North East Somerset 001B","E01014400","Total",903,865,38
"2011","Bath and North East Somerset 001C","E01014401","Total",668,651,17
"2011","Bath and North East Somerset 002A","E01014402","Total",744,731,13
"2011","Bath and North East Somerset 002B","E01014403","Total",856,833,23
"2011","Bath and North East Somerset 002C","E01014404","Total",771,743,28
"2011","Bath and North East Somerset 003A","E01014395","Total",524,519,5
"2011","Bath and North East Somerset 003B","E01014396","Total",682,656,26
"2011","Bath and North East Somerset 003C","E01014397","Total",521,510,11
"2011","Bath and North East Somerset 003D","E01014398","Total",656,639,17
"2011","Bath and North East Somerset 004A","E01014409","Total",774,747,27
"2011","Bath and North East Somerset 004B","E01014410","Total",744,733,11
"2011","Bath and North East Somerset 004C","E01014411","Total",969,932,37
"2011","Bath and North East Somerset 005A","E01014477","Total",648,636,12
"2011","Bath and North East Somerset 005B","E01014478","Total",474,469,5
"2011","Bath and North East Somerset 005C","E01014479","Total",699,650,49
"2011","Bath and North East Somerset 005D","E01014480","Total",578,551,27
"2011","Bath and North East Somerset 006A","E01014465","Total",688,669,19
"2011","Bath and North East Somerset 006B","E01014466","Total",601,576,25
"2011","Bath and North East Somerset 006C","E01014467","Total",870,827,43
"2011","Bath and North East Somerset 006D","E01014468","Total",835,756,79
"2011","Bath and North East Somerset 007A","E01014370","Total",1181,1044,137
"2011","Bath and North East Somerset 007B","E01014371","Total",1233,1084,149
"2011","Bath and North East Somerset 007C","E01014372","Total",1286,1164,122
"2011","Bath and North East Somerset 007D","E01014412","Total",718,679,39
"2011","Bath and North East Somerset 007E","E01014413","Total",699,653,46
"2011","Bath and North East Somerset 007F","E01014414","Total",912,848,64
"2011","Bath and North East Somerset 008A","E01014427","Total",598,582,16
"2011","Bath and North East Somerset 008B","E01014428","Total",573,558,15
"2011","Bath and North East Somerset 008C","E01014429","Total",648,634,14
"2011","Bath and North East Somerset 008D","E01014430","Total",726,709,17
"2011","Bath and North East Somerset 009A","E01014405","Total",872,836,36
"2011","Bath and North East Somerset 009C","E01014407","Total",673,643,30
"2011","Bath and North East Somerset 009E","E01033080","Total",1309,1187,122
"2011","Bath and North East Somerset 010A","E01014373","Total",681,656,25
"2011","Bath and North East Somerset 010B","E01014374","Total",656,642,14
"2011","Bath and North East Somerset 010C","E01014375","Total",533,515,18
"2011","Bath and North East Somerset 010D","E01014376","Total",657,633,24
"2011","Bath and North East Somerset 010E","E01014377","Total",681,656,25
"2011","Bath and North East Somerset 010G","E01033078","Total",750,706,44
"2011","Bath and North East Somerset 010H","E01033079","Total",505,471,34
"2011","Bath and North East Somerset 011A","E01014461","Total",474,461,13
"2011","Bath and North East Somerset 011B","E01014462","Total",624,617,7
"2011","Bath and North East Somerset 011C","E01014463","Total",598,589,9
"2011","Bath and North East Somerset 011D","E01014464","Total",623,606,17
"2011","Bath and North East Somerset 012A","E01014380","Total",542,517,25
"2011","Bath and North East Somerset 012B","E01014381","Total",728,660,68
"2011","Bath and North East Somerset 012C","E01014481","Total",595,562,33
"2011","Bath and North East Somerset 012D","E01014482","Total",527,510,17
"2011","Bath and North East Somerset 012E","E01014483","Total",688,640,48
"2011","Bath and North East Somerset 012F","E01014484","Total",635,611,24
"2011","Bath and North East Somerset 013A","E01014473","Total",592,577,15
"2011","Bath and North East Somerset 013B","E01014474","Total",496,492,4
"2011","Bath and North East Somerset 013C","E01014475","Total",632,623,9
"2011","Bath and North East Somerset 013D","E01014476","Total",534,524,10
"2011","Bath and North East Somerset 014A","E01014435","Total",533,525,8
"2011","Bath and North East Somerset 014B","E01014436","Total",621,616,5
"2011","Bath and North East Somerset 014C","E01014437","Total",641,637,4
"2011","Bath and North East Somerset 014D","E01014438","Total",507,499,8
"2011","Bath and North East Somerset 015A","E01014455","Total",582,567,15
"2011","Bath and North East Somerset 015B","E01014456","Total",637,625,12
"2011","Bath and North East Somerset 015C","E01014457","Total",621,613,8
"2011","Bath and North East Somerset 015D","E01014458","Total",535,522,13
"2011","Bath and North East Somerset 016A","E01014391","Total",637,611,26
"2011","Bath and North East Somerset 016B","E01014392","Total",450,426,24
"2011","Bath and North East Somerset 016C","E01014452","Total",668,658,10
"2011","Bath and North East Somerset 016D","E01014453","Total",521,503,18
"2011","Bath and North East Somerset 016E","E01014454","Total",526,519,7
"2011","Bath and North East Somerset 016F","E01014459","Total",636,612,24
"2011","Bath and North East Somerset 016G","E01014460","Total",509,501,8
"2011","Bath and North East Somerset 017A","E01014415","Total",786,771,15
"2011","Bath and North East Somerset 017B","E01014416","Total",750,726,24
"2011","Bath and North East Somerset 017C","E01014417","Total",761,743,18
"2011","Bath and North East Somerset 018A","E01014387","Total",517,505,12
"2011","Bath and North East Somerset 018B","E01014388","Total",568,546,22
"2011","Bath and North East Somerset 018C","E01014389","Total",643,620,23
"2011","Bath and North East Somerset 018D","E01014390","Total",676,665,11
"2011","Bath and North East Somerset 019A","E01014431","Total",516,511,5
"2011","Bath and North East Somerset 019B","E01014432","Total",558,543,15
"2011","Bath and North East Somerset 019C","E01014433","Total",559,553,6
"2011","Bath and North East Somerset 019D","E01014434","Total",763,757,6
"2011","Bath and North East Somerset 020A","E01014385","Total",525,508,17
"2011","Bath and North East Somerset 020B","E01014386","Total",468,454,14
"2011","Bath and North East Somerset 020C","E01014419","Total",492,483,9
"2011","Bath and North East Somerset 020D","E01014446","Total",470,448,22
"2011","Bath and North East Somerset 020E","E01014447","Total",516,499,17
"2011","Bath and North East Somerset 021A","E01014382","Total",991,944,47
"2011","Bath and North East Somerset 021B","E01014383","Total",451,424,27
"2011","Bath and North East Somerset 021C","E01014384","Total",565,546,19
"2011","Bath and North East Somerset 021D","E01014418","Total",583,565,18
"2011","Bath and North East Somerset 022A","E01014379","Total",884,841,43
"2011","Bath and North East Somerset 022B","E01014442","Total",714,705,9
"2011","Bath and North East Somerset 022C","E01014443","Total",680,658,22
"2011","Bath and North East Somerset 022D","E01014444","Total",595,588,7
"2011","Bath and North East Somerset 022E","E01014445","Total",694,681,13
"2011","Bath and North East Somerset 023A","E01014393","Total",524,511,13
"2011","Bath and North East Somerset 023B","E01014394","Total",698,675,23
"2011","Bath and North East Somerset 023C","E01014439","Total",738,713,25
"2011","Bath and North East Somerset 023D","E01014440","Total",784,761,23
"2011","Bath and North East Somerset 023E","E01014441","Total",741,711,30
"2011","Bath and North East Somerset 024A","E01014448","Total",700,679,21
"2011","Bath and North East Somerset 024B","E01014449","Total",585,568,17
"2011","Bath and North East Somerset 024C","E01014450","Total",543,533,10
"2011","Bath and North East Somerset 024D","E01014451","Total",535,520,15
"2011","Bath and North East Somerset 025A","E01014420","Total",711,691,20
"2011","Bath and North East Somerset 025B","E01014421","Total",537,528,9
"2011","Bath and North East Somerset 025C","E01014422","Total",634,622,12
"2011","Bath and North East Somerset 025D","E01014423","Total",641,614,27
"2011","Bath and North East Somerset 026A","E01014469","Total",495,490,5
"2011","Bath and North East Somerset 026B","E01014470","Total",635,618,17
"2011","Bath and North East Somerset 026C","E01014471","Total",661,645,16
"2011","Bath and North East Somerset 026D","E01014472","Total",556,546,10
"2011","Bath and North East Somerset 027A","E01014424","Total",674,664,10
"2011","Bath and North East Somerset 027B","E01014425","Total",849,829,20
"2011","Bath and North East Somerset 027C","E01014426","Total",655,637,18
"2011","Bournemouth 001A","E01015301","Total",694,671,23
"2011","Bournemouth 001B","E01015303","Total",678,661,17
"2011","Bournemouth 001C","E01015305","Total",629,624,5
"2011","Bournemouth 001D","E01015306","Total",744,732,12
"2011","Bournemouth 002A","E01015302","Total",857,842,15
"2011","Bournemouth 002B","E01015304","Total",791,782,9
"2011","Bournemouth 002C","E01015308","Total",731,718,13
"2011","Bournemouth 002D","E01015311","Total",699,685,14
"2011","Bournemouth 003A","E01015332","Total",719,701,18
"2011","Bournemouth 003B","E01015333","Total",684,677,7
"2011","Bournemouth 003C","E01015334","Total",696,678,18
"2011","Bournemouth 003D","E01015335","Total",711,703,8
"2011","Bournemouth 003E","E01015337","Total",746,727,19
"2011","Bournemouth 004A","E01015343","Total",648,639,9
"2011","Bournemouth 004B","E01015349","Total",669,656,13
"2011","Bournemouth 004C","E01015351","Total",615,606,9
"2011","Bournemouth 004D","E01015352","Total",656,643,13
"2011","Bournemouth 004E","E01015353","Total",509,494,15
"2011","Bournemouth 004F","E01015354","Total",724,712,12
"2011","Bournemouth 005A","E01015307","Total",604,598,6
"2011","Bournemouth 005B","E01015309","Total",590,585,5
"2011","Bournemouth 005C","E01015312","Total",525,519,6
"2011","Bournemouth 005D","E01015313","Total",526,518,8
"2011","Bournemouth 005E","E01015359","Total",795,756,39
"2011","Bournemouth 006A","E01015320","Total",680,671,9
"2011","Bournemouth 006B","E01015323","Total",609,593,16
"2011","Bournemouth 006C","E01015324","Total",681,659,22
"2011","Bournemouth 006D","E01015325","Total",660,648,12
"2011","Bournemouth 006E","E01015350","Total",626,617,9
"2011","Bournemouth 007A","E01015310","Total",619,606,13
"2011","Bournemouth 007B","E01015336","Total",699,674,25
"2011","Bournemouth 007C","E01015355","Total",720,707,13
"2011","Bournemouth 007D","E01015357","Total",716,697,19
"2011","Bournemouth 007E","E01015358","Total",748,733,15
"2011","Bournemouth 008A","E01015338","Total",839,828,11
"2011","Bournemouth 008B","E01015339","Total",689,674,15
"2011","Bournemouth 008C","E01015340","Total",737,723,14
"2011","Bournemouth 008D","E01015341","Total",546,541,5
"2011","Bournemouth 009A","E01015321","Total",775,747,28
"2011","Bournemouth 009B","E01015356","Total",701,684,17
"2011","Bournemouth 009C","E01015374","Total",901,875,26
"2011","Bournemouth 009D","E01015375","Total",725,703,22
"2011","Bournemouth 009E","E01015377","Total",625,608,17
"2011","Bournemouth 010A","E01015322","Total",685,670,15
"2011","Bournemouth 010B","E01015330","Total",803,771,32
"2011","Bournemouth 010C","E01015342","Total",626,615,11
"2011","Bournemouth 010D","E01015373","Total",692,673,19
"2011","Bournemouth 010E","E01015378","Total",630,612,18
"2011","Bournemouth 011A","E01015314","Total",628,615,13
"2011","Bournemouth 011B","E01015315","Total",741,733,8
"2011","Bournemouth 011C","E01015318","Total",744,715,29
"2011","Bournemouth 011D","E01015319","Total",719,626,93
"2011","Bournemouth 012A","E01015344","Total",744,719,25
"2011","Bournemouth 012B","E01015346","Total",696,678,18
"2011","Bournemouth 012C","E01015348","Total",787,767,20
"2011","Bournemouth 012D","E01015360","Total",623,601,22
"2011","Bournemouth 013A","E01015326","Total",865,815,50
"2011","Bournemouth 013B","E01015331","Total",1061,1015,46
"2011","Bournemouth 013C","E01015345","Total",765,728,37
"2011","Bournemouth 013D","E01015376","Total",627,613,14
"2011","Bournemouth 014A","E01015316","Total",698,674,24
"2011","Bournemouth 014B","E01015317","Total",689,683,6
"2011","Bournemouth 014C","E01015361","Total",563,545,18
"2011","Bournemouth 014D","E01015362","Total",474,464,10
"2011","Bournemouth 014E","E01015363","Total",692,669,23
"2011","Bournemouth 015A","E01015292","Total",762,737,25
"2011","Bournemouth 015B","E01015293","Total",658,644,14
"2011","Bournemouth 015C","E01015294","Total",856,831,25
"2011","Bournemouth 015D","E01015327","Total",808,783,25
"2011","Bournemouth 015E","E01015329","Total",711,689,22
"2011","Bournemouth 016A","E01015272","Total",969,833,136
"2011","Bournemouth 016B","E01015273","Total",989,938,51
"2011","Bournemouth 016C","E01015275","Total",782,739,43
"2011","Bournemouth 016D","E01015276","Total",681,658,23
"2011","Bournemouth 016E","E01015277","Total",884,847,37
"2011","Bournemouth 017A","E01015283","Total",1108,992,116
"2011","Bournemouth 017C","E01015286","Total",1159,1086,73
"2011","Bournemouth 017D","E01015287","Total",1258,1183,75
"2011","Bournemouth 017E","E01015328","Total",1017,958,59
"2011","Bournemouth 017F","E01033242","Total",633,590,43
"2011","Bournemouth 017G","E01033285","Total",679,624,55
"2011","Bournemouth 018A","E01015274","Total",906,873,33
"2011","Bournemouth 018B","E01015297","Total",767,698,69
"2011","Bournemouth 018C","E01015364","Total",718,684,34
"2011","Bournemouth 018D","E01015365","Total",826,792,34
"2011","Bournemouth 018E","E01015366","Total",994,888,106
"2011","Bournemouth 019B","E01015279","Total",1041,991,50
"2011","Bournemouth 019C","E01015280","Total",1050,998,52
"2011","Bournemouth 019D","E01015281","Total",938,884,54
"2011","Bournemouth 019E","E01015282","Total",1268,1174,94
"2011","Bournemouth 019F","E01033241","Total",743,679,64
"2011","Bournemouth 019G","E01033283","Total",935,715,220
"2011","Bournemouth 020A","E01015295","Total",691,650,41
"2011","Bournemouth 020B","E01015296","Total",1138,985,153
"2011","Bournemouth 020C","E01015298","Total",842,794,48
"2011","Bournemouth 020D","E01015299","Total",760,732,28
"2011","Bournemouth 020E","E01015300","Total",701,679,22
"2011","Bournemouth 021A","E01015285","Total",1341,1091,250
"2011","Bournemouth 021B","E01015288","Total",949,911,38
"2011","Bournemouth 021C","E01015289","Total",1099,1018,81
"2011","Bournemouth 021D","E01015290","Total",975,887,88
"2011","Bournemouth 021E","E01015291","Total",1380,1101,279
"2011","Bournemouth 023A","E01015371","Total",910,867,43
"2011","Bournemouth 023B","E01015372","Total",1163,1111,52
"2011","Bournemouth 023C","E01033286","Total",649,611,38
"2011","Bournemouth 023D","E01033288","Total",650,615,35
"2011","Bournemouth 024A","E01015367","Total",1266,1110,156
"2011","Bournemouth 024B","E01015368","Total",1210,1019,191
"2011","Bournemouth 024C","E01015369","Total",1057,958,99
"2011","Bournemouth 024D","E01015370","Total",1007,811,196
"2011","Bristol 001A","E01014601","Total",699,687,12
"2011","Bristol 001B","E01014602","Total",850,825,25
"2011","Bristol 001C","E01014603","Total",996,960,36
"2011","Bristol 001E","E01014605","Total",824,810,14
"2011","Bristol 001G","E01032516","Total",868,830,38
"2011","Bristol 001H","E01032517","Total",711,694,17
"2011","Bristol 002A","E01014688","Total",672,644,28
"2011","Bristol 002B","E01014689","Total",660,637,23
"2011","Bristol 002C","E01014690","Total",816,792,24
"2011","Bristol 002D","E01014691","Total",895,853,42
"2011","Bristol 002E","E01014692","Total",622,606,16
"2011","Bristol 002F","E01014693","Total",669,651,18
"2011","Bristol 002G","E01014694","Total",682,667,15
"2011","Bristol 003A","E01014497","Total",699,670,29
"2011","Bristol 003B","E01014498","Total",675,658,17
"2011","Bristol 003C","E01014638","Total",799,788,11
"2011","Bristol 003D","E01014639","Total",638,625,13
"2011","Bristol 003E","E01014640","Total",612,590,22
"2011","Bristol 004A","E01014631","Total",535,520,15
"2011","Bristol 004B","E01014632","Total",667,618,49
"2011","Bristol 004C","E01014633","Total",683,663,20
"2011","Bristol 004D","E01014636","Total",647,635,12
"2011","Bristol 005A","E01014630","Total",890,885,5
"2011","Bristol 005B","E01014634","Total",716,694,22
"2011","Bristol 005C","E01014659","Total",904,880,24
"2011","Bristol 005D","E01014661","Total",615,600,15
"2011","Bristol 006A","E01014616","Total",719,684,35
"2011","Bristol 006B","E01014719","Total",654,628,26
"2011","Bristol 006C","E01014720","Total",800,777,23
"2011","Bristol 006D","E01014721","Total",669,647,22
"2011","Bristol 007A","E01014641","Total",638,625,13
"2011","Bristol 007B","E01014642","Total",624,608,16
"2011","Bristol 007C","E01014643","Total",563,547,16
"2011","Bristol 007D","E01014644","Total",643,613,30
"2011","Bristol 008A","E01014492","Total",751,741,10
"2011","Bristol 008B","E01014493","Total",644,609,35
"2011","Bristol 008C","E01014494","Total",657,623,34
"2011","Bristol 008D","E01014495","Total",767,733,34
"2011","Bristol 008E","E01014496","Total",740,680,60
"2011","Bristol 008F","E01014499","Total",626,609,17
"2011","Bristol 009A","E01014715","Total",627,616,11
"2011","Bristol 009B","E01014716","Total",623,614,9
"2011","Bristol 009C","E01014717","Total",653,637,16
"2011","Bristol 009D","E01014718","Total",656,637,19
"2011","Bristol 010A","E01014510","Total",765,740,25
"2011","Bristol 010B","E01014635","Total",785,769,16
"2011","Bristol 010C","E01014637","Total",547,530,17
"2011","Bristol 010D","E01014662","Total",640,631,9
"2011","Bristol 011A","E01014615","Total",623,609,14
"2011","Bristol 011B","E01014617","Total",533,522,11
"2011","Bristol 011C","E01014618","Total",652,624,28
"2011","Bristol 011D","E01014620","Total",667,634,33
"2011","Bristol 012A","E01014571","Total",677,663,14
"2011","Bristol 012B","E01014577","Total",662,640,22
"2011","Bristol 012C","E01014586","Total",730,719,11
"2011","Bristol 012D","E01014587","Total",624,608,16
"2011","Bristol 013A","E01014588","Total",807,747,60
"2011","Bristol 013B","E01014589","Total",648,630,18
"2011","Bristol 013C","E01014590","Total",771,728,43
"2011","Bristol 013D","E01014591","Total",845,800,45
"2011","Bristol 013E","E01014592","Total",729,694,35
"2011","Bristol 014A","E01014660","Total",689,667,22
"2011","Bristol 014B","E01014663","Total",634,616,18
"2011","Bristol 014C","E01014664","Total",677,664,13
"2011","Bristol 014D","E01014665","Total",798,779,19
"2011","Bristol 015A","E01014709","Total",628,596,32
"2011","Bristol 015B","E01014710","Total",565,529,36
"2011","Bristol 015C","E01014711","Total",530,527,3
"2011","Bristol 015D","E01014712","Total",511,500,11
"2011","Bristol 015E","E01014713","Total",580,565,15
"2011","Bristol 015F","E01014714","Total",535,524,11
"2011","Bristol 016A","E01014507","Total",693,673,20
"2011","Bristol 016B","E01014508","Total",539,510,29
"2011","Bristol 016C","E01014509","Total",873,855,18
"2011","Bristol 016D","E01014511","Total",527,517,10
"2011","Bristol 016E","E01014512","Total",606,587,19
"2011","Bristol 016F","E01014513","Total",639,619,20
"2011","Bristol 016G","E01014514","Total",847,817,30
"2011","Bristol 017A","E01014619","Total",619,602,17
"2011","Bristol 017B","E01014621","Total",609,581,28
"2011","Bristol 017C","E01014666","Total",678,660,18
"2011","Bristol 017D","E01014667","Total",643,625,18
"2011","Bristol 017E","E01014672","Total",1004,962,42
"2011","Bristol 018A","E01014624","Total",680,667,13
"2011","Bristol 018D","E01014629","Total",563,544,19
"2011","Bristol 018E","E01032518","Total",781,737,44
"2011","Bristol 018F","E01032519","Total",519,500,19
"2011","Bristol 019A","E01014572","Total",861,796,65
"2011","Bristol 019B","E01014573","Total",835,803,32
"2011","Bristol 019C","E01014575","Total",687,656,31
"2011","Bristol 019D","E01014576","Total",848,833,15
"2011","Bristol 020A","E01014487","Total",844,819,25
"2011","Bristol 020B","E01014491","Total",783,764,19
"2011","Bristol 020C","E01014668","Total",640,620,20
"2011","Bristol 020D","E01014669","Total",646,621,25
"2011","Bristol 020E","E01014670","Total",621,596,25
"2011","Bristol 020F","E01014671","Total",689,663,26
"2011","Bristol 021A","E01014622","Total",676,625,51
"2011","Bristol 021B","E01014623","Total",667,642,25
"2011","Bristol 021C","E01014626","Total",944,913,31
"2011","Bristol 021D","E01014627","Total",933,903,30
"2011","Bristol 022A","E01014557","Total",605,589,16
"2011","Bristol 022B","E01014558","Total",811,775,36
"2011","Bristol 022C","E01014559","Total",845,816,29
"2011","Bristol 022D","E01014560","Total",812,778,34
"2011","Bristol 022E","E01014562","Total",678,655,23
"2011","Bristol 023A","E01014485","Total",860,828,32
"2011","Bristol 023B","E01014486","Total",1125,1084,41
"2011","Bristol 023C","E01014488","Total",832,797,35
"2011","Bristol 023D","E01014489","Total",1195,1140,55
"2011","Bristol 023F","E01033347","Total",653,608,45
"2011","Bristol 023G","E01033348","Total",568,537,31
"2011","Bristol 023H","E01033366","Total",586,575,11
"2011","Bristol 025A","E01014539","Total",806,784,22
"2011","Bristol 025C","E01014561","Total",810,774,36
"2011","Bristol 025D","E01014563","Total",829,802,27
"2011","Bristol 025E","E01033342","Total",1000,887,113
"2011","Bristol 025F","E01033367","Total",701,666,35
"2011","Bristol 026A","E01014551","Total",852,813,39
"2011","Bristol 026B","E01014552","Total",801,775,26
"2011","Bristol 026C","E01014553","Total",802,759,43
"2011","Bristol 026D","E01014554","Total",887,832,55
"2011","Bristol 026E","E01014556","Total",916,859,57
"2011","Bristol 027A","E01014673","Total",872,817,55
"2011","Bristol 027B","E01014674","Total",670,647,23
"2011","Bristol 027C","E01014675","Total",711,662,49
"2011","Bristol 027D","E01014676","Total",700,669,31
"2011","Bristol 028A","E01014682","Total",700,647,53
"2011","Bristol 028B","E01014683","Total",892,840,52
"2011","Bristol 028C","E01014685","Total",641,623,18
"2011","Bristol 028D","E01014686","Total",722,704,18
"2011","Bristol 028E","E01014687","Total",738,704,34
"2011","Bristol 029A","E01014565","Total",808,778,30
"2011","Bristol 029B","E01014566","Total",855,819,36
"2011","Bristol 029C","E01014567","Total",913,894,19
"2011","Bristol 029D","E01014681","Total",1137,1061,76
"2011","Bristol 029E","E01014684","Total",873,840,33
"2011","Bristol 030A","E01014544","Total",609,577,32
"2011","Bristol 030B","E01014545","Total",850,809,41
"2011","Bristol 030C","E01014546","Total",805,736,69
"2011","Bristol 030D","E01014547","Total",920,857,63
"2011","Bristol 032A","E01014538","Total",717,676,41
"2011","Bristol 032B","E01014540","Total",1259,1164,95
"2011","Bristol 032C","E01014542","Total",931,865,66
"2011","Bristol 032E","E01033344","Total",685,646,39
"2011","Bristol 032F","E01033345","Total",763,661,102
"2011","Bristol 032G","E01033350","Total",726,635,91
"2011","Bristol 033A","E01014677","Total",692,662,30
"2011","Bristol 033B","E01014678","Total",699,674,25
"2011","Bristol 033C","E01014679","Total",678,662,16
"2011","Bristol 033D","E01014680","Total",533,515,18
"2011","Bristol 034A","E01014548","Total",857,832,25
"2011","Bristol 034B","E01014549","Total",566,550,16
"2011","Bristol 034C","E01014550","Total",925,895,30
"2011","Bristol 034D","E01014555","Total",747,711,36
"2011","Bristol 035A","E01014528","Total",702,686,16
"2011","Bristol 035B","E01014529","Total",606,596,10
"2011","Bristol 035C","E01014530","Total",695,684,11
"2011","Bristol 035D","E01014531","Total",795,754,41
"2011","Bristol 035E","E01014532","Total",647,631,16
"2011","Bristol 035F","E01014537","Total",773,756,17
"2011","Bristol 036A","E01014695","Total",889,852,37
"2011","Bristol 036B","E01014696","Total",726,695,31
"2011","Bristol 036C","E01014698","Total",874,857,17
"2011","Bristol 036D","E01014699","Total",724,706,18
"2011","Bristol 036E","E01014700","Total",663,652,11
"2011","Bristol 036F","E01014701","Total",733,712,21
"2011","Bristol 037A","E01014730","Total",909,883,26
"2011","Bristol 037B","E01014731","Total",809,775,34
"2011","Bristol 037C","E01014732","Total",816,799,17
"2011","Bristol 037D","E01014735","Total",771,755,16
"2011","Bristol 038A","E01014523","Total",555,548,7
"2011","Bristol 038B","E01014524","Total",619,591,28
"2011","Bristol 038C","E01014525","Total",670,651,19
"2011","Bristol 038D","E01014526","Total",694,672,22
"2011","Bristol 038E","E01014527","Total",684,660,24
"2011","Bristol 039A","E01014500","Total",740,686,54
"2011","Bristol 039B","E01014502","Total",798,750,48
"2011","Bristol 039E","E01033359","Total",723,704,19
"2011","Bristol 039F","E01033361","Total",769,717,52
"2011","Bristol 039G","E01033362","Total",717,685,32
"2011","Bristol 039H","E01033364","Total",798,780,18
"2011","Bristol 040A","E01014729","Total",620,585,35
"2011","Bristol 040B","E01014733","Total",767,741,26
"2011","Bristol 040C","E01014734","Total",701,678,23
"2011","Bristol 040D","E01014736","Total",870,827,43
"2011","Bristol 041A","E01014501","Total",780,756,24
"2011","Bristol 041B","E01014504","Total",708,656,52
"2011","Bristol 041C","E01014505","Total",848,824,24
"2011","Bristol 041D","E01014506","Total",615,599,16
"2011","Bristol 042A","E01014645","Total",716,688,28
"2011","Bristol 042B","E01014646","Total",663,633,30
"2011","Bristol 042C","E01014648","Total",697,675,22
"2011","Bristol 042D","E01014649","Total",684,670,14
"2011","Bristol 042E","E01014651","Total",691,676,15
"2011","Bristol 043A","E01014533","Total",639,619,20
"2011","Bristol 043B","E01014534","Total",670,650,20
"2011","Bristol 043C","E01014535","Total",771,757,14
"2011","Bristol 043D","E01014536","Total",690,672,18
"2011","Bristol 044A","E01014578","Total",674,645,29
"2011","Bristol 044B","E01014583","Total",555,529,26
"2011","Bristol 044C","E01014585","Total",727,711,16
"2011","Bristol 044D","E01014647","Total",641,613,28
"2011","Bristol 044E","E01014650","Total",632,620,12
"2011","Bristol 045A","E01014579","Total",570,546,24
"2011","Bristol 045B","E01014580","Total",704,666,38
"2011","Bristol 045C","E01014581","Total",657,641,16
"2011","Bristol 045D","E01014582","Total",538,520,18
"2011","Bristol 045E","E01014584","Total",491,468,23
"2011","Bristol 046A","E01014518","Total",749,720,29
"2011","Bristol 046B","E01014519","Total",562,552,10
"2011","Bristol 046C","E01014520","Total",671,652,19
"2011","Bristol 046D","E01014521","Total",542,510,32
"2011","Bristol 047A","E01014607","Total",547,541,6
"2011","Bristol 047B","E01014608","Total",733,719,14
"2011","Bristol 047C","E01014609","Total",721,704,17
"2011","Bristol 047D","E01014610","Total",756,715,41
"2011","Bristol 047E","E01014613","Total",676,659,17
"2011","Bristol 047F","E01014614","Total",513,498,15
"2011","Bristol 048A","E01014594","Total",663,640,23
"2011","Bristol 048B","E01014598","Total",629,616,13
"2011","Bristol 048C","E01014599","Total",554,533,21
"2011","Bristol 048D","E01014600","Total",609,585,24
"2011","Bristol 049A","E01014702","Total",608,599,9
"2011","Bristol 049B","E01014703","Total",696,676,20
"2011","Bristol 049C","E01014704","Total",757,742,15
"2011","Bristol 049D","E01014705","Total",623,616,7
"2011","Bristol 049E","E01014706","Total",637,624,13
"2011","Bristol 049F","E01014707","Total",646,626,20
"2011","Bristol 049G","E01014708","Total",722,708,14
"2011","Bristol 050A","E01014515","Total",646,618,28
"2011","Bristol 050B","E01014516","Total",663,636,27
"2011","Bristol 050C","E01014517","Total",515,495,20
"2011","Bristol 050D","E01014522","Total",752,732,20
"2011","Bristol 051A","E01014593","Total",595,572,23
"2011","Bristol 051B","E01014595","Total",663,642,21
"2011","Bristol 051C","E01014596","Total",631,603,28
"2011","Bristol 051D","E01014597","Total",666,618,48
"2011","Bristol 052A","E01014611","Total",586,560,26
"2011","Bristol 052B","E01014612","Total",635,625,10
"2011","Bristol 052C","E01014722","Total",633,622,11
"2011","Bristol 052D","E01014723","Total",547,533,14
"2011","Bristol 052E","E01014725","Total",624,607,17
"2011","Bristol 053B","E01014726","Total",687,675,12
"2011","Bristol 053C","E01014727","Total",649,631,18
"2011","Bristol 053E","E01032514","Total",920,899,21
"2011","Bristol 053F","E01032515","Total",644,629,15
"2011","Bristol 054A","E01033352","Total",707,678,29
"2011","Bristol 054B","E01033353","Total",766,713,53
"2011","Bristol 054C","E01033355","Total",673,606,67
"2011","Bristol 054D","E01033358","Total",700,689,11
"2011","Bristol 054E","E01033370","Total",722,694,28
"2011","Bristol 055A","E01014564","Total",752,736,16
"2011","Bristol 055B","E01014653","Total",1100,1058,42
"2011","Bristol 055C","E01014655","Total",1122,1063,59
"2011","Bristol 056A","E01014654","Total",917,879,38
"2011","Bristol 056B","E01014658","Total",851,842,9
"2011","Bristol 056C","E01033356","Total",699,693,6
"2011","Bristol 056D","E01033369","Total",611,601,10
"2011","Bristol 057A","E01014568","Total",1046,1007,39
"2011","Bristol 057B","E01014569","Total",893,846,47
"2011","Bristol 057C","E01014570","Total",802,779,23
"2011","Bristol 057D","E01014574","Total",1024,989,35
"2011","Cornwall 010A","E01018753","Total",725,686,39
"2011","Cornwall 010B","E01018754","Total",724,684,40
"2011","Cornwall 010C","E01018755","Total",696,654,42
"2011","Cornwall 010D","E01018756","Total",809,745,64
"2011","Cornwall 012A","E01018777","Total",921,865,56
"2011","Cornwall 012B","E01018782","Total",659,630,29
"2011","Cornwall 012C","E01018783","Total",793,674,119
"2011","Cornwall 012D","E01018784","Total",727,650,77
"2011","Cornwall 013A","E01018750","Total",972,953,19
"2011","Cornwall 013B","E01018751","Total",760,697,63
"2011","Cornwall 013C","E01018752","Total",917,858,59
"2011","Cornwall 013D","E01018779","Total",1013,971,42
"2011","Cornwall 016A","E01018758","Total",1078,1030,48
"2011","Cornwall 016B","E01018768","Total",811,781,30
"2011","Cornwall 016C","E01018769","Total",890,832,58
"2011","Cornwall 016D","E01018778","Total",782,736,46
"2011","Cornwall 017A","E01018767","Total",660,647,13
"2011","Cornwall 017B","E01018770","Total",572,552,20
"2011","Cornwall 017C","E01018771","Total",778,704,74
"2011","Cornwall 017D","E01018772","Total",748,705,43
"2011","Cornwall 022A","E01018764","Total",657,616,41
"2011","Cornwall 022B","E01018787","Total",629,604,25
"2011","Cornwall 022C","E01018795","Total",536,510,26
"2011","Cornwall 022D","E01018796","Total",506,498,8
"2011","Cornwall 023A","E01018757","Total",1160,939,221
"2011","Cornwall 023B","E01018763","Total",487,447,40
"2011","Cornwall 023C","E01018765","Total",706,671,35
"2011","Cornwall 023D","E01018785","Total",859,822,37
"2011","Cornwall 025A","E01018786","Total",566,550,16
"2011","Cornwall 025B","E01018788","Total",749,723,26
"2011","Cornwall 025C","E01018790","Total",495,487,8
"2011","Cornwall 025D","E01018794","Total",625,612,13
"2011","Cornwall 026A","E01018789","Total",619,604,15
"2011","Cornwall 026B","E01018791","Total",550,531,19
"2011","Cornwall 026C","E01018792","Total",1209,1183,26
"2011","Cornwall 026D","E01018793","Total",797,772,25
"2011","Cornwall 028A","E01018759","Total",668,629,39
"2011","Cornwall 028B","E01018760","Total",588,514,74
"2011","Cornwall 028C","E01018761","Total",794,695,99
"2011","Cornwall 028D","E01018766","Total",1212,858,354
"2011","Cornwall 028E","E01018774","Total",826,673,153
"2011","Cornwall 029A","E01018797","Total",546,501,45
"2011","Cornwall 029B","E01018798","Total",696,665,31
"2011","Cornwall 029C","E01018799","Total",575,561,14
"2011","Cornwall 029D","E01018800","Total",680,656,24
"2011","Cornwall 034A","E01018780","Total",1062,1002,60
"2011","Cornwall 034B","E01018781","Total",1311,853,458
"2011","Cornwall 034E","E01033294","Total",1036,1017,19
"2011","Cornwall 037A","E01018762","Total",747,549,198
"2011","Cornwall 037B","E01018773","Total",876,727,149
"2011","Cornwall 037C","E01018775","Total",724,636,88
"2011","Cornwall 037D","E01018776","Total",910,597,313
"2011","Cornwall 032A","E01018815","Total",876,836,40
"2011","Cornwall 032B","E01018831","Total",573,536,37
"2011","Cornwall 032C","E01018832","Total",629,553,76
"2011","Cornwall 032D","E01018847","Total",673,631,42
"2011","Cornwall 033A","E01018833","Total",672,591,81
"2011","Cornwall 033B","E01018842","Total",695,621,74
"2011","Cornwall 033C","E01018843","Total",612,534,78
"2011","Cornwall 033D","E01018844","Total",771,616,155
"2011","Cornwall 040A","E01018825","Total",798,667,131
"2011","Cornwall 040B","E01018826","Total",1035,987,48
"2011","Cornwall 040C","E01018851","Total",761,672,89
"2011","Cornwall 040D","E01018852","Total",1326,1078,248
"2011","Cornwall 042A","E01018823","Total",793,748,45
"2011","Cornwall 042B","E01018824","Total",1047,1031,16
"2011","Cornwall 042C","E01018853","Total",1055,1010,45
"2011","Cornwall 042D","E01018854","Total",632,598,34
"2011","Cornwall 043A","E01018819","Total",663,652,11
"2011","Cornwall 043B","E01018822","Total",529,516,13
"2011","Cornwall 043C","E01018855","Total",981,936,45
"2011","Cornwall 043D","E01018856","Total",653,638,15
"2011","Cornwall 043E","E01018857","Total",550,540,10
"2011","Cornwall 043F","E01018858","Total",655,632,23
"2011","Cornwall 044A","E01018807","Total",672,626,46
"2011","Cornwall 044B","E01018808","Total",690,656,34
"2011","Cornwall 044C","E01018809","Total",1248,1141,107
"2011","Cornwall 044D","E01018810","Total",614,579,35
"2011","Cornwall 047A","E01018816","Total",825,736,89
"2011","Cornwall 047B","E01018817","Total",999,886,113
"2011","Cornwall 047C","E01018818","Total",749,721,28
"2011","Cornwall 047D","E01018820","Total",805,759,46
"2011","Cornwall 047E","E01018821","Total",502,492,10
"2011","Cornwall 048A","E01018845","Total",727,665,62
"2011","Cornwall 048B","E01018846","Total",702,606,96
"2011","Cornwall 048C","E01018848","Total",739,698,41
"2011","Cornwall 048D","E01018849","Total",1609,941,668
"2011","Cornwall 048E","E01018850","Total",775,586,189
"2011","Cornwall 056A","E01018827","Total",734,656,78
"2011","Cornwall 056B","E01018828","Total",847,696,151
"2011","Cornwall 056C","E01018829","Total",571,539,32
"2011","Cornwall 056D","E01018830","Total",689,673,16
"2011","Cornwall 060A","E01018834","Total",748,718,30
"2011","Cornwall 060B","E01018835","Total",786,756,30
"2011","Cornwall 060C","E01018836","Total",823,758,65
"2011","Cornwall 060D","E01018837","Total",985,914,71
"2011","Cornwall 062A","E01018838","Total",648,625,23
"2011","Cornwall 062B","E01018839","Total",716,586,130
"2011","Cornwall 062C","E01018840","Total",755,689,66
"2011","Cornwall 062D","E01018841","Total",616,582,34
"2011","Cornwall 062E","E01018860","Total",843,826,17
"2011","Cornwall 063A","E01018803","Total",1339,966,373
"2011","Cornwall 063B","E01018804","Total",880,742,138
"2011","Cornwall 063C","E01018805","Total",750,685,65
"2011","Cornwall 063D","E01018806","Total",667,641,26
"2011","Cornwall 064A","E01018811","Total",639,622,17
"2011","Cornwall 064B","E01018812","Total",609,594,15
"2011","Cornwall 064C","E01018813","Total",634,599,35
"2011","Cornwall 064D","E01018814","Total",616,597,19
"2011","Cornwall 064E","E01018859","Total",769,755,14
"2011","Cornwall 045A","E01018889","Total",560,548,12
"2011","Cornwall 045B","E01018890","Total",640,630,10
"2011","Cornwall 045C","E01018891","Total",617,589,28
"2011","Cornwall 045D","E01018892","Total",706,584,122
"2011","Cornwall 045E","E01018893","Total",661,618,43
"2011","Cornwall 046A","E01018908","Total",711,692,19
"2011","Cornwall 046B","E01018909","Total",723,695,28
"2011","Cornwall 046C","E01018910","Total",809,776,33
"2011","Cornwall 046D","E01018911","Total",911,835,76
"2011","Cornwall 049A","E01018912","Total",664,630,34
"2011","Cornwall 049B","E01018913","Total",850,777,73
"2011","Cornwall 049C","E01018914","Total",868,814,54
"2011","Cornwall 049D","E01018915","Total",943,872,71
"2011","Cornwall 050A","E01018916","Total",579,545,34
"2011","Cornwall 050B","E01018917","Total",626,597,29
"2011","Cornwall 050C","E01018918","Total",810,764,46
"2011","Cornwall 050D","E01018919","Total",637,611,26
"2011","Cornwall 051A","E01018894","Total",781,742,39
"2011","Cornwall 051B","E01018895","Total",720,678,42
"2011","Cornwall 051C","E01018896","Total",665,649,16
"2011","Cornwall 051D","E01018897","Total",674,641,33
"2011","Cornwall 051E","E01018898","Total",566,552,14
"2011","Cornwall 052A","E01018865","Total",870,819,51
"2011","Cornwall 052B","E01018866","Total",755,716,39
"2011","Cornwall 052C","E01018867","Total",812,795,17
"2011","Cornwall 052D","E01018868","Total",800,760,40
"2011","Cornwall 053A","E01018874","Total",596,587,9
"2011","Cornwall 053B","E01018875","Total",651,630,21
"2011","Cornwall 053C","E01018876","Total",609,575,34
"2011","Cornwall 053D","E01018877","Total",667,629,38
"2011","Cornwall 053E","E01018878","Total",765,702,63
"2011","Cornwall 055A","E01018869","Total",681,661,20
"2011","Cornwall 055B","E01018870","Total",501,492,9
"2011","Cornwall 055C","E01018871","Total",729,702,27
"2011","Cornwall 055D","E01018872","Total",575,532,43
"2011","Cornwall 055E","E01018873","Total",520,505,15
"2011","Cornwall 059A","E01018863","Total",700,660,40
"2011","Cornwall 059B","E01018864","Total",718,664,54
"2011","Cornwall 059C","E01018921","Total",923,872,51
"2011","Cornwall 059D","E01018922","Total",990,921,69
"2011","Cornwall 066A","E01018879","Total",998,799,199
"2011","Cornwall 066B","E01018880","Total",1029,919,110
"2011","Cornwall 066C","E01018899","Total",638,618,20
"2011","Cornwall 066D","E01018900","Total",786,639,147
"2011","Cornwall 066E","E01018901","Total",716,699,17
"2011","Cornwall 071A","E01018882","Total",630,616,14
"2011","Cornwall 071B","E01018883","Total",672,651,21
"2011","Cornwall 071C","E01018884","Total",699,684,15
"2011","Cornwall 071D","E01018885","Total",721,680,41
"2011","Cornwall 071E","E01018886","Total",772,738,34
"2011","Cornwall 071F","E01018887","Total",675,643,32
"2011","Cornwall 071G","E01018888","Total",926,904,22
"2011","Cornwall 072A","E01018861","Total",667,613,54
"2011","Cornwall 072B","E01018862","Total",764,619,145
"2011","Cornwall 072C","E01018905","Total",648,570,78
"2011","Cornwall 072D","E01018906","Total",757,566,191
"2011","Cornwall 072E","E01018907","Total",677,589,88
"2011","Cornwall 073A","E01018881","Total",1093,815,278
"2011","Cornwall 073B","E01018902","Total",721,512,209
"2011","Cornwall 073C","E01018903","Total",519,446,73
"2011","Cornwall 073D","E01018904","Total",1102,942,160
"2011","Cornwall 073E","E01018920","Total",1131,885,246
"2011","Cornwall 001A","E01018936","Total",836,713,123
"2011","Cornwall 001B","E01018937","Total",801,772,29
"2011","Cornwall 001C","E01018938","Total",885,812,73
"2011","Cornwall 001D","E01018959","Total",773,684,89
"2011","Cornwall 001E","E01018960","Total",906,796,110
"2011","Cornwall 001F","E01018961","Total",802,707,95
"2011","Cornwall 002A","E01018943","Total",1238,897,341
"2011","Cornwall 002B","E01018951","Total",1155,949,206
"2011","Cornwall 002C","E01018974","Total",1132,1007,125
"2011","Cornwall 003A","E01018940","Total",802,691,111
"2011","Cornwall 003B","E01018941","Total",811,684,127
"2011","Cornwall 003C","E01018942","Total",890,692,198
"2011","Cornwall 003D","E01018969","Total",1405,1011,394
"2011","Cornwall 004B","E01018953","Total",545,496,49
"2011","Cornwall 004C","E01018968","Total",1126,1002,124
"2011","Cornwall 004D","E01033291","Total",758,660,98
"2011","Cornwall 004E","E01033292","Total",648,576,72
"2011","Cornwall 005A","E01018946","Total",694,678,16
"2011","Cornwall 005B","E01018947","Total",1238,1179,59
"2011","Cornwall 005C","E01018948","Total",774,710,64
"2011","Cornwall 005D","E01018949","Total",549,523,26
"2011","Cornwall 005E","E01018950","Total",917,836,81
"2011","Cornwall 006A","E01018925","Total",1021,916,105
"2011","Cornwall 006B","E01018952","Total",534,501,33
"2011","Cornwall 006C","E01018965","Total",1086,995,91
"2011","Cornwall 006D","E01018966","Total",504,467,37
"2011","Cornwall 006E","E01018967","Total",579,535,44
"2011","Cornwall 007A","E01018924","Total",577,467,110
"2011","Cornwall 007B","E01018962","Total",1443,930,513
"2011","Cornwall 007E","E01033289","Total",2067,999,1068
"2011","Cornwall 008A","E01018954","Total",680,476,204
"2011","Cornwall 008B","E01018955","Total",1406,684,722
"2011","Cornwall 008C","E01018956","Total",671,474,197
"2011","Cornwall 008D","E01018957","Total",786,542,244
"2011","Cornwall 008E","E01018958","Total",1015,634,381
"2011","Cornwall 009A","E01018970","Total",655,634,21
"2011","Cornwall 009B","E01018971","Total",917,851,66
"2011","Cornwall 009C","E01018972","Total",890,832,58
"2011","Cornwall 009D","E01018973","Total",689,638,51
"2011","Cornwall 011A","E01018923","Total",631,531,100
"2011","Cornwall 011B","E01018926","Total",1200,1027,173
"2011","Cornwall 011C","E01018944","Total",485,455,30
"2011","Cornwall 011D","E01018945","Total",649,540,109
"2011","Cornwall 014A","E01018932","Total",722,703,19
"2011","Cornwall 014B","E01018933","Total",722,657,65
"2011","Cornwall 014C","E01018934","Total",847,811,36
"2011","Cornwall 014D","E01018935","Total",964,927,37
"2011","Cornwall 015A","E01018927","Total",662,648,14
"2011","Cornwall 015B","E01018928","Total",817,790,27
"2011","Cornwall 015C","E01018929","Total",557,539,18
"2011","Cornwall 015D","E01018930","Total",678,669,9
"2011","Cornwall 015E","E01018931","Total",516,502,14
"2011","Cornwall 054A","E01019008","Total",682,642,40
"2011","Cornwall 054B","E01019009","Total",659,606,53
"2011","Cornwall 054C","E01019010","Total",648,569,79
"2011","Cornwall 054D","E01019011","Total",839,628,211
"2011","Cornwall 054E","E01019012","Total",1935,1000,935
"2011","Cornwall 057A","E01018978","Total",660,632,28
"2011","Cornwall 057B","E01018981","Total",958,907,51
"2011","Cornwall 057C","E01018982","Total",1040,919,121
"2011","Cornwall 057D","E01018983","Total",707,682,25
"2011","Cornwall 057E","E01018984","Total",918,891,27
"2011","Cornwall 058A","E01018985","Total",1136,995,141
"2011","Cornwall 058B","E01018986","Total",992,746,246
"2011","Cornwall 058C","E01018987","Total",1001,915,86
"2011","Cornwall 061A","E01018975","Total",887,827,60
"2011","Cornwall 061B","E01018979","Total",594,542,52
"2011","Cornwall 061C","E01018980","Total",699,577,122
"2011","Cornwall 061D","E01018990","Total",1096,859,237
"2011","Cornwall 061E","E01019007","Total",1029,909,120
"2011","Cornwall 065A","E01018988","Total",723,669,54
"2011","Cornwall 065B","E01018989","Total",810,717,93
"2011","Cornwall 065C","E01018991","Total",808,680,128
"2011","Cornwall 065D","E01019006","Total",811,687,124
"2011","Cornwall 067A","E01018976","Total",1044,976,68
"2011","Cornwall 067B","E01018977","Total",618,608,10
"2011","Cornwall 067C","E01018994","Total",825,776,49
"2011","Cornwall 067D","E01018996","Total",871,752,119
"2011","Cornwall 067E","E01018997","Total",596,573,23
"2011","Cornwall 068A","E01018995","Total",1130,1048,82
"2011","Cornwall 068B","E01018998","Total",733,687,46
"2011","Cornwall 068C","E01018999","Total",946,797,149
"2011","Cornwall 068D","E01019001","Total",1078,940,138
"2011","Cornwall 069A","E01018992","Total",897,727,170
"2011","Cornwall 069B","E01018993","Total",881,794,87
"2011","Cornwall 069C","E01019005","Total",1280,908,372
"2011","Cornwall 070A","E01019000","Total",750,682,68
"2011","Cornwall 070B","E01019002","Total",1042,705,337
"2011","Cornwall 070C","E01019003","Total",861,777,84
"2011","Cornwall 070D","E01019004","Total",856,756,100
"2011","Cornwall 018A","E01019048","Total",1109,806,303
"2011","Cornwall 018B","E01019049","Total",818,752,66
"2011","Cornwall 018C","E01019050","Total",623,583,40
"2011","Cornwall 018D","E01019051","Total",738,712,26
"2011","Cornwall 019A","E01019060","Total",934,629,305
"2011","Cornwall 019B","E01019061","Total",763,718,45
"2011","Cornwall 019C","E01019062","Total",815,788,27
"2011","Cornwall 019D","E01019063","Total",864,799,65
"2011","Cornwall 019E","E01019064","Total",860,775,85
"2011","Cornwall 019F","E01019065","Total",546,523,23
"2011","Cornwall 020A","E01019028","Total",1220,938,282
"2011","Cornwall 020B","E01019029","Total",902,687,215
"2011","Cornwall 020C","E01019030","Total",857,742,115
"2011","Cornwall 020D","E01019031","Total",1003,724,279
"2011","Cornwall 021A","E01019018","Total",676,656,20
"2011","Cornwall 021B","E01019019","Total",686,638,48
"2011","Cornwall 021C","E01019020","Total",850,688,162
"2011","Cornwall 021D","E01019021","Total",685,651,34
"2011","Cornwall 021E","E01019022","Total",842,769,73
"2011","Cornwall 021F","E01019023","Total",640,630,10
"2011","Cornwall 024A","E01019052","Total",778,723,55
"2011","Cornwall 024B","E01019053","Total",970,842,128
"2011","Cornwall 024C","E01019054","Total",776,742,34
"2011","Cornwall 024D","E01019055","Total",606,577,29
"2011","Cornwall 027A","E01019035","Total",805,720,85
"2011","Cornwall 027B","E01019036","Total",762,720,42
"2011","Cornwall 027C","E01019037","Total",640,603,37
"2011","Cornwall 027D","E01019074","Total",756,721,35
"2011","Cornwall 027E","E01019075","Total",715,691,24
"2011","Cornwall 027F","E01019076","Total",775,737,38
"2011","Cornwall 030A","E01019069","Total",554,531,23
"2011","Cornwall 030B","E01019070","Total",911,863,48
"2011","Cornwall 030C","E01019071","Total",626,601,25
"2011","Cornwall 030D","E01019072","Total",632,610,22
"2011","Cornwall 030E","E01019073","Total",598,575,23
"2011","Cornwall 031A","E01019056","Total",632,610,22
"2011","Cornwall 031B","E01019057","Total",825,799,26
"2011","Cornwall 031C","E01019058","Total",814,749,65
"2011","Cornwall 031D","E01019059","Total",711,683,28
"2011","Cornwall 035A","E01019024","Total",652,604,48
"2011","Cornwall 035B","E01019025","Total",743,612,131
"2011","Cornwall 035C","E01019026","Total",687,644,43
"2011","Cornwall 035D","E01019027","Total",1064,717,347
"2011","Cornwall 036A","E01019013","Total",980,932,48
"2011","Cornwall 036B","E01019014","Total",582,571,11
"2011","Cornwall 036C","E01019015","Total",596,591,5
"2011","Cornwall 036D","E01019016","Total",719,697,22
"2011","Cornwall 036E","E01019017","Total",1328,1075,253
"2011","Cornwall 038A","E01019032","Total",627,611,16
"2011","Cornwall 038B","E01019034","Total",663,622,41
"2011","Cornwall 038C","E01019045","Total",1007,871,136
"2011","Cornwall 038D","E01019047","Total",508,483,25
"2011","Cornwall 039A","E01019033","Total",735,694,41
"2011","Cornwall 039B","E01019041","Total",812,763,49
"2011","Cornwall 039C","E01019042","Total",786,749,37
"2011","Cornwall 039D","E01019043","Total",708,678,30
"2011","Cornwall 039E","E01019044","Total",751,721,30
"2011","Cornwall 039F","E01019046","Total",613,590,23
"2011","Cornwall 041A","E01019038","Total",824,549,275
"2011","Cornwall 041B","E01019039","Total",774,598,176
"2011","Cornwall 041C","E01019040","Total",625,546,79
"2011","Cornwall 041D","E01019066","Total",560,501,59
"2011","Cornwall 041E","E01019067","Total",577,493,84
"2011","Cornwall 041F","E01019068","Total",754,720,34
"2011","Isles of Scilly 001A","E01019077","Total",1389,989,400
"2011","North Somerset 001B","E01014790","Total",640,624,16
"2011","North Somerset 001C","E01014795","Total",615,605,10
"2011","North Somerset 001D","E01014797","Total",767,740,27
"2011","North Somerset 001E","E01032675","Total",668,637,31
"2011","North Somerset 001F","E01032676","Total",762,726,36
"2011","North Somerset 001G","E01032681","Total",661,628,33
"2011","North Somerset 002A","E01014789","Total",643,615,28
"2011","North Somerset 002B","E01014793","Total",672,666,6
"2011","North Somerset 002C","E01014794","Total",754,745,9
"2011","North Somerset 002D","E01014798","Total",596,587,9
"2011","North Somerset 003B","E01014792","Total",906,891,15
"2011","North Somerset 003C","E01014796","Total",750,732,18
"2011","North Somerset 003D","E01032677","Total",588,573,15
"2011","North Somerset 003E","E01032678","Total",558,553,5
"2011","North Somerset 003F","E01032682","Total",431,425,6
"2011","North Somerset 004A","E01014766","Total",611,564,47
"2011","North Somerset 004B","E01014767","Total",588,572,16
"2011","North Somerset 004C","E01014786","Total",741,721,20
"2011","North Somerset 004D","E01014787","Total",839,814,25
"2011","North Somerset 005A","E01014752","Total",668,646,22
"2011","North Somerset 005B","E01014754","Total",687,636,51
"2011","North Somerset 005C","E01014758","Total",529,512,17
"2011","North Somerset 005D","E01014759","Total",619,596,23
"2011","North Somerset 006B","E01014849","Total",717,682,35
"2011","North Somerset 006C","E01014850","Total",851,822,29
"2011","North Somerset 006D","E01014851","Total",1114,1080,34
"2011","North Somerset 006E","E01014852","Total",633,613,20
"2011","North Somerset 006F","E01032674","Total",973,948,25
"2011","North Somerset 006G","E01032680","Total",830,797,33
"2011","North Somerset 007A","E01014750","Total",770,742,28
"2011","North Somerset 007B","E01014751","Total",726,716,10
"2011","North Somerset 007C","E01014753","Total",832,810,22
"2011","North Somerset 007D","E01014755","Total",681,627,54
"2011","North Somerset 007E","E01014760","Total",653,626,27
"2011","North Somerset 008A","E01014780","Total",730,715,15
"2011","North Somerset 008B","E01014781","Total",818,789,29
"2011","North Somerset 008C","E01014782","Total",614,605,9
"2011","North Somerset 008D","E01014783","Total",744,729,15
"2011","North Somerset 008E","E01014784","Total",715,702,13
"2011","North Somerset 008F","E01014785","Total",592,587,5
"2011","North Somerset 009A","E01014775","Total",502,496,6
"2011","North Somerset 009B","E01014776","Total",507,498,9
"2011","North Somerset 009C","E01014777","Total",634,628,6
"2011","North Somerset 009D","E01014778","Total",542,536,6
"2011","North Somerset 009E","E01014779","Total",500,493,7
"2011","North Somerset 010A","E01014756","Total",781,768,13
"2011","North Somerset 010B","E01014757","Total",627,620,7
"2011","North Somerset 010C","E01014761","Total",742,729,13
"2011","North Somerset 010D","E01014762","Total",621,612,9
"2011","North Somerset 010E","E01014763","Total",732,719,13
"2011","North Somerset 011A","E01014737","Total",620,603,17
"2011","North Somerset 011B","E01014738","Total",573,566,7
"2011","North Somerset 011C","E01014739","Total",618,589,29
"2011","North Somerset 011D","E01014740","Total",541,530,11
"2011","North Somerset 012A","E01014855","Total",594,581,13
"2011","North Somerset 012B","E01014856","Total",597,590,7
"2011","North Somerset 012C","E01014857","Total",630,616,14
"2011","North Somerset 012D","E01014858","Total",747,714,33
"2011","North Somerset 012E","E01014859","Total",654,636,18
"2011","North Somerset 012F","E01014860","Total",635,624,11
"2011","North Somerset 013A","E01014847","Total",716,681,35
"2011","North Somerset 013B","E01014848","Total",558,522,36
"2011","North Somerset 013C","E01014853","Total",765,739,26
"2011","North Somerset 013D","E01014854","Total",583,549,34
"2011","North Somerset 014A","E01014764","Total",708,687,21
"2011","North Somerset 014B","E01014765","Total",767,735,32
"2011","North Somerset 014C","E01014773","Total",660,640,20
"2011","North Somerset 014D","E01014774","Total",729,694,35
"2011","North Somerset 015A","E01014821","Total",509,500,9
"2011","North Somerset 015B","E01014822","Total",547,542,5
"2011","North Somerset 015C","E01014823","Total",510,504,6
"2011","North Somerset 015D","E01014824","Total",654,644,10
"2011","North Somerset 015E","E01014825","Total",493,487,6
"2011","North Somerset 015F","E01014826","Total",638,630,8
"2011","North Somerset 015G","E01014827","Total",609,598,11
"2011","North Somerset 016A","E01014817","Total",713,695,18
"2011","North Somerset 016B","E01014820","Total",734,719,15
"2011","North Somerset 016C","E01014835","Total",662,650,12
"2011","North Somerset 016D","E01014836","Total",669,644,25
"2011","North Somerset 016E","E01014838","Total",601,594,7
"2011","North Somerset 016F","E01014840","Total",623,615,8
"2011","North Somerset 017A","E01014812","Total",712,675,37
"2011","North Somerset 017B","E01014813","Total",771,734,37
"2011","North Somerset 017C","E01014815","Total",611,587,24
"2011","North Somerset 017D","E01014816","Total",664,648,16
"2011","North Somerset 017E","E01014818","Total",770,750,20
"2011","North Somerset 017F","E01014819","Total",747,732,15
"2011","North Somerset 018A","E01014841","Total",1125,978,147
"2011","North Somerset 018B","E01014842","Total",991,822,169
"2011","North Somerset 018C","E01014843","Total",698,670,28
"2011","North Somerset 018D","E01014844","Total",856,769,87
"2011","North Somerset 018E","E01014845","Total",607,577,30
"2011","North Somerset 018F","E01014846","Total",681,637,44
"2011","North Somerset 020A","E01014799","Total",847,801,46
"2011","North Somerset 020B","E01014800","Total",898,799,99
"2011","North Somerset 020C","E01014801","Total",940,793,147
"2011","North Somerset 020D","E01014802","Total",813,758,55
"2011","North Somerset 020E","E01014809","Total",829,772,57
"2011","North Somerset 020F","E01014811","Total",775,742,33
"2011","North Somerset 021A","E01014829","Total",845,793,52
"2011","North Somerset 021B","E01014830","Total",718,657,61
"2011","North Somerset 021C","E01014831","Total",639,582,57
"2011","North Somerset 021D","E01014832","Total",678,630,48
"2011","North Somerset 021E","E01014833","Total",680,645,35
"2011","North Somerset 022A","E01014804","Total",680,624,56
"2011","North Somerset 022B","E01014806","Total",855,780,75
"2011","North Somerset 022C","E01014807","Total",884,818,66
"2011","North Somerset 022D","E01014808","Total",628,588,40
"2011","North Somerset 023A","E01014744","Total",631,606,25
"2011","North Somerset 023B","E01014746","Total",627,597,30
"2011","North Somerset 023C","E01014769","Total",970,943,27
"2011","North Somerset 023D","E01014770","Total",665,632,33
"2011","North Somerset 023E","E01014771","Total",656,637,19
"2011","North Somerset 023F","E01014772","Total",661,614,47
"2011","North Somerset 024A","E01014741","Total",700,646,54
"2011","North Somerset 024B","E01014742","Total",639,613,26
"2011","North Somerset 024C","E01014745","Total",704,657,47
"2011","North Somerset 024D","E01014747","Total",612,587,25
"2011","North Somerset 024E","E01014748","Total",459,441,18
"2011","North Somerset 024F","E01014749","Total",527,507,20
"2011","North Somerset 025A","E01014803","Total",682,644,38
"2011","North Somerset 025B","E01014805","Total",713,688,25
"2011","North Somerset 025C","E01014828","Total",618,579,39
"2011","North Somerset 025D","E01014834","Total",640,621,19
"2011","North Somerset 026A","E01014839","Total",635,631,4
"2011","North Somerset 026B","E01032666","Total",506,482,24
"2011","North Somerset 026C","E01032667","Total",435,429,6
"2011","North Somerset 026D","E01032668","Total",610,602,8
"2011","North Somerset 026E","E01032672","Total",600,586,14
"2011","North Somerset 026F","E01032673","Total",633,622,11
"2011","North Somerset 027A","E01014810","Total",726,693,33
"2011","North Somerset 027B","E01032669","Total",575,561,14
"2011","North Somerset 027C","E01032670","Total",593,586,7
"2011","North Somerset 027D","E01032671","Total",505,496,9
"2011","North Somerset 027E","E01032679","Total",559,551,8
"2011","Plymouth 001A","E01015025","Total",671,655,16
"2011","Plymouth 001B","E01015097","Total",854,830,24
"2011","Plymouth 001C","E01015160","Total",637,624,13
"2011","Plymouth 001D","E01015164","Total",774,734,40
"2011","Plymouth 002A","E01015027","Total",657,647,10
"2011","Plymouth 002B","E01015159","Total",777,767,10
"2011","Plymouth 002C","E01015161","Total",649,640,9
"2011","Plymouth 002D","E01015162","Total",648,633,15
"2011","Plymouth 002E","E01015166","Total",841,821,20
"2011","Plymouth 003A","E01015023","Total",693,686,7
"2011","Plymouth 003B","E01015026","Total",790,769,21
"2011","Plymouth 003C","E01015028","Total",665,642,23
"2011","Plymouth 003D","E01015163","Total",601,593,8
"2011","Plymouth 003E","E01015165","Total",656,643,13
"2011","Plymouth 004A","E01015024","Total",665,648,17
"2011","Plymouth 004B","E01015082","Total",711,693,18
"2011","Plymouth 004C","E01015083","Total",716,687,29
"2011","Plymouth 004D","E01015084","Total",642,620,22
"2011","Plymouth 005A","E01015090","Total",576,567,9
"2011","Plymouth 005B","E01015091","Total",633,629,4
"2011","Plymouth 005C","E01015092","Total",535,483,52
"2011","Plymouth 005D","E01015093","Total",642,634,8
"2011","Plymouth 005E","E01015094","Total",605,596,9
"2011","Plymouth 006A","E01015085","Total",744,716,28
"2011","Plymouth 006B","E01015087","Total",577,560,17
"2011","Plymouth 006C","E01015088","Total",640,620,20
"2011","Plymouth 006D","E01015147","Total",514,503,11
"2011","Plymouth 006E","E01015148","Total",675,661,14
"2011","Plymouth 007A","E01015030","Total",787,757,30
"2011","Plymouth 007B","E01015070","Total",1116,1078,38
"2011","Plymouth 007C","E01015081","Total",647,626,21
"2011","Plymouth 007D","E01015086","Total",640,621,19
"2011","Plymouth 007E","E01015089","Total",768,741,27
"2011","Plymouth 008A","E01015029","Total",744,716,28
"2011","Plymouth 008B","E01015064","Total",724,713,11
"2011","Plymouth 008C","E01015065","Total",658,635,23
"2011","Plymouth 008D","E01015071","Total",728,696,32
"2011","Plymouth 009A","E01015076","Total",645,628,17
"2011","Plymouth 009B","E01015142","Total",639,602,37
"2011","Plymouth 009C","E01015143","Total",628,612,16
"2011","Plymouth 009D","E01015144","Total",652,613,39
"2011","Plymouth 009E","E01015146","Total",695,676,19
"2011","Plymouth 009F","E01015149","Total",638,623,15
"2011","Plymouth 009G","E01015150","Total",659,638,21
"2011","Plymouth 010A","E01015063","Total",639,634,5
"2011","Plymouth 010B","E01015068","Total",639,628,11
"2011","Plymouth 010C","E01015069","Total",688,674,14
"2011","Plymouth 010D","E01015095","Total",659,645,14
"2011","Plymouth 010E","E01015096","Total",619,612,7
"2011","Plymouth 011A","E01015074","Total",688,667,21
"2011","Plymouth 011B","E01015077","Total",762,748,14
"2011","Plymouth 011C","E01015079","Total",657,628,29
"2011","Plymouth 011D","E01015102","Total",803,763,40
"2011","Plymouth 011E","E01015104","Total",602,592,10
"2011","Plymouth 012A","E01015035","Total",646,634,12
"2011","Plymouth 012B","E01015037","Total",624,601,23
"2011","Plymouth 012C","E01015058","Total",568,559,9
"2011","Plymouth 012D","E01015066","Total",610,605,5
"2011","Plymouth 012E","E01015067","Total",620,613,7
"2011","Plymouth 013A","E01015072","Total",614,607,7
"2011","Plymouth 013B","E01015073","Total",651,642,9
"2011","Plymouth 013C","E01015078","Total",508,484,24
"2011","Plymouth 013D","E01015080","Total",504,471,33
"2011","Plymouth 013E","E01015106","Total",538,531,7
"2011","Plymouth 014A","E01015039","Total",494,461,33
"2011","Plymouth 014B","E01015040","Total",609,589,20
"2011","Plymouth 014C","E01015041","Total",680,642,38
"2011","Plymouth 014D","E01015075","Total",680,648,32
"2011","Plymouth 014E","E01015145","Total",676,668,8
"2011","Plymouth 015A","E01015120","Total",613,608,5
"2011","Plymouth 015B","E01015121","Total",657,645,12
"2011","Plymouth 015C","E01015123","Total",761,721,40
"2011","Plymouth 015D","E01015124","Total",701,692,9
"2011","Plymouth 015E","E01015125","Total",628,620,8
"2011","Plymouth 016A","E01015033","Total",642,626,16
"2011","Plymouth 016B","E01015034","Total",547,516,31
"2011","Plymouth 016C","E01015036","Total",672,655,17
"2011","Plymouth 016D","E01015038","Total",729,712,17
"2011","Plymouth 016E","E01015101","Total",654,616,38
"2011","Plymouth 017A","E01015098","Total",691,647,44
"2011","Plymouth 017B","E01015099","Total",659,634,25
"2011","Plymouth 017C","E01015100","Total",635,612,23
"2011","Plymouth 017D","E01015103","Total",650,624,26
"2011","Plymouth 017E","E01015105","Total",651,621,30
"2011","Plymouth 018A","E01015107","Total",602,593,9
"2011","Plymouth 018B","E01015110","Total",618,609,9
"2011","Plymouth 018C","E01015111","Total",715,703,12
"2011","Plymouth 018D","E01015119","Total",642,639,3
"2011","Plymouth 019A","E01015112","Total",596,559,37
"2011","Plymouth 019B","E01015113","Total",635,627,8
"2011","Plymouth 019C","E01015114","Total",641,622,19
"2011","Plymouth 019D","E01015118","Total",689,676,13
"2011","Plymouth 019E","E01015122","Total",658,642,16
"2011","Plymouth 020A","E01015042","Total",692,650,42
"2011","Plymouth 020B","E01015044","Total",766,734,32
"2011","Plymouth 020C","E01015167","Total",720,683,37
"2011","Plymouth 020D","E01015168","Total",879,814,65
"2011","Plymouth 020E","E01015171","Total",869,809,60
"2011","Plymouth 021A","E01015055","Total",616,603,13
"2011","Plymouth 021B","E01015056","Total",767,746,21
"2011","Plymouth 021C","E01015057","Total",678,657,21
"2011","Plymouth 021D","E01015059","Total",669,639,30
"2011","Plymouth 021E","E01015060","Total",676,644,32
"2011","Plymouth 021F","E01015176","Total",608,588,20
"2011","Plymouth 022A","E01015108","Total",781,762,19
"2011","Plymouth 022B","E01015109","Total",649,641,8
"2011","Plymouth 022C","E01015115","Total",718,697,21
"2011","Plymouth 022D","E01015116","Total",613,603,10
"2011","Plymouth 022E","E01015117","Total",596,592,4
"2011","Plymouth 023A","E01015031","Total",716,673,43
"2011","Plymouth 023B","E01015032","Total",844,804,40
"2011","Plymouth 023C","E01015049","Total",628,594,34
"2011","Plymouth 023D","E01015050","Total",701,665,36
"2011","Plymouth 023E","E01015051","Total",538,521,17
"2011","Plymouth 024A","E01015169","Total",888,860,28
"2011","Plymouth 024B","E01015170","Total",806,748,58
"2011","Plymouth 024C","E01015173","Total",797,760,37
"2011","Plymouth 024D","E01015174","Total",705,681,24
"2011","Plymouth 025A","E01015061","Total",684,614,70
"2011","Plymouth 025B","E01015062","Total",768,711,57
"2011","Plymouth 025C","E01015175","Total",707,660,47
"2011","Plymouth 025D","E01015177","Total",790,727,63
"2011","Plymouth 025E","E01015178","Total",869,810,59
"2011","Plymouth 026A","E01015043","Total",708,675,33
"2011","Plymouth 026B","E01015045","Total",773,748,25
"2011","Plymouth 026C","E01015046","Total",951,931,20
"2011","Plymouth 026D","E01015047","Total",677,633,44
"2011","Plymouth 026E","E01015048","Total",628,592,36
"2011","Plymouth 027A","E01015053","Total",599,581,18
"2011","Plymouth 027B","E01015054","Total",548,528,20
"2011","Plymouth 027C","E01015152","Total",983,947,36
"2011","Plymouth 027E","E01015156","Total",832,758,74
"2011","Plymouth 027F","E01032657","Total",808,754,54
"2011","Plymouth 027G","E01032658","Total",846,808,38
"2011","Plymouth 028A","E01015052","Total",864,806,58
"2011","Plymouth 028B","E01015179","Total",715,659,56
"2011","Plymouth 028C","E01015180","Total",929,871,58
"2011","Plymouth 028D","E01015181","Total",1061,985,76
"2011","Plymouth 028E","E01015182","Total",904,837,67
"2011","Plymouth 029A","E01015151","Total",961,914,47
"2011","Plymouth 029B","E01015153","Total",953,903,50
"2011","Plymouth 029C","E01015155","Total",956,934,22
"2011","Plymouth 029D","E01015157","Total",1309,1193,116
"2011","Plymouth 029E","E01015158","Total",1477,1334,143
"2011","Plymouth 029F","E01015172","Total",851,822,29
"2011","Plymouth 030A","E01015126","Total",648,637,11
"2011","Plymouth 030B","E01015127","Total",639,616,23
"2011","Plymouth 030C","E01015131","Total",658,643,15
"2011","Plymouth 030D","E01015132","Total",690,668,22
"2011","Plymouth 030E","E01015133","Total",659,649,10
"2011","Plymouth 031A","E01015135","Total",644,630,14
"2011","Plymouth 031B","E01015136","Total",645,628,17
"2011","Plymouth 031C","E01015137","Total",686,655,31
"2011","Plymouth 031D","E01015138","Total",727,699,28
"2011","Plymouth 031E","E01015139","Total",632,613,19
"2011","Plymouth 031F","E01015141","Total",762,746,16
"2011","Plymouth 032A","E01015128","Total",773,758,15
"2011","Plymouth 032B","E01015129","Total",680,674,6
"2011","Plymouth 032C","E01015130","Total",622,616,6
"2011","Plymouth 032D","E01015134","Total",704,678,26
"2011","Plymouth 032E","E01015140","Total",668,653,15
"2011","Poole 001A","E01015431","Total",449,441,8
"2011","Poole 001B","E01015432","Total",762,745,17
"2011","Poole 001C","E01015433","Total",618,603,15
"2011","Poole 001D","E01015434","Total",657,651,6
"2011","Poole 002A","E01015379","Total",485,480,5
"2011","Poole 002B","E01015435","Total",668,659,9
"2011","Poole 002C","E01015436","Total",544,532,12
"2011","Poole 002D","E01015437","Total",511,505,6
"2011","Poole 003A","E01015395","Total",644,625,19
"2011","Poole 003B","E01015396","Total",654,643,11
"2011","Poole 003C","E01015397","Total",531,528,3
"2011","Poole 003D","E01015398","Total",510,508,2
"2011","Poole 003E","E01015399","Total",648,628,20
"2011","Poole 003F","E01015400","Total",633,621,12
"2011","Poole 003G","E01015401","Total",655,644,11
"2011","Poole 004A","E01015412","Total",488,486,2
"2011","Poole 004B","E01015413","Total",643,635,8
"2011","Poole 004C","E01015414","Total",635,625,10
"2011","Poole 004D","E01015415","Total",547,541,6
"2011","Poole 004E","E01015416","Total",525,522,3
"2011","Poole 005A","E01015407","Total",631,622,9
"2011","Poole 005B","E01015408","Total",506,503,3
"2011","Poole 005C","E01015409","Total",597,589,8
"2011","Poole 005D","E01015410","Total",661,655,6
"2011","Poole 005E","E01015411","Total",531,529,2
"2011","Poole 006A","E01015417","Total",629,621,8
"2011","Poole 006B","E01015418","Total",700,694,6
"2011","Poole 006C","E01015419","Total",789,782,7
"2011","Poole 006D","E01015420","Total",651,646,5
"2011","Poole 006E","E01015421","Total",643,629,14
"2011","Poole 006F","E01015422","Total",622,614,8
"2011","Poole 007A","E01015380","Total",766,753,13
"2011","Poole 007B","E01015381","Total",660,652,8
"2011","Poole 007C","E01015382","Total",787,768,19
"2011","Poole 007D","E01015383","Total",699,685,14
"2011","Poole 007E","E01015384","Total",496,493,3
"2011","Poole 007F","E01015385","Total",804,788,16
"2011","Poole 008A","E01015438","Total",637,622,15
"2011","Poole 008B","E01015439","Total",772,755,17
"2011","Poole 008C","E01015441","Total",866,836,30
"2011","Poole 008D","E01015442","Total",806,799,7
"2011","Poole 008E","E01015443","Total",781,759,22
"2011","Poole 008F","E01015444","Total",703,687,16
"2011","Poole 009A","E01015386","Total",866,843,23
"2011","Poole 009B","E01015387","Total",671,666,5
"2011","Poole 009C","E01015388","Total",492,487,5
"2011","Poole 009D","E01015389","Total",704,675,29
"2011","Poole 010A","E01015390","Total",781,753,28
"2011","Poole 010B","E01015391","Total",624,619,5
"2011","Poole 010C","E01015392","Total",666,647,19
"2011","Poole 010D","E01015393","Total",536,520,16
"2011","Poole 010E","E01015394","Total",649,634,15
"2011","Poole 011A","E01015440","Total",865,842,23
"2011","Poole 011B","E01015447","Total",657,647,10
"2011","Poole 011C","E01015449","Total",719,707,12
"2011","Poole 011D","E01015456","Total",796,780,16
"2011","Poole 011E","E01015457","Total",852,805,47
"2011","Poole 012A","E01015445","Total",797,779,18
"2011","Poole 012B","E01015446","Total",669,646,23
"2011","Poole 012C","E01015448","Total",633,627,6
"2011","Poole 012D","E01015450","Total",686,669,17
"2011","Poole 012E","E01015451","Total",653,633,20
"2011","Poole 013A","E01015458","Total",679,651,28
"2011","Poole 013B","E01015460","Total",751,720,31
"2011","Poole 013C","E01015461","Total",653,642,11
"2011","Poole 013D","E01015462","Total",708,682,26
"2011","Poole 013E","E01015463","Total",767,733,34
"2011","Poole 013F","E01015464","Total",682,649,33
"2011","Poole 014A","E01015427","Total",653,647,6
"2011","Poole 014B","E01015428","Total",1055,965,90
"2011","Poole 014C","E01015429","Total",691,675,16
"2011","Poole 014D","E01015430","Total",579,574,5
"2011","Poole 015A","E01015465","Total",803,770,33
"2011","Poole 015B","E01015466","Total",769,734,35
"2011","Poole 015D","E01015468","Total",1022,933,89
"2011","Poole 015F","E01032659","Total",685,619,66
"2011","Poole 015G","E01032660","Total",782,657,125
"2011","Poole 015H","E01032661","Total",837,679,158
"2011","Poole 015I","E01032662","Total",732,633,99
"2011","Poole 016A","E01015423","Total",1055,975,80
"2011","Poole 016B","E01015424","Total",619,610,9
"2011","Poole 016C","E01015425","Total",563,551,12
"2011","Poole 016D","E01015426","Total",562,550,12
"2011","Poole 017A","E01015452","Total",873,826,47
"2011","Poole 017B","E01015453","Total",1072,980,92
"2011","Poole 017C","E01015454","Total",932,874,58
"2011","Poole 017D","E01015455","Total",1004,906,98
"2011","Poole 017E","E01015459","Total",883,800,83
"2011","Poole 018A","E01015402","Total",864,795,69
"2011","Poole 018B","E01015403","Total",1203,1095,108
"2011","Poole 018C","E01015404","Total",1023,855,168
"2011","Poole 018D","E01015405","Total",899,766,133
"2011","Poole 018E","E01015406","Total",1386,902,484
"2011","South Gloucestershire 001A","E01014985","Total",653,641,12
"2011","South Gloucestershire 001B","E01014986","Total",675,663,12
"2011","South Gloucestershire 001C","E01014987","Total",520,514,6
"2011","South Gloucestershire 001D","E01014988","Total",549,543,6
"2011","South Gloucestershire 001E","E01014989","Total",457,441,16
"2011","South Gloucestershire 002A","E01014990","Total",654,640,14
"2011","South Gloucestershire 002B","E01014991","Total",1019,983,36
"2011","South Gloucestershire 002C","E01014992","Total",585,582,3
"2011","South Gloucestershire 002D","E01014993","Total",569,551,18
"2011","South Gloucestershire 003A","E01014884","Total",599,589,10
"2011","South Gloucestershire 003B","E01014885","Total",726,717,9
"2011","South Gloucestershire 003C","E01014929","Total",808,786,22
"2011","South Gloucestershire 003D","E01014930","Total",718,709,9
"2011","South Gloucestershire 004A","E01014863","Total",672,660,12
"2011","South Gloucestershire 004B","E01014864","Total",655,632,23
"2011","South Gloucestershire 004C","E01014962","Total",687,666,21
"2011","South Gloucestershire 004D","E01014963","Total",790,768,22
"2011","South Gloucestershire 005A","E01014861","Total",775,747,28
"2011","South Gloucestershire 005B","E01014862","Total",1090,1065,25
"2011","South Gloucestershire 005C","E01014953","Total",822,807,15
"2011","South Gloucestershire 005D","E01014954","Total",720,700,20
"2011","South Gloucestershire 006A","E01015014","Total",546,537,9
"2011","South Gloucestershire 006B","E01015015","Total",579,575,4
"2011","South Gloucestershire 006C","E01015016","Total",457,455,2
"2011","South Gloucestershire 006D","E01015017","Total",593,585,8
"2011","South Gloucestershire 006E","E01015018","Total",576,571,5
"2011","South Gloucestershire 007A","E01015019","Total",773,758,15
"2011","South Gloucestershire 007B","E01015020","Total",660,650,10
"2011","South Gloucestershire 007C","E01015021","Total",640,636,4
"2011","South Gloucestershire 007D","E01015022","Total",685,675,10
"2011","South Gloucestershire 008A","E01014886","Total",868,836,32
"2011","South Gloucestershire 008B","E01014887","Total",620,614,6
"2011","South Gloucestershire 008C","E01014888","Total",625,618,7
"2011","South Gloucestershire 008D","E01014889","Total",617,613,4
"2011","South Gloucestershire 009A","E01014872","Total",746,723,23
"2011","South Gloucestershire 009B","E01014874","Total",617,601,16
"2011","South Gloucestershire 009C","E01014876","Total",760,746,14
"2011","South Gloucestershire 009D","E01014877","Total",611,601,10
"2011","South Gloucestershire 009E","E01014879","Total",796,757,39
"2011","South Gloucestershire 009F","E01014881","Total",738,717,21
"2011","South Gloucestershire 010A","E01015009","Total",621,616,5
"2011","South Gloucestershire 010B","E01015010","Total",530,527,3
"2011","South Gloucestershire 010C","E01015011","Total",668,659,9
"2011","South Gloucestershire 010D","E01015012","Total",532,526,6
"2011","South Gloucestershire 010E","E01015013","Total",522,514,8
"2011","South Gloucestershire 011A","E01014946","Total",653,639,14
"2011","South Gloucestershire 011B","E01014947","Total",644,632,12
"2011","South Gloucestershire 011C","E01014948","Total",821,804,17
"2011","South Gloucestershire 011D","E01014949","Total",558,544,14
"2011","South Gloucestershire 011E","E01014950","Total",623,601,22
"2011","South Gloucestershire 011F","E01014951","Total",601,586,15
"2011","South Gloucestershire 011G","E01014952","Total",729,708,21
"2011","South Gloucestershire 012A","E01014873","Total",562,558,4
"2011","South Gloucestershire 012B","E01014875","Total",818,794,24
"2011","South Gloucestershire 012C","E01014878","Total",872,853,19
"2011","South Gloucestershire 012D","E01014880","Total",727,715,12
"2011","South Gloucestershire 012E","E01014882","Total",859,834,25
"2011","South Gloucestershire 012F","E01014883","Total",548,535,13
"2011","South Gloucestershire 013A","E01014911","Total",562,548,14
"2011","South Gloucestershire 013B","E01014912","Total",747,735,12
"2011","South Gloucestershire 013C","E01014913","Total",663,655,8
"2011","South Gloucestershire 013D","E01014914","Total",642,639,3
"2011","South Gloucestershire 014A","E01014892","Total",690,679,11
"2011","South Gloucestershire 014B","E01014893","Total",631,620,11
"2011","South Gloucestershire 014C","E01014894","Total",496,490,6
"2011","South Gloucestershire 014D","E01014895","Total",530,526,4
"2011","South Gloucestershire 014E","E01014896","Total",483,478,5
"2011","South Gloucestershire 015A","E01014979","Total",672,667,5
"2011","South Gloucestershire 015B","E01014980","Total",648,641,7
"2011","South Gloucestershire 015C","E01014982","Total",641,632,9
"2011","South Gloucestershire 015D","E01014983","Total",657,648,9
"2011","South Gloucestershire 015E","E01014984","Total",614,608,6
"2011","South Gloucestershire 016A","E01014998","Total",652,643,9
"2011","South Gloucestershire 016B","E01014999","Total",641,629,12
"2011","South Gloucestershire 016C","E01015000","Total",664,654,10
"2011","South Gloucestershire 016D","E01015001","Total",641,628,13
"2011","South Gloucestershire 017A","E01014978","Total",594,589,5
"2011","South Gloucestershire 017B","E01014981","Total",1198,1168,30
"2011","South Gloucestershire 017C","E01014996","Total",729,699,30
"2011","South Gloucestershire 017E","E01033331","Total",668,588,80
"2011","South Gloucestershire 017F","E01033333","Total",577,552,25
"2011","South Gloucestershire 018A","E01014904","Total",663,648,15
"2011","South Gloucestershire 018B","E01014905","Total",680,663,17
"2011","South Gloucestershire 018C","E01014906","Total",765,742,23
"2011","South Gloucestershire 018D","E01014907","Total",713,685,28
"2011","South Gloucestershire 018E","E01014908","Total",570,559,11
"2011","South Gloucestershire 018F","E01014909","Total",616,595,21
"2011","South Gloucestershire 018G","E01014910","Total",641,622,19
"2011","South Gloucestershire 019A","E01014867","Total",537,523,14
"2011","South Gloucestershire 019B","E01014868","Total",644,630,14
"2011","South Gloucestershire 019D","E01014994","Total",755,734,21
"2011","South Gloucestershire 019E","E01014995","Total",700,689,11
"2011","South Gloucestershire 019F","E01033338","Total",639,630,9
"2011","South Gloucestershire 019G","E01033339","Total",616,607,9
"2011","South Gloucestershire 020A","E01014901","Total",671,660,11
"2011","South Gloucestershire 020B","E01014902","Total",541,537,4
"2011","South Gloucestershire 020C","E01014903","Total",656,641,15
"2011","South Gloucestershire 020D","E01014965","Total",613,607,6
"2011","South Gloucestershire 021A","E01014964","Total",678,667,11
"2011","South Gloucestershire 021B","E01014966","Total",654,640,14
"2011","South Gloucestershire 021C","E01014967","Total",818,811,7
"2011","South Gloucestershire 021D","E01014969","Total",645,634,11
"2011","South Gloucestershire 021F","E01033334","Total",656,639,17
"2011","South Gloucestershire 021G","E01033336","Total",613,607,6
"2011","South Gloucestershire 022A","E01014897","Total",604,594,10
"2011","South Gloucestershire 022B","E01014898","Total",738,720,18
"2011","South Gloucestershire 022C","E01014899","Total",768,744,24
"2011","South Gloucestershire 022D","E01014900","Total",650,631,19
"2011","South Gloucestershire 023A","E01014959","Total",542,535,7
"2011","South Gloucestershire 023B","E01014960","Total",699,685,14
"2011","South Gloucestershire 023C","E01014961","Total",676,668,8
"2011","South Gloucestershire 023D","E01014968","Total",787,747,40
"2011","South Gloucestershire 024A","E01014865","Total",815,784,31
"2011","South Gloucestershire 024B","E01014869","Total",741,719,22
"2011","South Gloucestershire 024C","E01014870","Total",666,635,31
"2011","South Gloucestershire 024D","E01014871","Total",523,518,5
"2011","South Gloucestershire 024E","E01014890","Total",851,817,34
"2011","South Gloucestershire 024F","E01014891","Total",716,688,28
"2011","South Gloucestershire 025A","E01014955","Total",565,557,8
"2011","South Gloucestershire 025B","E01014956","Total",664,658,6
"2011","South Gloucestershire 025C","E01014957","Total",518,509,9
"2011","South Gloucestershire 025D","E01014974","Total",727,713,14
"2011","South Gloucestershire 025E","E01014977","Total",748,696,52
"2011","South Gloucestershire 026A","E01014922","Total",556,547,9
"2011","South Gloucestershire 026B","E01014923","Total",659,651,8
"2011","South Gloucestershire 026C","E01014924","Total",822,792,30
"2011","South Gloucestershire 026D","E01014973","Total",652,638,14
"2011","South Gloucestershire 026E","E01014975","Total",735,706,29
"2011","South Gloucestershire 026F","E01014976","Total",683,660,23
"2011","South Gloucestershire 027A","E01014925","Total",635,625,10
"2011","South Gloucestershire 027B","E01014926","Total",701,686,15
"2011","South Gloucestershire 027C","E01014927","Total",853,826,27
"2011","South Gloucestershire 027D","E01014928","Total",654,644,10
"2011","South Gloucestershire 027E","E01014958","Total",494,483,11
"2011","South Gloucestershire 028A","E01014915","Total",666,651,15
"2011","South Gloucestershire 028B","E01015003","Total",668,657,11
"2011","South Gloucestershire 028C","E01015005","Total",881,850,31
"2011","South Gloucestershire 028D","E01015007","Total",865,794,71
"2011","South Gloucestershire 028E","E01015008","Total",679,663,16
"2011","South Gloucestershire 029A","E01014943","Total",823,815,8
"2011","South Gloucestershire 029B","E01014944","Total",715,710,5
"2011","South Gloucestershire 029C","E01014972","Total",723,701,22
"2011","South Gloucestershire 029D","E01015002","Total",654,643,11
"2011","South Gloucestershire 029E","E01015004","Total",730,716,14
"2011","South Gloucestershire 029F","E01015006","Total",679,665,14
"2011","South Gloucestershire 030A","E01014936","Total",557,554,3
"2011","South Gloucestershire 030B","E01014938","Total",634,624,10
"2011","South Gloucestershire 030C","E01014939","Total",510,498,12
"2011","South Gloucestershire 030D","E01014940","Total",508,501,7
"2011","South Gloucestershire 030E","E01014941","Total",653,645,8
"2011","South Gloucestershire 030F","E01014942","Total",668,654,14
"2011","South Gloucestershire 030G","E01014945","Total",697,687,10
"2011","South Gloucestershire 031A","E01014916","Total",703,685,18
"2011","South Gloucestershire 031B","E01014917","Total",631,616,15
"2011","South Gloucestershire 031C","E01014918","Total",669,644,25
"2011","South Gloucestershire 031D","E01014919","Total",511,501,10
"2011","South Gloucestershire 031E","E01014920","Total",542,532,10
"2011","South Gloucestershire 031F","E01014921","Total",560,553,7
"2011","South Gloucestershire 032A","E01014866","Total",654,646,8
"2011","South Gloucestershire 032B","E01014931","Total",651,613,38
"2011","South Gloucestershire 032C","E01014932","Total",750,728,22
"2011","South Gloucestershire 032D","E01014933","Total",629,623,6
"2011","South Gloucestershire 032E","E01014934","Total",508,502,6
"2011","South Gloucestershire 032F","E01014935","Total",669,664,5
"2011","South Gloucestershire 032G","E01014937","Total",533,524,9
"2011","Swindon 001A","E01015519","Total",712,691,21
"2011","Swindon 001B","E01015520","Total",599,549,50
"2011","Swindon 001C","E01015521","Total",612,604,8
"2011","Swindon 001D","E01015522","Total",654,643,11
"2011","Swindon 001E","E01015523","Total",678,655,23
"2011","Swindon 001F","E01015524","Total",479,465,14
"2011","Swindon 003A","E01015543","Total",616,605,11
"2011","Swindon 003B","E01015544","Total",757,743,14
"2011","Swindon 003C","E01015545","Total",702,698,4
"2011","Swindon 003D","E01015546","Total",710,699,11
"2011","Swindon 004A","E01015513","Total",690,672,18
"2011","Swindon 004B","E01015514","Total",526,523,3
"2011","Swindon 004C","E01015515","Total",588,580,8
"2011","Swindon 004D","E01015516","Total",639,624,15
"2011","Swindon 004E","E01015517","Total",680,669,11
"2011","Swindon 005A","E01015555","Total",684,668,16
"2011","Swindon 005B","E01015556","Total",676,669,7
"2011","Swindon 005C","E01015557","Total",642,627,15
"2011","Swindon 005D","E01015558","Total",656,640,16
"2011","Swindon 005E","E01015559","Total",648,638,10
"2011","Swindon 005F","E01015560","Total",685,669,16
"2011","Swindon 006A","E01015526","Total",618,607,11
"2011","Swindon 006B","E01015528","Total",806,794,12
"2011","Swindon 006C","E01015529","Total",691,676,15
"2011","Swindon 006D","E01015530","Total",703,698,5
"2011","Swindon 007A","E01015506","Total",648,633,15
"2011","Swindon 007B","E01015507","Total",652,644,8
"2011","Swindon 007C","E01015527","Total",692,682,10
"2011","Swindon 007D","E01015580","Total",649,637,12
"2011","Swindon 008A","E01015473","Total",687,674,13
"2011","Swindon 008B","E01015474","Total",670,649,21
"2011","Swindon 008C","E01015547","Total",614,594,20
"2011","Swindon 008D","E01015548","Total",637,619,18
"2011","Swindon 009A","E01015549","Total",709,702,7
"2011","Swindon 009B","E01015550","Total",904,876,28
"2011","Swindon 009C","E01015551","Total",636,619,17
"2011","Swindon 009D","E01015552","Total",834,814,20
"2011","Swindon 009E","E01015553","Total",685,670,15
"2011","Swindon 009F","E01015554","Total",658,640,18
"2011","Swindon 010A","E01015508","Total",633,614,19
"2011","Swindon 010B","E01015509","Total",725,705,20
"2011","Swindon 010C","E01015510","Total",873,844,29
"2011","Swindon 010D","E01015511","Total",735,709,26
"2011","Swindon 011A","E01015562","Total",608,599,9
"2011","Swindon 011B","E01015563","Total",613,601,12
"2011","Swindon 011C","E01015565","Total",652,646,6
"2011","Swindon 011D","E01015566","Total",693,679,14
"2011","Swindon 012B","E01015578","Total",833,748,85
"2011","Swindon 012C","E01015579","Total",713,696,17
"2011","Swindon 012D","E01015581","Total",652,617,35
"2011","Swindon 012E","E01015582","Total",869,832,37
"2011","Swindon 012F","E01032708","Total",810,769,41
"2011","Swindon 012G","E01032716","Total",667,644,23
"2011","Swindon 013A","E01015481","Total",771,758,13
"2011","Swindon 013B","E01015482","Total",520,512,8
"2011","Swindon 013C","E01015483","Total",657,648,9
"2011","Swindon 013D","E01015484","Total",628,621,7
"2011","Swindon 013E","E01015485","Total",662,654,8
"2011","Swindon 013F","E01015486","Total",628,621,7
"2011","Swindon 014A","E01015561","Total",677,650,27
"2011","Swindon 014B","E01015564","Total",618,607,11
"2011","Swindon 014C","E01015567","Total",689,673,16
"2011","Swindon 014D","E01015568","Total",645,622,23
"2011","Swindon 015A","E01015475","Total",707,683,24
"2011","Swindon 015B","E01015476","Total",1287,1198,89
"2011","Swindon 015C","E01015477","Total",763,713,50
"2011","Swindon 015D","E01015480","Total",832,751,81
"2011","Swindon 016A","E01015538","Total",859,841,18
"2011","Swindon 016B","E01015572","Total",536,523,13
"2011","Swindon 016C","E01015573","Total",947,936,11
"2011","Swindon 016D","E01015575","Total",503,489,14
"2011","Swindon 017A","E01015479","Total",685,661,24
"2011","Swindon 017B","E01015493","Total",756,712,44
"2011","Swindon 017C","E01015574","Total",654,644,10
"2011","Swindon 017D","E01015576","Total",699,681,18
"2011","Swindon 018A","E01015499","Total",468,463,5
"2011","Swindon 018B","E01015500","Total",669,653,16
"2011","Swindon 018C","E01015504","Total",522,516,6
"2011","Swindon 018D","E01015505","Total",694,668,26
"2011","Swindon 019A","E01015494","Total",885,811,74
"2011","Swindon 019C","E01015496","Total",853,816,37
"2011","Swindon 019D","E01015497","Total",747,711,36
"2011","Swindon 019E","E01032714","Total",736,670,66
"2011","Swindon 019F","E01032715","Total",597,540,57
"2011","Swindon 020A","E01015537","Total",718,707,11
"2011","Swindon 020B","E01015539","Total",637,630,7
"2011","Swindon 020C","E01015540","Total",760,736,24
"2011","Swindon 020D","E01015541","Total",763,749,14
"2011","Swindon 020E","E01015542","Total",631,623,8
"2011","Swindon 021A","E01015478","Total",692,657,35
"2011","Swindon 021B","E01015498","Total",808,783,25
"2011","Swindon 021D","E01015532","Total",669,636,33
"2011","Swindon 021E","E01032706","Total",728,710,18
"2011","Swindon 021F","E01032707","Total",775,736,39
"2011","Swindon 022A","E01015501","Total",527,523,4
"2011","Swindon 022B","E01015502","Total",655,640,15
"2011","Swindon 022C","E01015503","Total",629,613,16
"2011","Swindon 022D","E01015569","Total",654,643,11
"2011","Swindon 022E","E01015570","Total",791,771,20
"2011","Swindon 022F","E01015571","Total",666,648,18
"2011","Swindon 023A","E01015487","Total",612,608,4
"2011","Swindon 023B","E01015488","Total",673,654,19
"2011","Swindon 023C","E01015489","Total",557,549,8
"2011","Swindon 023D","E01015490","Total",550,543,7
"2011","Swindon 023E","E01015491","Total",735,721,14
"2011","Swindon 023F","E01015492","Total",546,540,6
"2011","Swindon 024A","E01015533","Total",693,673,20
"2011","Swindon 024B","E01015534","Total",1153,1046,107
"2011","Swindon 024C","E01015535","Total",788,618,170
"2011","Swindon 024D","E01015536","Total",1113,1012,101
"2011","Swindon 025A","E01015583","Total",885,860,25
"2011","Swindon 025B","E01015584","Total",660,646,14
"2011","Swindon 025C","E01015585","Total",673,661,12
"2011","Swindon 025D","E01015586","Total",638,631,7
"2011","Swindon 025E","E01015587","Total",893,865,28
"2011","Swindon 025F","E01015588","Total",756,740,16
"2011","Swindon 026A","E01015525","Total",678,664,14
"2011","Swindon 026B","E01032700","Total",595,583,12
"2011","Swindon 026C","E01032703","Total",567,555,12
"2011","Swindon 026D","E01032705","Total",592,582,10
"2011","Swindon 026E","E01032709","Total",561,545,16
"2011","Swindon 026F","E01032713","Total",636,622,14
"2011","Swindon 027A","E01032701","Total",558,543,15
"2011","Swindon 027B","E01032702","Total",582,573,9
"2011","Swindon 027C","E01032704","Total",592,584,8
"2011","Swindon 027D","E01032711","Total",641,603,38
"2011","Swindon 027E","E01032712","Total",601,589,12
"2011","Swindon 028A","E01015471","Total",696,675,21
"2011","Swindon 028B","E01015472","Total",1112,1088,24
"2011","Swindon 028C","E01015512","Total",617,612,5
"2011","Swindon 028D","E01015518","Total",541,537,4
"2011","Swindon 028E","E01032710","Total",534,525,9
"2011","Torbay 001A","E01015262","Total",540,525,15
"2011","Torbay 001B","E01015263","Total",646,624,22
"2011","Torbay 001C","E01015264","Total",641,618,23
"2011","Torbay 001D","E01015265","Total",665,653,12
"2011","Torbay 001E","E01015266","Total",627,618,9
"2011","Torbay 002A","E01015236","Total",705,647,58
"2011","Torbay 002B","E01015237","Total",540,519,21
"2011","Torbay 002C","E01015238","Total",658,611,47
"2011","Torbay 002D","E01015239","Total",853,791,62
"2011","Torbay 003A","E01015249","Total",655,619,36
"2011","Torbay 003B","E01015250","Total",618,608,10
"2011","Torbay 003C","E01015251","Total",471,461,10
"2011","Torbay 003D","E01015252","Total",1058,1001,57
"2011","Torbay 003E","E01015253","Total",650,645,5
"2011","Torbay 003F","E01015254","Total",626,610,16
"2011","Torbay 004A","E01015257","Total",627,566,61
"2011","Torbay 004B","E01015258","Total",919,885,34
"2011","Torbay 004C","E01015259","Total",603,585,18
"2011","Torbay 004D","E01015260","Total",894,783,111
"2011","Torbay 005A","E01015240","Total",894,790,104
"2011","Torbay 005B","E01015241","Total",690,627,63
"2011","Torbay 005C","E01015242","Total",548,518,30
"2011","Torbay 005D","E01015243","Total",626,594,32
"2011","Torbay 006A","E01015214","Total",727,630,97
"2011","Torbay 006B","E01015215","Total",635,608,27
"2011","Torbay 006C","E01015216","Total",669,625,44
"2011","Torbay 006D","E01015218","Total",618,586,32
"2011","Torbay 008A","E01015217","Total",877,778,99
"2011","Torbay 008B","E01015255","Total",895,823,72
"2011","Torbay 008C","E01015256","Total",1276,1034,242
"2011","Torbay 008D","E01015261","Total",1044,918,126
"2011","Torbay 010A","E01015267","Total",1077,852,225
"2011","Torbay 010B","E01015268","Total",1034,875,159
"2011","Torbay 010C","E01015269","Total",873,796,77
"2011","Torbay 010D","E01015270","Total",1031,882,149
"2011","Torbay 010E","E01015271","Total",817,704,113
"2011","Torbay 011A","E01015224","Total",684,623,61
"2011","Torbay 011B","E01015225","Total",635,597,38
"2011","Torbay 011C","E01015226","Total",629,603,26
"2011","Torbay 011D","E01015227","Total",643,622,21
"2011","Torbay 011E","E01015228","Total",834,737,97
"2011","Torbay 011F","E01015230","Total",652,639,13
"2011","Torbay 012A","E01015202","Total",618,601,17
"2011","Torbay 012B","E01015203","Total",565,547,18
"2011","Torbay 012C","E01015204","Total",679,622,57
"2011","Torbay 012D","E01015205","Total",656,639,17
"2011","Torbay 012E","E01015206","Total",669,629,40
"2011","Torbay 013A","E01015190","Total",746,708,38
"2011","Torbay 013B","E01015191","Total",690,662,28
"2011","Torbay 013C","E01015192","Total",608,589,19
"2011","Torbay 013D","E01015193","Total",577,552,25
"2011","Torbay 013E","E01015194","Total",621,606,15
"2011","Torbay 013F","E01015195","Total",664,639,25
"2011","Torbay 013G","E01015196","Total",632,593,39
"2011","Torbay 014A","E01015229","Total",688,609,79
"2011","Torbay 014B","E01015231","Total",980,856,124
"2011","Torbay 014C","E01015232","Total",1075,842,233
"2011","Torbay 014D","E01015233","Total",810,701,109
"2011","Torbay 014E","E01015234","Total",641,595,46
"2011","Torbay 014F","E01015235","Total",1057,845,212
"2011","Torbay 015A","E01015219","Total",747,688,59
"2011","Torbay 015B","E01015220","Total",646,618,28
"2011","Torbay 015C","E01015221","Total",671,634,37
"2011","Torbay 015D","E01015222","Total",690,631,59
"2011","Torbay 015E","E01015223","Total",521,510,11
"2011","Torbay 016A","E01015197","Total",666,637,29
"2011","Torbay 016B","E01015198","Total",765,740,25
"2011","Torbay 016C","E01015199","Total",671,628,43
"2011","Torbay 016D","E01015200","Total",465,442,23
"2011","Torbay 016E","E01015201","Total",617,580,37
"2011","Torbay 017A","E01015183","Total",628,582,46
"2011","Torbay 017B","E01015184","Total",658,620,38
"2011","Torbay 017C","E01015185","Total",749,681,68
"2011","Torbay 017D","E01015186","Total",900,681,219
"2011","Torbay 017E","E01015187","Total",870,705,165
"2011","Torbay 017F","E01015188","Total",728,667,61
"2011","Torbay 017G","E01015189","Total",770,564,206
"2011","Torbay 018A","E01015244","Total",662,641,21
"2011","Torbay 018B","E01015245","Total",624,603,21
"2011","Torbay 018C","E01015246","Total",645,600,45
"2011","Torbay 018D","E01015247","Total",774,735,39
"2011","Torbay 018E","E01015248","Total",717,657,60
"2011","Torbay 019E","E01015207","Total",687,649,38
"2011","Torbay 019F","E01015208","Total",949,847,102
"2011","Torbay 019A","E01015209","Total",709,625,84
"2011","Torbay 019B","E01015210","Total",658,639,19
"2011","Torbay 019G","E01015211","Total",602,586,16
"2011","Torbay 019C","E01015212","Total",621,586,35
"2011","Torbay 019D","E01015213","Total",580,569,11
"2011","Wiltshire 012A","E01031841","Total",806,783,23
"2011","Wiltshire 012B","E01031868","Total",730,683,47
"2011","Wiltshire 012C","E01031873","Total",796,738,58
"2011","Wiltshire 012D","E01031874","Total",689,654,35
"2011","Wiltshire 012E","E01031884","Total",714,675,39
"2011","Wiltshire 019A","E01031861","Total",1077,1024,53
"2011","Wiltshire 019B","E01031862","Total",741,722,19
"2011","Wiltshire 019C","E01031863","Total",634,576,58
"2011","Wiltshire 019D","E01031864","Total",545,522,23
"2011","Wiltshire 019E","E01031865","Total",600,571,29
"2011","Wiltshire 024A","E01031866","Total",743,687,56
"2011","Wiltshire 024B","E01031869","Total",872,850,22
"2011","Wiltshire 024C","E01031870","Total",843,810,33
"2011","Wiltshire 024D","E01031871","Total",754,712,42
"2011","Wiltshire 025A","E01031850","Total",961,938,23
"2011","Wiltshire 025B","E01031851","Total",648,630,18
"2011","Wiltshire 025C","E01031852","Total",852,824,28
"2011","Wiltshire 025E","E01032688","Total",520,501,19
"2011","Wiltshire 025F","E01032689","Total",546,532,14
"2011","Wiltshire 025G","E01032692","Total",516,509,7
"2011","Wiltshire 025H","E01032693","Total",583,571,12
"2011","Wiltshire 026A","E01031853","Total",674,657,17
"2011","Wiltshire 026B","E01031854","Total",1091,1024,67
"2011","Wiltshire 026C","E01031855","Total",672,645,27
"2011","Wiltshire 026D","E01031856","Total",772,750,22
"2011","Wiltshire 028A","E01031845","Total",702,666,36
"2011","Wiltshire 028B","E01031846","Total",720,704,16
"2011","Wiltshire 028C","E01031848","Total",749,724,25
"2011","Wiltshire 028D","E01031872","Total",689,675,14
"2011","Wiltshire 028E","E01031876","Total",649,622,27
"2011","Wiltshire 029A","E01031843","Total",817,774,43
"2011","Wiltshire 029B","E01031847","Total",758,728,30
"2011","Wiltshire 029C","E01031849","Total",693,672,21
"2011","Wiltshire 029D","E01031877","Total",854,767,87
"2011","Wiltshire 034A","E01031844","Total",864,830,34
"2011","Wiltshire 034B","E01031857","Total",664,640,24
"2011","Wiltshire 034C","E01031858","Total",758,713,45
"2011","Wiltshire 034D","E01031883","Total",823,785,38
"2011","Wiltshire 038A","E01031842","Total",810,768,42
"2011","Wiltshire 038B","E01031867","Total",825,795,30
"2011","Wiltshire 038C","E01031882","Total",909,849,60
"2011","Wiltshire 041A","E01031859","Total",747,744,3
"2011","Wiltshire 041B","E01031860","Total",647,634,13
"2011","Wiltshire 041C","E01031878","Total",783,763,20
"2011","Wiltshire 041D","E01031879","Total",641,597,44
"2011","Wiltshire 041E","E01031880","Total",619,582,37
"2011","Wiltshire 041G","E01032697","Total",598,574,24
"2011","Wiltshire 041H","E01032698","Total",631,618,13
"2011","Wiltshire 001A","E01031887","Total",750,714,36
"2011","Wiltshire 001B","E01031934","Total",724,698,26
"2011","Wiltshire 001C","E01031935","Total",767,736,31
"2011","Wiltshire 001D","E01031936","Total",653,634,19
"2011","Wiltshire 002A","E01031885","Total",658,634,24
"2011","Wiltshire 002B","E01031947","Total",716,697,19
"2011","Wiltshire 002C","E01031948","Total",853,828,25
"2011","Wiltshire 002D","E01031949","Total",918,833,85
"2011","Wiltshire 003A","E01031954","Total",554,530,24
"2011","Wiltshire 003B","E01031955","Total",688,659,29
"2011","Wiltshire 003C","E01031956","Total",532,512,20
"2011","Wiltshire 003D","E01031962","Total",553,541,12
"2011","Wiltshire 004A","E01031886","Total",584,566,18
"2011","Wiltshire 004B","E01031892","Total",578,558,20
"2011","Wiltshire 004C","E01031893","Total",640,612,28
"2011","Wiltshire 004D","E01031894","Total",643,601,42
"2011","Wiltshire 005A","E01031957","Total",655,619,36
"2011","Wiltshire 005B","E01031958","Total",599,563,36
"2011","Wiltshire 005C","E01031959","Total",733,690,43
"2011","Wiltshire 005D","E01031960","Total",557,526,31
"2011","Wiltshire 006A","E01031963","Total",756,737,19
"2011","Wiltshire 006B","E01031964","Total",796,776,20
"2011","Wiltshire 006C","E01031967","Total",915,880,35
"2011","Wiltshire 006D","E01031969","Total",595,586,9
"2011","Wiltshire 007B","E01031944","Total",482,457,25
"2011","Wiltshire 007D","E01031946","Total",546,482,64
"2011","Wiltshire 007E","E01031961","Total",544,526,18
"2011","Wiltshire 007F","E01031965","Total",630,620,10
"2011","Wiltshire 007G","E01031966","Total",635,628,7
"2011","Wiltshire 007H","E01031968","Total",718,678,40
"2011","Wiltshire 007I","E01032699","Total",1069,996,73
"2011","Wiltshire 008A","E01031939","Total",876,842,34
"2011","Wiltshire 008B","E01031940","Total",960,917,43
"2011","Wiltshire 008C","E01031950","Total",572,536,36
"2011","Wiltshire 008D","E01031951","Total",503,465,38
"2011","Wiltshire 009A","E01031907","Total",931,921,10
"2011","Wiltshire 009B","E01031910","Total",605,586,19
"2011","Wiltshire 009C","E01031914","Total",510,495,15
"2011","Wiltshire 009D","E01031915","Total",623,603,20
"2011","Wiltshire 009E","E01031919","Total",614,593,21
"2011","Wiltshire 009F","E01031920","Total",585,505,80
"2011","Wiltshire 010A","E01031905","Total",500,497,3
"2011","Wiltshire 010B","E01031906","Total",659,643,16
"2011","Wiltshire 010C","E01031908","Total",728,706,22
"2011","Wiltshire 010D","E01031909","Total",530,526,4
"2011","Wiltshire 010E","E01031925","Total",502,495,7
"2011","Wiltshire 010F","E01031926","Total",630,620,10
"2011","Wiltshire 010G","E01031927","Total",502,502,0
"2011","Wiltshire 011A","E01031911","Total",577,572,5
"2011","Wiltshire 011B","E01031912","Total",784,739,45
"2011","Wiltshire 011C","E01031913","Total",571,556,15
"2011","Wiltshire 011D","E01031917","Total",699,673,26
"2011","Wiltshire 011E","E01031918","Total",1169,1138,31
"2011","Wiltshire 011F","E01031928","Total",630,613,17
"2011","Wiltshire 013A","E01031891","Total",930,883,47
"2011","Wiltshire 013B","E01031904","Total",838,808,30
"2011","Wiltshire 013C","E01031937","Total",470,444,26
"2011","Wiltshire 013D","E01031938","Total",586,568,18
"2011","Wiltshire 014A","E01031916","Total",550,538,12
"2011","Wiltshire 014B","E01031921","Total",542,533,9
"2011","Wiltshire 014C","E01031922","Total",607,594,13
"2011","Wiltshire 014D","E01031923","Total",546,536,10
"2011","Wiltshire 014E","E01031924","Total",677,666,11
"2011","Wiltshire 015A","E01031895","Total",643,628,15
"2011","Wiltshire 015B","E01031896","Total",585,571,14
"2011","Wiltshire 015C","E01031897","Total",863,842,21
"2011","Wiltshire 015D","E01031898","Total",681,656,25
"2011","Wiltshire 015F","E01032690","Total",676,659,17
"2011","Wiltshire 015G","E01032691","Total",613,595,18
"2011","Wiltshire 016A","E01031900","Total",1077,1043,34
"2011","Wiltshire 016B","E01031901","Total",661,645,16
"2011","Wiltshire 016C","E01031902","Total",485,475,10
"2011","Wiltshire 016D","E01031903","Total",1024,999,25
"2011","Wiltshire 017A","E01031888","Total",607,574,33
"2011","Wiltshire 017B","E01031889","Total",786,762,24
"2011","Wiltshire 017C","E01031890","Total",646,628,18
"2011","Wiltshire 017D","E01031929","Total",577,548,29
"2011","Wiltshire 017E","E01031930","Total",514,485,29
"2011","Wiltshire 018A","E01031931","Total",751,729,22
"2011","Wiltshire 018B","E01031932","Total",686,667,19
"2011","Wiltshire 018C","E01031933","Total",624,620,4
"2011","Wiltshire 018D","E01031941","Total",719,637,82
"2011","Wiltshire 018E","E01031942","Total",581,549,32
"2011","Wiltshire 018F","E01031952","Total",1143,1094,49
"2011","Wiltshire 018G","E01031953","Total",1210,1185,25
"2011","Wiltshire 045B","E01031988","Total",681,561,120
"2011","Wiltshire 045C","E01031998","Total",777,719,58
"2011","Wiltshire 045D","E01032026","Total",696,670,26
"2011","Wiltshire 045F","E01032696","Total",954,858,96
"2011","Wiltshire 046A","E01031989","Total",600,577,23
"2011","Wiltshire 046B","E01031996","Total",564,556,8
"2011","Wiltshire 046C","E01031997","Total",598,584,14
"2011","Wiltshire 046D","E01031999","Total",660,650,10
"2011","Wiltshire 048A","E01031974","Total",607,586,21
"2011","Wiltshire 048B","E01031975","Total",541,531,10
"2011","Wiltshire 048C","E01031976","Total",526,490,36
"2011","Wiltshire 048D","E01031977","Total",1128,1083,45
"2011","Wiltshire 048E","E01031978","Total",706,693,13
"2011","Wiltshire 048F","E01031979","Total",926,881,45
"2011","Wiltshire 049A","E01032013","Total",869,829,40
"2011","Wiltshire 049B","E01032032","Total",681,662,19
"2011","Wiltshire 049C","E01032033","Total",636,609,27
"2011","Wiltshire 049D","E01032034","Total",609,583,26
"2011","Wiltshire 050A","E01032010","Total",1017,931,86
"2011","Wiltshire 050B","E01032035","Total",732,686,46
"2011","Wiltshire 050C","E01032036","Total",683,638,45
"2011","Wiltshire 050D","E01032037","Total",734,698,36
"2011","Wiltshire 051A","E01031984","Total",606,602,4
"2011","Wiltshire 051B","E01031985","Total",532,524,8
"2011","Wiltshire 051C","E01031986","Total",613,603,10
"2011","Wiltshire 051D","E01032017","Total",624,609,15
"2011","Wiltshire 052A","E01031980","Total",612,600,12
"2011","Wiltshire 052B","E01031981","Total",625,619,6
"2011","Wiltshire 052C","E01031982","Total",580,567,13
"2011","Wiltshire 052D","E01031983","Total",745,723,22
"2011","Wiltshire 053A","E01032018","Total",645,634,11
"2011","Wiltshire 053B","E01032019","Total",639,623,16
"2011","Wiltshire 053C","E01032020","Total",647,634,13
"2011","Wiltshire 053D","E01032025","Total",645,626,19
"2011","Wiltshire 054A","E01031990","Total",861,809,52
"2011","Wiltshire 054B","E01032004","Total",1063,999,64
"2011","Wiltshire 054C","E01032027","Total",657,612,45
"2011","Wiltshire 054D","E01032038","Total",672,639,33
"2011","Wiltshire 054E","E01032039","Total",700,674,26
"2011","Wiltshire 054F","E01032040","Total",640,625,15
"2011","Wiltshire 055A","E01032001","Total",634,609,25
"2011","Wiltshire 055B","E01032002","Total",619,600,19
"2011","Wiltshire 055C","E01032003","Total",773,734,39
"2011","Wiltshire 055D","E01032024","Total",1175,1125,50
"2011","Wiltshire 056A","E01032014","Total",917,865,52
"2011","Wiltshire 056B","E01032015","Total",623,602,21
"2011","Wiltshire 056C","E01032016","Total",655,624,31
"2011","Wiltshire 056D","E01032021","Total",734,700,34
"2011","Wiltshire 057A","E01032000","Total",986,947,39
"2011","Wiltshire 057B","E01032011","Total",1065,1022,43
"2011","Wiltshire 057C","E01032012","Total",776,759,17
"2011","Wiltshire 058A","E01032008","Total",679,668,11
"2011","Wiltshire 058B","E01032009","Total",873,836,37
"2011","Wiltshire 058C","E01032022","Total",1032,931,101
"2011","Wiltshire 059A","E01032005","Total",539,532,7
"2011","Wiltshire 059B","E01032006","Total",522,510,12
"2011","Wiltshire 059C","E01032007","Total",560,543,17
"2011","Wiltshire 059D","E01032023","Total",889,840,49
"2011","Wiltshire 060A","E01031970","Total",675,658,17
"2011","Wiltshire 060B","E01031971","Total",522,512,10
"2011","Wiltshire 060C","E01031972","Total",618,598,20
"2011","Wiltshire 060D","E01032041","Total",813,784,29
"2011","Wiltshire 060E","E01032042","Total",698,677,21
"2011","Wiltshire 061A","E01031991","Total",939,845,94
"2011","Wiltshire 061B","E01032029","Total",676,605,71
"2011","Wiltshire 061C","E01032030","Total",753,718,35
"2011","Wiltshire 061D","E01032031","Total",539,490,49
"2011","Wiltshire 062A","E01031973","Total",742,720,22
"2011","Wiltshire 062B","E01031992","Total",641,623,18
"2011","Wiltshire 062C","E01031993","Total",641,625,16
"2011","Wiltshire 062D","E01031994","Total",528,512,16
"2011","Wiltshire 062E","E01031995","Total",761,721,40
"2011","Wiltshire 020A","E01032063","Total",797,776,21
"2011","Wiltshire 020B","E01032064","Total",514,508,6
"2011","Wiltshire 020C","E01032065","Total",656,646,10
"2011","Wiltshire 020D","E01032073","Total",583,571,12
"2011","Wiltshire 020E","E01032074","Total",540,532,8
"2011","Wiltshire 021A","E01032043","Total",524,513,11
"2011","Wiltshire 021B","E01032044","Total",566,555,11
"2011","Wiltshire 021C","E01032057","Total",505,492,13
"2011","Wiltshire 021D","E01032070","Total",701,685,16
"2011","Wiltshire 021E","E01032071","Total",913,889,24
"2011","Wiltshire 021F","E01032072","Total",748,738,10
"2011","Wiltshire 022A","E01032062","Total",798,766,32
"2011","Wiltshire 022B","E01032066","Total",631,626,5
"2011","Wiltshire 022C","E01032067","Total",668,653,15
"2011","Wiltshire 022D","E01032068","Total",758,707,51
"2011","Wiltshire 022E","E01032069","Total",504,499,5
"2011","Wiltshire 023A","E01032058","Total",609,595,14
"2011","Wiltshire 023B","E01032059","Total",751,728,23
"2011","Wiltshire 023C","E01032060","Total",762,701,61
"2011","Wiltshire 023D","E01032061","Total",522,514,8
"2011","Wiltshire 027A","E01032045","Total",625,604,21
"2011","Wiltshire 027B","E01032046","Total",724,708,16
"2011","Wiltshire 027C","E01032047","Total",624,608,16
"2011","Wiltshire 027D","E01032048","Total",769,754,15
"2011","Wiltshire 027E","E01032049","Total",725,701,24
"2011","Wiltshire 027F","E01032050","Total",981,911,70
"2011","Wiltshire 030A","E01032077","Total",689,671,18
"2011","Wiltshire 030B","E01032078","Total",1199,1173,26
"2011","Wiltshire 030C","E01032079","Total",645,633,12
"2011","Wiltshire 030D","E01032080","Total",629,617,12
"2011","Wiltshire 031A","E01032085","Total",683,670,13
"2011","Wiltshire 031B","E01032086","Total",1269,1172,97
"2011","Wiltshire 031C","E01032087","Total",967,936,31
"2011","Wiltshire 032A","E01032099","Total",1159,1131,28
"2011","Wiltshire 032B","E01032100","Total",679,654,25
"2011","Wiltshire 032C","E01032101","Total",847,792,55
"2011","Wiltshire 032D","E01032102","Total",666,657,9
"2011","Wiltshire 033A","E01032096","Total",775,758,17
"2011","Wiltshire 033B","E01032097","Total",755,740,15
"2011","Wiltshire 033C","E01032098","Total",639,632,7
"2011","Wiltshire 035A","E01032092","Total",628,621,7
"2011","Wiltshire 035B","E01032093","Total",734,718,16
"2011","Wiltshire 035C","E01032094","Total",1027,1009,18
"2011","Wiltshire 035D","E01032095","Total",674,669,5
"2011","Wiltshire 036A","E01032088","Total",639,632,7
"2011","Wiltshire 036B","E01032089","Total",678,655,23
"2011","Wiltshire 036C","E01032090","Total",627,616,11
"2011","Wiltshire 036D","E01032091","Total",548,544,4
"2011","Wiltshire 037A","E01032053","Total",587,583,4
"2011","Wiltshire 037B","E01032083","Total",940,916,24
"2011","Wiltshire 037C","E01032084","Total",1129,1085,44
"2011","Wiltshire 039A","E01032052","Total",578,562,16
"2011","Wiltshire 039B","E01032054","Total",541,519,22
"2011","Wiltshire 039C","E01032055","Total",561,542,19
"2011","Wiltshire 039D","E01032056","Total",580,548,32
"2011","Wiltshire 039E","E01032121","Total",712,694,18
"2011","Wiltshire 040A","E01032115","Total",862,825,37
"2011","Wiltshire 040B","E01032116","Total",1088,1063,25
"2011","Wiltshire 040C","E01032117","Total",1033,1014,19
"2011","Wiltshire 040D","E01032118","Total",571,564,7
"2011","Wiltshire 040E","E01032119","Total",958,926,32
"2011","Wiltshire 040G","E01032694","Total",615,601,14
"2011","Wiltshire 040H","E01032695","Total",614,602,12
"2011","Wiltshire 042A","E01032104","Total",522,510,12
"2011","Wiltshire 042B","E01032105","Total",681,667,14
"2011","Wiltshire 042C","E01032107","Total",575,493,82
"2011","Wiltshire 042D","E01032108","Total",660,620,40
"2011","Wiltshire 043A","E01032110","Total",784,696,88
"2011","Wiltshire 043B","E01032111","Total",576,547,29
"2011","Wiltshire 043C","E01032112","Total",633,618,15
"2011","Wiltshire 043D","E01032113","Total",612,601,11
"2011","Wiltshire 044A","E01032103","Total",948,874,74
"2011","Wiltshire 044B","E01032106","Total",618,595,23
"2011","Wiltshire 044C","E01032109","Total",691,676,15
"2011","Wiltshire 044D","E01032114","Total",717,646,71
"2011","Wiltshire 047A","E01032051","Total",616,582,34
"2011","Wiltshire 047B","E01032075","Total",621,584,37
"2011","Wiltshire 047C","E01032076","Total",579,533,46
"2011","Wiltshire 047D","E01032081","Total",582,540,42
"2011","Wiltshire 047E","E01032082","Total",551,523,28
"2011","East Devon 001A","E01019902","Total",961,917,44
"2011","East Devon 001B","E01019938","Total",999,905,94
"2011","East Devon 001C","E01019967","Total",603,541,62
"2011","East Devon 002A","E01019927","Total",673,625,48
"2011","East Devon 002B","E01019932","Total",861,819,42
"2011","East Devon 002C","E01019933","Total",635,604,31
"2011","East Devon 002D","E01019934","Total",848,825,23
"2011","East Devon 003A","E01019928","Total",614,597,17
"2011","East Devon 003B","E01019929","Total",636,625,11
"2011","East Devon 003C","E01019930","Total",688,667,21
"2011","East Devon 003D","E01019931","Total",545,532,13
"2011","East Devon 004A","E01019925","Total",530,522,8
"2011","East Devon 004D","E01019959","Total",505,485,20
"2011","East Devon 004E","E01019960","Total",542,530,12
"2011","East Devon 004F","E01019962","Total",993,961,32
"2011","East Devon 004G","E01032628","Total",895,851,44
"2011","East Devon 005A","E01019886","Total",1183,1112,71
"2011","East Devon 005B","E01019887","Total",698,654,44
"2011","East Devon 005C","E01019888","Total",897,817,80
"2011","East Devon 005D","E01019889","Total",691,657,34
"2011","East Devon 005E","E01019966","Total",509,471,38
"2011","East Devon 006A","E01019891","Total",620,574,46
"2011","East Devon 006B","E01019892","Total",629,617,12
"2011","East Devon 006C","E01019893","Total",745,728,17
"2011","East Devon 006D","E01019903","Total",936,891,45
"2011","East Devon 007A","E01019899","Total",694,629,65
"2011","East Devon 007B","E01019900","Total",883,812,71
"2011","East Devon 007C","E01019935","Total",615,563,52
"2011","East Devon 007D","E01019936","Total",565,507,58
"2011","East Devon 007E","E01019961","Total",1289,1093,196
"2011","East Devon 008A","E01019939","Total",653,628,25
"2011","East Devon 008B","E01019940","Total",710,659,51
"2011","East Devon 008C","E01019942","Total",845,796,49
"2011","East Devon 008D","E01019943","Total",665,630,35
"2011","East Devon 008E","E01019944","Total",737,685,52
"2011","East Devon 009A","E01019890","Total",1148,821,327
"2011","East Devon 009B","E01019901","Total",645,579,66
"2011","East Devon 009C","E01019951","Total",1143,975,168
"2011","East Devon 010A","E01019946","Total",716,645,71
"2011","East Devon 010B","E01019947","Total",1250,982,268
"2011","East Devon 010C","E01019948","Total",674,637,37
"2011","East Devon 010D","E01019949","Total",786,703,83
"2011","East Devon 010E","E01019950","Total",663,597,66
"2011","East Devon 011A","E01019952","Total",915,842,73
"2011","East Devon 011B","E01019953","Total",757,727,30
"2011","East Devon 011C","E01019954","Total",715,688,27
"2011","East Devon 011D","E01019955","Total",829,775,54
"2011","East Devon 012A","E01019956","Total",1080,879,201
"2011","East Devon 012B","E01019957","Total",1123,918,205
"2011","East Devon 012C","E01019958","Total",855,809,46
"2011","East Devon 013A","E01019937","Total",979,928,51
"2011","East Devon 013B","E01019945","Total",933,835,98
"2011","East Devon 013C","E01019963","Total",742,709,33
"2011","East Devon 014A","E01019898","Total",1051,1023,28
"2011","East Devon 014B","E01019964","Total",449,428,21
"2011","East Devon 014C","E01019965","Total",828,773,55
"2011","East Devon 015A","E01019904","Total",616,603,13
"2011","East Devon 015B","E01019905","Total",756,743,13
"2011","East Devon 015C","E01019906","Total",675,658,17
"2011","East Devon 015D","E01019907","Total",696,675,21
"2011","East Devon 016A","E01019908","Total",721,709,12
"2011","East Devon 016B","E01019909","Total",837,813,24
"2011","East Devon 016C","E01019910","Total",697,668,29
"2011","East Devon 016D","E01019911","Total",817,783,34
"2011","East Devon 017A","E01019894","Total",927,786,141
"2011","East Devon 017B","E01019895","Total",704,656,48
"2011","East Devon 017C","E01019896","Total",825,757,68
"2011","East Devon 017D","E01019897","Total",731,697,34
"2011","East Devon 018A","E01019920","Total",638,626,12
"2011","East Devon 018B","E01019921","Total",653,635,18
"2011","East Devon 018C","E01019922","Total",658,643,15
"2011","East Devon 018D","E01019923","Total",552,534,18
"2011","East Devon 018E","E01019924","Total",621,605,16
"2011","East Devon 019A","E01019916","Total",1099,952,147
"2011","East Devon 019B","E01019917","Total",689,650,39
"2011","East Devon 019C","E01019918","Total",1201,948,253
"2011","East Devon 019D","E01019919","Total",814,778,36
"2011","East Devon 020A","E01019912","Total",932,855,77
"2011","East Devon 020B","E01019913","Total",919,794,125
"2011","East Devon 020C","E01019914","Total",996,948,48
"2011","East Devon 020D","E01019915","Total",809,753,56
"2011","Exeter 001C","E01019998","Total",617,608,9
"2011","Exeter 001D","E01019999","Total",526,503,23
"2011","Exeter 001E","E01020001","Total",617,601,16
"2011","Exeter 001F","E01033233","Total",1009,969,40
"2011","Exeter 002A","E01019990","Total",615,607,8
"2011","Exeter 002B","E01019991","Total",635,620,15
"2011","Exeter 002C","E01019993","Total",504,497,7
"2011","Exeter 002D","E01020000","Total",616,604,12
"2011","Exeter 002E","E01020007","Total",526,507,19
"2011","Exeter 003A","E01019992","Total",637,616,21
"2011","Exeter 003B","E01020002","Total",651,638,13
"2011","Exeter 003C","E01020003","Total",717,695,22
"2011","Exeter 003D","E01020004","Total",649,631,18
"2011","Exeter 003E","E01020005","Total",715,704,11
"2011","Exeter 004A","E01019997","Total",653,620,33
"2011","Exeter 004B","E01020019","Total",583,558,25
"2011","Exeter 004C","E01020020","Total",631,599,32
"2011","Exeter 004D","E01020021","Total",570,536,34
"2011","Exeter 004E","E01020022","Total",716,673,43
"2011","Exeter 005A","E01019980","Total",753,738,15
"2011","Exeter 005B","E01019982","Total",756,727,29
"2011","Exeter 005C","E01019983","Total",632,626,6
"2011","Exeter 005D","E01019984","Total",558,549,9
"2011","Exeter 005E","E01019985","Total",580,579,1
"2011","Exeter 006A","E01019987","Total",677,648,29
"2011","Exeter 006B","E01019989","Total",545,528,17
"2011","Exeter 006C","E01020006","Total",797,785,12
"2011","Exeter 006D","E01020008","Total",618,607,11
"2011","Exeter 006E","E01020009","Total",633,615,18
"2011","Exeter 007A","E01019986","Total",643,627,16
"2011","Exeter 007B","E01020036","Total",676,655,21
"2011","Exeter 007C","E01020037","Total",608,602,6
"2011","Exeter 007D","E01020039","Total",848,839,9
"2011","Exeter 007E","E01020040","Total",591,582,9
"2011","Exeter 008A","E01019994","Total",685,659,26
"2011","Exeter 008B","E01019995","Total",867,816,51
"2011","Exeter 008C","E01020016","Total",1257,1166,91
"2011","Exeter 008D","E01020017","Total",1085,1009,76
"2011","Exeter 008E","E01020018","Total",1178,1116,62
"2011","Exeter 009A","E01019996","Total",592,563,29
"2011","Exeter 009B","E01020023","Total",1032,1004,28
"2011","Exeter 009C","E01020024","Total",702,667,35
"2011","Exeter 009D","E01020025","Total",796,759,37
"2011","Exeter 010A","E01019975","Total",511,500,11
"2011","Exeter 010B","E01020029","Total",671,661,10
"2011","Exeter 010C","E01020030","Total",931,889,42
"2011","Exeter 010D","E01020031","Total",663,645,18
"2011","Exeter 010E","E01020032","Total",666,622,44
"2011","Exeter 011A","E01020026","Total",752,742,10
"2011","Exeter 011B","E01020027","Total",706,695,11
"2011","Exeter 011D","E01020035","Total",685,669,16
"2011","Exeter 011E","E01020038","Total",617,606,11
"2011","Exeter 011F","E01033232","Total",628,619,9
"2011","Exeter 011G","E01033234","Total",624,608,16
"2011","Exeter 012A","E01019973","Total",698,616,82
"2011","Exeter 012B","E01019974","Total",658,648,10
"2011","Exeter 012C","E01019976","Total",613,555,58
"2011","Exeter 012D","E01019977","Total",625,612,13
"2011","Exeter 012E","E01019981","Total",611,599,12
"2011","Exeter 013A","E01019988","Total",655,645,10
"2011","Exeter 013B","E01020010","Total",758,742,16
"2011","Exeter 013C","E01020013","Total",574,558,16
"2011","Exeter 013D","E01020014","Total",659,651,8
"2011","Exeter 013E","E01020015","Total",732,717,15
"2011","Exeter 014A","E01019968","Total",718,703,15
"2011","Exeter 014B","E01019969","Total",625,612,13
"2011","Exeter 014C","E01019970","Total",550,529,21
"2011","Exeter 014D","E01019971","Total",838,801,37
"2011","Exeter 014E","E01019972","Total",617,602,15
"2011","Exeter 015A","E01020011","Total",524,514,10
"2011","Exeter 015B","E01020012","Total",633,621,12
"2011","Exeter 015C","E01020033","Total",770,739,31
"2011","Exeter 015E","E01033235","Total",780,711,69
"2011","Exeter 015F","E01033236","Total",632,559,73
"2011","Mid Devon 001A","E01020046","Total",639,625,14
"2011","Mid Devon 001B","E01020049","Total",587,547,40
"2011","Mid Devon 001C","E01020050","Total",1029,953,76
"2011","Mid Devon 001D","E01020077","Total",639,622,17
"2011","Mid Devon 002A","E01020047","Total",986,956,30
"2011","Mid Devon 002B","E01020051","Total",845,826,19
"2011","Mid Devon 002C","E01020066","Total",1136,1115,21
"2011","Mid Devon 002D","E01020080","Total",547,536,11
"2011","Mid Devon 003A","E01020063","Total",1079,1049,30
"2011","Mid Devon 003B","E01020074","Total",913,876,37
"2011","Mid Devon 003C","E01020075","Total",836,790,46
"2011","Mid Devon 004A","E01020052","Total",921,867,54
"2011","Mid Devon 004B","E01020053","Total",618,606,12
"2011","Mid Devon 004C","E01020065","Total",789,758,31
"2011","Mid Devon 004D","E01020067","Total",791,784,7
"2011","Mid Devon 005A","E01020048","Total",1022,965,57
"2011","Mid Devon 005B","E01020078","Total",674,653,21
"2011","Mid Devon 005C","E01020079","Total",620,603,17
"2011","Mid Devon 005D","E01020081","Total",522,513,9
"2011","Mid Devon 006A","E01020045","Total",693,665,28
"2011","Mid Devon 006B","E01020059","Total",871,825,46
"2011","Mid Devon 006C","E01020062","Total",661,643,18
"2011","Mid Devon 006D","E01020064","Total",749,725,24
"2011","Mid Devon 007A","E01020054","Total",852,840,12
"2011","Mid Devon 007B","E01020055","Total",827,789,38
"2011","Mid Devon 007C","E01020057","Total",782,757,25
"2011","Mid Devon 007D","E01020058","Total",849,837,12
"2011","Mid Devon 008A","E01020043","Total",860,831,29
"2011","Mid Devon 008B","E01020044","Total",703,671,32
"2011","Mid Devon 008C","E01020056","Total",837,803,34
"2011","Mid Devon 008D","E01020071","Total",864,839,25
"2011","Mid Devon 009A","E01020072","Total",729,676,53
"2011","Mid Devon 009B","E01020073","Total",751,715,36
"2011","Mid Devon 009C","E01020076","Total",730,699,31
"2011","Mid Devon 009D","E01020082","Total",511,481,30
"2011","Mid Devon 010A","E01020068","Total",677,655,22
"2011","Mid Devon 010B","E01020069","Total",618,597,21
"2011","Mid Devon 010C","E01020070","Total",792,760,32
"2011","Mid Devon 010D","E01020083","Total",946,910,36
"2011","Mid Devon 011A","E01020041","Total",942,916,26
"2011","Mid Devon 011B","E01020042","Total",736,726,10
"2011","Mid Devon 011C","E01020060","Total",926,888,38
"2011","Mid Devon 011D","E01020061","Total",891,866,25
"2011","North Devon 001A","E01020111","Total",698,667,31
"2011","North Devon 001B","E01020112","Total",988,799,189
"2011","North Devon 001C","E01020114","Total",594,502,92
"2011","North Devon 001D","E01020115","Total",592,523,69
"2011","North Devon 002A","E01020099","Total",738,600,138
"2011","North Devon 002B","E01020100","Total",571,464,107
"2011","North Devon 002C","E01020101","Total",744,642,102
"2011","North Devon 002D","E01020126","Total",1003,715,288
"2011","North Devon 003A","E01020113","Total",761,644,117
"2011","North Devon 003B","E01020116","Total",724,685,39
"2011","North Devon 003C","E01020117","Total",756,670,86
"2011","North Devon 003D","E01020118","Total",568,542,26
"2011","North Devon 004A","E01020090","Total",727,676,51
"2011","North Devon 004B","E01020108","Total",1524,964,560
"2011","North Devon 004C","E01020109","Total",1053,620,433
"2011","North Devon 005A","E01020089","Total",1036,960,76
"2011","North Devon 005B","E01020091","Total",645,574,71
"2011","North Devon 005C","E01020092","Total",685,634,51
"2011","North Devon 005D","E01020093","Total",770,708,62
"2011","North Devon 005E","E01020110","Total",918,841,77
"2011","North Devon 006A","E01020088","Total",904,819,85
"2011","North Devon 006B","E01020120","Total",765,737,28
"2011","North Devon 006C","E01020127","Total",826,717,109
"2011","North Devon 007A","E01020132","Total",874,827,47
"2011","North Devon 007B","E01020133","Total",648,624,24
"2011","North Devon 007C","E01020134","Total",524,495,29
"2011","North Devon 007D","E01020139","Total",649,625,24
"2011","North Devon 008A","E01020094","Total",1100,1012,88
"2011","North Devon 008B","E01020095","Total",687,658,29
"2011","North Devon 008C","E01020140","Total",540,516,24
"2011","North Devon 008D","E01020141","Total",732,710,22
"2011","North Devon 009A","E01020096","Total",920,864,56
"2011","North Devon 009B","E01020123","Total",620,601,19
"2011","North Devon 009C","E01020124","Total",621,592,29
"2011","North Devon 009D","E01020125","Total",619,597,22
"2011","North Devon 010A","E01020102","Total",670,654,16
"2011","North Devon 010B","E01020103","Total",595,569,26
"2011","North Devon 010C","E01020104","Total",593,577,16
"2011","North Devon 010D","E01020128","Total",549,522,27
"2011","North Devon 010E","E01020129","Total",543,523,20
"2011","North Devon 010F","E01020130","Total",732,687,45
"2011","North Devon 011A","E01020105","Total",641,616,25
"2011","North Devon 011B","E01020106","Total",528,513,15
"2011","North Devon 011C","E01020107","Total",737,708,29
"2011","North Devon 011D","E01020119","Total",844,673,171
"2011","North Devon 012A","E01020084","Total",688,672,16
"2011","North Devon 012B","E01020085","Total",656,628,28
"2011","North Devon 012C","E01020086","Total",676,638,38
"2011","North Devon 012D","E01020121","Total",858,794,64
"2011","North Devon 012E","E01020122","Total",779,694,85
"2011","North Devon 013A","E01020097","Total",1061,913,148
"2011","North Devon 013B","E01020131","Total",970,882,88
"2011","North Devon 013C","E01020135","Total",723,697,26
"2011","North Devon 013D","E01020136","Total",824,775,49
"2011","North Devon 013E","E01020137","Total",732,699,33
"2011","North Devon 014A","E01020087","Total",937,840,97
"2011","North Devon 014B","E01020098","Total",1026,921,105
"2011","North Devon 014C","E01020138","Total",1073,982,91
"2011","South Hams 001A","E01020144","Total",624,616,8
"2011","South Hams 001B","E01020145","Total",785,749,36
"2011","South Hams 001C","E01020146","Total",542,525,17
"2011","South Hams 001D","E01020149","Total",553,527,26
"2011","South Hams 002A","E01020148","Total",524,483,41
"2011","South Hams 002B","E01020157","Total",1063,941,122
"2011","South Hams 002C","E01020160","Total",835,754,81
"2011","South Hams 002D","E01020176","Total",546,505,41
"2011","South Hams 002E","E01020177","Total",631,602,29
"2011","South Hams 003A","E01020180","Total",892,834,58
"2011","South Hams 003B","E01020181","Total",800,778,22
"2011","South Hams 003C","E01020182","Total",642,624,18
"2011","South Hams 003D","E01020183","Total",921,766,155
"2011","South Hams 003E","E01020184","Total",902,846,56
"2011","South Hams 004A","E01020153","Total",827,615,212
"2011","South Hams 004B","E01020156","Total",903,836,67
"2011","South Hams 004C","E01020170","Total",972,942,30
"2011","South Hams 004D","E01020188","Total",1055,837,218
"2011","South Hams 005A","E01020161","Total",1125,1074,51
"2011","South Hams 005B","E01020162","Total",655,644,11
"2011","South Hams 005C","E01020163","Total",690,679,11
"2011","South Hams 005D","E01020164","Total",661,643,18
"2011","South Hams 005E","E01020165","Total",627,621,6
"2011","South Hams 005F","E01020166","Total",594,577,17
"2011","South Hams 005G","E01020167","Total",507,503,4
"2011","South Hams 006A","E01020142","Total",1159,973,186
"2011","South Hams 006B","E01020143","Total",1069,933,136
"2011","South Hams 006C","E01020150","Total",801,749,52
"2011","South Hams 007A","E01020151","Total",1028,796,232
"2011","South Hams 007B","E01020152","Total",1359,857,502
"2011","South Hams 007C","E01020154","Total",523,500,23
"2011","South Hams 007D","E01020155","Total",493,482,11
"2011","South Hams 008A","E01020147","Total",1213,869,344
"2011","South Hams 008B","E01020158","Total",812,745,67
"2011","South Hams 008C","E01020159","Total",668,597,71
"2011","South Hams 008D","E01020190","Total",951,900,51
"2011","South Hams 009A","E01020171","Total",1059,853,206
"2011","South Hams 009B","E01020185","Total",630,594,36
"2011","South Hams 009C","E01020186","Total",809,691,118
"2011","South Hams 009D","E01020187","Total",783,736,47
"2011","South Hams 010A","E01020168","Total",1062,924,138
"2011","South Hams 010B","E01020169","Total",1202,1067,135
"2011","South Hams 010C","E01020189","Total",1050,989,61
"2011","South Hams 011A","E01020174","Total",1038,724,314
"2011","South Hams 011B","E01020175","Total",1155,926,229
"2011","South Hams 011C","E01020178","Total",1150,900,250
"2011","South Hams 012A","E01020172","Total",1441,855,586
"2011","South Hams 012B","E01020173","Total",1645,800,845
"2011","South Hams 012C","E01020179","Total",1269,877,392
"2011","Teignbridge 001A","E01020243","Total",545,498,47
"2011","Teignbridge 001B","E01020262","Total",556,506,50
"2011","Teignbridge 001C","E01020263","Total",737,691,46
"2011","Teignbridge 001D","E01020274","Total",582,536,46
"2011","Teignbridge 002A","E01020240","Total",689,671,18
"2011","Teignbridge 002B","E01020241","Total",787,738,49
"2011","Teignbridge 002C","E01020242","Total",594,587,7
"2011","Teignbridge 002D","E01020244","Total",666,640,26
"2011","Teignbridge 002E","E01020245","Total",762,696,66
"2011","Teignbridge 003A","E01020205","Total",668,612,56
"2011","Teignbridge 003B","E01020258","Total",826,727,99
"2011","Teignbridge 003C","E01020259","Total",592,491,101
"2011","Teignbridge 003D","E01020273","Total",652,595,57
"2011","Teignbridge 004A","E01020203","Total",831,794,37
"2011","Teignbridge 004B","E01020206","Total",742,710,32
"2011","Teignbridge 004C","E01020220","Total",575,542,33
"2011","Teignbridge 004D","E01020221","Total",760,710,50
"2011","Teignbridge 004E","E01020222","Total",559,539,20
"2011","Teignbridge 004F","E01020223","Total",789,743,46
"2011","Teignbridge 005A","E01020229","Total",902,750,152
"2011","Teignbridge 005B","E01020230","Total",807,740,67
"2011","Teignbridge 005C","E01020231","Total",681,639,42
"2011","Teignbridge 005D","E01020232","Total",656,630,26
"2011","Teignbridge 006A","E01020228","Total",1090,945,145
"2011","Teignbridge 006B","E01020233","Total",906,832,74
"2011","Teignbridge 006C","E01020234","Total",623,598,25
"2011","Teignbridge 006D","E01020235","Total",904,841,63
"2011","Teignbridge 007A","E01020202","Total",770,734,36
"2011","Teignbridge 007B","E01020204","Total",631,624,7
"2011","Teignbridge 007C","E01020236","Total",558,539,19
"2011","Teignbridge 007D","E01020237","Total",673,637,36
"2011","Teignbridge 008A","E01020265","Total",800,749,51
"2011","Teignbridge 008B","E01020266","Total",725,671,54
"2011","Teignbridge 008C","E01020267","Total",709,646,63
"2011","Teignbridge 008D","E01020268","Total",704,641,63
"2011","Teignbridge 008E","E01020270","Total",749,716,33
"2011","Teignbridge 009A","E01020250","Total",727,695,32
"2011","Teignbridge 009B","E01020252","Total",675,639,36
"2011","Teignbridge 009C","E01020253","Total",612,593,19
"2011","Teignbridge 009D","E01020254","Total",591,557,34
"2011","Teignbridge 009E","E01020255","Total",615,568,47
"2011","Teignbridge 009F","E01020257","Total",518,501,17
"2011","Teignbridge 010A","E01020264","Total",731,677,54
"2011","Teignbridge 010B","E01020269","Total",1369,1158,211
"2011","Teignbridge 010C","E01020271","Total",733,674,59
"2011","Teignbridge 010D","E01020272","Total",792,759,33
"2011","Teignbridge 011A","E01020200","Total",573,521,52
"2011","Teignbridge 011B","E01020201","Total",736,695,41
"2011","Teignbridge 011C","E01020251","Total",617,576,41
"2011","Teignbridge 011D","E01020260","Total",812,628,184
"2011","Teignbridge 011E","E01020261","Total",613,526,87
"2011","Teignbridge 012A","E01020208","Total",532,523,9
"2011","Teignbridge 012B","E01020209","Total",638,627,11
"2011","Teignbridge 012C","E01020210","Total",515,499,16
"2011","Teignbridge 012D","E01020219","Total",881,845,36
"2011","Teignbridge 013A","E01020191","Total",444,431,13
"2011","Teignbridge 013B","E01020194","Total",600,589,11
"2011","Teignbridge 013C","E01020207","Total",458,427,31
"2011","Teignbridge 013D","E01020256","Total",626,602,24
"2011","Teignbridge 014A","E01020211","Total",692,675,17
"2011","Teignbridge 014B","E01020217","Total",950,879,71
"2011","Teignbridge 014C","E01020218","Total",795,746,49
"2011","Teignbridge 014D","E01020224","Total",557,521,36
"2011","Teignbridge 015A","E01020216","Total",700,675,25
"2011","Teignbridge 015B","E01020225","Total",627,603,24
"2011","Teignbridge 015C","E01020226","Total",508,469,39
"2011","Teignbridge 015D","E01020227","Total",697,643,54
"2011","Teignbridge 016A","E01020212","Total",514,497,17
"2011","Teignbridge 016B","E01020213","Total",669,637,32
"2011","Teignbridge 016C","E01020214","Total",697,674,23
"2011","Teignbridge 016D","E01020215","Total",589,575,14
"2011","Teignbridge 017A","E01020195","Total",743,716,27
"2011","Teignbridge 017B","E01020196","Total",852,794,58
"2011","Teignbridge 017C","E01020197","Total",586,543,43
"2011","Teignbridge 017D","E01020198","Total",634,618,16
"2011","Teignbridge 017E","E01020199","Total",756,711,45
"2011","Teignbridge 018A","E01020246","Total",503,460,43
"2011","Teignbridge 018B","E01020247","Total",735,689,46
"2011","Teignbridge 018C","E01020248","Total",741,701,40
"2011","Teignbridge 018D","E01020249","Total",639,612,27
"2011","Teignbridge 019A","E01020192","Total",676,648,28
"2011","Teignbridge 019B","E01020193","Total",613,571,42
"2011","Teignbridge 019C","E01020238","Total",561,538,23
"2011","Teignbridge 019D","E01020239","Total",574,540,34
"2011","Torridge 001A","E01020275","Total",968,672,296
"2011","Torridge 001B","E01020276","Total",735,682,53
"2011","Torridge 001C","E01020297","Total",815,765,50
"2011","Torridge 001D","E01020299","Total",987,908,79
"2011","Torridge 002A","E01020298","Total",1009,940,69
"2011","Torridge 002B","E01020300","Total",772,738,34
"2011","Torridge 002C","E01020310","Total",1313,1089,224
"2011","Torridge 003A","E01020280","Total",1261,1166,95
"2011","Torridge 003B","E01020281","Total",820,794,26
"2011","Torridge 003C","E01020282","Total",837,802,35
"2011","Torridge 004A","E01020277","Total",895,859,36
"2011","Torridge 004B","E01020278","Total",691,637,54
"2011","Torridge 004C","E01020279","Total",1074,993,81
"2011","Torridge 004D","E01020283","Total",671,653,18
"2011","Torridge 004E","E01020284","Total",854,827,27
"2011","Torridge 004F","E01020285","Total",834,824,10
"2011","Torridge 005A","E01020288","Total",829,709,120
"2011","Torridge 005B","E01020292","Total",769,646,123
"2011","Torridge 005C","E01020295","Total",773,669,104
"2011","Torridge 005D","E01020296","Total",668,616,52
"2011","Torridge 006A","E01020304","Total",778,739,39
"2011","Torridge 006B","E01020305","Total",575,524,51
"2011","Torridge 006C","E01020306","Total",533,521,12
"2011","Torridge 006D","E01020307","Total",670,654,16
"2011","Torridge 007A","E01020287","Total",700,650,50
"2011","Torridge 007B","E01020303","Total",821,754,67
"2011","Torridge 007C","E01020308","Total",780,703,77
"2011","Torridge 007D","E01020311","Total",1020,940,80
"2011","Torridge 008A","E01020291","Total",786,640,146
"2011","Torridge 008B","E01020293","Total",1059,938,121
"2011","Torridge 008C","E01020294","Total",815,761,54
"2011","Torridge 008D","E01020302","Total",777,680,97
"2011","Torridge 008E","E01020309","Total",714,663,51
"2011","Torridge 009A","E01020286","Total",744,670,74
"2011","Torridge 009B","E01020289","Total",745,659,86
"2011","Torridge 009C","E01020290","Total",775,711,64
"2011","Torridge 009D","E01020301","Total",862,790,72
"2011","West Devon 001A","E01020320","Total",777,706,71
"2011","West Devon 001B","E01020321","Total",1006,905,101
"2011","West Devon 001C","E01020322","Total",873,798,75
"2011","West Devon 001D","E01020326","Total",922,863,59
"2011","West Devon 002A","E01020327","Total",841,807,34
"2011","West Devon 002B","E01020328","Total",991,934,57
"2011","West Devon 002C","E01020329","Total",737,671,66
"2011","West Devon 002D","E01020330","Total",945,830,115
"2011","West Devon 003A","E01020318","Total",801,685,116
"2011","West Devon 003B","E01020319","Total",774,679,95
"2011","West Devon 003C","E01020323","Total",702,642,60
"2011","West Devon 003D","E01020339","Total",757,704,53
"2011","West Devon 004A","E01020314","Total",761,662,99
"2011","West Devon 004B","E01020325","Total",732,643,89
"2011","West Devon 004C","E01020331","Total",693,628,65
"2011","West Devon 004D","E01020340","Total",773,706,67
"2011","West Devon 005A","E01020332","Total",1026,932,94
"2011","West Devon 005B","E01020333","Total",856,811,45
"2011","West Devon 005C","E01020334","Total",868,840,28
"2011","West Devon 005D","E01020335","Total",694,668,26
"2011","West Devon 005E","E01020336","Total",644,606,38
"2011","West Devon 005F","E01020337","Total",608,581,27
"2011","West Devon 005G","E01020338","Total",1068,1029,39
"2011","West Devon 006A","E01020317","Total",680,648,32
"2011","West Devon 006B","E01020324","Total",739,661,78
"2011","West Devon 006C","E01020341","Total",732,668,64
"2011","West Devon 006D","E01020342","Total",693,653,40
"2011","West Devon 007A","E01020312","Total",777,714,63
"2011","West Devon 007B","E01020313","Total",684,632,52
"2011","West Devon 007C","E01020315","Total",706,645,61
"2011","West Devon 007D","E01020316","Total",837,774,63
"2011","Christchurch 001A","E01020343","Total",665,641,24
"2011","Christchurch 001B","E01020344","Total",584,562,22
"2011","Christchurch 001C","E01020345","Total",557,528,29
"2011","Christchurch 001D","E01020365","Total",765,709,56
"2011","Christchurch 002A","E01020351","Total",530,511,19
"2011","Christchurch 002B","E01020352","Total",534,518,16
"2011","Christchurch 002C","E01020353","Total",705,674,31
"2011","Christchurch 002D","E01020359","Total",509,496,13
"2011","Christchurch 002E","E01020366","Total",963,906,57
"2011","Christchurch 003A","E01020349","Total",1185,1046,139
"2011","Christchurch 003B","E01020350","Total",1067,919,148
"2011","Christchurch 003C","E01020357","Total",926,867,59
"2011","Christchurch 003D","E01020358","Total",702,671,31
"2011","Christchurch 004A","E01020369","Total",671,630,41
"2011","Christchurch 004B","E01020370","Total",673,649,24
"2011","Christchurch 004C","E01020371","Total",780,742,38
"2011","Christchurch 004D","E01020372","Total",632,606,26
"2011","Christchurch 005A","E01020346","Total",742,704,38
"2011","Christchurch 005B","E01020347","Total",768,740,28
"2011","Christchurch 005C","E01020348","Total",658,633,25
"2011","Christchurch 005D","E01020363","Total",516,499,17
"2011","Christchurch 006A","E01020360","Total",679,654,25
"2011","Christchurch 006B","E01020361","Total",683,647,36
"2011","Christchurch 006C","E01020364","Total",838,773,65
"2011","Christchurch 006D","E01020367","Total",1078,913,165
"2011","Christchurch 006E","E01020368","Total",1253,1145,108
"2011","Christchurch 007A","E01020354","Total",755,719,36
"2011","Christchurch 007B","E01020355","Total",1013,913,100
"2011","Christchurch 007C","E01020356","Total",976,782,194
"2011","Christchurch 007D","E01020362","Total",735,678,57
"2011","East Dorset 001A","E01020373","Total",512,495,17
"2011","East Dorset 001B","E01020374","Total",669,646,23
"2011","East Dorset 001C","E01020389","Total",912,851,61
"2011","East Dorset 001D","E01020397","Total",641,613,28
"2011","East Dorset 002A","E01020416","Total",692,674,18
"2011","East Dorset 002B","E01020417","Total",467,447,20
"2011","East Dorset 002C","E01020418","Total",705,673,32
"2011","East Dorset 002D","E01020419","Total",807,776,31
"2011","East Dorset 002E","E01020420","Total",544,526,18
"2011","East Dorset 003A","E01020411","Total",444,422,22
"2011","East Dorset 003B","E01020412","Total",591,567,24
"2011","East Dorset 003C","E01020413","Total",590,571,19
"2011","East Dorset 003D","E01020414","Total",852,808,44
"2011","East Dorset 003E","E01020415","Total",616,597,19
"2011","East Dorset 004A","E01020403","Total",677,628,49
"2011","East Dorset 004B","E01020404","Total",716,689,27
"2011","East Dorset 004C","E01020405","Total",718,675,43
"2011","East Dorset 004D","E01020406","Total",1097,1048,49
"2011","East Dorset 005A","E01020396","Total",485,450,35
"2011","East Dorset 005B","E01020398","Total",961,913,48
"2011","East Dorset 005C","E01020409","Total",488,482,6
"2011","East Dorset 005D","E01020410","Total",541,528,13
"2011","East Dorset 006A","E01020421","Total",547,529,18
"2011","East Dorset 006B","E01020422","Total",930,867,63
"2011","East Dorset 006C","E01020423","Total",663,637,26
"2011","East Dorset 006D","E01020424","Total",662,643,19
"2011","East Dorset 006E","E01020425","Total",855,816,39
"2011","East Dorset 007A","E01020377","Total",640,631,9
"2011","East Dorset 007B","E01020379","Total",652,642,10
"2011","East Dorset 007C","E01020380","Total",455,447,8
"2011","East Dorset 007D","E01020381","Total",513,503,10
"2011","East Dorset 008A","E01020390","Total",755,732,23
"2011","East Dorset 008B","E01020391","Total",700,668,32
"2011","East Dorset 008C","E01020392","Total",857,786,71
"2011","East Dorset 008D","E01020393","Total",578,563,15
"2011","East Dorset 008E","E01020394","Total",851,820,31
"2011","East Dorset 009A","E01020375","Total",648,642,6
"2011","East Dorset 009B","E01020376","Total",498,483,15
"2011","East Dorset 009C","E01020378","Total",644,634,10
"2011","East Dorset 009D","E01020407","Total",527,518,9
"2011","East Dorset 009E","E01020408","Total",493,480,13
"2011","East Dorset 010A","E01020426","Total",829,806,23
"2011","East Dorset 010B","E01020427","Total",739,725,14
"2011","East Dorset 010C","E01020428","Total",1154,1095,59
"2011","East Dorset 010D","E01020429","Total",808,796,12
"2011","East Dorset 011A","E01020395","Total",944,904,40
"2011","East Dorset 011B","E01020399","Total",1050,1014,36
"2011","East Dorset 011C","E01020400","Total",695,671,24
"2011","East Dorset 011D","E01020401","Total",767,722,45
"2011","East Dorset 011E","E01020402","Total",650,633,17
"2011","East Dorset 012A","E01020382","Total",638,628,10
"2011","East Dorset 012B","E01020383","Total",758,741,17
"2011","East Dorset 012C","E01020384","Total",646,638,8
"2011","East Dorset 012D","E01020385","Total",488,481,7
"2011","East Dorset 012E","E01020386","Total",484,477,7
"2011","East Dorset 012F","E01020387","Total",485,470,15
"2011","East Dorset 012G","E01020388","Total",651,643,8
"2011","North Dorset 001A","E01020443","Total",1173,1106,67
"2011","North Dorset 001B","E01020447","Total",880,846,34
"2011","North Dorset 001C","E01020463","Total",792,756,36
"2011","North Dorset 001D","E01020464","Total",722,691,31
"2011","North Dorset 002A","E01020440","Total",894,826,68
"2011","North Dorset 002B","E01020450","Total",993,956,37
"2011","North Dorset 002D","E01020462","Total",865,767,98
"2011","North Dorset 002E","E01033156","Total",681,656,25
"2011","North Dorset 002F","E01033158","Total",611,564,47
"2011","North Dorset 003A","E01020454","Total",1064,968,96
"2011","North Dorset 003B","E01020455","Total",833,780,53
"2011","North Dorset 003C","E01020456","Total",792,761,31
"2011","North Dorset 003D","E01020457","Total",805,726,79
"2011","North Dorset 004A","E01020433","Total",788,745,43
"2011","North Dorset 004B","E01020434","Total",847,788,59
"2011","North Dorset 004C","E01020449","Total",962,905,57
"2011","North Dorset 004D","E01020458","Total",986,940,46
"2011","North Dorset 004E","E01020459","Total",1239,1167,72
"2011","North Dorset 005A","E01020444","Total",792,752,40
"2011","North Dorset 005B","E01020445","Total",559,513,46
"2011","North Dorset 005C","E01020446","Total",698,652,46
"2011","North Dorset 005D","E01020460","Total",901,842,59
"2011","North Dorset 006A","E01020442","Total",953,888,65
"2011","North Dorset 006B","E01020452","Total",855,826,29
"2011","North Dorset 006C","E01020453","Total",758,716,42
"2011","North Dorset 006E","E01033154","Total",485,469,16
"2011","North Dorset 006F","E01033159","Total",449,429,20
"2011","North Dorset 007A","E01020435","Total",794,782,12
"2011","North Dorset 007B","E01020436","Total",821,809,12
"2011","North Dorset 007C","E01020437","Total",781,774,7
"2011","North Dorset 007D","E01020438","Total",1159,1086,73
"2011","North Dorset 007E","E01020439","Total",1032,987,45
"2011","North Dorset 008A","E01020430","Total",650,618,32
"2011","North Dorset 008B","E01020431","Total",494,438,56
"2011","North Dorset 008C","E01020432","Total",573,539,34
"2011","North Dorset 008D","E01020441","Total",862,786,76
"2011","North Dorset 008E","E01020448","Total",873,816,57
"2011","Purbeck 001A","E01020465","Total",941,883,58
"2011","Purbeck 001B","E01020469","Total",865,840,25
"2011","Purbeck 001C","E01020470","Total",777,740,37
"2011","Purbeck 002A","E01020471","Total",547,537,10
"2011","Purbeck 002B","E01020472","Total",631,604,27
"2011","Purbeck 002C","E01020473","Total",659,640,19
"2011","Purbeck 002D","E01020474","Total",767,746,21
"2011","Purbeck 002E","E01020475","Total",870,845,25
"2011","Purbeck 003A","E01020476","Total",581,544,37
"2011","Purbeck 003B","E01020477","Total",598,589,9
"2011","Purbeck 003C","E01020485","Total",809,745,64
"2011","Purbeck 003D","E01020486","Total",684,643,41
"2011","Purbeck 003E","E01020487","Total",529,516,13
"2011","Purbeck 003F","E01020488","Total",669,653,16
"2011","Purbeck 004A","E01020489","Total",708,581,127
"2011","Purbeck 004B","E01020490","Total",802,717,85
"2011","Purbeck 004C","E01020491","Total",713,669,44
"2011","Purbeck 004D","E01020492","Total",555,538,17
"2011","Purbeck 004E","E01020493","Total",840,808,32
"2011","Purbeck 005A","E01020466","Total",1024,794,230
"2011","Purbeck 005B","E01020467","Total",887,781,106
"2011","Purbeck 005C","E01020468","Total",868,666,202
"2011","Purbeck 006A","E01020478","Total",529,477,52
"2011","Purbeck 006B","E01020479","Total",875,648,227
"2011","Purbeck 006C","E01020480","Total",1054,730,324
"2011","Purbeck 006D","E01020481","Total",1159,748,411
"2011","Purbeck 006E","E01020482","Total",982,778,204
"2011","Purbeck 006F","E01020483","Total",535,498,37
"2011","Purbeck 006G","E01020484","Total",682,625,57
"2011","West Dorset 001A","E01020542","Total",701,665,36
"2011","West Dorset 001B","E01020543","Total",643,614,29
"2011","West Dorset 001C","E01020544","Total",890,821,69
"2011","West Dorset 001E","E01020546","Total",633,582,51
"2011","West Dorset 001F","E01020547","Total",520,510,10
"2011","West Dorset 001H","E01032642","Total",1065,1021,44
"2011","West Dorset 002A","E01020497","Total",865,811,54
"2011","West Dorset 002B","E01020508","Total",897,840,57
"2011","West Dorset 002C","E01020541","Total",928,863,65
"2011","West Dorset 002D","E01020550","Total",760,712,48
"2011","West Dorset 003A","E01020494","Total",554,490,64
"2011","West Dorset 003B","E01020495","Total",720,665,55
"2011","West Dorset 003C","E01020496","Total",872,792,80
"2011","West Dorset 003D","E01020506","Total",899,771,128
"2011","West Dorset 003E","E01020530","Total",886,785,101
"2011","West Dorset 003F","E01020534","Total",998,905,93
"2011","West Dorset 004A","E01020509","Total",1255,1146,109
"2011","West Dorset 004B","E01020510","Total",961,901,60
"2011","West Dorset 004C","E01020529","Total",1065,974,91
"2011","West Dorset 004D","E01020539","Total",936,856,80
"2011","West Dorset 004E","E01020540","Total",1135,1048,87
"2011","West Dorset 005A","E01020511","Total",1107,815,292
"2011","West Dorset 005B","E01020532","Total",1354,835,519
"2011","West Dorset 005C","E01020533","Total",1080,935,145
"2011","West Dorset 005D","E01020535","Total",896,753,143
"2011","West Dorset 006A","E01020498","Total",1002,933,69
"2011","West Dorset 006B","E01020499","Total",694,619,75
"2011","West Dorset 006C","E01020500","Total",938,850,88
"2011","West Dorset 006D","E01020501","Total",636,599,37
"2011","West Dorset 007A","E01020507","Total",1152,912,240
"2011","West Dorset 007B","E01020517","Total",1014,811,203
"2011","West Dorset 007C","E01020531","Total",895,762,133
"2011","West Dorset 007D","E01020536","Total",1001,881,120
"2011","West Dorset 008A","E01020502","Total",880,819,61
"2011","West Dorset 008B","E01020503","Total",1020,902,118
"2011","West Dorset 008C","E01020504","Total",1314,1092,222
"2011","West Dorset 009C","E01020526","Total",534,509,25
"2011","West Dorset 009D","E01020527","Total",602,584,18
"2011","West Dorset 009E","E01020528","Total",1063,853,210
"2011","West Dorset 009F","E01032641","Total",757,694,63
"2011","West Dorset 009G","E01032643","Total",734,704,30
"2011","West Dorset 009H","E01032644","Total",736,669,67
"2011","West Dorset 009I","E01032645","Total",598,560,38
"2011","West Dorset 010A","E01020518","Total",782,746,36
"2011","West Dorset 010B","E01020519","Total",836,809,27
"2011","West Dorset 010C","E01020520","Total",665,657,8
"2011","West Dorset 010D","E01020523","Total",528,514,14
"2011","West Dorset 010E","E01020524","Total",640,629,11
"2011","West Dorset 010F","E01020525","Total",526,521,5
"2011","West Dorset 011A","E01020505","Total",867,807,60
"2011","West Dorset 011B","E01020537","Total",952,807,145
"2011","West Dorset 011C","E01020538","Total",839,813,26
"2011","West Dorset 011D","E01020549","Total",957,896,61
"2011","West Dorset 012A","E01020512","Total",1087,938,149
"2011","West Dorset 012B","E01020513","Total",696,676,20
"2011","West Dorset 012C","E01020514","Total",554,531,23
"2011","West Dorset 012D","E01020515","Total",519,505,14
"2011","West Dorset 012E","E01020516","Total",701,674,27
"2011","Weymouth and Portland 001A","E01020551","Total",864,836,28
"2011","Weymouth and Portland 001B","E01020552","Total",768,739,29
"2011","Weymouth and Portland 001C","E01020570","Total",757,705,52
"2011","Weymouth and Portland 001D","E01020571","Total",918,896,22
"2011","Weymouth and Portland 002A","E01020557","Total",847,754,93
"2011","Weymouth and Portland 002B","E01020558","Total",1114,787,327
"2011","Weymouth and Portland 002C","E01020559","Total",766,739,27
"2011","Weymouth and Portland 002D","E01020560","Total",836,820,16
"2011","Weymouth and Portland 002E","E01020561","Total",843,812,31
"2011","Weymouth and Portland 003A","E01020574","Total",808,766,42
"2011","Weymouth and Portland 003B","E01020575","Total",750,730,20
"2011","Weymouth and Portland 003C","E01020576","Total",794,779,15
"2011","Weymouth and Portland 003D","E01020579","Total",883,829,54
"2011","Weymouth and Portland 003E","E01020580","Total",634,605,29
"2011","Weymouth and Portland 004A","E01020553","Total",679,579,100
"2011","Weymouth and Portland 004B","E01020554","Total",1271,991,280
"2011","Weymouth and Portland 004C","E01020555","Total",834,669,165
"2011","Weymouth and Portland 004D","E01020556","Total",842,744,98
"2011","Weymouth and Portland 004E","E01020581","Total",1248,992,256
"2011","Weymouth and Portland 004F","E01020582","Total",828,768,60
"2011","Weymouth and Portland 005A","E01020572","Total",898,850,48
"2011","Weymouth and Portland 005B","E01020573","Total",949,869,80
"2011","Weymouth and Portland 005C","E01020577","Total",654,640,14
"2011","Weymouth and Portland 005D","E01020578","Total",953,940,13
"2011","Weymouth and Portland 006A","E01020583","Total",838,800,38
"2011","Weymouth and Portland 006B","E01020584","Total",747,719,28
"2011","Weymouth and Portland 006C","E01020585","Total",615,603,12
"2011","Weymouth and Portland 007A","E01020586","Total",547,533,14
"2011","Weymouth and Portland 007B","E01020587","Total",727,675,52
"2011","Weymouth and Portland 007C","E01020588","Total",561,545,16
"2011","Weymouth and Portland 007D","E01020589","Total",660,646,14
"2011","Weymouth and Portland 008A","E01020563","Total",544,516,28
"2011","Weymouth and Portland 008D","E01020569","Total",735,640,95
"2011","Weymouth and Portland 008E","E01033200","Total",1095,938,157
"2011","Weymouth and Portland 009A","E01020562","Total",945,876,69
"2011","Weymouth and Portland 009B","E01020564","Total",675,659,16
"2011","Weymouth and Portland 009C","E01020565","Total",659,646,13
"2011","Weymouth and Portland 009D","E01020566","Total",957,900,57
"2011","Cheltenham 001A","E01022163","Total",612,605,7
"2011","Cheltenham 001B","E01022164","Total",617,597,20
"2011","Cheltenham 001C","E01022165","Total",726,709,17
"2011","Cheltenham 001D","E01022166","Total",552,540,12
"2011","Cheltenham 002A","E01022143","Total",685,667,18
"2011","Cheltenham 002B","E01022144","Total",554,536,18
"2011","Cheltenham 002C","E01022145","Total",524,512,12
"2011","Cheltenham 002D","E01022146","Total",652,626,26
"2011","Cheltenham 003A","E01022122","Total",598,572,26
"2011","Cheltenham 003B","E01022160","Total",905,879,26
"2011","Cheltenham 003C","E01022161","Total",646,631,15
"2011","Cheltenham 003D","E01022162","Total",703,689,14
"2011","Cheltenham 004A","E01022139","Total",544,526,18
"2011","Cheltenham 004B","E01022151","Total",661,640,21
"2011","Cheltenham 004C","E01022152","Total",447,434,13
"2011","Cheltenham 004D","E01022153","Total",730,658,72
"2011","Cheltenham 004E","E01022154","Total",747,700,47
"2011","Cheltenham 005A","E01022120","Total",725,691,34
"2011","Cheltenham 005B","E01022121","Total",750,732,18
"2011","Cheltenham 005C","E01022147","Total",787,768,19
"2011","Cheltenham 005D","E01022157","Total",660,643,17
"2011","Cheltenham 005E","E01022159","Total",624,603,21
"2011","Cheltenham 006A","E01022131","Total",590,572,18
"2011","Cheltenham 006B","E01022132","Total",608,596,12
"2011","Cheltenham 006C","E01022133","Total",511,508,3
"2011","Cheltenham 006D","E01022134","Total",819,767,52
"2011","Cheltenham 007A","E01022148","Total",668,648,20
"2011","Cheltenham 007B","E01022149","Total",547,525,22
"2011","Cheltenham 007C","E01022150","Total",689,657,32
"2011","Cheltenham 007D","E01022155","Total",634,612,22
"2011","Cheltenham 007E","E01022156","Total",687,657,30
"2011","Cheltenham 007F","E01022158","Total",1131,1048,83
"2011","Cheltenham 008A","E01022100","Total",818,770,48
"2011","Cheltenham 008B","E01022101","Total",885,857,28
"2011","Cheltenham 008C","E01022102","Total",1153,1038,115
"2011","Cheltenham 008D","E01022140","Total",596,570,26
"2011","Cheltenham 008E","E01022141","Total",875,787,88
"2011","Cheltenham 008F","E01022142","Total",848,772,76
"2011","Cheltenham 009A","E01022116","Total",612,554,58
"2011","Cheltenham 009B","E01022117","Total",1100,967,133
"2011","Cheltenham 009C","E01022119","Total",601,577,24
"2011","Cheltenham 009D","E01022124","Total",832,761,71
"2011","Cheltenham 009E","E01022125","Total",634,592,42
"2011","Cheltenham 009F","E01022126","Total",1084,943,141
"2011","Cheltenham 009G","E01022127","Total",805,678,127
"2011","Cheltenham 010A","E01022106","Total",761,747,14
"2011","Cheltenham 010B","E01022107","Total",666,656,10
"2011","Cheltenham 010C","E01022108","Total",756,734,22
"2011","Cheltenham 010D","E01022123","Total",1029,988,41
"2011","Cheltenham 011A","E01022135","Total",666,624,42
"2011","Cheltenham 011B","E01022136","Total",788,742,46
"2011","Cheltenham 011C","E01022137","Total",965,879,86
"2011","Cheltenham 011D","E01022138","Total",823,776,47
"2011","Cheltenham 011E","E01022174","Total",616,597,19
"2011","Cheltenham 012A","E01022103","Total",1037,1001,36
"2011","Cheltenham 012B","E01022104","Total",744,721,23
"2011","Cheltenham 012C","E01022105","Total",606,584,22
"2011","Cheltenham 012D","E01022109","Total",627,606,21
"2011","Cheltenham 012E","E01022110","Total",639,616,23
"2011","Cheltenham 012F","E01022111","Total",611,589,22
"2011","Cheltenham 012G","E01022112","Total",487,469,18
"2011","Cheltenham 013A","E01022167","Total",525,509,16
"2011","Cheltenham 013B","E01022168","Total",484,476,8
"2011","Cheltenham 013C","E01022169","Total",683,667,16
"2011","Cheltenham 013D","E01022170","Total",634,628,6
"2011","Cheltenham 013E","E01022171","Total",558,551,7
"2011","Cheltenham 013F","E01022172","Total",738,711,27
"2011","Cheltenham 013G","E01022173","Total",629,613,16
"2011","Cheltenham 014A","E01022113","Total",752,714,38
"2011","Cheltenham 014B","E01022114","Total",688,662,26
"2011","Cheltenham 014C","E01022115","Total",829,807,22
"2011","Cheltenham 014D","E01022118","Total",591,572,19
"2011","Cheltenham 015A","E01022128","Total",679,670,9
"2011","Cheltenham 015B","E01022129","Total",884,874,10
"2011","Cheltenham 015C","E01022130","Total",759,732,27
"2011","Cotswold 001A","E01022179","Total",1104,905,199
"2011","Cotswold 001B","E01022182","Total",780,689,91
"2011","Cotswold 001C","E01022183","Total",832,694,138
"2011","Cotswold 001D","E01022184","Total",782,674,108
"2011","Cotswold 001E","E01022185","Total",666,627,39
"2011","Cotswold 002A","E01022177","Total",1156,966,190
"2011","Cotswold 002B","E01022178","Total",738,595,143
"2011","Cotswold 002C","E01022205","Total",988,841,147
"2011","Cotswold 002D","E01022211","Total",1041,931,110
"2011","Cotswold 002E","E01022212","Total",758,722,36
"2011","Cotswold 003A","E01022180","Total",961,923,38
"2011","Cotswold 003B","E01022181","Total",920,782,138
"2011","Cotswold 003C","E01022214","Total",937,848,89
"2011","Cotswold 003D","E01022222","Total",1055,875,180
"2011","Cotswold 004A","E01022186","Total",797,721,76
"2011","Cotswold 004B","E01022187","Total",795,732,63
"2011","Cotswold 004C","E01022201","Total",837,749,88
"2011","Cotswold 004D","E01022216","Total",873,788,85
"2011","Cotswold 005A","E01022175","Total",956,818,138
"2011","Cotswold 005B","E01022207","Total",791,751,40
"2011","Cotswold 005C","E01022213","Total",855,787,68
"2011","Cotswold 005D","E01022215","Total",971,815,156
"2011","Cotswold 006A","E01022188","Total",621,601,20
"2011","Cotswold 006B","E01022189","Total",519,512,7
"2011","Cotswold 006C","E01022190","Total",535,529,6
"2011","Cotswold 006D","E01022196","Total",757,731,26
"2011","Cotswold 006E","E01022197","Total",793,776,17
"2011","Cotswold 007A","E01022194","Total",1100,995,105
"2011","Cotswold 007B","E01022195","Total",680,641,39
"2011","Cotswold 007C","E01022199","Total",901,860,41
"2011","Cotswold 007D","E01022200","Total",619,607,12
"2011","Cotswold 008A","E01022191","Total",667,653,14
"2011","Cotswold 008B","E01022192","Total",541,532,9
"2011","Cotswold 008C","E01022193","Total",422,417,5
"2011","Cotswold 008D","E01022198","Total",577,563,14
"2011","Cotswold 008E","E01022225","Total",658,633,25
"2011","Cotswold 009A","E01022202","Total",476,429,47
"2011","Cotswold 009B","E01022203","Total",698,642,56
"2011","Cotswold 009C","E01022204","Total",627,611,16
"2011","Cotswold 009D","E01022208","Total",695,671,24
"2011","Cotswold 009E","E01022209","Total",461,447,14
"2011","Cotswold 009F","E01022210","Total",696,651,45
"2011","Cotswold 010A","E01022221","Total",845,782,63
"2011","Cotswold 010B","E01022223","Total",1204,1020,184
"2011","Cotswold 010C","E01022224","Total",967,686,281
"2011","Cotswold 011A","E01022176","Total",886,815,71
"2011","Cotswold 011B","E01022206","Total",886,796,90
"2011","Cotswold 011C","E01022217","Total",576,561,15
"2011","Cotswold 011D","E01022218","Total",539,525,14
"2011","Cotswold 011E","E01022219","Total",539,522,17
"2011","Cotswold 011F","E01022220","Total",890,795,95
"2011","Forest of Dean 001A","E01022233","Total",840,785,55
"2011","Forest of Dean 001B","E01022235","Total",775,735,40
"2011","Forest of Dean 001C","E01022247","Total",725,673,52
"2011","Forest of Dean 001D","E01022270","Total",796,749,47
"2011","Forest of Dean 001E","E01022271","Total",741,703,38
"2011","Forest of Dean 002A","E01022261","Total",797,781,16
"2011","Forest of Dean 002B","E01022262","Total",957,861,96
"2011","Forest of Dean 002C","E01022267","Total",704,660,44
"2011","Forest of Dean 003A","E01022251","Total",677,629,48
"2011","Forest of Dean 003B","E01022252","Total",752,710,42
"2011","Forest of Dean 003C","E01022258","Total",504,470,34
"2011","Forest of Dean 003D","E01022259","Total",680,640,40
"2011","Forest of Dean 003E","E01022260","Total",802,752,50
"2011","Forest of Dean 004A","E01022236","Total",927,898,29
"2011","Forest of Dean 004B","E01022237","Total",645,628,17
"2011","Forest of Dean 004C","E01022238","Total",634,607,27
"2011","Forest of Dean 004D","E01022239","Total",714,691,23
"2011","Forest of Dean 004E","E01022240","Total",973,930,43
"2011","Forest of Dean 004F","E01022249","Total",869,817,52
"2011","Forest of Dean 004G","E01022250","Total",778,762,16
"2011","Forest of Dean 005A","E01022228","Total",715,686,29
"2011","Forest of Dean 005B","E01022230","Total",753,689,64
"2011","Forest of Dean 005C","E01022265","Total",742,704,38
"2011","Forest of Dean 005D","E01022266","Total",563,526,37
"2011","Forest of Dean 006A","E01022234","Total",684,639,45
"2011","Forest of Dean 006B","E01022253","Total",770,713,57
"2011","Forest of Dean 006C","E01022263","Total",880,778,102
"2011","Forest of Dean 007A","E01022229","Total",692,677,15
"2011","Forest of Dean 007B","E01022241","Total",859,819,40
"2011","Forest of Dean 007C","E01022242","Total",622,592,30
"2011","Forest of Dean 007D","E01022243","Total",545,532,13
"2011","Forest of Dean 007E","E01022244","Total",643,616,27
"2011","Forest of Dean 007F","E01022245","Total",626,594,32
"2011","Forest of Dean 007G","E01022246","Total",556,532,24
"2011","Forest of Dean 008A","E01022231","Total",742,692,50
"2011","Forest of Dean 008B","E01022232","Total",682,643,39
"2011","Forest of Dean 008C","E01022264","Total",666,613,53
"2011","Forest of Dean 008D","E01022268","Total",706,674,32
"2011","Forest of Dean 008E","E01022269","Total",864,801,63
"2011","Forest of Dean 009A","E01022226","Total",712,690,22
"2011","Forest of Dean 009B","E01022227","Total",726,682,44
"2011","Forest of Dean 009C","E01022254","Total",776,757,19
"2011","Forest of Dean 009D","E01022255","Total",645,622,23
"2011","Forest of Dean 009E","E01022256","Total",805,742,63
"2011","Forest of Dean 009F","E01022257","Total",807,770,37
"2011","Forest of Dean 010A","E01022248","Total",757,711,46
"2011","Forest of Dean 010B","E01022272","Total",606,564,42
"2011","Forest of Dean 010C","E01022273","Total",503,457,46
"2011","Forest of Dean 010D","E01022274","Total",531,496,35
"2011","Forest of Dean 010E","E01022275","Total",707,675,32
"2011","Gloucester 001A","E01022313","Total",720,702,18
"2011","Gloucester 001B","E01022315","Total",647,628,19
"2011","Gloucester 001C","E01022316","Total",694,676,18
"2011","Gloucester 001D","E01022317","Total",624,610,14
"2011","Gloucester 001E","E01022318","Total",667,656,11
"2011","Gloucester 002A","E01022309","Total",658,618,40
"2011","Gloucester 002B","E01022310","Total",788,742,46
"2011","Gloucester 002C","E01022311","Total",1141,1000,141
"2011","Gloucester 002D","E01022312","Total",1057,958,99
"2011","Gloucester 002E","E01022314","Total",668,647,21
"2011","Gloucester 003A","E01022295","Total",604,590,14
"2011","Gloucester 003B","E01022296","Total",621,597,24
"2011","Gloucester 003C","E01022297","Total",511,496,15
"2011","Gloucester 003D","E01022298","Total",621,602,19
"2011","Gloucester 004A","E01022332","Total",760,671,89
"2011","Gloucester 004B","E01022347","Total",1205,919,286
"2011","Gloucester 004C","E01022348","Total",1188,1113,75
"2011","Gloucester 004E","E01032932","Total",691,628,63
"2011","Gloucester 004F","E01032937","Total",731,604,127
"2011","Gloucester 005A","E01022288","Total",771,705,66
"2011","Gloucester 005B","E01022289","Total",723,625,98
"2011","Gloucester 005C","E01022290","Total",569,529,40
"2011","Gloucester 005D","E01022291","Total",698,635,63
"2011","Gloucester 005E","E01022292","Total",547,493,54
"2011","Gloucester 006A","E01022283","Total",649,635,14
"2011","Gloucester 006B","E01022303","Total",657,622,35
"2011","Gloucester 006C","E01022304","Total",805,765,40
"2011","Gloucester 006D","E01022305","Total",612,589,23
"2011","Gloucester 006E","E01022308","Total",663,649,14
"2011","Gloucester 007A","E01022278","Total",653,638,15
"2011","Gloucester 007B","E01022279","Total",584,569,15
"2011","Gloucester 007C","E01022282","Total",1051,1043,8
"2011","Gloucester 007D","E01022284","Total",543,511,32
"2011","Gloucester 007E","E01022285","Total",508,497,11
"2011","Gloucester 007F","E01022286","Total",635,611,24
"2011","Gloucester 007G","E01022287","Total",749,711,38
"2011","Gloucester 008A","E01022293","Total",712,633,79
"2011","Gloucester 008B","E01022294","Total",680,634,46
"2011","Gloucester 008C","E01022323","Total",676,633,43
"2011","Gloucester 008D","E01022328","Total",540,501,39
"2011","Gloucester 008E","E01022329","Total",636,599,37
"2011","Gloucester 009A","E01022326","Total",578,555,23
"2011","Gloucester 009B","E01022327","Total",633,618,15
"2011","Gloucester 009C","E01022330","Total",621,587,34
"2011","Gloucester 009D","E01022331","Total",515,496,19
"2011","Gloucester 009E","E01022333","Total",673,641,32
"2011","Gloucester 009F","E01022334","Total",662,650,12
"2011","Gloucester 010A","E01022276","Total",693,685,8
"2011","Gloucester 010B","E01022277","Total",682,659,23
"2011","Gloucester 010C","E01022280","Total",700,685,15
"2011","Gloucester 010D","E01022281","Total",696,690,6
"2011","Gloucester 010E","E01022306","Total",592,584,8
"2011","Gloucester 010F","E01022307","Total",644,638,6
"2011","Gloucester 011A","E01022319","Total",742,703,39
"2011","Gloucester 011B","E01022320","Total",652,626,26
"2011","Gloucester 011C","E01022321","Total",625,609,16
"2011","Gloucester 011D","E01022322","Total",642,609,33
"2011","Gloucester 011E","E01022324","Total",672,649,23
"2011","Gloucester 011F","E01022325","Total",596,586,10
"2011","Gloucester 012A","E01022343","Total",529,510,19
"2011","Gloucester 012B","E01022344","Total",636,625,11
"2011","Gloucester 012C","E01022345","Total",639,630,9
"2011","Gloucester 012D","E01022346","Total",661,658,3
"2011","Gloucester 013A","E01022299","Total",640,629,11
"2011","Gloucester 013B","E01022300","Total",643,635,8
"2011","Gloucester 013C","E01022301","Total",683,660,23
"2011","Gloucester 013D","E01022302","Total",641,625,16
"2011","Gloucester 014A","E01022339","Total",664,660,4
"2011","Gloucester 014B","E01022340","Total",635,622,13
"2011","Gloucester 014C","E01022341","Total",870,853,17
"2011","Gloucester 014D","E01022342","Total",682,677,5
"2011","Gloucester 015A","E01022335","Total",645,612,33
"2011","Gloucester 015B","E01022336","Total",499,496,3
"2011","Gloucester 015D","E01022338","Total",647,630,17
"2011","Gloucester 015E","E01032933","Total",542,535,7
"2011","Gloucester 015F","E01032934","Total",578,573,5
"2011","Gloucester 015G","E01032935","Total",573,556,17
"2011","Gloucester 015H","E01032936","Total",664,623,41
"2011","Stroud 001A","E01022378","Total",756,739,17
"2011","Stroud 001B","E01022379","Total",692,665,27
"2011","Stroud 001C","E01022380","Total",631,606,25
"2011","Stroud 001D","E01022412","Total",1196,1163,33
"2011","Stroud 002A","E01022354","Total",1030,936,94
"2011","Stroud 002B","E01022390","Total",648,594,54
"2011","Stroud 002C","E01022391","Total",706,640,66
"2011","Stroud 002D","E01022392","Total",712,658,54
"2011","Stroud 003A","E01022376","Total",763,736,27
"2011","Stroud 003B","E01022396","Total",706,667,39
"2011","Stroud 003C","E01022397","Total",749,717,32
"2011","Stroud 003D","E01022398","Total",463,449,14
"2011","Stroud 004A","E01022355","Total",661,641,20
"2011","Stroud 004B","E01022356","Total",991,952,39
"2011","Stroud 004C","E01022357","Total",790,778,12
"2011","Stroud 004D","E01022358","Total",667,656,11
"2011","Stroud 004E","E01022377","Total",999,987,12
"2011","Stroud 004F","E01022389","Total",751,717,34
"2011","Stroud 005A","E01022400","Total",804,789,15
"2011","Stroud 005B","E01022401","Total",606,596,10
"2011","Stroud 005C","E01022402","Total",665,648,17
"2011","Stroud 005D","E01022403","Total",628,609,19
"2011","Stroud 005E","E01022404","Total",575,551,24
"2011","Stroud 006A","E01022365","Total",1137,1005,132
"2011","Stroud 006B","E01022399","Total",963,917,46
"2011","Stroud 006C","E01022410","Total",1025,986,39
"2011","Stroud 006D","E01022411","Total",972,950,22
"2011","Stroud 006E","E01022414","Total",1150,1109,41
"2011","Stroud 007A","E01022393","Total",640,619,21
"2011","Stroud 007B","E01022394","Total",710,672,38
"2011","Stroud 007C","E01022395","Total",658,635,23
"2011","Stroud 007D","E01022408","Total",458,435,23
"2011","Stroud 007E","E01022409","Total",537,499,38
"2011","Stroud 008A","E01022366","Total",697,676,21
"2011","Stroud 008B","E01022367","Total",712,674,38
"2011","Stroud 008C","E01022368","Total",612,587,25
"2011","Stroud 008D","E01022369","Total",767,744,23
"2011","Stroud 009A","E01022370","Total",562,534,28
"2011","Stroud 009B","E01022371","Total",428,413,15
"2011","Stroud 009C","E01022405","Total",649,625,24
"2011","Stroud 009D","E01022406","Total",551,521,30
"2011","Stroud 009E","E01022407","Total",574,547,27
"2011","Stroud 010A","E01022350","Total",953,888,65
"2011","Stroud 010B","E01022382","Total",705,662,43
"2011","Stroud 010C","E01022383","Total",632,593,39
"2011","Stroud 010D","E01022384","Total",667,617,50
"2011","Stroud 011A","E01022359","Total",659,638,21
"2011","Stroud 011B","E01022360","Total",577,567,10
"2011","Stroud 011C","E01022361","Total",612,603,9
"2011","Stroud 011D","E01022362","Total",524,512,12
"2011","Stroud 011E","E01022363","Total",788,765,23
"2011","Stroud 011F","E01022364","Total",496,488,8
"2011","Stroud 012A","E01022351","Total",627,592,35
"2011","Stroud 012B","E01022352","Total",600,578,22
"2011","Stroud 012C","E01022353","Total",658,643,15
"2011","Stroud 012D","E01022413","Total",776,727,49
"2011","Stroud 013A","E01022385","Total",707,663,44
"2011","Stroud 013B","E01022386","Total",795,746,49
"2011","Stroud 013C","E01022387","Total",766,722,44
"2011","Stroud 013D","E01022388","Total",728,696,32
"2011","Stroud 014A","E01022372","Total",807,755,52
"2011","Stroud 014B","E01022373","Total",763,737,26
"2011","Stroud 014C","E01022374","Total",969,932,37
"2011","Stroud 014D","E01022375","Total",498,485,13
"2011","Stroud 015A","E01022381","Total",821,784,37
"2011","Stroud 015B","E01022415","Total",668,628,40
"2011","Stroud 015C","E01022416","Total",598,585,13
"2011","Stroud 015D","E01022417","Total",742,727,15
"2011","Stroud 015E","E01022418","Total",856,819,37
"2011","Tewkesbury 001B","E01022450","Total",907,885,22
"2011","Tewkesbury 001C","E01022451","Total",647,636,11
"2011","Tewkesbury 001D","E01022452","Total",539,534,5
"2011","Tewkesbury 001E","E01022455","Total",827,812,15
"2011","Tewkesbury 001F","E01032938","Total",637,608,29
"2011","Tewkesbury 001G","E01032939","Total",592,584,8
"2011","Tewkesbury 001H","E01032940","Total",560,541,19
"2011","Tewkesbury 002A","E01022456","Total",548,539,9
"2011","Tewkesbury 002B","E01022457","Total",618,600,18
"2011","Tewkesbury 002C","E01022458","Total",680,668,12
"2011","Tewkesbury 002D","E01022459","Total",979,850,129
"2011","Tewkesbury 002E","E01022460","Total",884,832,52
"2011","Tewkesbury 002F","E01022461","Total",650,635,15
"2011","Tewkesbury 002G","E01022462","Total",737,695,42
"2011","Tewkesbury 003A","E01022449","Total",1020,848,172
"2011","Tewkesbury 003B","E01022463","Total",861,718,143
"2011","Tewkesbury 003C","E01022464","Total",780,743,37
"2011","Tewkesbury 003D","E01022465","Total",673,627,46
"2011","Tewkesbury 003E","E01022466","Total",804,748,56
"2011","Tewkesbury 004A","E01022434","Total",907,852,55
"2011","Tewkesbury 004B","E01022441","Total",697,667,30
"2011","Tewkesbury 004C","E01022445","Total",617,564,53
"2011","Tewkesbury 004D","E01022453","Total",691,648,43
"2011","Tewkesbury 005A","E01022432","Total",974,950,24
"2011","Tewkesbury 005B","E01022433","Total",882,854,28
"2011","Tewkesbury 005C","E01022435","Total",988,958,30
"2011","Tewkesbury 005D","E01022436","Total",956,914,42
"2011","Tewkesbury 005E","E01022437","Total",600,584,16
"2011","Tewkesbury 005F","E01022438","Total",618,604,14
"2011","Tewkesbury 005G","E01022439","Total",730,710,20
"2011","Tewkesbury 006A","E01022440","Total",791,735,56
"2011","Tewkesbury 006B","E01022442","Total",696,618,78
"2011","Tewkesbury 006C","E01022443","Total",567,548,19
"2011","Tewkesbury 006D","E01022444","Total",620,579,41
"2011","Tewkesbury 007A","E01022425","Total",509,499,10
"2011","Tewkesbury 007B","E01022426","Total",674,642,32
"2011","Tewkesbury 007C","E01022427","Total",684,643,41
"2011","Tewkesbury 007D","E01022428","Total",828,797,31
"2011","Tewkesbury 007E","E01022429","Total",684,672,12
"2011","Tewkesbury 007F","E01022430","Total",643,632,11
"2011","Tewkesbury 007G","E01022431","Total",910,893,17
"2011","Tewkesbury 007H","E01022447","Total",511,473,38
"2011","Tewkesbury 008A","E01022420","Total",1013,910,103
"2011","Tewkesbury 008B","E01022448","Total",602,580,22
"2011","Tewkesbury 008C","E01022454","Total",911,861,50
"2011","Tewkesbury 009A","E01022421","Total",783,735,48
"2011","Tewkesbury 009B","E01022422","Total",671,642,29
"2011","Tewkesbury 009C","E01022423","Total",876,839,37
"2011","Tewkesbury 009D","E01022424","Total",669,658,11
"2011","Tewkesbury 009E","E01022446","Total",820,762,58
"2011","Mendip 001A","E01029022","Total",614,584,30
"2011","Mendip 001B","E01029023","Total",523,481,42
"2011","Mendip 001C","E01029044","Total",599,570,29
"2011","Mendip 001D","E01029053","Total",1030,953,77
"2011","Mendip 001E","E01029057","Total",899,830,69
"2011","Mendip 002A","E01029024","Total",851,823,28
"2011","Mendip 002B","E01029025","Total",569,544,25
"2011","Mendip 002C","E01029026","Total",434,417,17
"2011","Mendip 002D","E01029068","Total",516,485,31
"2011","Mendip 002E","E01029069","Total",472,445,27
"2011","Mendip 003A","E01029030","Total",797,784,13
"2011","Mendip 003B","E01029031","Total",690,676,14
"2011","Mendip 003C","E01029032","Total",503,497,6
"2011","Mendip 003D","E01029033","Total",639,628,11
"2011","Mendip 003E","E01029034","Total",602,582,20
"2011","Mendip 004A","E01029036","Total",780,713,67
"2011","Mendip 004B","E01029041","Total",1075,950,125
"2011","Mendip 004C","E01029042","Total",720,673,47
"2011","Mendip 004D","E01029043","Total",653,620,33
"2011","Mendip 004E","E01029045","Total",680,657,23
"2011","Mendip 005A","E01029052","Total",898,862,36
"2011","Mendip 005B","E01029060","Total",815,764,51
"2011","Mendip 005C","E01029061","Total",981,930,51
"2011","Mendip 005D","E01029083","Total",572,543,29
"2011","Mendip 006A","E01029018","Total",965,921,44
"2011","Mendip 006B","E01029056","Total",1029,963,66
"2011","Mendip 006C","E01029064","Total",659,633,26
"2011","Mendip 006D","E01029084","Total",691,670,21
"2011","Mendip 007A","E01029029","Total",739,708,31
"2011","Mendip 007B","E01029035","Total",693,623,70
"2011","Mendip 007C","E01029037","Total",654,597,57
"2011","Mendip 007D","E01029038","Total",600,568,32
"2011","Mendip 007E","E01029039","Total",649,635,14
"2011","Mendip 007F","E01029040","Total",739,717,22
"2011","Mendip 008A","E01029078","Total",1017,929,88
"2011","Mendip 008B","E01029079","Total",790,763,27
"2011","Mendip 008C","E01029080","Total",655,634,21
"2011","Mendip 008D","E01029081","Total",786,728,58
"2011","Mendip 008E","E01029082","Total",680,645,35
"2011","Mendip 009A","E01029062","Total",761,685,76
"2011","Mendip 009B","E01029063","Total",1019,995,24
"2011","Mendip 009C","E01029065","Total",673,660,13
"2011","Mendip 009D","E01029066","Total",766,739,27
"2011","Mendip 009E","E01029067","Total",694,665,29
"2011","Mendip 010A","E01029020","Total",618,592,26
"2011","Mendip 010B","E01029021","Total",514,488,26
"2011","Mendip 010C","E01029027","Total",519,490,29
"2011","Mendip 010D","E01029028","Total",579,552,27
"2011","Mendip 010E","E01029058","Total",1010,946,64
"2011","Mendip 011A","E01029046","Total",895,771,124
"2011","Mendip 011D","E01029050","Total",1000,965,35
"2011","Mendip 011E","E01029051","Total",733,707,26
"2011","Mendip 011F","E01032627","Total",1048,967,81
"2011","Mendip 012A","E01029047","Total",650,626,24
"2011","Mendip 012B","E01029054","Total",660,624,36
"2011","Mendip 012C","E01029055","Total",509,499,10
"2011","Mendip 012D","E01029074","Total",544,513,31
"2011","Mendip 012E","E01029076","Total",843,823,20
"2011","Mendip 013A","E01029019","Total",1036,973,63
"2011","Mendip 013B","E01029059","Total",931,872,59
"2011","Mendip 013C","E01029077","Total",886,828,58
"2011","Mendip 014A","E01029070","Total",887,825,62
"2011","Mendip 014B","E01029071","Total",698,683,15
"2011","Mendip 014C","E01029072","Total",790,767,23
"2011","Mendip 014D","E01029073","Total",569,545,24
"2011","Mendip 014E","E01029075","Total",629,612,17
"2011","Sedgemoor 001A","E01029085","Total",923,878,45
"2011","Sedgemoor 001B","E01029126","Total",683,658,25
"2011","Sedgemoor 001C","E01029127","Total",826,782,44
"2011","Sedgemoor 001D","E01029128","Total",785,754,31
"2011","Sedgemoor 001E","E01029129","Total",731,719,12
"2011","Sedgemoor 002C","E01029089","Total",873,846,27
"2011","Sedgemoor 002D","E01029113","Total",772,736,36
"2011","Sedgemoor 002E","E01029115","Total",750,734,16
"2011","Sedgemoor 002F","E01029140","Total",1183,1140,43
"2011","Sedgemoor 002G","E01032633","Total",1084,967,117
"2011","Sedgemoor 003A","E01029086","Total",906,864,42
"2011","Sedgemoor 003B","E01029147","Total",701,679,22
"2011","Sedgemoor 003C","E01029148","Total",687,651,36
"2011","Sedgemoor 003D","E01029149","Total",574,554,20
"2011","Sedgemoor 004A","E01029114","Total",737,710,27
"2011","Sedgemoor 004B","E01029116","Total",889,817,72
"2011","Sedgemoor 004C","E01029117","Total",872,791,81
"2011","Sedgemoor 004D","E01029119","Total",787,764,23
"2011","Sedgemoor 004E","E01029120","Total",673,658,15
"2011","Sedgemoor 005A","E01029118","Total",727,717,10
"2011","Sedgemoor 005B","E01029131","Total",991,936,55
"2011","Sedgemoor 005C","E01029132","Total",649,636,13
"2011","Sedgemoor 005D","E01029133","Total",610,597,13
"2011","Sedgemoor 005E","E01029134","Total",876,857,19
"2011","Sedgemoor 006A","E01029135","Total",730,716,14
"2011","Sedgemoor 006B","E01029136","Total",833,809,24
"2011","Sedgemoor 006C","E01029145","Total",864,843,21
"2011","Sedgemoor 006D","E01029152","Total",973,941,32
"2011","Sedgemoor 007A","E01029121","Total",555,535,20
"2011","Sedgemoor 007B","E01029122","Total",616,589,27
"2011","Sedgemoor 007C","E01029123","Total",506,488,18
"2011","Sedgemoor 007D","E01029124","Total",865,792,73
"2011","Sedgemoor 007E","E01029125","Total",597,568,29
"2011","Sedgemoor 008A","E01029093","Total",766,728,38
"2011","Sedgemoor 008B","E01029096","Total",622,597,25
"2011","Sedgemoor 008C","E01029106","Total",629,617,12
"2011","Sedgemoor 008D","E01029107","Total",644,633,11
"2011","Sedgemoor 008E","E01029109","Total",530,517,13
"2011","Sedgemoor 009A","E01029094","Total",737,722,15
"2011","Sedgemoor 009B","E01029095","Total",816,741,75
"2011","Sedgemoor 009C","E01029110","Total",1038,999,39
"2011","Sedgemoor 009D","E01029111","Total",995,966,29
"2011","Sedgemoor 009E","E01029112","Total",1121,1007,114
"2011","Sedgemoor 010A","E01029090","Total",668,656,12
"2011","Sedgemoor 010B","E01029091","Total",757,740,17
"2011","Sedgemoor 010C","E01029092","Total",630,615,15
"2011","Sedgemoor 010D","E01029108","Total",963,944,19
"2011","Sedgemoor 011A","E01029102","Total",641,626,15
"2011","Sedgemoor 011B","E01029103","Total",636,629,7
"2011","Sedgemoor 011C","E01029104","Total",636,618,18
"2011","Sedgemoor 011E","E01032631","Total",561,543,18
"2011","Sedgemoor 011F","E01032632","Total",509,491,18
"2011","Sedgemoor 011G","E01032634","Total",512,501,11
"2011","Sedgemoor 012A","E01029130","Total",905,862,43
"2011","Sedgemoor 012B","E01029137","Total",659,631,28
"2011","Sedgemoor 012C","E01029138","Total",599,584,15
"2011","Sedgemoor 012D","E01029139","Total",640,607,33
"2011","Sedgemoor 012E","E01029150","Total",531,514,17
"2011","Sedgemoor 012F","E01029151","Total",576,560,16
"2011","Sedgemoor 013A","E01029097","Total",616,596,20
"2011","Sedgemoor 013B","E01029098","Total",682,638,44
"2011","Sedgemoor 013C","E01029099","Total",519,507,12
"2011","Sedgemoor 013D","E01029100","Total",514,491,23
"2011","Sedgemoor 013E","E01029105","Total",768,728,40
"2011","Sedgemoor 014A","E01029101","Total",468,462,6
"2011","Sedgemoor 014C","E01029142","Total",671,642,29
"2011","Sedgemoor 014D","E01029143","Total",651,630,21
"2011","Sedgemoor 014E","E01029144","Total",523,498,25
"2011","Sedgemoor 014F","E01032629","Total",736,624,112
"2011","Sedgemoor 014G","E01032630","Total",624,611,13
"2011","South Somerset 001A","E01029157","Total",621,577,44
"2011","South Somerset 001B","E01029158","Total",534,505,29
"2011","South Somerset 001C","E01029221","Total",1124,1017,107
"2011","South Somerset 002A","E01029166","Total",1039,946,93
"2011","South Somerset 002B","E01029167","Total",810,740,70
"2011","South Somerset 002C","E01029168","Total",768,742,26
"2011","South Somerset 002D","E01029210","Total",664,639,25
"2011","South Somerset 002E","E01029211","Total",626,593,33
"2011","South Somerset 003A","E01029224","Total",743,702,41
"2011","South Somerset 003B","E01029225","Total",943,933,10
"2011","South Somerset 003C","E01029226","Total",864,809,55
"2011","South Somerset 004A","E01029200","Total",690,640,50
"2011","South Somerset 004B","E01029201","Total",648,611,37
"2011","South Somerset 004C","E01029222","Total",700,646,54
"2011","South Somerset 004D","E01029223","Total",545,513,32
"2011","South Somerset 005A","E01029155","Total",862,789,73
"2011","South Somerset 005B","E01029227","Total",687,658,29
"2011","South Somerset 005C","E01029228","Total",758,719,39
"2011","South Somerset 005D","E01029229","Total",1033,948,85
"2011","South Somerset 006A","E01029164","Total",650,613,37
"2011","South Somerset 006B","E01029165","Total",550,522,28
"2011","South Somerset 006C","E01029198","Total",533,486,47
"2011","South Somerset 006D","E01029199","Total",911,881,30
"2011","South Somerset 007A","E01029187","Total",456,443,13
"2011","South Somerset 007B","E01029188","Total",686,654,32
"2011","South Somerset 007C","E01029196","Total",677,619,58
"2011","South Somerset 007D","E01029197","Total",563,537,26
"2011","South Somerset 008A","E01029154","Total",844,773,71
"2011","South Somerset 008B","E01029156","Total",887,816,71
"2011","South Somerset 008C","E01029206","Total",677,645,32
"2011","South Somerset 008D","E01029207","Total",649,606,43
"2011","South Somerset 009A","E01029202","Total",580,557,23
"2011","South Somerset 009B","E01029203","Total",685,645,40
"2011","South Somerset 009C","E01029204","Total",568,537,31
"2011","South Somerset 009D","E01029205","Total",791,765,26
"2011","South Somerset 010A","E01029163","Total",1008,946,62
"2011","South Somerset 010B","E01029216","Total",703,660,43
"2011","South Somerset 010C","E01029217","Total",715,679,36
"2011","South Somerset 010D","E01029218","Total",911,880,31
"2011","South Somerset 011A","E01029238","Total",664,651,13
"2011","South Somerset 011B","E01029252","Total",617,601,16
"2011","South Somerset 011C","E01029253","Total",772,704,68
"2011","South Somerset 011D","E01029254","Total",609,593,16
"2011","South Somerset 012A","E01029160","Total",976,960,16
"2011","South Somerset 012B","E01029248","Total",662,641,21
"2011","South Somerset 012C","E01029250","Total",566,549,17
"2011","South Somerset 012D","E01029251","Total",569,556,13
"2011","South Somerset 013A","E01029161","Total",672,660,12
"2011","South Somerset 013B","E01029162","Total",770,754,16
"2011","South Somerset 013C","E01029247","Total",641,626,15
"2011","South Somerset 013D","E01029255","Total",620,600,20
"2011","South Somerset 014A","E01029231","Total",702,676,26
"2011","South Somerset 014B","E01029233","Total",589,571,18
"2011","South Somerset 014C","E01029235","Total",650,625,25
"2011","South Somerset 014D","E01029236","Total",640,613,27
"2011","South Somerset 014E","E01029237","Total",682,664,18
"2011","South Somerset 015A","E01029232","Total",676,620,56
"2011","South Somerset 015B","E01029234","Total",1161,995,166
"2011","South Somerset 015C","E01029239","Total",767,700,67
"2011","South Somerset 015D","E01029240","Total",651,624,27
"2011","South Somerset 016A","E01029241","Total",855,813,42
"2011","South Somerset 016B","E01029245","Total",947,925,22
"2011","South Somerset 016C","E01029246","Total",643,612,31
"2011","South Somerset 016D","E01029249","Total",650,635,15
"2011","South Somerset 017A","E01029189","Total",491,481,10
"2011","South Somerset 017B","E01029190","Total",658,584,74
"2011","South Somerset 017C","E01029191","Total",568,548,20
"2011","South Somerset 017D","E01029192","Total",656,621,35
"2011","South Somerset 017E","E01029212","Total",522,479,43
"2011","South Somerset 017F","E01029213","Total",592,552,40
"2011","South Somerset 017G","E01029214","Total",516,483,33
"2011","South Somerset 017H","E01029215","Total",532,506,26
"2011","South Somerset 018A","E01029159","Total",660,634,26
"2011","South Somerset 018B","E01029242","Total",648,631,17
"2011","South Somerset 018C","E01029243","Total",816,775,41
"2011","South Somerset 018D","E01029244","Total",627,619,8
"2011","South Somerset 019A","E01029193","Total",955,911,44
"2011","South Somerset 019B","E01029194","Total",1118,1080,38
"2011","South Somerset 019C","E01029195","Total",731,704,27
"2011","South Somerset 019D","E01029208","Total",522,488,34
"2011","South Somerset 019E","E01029209","Total",600,564,36
"2011","South Somerset 020A","E01029178","Total",700,642,58
"2011","South Somerset 020B","E01029179","Total",517,504,13
"2011","South Somerset 020C","E01029180","Total",606,591,15
"2011","South Somerset 020D","E01029181","Total",653,620,33
"2011","South Somerset 021A","E01029182","Total",647,618,29
"2011","South Somerset 021B","E01029183","Total",614,602,12
"2011","South Somerset 021C","E01029184","Total",871,831,40
"2011","South Somerset 021D","E01029185","Total",906,812,94
"2011","South Somerset 021E","E01029186","Total",764,722,42
"2011","South Somerset 022A","E01029169","Total",645,621,24
"2011","South Somerset 022B","E01029172","Total",650,624,26
"2011","South Somerset 022C","E01029173","Total",539,522,17
"2011","South Somerset 022D","E01029176","Total",576,556,20
"2011","South Somerset 022E","E01029177","Total",548,526,22
"2011","South Somerset 023A","E01029170","Total",528,493,35
"2011","South Somerset 023B","E01029171","Total",1064,995,69
"2011","South Somerset 023C","E01029174","Total",512,501,11
"2011","South Somerset 023D","E01029175","Total",1004,944,60
"2011","South Somerset 024A","E01029153","Total",1137,1067,70
"2011","South Somerset 024B","E01029219","Total",621,583,38
"2011","South Somerset 024C","E01029220","Total",549,525,24
"2011","South Somerset 024D","E01029230","Total",1093,983,110
"2011","Taunton Deane 001A","E01029258","Total",621,605,16
"2011","Taunton Deane 001B","E01029259","Total",625,610,15
"2011","Taunton Deane 001C","E01029260","Total",889,863,26
"2011","Taunton Deane 001D","E01029268","Total",700,658,42
"2011","Taunton Deane 002A","E01029276","Total",604,584,20
"2011","Taunton Deane 002B","E01029278","Total",602,540,62
"2011","Taunton Deane 002C","E01029290","Total",647,632,15
"2011","Taunton Deane 002D","E01029306","Total",637,617,20
"2011","Taunton Deane 002E","E01029319","Total",590,582,8
"2011","Taunton Deane 003A","E01029267","Total",781,744,37
"2011","Taunton Deane 003B","E01029320","Total",756,704,52
"2011","Taunton Deane 003C","E01029321","Total",1047,972,75
"2011","Taunton Deane 004A","E01029297","Total",630,606,24
"2011","Taunton Deane 004B","E01029298","Total",627,610,17
"2011","Taunton Deane 004C","E01029304","Total",675,658,17
"2011","Taunton Deane 004D","E01029305","Total",613,599,14
"2011","Taunton Deane 004E","E01029307","Total",639,610,29
"2011","Taunton Deane 005A","E01029271","Total",839,769,70
"2011","Taunton Deane 005B","E01029273","Total",504,497,7
"2011","Taunton Deane 005C","E01029274","Total",693,647,46
"2011","Taunton Deane 005D","E01029275","Total",585,565,20
"2011","Taunton Deane 005E","E01029279","Total",632,601,31
"2011","Taunton Deane 006A","E01029282","Total",655,639,16
"2011","Taunton Deane 006B","E01029291","Total",790,763,27
"2011","Taunton Deane 006C","E01029294","Total",732,716,16
"2011","Taunton Deane 006D","E01029317","Total",537,523,14
"2011","Taunton Deane 006E","E01029318","Total",643,623,20
"2011","Taunton Deane 007A","E01029285","Total",1148,1066,82
"2011","Taunton Deane 007B","E01029287","Total",719,678,41
"2011","Taunton Deane 007C","E01029288","Total",688,655,33
"2011","Taunton Deane 007D","E01029289","Total",952,897,55
"2011","Taunton Deane 007E","E01029299","Total",778,718,60
"2011","Taunton Deane 007F","E01029300","Total",689,666,23
"2011","Taunton Deane 008A","E01029256","Total",648,625,23
"2011","Taunton Deane 008B","E01029257","Total",894,867,27
"2011","Taunton Deane 008D","E01029277","Total",486,473,13
"2011","Taunton Deane 008E","E01032651","Total",563,536,27
"2011","Taunton Deane 008F","E01032652","Total",510,490,20
"2011","Taunton Deane 009A","E01029280","Total",704,690,14
"2011","Taunton Deane 009B","E01029281","Total",773,758,15
"2011","Taunton Deane 009C","E01029283","Total",782,769,13
"2011","Taunton Deane 009D","E01029292","Total",673,630,43
"2011","Taunton Deane 009E","E01029293","Total",645,611,34
"2011","Taunton Deane 010A","E01029266","Total",613,586,27
"2011","Taunton Deane 010B","E01029284","Total",1075,881,194
"2011","Taunton Deane 010C","E01029286","Total",751,710,41
"2011","Taunton Deane 010D","E01029301","Total",1140,1016,124
"2011","Taunton Deane 010E","E01029303","Total",875,836,39
"2011","Taunton Deane 011A","E01029263","Total",609,593,16
"2011","Taunton Deane 011B","E01029264","Total",599,575,24
"2011","Taunton Deane 011C","E01029265","Total",617,611,6
"2011","Taunton Deane 011D","E01029302","Total",749,716,33
"2011","Taunton Deane 011E","E01029308","Total",886,860,26
"2011","Taunton Deane 012A","E01029309","Total",985,899,86
"2011","Taunton Deane 012B","E01029311","Total",653,593,60
"2011","Taunton Deane 012C","E01029312","Total",619,600,19
"2011","Taunton Deane 012D","E01029313","Total",586,560,26
"2011","Taunton Deane 012E","E01029316","Total",843,789,54
"2011","Taunton Deane 013A","E01029262","Total",1004,971,33
"2011","Taunton Deane 013B","E01029269","Total",907,859,48
"2011","Taunton Deane 013C","E01029310","Total",812,785,27
"2011","Taunton Deane 013D","E01029314","Total",1122,1059,63
"2011","Taunton Deane 013E","E01029315","Total",667,648,19
"2011","Taunton Deane 014A","E01029261","Total",924,846,78
"2011","Taunton Deane 014B","E01029270","Total",977,921,56
"2011","Taunton Deane 014C","E01029295","Total",711,699,12
"2011","Taunton Deane 014D","E01029296","Total",652,628,24
"2011","West Somerset 001B","E01029324","Total",719,687,32
"2011","West Somerset 001C","E01029329","Total",847,735,112
"2011","West Somerset 001D","E01029330","Total",1149,993,156
"2011","West Somerset 001F","E01032636","Total",1018,925,93
"2011","West Somerset 002A","E01029322","Total",660,625,35
"2011","West Somerset 002B","E01029331","Total",779,722,57
"2011","West Somerset 002C","E01029333","Total",592,557,35
"2011","West Somerset 002D","E01029336","Total",1198,983,215
"2011","West Somerset 003A","E01029326","Total",607,539,68
"2011","West Somerset 003B","E01029334","Total",597,530,67
"2011","West Somerset 003C","E01029339","Total",703,671,32
"2011","West Somerset 003E","E01029341","Total",721,619,102
"2011","West Somerset 003G","E01032635","Total",921,895,26
"2011","West Somerset 004A","E01029327","Total",957,875,82
"2011","West Somerset 004B","E01029335","Total",576,497,79
"2011","West Somerset 004C","E01029337","Total",1007,931,76
"2011","West Somerset 004D","E01029342","Total",573,530,43
"2011","West Somerset 004E","E01029343","Total",758,686,72
"2011","West Somerset 005A","E01029325","Total",1148,887,261
"2011","West Somerset 005B","E01029328","Total",1116,971,145
"2011","West Somerset 005C","E01029338","Total",948,765,183
"2011","Isle of Anglesey 001A","W01000003","Total",1235,1131,104
"2011","Isle of Anglesey 001B","W01000004","Total",604,555,49
"2011","Isle of Anglesey 001C","W01000018","Total",752,646,106
"2011","Isle of Anglesey 001D","W01000028","Total",866,802,64
"2011","Isle of Anglesey 001E","W01000031","Total",738,659,79
"2011","Isle of Anglesey 002A","W01000010","Total",1009,899,110
"2011","Isle of Anglesey 002B","W01000020","Total",629,558,71
"2011","Isle of Anglesey 002C","W01000021","Total",1075,968,107
"2011","Isle of Anglesey 002D","W01000032","Total",662,491,171
"2011","Isle of Anglesey 003A","W01000016","Total",645,579,66
"2011","Isle of Anglesey 003B","W01000017","Total",664,642,22
"2011","Isle of Anglesey 003C","W01000029","Total",731,718,13
"2011","Isle of Anglesey 003D","W01000030","Total",1051,997,54
"2011","Isle of Anglesey 003E","W01000033","Total",714,697,17
"2011","Isle of Anglesey 003F","W01000036","Total",546,522,24
"2011","Isle of Anglesey 003G","W01000037","Total",546,518,28
"2011","Isle of Anglesey 004A","W01000022","Total",802,689,113
"2011","Isle of Anglesey 004B","W01000034","Total",542,520,22
"2011","Isle of Anglesey 004C","W01000039","Total",706,472,234
"2011","Isle of Anglesey 004D","W01000040","Total",770,537,233
"2011","Isle of Anglesey 004E","W01000043","Total",555,528,27
"2011","Isle of Anglesey 004F","W01000044","Total",519,495,24
"2011","Isle of Anglesey 005A","W01000005","Total",1132,980,152
"2011","Isle of Anglesey 005B","W01000013","Total",1047,942,105
"2011","Isle of Anglesey 005C","W01000019","Total",843,691,152
"2011","Isle of Anglesey 005D","W01000026","Total",690,580,110
"2011","Isle of Anglesey 005E","W01000035","Total",916,804,112
"2011","Isle of Anglesey 006A","W01000006","Total",696,654,42
"2011","Isle of Anglesey 006B","W01000012","Total",721,665,56
"2011","Isle of Anglesey 006C","W01000014","Total",930,891,39
"2011","Isle of Anglesey 006D","W01000041","Total",653,637,16
"2011","Isle of Anglesey 007A","W01000001","Total",873,559,314
"2011","Isle of Anglesey 007B","W01000002","Total",698,559,139
"2011","Isle of Anglesey 007C","W01000009","Total",825,778,47
"2011","Isle of Anglesey 007D","W01000023","Total",626,599,27
"2011","Isle of Anglesey 007E","W01000024","Total",545,508,37
"2011","Isle of Anglesey 008A","W01000008","Total",646,617,29
"2011","Isle of Anglesey 008B","W01000011","Total",656,609,47
"2011","Isle of Anglesey 008C","W01000015","Total",682,653,29
"2011","Isle of Anglesey 008D","W01000042","Total",946,910,36
"2011","Isle of Anglesey 009A","W01000007","Total",807,717,90
"2011","Isle of Anglesey 009B","W01000025","Total",916,859,57
"2011","Isle of Anglesey 009C","W01000027","Total",844,773,71
"2011","Isle of Anglesey 009D","W01000038","Total",1130,986,144
"2011","Gwynedd 001A","W01000062","Total",608,553,55
"2011","Gwynedd 001B","W01000076","Total",462,439,23
"2011","Gwynedd 001C","W01000077","Total",613,586,27
"2011","Gwynedd 001D","W01000091","Total",524,510,14
"2011","Gwynedd 001E","W01000092","Total",741,697,44
"2011","Gwynedd 002A","W01000064","Total",712,693,19
"2011","Gwynedd 002B","W01000072","Total",717,700,17
"2011","Gwynedd 002C","W01000075","Total",647,622,25
"2011","Gwynedd 002D","W01000090","Total",534,519,15
"2011","Gwynedd 002E","W01000102","Total",493,477,16
"2011","Gwynedd 003A","W01000050","Total",617,580,37
"2011","Gwynedd 003B","W01000071","Total",1088,1016,72
"2011","Gwynedd 003C","W01000096","Total",531,513,18
"2011","Gwynedd 003D","W01000097","Total",569,529,40
"2011","Gwynedd 003E","W01000115","Total",959,908,51
"2011","Gwynedd 004A","W01000052","Total",476,461,15
"2011","Gwynedd 004B","W01000053","Total",542,497,45
"2011","Gwynedd 004C","W01000087","Total",789,756,33
"2011","Gwynedd 004D","W01000119","Total",1177,1006,171
"2011","Gwynedd 005A","W01000063","Total",865,802,63
"2011","Gwynedd 005B","W01000081","Total",980,896,84
"2011","Gwynedd 005C","W01000099","Total",783,724,59
"2011","Gwynedd 005D","W01000103","Total",584,527,57
"2011","Gwynedd 006A","W01000059","Total",984,954,30
"2011","Gwynedd 006B","W01000093","Total",1118,1037,81
"2011","Gwynedd 006C","W01000098","Total",953,925,28
"2011","Gwynedd 006D","W01000110","Total",605,592,13
"2011","Gwynedd 007A","W01000054","Total",489,472,17
"2011","Gwynedd 007B","W01000088","Total",894,817,77
"2011","Gwynedd 007C","W01000111","Total",847,763,84
"2011","Gwynedd 007D","W01000118","Total",810,715,95
"2011","Gwynedd 008A","W01000073","Total",805,729,76
"2011","Gwynedd 008B","W01000086","Total",1148,952,196
"2011","Gwynedd 008C","W01000104","Total",870,793,77
"2011","Gwynedd 008D","W01000112","Total",985,861,124
"2011","Gwynedd 009A","W01000056","Total",1002,869,133
"2011","Gwynedd 009B","W01000065","Total",653,584,69
"2011","Gwynedd 009C","W01000113","Total",969,830,139
"2011","Gwynedd 009D","W01000114","Total",876,714,162
"2011","Gwynedd 010A","W01000066","Total",614,513,101
"2011","Gwynedd 010B","W01000100","Total",537,466,71
"2011","Gwynedd 010C","W01000105","Total",829,779,50
"2011","Gwynedd 010D","W01000106","Total",1302,872,430
"2011","Gwynedd 010E","W01000107","Total",799,588,211
"2011","Gwynedd 011A","W01000047","Total",632,586,46
"2011","Gwynedd 011B","W01000061","Total",995,801,194
"2011","Gwynedd 011C","W01000078","Total",886,722,164
"2011","Gwynedd 011D","W01000089","Total",972,849,123
"2011","Gwynedd 012A","W01000070","Total",640,543,97
"2011","Gwynedd 012B","W01000094","Total",800,574,226
"2011","Gwynedd 012C","W01000095","Total",750,618,132
"2011","Gwynedd 012D","W01000108","Total",1154,1048,106
"2011","Gwynedd 012E","W01000109","Total",966,871,95
"2011","Gwynedd 013A","W01000069","Total",878,751,127
"2011","Gwynedd 013B","W01000074","Total",1241,946,295
"2011","Gwynedd 013C","W01000079","Total",684,528,156
"2011","Gwynedd 013D","W01000101","Total",711,656,55
"2011","Gwynedd 014C","W01000080","Total",1587,915,672
"2011","Gwynedd 014D","W01000084","Total",851,556,295
"2011","Gwynedd 014E","W01001932","Total",1584,1227,357
"2011","Gwynedd 015A","W01000051","Total",1001,936,65
"2011","Gwynedd 015B","W01000060","Total",800,624,176
"2011","Gwynedd 015C","W01000082","Total",507,436,71
"2011","Gwynedd 015D","W01000083","Total",678,560,118
"2011","Gwynedd 016A","W01000048","Total",733,625,108
"2011","Gwynedd 016B","W01000049","Total",759,620,139
"2011","Gwynedd 016C","W01000057","Total",786,635,151
"2011","Gwynedd 016D","W01000067","Total",714,592,122
"2011","Gwynedd 016E","W01000068","Total",762,688,74
"2011","Gwynedd 017C","W01000085","Total",1293,978,315
"2011","Gwynedd 017D","W01000116","Total",1053,864,189
"2011","Gwynedd 017E","W01000117","Total",829,737,92
"2011","Gwynedd 017F","W01001933","Total",1729,1151,578
"2011","Conwy 001A","W01000132","Total",900,708,192
"2011","Conwy 001B","W01000146","Total",1201,1016,185
"2011","Conwy 001C","W01000147","Total",866,760,106
"2011","Conwy 001D","W01000169","Total",1082,916,166
"2011","Conwy 001E","W01000186","Total",897,828,69
"2011","Conwy 002A","W01000133","Total",952,873,79
"2011","Conwy 002B","W01000168","Total",815,757,58
"2011","Conwy 002C","W01000187","Total",639,633,6
"2011","Conwy 002D","W01000188","Total",801,780,21
"2011","Conwy 003A","W01000154","Total",635,610,25
"2011","Conwy 003B","W01000173","Total",708,652,56
"2011","Conwy 003C","W01000174","Total",791,745,46
"2011","Conwy 003D","W01000175","Total",837,799,38
"2011","Conwy 004A","W01000155","Total",743,673,70
"2011","Conwy 004B","W01000156","Total",943,819,124
"2011","Conwy 004C","W01000157","Total",777,731,46
"2011","Conwy 004D","W01000158","Total",814,779,35
"2011","Conwy 005A","W01000149","Total",729,677,52
"2011","Conwy 005B","W01000150","Total",653,632,21
"2011","Conwy 005C","W01000151","Total",636,621,15
"2011","Conwy 005D","W01000152","Total",645,614,31
"2011","Conwy 005E","W01000184","Total",1132,1062,70
"2011","Conwy 006A","W01000135","Total",1120,1009,111
"2011","Conwy 006B","W01000136","Total",981,852,129
"2011","Conwy 006C","W01000165","Total",918,865,53
"2011","Conwy 006D","W01000166","Total",898,813,85
"2011","Conwy 007A","W01000139","Total",705,691,14
"2011","Conwy 007B","W01000143","Total",682,649,33
"2011","Conwy 007C","W01000144","Total",850,712,138
"2011","Conwy 007D","W01000182","Total",1111,950,161
"2011","Conwy 008A","W01000138","Total",912,886,26
"2011","Conwy 008B","W01000145","Total",604,578,26
"2011","Conwy 008C","W01000180","Total",618,599,19
"2011","Conwy 008D","W01000181","Total",618,610,8
"2011","Conwy 008E","W01000183","Total",633,585,48
"2011","Conwy 009A","W01000126","Total",785,743,42
"2011","Conwy 009B","W01000127","Total",602,578,24
"2011","Conwy 009C","W01000128","Total",695,677,18
"2011","Conwy 009D","W01000153","Total",855,713,142
"2011","Conwy 009E","W01000163","Total",525,503,22
"2011","Conwy 009F","W01000164","Total",576,549,27
"2011","Conwy 010B","W01000140","Total",695,651,44
"2011","Conwy 010C","W01000141","Total",856,802,54
"2011","Conwy 010D","W01000142","Total",747,715,32
"2011","Conwy 010E","W01000178","Total",877,839,38
"2011","Conwy 010F","W01000179","Total",815,775,40
"2011","Conwy 010G","W01001927","Total",627,582,45
"2011","Conwy 010H","W01001928","Total",717,622,95
"2011","Conwy 011C","W01000167","Total",858,815,43
"2011","Conwy 011D","W01000176","Total",768,718,50
"2011","Conwy 011E","W01000177","Total",516,489,27
"2011","Conwy 011F","W01001926","Total",1077,1001,76
"2011","Conwy 012A","W01000124","Total",1042,887,155
"2011","Conwy 012B","W01000129","Total",610,497,113
"2011","Conwy 012C","W01000130","Total",901,767,134
"2011","Conwy 012D","W01000131","Total",640,604,36
"2011","Conwy 013A","W01000123","Total",822,744,78
"2011","Conwy 013B","W01000125","Total",861,690,171
"2011","Conwy 013C","W01000170","Total",861,783,78
"2011","Conwy 013D","W01000171","Total",760,690,70
"2011","Conwy 013E","W01000172","Total",648,595,53
"2011","Conwy 014A","W01000122","Total",944,882,62
"2011","Conwy 014B","W01000159","Total",628,564,64
"2011","Conwy 014C","W01000162","Total",808,762,46
"2011","Conwy 014D","W01000190","Total",672,599,73
"2011","Conwy 015A","W01000121","Total",709,548,161
"2011","Conwy 015B","W01000134","Total",1083,988,95
"2011","Conwy 015C","W01000137","Total",707,630,77
"2011","Conwy 015D","W01000148","Total",509,484,25
"2011","Conwy 015E","W01000185","Total",641,563,78
"2011","Conwy 015F","W01000189","Total",916,644,272
"2011","Denbighshire 001A","W01000218","Total",717,686,31
"2011","Denbighshire 001B","W01000219","Total",1102,1058,44
"2011","Denbighshire 001C","W01000220","Total",936,878,58
"2011","Denbighshire 002A","W01000213","Total",611,588,23
"2011","Denbighshire 002B","W01000214","Total",489,475,14
"2011","Denbighshire 002C","W01000215","Total",600,582,18
"2011","Denbighshire 002D","W01000216","Total",594,572,22
"2011","Denbighshire 003A","W01000212","Total",946,919,27
"2011","Denbighshire 003B","W01000221","Total",709,672,37
"2011","Denbighshire 003C","W01000222","Total",821,800,21
"2011","Denbighshire 004A","W01000226","Total",756,709,47
"2011","Denbighshire 004B","W01000227","Total",760,732,28
"2011","Denbighshire 004C","W01000228","Total",587,534,53
"2011","Denbighshire 004D","W01000239","Total",991,897,94
"2011","Denbighshire 004E","W01000240","Total",797,720,77
"2011","Denbighshire 004F","W01000241","Total",523,492,31
"2011","Denbighshire 006A","W01000236","Total",810,774,36
"2011","Denbighshire 006B","W01000237","Total",655,639,16
"2011","Denbighshire 006C","W01000238","Total",668,645,23
"2011","Denbighshire 008A","W01000200","Total",545,524,21
"2011","Denbighshire 008B","W01000201","Total",688,660,28
"2011","Denbighshire 008C","W01000217","Total",897,862,35
"2011","Denbighshire 008D","W01000248","Total",704,663,41
"2011","Denbighshire 009A","W01000191","Total",890,881,9
"2011","Denbighshire 009B","W01000223","Total",592,580,12
"2011","Denbighshire 009C","W01000224","Total",632,610,22
"2011","Denbighshire 009D","W01000225","Total",744,718,26
"2011","Denbighshire 010A","W01000245","Total",790,737,53
"2011","Denbighshire 010B","W01000246","Total",727,711,16
"2011","Denbighshire 010C","W01000247","Total",841,815,26
"2011","Denbighshire 011A","W01000194","Total",1034,951,83
"2011","Denbighshire 011B","W01000198","Total",650,639,11
"2011","Denbighshire 011C","W01000199","Total",744,715,29
"2011","Denbighshire 012A","W01000195","Total",641,622,19
"2011","Denbighshire 012B","W01000196","Total",574,563,11
"2011","Denbighshire 012C","W01000197","Total",718,697,21
"2011","Denbighshire 012D","W01000211","Total",795,749,46
"2011","Denbighshire 013A","W01000203","Total",1071,986,85
"2011","Denbighshire 013B","W01000204","Total",681,622,59
"2011","Denbighshire 013C","W01000206","Total",899,852,47
"2011","Denbighshire 014A","W01000242","Total",945,881,64
"2011","Denbighshire 014B","W01000243","Total",872,792,80
"2011","Denbighshire 014C","W01000244","Total",760,733,27
"2011","Denbighshire 015A","W01000193","Total",618,572,46
"2011","Denbighshire 015B","W01000202","Total",705,654,51
"2011","Denbighshire 015C","W01000207","Total",1014,946,68
"2011","Denbighshire 016A","W01000192","Total",508,451,57
"2011","Denbighshire 016B","W01000205","Total",561,489,72
"2011","Denbighshire 016C","W01000208","Total",667,561,106
"2011","Denbighshire 016D","W01000209","Total",707,678,29
"2011","Denbighshire 016E","W01000210","Total",660,607,53
"2011","Denbighshire 017E","W01000229","Total",793,772,21
"2011","Denbighshire 017F","W01000230","Total",916,888,28
"2011","Denbighshire 017A","W01000231","Total",635,615,20
"2011","Denbighshire 017B","W01000232","Total",699,680,19
"2011","Denbighshire 017C","W01000233","Total",594,568,26
"2011","Denbighshire 017G","W01000234","Total",582,567,15
"2011","Denbighshire 017D","W01000235","Total",572,563,9
"2011","Flintshire 001A","W01000287","Total",909,828,81
"2011","Flintshire 001B","W01000298","Total",709,675,34
"2011","Flintshire 001C","W01000338","Total",840,788,52
"2011","Flintshire 002A","W01000306","Total",1009,972,37
"2011","Flintshire 002B","W01000320","Total",809,762,47
"2011","Flintshire 002C","W01000340","Total",1002,957,45
"2011","Flintshire 003A","W01000253","Total",801,784,17
"2011","Flintshire 003B","W01000254","Total",966,920,46
"2011","Flintshire 003C","W01000296","Total",666,638,28
"2011","Flintshire 003D","W01000297","Total",514,500,14
"2011","Flintshire 003E","W01000304","Total",959,896,63
"2011","Flintshire 003F","W01000305","Total",782,753,29
"2011","Flintshire 004A","W01000288","Total",1040,1027,13
"2011","Flintshire 004B","W01000290","Total",651,633,18
"2011","Flintshire 004C","W01000292","Total",552,546,6
"2011","Flintshire 004D","W01000293","Total",673,656,17
"2011","Flintshire 005A","W01000289","Total",496,493,3
"2011","Flintshire 005B","W01000291","Total",576,573,3
"2011","Flintshire 005C","W01000294","Total",718,709,9
"2011","Flintshire 005D","W01000295","Total",635,625,10
"2011","Flintshire 006A","W01000258","Total",936,918,18
"2011","Flintshire 006B","W01000270","Total",547,521,26
"2011","Flintshire 006C","W01000271","Total",594,569,25
"2011","Flintshire 006D","W01000272","Total",812,767,45
"2011","Flintshire 006E","W01000301","Total",773,731,42
"2011","Flintshire 007A","W01000273","Total",658,645,13
"2011","Flintshire 007B","W01000274","Total",847,837,10
"2011","Flintshire 007C","W01000275","Total",507,496,11
"2011","Flintshire 007D","W01000278","Total",624,618,6
"2011","Flintshire 008A","W01000276","Total",518,517,1
"2011","Flintshire 008B","W01000277","Total",528,522,6
"2011","Flintshire 008C","W01000279","Total",523,515,8
"2011","Flintshire 008D","W01000281","Total",519,515,4
"2011","Flintshire 008E","W01000283","Total",955,931,24
"2011","Flintshire 009A","W01000332","Total",664,645,19
"2011","Flintshire 009B","W01000333","Total",622,614,8
"2011","Flintshire 009C","W01000334","Total",904,871,33
"2011","Flintshire 009D","W01000335","Total",514,491,23
"2011","Flintshire 009E","W01000336","Total",582,575,7
"2011","Flintshire 009F","W01000337","Total",987,954,33
"2011","Flintshire 010A","W01000252","Total",743,723,20
"2011","Flintshire 010B","W01000280","Total",569,566,3
"2011","Flintshire 010C","W01000282","Total",563,561,2
"2011","Flintshire 010D","W01000325","Total",662,644,18
"2011","Flintshire 011A","W01000311","Total",770,748,22
"2011","Flintshire 011B","W01000312","Total",798,775,23
"2011","Flintshire 011C","W01000328","Total",973,930,43
"2011","Flintshire 012A","W01000264","Total",670,655,15
"2011","Flintshire 012B","W01000265","Total",618,596,22
"2011","Flintshire 012C","W01000323","Total",684,665,19
"2011","Flintshire 012D","W01000324","Total",624,608,16
"2011","Flintshire 013A","W01000251","Total",612,597,15
"2011","Flintshire 013B","W01000268","Total",696,681,15
"2011","Flintshire 013C","W01000284","Total",720,668,52
"2011","Flintshire 013D","W01000285","Total",632,608,24
"2011","Flintshire 013E","W01000286","Total",905,882,23
"2011","Flintshire 013F","W01000302","Total",866,830,36
"2011","Flintshire 014A","W01000249","Total",516,510,6
"2011","Flintshire 014B","W01000250","Total",666,647,19
"2011","Flintshire 014C","W01000261","Total",664,644,20
"2011","Flintshire 014D","W01000321","Total",697,685,12
"2011","Flintshire 014E","W01000322","Total",578,563,15
"2011","Flintshire 015A","W01000255","Total",984,955,29
"2011","Flintshire 015B","W01000256","Total",667,660,7
"2011","Flintshire 015C","W01000257","Total",916,900,16
"2011","Flintshire 015D","W01000329","Total",642,605,37
"2011","Flintshire 015E","W01000330","Total",937,913,24
"2011","Flintshire 015F","W01000331","Total",650,635,15
"2011","Flintshire 016A","W01000313","Total",661,650,11
"2011","Flintshire 016B","W01000314","Total",603,562,41
"2011","Flintshire 016C","W01000315","Total",941,898,43
"2011","Flintshire 016D","W01000316","Total",529,516,13
"2011","Flintshire 016E","W01000317","Total",517,508,9
"2011","Flintshire 016F","W01000318","Total",468,453,15
"2011","Flintshire 016G","W01000319","Total",747,726,21
"2011","Flintshire 017A","W01000259","Total",781,751,30
"2011","Flintshire 017B","W01000260","Total",782,763,19
"2011","Flintshire 017C","W01000262","Total",669,652,17
"2011","Flintshire 017D","W01000263","Total",654,639,15
"2011","Flintshire 017E","W01000266","Total",629,599,30
"2011","Flintshire 017F","W01000267","Total",710,694,16
"2011","Flintshire 018A","W01000303","Total",676,660,16
"2011","Flintshire 018B","W01000326","Total",703,686,17
"2011","Flintshire 018C","W01000327","Total",900,878,22
"2011","Flintshire 019A","W01000299","Total",865,842,23
"2011","Flintshire 019B","W01000300","Total",789,743,46
"2011","Flintshire 019C","W01000309","Total",949,906,43
"2011","Flintshire 019D","W01000339","Total",704,678,26
"2011","Flintshire 020A","W01000269","Total",771,735,36
"2011","Flintshire 020B","W01000307","Total",535,524,11
"2011","Flintshire 020C","W01000308","Total",523,510,13
"2011","Flintshire 020D","W01000310","Total",789,767,22
"2011","Wrexham 003A","W01000374","Total",619,604,15
"2011","Wrexham 003B","W01000375","Total",852,822,30
"2011","Wrexham 003C","W01000376","Total",564,555,9
"2011","Wrexham 003D","W01000391","Total",615,610,5
"2011","Wrexham 003E","W01000392","Total",710,696,14
"2011","Wrexham 004A","W01000377","Total",618,602,16
"2011","Wrexham 004B","W01000378","Total",544,532,12
"2011","Wrexham 004C","W01000379","Total",722,708,14
"2011","Wrexham 004D","W01000380","Total",498,489,9
"2011","Wrexham 005A","W01000351","Total",910,882,28
"2011","Wrexham 005B","W01000373","Total",772,753,19
"2011","Wrexham 005C","W01000400","Total",763,742,21
"2011","Wrexham 005D","W01000401","Total",818,794,24
"2011","Wrexham 006A","W01000347","Total",1066,1047,19
"2011","Wrexham 006B","W01000348","Total",645,622,23
"2011","Wrexham 006C","W01000362","Total",637,622,15
"2011","Wrexham 006D","W01000363","Total",710,689,21
"2011","Wrexham 006E","W01000364","Total",706,688,18
"2011","Wrexham 007A","W01000343","Total",477,463,14
"2011","Wrexham 007B","W01000344","Total",600,586,14
"2011","Wrexham 007C","W01000415","Total",702,683,19
"2011","Wrexham 007D","W01000416","Total",515,508,7
"2011","Wrexham 008A","W01000368","Total",951,918,33
"2011","Wrexham 008B","W01000371","Total",544,527,17
"2011","Wrexham 008C","W01000372","Total",645,598,47
"2011","Wrexham 008D","W01000387","Total",518,508,10
"2011","Wrexham 008E","W01000388","Total",487,470,17
"2011","Wrexham 008F","W01000422","Total",982,944,38
"2011","Wrexham 009A","W01000341","Total",703,684,19
"2011","Wrexham 009B","W01000342","Total",744,727,17
"2011","Wrexham 009C","W01000393","Total",866,828,38
"2011","Wrexham 010A","W01000352","Total",422,408,14
"2011","Wrexham 010B","W01000353","Total",567,552,15
"2011","Wrexham 010C","W01000413","Total",574,553,21
"2011","Wrexham 010D","W01000414","Total",530,515,15
"2011","Wrexham 010E","W01000425","Total",926,910,16
"2011","Wrexham 011A","W01000349","Total",871,840,31
"2011","Wrexham 011B","W01000350","Total",768,716,52
"2011","Wrexham 011C","W01000365","Total",846,822,24
"2011","Wrexham 011D","W01000402","Total",1197,1137,60
"2011","Wrexham 012A","W01000381","Total",550,534,16
"2011","Wrexham 012B","W01000382","Total",558,545,13
"2011","Wrexham 012D","W01000423","Total",909,886,23
"2011","Wrexham 012E","W01000424","Total",565,556,9
"2011","Wrexham 012F","W01001929","Total",638,621,17
"2011","Wrexham 012G","W01001931","Total",665,639,26
"2011","Wrexham 013A","W01000398","Total",583,571,12
"2011","Wrexham 013B","W01000399","Total",485,465,20
"2011","Wrexham 013C","W01000406","Total",906,880,26
"2011","Wrexham 013D","W01000408","Total",531,506,25
"2011","Wrexham 014A","W01000366","Total",636,619,17
"2011","Wrexham 014B","W01000367","Total",555,543,12
"2011","Wrexham 014C","W01000385","Total",760,750,10
"2011","Wrexham 014D","W01000410","Total",759,724,35
"2011","Wrexham 015A","W01000386","Total",682,661,21
"2011","Wrexham 015B","W01000405","Total",946,919,27
"2011","Wrexham 015C","W01000411","Total",834,796,38
"2011","Wrexham 015D","W01000412","Total",738,703,35
"2011","Wrexham 016A","W01000394","Total",537,506,31
"2011","Wrexham 016B","W01000395","Total",489,475,14
"2011","Wrexham 016C","W01000407","Total",626,596,30
"2011","Wrexham 016D","W01000419","Total",642,619,23
"2011","Wrexham 016E","W01000420","Total",658,630,28
"2011","Wrexham 017A","W01000354","Total",737,719,18
"2011","Wrexham 017B","W01000355","Total",809,770,39
"2011","Wrexham 017C","W01000356","Total",660,645,15
"2011","Wrexham 017D","W01000389","Total",920,869,51
"2011","Wrexham 017E","W01000409","Total",834,815,19
"2011","Wrexham 018A","W01000345","Total",711,684,27
"2011","Wrexham 018B","W01000346","Total",649,632,17
"2011","Wrexham 018C","W01000403","Total",575,555,20
"2011","Wrexham 018D","W01000404","Total",871,826,45
"2011","Wrexham 019C","W01000359","Total",532,507,25
"2011","Wrexham 019D","W01000360","Total",542,532,10
"2011","Wrexham 019E","W01000361","Total",919,893,26
"2011","Wrexham 019F","W01001930","Total",1017,907,110
"2011","Wrexham 020F","W01000369","Total",613,594,19
"2011","Wrexham 020G","W01000370","Total",658,630,28
"2011","Wrexham 020A","W01000383","Total",955,922,33
"2011","Wrexham 020B","W01000384","Total",502,485,17
"2011","Wrexham 020C","W01000390","Total",691,670,21
"2011","Wrexham 020H","W01000396","Total",509,500,9
"2011","Wrexham 020I","W01000397","Total",418,412,6
"2011","Wrexham 020D","W01000417","Total",716,640,76
"2011","Wrexham 020E","W01000418","Total",750,724,26
"2011","Powys 001A","W01000461","Total",734,675,59
"2011","Powys 001D","W01000470","Total",889,828,61
"2011","Powys 001E","W01000475","Total",1092,975,117
"2011","Powys 001F","W01001906","Total",993,843,150
"2011","Powys 001G","W01001907","Total",630,572,58
"2011","Powys 002A","W01000444","Total",1050,1005,45
"2011","Powys 002B","W01000457","Total",910,867,43
"2011","Powys 002C","W01000458","Total",829,769,60
"2011","Powys 003A","W01000498","Total",765,734,31
"2011","Powys 003B","W01000499","Total",587,555,32
"2011","Powys 003C","W01000500","Total",679,655,24
"2011","Powys 003D","W01000501","Total",1069,1011,58
"2011","Powys 004A","W01000442","Total",1063,890,173
"2011","Powys 004B","W01000452","Total",948,825,123
"2011","Powys 004C","W01000473","Total",1101,1033,68
"2011","Powys 005A","W01000428","Total",628,593,35
"2011","Powys 005B","W01000441","Total",630,598,32
"2011","Powys 005C","W01000476","Total",650,603,47
"2011","Powys 005D","W01000497","Total",583,556,27
"2011","Powys 006A","W01000433","Total",1108,1032,76
"2011","Powys 006B","W01000460","Total",799,728,71
"2011","Powys 006C","W01000488","Total",962,892,70
"2011","Powys 007A","W01000434","Total",736,695,41
"2011","Powys 007B","W01000439","Total",854,816,38
"2011","Powys 007C","W01000447","Total",892,838,54
"2011","Powys 008A","W01000480","Total",1028,970,58
"2011","Powys 008B","W01000481","Total",1129,1093,36
"2011","Powys 008C","W01000482","Total",864,817,47
"2011","Powys 009A","W01000478","Total",734,719,15
"2011","Powys 009B","W01000479","Total",634,614,20
"2011","Powys 009C","W01000483","Total",819,802,17
"2011","Powys 010A","W01000429","Total",1050,951,99
"2011","Powys 010B","W01000453","Total",631,587,44
"2011","Powys 010C","W01000466","Total",657,621,36
"2011","Powys 010D","W01000467","Total",869,795,74
"2011","Powys 011A","W01000427","Total",686,604,82
"2011","Powys 011B","W01000448","Total",661,639,22
"2011","Powys 011C","W01000449","Total",828,753,75
"2011","Powys 011D","W01000464","Total",585,534,51
"2011","Powys 011E","W01000484","Total",769,678,91
"2011","Powys 011F","W01000485","Total",812,740,72
"2011","Powys 011G","W01000486","Total",535,501,34
"2011","Powys 012A","W01000438","Total",652,608,44
"2011","Powys 012B","W01000451","Total",514,483,31
"2011","Powys 012C","W01000472","Total",536,511,25
"2011","Powys 012D","W01000477","Total",716,621,95
"2011","Powys 012E","W01000487","Total",1105,987,118
"2011","Powys 013A","W01000454","Total",790,671,119
"2011","Powys 013B","W01000455","Total",953,901,52
"2011","Powys 013C","W01000456","Total",1108,1011,97
"2011","Powys 014A","W01000431","Total",640,586,54
"2011","Powys 014B","W01000432","Total",560,532,28
"2011","Powys 014C","W01000450","Total",675,597,78
"2011","Powys 014D","W01000459","Total",608,519,89
"2011","Powys 014E","W01000471","Total",938,838,100
"2011","Powys 015A","W01000430","Total",639,554,85
"2011","Powys 015B","W01000443","Total",1099,1009,90
"2011","Powys 015C","W01000445","Total",705,623,82
"2011","Powys 015D","W01000446","Total",942,828,114
"2011","Powys 015E","W01000494","Total",790,737,53
"2011","Powys 017A","W01000489","Total",780,742,38
"2011","Powys 017D","W01000492","Total",920,823,97
"2011","Powys 017E","W01000493","Total",629,595,34
"2011","Powys 017F","W01001901","Total",914,884,30
"2011","Powys 017G","W01001902","Total",598,591,7
"2011","Powys 018E","W01000465","Total",474,426,48
"2011","Powys 018F","W01001903","Total",1039,937,102
"2011","Powys 018G","W01001904","Total",832,727,105
"2011","Powys 018H","W01001905","Total",995,880,115
"2011","Powys 020A","W01000440","Total",629,546,83
"2011","Powys 020B","W01000474","Total",866,750,116
"2011","Powys 020C","W01000503","Total",501,432,69
"2011","Powys 020D","W01001897","Total",966,837,129
"2011","Powys 021A","W01000426","Total",687,643,44
"2011","Powys 021B","W01000496","Total",985,895,90
"2011","Powys 021C","W01000502","Total",1023,957,66
"2011","Powys 021D","W01000504","Total",587,546,41
"2011","Powys 021E","W01000505","Total",688,646,42
"2011","Powys 021F","W01001899","Total",927,866,61
"2011","Ceredigion 001C","W01000523","Total",898,834,64
"2011","Ceredigion 001D","W01000548","Total",789,764,25
"2011","Ceredigion 001E","W01000549","Total",771,744,27
"2011","Ceredigion 001F","W01001937","Total",1125,949,176
"2011","Ceredigion 002A","W01000512","Total",640,604,36
"2011","Ceredigion 002B","W01000513","Total",1102,1022,80
"2011","Ceredigion 002D","W01000517","Total",626,589,37
"2011","Ceredigion 002F","W01001934","Total",1178,1106,72
"2011","Ceredigion 003A","W01000515","Total",621,608,13
"2011","Ceredigion 003B","W01000516","Total",688,674,14
"2011","Ceredigion 003C","W01000518","Total",658,627,31
"2011","Ceredigion 003E","W01001935","Total",494,469,25
"2011","Ceredigion 003F","W01001936","Total",475,462,13
"2011","Ceredigion 005A","W01000506","Total",846,732,114
"2011","Ceredigion 005B","W01000524","Total",912,831,81
"2011","Ceredigion 005C","W01000538","Total",704,654,50
"2011","Ceredigion 005D","W01000539","Total",546,506,40
"2011","Ceredigion 005E","W01000540","Total",611,534,77
"2011","Ceredigion 007A","W01000529","Total",738,664,74
"2011","Ceredigion 007B","W01000532","Total",989,838,151
"2011","Ceredigion 007C","W01000544","Total",783,517,266
"2011","Ceredigion 007D","W01000545","Total",1123,902,221
"2011","Ceredigion 008A","W01000527","Total",508,461,47
"2011","Ceredigion 008B","W01000528","Total",678,641,37
"2011","Ceredigion 008C","W01000535","Total",965,885,80
"2011","Ceredigion 008D","W01000537","Total",713,664,49
"2011","Ceredigion 008E","W01000541","Total",831,781,50
"2011","Ceredigion 009A","W01000507","Total",610,554,56
"2011","Ceredigion 009B","W01000508","Total",605,538,67
"2011","Ceredigion 009C","W01000509","Total",838,802,36
"2011","Ceredigion 009D","W01000510","Total",701,643,58
"2011","Ceredigion 009E","W01000511","Total",610,560,50
"2011","Ceredigion 009F","W01000546","Total",581,532,49
"2011","Ceredigion 009G","W01000547","Total",613,536,77
"2011","Ceredigion 010A","W01000519","Total",780,720,60
"2011","Ceredigion 010B","W01000522","Total",608,553,55
"2011","Ceredigion 010C","W01000531","Total",844,800,44
"2011","Ceredigion 010D","W01000533","Total",724,660,64
"2011","Ceredigion 010E","W01000551","Total",618,575,43
"2011","Ceredigion 011A","W01000525","Total",529,500,29
"2011","Ceredigion 011B","W01000534","Total",696,655,41
"2011","Ceredigion 011E","W01000536","Total",720,663,57
"2011","Ceredigion 011F","W01000542","Total",1057,937,120
"2011","Ceredigion 011C","W01000543","Total",997,880,117
"2011","Ceredigion 011G","W01000550","Total",640,565,75
"2011","Ceredigion 011D","W01000552","Total",886,827,59
"2011","Pembrokeshire 001A","W01000558","Total",996,887,109
"2011","Pembrokeshire 001B","W01000559","Total",667,611,56
"2011","Pembrokeshire 001C","W01000560","Total",597,521,76
"2011","Pembrokeshire 001D","W01000561","Total",549,502,47
"2011","Pembrokeshire 001E","W01000613","Total",1288,1016,272
"2011","Pembrokeshire 002A","W01000562","Total",946,736,210
"2011","Pembrokeshire 002B","W01000565","Total",1037,891,146
"2011","Pembrokeshire 002C","W01000566","Total",790,736,54
"2011","Pembrokeshire 002D","W01000567","Total",990,901,89
"2011","Pembrokeshire 002E","W01000597","Total",930,583,347
"2011","Pembrokeshire 002F","W01000617","Total",729,615,114
"2011","Pembrokeshire 003A","W01000579","Total",1081,985,96
"2011","Pembrokeshire 003B","W01000581","Total",859,648,211
"2011","Pembrokeshire 003C","W01000612","Total",1164,851,313
"2011","Pembrokeshire 003D","W01000618","Total",860,646,214
"2011","Pembrokeshire 004A","W01000582","Total",775,711,64
"2011","Pembrokeshire 004B","W01000583","Total",628,592,36
"2011","Pembrokeshire 004C","W01000611","Total",759,730,29
"2011","Pembrokeshire 004D","W01000623","Total",812,774,38
"2011","Pembrokeshire 005A","W01000568","Total",1341,1193,148
"2011","Pembrokeshire 005B","W01000569","Total",553,526,27
"2011","Pembrokeshire 005C","W01000570","Total",646,610,36
"2011","Pembrokeshire 005D","W01000572","Total",845,789,56
"2011","Pembrokeshire 006A","W01000571","Total",1095,1013,82
"2011","Pembrokeshire 006B","W01000573","Total",1180,1119,61
"2011","Pembrokeshire 006C","W01000586","Total",908,888,20
"2011","Pembrokeshire 007A","W01000577","Total",707,634,73
"2011","Pembrokeshire 007B","W01000585","Total",622,540,82
"2011","Pembrokeshire 007C","W01000595","Total",957,908,49
"2011","Pembrokeshire 007D","W01000596","Total",667,620,47
"2011","Pembrokeshire 008A","W01000555","Total",632,579,53
"2011","Pembrokeshire 008B","W01000556","Total",640,509,131
"2011","Pembrokeshire 008C","W01000575","Total",1029,985,44
"2011","Pembrokeshire 008D","W01000614","Total",793,612,181
"2011","Pembrokeshire 008E","W01000622","Total",940,637,303
"2011","Pembrokeshire 009A","W01000554","Total",793,752,41
"2011","Pembrokeshire 009B","W01000580","Total",1013,961,52
"2011","Pembrokeshire 009C","W01000598","Total",1087,1023,64
"2011","Pembrokeshire 009D","W01000599","Total",950,897,53
"2011","Pembrokeshire 010A","W01000587","Total",1107,1003,104
"2011","Pembrokeshire 010B","W01000588","Total",962,931,31
"2011","Pembrokeshire 010C","W01000593","Total",1200,1163,37
"2011","Pembrokeshire 011A","W01000553","Total",731,546,185
"2011","Pembrokeshire 011B","W01000563","Total",542,484,58
"2011","Pembrokeshire 011C","W01000564","Total",575,523,52
"2011","Pembrokeshire 011D","W01000576","Total",1026,955,71
"2011","Pembrokeshire 011E","W01000615","Total",818,671,147
"2011","Pembrokeshire 011F","W01000616","Total",862,529,333
"2011","Pembrokeshire 012A","W01000589","Total",546,525,21
"2011","Pembrokeshire 012B","W01000590","Total",592,547,45
"2011","Pembrokeshire 012C","W01000591","Total",503,489,14
"2011","Pembrokeshire 012D","W01000592","Total",510,497,13
"2011","Pembrokeshire 012E","W01000594","Total",1042,989,53
"2011","Pembrokeshire 013A","W01000600","Total",914,786,128
"2011","Pembrokeshire 013B","W01000601","Total",662,642,20
"2011","Pembrokeshire 013C","W01000602","Total",620,581,39
"2011","Pembrokeshire 013D","W01000603","Total",898,827,71
"2011","Pembrokeshire 013E","W01000604","Total",655,624,31
"2011","Pembrokeshire 013F","W01000605","Total",754,711,43
"2011","Pembrokeshire 014A","W01000557","Total",667,612,55
"2011","Pembrokeshire 014B","W01000578","Total",1156,740,416
"2011","Pembrokeshire 014C","W01000584","Total",1025,876,149
"2011","Pembrokeshire 014D","W01000609","Total",1167,1090,77
"2011","Pembrokeshire 015A","W01000574","Total",918,791,127
"2011","Pembrokeshire 015B","W01000606","Total",736,707,29
"2011","Pembrokeshire 015C","W01000607","Total",909,848,61
"2011","Pembrokeshire 015D","W01000608","Total",799,700,99
"2011","Pembrokeshire 016A","W01000610","Total",976,751,225
"2011","Pembrokeshire 016B","W01000619","Total",1187,969,218
"2011","Pembrokeshire 016C","W01000620","Total",916,595,321
"2011","Pembrokeshire 016D","W01000621","Total",882,689,193
"2011","Carmarthenshire 001A","W01000685","Total",713,682,31
"2011","Carmarthenshire 001B","W01000686","Total",579,531,48
"2011","Carmarthenshire 001C","W01000701","Total",749,678,71
"2011","Carmarthenshire 001D","W01000702","Total",555,515,40
"2011","Carmarthenshire 002A","W01000647","Total",726,630,96
"2011","Carmarthenshire 002B","W01000650","Total",778,716,62
"2011","Carmarthenshire 002C","W01000678","Total",677,615,62
"2011","Carmarthenshire 002D","W01000679","Total",615,555,60
"2011","Carmarthenshire 003A","W01000646","Total",1066,960,106
"2011","Carmarthenshire 003B","W01000688","Total",820,772,48
"2011","Carmarthenshire 003C","W01000689","Total",763,707,56
"2011","Carmarthenshire 003D","W01000728","Total",919,835,84
"2011","Carmarthenshire 004A","W01000676","Total",735,684,51
"2011","Carmarthenshire 004B","W01000677","Total",755,702,53
"2011","Carmarthenshire 004C","W01000687","Total",907,817,90
"2011","Carmarthenshire 004D","W01000709","Total",992,921,71
"2011","Carmarthenshire 005A","W01000624","Total",991,946,45
"2011","Carmarthenshire 005B","W01000682","Total",614,560,54
"2011","Carmarthenshire 005C","W01000683","Total",506,452,54
"2011","Carmarthenshire 005D","W01000684","Total",848,774,74
"2011","Carmarthenshire 006A","W01000643","Total",727,699,28
"2011","Carmarthenshire 006B","W01000644","Total",582,565,17
"2011","Carmarthenshire 006C","W01000645","Total",799,742,57
"2011","Carmarthenshire 006D","W01000648","Total",610,566,44
"2011","Carmarthenshire 006E","W01000649","Total",696,649,47
"2011","Carmarthenshire 007A","W01000637","Total",667,641,26
"2011","Carmarthenshire 007B","W01000638","Total",521,484,37
"2011","Carmarthenshire 007C","W01000639","Total",685,638,47
"2011","Carmarthenshire 007D","W01000640","Total",531,504,27
"2011","Carmarthenshire 008A","W01000641","Total",1305,1162,143
"2011","Carmarthenshire 008B","W01000642","Total",761,720,41
"2011","Carmarthenshire 008C","W01000693","Total",516,505,11
"2011","Carmarthenshire 008D","W01000694","Total",593,558,35
"2011","Carmarthenshire 010A","W01000656","Total",947,906,41
"2011","Carmarthenshire 010B","W01000657","Total",537,502,35
"2011","Carmarthenshire 010C","W01000658","Total",589,545,44
"2011","Carmarthenshire 010D","W01000718","Total",674,627,47
"2011","Carmarthenshire 010E","W01000719","Total",683,629,54
"2011","Carmarthenshire 011A","W01000680","Total",887,853,34
"2011","Carmarthenshire 011B","W01000681","Total",900,857,43
"2011","Carmarthenshire 011C","W01000724","Total",795,762,33
"2011","Carmarthenshire 011D","W01000725","Total",957,915,42
"2011","Carmarthenshire 012A","W01000675","Total",881,848,33
"2011","Carmarthenshire 012B","W01000695","Total",734,675,59
"2011","Carmarthenshire 012C","W01000696","Total",712,670,42
"2011","Carmarthenshire 012D","W01000722","Total",566,542,24
"2011","Carmarthenshire 012E","W01000723","Total",717,616,101
"2011","Carmarthenshire 013A","W01000625","Total",528,521,7
"2011","Carmarthenshire 013B","W01000626","Total",776,725,51
"2011","Carmarthenshire 013C","W01000627","Total",947,896,51
"2011","Carmarthenshire 013D","W01000714","Total",671,647,24
"2011","Carmarthenshire 013E","W01000715","Total",576,555,21
"2011","Carmarthenshire 015A","W01000697","Total",858,805,53
"2011","Carmarthenshire 015B","W01000698","Total",813,768,45
"2011","Carmarthenshire 015C","W01000699","Total",620,600,20
"2011","Carmarthenshire 015D","W01000712","Total",691,634,57
"2011","Carmarthenshire 015E","W01000713","Total",615,574,41
"2011","Carmarthenshire 016A","W01000662","Total",986,921,65
"2011","Carmarthenshire 016B","W01000663","Total",1053,998,55
"2011","Carmarthenshire 016C","W01000664","Total",797,737,60
"2011","Carmarthenshire 016D","W01000716","Total",597,544,53
"2011","Carmarthenshire 016E","W01000717","Total",683,645,38
"2011","Carmarthenshire 017A","W01000665","Total",746,727,19
"2011","Carmarthenshire 017B","W01000666","Total",677,643,34
"2011","Carmarthenshire 017C","W01000731","Total",1074,1039,35
"2011","Carmarthenshire 018A","W01000670","Total",782,733,49
"2011","Carmarthenshire 018B","W01000671","Total",830,774,56
"2011","Carmarthenshire 018C","W01000729","Total",580,546,34
"2011","Carmarthenshire 018D","W01000730","Total",555,522,33
"2011","Carmarthenshire 019A","W01000690","Total",779,754,25
"2011","Carmarthenshire 019B","W01000691","Total",703,682,21
"2011","Carmarthenshire 019C","W01000692","Total",664,648,16
"2011","Carmarthenshire 019D","W01000726","Total",651,630,21
"2011","Carmarthenshire 019E","W01000727","Total",493,479,14
"2011","Carmarthenshire 020A","W01000651","Total",718,700,18
"2011","Carmarthenshire 020B","W01000652","Total",817,793,24
"2011","Carmarthenshire 020C","W01000655","Total",870,827,43
"2011","Carmarthenshire 021A","W01000632","Total",670,618,52
"2011","Carmarthenshire 021B","W01000633","Total",819,703,116
"2011","Carmarthenshire 021C","W01000634","Total",689,653,36
"2011","Carmarthenshire 021D","W01000710","Total",948,899,49
"2011","Carmarthenshire 021E","W01000711","Total",970,908,62
"2011","Carmarthenshire 022A","W01000703","Total",870,818,52
"2011","Carmarthenshire 022B","W01000704","Total",756,719,37
"2011","Carmarthenshire 022C","W01000705","Total",877,834,43
"2011","Carmarthenshire 023A","W01000653","Total",674,642,32
"2011","Carmarthenshire 023B","W01000654","Total",855,788,67
"2011","Carmarthenshire 023C","W01000667","Total",653,625,28
"2011","Carmarthenshire 023F","W01001925","Total",1043,980,63
"2011","Carmarthenshire 024A","W01000628","Total",635,617,18
"2011","Carmarthenshire 024B","W01000629","Total",807,761,46
"2011","Carmarthenshire 024C","W01000630","Total",691,666,25
"2011","Carmarthenshire 024D","W01000631","Total",812,783,29
"2011","Carmarthenshire 025A","W01000635","Total",970,916,54
"2011","Carmarthenshire 025B","W01000636","Total",808,789,19
"2011","Carmarthenshire 025C","W01000706","Total",716,683,33
"2011","Carmarthenshire 025D","W01000707","Total",638,615,23
"2011","Carmarthenshire 025E","W01000708","Total",644,613,31
"2011","Carmarthenshire 026A","W01000659","Total",693,650,43
"2011","Carmarthenshire 026B","W01000660","Total",788,747,41
"2011","Carmarthenshire 026D","W01000732","Total",678,623,55
"2011","Carmarthenshire 026E","W01000733","Total",742,654,88
"2011","Carmarthenshire 026F","W01000734","Total",713,651,62
"2011","Carmarthenshire 026G","W01001923","Total",668,603,65
"2011","Carmarthenshire 026H","W01001924","Total",656,623,33
"2011","Carmarthenshire 027E","W01000672","Total",758,681,77
"2011","Carmarthenshire 027F","W01000673","Total",624,544,80
"2011","Carmarthenshire 027A","W01000674","Total",907,831,76
"2011","Carmarthenshire 027G","W01000700","Total",987,883,104
"2011","Carmarthenshire 027B","W01000720","Total",741,696,45
"2011","Carmarthenshire 027C","W01000721","Total",561,536,25
"2011","Carmarthenshire 027D","W01000735","Total",1064,978,86
"2011","Swansea 001A","W01000845","Total",855,819,36
"2011","Swansea 001B","W01000846","Total",864,815,49
"2011","Swansea 001C","W01000847","Total",554,522,32
"2011","Swansea 001D","W01000848","Total",523,505,18
"2011","Swansea 002A","W01000750","Total",751,717,34
"2011","Swansea 002B","W01000751","Total",646,626,20
"2011","Swansea 002C","W01000752","Total",662,641,21
"2011","Swansea 002D","W01000753","Total",622,602,20
"2011","Swansea 002E","W01000754","Total",735,681,54
"2011","Swansea 002F","W01000803","Total",809,767,42
"2011","Swansea 003A","W01000806","Total",638,631,7
"2011","Swansea 003B","W01000807","Total",568,562,6
"2011","Swansea 003C","W01000808","Total",642,625,17
"2011","Swansea 003D","W01000810","Total",681,667,14
"2011","Swansea 003E","W01000815","Total",816,671,145
"2011","Swansea 003F","W01000816","Total",732,712,20
"2011","Swansea 004A","W01000791","Total",643,636,7
"2011","Swansea 004B","W01000792","Total",707,686,21
"2011","Swansea 004C","W01000793","Total",784,766,18
"2011","Swansea 004D","W01000837","Total",653,641,12
"2011","Swansea 004E","W01000838","Total",579,559,20
"2011","Swansea 005A","W01000773","Total",1244,1184,60
"2011","Swansea 005B","W01000774","Total",784,740,44
"2011","Swansea 005C","W01000841","Total",649,635,14
"2011","Swansea 005D","W01000842","Total",611,590,21
"2011","Swansea 005E","W01000843","Total",582,563,19
"2011","Swansea 005F","W01000844","Total",509,489,20
"2011","Swansea 006A","W01000795","Total",708,685,23
"2011","Swansea 006B","W01000796","Total",1091,1063,28
"2011","Swansea 006C","W01000800","Total",618,604,14
"2011","Swansea 006D","W01000801","Total",647,635,12
"2011","Swansea 007A","W01000784","Total",602,586,16
"2011","Swansea 007B","W01000785","Total",536,528,8
"2011","Swansea 007C","W01000786","Total",588,573,15
"2011","Swansea 007D","W01000802","Total",1028,1010,18
"2011","Swansea 007E","W01000877","Total",671,644,27
"2011","Swansea 007F","W01000878","Total",545,526,19
"2011","Swansea 008A","W01000809","Total",766,692,74
"2011","Swansea 008B","W01000811","Total",713,684,29
"2011","Swansea 008C","W01000812","Total",730,689,41
"2011","Swansea 008D","W01000813","Total",717,676,41
"2011","Swansea 008E","W01000814","Total",699,675,24
"2011","Swansea 009A","W01000817","Total",853,842,11
"2011","Swansea 009B","W01000818","Total",681,671,10
"2011","Swansea 009C","W01000819","Total",641,626,15
"2011","Swansea 009D","W01000820","Total",635,605,30
"2011","Swansea 009E","W01000821","Total",691,673,18
"2011","Swansea 009F","W01000822","Total",603,594,9
"2011","Swansea 010A","W01000794","Total",955,921,34
"2011","Swansea 010B","W01000797","Total",668,652,16
"2011","Swansea 010C","W01000798","Total",643,627,16
"2011","Swansea 010D","W01000799","Total",818,782,36
"2011","Swansea 011A","W01000830","Total",694,687,7
"2011","Swansea 011B","W01000832","Total",774,763,11
"2011","Swansea 011C","W01000833","Total",779,767,12
"2011","Swansea 011D","W01000834","Total",619,602,17
"2011","Swansea 011E","W01000836","Total",965,934,31
"2011","Swansea 012A","W01000759","Total",690,655,35
"2011","Swansea 012B","W01000777","Total",803,785,18
"2011","Swansea 012C","W01000778","Total",813,770,43
"2011","Swansea 012D","W01000779","Total",622,597,25
"2011","Swansea 013A","W01000760","Total",765,728,37
"2011","Swansea 013B","W01000761","Total",666,652,14
"2011","Swansea 013C","W01000762","Total",626,617,9
"2011","Swansea 013D","W01000831","Total",835,825,10
"2011","Swansea 013E","W01000835","Total",602,594,8
"2011","Swansea 014A","W01000738","Total",778,753,25
"2011","Swansea 014B","W01000739","Total",918,863,55
"2011","Swansea 014C","W01000740","Total",665,658,7
"2011","Swansea 014D","W01000741","Total",734,706,28
"2011","Swansea 015A","W01000763","Total",636,620,16
"2011","Swansea 015B","W01000764","Total",697,680,17
"2011","Swansea 015C","W01000765","Total",766,748,18
"2011","Swansea 015D","W01000766","Total",651,641,10
"2011","Swansea 015E","W01000767","Total",766,757,9
"2011","Swansea 016A","W01000742","Total",815,800,15
"2011","Swansea 016B","W01000744","Total",773,755,18
"2011","Swansea 016C","W01000787","Total",719,678,41
"2011","Swansea 016D","W01000788","Total",677,658,19
"2011","Swansea 016E","W01000789","Total",657,640,17
"2011","Swansea 016F","W01000790","Total",768,748,20
"2011","Swansea 017A","W01000755","Total",894,868,26
"2011","Swansea 017B","W01000756","Total",783,751,32
"2011","Swansea 017C","W01000757","Total",733,718,15
"2011","Swansea 017D","W01000758","Total",864,839,25
"2011","Swansea 018A","W01000772","Total",634,615,19
"2011","Swansea 018B","W01000828","Total",773,732,41
"2011","Swansea 018C","W01000829","Total",877,828,49
"2011","Swansea 019A","W01000862","Total",734,706,28
"2011","Swansea 019B","W01000863","Total",779,753,26
"2011","Swansea 019C","W01000864","Total",720,706,14
"2011","Swansea 019D","W01000865","Total",605,591,14
"2011","Swansea 019E","W01000866","Total",529,524,5
"2011","Swansea 019F","W01000867","Total",582,570,12
"2011","Swansea 020A","W01000768","Total",628,611,17
"2011","Swansea 020B","W01000769","Total",612,591,21
"2011","Swansea 020C","W01000770","Total",654,638,16
"2011","Swansea 020D","W01000771","Total",556,533,23
"2011","Swansea 021A","W01000849","Total",846,807,39
"2011","Swansea 021B","W01000850","Total",1309,1195,114
"2011","Swansea 021C","W01000851","Total",706,682,24
"2011","Swansea 021D","W01000852","Total",650,637,13
"2011","Swansea 022A","W01000853","Total",635,607,28
"2011","Swansea 022B","W01000854","Total",535,529,6
"2011","Swansea 022C","W01000855","Total",661,645,16
"2011","Swansea 022D","W01000856","Total",1020,997,23
"2011","Swansea 022E","W01000857","Total",931,900,31
"2011","Swansea 023B","W01000781","Total",738,708,30
"2011","Swansea 023C","W01000782","Total",539,516,23
"2011","Swansea 023E","W01001956","Total",847,803,44
"2011","Swansea 024A","W01000747","Total",809,743,66
"2011","Swansea 024B","W01000868","Total",501,482,19
"2011","Swansea 024C","W01000869","Total",807,727,80
"2011","Swansea 024D","W01000870","Total",671,640,31
"2011","Swansea 024E","W01000872","Total",633,615,18
"2011","Swansea 024F","W01000874","Total",759,709,50
"2011","Swansea 025B","W01000745","Total",1143,1072,71
"2011","Swansea 025C","W01000746","Total",845,800,45
"2011","Swansea 025E","W01001938","Total",973,807,166
"2011","Swansea 025F","W01001955","Total",1236,1153,83
"2011","Swansea 025G","W01001957","Total",450,411,39
"2011","Swansea 025H","W01001958","Total",952,836,116
"2011","Swansea 026A","W01000749","Total",971,894,77
"2011","Swansea 026B","W01000871","Total",784,714,70
"2011","Swansea 026C","W01000873","Total",651,593,58
"2011","Swansea 026D","W01000875","Total",824,771,53
"2011","Swansea 026E","W01000876","Total",656,637,19
"2011","Swansea 027A","W01000858","Total",711,687,24
"2011","Swansea 027B","W01000859","Total",701,679,22
"2011","Swansea 027C","W01000860","Total",657,631,26
"2011","Swansea 027D","W01000861","Total",478,451,27
"2011","Swansea 028A","W01000736","Total",793,763,30
"2011","Swansea 028B","W01000737","Total",839,700,139
"2011","Swansea 028C","W01000804","Total",778,730,48
"2011","Swansea 028D","W01000805","Total",496,479,17
"2011","Swansea 029A","W01000879","Total",796,767,29
"2011","Swansea 029B","W01000880","Total",811,759,52
"2011","Swansea 029C","W01000881","Total",760,710,50
"2011","Swansea 029D","W01000882","Total",867,826,41
"2011","Swansea 030A","W01000775","Total",1118,738,380
"2011","Swansea 030B","W01000776","Total",861,733,128
"2011","Swansea 030C","W01000839","Total",491,460,31
"2011","Swansea 030D","W01000840","Total",772,706,66
"2011","Swansea 031A","W01000823","Total",764,738,26
"2011","Swansea 031B","W01000824","Total",959,765,194
"2011","Swansea 031C","W01000825","Total",853,718,135
"2011","Swansea 031D","W01000826","Total",784,642,142
"2011","Swansea 031E","W01000827","Total",686,615,71
"2011","Neath Port Talbot 002A","W01000918","Total",888,842,46
"2011","Neath Port Talbot 002B","W01000944","Total",561,524,37
"2011","Neath Port Talbot 002C","W01000965","Total",915,866,49
"2011","Neath Port Talbot 003A","W01000893","Total",852,817,35
"2011","Neath Port Talbot 003B","W01000925","Total",678,657,21
"2011","Neath Port Talbot 003C","W01000926","Total",935,862,73
"2011","Neath Port Talbot 004A","W01000888","Total",982,933,49
"2011","Neath Port Talbot 004B","W01000946","Total",674,616,58
"2011","Neath Port Talbot 004C","W01000947","Total",903,866,37
"2011","Neath Port Talbot 004D","W01000948","Total",915,842,73
"2011","Neath Port Talbot 004E","W01000955","Total",546,526,20
"2011","Neath Port Talbot 004F","W01000956","Total",536,522,14
"2011","Neath Port Talbot 004G","W01000971","Total",630,599,31
"2011","Neath Port Talbot 005A","W01000887","Total",977,953,24
"2011","Neath Port Talbot 005B","W01000953","Total",776,727,49
"2011","Neath Port Talbot 005C","W01000954","Total",675,633,42
"2011","Neath Port Talbot 005D","W01000970","Total",521,500,21
"2011","Neath Port Talbot 006A","W01000902","Total",449,438,11
"2011","Neath Port Talbot 006B","W01000903","Total",513,491,22
"2011","Neath Port Talbot 006C","W01000904","Total",650,640,10
"2011","Neath Port Talbot 006D","W01000905","Total",651,627,24
"2011","Neath Port Talbot 006E","W01000908","Total",771,744,27
"2011","Neath Port Talbot 007A","W01000906","Total",487,461,26
"2011","Neath Port Talbot 007B","W01000907","Total",787,762,25
"2011","Neath Port Talbot 007C","W01000922","Total",769,721,48
"2011","Neath Port Talbot 007D","W01000923","Total",686,651,35
"2011","Neath Port Talbot 008A","W01000934","Total",684,628,56
"2011","Neath Port Talbot 008B","W01000935","Total",923,842,81
"2011","Neath Port Talbot 008C","W01000938","Total",652,611,41
"2011","Neath Port Talbot 008D","W01000939","Total",760,690,70
"2011","Neath Port Talbot 008E","W01000940","Total",628,596,32
"2011","Neath Port Talbot 009A","W01000909","Total",515,494,21
"2011","Neath Port Talbot 009B","W01000910","Total",655,640,15
"2011","Neath Port Talbot 009C","W01000911","Total",504,490,14
"2011","Neath Port Talbot 009D","W01000969","Total",537,515,22
"2011","Neath Port Talbot 010A","W01000912","Total",558,537,21
"2011","Neath Port Talbot 010B","W01000913","Total",574,528,46
"2011","Neath Port Talbot 010C","W01000914","Total",682,647,35
"2011","Neath Port Talbot 010D","W01000915","Total",522,496,26
"2011","Neath Port Talbot 010E","W01000916","Total",502,479,23
"2011","Neath Port Talbot 010F","W01000917","Total",1193,1086,107
"2011","Neath Port Talbot 011A","W01000920","Total",576,518,58
"2011","Neath Port Talbot 011B","W01000921","Total",682,666,16
"2011","Neath Port Talbot 011C","W01000924","Total",502,463,39
"2011","Neath Port Talbot 011D","W01000930","Total",671,617,54
"2011","Neath Port Talbot 012A","W01000936","Total",661,628,33
"2011","Neath Port Talbot 012B","W01000941","Total",668,639,29
"2011","Neath Port Talbot 012C","W01000942","Total",813,782,31
"2011","Neath Port Talbot 012D","W01000943","Total",638,614,24
"2011","Neath Port Talbot 013A","W01000894","Total",672,615,57
"2011","Neath Port Talbot 013B","W01000895","Total",861,783,78
"2011","Neath Port Talbot 013C","W01000896","Total",680,646,34
"2011","Neath Port Talbot 013D","W01000897","Total",646,594,52
"2011","Neath Port Talbot 013E","W01000937","Total",1007,950,57
"2011","Neath Port Talbot 014A","W01000898","Total",665,636,29
"2011","Neath Port Talbot 014B","W01000899","Total",729,694,35
"2011","Neath Port Talbot 014C","W01000900","Total",842,787,55
"2011","Neath Port Talbot 014D","W01000901","Total",762,733,29
"2011","Neath Port Talbot 014E","W01000945","Total",542,492,50
"2011","Neath Port Talbot 015A","W01000889","Total",882,795,87
"2011","Neath Port Talbot 015B","W01000890","Total",708,675,33
"2011","Neath Port Talbot 015C","W01000891","Total",661,640,21
"2011","Neath Port Talbot 015D","W01000892","Total",864,814,50
"2011","Neath Port Talbot 016A","W01000883","Total",629,619,10
"2011","Neath Port Talbot 016B","W01000958","Total",656,650,6
"2011","Neath Port Talbot 016C","W01000961","Total",745,726,19
"2011","Neath Port Talbot 016D","W01000962","Total",620,606,14
"2011","Neath Port Talbot 016E","W01000963","Total",809,776,33
"2011","Neath Port Talbot 016F","W01000964","Total",787,774,13
"2011","Neath Port Talbot 017A","W01000884","Total",608,527,81
"2011","Neath Port Talbot 017B","W01000885","Total",660,623,37
"2011","Neath Port Talbot 017C","W01000886","Total",778,689,89
"2011","Neath Port Talbot 017D","W01000957","Total",870,852,18
"2011","Neath Port Talbot 017E","W01000959","Total",809,760,49
"2011","Neath Port Talbot 017F","W01000960","Total",848,783,65
"2011","Neath Port Talbot 018A","W01000949","Total",601,572,29
"2011","Neath Port Talbot 018B","W01000950","Total",731,676,55
"2011","Neath Port Talbot 018C","W01000951","Total",754,650,104
"2011","Neath Port Talbot 018D","W01000952","Total",540,484,56
"2011","Neath Port Talbot 018E","W01000966","Total",687,637,50
"2011","Neath Port Talbot 019A","W01000932","Total",514,491,23
"2011","Neath Port Talbot 019B","W01000933","Total",774,741,33
"2011","Neath Port Talbot 019C","W01000967","Total",723,681,42
"2011","Neath Port Talbot 019D","W01000968","Total",847,803,44
"2011","Neath Port Talbot 020A","W01000919","Total",534,504,30
"2011","Neath Port Talbot 020B","W01000927","Total",754,704,50
"2011","Neath Port Talbot 020C","W01000928","Total",736,698,38
"2011","Neath Port Talbot 020D","W01000929","Total",582,562,20
"2011","Neath Port Talbot 020E","W01000931","Total",596,560,36
"2011","Neath Port Talbot 020F","W01000973","Total",714,681,33
"2011","Neath Port Talbot 020G","W01001900","Total",763,684,79
"2011","Bridgend 001A","W01000991","Total",501,475,26
"2011","Bridgend 001B","W01000992","Total",703,636,67
"2011","Bridgend 001C","W01000993","Total",646,625,21
"2011","Bridgend 001D","W01000994","Total",611,576,35
"2011","Bridgend 001E","W01000995","Total",698,654,44
"2011","Bridgend 002A","W01001014","Total",838,779,59
"2011","Bridgend 002B","W01001015","Total",631,594,37
"2011","Bridgend 002C","W01001017","Total",645,601,44
"2011","Bridgend 002D","W01001018","Total",677,634,43
"2011","Bridgend 002E","W01001020","Total",644,615,29
"2011","Bridgend 003A","W01000976","Total",479,450,29
"2011","Bridgend 003B","W01000977","Total",601,579,22
"2011","Bridgend 003C","W01001024","Total",583,507,76
"2011","Bridgend 003D","W01001025","Total",562,519,43
"2011","Bridgend 003E","W01001033","Total",786,735,51
"2011","Bridgend 003F","W01001034","Total",722,659,63
"2011","Bridgend 004A","W01000975","Total",910,884,26
"2011","Bridgend 004B","W01000978","Total",826,774,52
"2011","Bridgend 004C","W01001009","Total",515,497,18
"2011","Bridgend 004D","W01001042","Total",624,573,51
"2011","Bridgend 004E","W01001043","Total",564,502,62
"2011","Bridgend 005A","W01001012","Total",602,584,18
"2011","Bridgend 005B","W01001013","Total",654,636,18
"2011","Bridgend 005C","W01001016","Total",783,744,39
"2011","Bridgend 005D","W01001019","Total",649,621,28
"2011","Bridgend 006A","W01000974","Total",947,900,47
"2011","Bridgend 006B","W01001057","Total",694,665,29
"2011","Bridgend 006C","W01001058","Total",803,772,31
"2011","Bridgend 007A","W01000986","Total",586,573,13
"2011","Bridgend 007B","W01000987","Total",986,962,24
"2011","Bridgend 007C","W01001055","Total",527,514,13
"2011","Bridgend 007D","W01001056","Total",525,507,18
"2011","Bridgend 008A","W01000996","Total",669,638,31
"2011","Bridgend 008B","W01001048","Total",642,607,35
"2011","Bridgend 008C","W01001049","Total",538,530,8
"2011","Bridgend 008D","W01001050","Total",694,669,25
"2011","Bridgend 008E","W01001051","Total",745,727,18
"2011","Bridgend 008F","W01001052","Total",629,612,17
"2011","Bridgend 009A","W01001004","Total",509,488,21
"2011","Bridgend 009B","W01001005","Total",749,740,9
"2011","Bridgend 009C","W01001006","Total",966,946,20
"2011","Bridgend 009D","W01001007","Total",716,700,16
"2011","Bridgend 009E","W01001039","Total",693,678,15
"2011","Bridgend 009F","W01001040","Total",627,611,16
"2011","Bridgend 010A","W01000999","Total",639,614,25
"2011","Bridgend 010B","W01001000","Total",753,726,27
"2011","Bridgend 010C","W01001001","Total",637,623,14
"2011","Bridgend 010D","W01001002","Total",1098,1060,38
"2011","Bridgend 011A","W01000998","Total",535,513,22
"2011","Bridgend 011B","W01001008","Total",933,910,23
"2011","Bridgend 011C","W01001038","Total",969,927,42
"2011","Bridgend 012A","W01000997","Total",707,690,17
"2011","Bridgend 012B","W01001010","Total",516,510,6
"2011","Bridgend 012C","W01001011","Total",590,578,12
"2011","Bridgend 012D","W01001026","Total",903,838,65
"2011","Bridgend 013A","W01000989","Total",604,574,30
"2011","Bridgend 013B","W01001037","Total",697,671,26
"2011","Bridgend 013C","W01001041","Total",941,926,15
"2011","Bridgend 014A","W01001021","Total",805,764,41
"2011","Bridgend 014B","W01001022","Total",650,623,27
"2011","Bridgend 014C","W01001023","Total",865,815,50
"2011","Bridgend 014D","W01001028","Total",863,823,40
"2011","Bridgend 014E","W01001035","Total",811,745,66
"2011","Bridgend 015A","W01000979","Total",709,694,15
"2011","Bridgend 015B","W01000983","Total",662,638,24
"2011","Bridgend 015C","W01000985","Total",520,512,8
"2011","Bridgend 015D","W01001003","Total",606,583,23
"2011","Bridgend 016A","W01000980","Total",568,555,13
"2011","Bridgend 016B","W01000981","Total",497,489,8
"2011","Bridgend 016C","W01000982","Total",640,627,13
"2011","Bridgend 016D","W01000984","Total",957,931,26
"2011","Bridgend 017B","W01000990","Total",675,660,15
"2011","Bridgend 017C","W01001027","Total",741,720,21
"2011","Bridgend 017D","W01001036","Total",671,646,25
"2011","Bridgend 017E","W01001918","Total",547,536,11
"2011","Bridgend 017F","W01001919","Total",539,531,8
"2011","Bridgend 017G","W01001920","Total",452,443,9
"2011","Bridgend 017H","W01001921","Total",579,576,3
"2011","Bridgend 018A","W01001031","Total",654,628,26
"2011","Bridgend 018B","W01001032","Total",868,818,50
"2011","Bridgend 018C","W01001046","Total",1158,873,285
"2011","Bridgend 018D","W01001047","Total",850,757,93
"2011","Bridgend 018E","W01001053","Total",484,465,19
"2011","Bridgend 018F","W01001054","Total",580,532,48
"2011","Bridgend 019A","W01001029","Total",848,798,50
"2011","Bridgend 019B","W01001030","Total",814,765,49
"2011","Bridgend 019C","W01001044","Total",787,771,16
"2011","Bridgend 019D","W01001045","Total",877,745,132
"2011","The Vale of Glamorgan 001A","W01001105","Total",1066,1024,42
"2011","The Vale of Glamorgan 001B","W01001127","Total",591,535,56
"2011","The Vale of Glamorgan 001C","W01001128","Total",622,599,23
"2011","The Vale of Glamorgan 002A","W01001082","Total",812,754,58
"2011","The Vale of Glamorgan 002B","W01001083","Total",683,659,24
"2011","The Vale of Glamorgan 002C","W01001084","Total",746,721,25
"2011","The Vale of Glamorgan 002D","W01001085","Total",605,581,24
"2011","The Vale of Glamorgan 003A","W01001113","Total",983,913,70
"2011","The Vale of Glamorgan 003B","W01001119","Total",715,678,37
"2011","The Vale of Glamorgan 003C","W01001135","Total",624,600,24
"2011","The Vale of Glamorgan 003D","W01001136","Total",509,497,12
"2011","The Vale of Glamorgan 004A","W01001075","Total",508,496,12
"2011","The Vale of Glamorgan 004B","W01001076","Total",642,625,17
"2011","The Vale of Glamorgan 004C","W01001077","Total",635,616,19
"2011","The Vale of Glamorgan 004D","W01001078","Total",519,510,9
"2011","The Vale of Glamorgan 004E","W01001104","Total",884,864,20
"2011","The Vale of Glamorgan 004F","W01001129","Total",528,517,11
"2011","The Vale of Glamorgan 005A","W01001116","Total",891,833,58
"2011","The Vale of Glamorgan 005B","W01001123","Total",915,850,65
"2011","The Vale of Glamorgan 005C","W01001124","Total",722,683,39
"2011","The Vale of Glamorgan 005D","W01001125","Total",662,618,44
"2011","The Vale of Glamorgan 005E","W01001126","Total",1114,1036,78
"2011","The Vale of Glamorgan 005F","W01001130","Total",556,534,22
"2011","The Vale of Glamorgan 006A","W01001086","Total",674,644,30
"2011","The Vale of Glamorgan 006B","W01001087","Total",669,657,12
"2011","The Vale of Glamorgan 006C","W01001088","Total",821,813,8
"2011","The Vale of Glamorgan 006D","W01001089","Total",619,604,15
"2011","The Vale of Glamorgan 006E","W01001090","Total",632,615,17
"2011","The Vale of Glamorgan 007A","W01001081","Total",702,670,32
"2011","The Vale of Glamorgan 007B","W01001092","Total",684,673,11
"2011","The Vale of Glamorgan 007C","W01001094","Total",534,531,3
"2011","The Vale of Glamorgan 007D","W01001095","Total",671,667,4
"2011","The Vale of Glamorgan 007E","W01001096","Total",649,636,13
"2011","The Vale of Glamorgan 007F","W01001097","Total",620,607,13
"2011","The Vale of Glamorgan 008A","W01001114","Total",682,661,21
"2011","The Vale of Glamorgan 008B","W01001115","Total",893,872,21
"2011","The Vale of Glamorgan 008C","W01001131","Total",782,760,22
"2011","The Vale of Glamorgan 008D","W01001132","Total",595,585,10
"2011","The Vale of Glamorgan 008E","W01001133","Total",956,904,52
"2011","The Vale of Glamorgan 008F","W01001134","Total",644,536,108
"2011","The Vale of Glamorgan 009A","W01001067","Total",654,648,6
"2011","The Vale of Glamorgan 009B","W01001068","Total",748,731,17
"2011","The Vale of Glamorgan 009C","W01001070","Total",561,539,22
"2011","The Vale of Glamorgan 009D","W01001071","Total",685,667,18
"2011","The Vale of Glamorgan 009E","W01001072","Total",1012,1001,11
"2011","The Vale of Glamorgan 010A","W01001091","Total",738,724,14
"2011","The Vale of Glamorgan 010B","W01001098","Total",473,467,6
"2011","The Vale of Glamorgan 010C","W01001100","Total",645,636,9
"2011","The Vale of Glamorgan 010D","W01001103","Total",525,520,5
"2011","The Vale of Glamorgan 011A","W01001106","Total",596,582,14
"2011","The Vale of Glamorgan 011B","W01001107","Total",742,712,30
"2011","The Vale of Glamorgan 011C","W01001109","Total",642,625,17
"2011","The Vale of Glamorgan 011D","W01001110","Total",564,529,35
"2011","The Vale of Glamorgan 011E","W01001111","Total",607,594,13
"2011","The Vale of Glamorgan 011F","W01001112","Total",607,595,12
"2011","The Vale of Glamorgan 012A","W01001063","Total",723,711,12
"2011","The Vale of Glamorgan 012B","W01001065","Total",662,642,20
"2011","The Vale of Glamorgan 012C","W01001069","Total",733,686,47
"2011","The Vale of Glamorgan 012E","W01001079","Total",720,695,25
"2011","The Vale of Glamorgan 012F","W01001080","Total",665,648,17
"2011","The Vale of Glamorgan 012G","W01001910","Total",787,734,53
"2011","The Vale of Glamorgan 012H","W01001911","Total",529,508,21
"2011","The Vale of Glamorgan 013A","W01001062","Total",603,544,59
"2011","The Vale of Glamorgan 013B","W01001064","Total",664,640,24
"2011","The Vale of Glamorgan 013C","W01001093","Total",799,788,11
"2011","The Vale of Glamorgan 013D","W01001099","Total",606,600,6
"2011","The Vale of Glamorgan 013E","W01001101","Total",765,694,71
"2011","The Vale of Glamorgan 013F","W01001102","Total",706,668,38
"2011","The Vale of Glamorgan 014A","W01001108","Total",803,728,75
"2011","The Vale of Glamorgan 014B","W01001117","Total",605,585,20
"2011","The Vale of Glamorgan 014C","W01001118","Total",975,959,16
"2011","The Vale of Glamorgan 014D","W01001120","Total",603,589,14
"2011","The Vale of Glamorgan 014E","W01001121","Total",678,644,34
"2011","The Vale of Glamorgan 014F","W01001122","Total",862,802,60
"2011","The Vale of Glamorgan 015A","W01001059","Total",644,614,30
"2011","The Vale of Glamorgan 015B","W01001060","Total",682,659,23
"2011","The Vale of Glamorgan 015C","W01001061","Total",952,926,26
"2011","The Vale of Glamorgan 015D","W01001066","Total",702,688,14
"2011","The Vale of Glamorgan 015E","W01001073","Total",1038,1005,33
"2011","Cardiff 001A","W01001777","Total",633,610,23
"2011","Cardiff 001B","W01001778","Total",715,700,15
"2011","Cardiff 001C","W01001794","Total",635,626,9
"2011","Cardiff 001D","W01001799","Total",540,520,20
"2011","Cardiff 002A","W01001793","Total",584,567,17
"2011","Cardiff 002B","W01001795","Total",657,644,13
"2011","Cardiff 002C","W01001796","Total",658,653,5
"2011","Cardiff 002D","W01001798","Total",636,624,12
"2011","Cardiff 003A","W01001841","Total",753,740,13
"2011","Cardiff 003B","W01001842","Total",748,726,22
"2011","Cardiff 003C","W01001843","Total",833,808,25
"2011","Cardiff 003D","W01001844","Total",853,841,12
"2011","Cardiff 004A","W01001849","Total",665,651,14
"2011","Cardiff 004B","W01001852","Total",741,723,18
"2011","Cardiff 004C","W01001853","Total",776,749,27
"2011","Cardiff 004D","W01001854","Total",861,834,27
"2011","Cardiff 005A","W01001791","Total",771,734,37
"2011","Cardiff 005B","W01001792","Total",716,705,11
"2011","Cardiff 005C","W01001797","Total",621,607,14
"2011","Cardiff 005D","W01001800","Total",681,665,16
"2011","Cardiff 005F","W01001949","Total",663,635,28
"2011","Cardiff 005G","W01001953","Total",665,643,22
"2011","Cardiff 006A","W01001820","Total",518,508,10
"2011","Cardiff 006C","W01001846","Total",654,641,13
"2011","Cardiff 006D","W01001847","Total",649,637,12
"2011","Cardiff 006E","W01001948","Total",657,637,20
"2011","Cardiff 006F","W01001954","Total",676,637,39
"2011","Cardiff 007A","W01001802","Total",711,684,27
"2011","Cardiff 007B","W01001807","Total",602,591,11
"2011","Cardiff 007C","W01001808","Total",663,638,25
"2011","Cardiff 007D","W01001840","Total",776,755,21
"2011","Cardiff 008A","W01001730","Total",682,647,35
"2011","Cardiff 008B","W01001731","Total",543,534,9
"2011","Cardiff 008C","W01001736","Total",625,601,24
"2011","Cardiff 008D","W01001815","Total",518,511,7
"2011","Cardiff 009A","W01001811","Total",553,540,13
"2011","Cardiff 009B","W01001816","Total",1085,1065,20
"2011","Cardiff 009C","W01001817","Total",558,553,5
"2011","Cardiff 009D","W01001818","Total",645,625,20
"2011","Cardiff 010A","W01001888","Total",718,694,24
"2011","Cardiff 010B","W01001893","Total",813,793,20
"2011","Cardiff 010C","W01001894","Total",682,651,31
"2011","Cardiff 010D","W01001895","Total",895,851,44
"2011","Cardiff 011A","W01001877","Total",737,721,16
"2011","Cardiff 011B","W01001878","Total",643,630,13
"2011","Cardiff 011C","W01001882","Total",752,739,13
"2011","Cardiff 011D","W01001885","Total",804,786,18
"2011","Cardiff 012A","W01001773","Total",1035,991,44
"2011","Cardiff 012B","W01001848","Total",632,618,14
"2011","Cardiff 012C","W01001850","Total",819,790,29
"2011","Cardiff 012D","W01001851","Total",719,697,22
"2011","Cardiff 013A","W01001879","Total",835,817,18
"2011","Cardiff 013B","W01001880","Total",591,573,18
"2011","Cardiff 013C","W01001881","Total",664,645,19
"2011","Cardiff 013D","W01001884","Total",534,527,7
"2011","Cardiff 014A","W01001727","Total",471,462,9
"2011","Cardiff 014B","W01001728","Total",592,582,10
"2011","Cardiff 014C","W01001729","Total",824,808,16
"2011","Cardiff 014D","W01001819","Total",934,912,22
"2011","Cardiff 015A","W01001803","Total",729,712,17
"2011","Cardiff 015B","W01001804","Total",658,643,15
"2011","Cardiff 015C","W01001805","Total",671,645,26
"2011","Cardiff 015D","W01001806","Total",836,799,37
"2011","Cardiff 016A","W01001866","Total",624,606,18
"2011","Cardiff 016B","W01001867","Total",579,545,34
"2011","Cardiff 016C","W01001883","Total",696,675,21
"2011","Cardiff 016D","W01001886","Total",533,516,17
"2011","Cardiff 017A","W01001809","Total",546,538,8
"2011","Cardiff 017B","W01001810","Total",647,635,12
"2011","Cardiff 017C","W01001812","Total",493,484,9
"2011","Cardiff 017D","W01001813","Total",707,698,9
"2011","Cardiff 017E","W01001814","Total",685,672,13
"2011","Cardiff 018A","W01001769","Total",631,617,14
"2011","Cardiff 018B","W01001770","Total",502,476,26
"2011","Cardiff 018C","W01001771","Total",692,688,4
"2011","Cardiff 018D","W01001774","Total",548,541,7
"2011","Cardiff 019A","W01001732","Total",693,667,26
"2011","Cardiff 019B","W01001733","Total",601,586,15
"2011","Cardiff 019C","W01001734","Total",610,592,18
"2011","Cardiff 019D","W01001735","Total",632,608,24
"2011","Cardiff 020A","W01001887","Total",631,613,18
"2011","Cardiff 020B","W01001889","Total",777,747,30
"2011","Cardiff 020C","W01001891","Total",783,762,21
"2011","Cardiff 020D","W01001892","Total",611,599,12
"2011","Cardiff 020E","W01001896","Total",647,628,19
"2011","Cardiff 021A","W01001772","Total",614,603,11
"2011","Cardiff 021B","W01001775","Total",733,693,40
"2011","Cardiff 021C","W01001776","Total",533,515,18
"2011","Cardiff 021D","W01001890","Total",630,608,22
"2011","Cardiff 022A","W01001863","Total",655,637,18
"2011","Cardiff 022B","W01001864","Total",654,623,31
"2011","Cardiff 022C","W01001865","Total",527,515,12
"2011","Cardiff 022D","W01001868","Total",628,609,19
"2011","Cardiff 023A","W01001785","Total",488,482,6
"2011","Cardiff 023B","W01001786","Total",642,628,14
"2011","Cardiff 023C","W01001787","Total",569,556,13
"2011","Cardiff 023D","W01001788","Total",627,608,19
"2011","Cardiff 023E","W01001789","Total",754,730,24
"2011","Cardiff 023F","W01001790","Total",508,500,8
"2011","Cardiff 024A","W01001821","Total",585,548,37
"2011","Cardiff 024B","W01001826","Total",574,561,13
"2011","Cardiff 024C","W01001827","Total",648,619,29
"2011","Cardiff 024D","W01001828","Total",658,637,21
"2011","Cardiff 025A","W01001755","Total",574,536,38
"2011","Cardiff 025B","W01001756","Total",682,667,15
"2011","Cardiff 025C","W01001757","Total",611,571,40
"2011","Cardiff 025D","W01001758","Total",694,652,42
"2011","Cardiff 026A","W01001779","Total",686,653,33
"2011","Cardiff 026B","W01001780","Total",641,628,13
"2011","Cardiff 026C","W01001781","Total",911,829,82
"2011","Cardiff 026D","W01001782","Total",604,591,13
"2011","Cardiff 026E","W01001783","Total",513,508,5
"2011","Cardiff 026F","W01001784","Total",600,585,15
"2011","Cardiff 027A","W01001747","Total",839,812,27
"2011","Cardiff 027B","W01001748","Total",669,650,19
"2011","Cardiff 027C","W01001749","Total",716,699,17
"2011","Cardiff 027D","W01001751","Total",816,802,14
"2011","Cardiff 028A","W01001718","Total",615,577,38
"2011","Cardiff 028B","W01001719","Total",552,534,18
"2011","Cardiff 028C","W01001720","Total",631,590,41
"2011","Cardiff 028D","W01001722","Total",540,514,26
"2011","Cardiff 028E","W01001726","Total",552,524,28
"2011","Cardiff 029A","W01001822","Total",763,739,24
"2011","Cardiff 029B","W01001823","Total",537,521,16
"2011","Cardiff 029C","W01001824","Total",728,693,35
"2011","Cardiff 029D","W01001825","Total",823,774,49
"2011","Cardiff 030A","W01001831","Total",656,620,36
"2011","Cardiff 030B","W01001836","Total",610,580,30
"2011","Cardiff 030C","W01001837","Total",539,510,29
"2011","Cardiff 030D","W01001838","Total",665,640,25
"2011","Cardiff 030E","W01001839","Total",641,613,28
"2011","Cardiff 031A","W01001750","Total",865,841,24
"2011","Cardiff 031B","W01001752","Total",681,673,8
"2011","Cardiff 031C","W01001753","Total",646,642,4
"2011","Cardiff 031D","W01001754","Total",850,829,21
"2011","Cardiff 032A","W01001721","Total",626,594,32
"2011","Cardiff 032C","W01001724","Total",575,549,26
"2011","Cardiff 032D","W01001725","Total",641,589,52
"2011","Cardiff 032E","W01001922","Total",447,424,23
"2011","Cardiff 032F","W01001939","Total",742,627,115
"2011","Cardiff 032G","W01001941","Total",868,670,198
"2011","Cardiff 033A","W01001829","Total",704,663,41
"2011","Cardiff 033B","W01001830","Total",959,883,76
"2011","Cardiff 033C","W01001832","Total",774,741,33
"2011","Cardiff 033D","W01001833","Total",782,716,66
"2011","Cardiff 033E","W01001834","Total",730,691,39
"2011","Cardiff 033F","W01001835","Total",955,908,47
"2011","Cardiff 034A","W01001858","Total",959,869,90
"2011","Cardiff 034B","W01001859","Total",796,722,74
"2011","Cardiff 034C","W01001860","Total",845,799,46
"2011","Cardiff 034D","W01001861","Total",823,757,66
"2011","Cardiff 035A","W01001714","Total",616,612,4
"2011","Cardiff 035B","W01001715","Total",792,765,27
"2011","Cardiff 035C","W01001716","Total",562,543,19
"2011","Cardiff 035D","W01001717","Total",783,768,15
"2011","Cardiff 036A","W01001694","Total",946,878,68
"2011","Cardiff 036B","W01001695","Total",894,845,49
"2011","Cardiff 036C","W01001696","Total",710,683,27
"2011","Cardiff 036D","W01001697","Total",806,762,44
"2011","Cardiff 036E","W01001698","Total",942,896,46
"2011","Cardiff 037A","W01001870","Total",593,580,13
"2011","Cardiff 037B","W01001871","Total",695,679,16
"2011","Cardiff 037C","W01001875","Total",1163,1140,23
"2011","Cardiff 037D","W01001876","Total",694,678,16
"2011","Cardiff 038A","W01001869","Total",636,623,13
"2011","Cardiff 038B","W01001872","Total",691,662,29
"2011","Cardiff 038C","W01001873","Total",822,778,44
"2011","Cardiff 038D","W01001874","Total",748,723,25
"2011","Cardiff 039A","W01001737","Total",676,653,23
"2011","Cardiff 039B","W01001738","Total",535,525,10
"2011","Cardiff 039C","W01001739","Total",533,523,10
"2011","Cardiff 039D","W01001740","Total",697,682,15
"2011","Cardiff 039E","W01001741","Total",631,613,18
"2011","Cardiff 040A","W01001709","Total",750,721,29
"2011","Cardiff 040B","W01001710","Total",730,701,29
"2011","Cardiff 040C","W01001711","Total",737,720,17
"2011","Cardiff 040D","W01001712","Total",713,679,34
"2011","Cardiff 040E","W01001713","Total",771,745,26
"2011","Cardiff 041A","W01001704","Total",650,631,19
"2011","Cardiff 041B","W01001706","Total",551,540,11
"2011","Cardiff 041C","W01001707","Total",816,803,13
"2011","Cardiff 041D","W01001746","Total",685,663,22
"2011","Cardiff 042A","W01001855","Total",714,685,29
"2011","Cardiff 042B","W01001856","Total",844,776,68
"2011","Cardiff 042C","W01001857","Total",872,843,29
"2011","Cardiff 042D","W01001862","Total",785,707,78
"2011","Cardiff 043A","W01001742","Total",658,640,18
"2011","Cardiff 043B","W01001743","Total",617,605,12
"2011","Cardiff 043C","W01001744","Total",756,740,16
"2011","Cardiff 043D","W01001745","Total",563,556,7
"2011","Cardiff 044A","W01001764","Total",636,603,33
"2011","Cardiff 044B","W01001765","Total",545,521,24
"2011","Cardiff 044C","W01001766","Total",731,685,46
"2011","Cardiff 044D","W01001767","Total",729,691,38
"2011","Cardiff 044E","W01001768","Total",584,539,45
"2011","Cardiff 045A","W01001702","Total",763,745,18
"2011","Cardiff 045B","W01001703","Total",514,503,11
"2011","Cardiff 045C","W01001705","Total",729,718,11
"2011","Cardiff 045D","W01001708","Total",761,737,24
"2011","Cardiff 046A","W01001759","Total",687,674,13
"2011","Cardiff 046B","W01001760","Total",695,670,25
"2011","Cardiff 046C","W01001761","Total",759,724,35
"2011","Cardiff 046D","W01001762","Total",781,736,45
"2011","Cardiff 048A","W01001940","Total",792,728,64
"2011","Cardiff 048B","W01001943","Total",807,635,172
"2011","Cardiff 048C","W01001944","Total",625,580,45
"2011","Cardiff 048D","W01001945","Total",919,838,81
"2011","Cardiff 048E","W01001947","Total",941,873,68
"2011","Cardiff 049A","W01001699","Total",1066,1000,66
"2011","Cardiff 049B","W01001942","Total",708,647,61
"2011","Cardiff 049C","W01001946","Total",727,707,20
"2011","Cardiff 049D","W01001950","Total",714,609,105
"2011","Cardiff 049E","W01001951","Total",594,548,46
"2011","Cardiff 049F","W01001952","Total",736,621,115
"2011","Rhondda Cynon Taf 001A","W01001186","Total",718,685,33
"2011","Rhondda Cynon Taf 001B","W01001187","Total",595,574,21
"2011","Rhondda Cynon Taf 001C","W01001188","Total",560,497,63
"2011","Rhondda Cynon Taf 001D","W01001221","Total",644,602,42
"2011","Rhondda Cynon Taf 001E","W01001222","Total",687,649,38
"2011","Rhondda Cynon Taf 001F","W01001233","Total",773,735,38
"2011","Rhondda Cynon Taf 002A","W01001148","Total",856,750,106
"2011","Rhondda Cynon Taf 002B","W01001152","Total",699,671,28
"2011","Rhondda Cynon Taf 002C","W01001153","Total",688,636,52
"2011","Rhondda Cynon Taf 002D","W01001155","Total",721,665,56
"2011","Rhondda Cynon Taf 003A","W01001149","Total",672,619,53
"2011","Rhondda Cynon Taf 003B","W01001150","Total",911,797,114
"2011","Rhondda Cynon Taf 003C","W01001151","Total",728,713,15
"2011","Rhondda Cynon Taf 003D","W01001154","Total",719,678,41
"2011","Rhondda Cynon Taf 003E","W01001156","Total",560,549,11
"2011","Rhondda Cynon Taf 004A","W01001147","Total",854,792,62
"2011","Rhondda Cynon Taf 004B","W01001168","Total",669,638,31
"2011","Rhondda Cynon Taf 004C","W01001169","Total",812,761,51
"2011","Rhondda Cynon Taf 004D","W01001170","Total",542,527,15
"2011","Rhondda Cynon Taf 005A","W01001137","Total",1139,1064,75
"2011","Rhondda Cynon Taf 005B","W01001138","Total",676,636,40
"2011","Rhondda Cynon Taf 005C","W01001139","Total",656,611,45
"2011","Rhondda Cynon Taf 005D","W01001140","Total",701,637,64
"2011","Rhondda Cynon Taf 005E","W01001141","Total",717,677,40
"2011","Rhondda Cynon Taf 005F","W01001142","Total",760,704,56
"2011","Rhondda Cynon Taf 006A","W01001204","Total",618,584,34
"2011","Rhondda Cynon Taf 006B","W01001205","Total",760,728,32
"2011","Rhondda Cynon Taf 006C","W01001206","Total",663,635,28
"2011","Rhondda Cynon Taf 006D","W01001207","Total",606,585,21
"2011","Rhondda Cynon Taf 006E","W01001208","Total",810,750,60
"2011","Rhondda Cynon Taf 007A","W01001265","Total",748,667,81
"2011","Rhondda Cynon Taf 007B","W01001266","Total",685,636,49
"2011","Rhondda Cynon Taf 007C","W01001267","Total",712,634,78
"2011","Rhondda Cynon Taf 007D","W01001268","Total",692,636,56
"2011","Rhondda Cynon Taf 008A","W01001209","Total",641,567,74
"2011","Rhondda Cynon Taf 008B","W01001210","Total",676,625,51
"2011","Rhondda Cynon Taf 008C","W01001211","Total",696,650,46
"2011","Rhondda Cynon Taf 008D","W01001212","Total",637,585,52
"2011","Rhondda Cynon Taf 009A","W01001175","Total",661,620,41
"2011","Rhondda Cynon Taf 009B","W01001177","Total",693,587,106
"2011","Rhondda Cynon Taf 009C","W01001202","Total",923,839,84
"2011","Rhondda Cynon Taf 009D","W01001203","Total",615,594,21
"2011","Rhondda Cynon Taf 010A","W01001269","Total",682,626,56
"2011","Rhondda Cynon Taf 010B","W01001270","Total",676,622,54
"2011","Rhondda Cynon Taf 010C","W01001271","Total",780,724,56
"2011","Rhondda Cynon Taf 010D","W01001272","Total",667,632,35
"2011","Rhondda Cynon Taf 010E","W01001273","Total",813,758,55
"2011","Rhondda Cynon Taf 011A","W01001213","Total",666,618,48
"2011","Rhondda Cynon Taf 011B","W01001214","Total",547,531,16
"2011","Rhondda Cynon Taf 011C","W01001215","Total",602,519,83
"2011","Rhondda Cynon Taf 011D","W01001216","Total",701,654,47
"2011","Rhondda Cynon Taf 012A","W01001143","Total",664,633,31
"2011","Rhondda Cynon Taf 012B","W01001144","Total",716,668,48
"2011","Rhondda Cynon Taf 012C","W01001145","Total",794,753,41
"2011","Rhondda Cynon Taf 012D","W01001146","Total",671,640,31
"2011","Rhondda Cynon Taf 013A","W01001176","Total",659,620,39
"2011","Rhondda Cynon Taf 013B","W01001274","Total",655,577,78
"2011","Rhondda Cynon Taf 013C","W01001275","Total",856,792,64
"2011","Rhondda Cynon Taf 013D","W01001276","Total",789,668,121
"2011","Rhondda Cynon Taf 014A","W01001200","Total",444,420,24
"2011","Rhondda Cynon Taf 014B","W01001201","Total",556,537,19
"2011","Rhondda Cynon Taf 014C","W01001260","Total",506,476,30
"2011","Rhondda Cynon Taf 014D","W01001285","Total",642,605,37
"2011","Rhondda Cynon Taf 014E","W01001286","Total",687,643,44
"2011","Rhondda Cynon Taf 014F","W01001287","Total",667,623,44
"2011","Rhondda Cynon Taf 014G","W01001288","Total",688,640,48
"2011","Rhondda Cynon Taf 015A","W01001180","Total",668,648,20
"2011","Rhondda Cynon Taf 015B","W01001181","Total",621,606,15
"2011","Rhondda Cynon Taf 015C","W01001282","Total",941,867,74
"2011","Rhondda Cynon Taf 015D","W01001283","Total",652,639,13
"2011","Rhondda Cynon Taf 015E","W01001284","Total",437,423,14
"2011","Rhondda Cynon Taf 016A","W01001166","Total",660,553,107
"2011","Rhondda Cynon Taf 016B","W01001167","Total",679,632,47
"2011","Rhondda Cynon Taf 016C","W01001247","Total",802,755,47
"2011","Rhondda Cynon Taf 016D","W01001248","Total",923,864,59
"2011","Rhondda Cynon Taf 017A","W01001171","Total",618,581,37
"2011","Rhondda Cynon Taf 017B","W01001229","Total",689,648,41
"2011","Rhondda Cynon Taf 017C","W01001230","Total",638,612,26
"2011","Rhondda Cynon Taf 017D","W01001231","Total",725,696,29
"2011","Rhondda Cynon Taf 017E","W01001280","Total",801,752,49
"2011","Rhondda Cynon Taf 017F","W01001281","Total",780,741,39
"2011","Rhondda Cynon Taf 018A","W01001217","Total",496,483,13
"2011","Rhondda Cynon Taf 018B","W01001218","Total",687,643,44
"2011","Rhondda Cynon Taf 018C","W01001219","Total",672,624,48
"2011","Rhondda Cynon Taf 018D","W01001220","Total",646,623,23
"2011","Rhondda Cynon Taf 018E","W01001259","Total",715,684,31
"2011","Rhondda Cynon Taf 018F","W01001261","Total",583,541,42
"2011","Rhondda Cynon Taf 019A","W01001164","Total",696,656,40
"2011","Rhondda Cynon Taf 019B","W01001165","Total",583,554,29
"2011","Rhondda Cynon Taf 019C","W01001256","Total",543,522,21
"2011","Rhondda Cynon Taf 019D","W01001257","Total",543,520,23
"2011","Rhondda Cynon Taf 019E","W01001258","Total",676,636,40
"2011","Rhondda Cynon Taf 020A","W01001172","Total",672,642,30
"2011","Rhondda Cynon Taf 020B","W01001173","Total",639,612,27
"2011","Rhondda Cynon Taf 020C","W01001174","Total",654,624,30
"2011","Rhondda Cynon Taf 020D","W01001232","Total",664,609,55
"2011","Rhondda Cynon Taf 021A","W01001182","Total",630,594,36
"2011","Rhondda Cynon Taf 021B","W01001183","Total",532,500,32
"2011","Rhondda Cynon Taf 021C","W01001227","Total",558,543,15
"2011","Rhondda Cynon Taf 021D","W01001228","Total",703,662,41
"2011","Rhondda Cynon Taf 021E","W01001234","Total",672,632,40
"2011","Rhondda Cynon Taf 021F","W01001235","Total",776,718,58
"2011","Rhondda Cynon Taf 021G","W01001236","Total",670,645,25
"2011","Rhondda Cynon Taf 022A","W01001185","Total",804,762,42
"2011","Rhondda Cynon Taf 022B","W01001237","Total",653,633,20
"2011","Rhondda Cynon Taf 022C","W01001238","Total",697,672,25
"2011","Rhondda Cynon Taf 022D","W01001262","Total",606,546,60
"2011","Rhondda Cynon Taf 022E","W01001263","Total",648,600,48
"2011","Rhondda Cynon Taf 022F","W01001264","Total",560,519,41
"2011","Rhondda Cynon Taf 023A","W01001178","Total",742,723,19
"2011","Rhondda Cynon Taf 023B","W01001179","Total",760,728,32
"2011","Rhondda Cynon Taf 023C","W01001253","Total",631,596,35
"2011","Rhondda Cynon Taf 023E","W01001255","Total",713,691,22
"2011","Rhondda Cynon Taf 023F","W01001914","Total",583,577,6
"2011","Rhondda Cynon Taf 023G","W01001917","Total",626,606,20
"2011","Rhondda Cynon Taf 024A","W01001249","Total",672,645,27
"2011","Rhondda Cynon Taf 024B","W01001250","Total",579,562,17
"2011","Rhondda Cynon Taf 024C","W01001251","Total",686,675,11
"2011","Rhondda Cynon Taf 024D","W01001252","Total",628,619,9
"2011","Rhondda Cynon Taf 025A","W01001162","Total",782,763,19
"2011","Rhondda Cynon Taf 025B","W01001244","Total",633,612,21
"2011","Rhondda Cynon Taf 025C","W01001245","Total",524,518,6
"2011","Rhondda Cynon Taf 025D","W01001246","Total",634,625,9
"2011","Rhondda Cynon Taf 026A","W01001184","Total",909,864,45
"2011","Rhondda Cynon Taf 026B","W01001239","Total",655,633,22
"2011","Rhondda Cynon Taf 026C","W01001240","Total",861,845,16
"2011","Rhondda Cynon Taf 026D","W01001241","Total",774,756,18
"2011","Rhondda Cynon Taf 027B","W01001196","Total",640,630,10
"2011","Rhondda Cynon Taf 027C","W01001197","Total",488,481,7
"2011","Rhondda Cynon Taf 027D","W01001198","Total",670,662,8
"2011","Rhondda Cynon Taf 027E","W01001199","Total",712,694,18
"2011","Rhondda Cynon Taf 027F","W01001915","Total",616,609,7
"2011","Rhondda Cynon Taf 027G","W01001916","Total",554,547,7
"2011","Rhondda Cynon Taf 028A","W01001157","Total",607,591,16
"2011","Rhondda Cynon Taf 028B","W01001158","Total",620,614,6
"2011","Rhondda Cynon Taf 028C","W01001159","Total",524,509,15
"2011","Rhondda Cynon Taf 028D","W01001277","Total",458,456,2
"2011","Rhondda Cynon Taf 028E","W01001278","Total",472,464,8
"2011","Rhondda Cynon Taf 028F","W01001279","Total",542,532,10
"2011","Rhondda Cynon Taf 029A","W01001160","Total",692,664,28
"2011","Rhondda Cynon Taf 029B","W01001161","Total",922,898,24
"2011","Rhondda Cynon Taf 029C","W01001189","Total",703,686,17
"2011","Rhondda Cynon Taf 029D","W01001190","Total",1039,1018,21
"2011","Rhondda Cynon Taf 030A","W01001193","Total",504,489,15
"2011","Rhondda Cynon Taf 030B","W01001194","Total",892,878,14
"2011","Rhondda Cynon Taf 030C","W01001195","Total",703,685,18
"2011","Rhondda Cynon Taf 030D","W01001242","Total",590,569,21
"2011","Rhondda Cynon Taf 030E","W01001243","Total",694,672,22
"2011","Rhondda Cynon Taf 031A","W01001191","Total",1054,1011,43
"2011","Rhondda Cynon Taf 031B","W01001192","Total",641,626,15
"2011","Rhondda Cynon Taf 031C","W01001223","Total",753,702,51
"2011","Rhondda Cynon Taf 031D","W01001224","Total",784,779,5
"2011","Rhondda Cynon Taf 031E","W01001225","Total",662,653,9
"2011","Rhondda Cynon Taf 031F","W01001226","Total",749,722,27
"2011","Merthyr Tydfil 002A","W01001295","Total",748,683,65
"2011","Merthyr Tydfil 002B","W01001296","Total",691,651,40
"2011","Merthyr Tydfil 002C","W01001297","Total",867,775,92
"2011","Merthyr Tydfil 002D","W01001298","Total",863,780,83
"2011","Merthyr Tydfil 002E","W01001310","Total",695,659,36
"2011","Merthyr Tydfil 002F","W01001311","Total",538,500,38
"2011","Merthyr Tydfil 003A","W01001291","Total",709,679,30
"2011","Merthyr Tydfil 003B","W01001294","Total",679,649,30
"2011","Merthyr Tydfil 003C","W01001305","Total",554,517,37
"2011","Merthyr Tydfil 003D","W01001306","Total",685,644,41
"2011","Merthyr Tydfil 003E","W01001324","Total",972,896,76
"2011","Merthyr Tydfil 004A","W01001292","Total",754,692,62
"2011","Merthyr Tydfil 004B","W01001293","Total",771,734,37
"2011","Merthyr Tydfil 004C","W01001307","Total",803,731,72
"2011","Merthyr Tydfil 004D","W01001315","Total",914,809,105
"2011","Merthyr Tydfil 005A","W01001314","Total",954,895,59
"2011","Merthyr Tydfil 005B","W01001316","Total",1232,1162,70
"2011","Merthyr Tydfil 005C","W01001317","Total",712,677,35
"2011","Merthyr Tydfil 005D","W01001318","Total",707,646,61
"2011","Merthyr Tydfil 006A","W01001289","Total",680,619,61
"2011","Merthyr Tydfil 006B","W01001302","Total",528,472,56
"2011","Merthyr Tydfil 006C","W01001303","Total",563,506,57
"2011","Merthyr Tydfil 006D","W01001304","Total",653,614,39
"2011","Merthyr Tydfil 006E","W01001312","Total",698,643,55
"2011","Merthyr Tydfil 006F","W01001313","Total",763,658,105
"2011","Merthyr Tydfil 007A","W01001290","Total",844,768,76
"2011","Merthyr Tydfil 007B","W01001319","Total",691,646,45
"2011","Merthyr Tydfil 007C","W01001320","Total",672,603,69
"2011","Merthyr Tydfil 007D","W01001321","Total",688,632,56
"2011","Merthyr Tydfil 007E","W01001322","Total",743,667,76
"2011","Merthyr Tydfil 008A","W01001299","Total",728,686,42
"2011","Merthyr Tydfil 008B","W01001300","Total",683,654,29
"2011","Merthyr Tydfil 008C","W01001301","Total",794,751,43
"2011","Merthyr Tydfil 008D","W01001308","Total",502,445,57
"2011","Merthyr Tydfil 008E","W01001309","Total",525,496,29
"2011","Merthyr Tydfil 008F","W01001898","Total",651,625,26
"2011","Caerphilly 001A","W01001374","Total",617,591,26
"2011","Caerphilly 001B","W01001375","Total",729,685,44
"2011","Caerphilly 001C","W01001376","Total",682,665,17
"2011","Caerphilly 001D","W01001406","Total",887,841,46
"2011","Caerphilly 001E","W01001428","Total",557,543,14
"2011","Caerphilly 001F","W01001429","Total",568,532,36
"2011","Caerphilly 002A","W01001360","Total",577,544,33
"2011","Caerphilly 002B","W01001361","Total",508,497,11
"2011","Caerphilly 002C","W01001384","Total",746,698,48
"2011","Caerphilly 002D","W01001385","Total",756,693,63
"2011","Caerphilly 002E","W01001386","Total",766,719,47
"2011","Caerphilly 003A","W01001325","Total",632,624,8
"2011","Caerphilly 003B","W01001326","Total",917,887,30
"2011","Caerphilly 003C","W01001362","Total",951,921,30
"2011","Caerphilly 004A","W01001336","Total",647,614,33
"2011","Caerphilly 004B","W01001337","Total",700,657,43
"2011","Caerphilly 004C","W01001338","Total",830,774,56
"2011","Caerphilly 004D","W01001339","Total",618,600,18
"2011","Caerphilly 005A","W01001334","Total",625,592,33
"2011","Caerphilly 005B","W01001335","Total",540,517,23
"2011","Caerphilly 005C","W01001347","Total",624,602,22
"2011","Caerphilly 005D","W01001351","Total",665,652,13
"2011","Caerphilly 006A","W01001356","Total",496,485,11
"2011","Caerphilly 006B","W01001357","Total",680,661,19
"2011","Caerphilly 006C","W01001358","Total",662,650,12
"2011","Caerphilly 006D","W01001359","Total",676,650,26
"2011","Caerphilly 006E","W01001390","Total",686,672,14
"2011","Caerphilly 006F","W01001391","Total",694,672,22
"2011","Caerphilly 007A","W01001352","Total",769,754,15
"2011","Caerphilly 007B","W01001353","Total",753,738,15
"2011","Caerphilly 007C","W01001387","Total",572,542,30
"2011","Caerphilly 007D","W01001388","Total",742,723,19
"2011","Caerphilly 007E","W01001389","Total",468,457,11
"2011","Caerphilly 008A","W01001414","Total",676,647,29
"2011","Caerphilly 008B","W01001415","Total",748,719,29
"2011","Caerphilly 008C","W01001416","Total",658,647,11
"2011","Caerphilly 008D","W01001417","Total",594,578,16
"2011","Caerphilly 008E","W01001418","Total",644,623,21
"2011","Caerphilly 009A","W01001348","Total",750,734,16
"2011","Caerphilly 009B","W01001349","Total",693,685,8
"2011","Caerphilly 009C","W01001350","Total",803,766,37
"2011","Caerphilly 009D","W01001392","Total",780,755,25
"2011","Caerphilly 010A","W01001380","Total",810,771,39
"2011","Caerphilly 010B","W01001381","Total",642,624,18
"2011","Caerphilly 010C","W01001382","Total",733,685,48
"2011","Caerphilly 010D","W01001383","Total",698,663,35
"2011","Caerphilly 011A","W01001401","Total",874,848,26
"2011","Caerphilly 011B","W01001402","Total",700,679,21
"2011","Caerphilly 011C","W01001403","Total",697,680,17
"2011","Caerphilly 011D","W01001404","Total",594,584,10
"2011","Caerphilly 011E","W01001405","Total",766,744,22
"2011","Caerphilly 012A","W01001363","Total",581,565,16
"2011","Caerphilly 012B","W01001364","Total",704,689,15
"2011","Caerphilly 012C","W01001365","Total",869,842,27
"2011","Caerphilly 012D","W01001369","Total",970,943,27
"2011","Caerphilly 013A","W01001377","Total",699,672,27
"2011","Caerphilly 013B","W01001378","Total",714,681,33
"2011","Caerphilly 013C","W01001379","Total",644,625,19
"2011","Caerphilly 013D","W01001432","Total",1042,952,90
"2011","Caerphilly 013E","W01001433","Total",675,635,40
"2011","Caerphilly 013F","W01001434","Total",561,549,12
"2011","Caerphilly 014A","W01001327","Total",1004,947,57
"2011","Caerphilly 014B","W01001328","Total",680,641,39
"2011","Caerphilly 014C","W01001329","Total",700,654,46
"2011","Caerphilly 014D","W01001354","Total",733,706,27
"2011","Caerphilly 015A","W01001355","Total",845,811,34
"2011","Caerphilly 015B","W01001430","Total",1037,983,54
"2011","Caerphilly 015C","W01001431","Total",670,642,28
"2011","Caerphilly 016A","W01001407","Total",632,617,15
"2011","Caerphilly 016B","W01001408","Total",624,606,18
"2011","Caerphilly 016C","W01001409","Total",708,697,11
"2011","Caerphilly 016D","W01001410","Total",841,823,18
"2011","Caerphilly 017A","W01001411","Total",807,784,23
"2011","Caerphilly 017B","W01001412","Total",894,831,63
"2011","Caerphilly 017C","W01001413","Total",770,749,21
"2011","Caerphilly 018A","W01001330","Total",637,620,17
"2011","Caerphilly 018B","W01001331","Total",756,728,28
"2011","Caerphilly 018C","W01001332","Total",870,806,64
"2011","Caerphilly 018D","W01001333","Total",643,624,19
"2011","Caerphilly 019A","W01001366","Total",719,697,22
"2011","Caerphilly 019B","W01001367","Total",658,634,24
"2011","Caerphilly 019C","W01001368","Total",651,640,11
"2011","Caerphilly 019D","W01001393","Total",557,545,12
"2011","Caerphilly 019E","W01001397","Total",687,677,10
"2011","Caerphilly 019F","W01001400","Total",574,567,7
"2011","Caerphilly 020A","W01001340","Total",705,694,11
"2011","Caerphilly 020B","W01001341","Total",807,794,13
"2011","Caerphilly 020C","W01001344","Total",707,689,18
"2011","Caerphilly 020D","W01001346","Total",677,660,17
"2011","Caerphilly 021A","W01001342","Total",513,496,17
"2011","Caerphilly 021B","W01001343","Total",513,497,16
"2011","Caerphilly 021C","W01001345","Total",610,590,20
"2011","Caerphilly 021D","W01001419","Total",652,632,20
"2011","Caerphilly 022A","W01001371","Total",637,624,13
"2011","Caerphilly 022B","W01001372","Total",818,805,13
"2011","Caerphilly 022C","W01001373","Total",738,703,35
"2011","Caerphilly 022D","W01001420","Total",583,562,21
"2011","Caerphilly 022E","W01001421","Total",731,710,21
"2011","Caerphilly 022F","W01001422","Total",693,673,20
"2011","Caerphilly 023A","W01001370","Total",804,773,31
"2011","Caerphilly 023B","W01001394","Total",514,507,7
"2011","Caerphilly 023C","W01001395","Total",625,616,9
"2011","Caerphilly 023D","W01001396","Total",669,656,13
"2011","Caerphilly 023E","W01001399","Total",564,548,16
"2011","Caerphilly 024A","W01001398","Total",1016,963,53
"2011","Caerphilly 024B","W01001423","Total",647,632,15
"2011","Caerphilly 024C","W01001424","Total",687,659,28
"2011","Caerphilly 024D","W01001425","Total",746,715,31
"2011","Caerphilly 024E","W01001426","Total",542,532,10
"2011","Caerphilly 024F","W01001427","Total",690,683,7
"2011","Blaenau Gwent 001A","W01001440","Total",628,604,24
"2011","Blaenau Gwent 001B","W01001441","Total",513,503,10
"2011","Blaenau Gwent 001C","W01001442","Total",529,504,25
"2011","Blaenau Gwent 001D","W01001470","Total",648,633,15
"2011","Blaenau Gwent 001E","W01001471","Total",786,767,19
"2011","Blaenau Gwent 002A","W01001446","Total",506,485,21
"2011","Blaenau Gwent 002B","W01001447","Total",642,622,20
"2011","Blaenau Gwent 002C","W01001448","Total",673,624,49
"2011","Blaenau Gwent 002D","W01001449","Total",757,726,31
"2011","Blaenau Gwent 003A","W01001472","Total",649,634,15
"2011","Blaenau Gwent 003B","W01001473","Total",608,603,5
"2011","Blaenau Gwent 003C","W01001474","Total",693,673,20
"2011","Blaenau Gwent 003D","W01001475","Total",530,513,17
"2011","Blaenau Gwent 003E","W01001480","Total",652,635,17
"2011","Blaenau Gwent 004A","W01001438","Total",732,670,62
"2011","Blaenau Gwent 004B","W01001439","Total",702,680,22
"2011","Blaenau Gwent 004C","W01001456","Total",588,552,36
"2011","Blaenau Gwent 004D","W01001457","Total",754,743,11
"2011","Blaenau Gwent 004E","W01001458","Total",673,638,35
"2011","Blaenau Gwent 005A","W01001443","Total",680,646,34
"2011","Blaenau Gwent 005B","W01001444","Total",819,796,23
"2011","Blaenau Gwent 005C","W01001445","Total",663,633,30
"2011","Blaenau Gwent 005D","W01001467","Total",812,798,14
"2011","Blaenau Gwent 005E","W01001468","Total",616,582,34
"2011","Blaenau Gwent 005F","W01001469","Total",518,504,14
"2011","Blaenau Gwent 006A","W01001462","Total",687,662,25
"2011","Blaenau Gwent 006B","W01001463","Total",901,868,33
"2011","Blaenau Gwent 006C","W01001478","Total",685,662,23
"2011","Blaenau Gwent 006D","W01001479","Total",715,706,9
"2011","Blaenau Gwent 006E","W01001481","Total",882,775,107
"2011","Blaenau Gwent 007A","W01001450","Total",604,570,34
"2011","Blaenau Gwent 007B","W01001451","Total",729,656,73
"2011","Blaenau Gwent 007C","W01001452","Total",642,624,18
"2011","Blaenau Gwent 007D","W01001459","Total",472,448,24
"2011","Blaenau Gwent 007E","W01001460","Total",818,764,54
"2011","Blaenau Gwent 007F","W01001461","Total",676,634,42
"2011","Blaenau Gwent 008A","W01001435","Total",702,632,70
"2011","Blaenau Gwent 008B","W01001436","Total",723,646,77
"2011","Blaenau Gwent 008C","W01001437","Total",690,658,32
"2011","Blaenau Gwent 008D","W01001453","Total",673,648,25
"2011","Blaenau Gwent 008E","W01001454","Total",629,609,20
"2011","Blaenau Gwent 008F","W01001455","Total",835,792,43
"2011","Blaenau Gwent 009A","W01001464","Total",725,689,36
"2011","Blaenau Gwent 009B","W01001465","Total",749,698,51
"2011","Blaenau Gwent 009C","W01001466","Total",855,787,68
"2011","Blaenau Gwent 009D","W01001476","Total",518,486,32
"2011","Blaenau Gwent 009E","W01001477","Total",671,634,37
"2011","Torfaen 001A","W01001487","Total",712,662,50
"2011","Torfaen 001B","W01001488","Total",702,683,19
"2011","Torfaen 001C","W01001489","Total",755,702,53
"2011","Torfaen 001D","W01001490","Total",648,598,50
"2011","Torfaen 002A","W01001482","Total",517,497,20
"2011","Torfaen 002B","W01001483","Total",583,564,19
"2011","Torfaen 002C","W01001484","Total",711,695,16
"2011","Torfaen 002D","W01001485","Total",542,529,13
"2011","Torfaen 002E","W01001486","Total",679,653,26
"2011","Torfaen 003A","W01001525","Total",627,602,25
"2011","Torfaen 003B","W01001529","Total",1008,917,91
"2011","Torfaen 003C","W01001530","Total",735,698,37
"2011","Torfaen 003D","W01001531","Total",744,706,38
"2011","Torfaen 004A","W01001491","Total",857,802,55
"2011","Torfaen 004B","W01001496","Total",634,585,49
"2011","Torfaen 004C","W01001523","Total",681,638,43
"2011","Torfaen 004D","W01001524","Total",939,829,110
"2011","Torfaen 004E","W01001540","Total",560,532,28
"2011","Torfaen 004F","W01001541","Total",493,459,34
"2011","Torfaen 005A","W01001510","Total",705,670,35
"2011","Torfaen 005B","W01001511","Total",738,719,19
"2011","Torfaen 005C","W01001512","Total",617,607,10
"2011","Torfaen 005D","W01001513","Total",648,636,12
"2011","Torfaen 006A","W01001514","Total",513,495,18
"2011","Torfaen 006B","W01001515","Total",683,630,53
"2011","Torfaen 006C","W01001516","Total",635,619,16
"2011","Torfaen 006D","W01001517","Total",841,822,19
"2011","Torfaen 006E","W01001518","Total",499,477,22
"2011","Torfaen 007A","W01001519","Total",656,627,29
"2011","Torfaen 007B","W01001520","Total",739,729,10
"2011","Torfaen 007C","W01001521","Total",641,611,30
"2011","Torfaen 007D","W01001522","Total",780,759,21
"2011","Torfaen 007E","W01001537","Total",521,507,14
"2011","Torfaen 008A","W01001493","Total",937,905,32
"2011","Torfaen 008B","W01001494","Total",686,654,32
"2011","Torfaen 008C","W01001495","Total",878,850,28
"2011","Torfaen 008D","W01001507","Total",928,905,23
"2011","Torfaen 009A","W01001501","Total",531,510,21
"2011","Torfaen 009B","W01001503","Total",527,505,22
"2011","Torfaen 009C","W01001536","Total",508,471,37
"2011","Torfaen 009D","W01001538","Total",620,569,51
"2011","Torfaen 009E","W01001539","Total",636,598,38
"2011","Torfaen 010A","W01001506","Total",720,688,32
"2011","Torfaen 010B","W01001526","Total",605,574,31
"2011","Torfaen 010C","W01001527","Total",656,638,18
"2011","Torfaen 010D","W01001528","Total",505,484,21
"2011","Torfaen 010E","W01001532","Total",785,743,42
"2011","Torfaen 011A","W01001497","Total",629,613,16
"2011","Torfaen 011B","W01001498","Total",525,488,37
"2011","Torfaen 011C","W01001499","Total",526,513,13
"2011","Torfaen 011D","W01001500","Total",506,497,9
"2011","Torfaen 011E","W01001502","Total",507,500,7
"2011","Torfaen 012A","W01001492","Total",940,928,12
"2011","Torfaen 012B","W01001533","Total",619,611,8
"2011","Torfaen 012C","W01001534","Total",660,638,22
"2011","Torfaen 012D","W01001535","Total",581,576,5
"2011","Torfaen 013A","W01001504","Total",887,862,25
"2011","Torfaen 013B","W01001505","Total",818,800,18
"2011","Torfaen 013C","W01001508","Total",534,527,7
"2011","Torfaen 013D","W01001509","Total",632,618,14
"2011","Monmouthshire 001A","W01001545","Total",660,632,28
"2011","Monmouthshire 001B","W01001548","Total",958,857,101
"2011","Monmouthshire 001C","W01001557","Total",1032,911,121
"2011","Monmouthshire 001D","W01001571","Total",533,508,25
"2011","Monmouthshire 001E","W01001579","Total",809,745,64
"2011","Monmouthshire 002A","W01001546","Total",665,645,20
"2011","Monmouthshire 002C","W01001558","Total",719,697,22
"2011","Monmouthshire 002E","W01001580","Total",847,809,38
"2011","Monmouthshire 002F","W01001909","Total",1195,1165,30
"2011","Monmouthshire 003A","W01001561","Total",674,651,23
"2011","Monmouthshire 003B","W01001562","Total",646,604,42
"2011","Monmouthshire 003C","W01001563","Total",483,461,22
"2011","Monmouthshire 003D","W01001564","Total",1053,999,54
"2011","Monmouthshire 003E","W01001569","Total",649,622,27
"2011","Monmouthshire 004A","W01001552","Total",656,635,21
"2011","Monmouthshire 004B","W01001553","Total",1145,1113,32
"2011","Monmouthshire 004C","W01001554","Total",799,712,87
"2011","Monmouthshire 004D","W01001576","Total",513,490,23
"2011","Monmouthshire 004E","W01001577","Total",658,610,48
"2011","Monmouthshire 004F","W01001599","Total",990,960,30
"2011","Monmouthshire 005A","W01001566","Total",511,489,22
"2011","Monmouthshire 005B","W01001567","Total",457,433,24
"2011","Monmouthshire 005C","W01001568","Total",764,697,67
"2011","Monmouthshire 005D","W01001575","Total",524,500,24
"2011","Monmouthshire 005E","W01001581","Total",892,852,40
"2011","Monmouthshire 006A","W01001555","Total",506,484,22
"2011","Monmouthshire 006B","W01001556","Total",536,509,27
"2011","Monmouthshire 006C","W01001560","Total",539,514,25
"2011","Monmouthshire 006D","W01001565","Total",755,719,36
"2011","Monmouthshire 006E","W01001596","Total",550,495,55
"2011","Monmouthshire 006F","W01001597","Total",695,660,35
"2011","Monmouthshire 007A","W01001549","Total",631,598,33
"2011","Monmouthshire 007B","W01001583","Total",711,659,52
"2011","Monmouthshire 007C","W01001585","Total",523,509,14
"2011","Monmouthshire 007D","W01001586","Total",978,950,28
"2011","Monmouthshire 007E","W01001594","Total",561,537,24
"2011","Monmouthshire 007F","W01001595","Total",562,527,35
"2011","Monmouthshire 008A","W01001559","Total",571,559,12
"2011","Monmouthshire 008B","W01001584","Total",796,778,18
"2011","Monmouthshire 008C","W01001587","Total",1030,964,66
"2011","Monmouthshire 008D","W01001592","Total",693,679,14
"2011","Monmouthshire 008E","W01001593","Total",749,729,20
"2011","Monmouthshire 009A","W01001542","Total",758,728,30
"2011","Monmouthshire 009B","W01001543","Total",578,553,25
"2011","Monmouthshire 009C","W01001578","Total",918,884,34
"2011","Monmouthshire 009D","W01001590","Total",916,868,48
"2011","Monmouthshire 010C","W01001551","Total",477,466,11
"2011","Monmouthshire 010D","W01001588","Total",755,731,24
"2011","Monmouthshire 010E","W01001589","Total",677,655,22
"2011","Monmouthshire 010F","W01001598","Total",691,672,19
"2011","Monmouthshire 010G","W01001908","Total",960,934,26
"2011","Monmouthshire 011A","W01001572","Total",632,618,14
"2011","Monmouthshire 011B","W01001573","Total",575,560,15
"2011","Monmouthshire 011C","W01001574","Total",626,617,9
"2011","Monmouthshire 011D","W01001582","Total",707,698,9
"2011","Monmouthshire 011E","W01001591","Total",590,582,8
"2011","Newport 001A","W01001623","Total",698,654,44
"2011","Newport 001B","W01001624","Total",517,501,16
"2011","Newport 001C","W01001625","Total",581,560,21
"2011","Newport 001D","W01001626","Total",600,577,23
"2011","Newport 001E","W01001627","Total",649,630,19
"2011","Newport 001F","W01001628","Total",540,511,29
"2011","Newport 002A","W01001651","Total",647,637,10
"2011","Newport 002B","W01001652","Total",802,791,11
"2011","Newport 002C","W01001653","Total",614,608,6
"2011","Newport 002D","W01001654","Total",691,676,15
"2011","Newport 002E","W01001655","Total",661,651,10
"2011","Newport 003A","W01001617","Total",594,582,12
"2011","Newport 003B","W01001618","Total",501,494,7
"2011","Newport 003C","W01001619","Total",607,599,8
"2011","Newport 003D","W01001620","Total",487,482,5
"2011","Newport 003E","W01001621","Total",624,614,10
"2011","Newport 003F","W01001622","Total",544,535,9
"2011","Newport 004A","W01001639","Total",734,719,15
"2011","Newport 004B","W01001640","Total",505,495,10
"2011","Newport 004C","W01001641","Total",554,537,17
"2011","Newport 004D","W01001649","Total",638,608,30
"2011","Newport 004E","W01001650","Total",633,615,18
"2011","Newport 005A","W01001614","Total",817,778,39
"2011","Newport 005B","W01001615","Total",626,604,22
"2011","Newport 005C","W01001616","Total",652,633,19
"2011","Newport 005D","W01001678","Total",728,700,28
"2011","Newport 006A","W01001601","Total",659,638,21
"2011","Newport 006B","W01001681","Total",692,660,32
"2011","Newport 006C","W01001682","Total",614,599,15
"2011","Newport 006D","W01001683","Total",498,485,13
"2011","Newport 006E","W01001684","Total",666,637,29
"2011","Newport 007A","W01001675","Total",654,619,35
"2011","Newport 007B","W01001676","Total",775,720,55
"2011","Newport 007C","W01001677","Total",672,653,19
"2011","Newport 007D","W01001679","Total",465,457,8
"2011","Newport 007E","W01001680","Total",538,506,32
"2011","Newport 008A","W01001606","Total",535,517,18
"2011","Newport 008B","W01001608","Total",659,638,21
"2011","Newport 008C","W01001663","Total",710,689,21
"2011","Newport 008D","W01001665","Total",781,743,38
"2011","Newport 009A","W01001669","Total",540,528,12
"2011","Newport 009B","W01001670","Total",880,862,18
"2011","Newport 009C","W01001672","Total",757,733,24
"2011","Newport 009D","W01001673","Total",659,644,15
"2011","Newport 009E","W01001674","Total",628,619,9
"2011","Newport 010A","W01001664","Total",678,647,31
"2011","Newport 010B","W01001666","Total",636,623,13
"2011","Newport 010C","W01001667","Total",531,521,10
"2011","Newport 010D","W01001668","Total",494,482,12
"2011","Newport 011A","W01001611","Total",550,531,19
"2011","Newport 011B","W01001612","Total",707,651,56
"2011","Newport 011C","W01001613","Total",647,616,31
"2011","Newport 011D","W01001691","Total",731,657,74
"2011","Newport 011E","W01001692","Total",923,834,89
"2011","Newport 012A","W01001600","Total",694,669,25
"2011","Newport 012B","W01001602","Total",701,676,25
"2011","Newport 012C","W01001603","Total",618,569,49
"2011","Newport 012D","W01001604","Total",633,620,13
"2011","Newport 013A","W01001642","Total",833,779,54
"2011","Newport 013B","W01001643","Total",592,566,26
"2011","Newport 013C","W01001644","Total",1206,1136,70
"2011","Newport 013D","W01001690","Total",971,946,25
"2011","Newport 013E","W01001693","Total",688,647,41
"2011","Newport 014A","W01001605","Total",684,625,59
"2011","Newport 014B","W01001685","Total",807,773,34
"2011","Newport 014C","W01001686","Total",581,554,27
"2011","Newport 014D","W01001687","Total",989,879,110
"2011","Newport 015A","W01001607","Total",515,497,18
"2011","Newport 015B","W01001609","Total",580,567,13
"2011","Newport 015C","W01001610","Total",516,507,9
"2011","Newport 015D","W01001645","Total",527,513,14
"2011","Newport 015E","W01001646","Total",647,623,24
"2011","Newport 015F","W01001647","Total",651,633,18
"2011","Newport 015G","W01001648","Total",651,637,14
"2011","Newport 016A","W01001635","Total",604,596,8
"2011","Newport 016B","W01001637","Total",717,700,17
"2011","Newport 016C","W01001638","Total",477,468,9
"2011","Newport 016D","W01001671","Total",864,841,23
"2011","Newport 017A","W01001629","Total",654,634,20
"2011","Newport 017B","W01001630","Total",813,788,25
"2011","Newport 017C","W01001631","Total",626,617,9
"2011","Newport 017D","W01001632","Total",602,585,17
"2011","Newport 018A","W01001659","Total",850,782,68
"2011","Newport 018B","W01001660","Total",636,616,20
"2011","Newport 018C","W01001661","Total",1042,945,97
"2011","Newport 018D","W01001662","Total",646,614,32
"2011","Newport 019A","W01001633","Total",618,609,9
"2011","Newport 019B","W01001634","Total",637,611,26
"2011","Newport 019C","W01001688","Total",1123,1080,43
"2011","Newport 019D","W01001689","Total",819,777,42
"2011","Newport 020A","W01001636","Total",705,696,9
"2011","Newport 020C","W01001657","Total",562,547,15
"2011","Newport 020D","W01001658","Total",715,697,18
"2011","Newport 020E","W01001912","Total",660,648,12
"2011","Newport 020F","W01001913","Total",628,605,23
